game_id,closing_be_home,closing_be_away,closing_ml_home,closing_ml_away,home_prob,away_prob,home_away,team,over_under,line,closing_be,closing_odds,closing_prob,home,away,season_type,home_hits,home_score,away_hits,away_score,total_runs,total_hits,home_win,away_win,home_win_margin,away_win_margin,both_teams_score_1,both_teams_score_2,both_teams_score_3,both_teams_score_4,both_teams_score_5,both_teams_score_6,both_teams_score_7,both_teams_score_8,both_teams_score_9,total_over_prob,total_under_prob
85567,0.6254681647940076,0.4132231404958678,-167,142,0.6012679850808645,0.39873201491913546,away,MIL,over,8,0.5145631067961165,-106,0.49023796582517226,ARI,MIL,2022 REG,8,5,3,1,6,11,1,0,4,-4,1,0,0,0,0,0,0,0,0,0.49023796582517226,0.5097620341748277
85567,0.6254681647940076,0.4132231404958678,-167,142,0.6012679850808645,0.39873201491913546,home,ARI,under,8,0.5327102803738317,-114,0.5097620341748277,ARI,MIL,2022 REG,8,5,3,1,6,11,1,0,4,-4,1,0,0,0,0,0,0,0,0,0.49023796582517226,0.5097620341748277
85570,0.6153846153846154,0.425531914893617,-160,135,0.5902052121364724,0.40979478786352763,away,TEX,over,9.5,0.5121951219512195,-105,0.48919479393107135,BOS,TEX,2022 REG,7,5,10,3,8,17,1,0,2,-2,1,1,1,0,0,0,0,0,0,0.48919479393107135,0.5108052060689287
85570,0.6153846153846154,0.425531914893617,-160,135,0.5902052121364724,0.40979478786352763,home,BOS,under,9.5,0.5327102803738317,-114,0.5108052060689287,BOS,TEX,2022 REG,7,5,10,3,8,17,1,0,2,-2,1,1,1,0,0,0,0,0,0,0.48919479393107135,0.5108052060689287
85572,0.7674418604651163,0.2777777777777778,-330,260,0.7327384171624303,0.26726158283756973,away,ARI,over,8,0.5348837209302326,-115,0.5109810284308424,LAD,ARI,2022 REG,8,2,5,5,7,13,0,1,-3,3,1,1,0,0,0,0,0,0,0,0.5109810284308424,0.48901897156915763
85572,0.7674418604651163,0.2777777777777778,-330,260,0.7327384171624303,0.26726158283756973,home,LAD,under,8,0.5098039215686274,-104,0.48901897156915763,LAD,ARI,2022 REG,8,2,5,5,7,13,0,1,-3,3,1,1,0,0,0,0,0,0,0,0.5109810284308424,0.48901897156915763
85576,0.5901639344262295,0.4484304932735426,-144,123,0.5673868951280033,0.43261310487199667,away,CIN,over,8.5,0.5475113122171946,-121,0.5228602997583487,PIT,CIN,2022 REG,4,1,14,10,11,18,0,1,-9,9,1,0,0,0,0,0,0,0,0,0.5228602997583487,0.4771397002416513
85576,0.5901639344262295,0.4484304932735426,-144,123,0.5673868951280033,0.43261310487199667,home,PIT,under,8.5,0.49751243781094534,101,0.4771397002416513,PIT,CIN,2022 REG,4,1,14,10,11,18,0,1,-9,9,1,0,0,0,0,0,0,0,0,0.5228602997583487,0.4771397002416513
85581,0.5555555555555556,0.47619047619047616,-125,110,0.5379188712522047,0.4620811287477953,away,OAK,over,8.5,0.5348837209302326,-115,0.5097020142727117,TEX,OAK,2022 REG,11,8,10,7,15,21,1,0,1,-1,1,1,1,1,1,1,1,0,0,0.5097020142727117,0.49029798572728833
85581,0.5555555555555556,0.47619047619047616,-125,110,0.5379188712522047,0.4620811287477953,home,TEX,under,8.5,0.5121951219512195,-105,0.49029798572728833,TEX,OAK,2022 REG,11,8,10,7,15,21,1,0,1,-1,1,1,1,1,1,1,1,0,0,0.5097020142727117,0.49029798572728833
85584,0.5535714285714286,0.48780487804878053,-124,105,0.53066668740667,0.46933331259333,away,TB,over,7,0.49019607843137253,104,0.46874141813588177,SEA,TB,2022 REG,11,7,13,8,15,24,0,1,-1,1,1,1,1,1,1,1,1,0,0,0.46874141813588177,0.5312585818641182
85584,0.5535714285714286,0.48780487804878053,-124,105,0.53066668740667,0.46933331259333,home,SEA,under,7,0.5535714285714286,-124,0.5312585818641182,SEA,TB,2022 REG,11,7,13,8,15,24,0,1,-1,1,1,1,1,1,1,1,1,0,0,0.46874141813588177,0.5312585818641182
85600,0.7014925373134329,0.33557046979865773,-235,198,0.6754931144139067,0.3245068855860933,away,SF,over,8,0.5260663507109005,-111,0.5022370601254724,LAD,SF,2022 REG,9,4,9,7,11,18,0,1,-3,3,1,1,1,1,0,0,0,0,0,0.5022370601254724,0.4977629398745276
85600,0.7014925373134329,0.33557046979865773,-235,198,0.6754931144139067,0.3245068855860933,home,LAD,under,8,0.5192307692307692,-108,0.4977629398745276,LAD,SF,2022 REG,9,4,9,7,11,18,0,1,-3,3,1,1,1,1,0,0,0,0,0,0.5022370601254724,0.4977629398745276
85606,0.6721311475409836,0.37037037037037035,-205,170,0.6435645535349916,0.35643544646500835,away,KC,over,8,0.5305164319248826,-113,0.5053568787472517,ARI,KC,2022 REG,9,8,9,6,14,18,1,0,2,-2,1,1,1,1,1,1,0,0,0,0.5053568787472517,0.49464312125274834
85606,0.6721311475409836,0.37037037037037035,-205,170,0.6435645535349916,0.35643544646500835,home,ARI,under,8,0.5169082125603864,-107,0.49464312125274834,ARI,KC,2022 REG,9,8,9,6,14,18,1,0,2,-2,1,1,1,1,1,1,0,0,0,0.5053568787472517,0.49464312125274834
85609,0.6226415094339623,0.4166666666666667,-165,140,0.5981666073335706,0.40183339266642937,away,TB,over,7.5,0.5391705069124424,-117,0.5140669063204599,TOR,TB,2022 REG,8,7,7,2,9,15,1,0,5,-5,1,1,0,0,0,0,0,0,0,0.5140669063204599,0.4859330936795401
85609,0.6226415094339623,0.4166666666666667,-165,140,0.5981666073335706,0.40183339266642937,home,TOR,under,7.5,0.5073891625615764,-103,0.4859330936795401,TOR,TB,2022 REG,8,7,7,2,9,15,1,0,5,-5,1,1,0,0,0,0,0,0,0,0.5140669063204599,0.4859330936795401
85612,0.6666666666666666,0.37037037037037035,-200,170,0.6419753086419753,0.3580246913580247,away,COL,over,7,0.5454545454545454,-120,0.5193043049216726,STL,COL,2022 REG,9,5,7,1,6,16,1,0,4,-4,1,0,0,0,0,0,0,0,0,0.5193043049216726,0.48069569507832743
85612,0.6666666666666666,0.37037037037037035,-200,170,0.6419753086419753,0.3580246913580247,home,STL,under,7,0.5024875621890548,-101,0.48069569507832743,STL,COL,2022 REG,9,5,7,1,6,16,1,0,4,-4,1,0,0,0,0,0,0,0,0,0.5193043049216726,0.48069569507832743
85613,0.5495495495495495,0.48780487804878053,-122,105,0.529021440689206,0.470978559310794,away,BOS,over,8.5,0.5121951219512195,-105,0.48808156828023186,BAL,BOS,2022 REG,3,0,4,1,1,7,0,1,-1,1,0,0,0,0,0,0,0,0,0,0.48808156828023186,0.5119184317197681
85613,0.5495495495495495,0.48780487804878053,-122,105,0.529021440689206,0.470978559310794,home,BAL,under,8.5,0.5348837209302326,-115,0.5119184317197681,BAL,BOS,2022 REG,3,0,4,1,1,7,0,1,-1,1,0,0,0,0,0,0,0,0,0,0.48808156828023186,0.5119184317197681
85614,0.40322580645161293,0.6363636363636364,148,-175,0.387262321445464,0.612737678554536,away,BOS,over,8.5,0.5348837209302326,-115,0.5109810284308424,BAL,BOS,2022 REG,5,2,7,1,3,12,1,0,1,-1,1,0,0,0,0,0,0,0,0,0.5109810284308424,0.48901897156915763
85614,0.40322580645161293,0.6363636363636364,148,-175,0.387262321445464,0.612737678554536,home,BAL,under,8.5,0.5098039215686274,-104,0.48901897156915763,BAL,BOS,2022 REG,5,2,7,1,3,12,1,0,1,-1,1,0,0,0,0,0,0,0,0,0.5109810284308424,0.48901897156915763
85615,0.5652173913043479,0.47619047619047616,-130,110,0.5418129444594474,0.4581870555405526,away,NYY,over,7.5,0.5,100,0.4772727272727273,TB,NYY,2022 REG,11,9,5,0,9,16,1,0,9,-9,0,0,0,0,0,0,0,0,0,0.4772727272727273,0.5227272727272727
85615,0.5652173913043479,0.47619047619047616,-130,110,0.5418129444594474,0.4581870555405526,home,TB,under,7.5,0.5454545454545454,-120,0.5227272727272727,TB,NYY,2022 REG,11,9,5,0,9,16,1,0,9,-9,0,0,0,0,0,0,0,0,0,0.4772727272727273,0.5227272727272727
85616,0.43859649122807015,0.6031746031746031,128,-152,0.4202758357883012,0.5797241642116988,away,TOR,over,7.5,0.5215311004784688,-109,0.4978845547971712,STL,TOR,2022 REG,6,1,12,8,9,18,0,1,-7,7,1,0,0,0,0,0,0,0,0,0.4978845547971712,0.5021154452028288
85616,0.43859649122807015,0.6031746031746031,128,-152,0.4202758357883012,0.5797241642116988,home,STL,under,7.5,0.5238095238095238,-110,0.5021154452028288,STL,TOR,2022 REG,6,1,12,8,9,18,0,1,-7,7,1,0,0,0,0,0,0,0,0,0.4978845547971712,0.5021154452028288
85619,0.4854368932038835,0.5495495495495495,106,-122,0.4684531831294015,0.5315468168705986,away,PHI,over,8.5,0.5412844036697247,-118,0.5162581740877563,SF,PHI,2022 REG,11,5,12,4,9,23,1,0,1,-1,1,1,1,1,0,0,0,0,0,0.5162581740877563,0.4837418259122437
85619,0.4854368932038835,0.5495495495495495,106,-122,0.4684531831294015,0.5315468168705986,home,SF,under,8.5,0.504950495049505,-102,0.4837418259122437,SF,PHI,2022 REG,11,5,12,4,9,23,1,0,1,-1,1,1,1,1,0,0,0,0,0,0.5162581740877563,0.4837418259122437
85621,0.45454545454545453,0.5780590717299579,120,-137,0.439725215329358,0.560274784670642,away,MIL,over,11.5,0.5327102803738317,-114,0.5075272610403079,COL,MIL,2022 REG,5,4,9,6,10,14,0,1,-2,2,1,1,1,1,0,0,0,0,0,0.5075272610403079,0.4924727389596921
85621,0.45454545454545453,0.5780590717299579,120,-137,0.439725215329358,0.560274784670642,home,COL,under,11.5,0.5145631067961165,-106,0.4924727389596921,COL,MIL,2022 REG,5,4,9,6,10,14,0,1,-2,2,1,1,1,1,0,0,0,0,0,0.5075272610403079,0.4924727389596921
85622,0.7530864197530864,0.29411764705882354,-305,240,0.7175376780799196,0.28246232192008036,away,DET,over,8.5,0.5348837209302326,-115,0.5097020142727117,TOR,DET,2022 REG,6,4,3,1,5,9,1,0,3,-3,1,0,0,0,0,0,0,0,0,0.5097020142727117,0.49029798572728833
85622,0.7530864197530864,0.29411764705882354,-305,240,0.7175376780799196,0.28246232192008036,home,TOR,under,8.5,0.5121951219512195,-105,0.49029798572728833,TOR,DET,2022 REG,6,4,3,1,5,9,1,0,3,-3,1,0,0,0,0,0,0,0,0,0.5097020142727117,0.49029798572728833
85623,0.5815899581589958,0.4587155963302753,-139,118,0.5581486524100054,0.44185134758999456,away,BOS,over,9,0.5348837209302326,-115,0.5097020142727117,TOR,BOS,2022 REG,13,6,10,5,11,23,1,0,1,-1,1,1,1,1,1,0,0,0,0,0.5097020142727117,0.49029798572728833
85623,0.5815899581589958,0.4587155963302753,-139,118,0.5581486524100054,0.44185134758999456,home,TOR,under,9,0.5121951219512195,-105,0.49029798572728833,TOR,BOS,2022 REG,13,6,10,5,11,23,1,0,1,-1,1,1,1,1,1,0,0,0,0,0.5097020142727117,0.49029798572728833
85626,0.5454545454545454,0.49504950495049505,-120,102,0.5233614270517961,0.4766385729482039,away,PHI,over,8,0.5121951219512195,-105,0.48808156828023186,TOR,PHI,2022 REG,11,8,2,2,10,13,1,0,6,-6,1,1,0,0,0,0,0,0,0,0.48808156828023186,0.5119184317197681
85626,0.5454545454545454,0.49504950495049505,-120,102,0.5233614270517961,0.4766385729482039,home,TOR,under,8,0.5348837209302326,-115,0.5119184317197681,TOR,PHI,2022 REG,11,8,2,2,10,13,1,0,6,-6,1,1,0,0,0,0,0,0,0,0.48808156828023186,0.5119184317197681
85627,0.5594713656387665,0.4716981132075471,-127,112,0.5420329347423708,0.4579670652576292,away,LAA,over,8,0.5327102803738317,-114,0.508788710910954,CLE,LAA,2022 REG,9,3,4,1,4,13,1,0,2,-2,1,0,0,0,0,0,0,0,0,0.508788710910954,0.491211289089046
85627,0.5594713656387665,0.4716981132075471,-127,112,0.5420329347423708,0.4579670652576292,home,CLE,under,8,0.5121951219512195,-105,0.491211289089046,CLE,LAA,2022 REG,9,3,4,1,4,13,1,0,2,-2,1,0,0,0,0,0,0,0,0,0.508788710910954,0.491211289089046
85629,0.5652173913043479,0.4716981132075471,-130,112,0.5443521061454507,0.4556478938545493,away,MIN,over,9.5,0.5073891625615764,-103,0.4837652908580103,BOS,MIN,2022 REG,6,4,5,0,4,11,1,0,4,-4,0,0,0,0,0,0,0,0,0,0.4837652908580103,0.5162347091419897
85629,0.5652173913043479,0.4716981132075471,-130,112,0.5443521061454507,0.4556478938545493,home,BOS,under,9.5,0.5391705069124424,-117,0.5162347091419897,BOS,MIN,2022 REG,6,4,5,0,4,11,1,0,4,-4,0,0,0,0,0,0,0,0,0,0.4837652908580103,0.5162347091419897
85630,0.5726495726495727,0.4672897196261683,-134,114,0.5497783539959433,0.4502216460040567,away,HOU,over,8.5,0.5238095238095238,-110,0.5000596729920038,TOR,HOU,2022 REG,6,2,8,1,3,14,1,0,1,-1,1,0,0,0,0,0,0,0,0,0.5000596729920038,0.4999403270079962
85630,0.5726495726495727,0.4672897196261683,-134,114,0.5497783539959433,0.4502216460040567,home,TOR,under,8.5,0.5215311004784688,-109,0.4999403270079962,TOR,HOU,2022 REG,6,2,8,1,3,14,1,0,1,-1,1,0,0,0,0,0,0,0,0,0.5000596729920038,0.4999403270079962
85631,0.49504950495049505,0.5454545454545454,102,-120,0.47499799484898986,0.5250020051510101,away,CWS,over,8,0.5412844036697247,-118,0.5149381613977361,TEX,CWS,2022 REG,7,8,2,0,8,9,1,0,8,-8,0,0,0,0,0,0,0,0,0,0.5149381613977361,0.48506183860226393
85631,0.49504950495049505,0.5454545454545454,102,-120,0.47499799484898986,0.5250020051510101,home,TEX,under,8,0.5073891625615764,-103,0.48506183860226393,TEX,CWS,2022 REG,7,8,2,0,8,9,1,0,8,-8,0,0,0,0,0,0,0,0,0,0.5149381613977361,0.48506183860226393
85635,0.6226415094339623,0.4081632653061224,-165,145,0.6034611779920227,0.3965388220079773,away,OAK,over,7.5,0.5145631067961165,-106,0.4913668392989033,SF,OAK,2022 REG,3,0,7,1,1,10,0,1,-1,1,0,0,0,0,0,0,0,0,0,0.4913668392989033,0.5086331607010968
85635,0.6226415094339623,0.4081632653061224,-165,145,0.6034611779920227,0.3965388220079773,home,SF,under,7.5,0.5305164319248826,-113,0.5086331607010968,SF,OAK,2022 REG,3,0,7,1,1,10,0,1,-1,1,0,0,0,0,0,0,0,0,0,0.4913668392989033,0.5086331607010968
85636,0.5121951219512195,0.5283018867924528,-105,-112,0.49145275161909474,0.5085472483809053,away,TOR,over,8,0.5121951219512195,-105,0.48919479393107135,NYY,TOR,2022 REG,4,0,8,4,4,12,0,1,-4,4,0,0,0,0,0,0,0,0,0,0.48919479393107135,0.5108052060689287
85636,0.5121951219512195,0.5283018867924528,-105,-112,0.49145275161909474,0.5085472483809053,home,NYY,under,8,0.5327102803738317,-114,0.5108052060689287,NYY,TOR,2022 REG,4,0,8,4,4,12,0,1,-4,4,0,0,0,0,0,0,0,0,0,0.48919479393107135,0.5108052060689287
85644,0.5454545454545454,0.5,-120,100,0.5206611570247933,0.4793388429752067,away,TEX,over,10,0.5098039215686274,-104,0.4870219861770517,BOS,TEX,2022 REG,12,5,4,2,7,16,1,0,3,-3,1,1,0,0,0,0,0,0,0,0.4870219861770517,0.5129780138229483
85644,0.5454545454545454,0.5,-120,100,0.5206611570247933,0.4793388429752067,home,BOS,under,10,0.5348837209302326,-115,0.5129780138229483,BOS,TEX,2022 REG,12,5,4,2,7,16,1,0,3,-3,1,1,0,0,0,0,0,0,0,0.4870219861770517,0.5129780138229483
85645,0.43103448275862066,0.607843137254902,132,-155,0.4142768879252058,0.5857231120747942,away,SEA,over,7.5,0.5,100,0.4772727272727273,DET,SEA,2022 REG,4,0,10,7,7,14,0,1,-7,7,0,0,0,0,0,0,0,0,0,0.4772727272727273,0.5227272727272727
85645,0.43103448275862066,0.607843137254902,132,-155,0.4142768879252058,0.5857231120747942,home,DET,under,7.5,0.5454545454545454,-120,0.5227272727272727,DET,SEA,2022 REG,4,0,10,7,7,14,0,1,-7,7,0,0,0,0,0,0,0,0,0,0.4772727272727273,0.5227272727272727
85646,0.4807692307692307,0.5555555555555556,108,-125,0.4633053911900066,0.5366946088099934,away,MIA,over,7.5,0.5305164319248826,-113,0.5053568787472517,WSH,MIA,2022 REG,8,5,11,4,9,19,1,0,1,-1,1,1,1,1,0,0,0,0,0,0.5053568787472517,0.49464312125274834
85646,0.4807692307692307,0.5555555555555556,108,-125,0.4633053911900066,0.5366946088099934,home,WSH,under,7.5,0.5169082125603864,-107,0.49464312125274834,WSH,MIA,2022 REG,8,5,11,4,9,19,1,0,1,-1,1,1,1,1,0,0,0,0,0,0.5053568787472517,0.49464312125274834
85647,0.24096385542168672,0.7938144329896907,315,-385,0.23258354496111386,0.7674164550388861,away,NYM,over,6.5,0.5495495495495495,-122,0.5223196169142115,OAK,NYM,2022 REG,14,10,9,4,14,23,1,0,6,-6,1,1,1,1,0,0,0,0,0,0.5223196169142115,0.47768038308578853
85647,0.24096385542168672,0.7938144329896907,315,-385,0.23258354496111386,0.7674164550388861,home,OAK,under,6.5,0.5,100,0.47768038308578853,OAK,NYM,2022 REG,14,10,9,4,14,23,1,0,6,-6,1,1,1,1,0,0,0,0,0,0.5223196169142115,0.47768038308578853
85648,0.5192307692307692,0.5169082125603864,-108,-107,0.5004662979161306,0.4995337020838694,away,MIN,over,8,0.5098039215686274,-104,0.48483656587239576,CLE,MIN,2022 REG,3,0,10,3,3,13,0,1,-3,3,0,0,0,0,0,0,0,0,0,0.48483656587239576,0.5151634341276042
85648,0.5192307692307692,0.5169082125603864,-108,-107,0.5004662979161306,0.4995337020838694,home,CLE,under,8,0.5391705069124424,-117,0.5151634341276042,CLE,MIN,2022 REG,3,0,10,3,3,13,0,1,-3,3,0,0,0,0,0,0,0,0,0,0.48483656587239576,0.5151634341276042
85649,0.5850622406639003,0.45454545454545453,-141,120,0.5618892737571823,0.43811072624281766,away,SEA,over,7.5,0.5145631067961165,-106,0.4913668392989033,TB,SEA,2022 REG,7,3,5,2,5,12,1,0,1,-1,1,1,0,0,0,0,0,0,0,0.4913668392989033,0.5086331607010968
85649,0.5850622406639003,0.45454545454545453,-141,120,0.5618892737571823,0.43811072624281766,home,TB,under,7.5,0.5305164319248826,-113,0.5086331607010968,TB,SEA,2022 REG,7,3,5,2,5,12,1,0,1,-1,1,1,0,0,0,0,0,0,0,0.4913668392989033,0.5086331607010968
85651,0.5412844036697247,0.5,-118,100,0.5189377998484975,0.4810622001515025,away,SF,over,11.5,0.5121951219512195,-105,0.48919479393107135,COL,SF,2022 REG,10,3,9,6,9,19,0,1,-3,3,1,1,1,0,0,0,0,0,0,0.48919479393107135,0.5108052060689287
85651,0.5412844036697247,0.5,-118,100,0.5189377998484975,0.4810622001515025,home,COL,under,11.5,0.5327102803738317,-114,0.5108052060689287,COL,SF,2022 REG,10,3,9,6,9,19,0,1,-3,3,1,1,1,0,0,0,0,0,0,0.48919479393107135,0.5108052060689287
85652,0.574468085106383,0.46511627906976744,-135,115,0.5517281312179562,0.44827186878204384,away,LAA,over,7.5,0.5,100,0.4772727272727273,OAK,LAA,2022 REG,5,4,8,3,7,13,1,0,1,-1,1,1,1,0,0,0,0,0,0,0.4772727272727273,0.5227272727272727
85652,0.574468085106383,0.46511627906976744,-135,115,0.5517281312179562,0.44827186878204384,home,OAK,under,7.5,0.5454545454545454,-120,0.5227272727272727,OAK,LAA,2022 REG,5,4,8,3,7,13,1,0,1,-1,1,1,1,0,0,0,0,0,0,0.4772727272727273,0.5227272727272727
85653,0.5967741935483871,0.4424778761061947,-148,126,0.5733495713351688,0.42665042866483116,away,TB,over,9,0.49504950495049505,102,0.4739797934813417,CWS,TB,2022 REG,7,3,5,2,5,12,1,0,1,-1,1,1,0,0,0,0,0,0,0,0.4739797934813417,0.5260202065186583
85653,0.5967741935483871,0.4424778761061947,-148,126,0.5733495713351688,0.42665042866483116,home,CWS,under,9,0.5475113122171946,-121,0.5260202065186583,CWS,TB,2022 REG,7,3,5,2,5,12,1,0,1,-1,1,1,0,0,0,0,0,0,0,0.4739797934813417,0.5260202065186583
85655,0.4347826086956522,0.607843137254902,130,-155,0.41624967567367205,0.583750324326328,away,SF,over,8,0.5412844036697247,-118,0.5149381613977361,CLE,SF,2022 REG,3,1,8,4,5,11,0,1,-3,3,1,0,0,0,0,0,0,0,0,0.5149381613977361,0.48506183860226393
85655,0.4347826086956522,0.607843137254902,130,-155,0.41624967567367205,0.583750324326328,home,CLE,under,8,0.5073891625615764,-103,0.48506183860226393,CLE,SF,2022 REG,3,1,8,4,5,11,0,1,-3,3,1,0,0,0,0,0,0,0,0,0.5149381613977361,0.48506183860226393
85657,0.4807692307692307,0.5575221238938054,108,-126,0.46235992564277106,0.5376400743572289,away,TEX,over,8,0.5238095238095238,-110,0.4988662131519274,SEA,TEX,2022 REG,6,4,6,2,6,12,1,0,2,-2,1,1,0,0,0,0,0,0,0,0.4988662131519274,0.5011337868480725
85657,0.4807692307692307,0.5575221238938054,108,-126,0.46235992564277106,0.5376400743572289,home,SEA,under,8,0.5238095238095238,-110,0.5011337868480725,SEA,TEX,2022 REG,6,4,6,2,6,12,1,0,2,-2,1,1,0,0,0,0,0,0,0,0.4988662131519274,0.5011337868480725
85658,0.37735849056603776,0.6610169491525424,165,-195,0.36287719255902645,0.6371228074409736,away,SD,over,7.5,0.5024875621890548,-101,0.48049269377245407,PIT,SD,2022 REG,8,2,11,5,7,19,0,1,-3,3,1,1,0,0,0,0,0,0,0,0.48049269377245407,0.5195073062275459
85658,0.37735849056603776,0.6610169491525424,165,-195,0.36287719255902645,0.6371228074409736,home,PIT,under,7.5,0.5412844036697247,-118,0.5195073062275459,PIT,SD,2022 REG,8,2,11,5,7,19,0,1,-3,3,1,1,0,0,0,0,0,0,0,0.48049269377245407,0.5195073062275459
85661,0.5555555555555556,0.4854368932038835,-125,106,0.5327819729114227,0.4672180270885773,away,CHC,over,8.5,0.5238095238095238,-110,0.5012646084074657,ARI,CHC,2022 REG,6,2,8,3,5,14,0,1,-1,1,1,1,0,0,0,0,0,0,0,0.5012646084074657,0.4987353915925343
85661,0.5555555555555556,0.4854368932038835,-125,106,0.5327819729114227,0.4672180270885773,home,ARI,under,8.5,0.5192307692307692,-108,0.4987353915925343,ARI,CHC,2022 REG,6,2,8,3,5,14,0,1,-1,1,1,1,0,0,0,0,0,0,0,0.5012646084074657,0.4987353915925343
85662,0.6774193548387096,0.35714285714285715,-210,180,0.6540062434963579,0.34599375650364206,away,PHI,over,7.5,0.5433789954337899,-119,0.5171177654451503,ATL,PHI,2022 REG,7,7,6,2,9,13,1,0,5,-5,1,1,0,0,0,0,0,0,0,0.5171177654451503,0.4828822345548497
85662,0.6774193548387096,0.35714285714285715,-210,180,0.6540062434963579,0.34599375650364206,home,ATL,under,7.5,0.504950495049505,-102,0.4828822345548497,ATL,PHI,2022 REG,7,7,6,2,9,13,1,0,5,-5,1,1,0,0,0,0,0,0,0,0.5171177654451503,0.4828822345548497
85665,0.7409326424870467,0.29850746268656714,-286,235,0.7117101811407941,0.2882898188592059,away,WSH,over,7.5,0.5024875621890548,-101,0.47839724939301687,SEA,WSH,2022 REG,6,4,5,2,6,11,1,0,2,-2,1,1,0,0,0,0,0,0,0,0.47839724939301687,0.5216027506069831
85665,0.7409326424870467,0.29850746268656714,-286,235,0.7117101811407941,0.2882898188592059,home,SEA,under,7.5,0.5454545454545454,-120,0.5216027506069831,SEA,WSH,2022 REG,6,4,5,2,6,11,1,0,2,-2,1,1,0,0,0,0,0,0,0,0.47839724939301687,0.5216027506069831
85670,0.38167938931297707,0.6551724137931035,162,-190,0.3676138156083661,0.6323861843916339,away,STL,over,8,0.5238095238095238,-110,0.4953530708057871,CHC,STL,2022 REG,5,2,5,0,2,10,1,0,2,-2,0,0,0,0,0,0,0,0,0,0.4953530708057871,0.5046469291942128
85670,0.38167938931297707,0.6551724137931035,162,-190,0.3676138156083661,0.6323861843916339,home,CHC,under,8,0.5305164319248826,-113,0.5046469291942128,CHC,STL,2022 REG,5,2,5,0,2,10,1,0,2,-2,0,0,0,0,0,0,0,0,0,0.4953530708057871,0.5046469291942128
85673,0.75,0.2857142857142857,-300,250,0.7232142857142858,0.2767857142857142,away,OAK,over,8,0.5260663507109005,-111,0.5010269332605688,NYY,OAK,2022 REG,8,9,6,5,14,14,1,0,4,-4,1,1,1,1,1,0,0,0,0,0.5010269332605688,0.4989730667394312
85673,0.75,0.2857142857142857,-300,250,0.7232142857142858,0.2767857142857142,home,NYY,under,8,0.5215311004784688,-109,0.4989730667394312,NYY,OAK,2022 REG,8,9,6,5,14,14,1,0,4,-4,1,1,1,1,1,0,0,0,0,0.5010269332605688,0.4989730667394312
85674,0.7590361445783133,0.2857142857142857,-315,250,0.7250689505007983,0.27493104949920166,away,WSH,over,7.5,0.5238095238095238,-110,0.4988662131519274,SD,WSH,2022 REG,5,2,7,1,3,12,1,0,1,-1,1,0,0,0,0,0,0,0,0,0.4988662131519274,0.5011337868480725
85674,0.7590361445783133,0.2857142857142857,-315,250,0.7250689505007983,0.27493104949920166,home,SD,under,7.5,0.5238095238095238,-110,0.5011337868480725,SD,WSH,2022 REG,5,2,7,1,3,12,1,0,1,-1,1,0,0,0,0,0,0,0,0,0.4988662131519274,0.5011337868480725
85682,0.5633187772925764,0.47619047619047616,-129,110,0.5410624729287608,0.45893752707123925,away,MIN,over,7.5,0.5327102803738317,-114,0.508788710910954,TB,MIN,2022 REG,8,6,3,1,7,11,1,0,5,-5,1,0,0,0,0,0,0,0,0,0.508788710910954,0.491211289089046
85682,0.5633187772925764,0.47619047619047616,-129,110,0.5410624729287608,0.45893752707123925,home,TB,under,7.5,0.5121951219512195,-105,0.491211289089046,TB,MIN,2022 REG,8,6,3,1,7,11,1,0,5,-5,1,0,0,0,0,0,0,0,0,0.508788710910954,0.491211289089046
85683,0.425531914893617,0.607843137254902,135,-155,0.4113297650431834,0.5886702349568166,away,NYY,over,8.5,0.5098039215686274,-104,0.48483656587239576,CWS,NYY,2022 REG,11,3,9,2,5,20,1,0,1,-1,1,1,0,0,0,0,0,0,0,0.48483656587239576,0.5151634341276042
85683,0.425531914893617,0.607843137254902,135,-155,0.4113297650431834,0.5886702349568166,home,CWS,under,8.5,0.5391705069124424,-117,0.5151634341276042,CWS,NYY,2022 REG,11,3,9,2,5,20,1,0,1,-1,1,1,0,0,0,0,0,0,0,0.48483656587239576,0.5151634341276042
85685,0.5,0.5391705069124424,100,-117,0.4804147465437788,0.5195852534562212,away,ATL,over,7,0.5454545454545454,-120,0.5206611570247933,SEA,ATL,2022 REG,6,4,10,6,10,16,0,1,-2,2,1,1,1,1,0,0,0,0,0,0.5206611570247933,0.4793388429752067
85685,0.5,0.5391705069124424,100,-117,0.4804147465437788,0.5195852534562212,home,SEA,under,7,0.5,100,0.4793388429752067,SEA,ATL,2022 REG,6,4,10,6,10,16,0,1,-2,2,1,1,1,1,0,0,0,0,0,0.5206611570247933,0.4793388429752067
85686,0.5967741935483871,0.43859649122807015,-148,128,0.5756658816656627,0.4243341183343373,away,TB,over,8.5,0.5215311004784688,-109,0.4978845547971712,CWS,TB,2022 REG,6,3,6,2,5,12,1,0,1,-1,1,1,0,0,0,0,0,0,0,0.4978845547971712,0.5021154452028288
85686,0.5967741935483871,0.43859649122807015,-148,128,0.5756658816656627,0.4243341183343373,home,CWS,under,8.5,0.5238095238095238,-110,0.5021154452028288,CWS,TB,2022 REG,6,3,6,2,5,12,1,0,1,-1,1,1,0,0,0,0,0,0,0,0.4978845547971712,0.5021154452028288
85690,0.726027397260274,0.3125,-265,220,0.6980554513041847,0.30194454869581533,away,CIN,over,8,0.5145631067961165,-106,0.4913668392989033,STL,CIN,2022 REG,2,0,10,3,3,12,0,1,-3,3,0,0,0,0,0,0,0,0,0,0.4913668392989033,0.5086331607010968
85690,0.726027397260274,0.3125,-265,220,0.6980554513041847,0.30194454869581533,home,STL,under,8,0.5305164319248826,-113,0.5086331607010968,STL,CIN,2022 REG,2,0,10,3,3,12,0,1,-3,3,0,0,0,0,0,0,0,0,0,0.4913668392989033,0.5086331607010968
85692,0.6551724137931035,0.3846153846153846,-190,160,0.6291045458703008,0.37089545412969915,away,DET,over,9,0.5370370370370371,-116,0.5105975442470474,MIN,DET,2022 REG,7,3,7,5,8,14,0,1,-2,2,1,1,1,0,0,0,0,0,0,0.5105975442470474,0.4894024557529526
85692,0.6551724137931035,0.3846153846153846,-190,160,0.6291045458703008,0.37089545412969915,home,MIN,under,9,0.5121951219512195,-105,0.4894024557529526,MIN,DET,2022 REG,7,3,7,5,8,14,0,1,-2,2,1,1,1,0,0,0,0,0,0,0.5105975442470474,0.4894024557529526
85693,0.4347826086956522,0.607843137254902,130,-155,0.41624967567367205,0.583750324326328,away,LAD,over,7.5,0.5238095238095238,-110,0.4988662131519274,SD,LAD,2022 REG,7,0,5,1,1,12,0,1,-1,1,0,0,0,0,0,0,0,0,0,0.4988662131519274,0.5011337868480725
85693,0.4347826086956522,0.607843137254902,130,-155,0.41624967567367205,0.583750324326328,home,SD,under,7.5,0.5238095238095238,-110,0.5011337868480725,SD,LAD,2022 REG,7,0,5,1,1,12,0,1,-1,1,0,0,0,0,0,0,0,0,0,0.4988662131519274,0.5011337868480725
85694,0.6923076923076923,0.3508771929824561,-225,185,0.6624104640298972,0.33758953597010277,away,TEX,over,7,0.5260663507109005,-111,0.5022370601254724,NYY,TEX,2022 REG,3,2,7,4,6,10,0,1,-2,2,1,1,0,0,0,0,0,0,0,0.5022370601254724,0.4977629398745276
85694,0.6923076923076923,0.3508771929824561,-225,185,0.6624104640298972,0.33758953597010277,home,NYY,under,7,0.5192307692307692,-108,0.4977629398745276,NYY,TEX,2022 REG,3,2,7,4,6,10,0,1,-2,2,1,1,0,0,0,0,0,0,0,0.5022370601254724,0.4977629398745276
85695,0.5238095238095238,0.5238095238095238,-110,-110,0.4988662131519274,0.5011337868480725,away,SEA,over,8,0.5073891625615764,-103,0.4837652908580103,MIN,SEA,2022 REG,4,1,5,2,3,9,0,1,-1,1,1,0,0,0,0,0,0,0,0,0.4837652908580103,0.5162347091419897
85695,0.5238095238095238,0.5238095238095238,-110,-110,0.4988662131519274,0.5011337868480725,home,MIN,under,8,0.5391705069124424,-117,0.5162347091419897,MIN,SEA,2022 REG,4,1,5,2,3,9,0,1,-1,1,1,0,0,0,0,0,0,0,0,0.4837652908580103,0.5162347091419897
85696,0.4347826086956522,0.6000000000000001,130,-150,0.4196597353497164,0.5803402646502835,away,TB,over,9.5,0.5327102803738317,-114,0.5075272610403079,CIN,TB,2022 REG,13,5,8,4,9,21,1,0,1,-1,1,1,1,1,0,0,0,0,0,0.5075272610403079,0.4924727389596921
85696,0.4347826086956522,0.6000000000000001,130,-150,0.4196597353497164,0.5803402646502835,home,CIN,under,9.5,0.5145631067961165,-106,0.4924727389596921,CIN,TB,2022 REG,13,5,8,4,9,21,1,0,1,-1,1,1,1,1,0,0,0,0,0,0.5075272610403079,0.4924727389596921
85697,0.5967741935483871,0.43859649122807015,-148,128,0.5756658816656627,0.4243341183343373,away,TOR,over,8.5,0.5238095238095238,-110,0.5000596729920038,NYY,TOR,2022 REG,10,4,8,6,10,18,0,1,-2,2,1,1,1,1,0,0,0,0,0,0.5000596729920038,0.4999403270079962
85697,0.5967741935483871,0.43859649122807015,-148,128,0.5756658816656627,0.4243341183343373,home,NYY,under,8.5,0.5215311004784688,-109,0.4999403270079962,NYY,TOR,2022 REG,10,4,8,6,10,18,0,1,-2,2,1,1,1,1,0,0,0,0,0,0.5000596729920038,0.4999403270079962
85699,0.47619047619047616,0.5594713656387665,110,-127,0.4592086467479796,0.5407913532520203,away,CWS,over,7.5,0.5348837209302326,-115,0.5097020142727117,BOS,CWS,2022 REG,7,1,11,3,4,18,0,1,-2,2,1,0,0,0,0,0,0,0,0,0.5097020142727117,0.49029798572728833
85699,0.47619047619047616,0.5594713656387665,110,-127,0.4592086467479796,0.5407913532520203,home,BOS,under,7.5,0.5121951219512195,-105,0.49029798572728833,BOS,CWS,2022 REG,7,1,11,3,4,18,0,1,-2,2,1,0,0,0,0,0,0,0,0,0.5097020142727117,0.49029798572728833
85703,0.3508771929824561,0.6875,185,-220,0.3374115112342259,0.662588488765774,away,SF,over,7.5,0.5283018867924528,-112,0.5044173060022736,DET,SF,2022 REG,7,1,5,3,4,12,0,1,-2,2,1,0,0,0,0,0,0,0,0,0.5044173060022736,0.49558269399772636
85703,0.3508771929824561,0.6875,185,-220,0.3374115112342259,0.662588488765774,home,DET,under,7.5,0.5169082125603864,-107,0.49558269399772636,DET,SF,2022 REG,7,1,5,3,4,12,0,1,-2,2,1,0,0,0,0,0,0,0,0,0.5044173060022736,0.49558269399772636
85706,0.6610169491525424,0.37735849056603776,-195,165,0.6356501330673793,0.3643498669326207,away,ARI,over,8.5,0.5024875621890548,-101,0.48049269377245407,NYM,ARI,2022 REG,6,5,5,0,5,11,1,0,5,-5,0,0,0,0,0,0,0,0,0,0.48049269377245407,0.5195073062275459
85706,0.6610169491525424,0.37735849056603776,-195,165,0.6356501330673793,0.3643498669326207,home,NYM,under,8.5,0.5412844036697247,-118,0.5195073062275459,NYM,ARI,2022 REG,6,5,5,0,5,11,1,0,5,-5,0,0,0,0,0,0,0,0,0,0.48049269377245407,0.5195073062275459
85707,0.37735849056603776,0.6610169491525424,165,-195,0.36287719255902645,0.6371228074409736,away,HOU,over,8,0.5327102803738317,-114,0.5075272610403079,WSH,HOU,2022 REG,4,0,11,8,8,15,0,1,-8,8,0,0,0,0,0,0,0,0,0,0.5075272610403079,0.4924727389596921
85707,0.37735849056603776,0.6610169491525424,165,-195,0.36287719255902645,0.6371228074409736,home,WSH,under,8,0.5145631067961165,-106,0.4924727389596921,WSH,HOU,2022 REG,4,0,11,8,8,15,0,1,-8,8,0,0,0,0,0,0,0,0,0,0.5075272610403079,0.4924727389596921
85710,0.4347826086956522,0.6000000000000001,130,-150,0.4196597353497164,0.5803402646502835,away,MIL,over,8.5,0.5238095238095238,-110,0.4988662131519274,CIN,MIL,2022 REG,6,2,5,1,3,11,1,0,1,-1,1,0,0,0,0,0,0,0,0,0.4988662131519274,0.5011337868480725
85710,0.4347826086956522,0.6000000000000001,130,-150,0.4196597353497164,0.5803402646502835,home,CIN,under,8.5,0.5238095238095238,-110,0.5011337868480725,CIN,MIL,2022 REG,6,2,5,1,3,11,1,0,1,-1,1,0,0,0,0,0,0,0,0,0.4988662131519274,0.5011337868480725
85714,0.6000000000000001,0.4424778761061947,-150,126,0.5745132743362832,0.4254867256637168,away,OAK,over,6.5,0.5454545454545454,-120,0.5206611570247933,SEA,OAK,2022 REG,5,2,4,1,3,9,1,0,1,-1,1,0,0,0,0,0,0,0,0,0.5206611570247933,0.4793388429752067
85714,0.6000000000000001,0.4424778761061947,-150,126,0.5745132743362832,0.4254867256637168,home,SEA,under,6.5,0.5,100,0.4793388429752067,SEA,OAK,2022 REG,5,2,4,1,3,9,1,0,1,-1,1,0,0,0,0,0,0,0,0,0.5206611570247933,0.4793388429752067
85715,0.4347826086956522,0.6031746031746031,130,-152,0.418279473099889,0.581720526900111,away,KC,over,8,0.5215311004784688,-109,0.4978845547971712,OAK,KC,2022 REG,9,4,3,0,4,12,1,0,4,-4,0,0,0,0,0,0,0,0,0,0.4978845547971712,0.5021154452028288
85715,0.4347826086956522,0.6031746031746031,130,-152,0.418279473099889,0.581720526900111,home,OAK,under,8,0.5238095238095238,-110,0.5021154452028288,OAK,KC,2022 REG,9,4,3,0,4,12,1,0,4,-4,0,0,0,0,0,0,0,0,0,0.4978845547971712,0.5021154452028288
85717,0.607843137254902,0.4273504273504274,-155,134,0.5864509705340155,0.4135490294659845,away,TB,over,6.5,0.5121951219512195,-105,0.48808156828023186,CLE,TB,2022 REG,14,5,7,6,11,21,0,1,-1,1,1,1,1,1,1,0,0,0,0,0.48808156828023186,0.5119184317197681
85717,0.607843137254902,0.4273504273504274,-155,134,0.5864509705340155,0.4135490294659845,home,CLE,under,6.5,0.5348837209302326,-115,0.5119184317197681,CLE,TB,2022 REG,14,5,7,6,11,21,0,1,-1,1,1,1,1,1,1,0,0,0,0,0.48808156828023186,0.5119184317197681
85719,0.37037037037037035,0.6666666666666666,170,-200,0.35665294924554186,0.6433470507544581,away,PHI,over,8,0.5370370370370371,-116,0.5118817074154765,WSH,PHI,2022 REG,6,2,10,8,10,16,0,1,-6,6,1,1,0,0,0,0,0,0,0,0.5118817074154765,0.48811829258452355
85719,0.37037037037037035,0.6666666666666666,170,-200,0.35665294924554186,0.6433470507544581,home,WSH,under,8,0.5098039215686274,-104,0.48811829258452355,WSH,PHI,2022 REG,6,2,10,8,10,16,0,1,-6,6,1,1,0,0,0,0,0,0,0,0.5118817074154765,0.48811829258452355
85721,0.4347826086956522,0.607843137254902,130,-155,0.41624967567367205,0.583750324326328,away,TOR,over,8,0.5073891625615764,-103,0.48484779035144243,TEX,TOR,2022 REG,7,3,10,4,7,17,0,1,-1,1,1,1,1,0,0,0,0,0,0,0.48484779035144243,0.5151522096485576
85721,0.4347826086956522,0.607843137254902,130,-155,0.41624967567367205,0.583750324326328,home,TEX,under,8,0.5370370370370371,-116,0.5151522096485576,TEX,TOR,2022 REG,7,3,10,4,7,17,0,1,-1,1,1,1,1,0,0,0,0,0,0,0.48484779035144243,0.5151522096485576
85723,0.5918367346938775,0.45454545454545453,-145,120,0.5643860512665178,0.43561394873348225,away,TEX,over,7.5,0.5305164319248826,-113,0.5078572507605655,SEA,TEX,2022 REG,7,6,6,2,8,13,1,0,4,-4,1,1,0,0,0,0,0,0,0,0.5078572507605655,0.49214274923943446
85723,0.5918367346938775,0.45454545454545453,-145,120,0.5643860512665178,0.43561394873348225,home,SEA,under,7.5,0.5121951219512195,-105,0.49214274923943446,SEA,TEX,2022 REG,7,6,6,2,8,13,1,0,4,-4,1,1,0,0,0,0,0,0,0,0.5078572507605655,0.49214274923943446
85724,0.43859649122807015,0.6031746031746031,128,-152,0.4202758357883012,0.5797241642116988,away,CLE,over,8.5,0.5238095238095238,-110,0.4988662131519274,DET,CLE,2022 REG,7,3,8,4,7,15,0,1,-1,1,1,1,1,0,0,0,0,0,0,0.4988662131519274,0.5011337868480725
85724,0.43859649122807015,0.6031746031746031,128,-152,0.4202758357883012,0.5797241642116988,home,DET,under,8.5,0.5238095238095238,-110,0.5011337868480725,DET,CLE,2022 REG,7,3,8,4,7,15,0,1,-1,1,1,1,1,0,0,0,0,0,0,0.4988662131519274,0.5011337868480725
85726,0.6875,0.36363636363636365,-220,175,0.6523437499999999,0.3476562500000001,away,OAK,over,7.5,0.5238095238095238,-110,0.49651307063705985,MIN,OAK,2022 REG,5,1,3,0,1,8,1,0,1,-1,0,0,0,0,0,0,0,0,0,0.49651307063705985,0.5034869293629401
85726,0.6875,0.36363636363636365,-220,175,0.6523437499999999,0.3476562500000001,home,MIN,under,7.5,0.5283018867924528,-112,0.5034869293629401,MIN,OAK,2022 REG,5,1,3,0,1,8,1,0,1,-1,0,0,0,0,0,0,0,0,0,0.49651307063705985,0.5034869293629401
85729,0.5726495726495727,0.46511627906976744,-134,115,0.5510229738017454,0.44897702619825464,away,HOU,over,6,0.5348837209302326,-115,0.5097020142727117,TB,HOU,2022 REG,3,0,8,5,5,11,0,1,-5,5,0,0,0,0,0,0,0,0,0,0.5097020142727117,0.49029798572728833
85729,0.5726495726495727,0.46511627906976744,-134,115,0.5510229738017454,0.44897702619825464,home,TB,under,6,0.5121951219512195,-105,0.49029798572728833,TB,HOU,2022 REG,3,0,8,5,5,11,0,1,-5,5,0,0,0,0,0,0,0,0,0,0.5097020142727117,0.49029798572728833
85731,0.7222222222222222,0.3125,-260,220,0.697145061728395,0.30285493827160503,away,CIN,over,8.5,0.5370370370370371,-116,0.5118817074154765,STL,CIN,2022 REG,9,5,8,1,6,17,1,0,4,-4,1,0,0,0,0,0,0,0,0,0.5118817074154765,0.48811829258452355
85731,0.7222222222222222,0.3125,-260,220,0.697145061728395,0.30285493827160503,home,STL,under,8.5,0.5098039215686274,-104,0.48811829258452355,STL,CIN,2022 REG,9,5,8,1,6,17,1,0,4,-4,1,0,0,0,0,0,0,0,0,0.5118817074154765,0.48811829258452355
85733,0.425531914893617,0.607843137254902,135,-155,0.4113297650431834,0.5886702349568166,away,BOS,over,10.5,0.5145631067961165,-106,0.4913668392989033,CIN,BOS,2022 REG,8,5,6,1,6,14,1,0,4,-4,1,0,0,0,0,0,0,0,0,0.4913668392989033,0.5086331607010968
85733,0.425531914893617,0.607843137254902,135,-155,0.4113297650431834,0.5886702349568166,home,CIN,under,10.5,0.5305164319248826,-113,0.5086331607010968,CIN,BOS,2022 REG,8,5,6,1,6,14,1,0,4,-4,1,0,0,0,0,0,0,0,0,0.4913668392989033,0.5086331607010968
85735,0.3125,0.726027397260274,220,-265,0.3004601883561644,0.6995398116438356,away,LAD,over,9,0.5238095238095238,-110,0.5000596729920038,KC,LAD,2022 REG,4,3,8,8,11,12,0,1,-5,5,1,1,1,0,0,0,0,0,0,0.5000596729920038,0.4999403270079962
85735,0.3125,0.726027397260274,220,-265,0.3004601883561644,0.6995398116438356,home,KC,under,9,0.5215311004784688,-109,0.4999403270079962,KC,LAD,2022 REG,4,3,8,8,11,12,0,1,-5,5,1,1,1,0,0,0,0,0,0,0.5000596729920038,0.4999403270079962
85736,0.6031746031746031,0.4347826086956522,-152,130,0.5802797769671475,0.4197202230328525,away,DET,over,8.5,0.5348837209302326,-115,0.5109810284308424,ARI,DET,2022 REG,5,3,8,6,9,13,0,1,-3,3,1,1,1,0,0,0,0,0,0,0.5109810284308424,0.48901897156915763
85736,0.6031746031746031,0.4347826086956522,-152,130,0.5802797769671475,0.4197202230328525,home,ARI,under,8.5,0.5098039215686274,-104,0.48901897156915763,ARI,DET,2022 REG,5,3,8,6,9,13,0,1,-3,3,1,1,1,0,0,0,0,0,0,0.5109810284308424,0.48901897156915763
85737,0.5215311004784688,0.5145631067961165,-109,-106,0.5027068488376564,0.4972931511623436,away,SF,over,8,0.5215311004784688,-109,0.4978845547971712,STL,SF,2022 REG,9,4,8,0,4,17,1,0,4,-4,0,0,0,0,0,0,0,0,0,0.4978845547971712,0.5021154452028288
85737,0.5215311004784688,0.5145631067961165,-109,-106,0.5027068488376564,0.4972931511623436,home,STL,under,8,0.5238095238095238,-110,0.5021154452028288,STL,SF,2022 REG,9,4,8,0,4,17,1,0,4,-4,0,0,0,0,0,0,0,0,0,0.4978845547971712,0.5021154452028288
85739,0.5833333333333333,0.45454545454545453,-140,120,0.5612373737373737,0.4387626262626263,away,TEX,over,8,0.5238095238095238,-110,0.4988662131519274,MIN,TEX,2022 REG,5,2,4,1,3,9,1,0,1,-1,1,0,0,0,0,0,0,0,0,0.4988662131519274,0.5011337868480725
85739,0.5833333333333333,0.45454545454545453,-140,120,0.5612373737373737,0.4387626262626263,home,MIN,under,8,0.5238095238095238,-110,0.5011337868480725,MIN,TEX,2022 REG,5,2,4,1,3,9,1,0,1,-1,1,0,0,0,0,0,0,0,0,0.4988662131519274,0.5011337868480725
85742,0.7142857142857143,0.3225806451612903,-250,210,0.6879526003949967,0.3120473996050033,away,DET,over,8.5,0.5169082125603864,-107,0.49239402434819424,LAD,DET,2022 REG,6,5,6,1,6,12,1,0,4,-4,1,0,0,0,0,0,0,0,0,0.49239402434819424,0.5076059756518058
85742,0.7142857142857143,0.3225806451612903,-250,210,0.6879526003949967,0.3120473996050033,home,LAD,under,8.5,0.5305164319248826,-113,0.5076059756518058,LAD,DET,2022 REG,6,5,6,1,6,12,1,0,4,-4,1,0,0,0,0,0,0,0,0,0.49239402434819424,0.5076059756518058
85743,0.4,0.6389891696750902,150,-177,0.3844043321299639,0.6155956678700361,away,HOU,over,8,0.5348837209302326,-115,0.5109810284308424,OAK,HOU,2022 REG,5,1,9,6,7,14,0,1,-5,5,1,0,0,0,0,0,0,0,0,0.5109810284308424,0.48901897156915763
85743,0.4,0.6389891696750902,150,-177,0.3844043321299639,0.6155956678700361,home,OAK,under,8,0.5098039215686274,-104,0.48901897156915763,OAK,HOU,2022 REG,5,1,9,6,7,14,0,1,-5,5,1,0,0,0,0,0,0,0,0,0.5109810284308424,0.48901897156915763
85744,0.635036496350365,0.4081632653061224,-174,145,0.6076030710648583,0.39239692893514166,away,LAA,over,7,0.5495495495495495,-122,0.5250401592387142,TB,LAA,2022 REG,14,11,7,1,12,21,1,0,10,-10,1,0,0,0,0,0,0,0,0,0.5250401592387142,0.47495984076128583
85744,0.635036496350365,0.4081632653061224,-174,145,0.6076030710648583,0.39239692893514166,home,TB,under,7,0.49504950495049505,102,0.47495984076128583,TB,LAA,2022 REG,14,11,7,1,12,21,1,0,10,-10,1,0,0,0,0,0,0,0,0,0.5250401592387142,0.47495984076128583
85747,0.5,0.5454545454545454,100,-120,0.4772727272727273,0.5227272727272727,away,ARI,over,6.5,0.5475113122171946,-121,0.5214983313199976,MIL,ARI,2022 REG,8,3,1,0,3,9,1,0,3,-3,0,0,0,0,0,0,0,0,0,0.5214983313199976,0.47850166868000243
85747,0.5,0.5454545454545454,100,-120,0.4772727272727273,0.5227272727272727,home,MIL,under,6.5,0.5,100,0.47850166868000243,MIL,ARI,2022 REG,8,3,1,0,3,9,1,0,3,-3,0,0,0,0,0,0,0,0,0,0.5214983313199976,0.47850166868000243
85748,0.5884773662551441,0.45454545454545453,-143,120,0.5631594099815408,0.4368405900184592,away,CLE,over,7.5,0.49751243781094534,101,0.476135829221149,DET,CLE,2022 REG,9,4,8,3,7,17,1,0,1,-1,1,1,1,0,0,0,0,0,0,0.476135829221149,0.523864170778851
85748,0.5884773662551441,0.45454545454545453,-143,120,0.5631594099815408,0.4368405900184592,home,DET,under,7.5,0.5454545454545454,-120,0.523864170778851,DET,CLE,2022 REG,9,4,8,3,7,17,1,0,1,-1,1,1,1,0,0,0,0,0,0,0.476135829221149,0.523864170778851
85749,0.4166666666666667,0.613899613899614,140,-159,0.4039307164307164,0.5960692835692836,away,HOU,over,9,0.5121951219512195,-105,0.48808156828023186,TEX,HOU,2022 REG,11,5,7,3,8,18,1,0,2,-2,1,1,1,0,0,0,0,0,0,0.48808156828023186,0.5119184317197681
85749,0.4166666666666667,0.613899613899614,140,-159,0.4039307164307164,0.5960692835692836,home,TEX,under,9,0.5348837209302326,-115,0.5119184317197681,TEX,HOU,2022 REG,11,5,7,3,8,18,1,0,2,-2,1,1,1,0,0,0,0,0,0,0.48808156828023186,0.5119184317197681
85751,0.6363636363636364,0.40322580645161293,-175,148,0.6111703545721141,0.3888296454278859,away,TEX,over,9,0.5412844036697247,-118,0.5149381613977361,BOS,TEX,2022 REG,13,9,13,8,17,26,1,0,1,-1,1,1,1,1,1,1,1,1,0,0.5149381613977361,0.48506183860226393
85751,0.6363636363636364,0.40322580645161293,-175,148,0.6111703545721141,0.3888296454278859,home,BOS,under,9,0.5073891625615764,-103,0.48506183860226393,BOS,TEX,2022 REG,13,9,13,8,17,26,1,0,1,-1,1,1,1,1,1,1,1,1,0,0.5149381613977361,0.48506183860226393
85752,0.5633187772925764,0.47619047619047616,-129,110,0.5410624729287608,0.45893752707123925,away,MIN,over,8,0.5433789954337899,-119,0.5198077604720502,TEX,MIN,2022 REG,12,9,9,7,16,21,1,0,2,-2,1,1,1,1,1,1,1,0,0,0.5198077604720502,0.48019223952794976
85752,0.5633187772925764,0.47619047619047616,-129,110,0.5410624729287608,0.45893752707123925,home,TEX,under,8,0.5,100,0.48019223952794976,TEX,MIN,2022 REG,12,9,9,7,16,21,1,0,2,-2,1,1,1,1,1,1,1,0,0,0.5198077604720502,0.48019223952794976
85754,0.7333333333333333,0.3076923076923077,-275,225,0.7032478632478633,0.29675213675213674,away,PIT,over,7.5,0.49504950495049505,102,0.47297076509898783,NYM,PIT,2022 REG,10,7,4,1,8,14,1,0,6,-6,1,0,0,0,0,0,0,0,0,0.47297076509898783,0.5270292349010122
85754,0.7333333333333333,0.3076923076923077,-275,225,0.7032478632478633,0.29675213675213674,home,NYM,under,7.5,0.5495495495495495,-122,0.5270292349010122,NYM,PIT,2022 REG,10,7,4,1,8,14,1,0,6,-6,1,0,0,0,0,0,0,0,0,0.47297076509898783,0.5270292349010122
85755,0.36363636363636365,0.6774193548387096,175,-210,0.3487070114636097,0.6512929885363903,away,NYY,over,9.5,0.5192307692307692,-108,0.49688292476754015,BAL,NYY,2022 REG,6,2,7,1,3,13,1,0,1,-1,1,0,0,0,0,0,0,0,0,0.49688292476754015,0.5031170752324599
85755,0.36363636363636365,0.6774193548387096,175,-210,0.3487070114636097,0.6512929885363903,home,BAL,under,9.5,0.5238095238095238,-110,0.5031170752324599,BAL,NYY,2022 REG,6,2,7,1,3,13,1,0,1,-1,1,0,0,0,0,0,0,0,0,0.49688292476754015,0.5031170752324599
85756,0.7142857142857143,0.3225806451612903,-250,210,0.6879526003949967,0.3120473996050033,away,COL,over,7.5,0.5238095238095238,-110,0.4988662131519274,STL,COL,2022 REG,15,13,4,0,13,19,1,0,13,-13,0,0,0,0,0,0,0,0,0,0.4988662131519274,0.5011337868480725
85756,0.7142857142857143,0.3225806451612903,-250,210,0.6879526003949967,0.3120473996050033,home,STL,under,7.5,0.5238095238095238,-110,0.5011337868480725,STL,COL,2022 REG,15,13,4,0,13,19,1,0,13,-13,0,0,0,0,0,0,0,0,0,0.4988662131519274,0.5011337868480725
85757,0.7058823529411764,0.3333333333333333,-240,200,0.6782006920415226,0.32179930795847744,away,BAL,over,8,0.5412844036697247,-118,0.5162581740877563,NYY,BAL,2022 REG,12,10,14,5,15,26,1,0,5,-5,1,1,1,1,1,0,0,0,0,0.5162581740877563,0.4837418259122437
85757,0.7058823529411764,0.3333333333333333,-240,200,0.6782006920415226,0.32179930795847744,home,NYY,under,8,0.504950495049505,-102,0.4837418259122437,NYY,BAL,2022 REG,12,10,14,5,15,26,1,0,5,-5,1,1,1,1,1,0,0,0,0,0.5162581740877563,0.4837418259122437
85758,0.7058823529411764,0.3278688524590164,-240,205,0.6820579726586873,0.3179420273413127,away,BOS,over,7.5,0.49019607843137253,104,0.4697227523736127,NYY,BOS,2022 REG,8,5,7,4,9,15,1,0,1,-1,1,1,1,1,0,0,0,0,0,0.4697227523736127,0.5302772476263873
85758,0.7058823529411764,0.3278688524590164,-240,205,0.6820579726586873,0.3179420273413127,home,NYY,under,7.5,0.5515695067264574,-123,0.5302772476263873,NYY,BOS,2022 REG,8,5,7,4,9,15,1,0,1,-1,1,1,1,1,0,0,0,0,0,0.4697227523736127,0.5302772476263873
85760,0.6825396825396826,0.35714285714285715,-215,180,0.6554547745023935,0.34454522549760647,away,BOS,over,8,0.5305164319248826,-113,0.5066009958897986,HOU,BOS,2022 REG,9,1,5,2,3,14,0,1,-1,1,1,0,0,0,0,0,0,0,0,0.5066009958897986,0.49339900411020143
85760,0.6825396825396826,0.35714285714285715,-215,180,0.6554547745023935,0.34454522549760647,home,HOU,under,8,0.5145631067961165,-106,0.49339900411020143,HOU,BOS,2022 REG,9,1,5,2,3,14,0,1,-1,1,1,0,0,0,0,0,0,0,0,0.5066009958897986,0.49339900411020143
85761,0.5348837209302326,0.5098039215686274,-115,-104,0.5109810284308424,0.48901897156915763,away,ATL,over,7.5,0.5348837209302326,-115,0.5097020142727117,SD,ATL,2022 REG,16,12,6,1,13,22,1,0,11,-11,1,0,0,0,0,0,0,0,0,0.5097020142727117,0.49029798572728833
85761,0.5348837209302326,0.5098039215686274,-115,-104,0.5109810284308424,0.48901897156915763,home,SD,under,7.5,0.5121951219512195,-105,0.49029798572728833,SD,ATL,2022 REG,16,12,6,1,13,22,1,0,11,-11,1,0,0,0,0,0,0,0,0,0.5097020142727117,0.49029798572728833
85762,0.7354497354497355,0.3076923076923077,-278,225,0.7037209312341587,0.2962790687658413,away,WSH,over,7,0.5454545454545454,-120,0.5206611570247933,NYM,WSH,2022 REG,12,8,9,0,8,21,1,0,8,-8,0,0,0,0,0,0,0,0,0,0.5206611570247933,0.4793388429752067
85762,0.7354497354497355,0.3076923076923077,-278,225,0.7037209312341587,0.2962790687658413,home,NYM,under,7,0.5,100,0.4793388429752067,NYM,WSH,2022 REG,12,8,9,0,8,21,1,0,8,-8,0,0,0,0,0,0,0,0,0,0.5206611570247933,0.4793388429752067
85763,0.5238095238095238,0.5238095238095238,-110,-110,0.4988662131519274,0.5011337868480725,away,COL,over,8.5,0.5238095238095238,-110,0.5000596729920038,ARI,COL,2022 REG,6,1,8,4,5,14,0,1,-3,3,1,0,0,0,0,0,0,0,0,0.5000596729920038,0.4999403270079962
85763,0.5238095238095238,0.5238095238095238,-110,-110,0.4988662131519274,0.5011337868480725,home,ARI,under,8.5,0.5215311004784688,-109,0.4999403270079962,ARI,COL,2022 REG,6,1,8,4,5,14,0,1,-3,3,1,0,0,0,0,0,0,0,0,0.5000596729920038,0.4999403270079962
85765,0.6031746031746031,0.4347826086956522,-152,130,0.5802797769671475,0.4197202230328525,away,ATL,over,8,0.5121951219512195,-105,0.48808156828023186,LAD,ATL,2022 REG,2,1,12,3,4,14,0,1,-2,2,1,0,0,0,0,0,0,0,0,0.48808156828023186,0.5119184317197681
85765,0.6031746031746031,0.4347826086956522,-152,130,0.5802797769671475,0.4197202230328525,home,LAD,under,8,0.5348837209302326,-115,0.5119184317197681,LAD,ATL,2022 REG,2,1,12,3,4,14,0,1,-2,2,1,0,0,0,0,0,0,0,0,0.48808156828023186,0.5119184317197681
85767,0.613899613899614,0.425531914893617,-159,135,0.589692613597978,0.410307386402022,away,LAD,over,8.5,0.5454545454545454,-120,0.5206611570247933,ATL,LAD,2022 REG,9,5,9,3,8,18,1,0,2,-2,1,1,1,0,0,0,0,0,0,0.5206611570247933,0.4793388429752067
85767,0.613899613899614,0.425531914893617,-159,135,0.589692613597978,0.410307386402022,home,ATL,under,8.5,0.5,100,0.4793388429752067,ATL,LAD,2022 REG,9,5,9,3,8,18,1,0,2,-2,1,1,1,0,0,0,0,0,0,0.5206611570247933,0.4793388429752067
85768,0.6551724137931035,0.3846153846153846,-190,160,0.6291045458703008,0.37089545412969915,away,KC,over,8,0.5073891625615764,-103,0.4826927225525911,MIN,KC,2022 REG,12,2,6,3,5,18,0,1,-1,1,1,1,0,0,0,0,0,0,0,0.4826927225525911,0.5173072774474089
85768,0.6551724137931035,0.3846153846153846,-190,160,0.6291045458703008,0.37089545412969915,home,MIN,under,8,0.5412844036697247,-118,0.5173072774474089,MIN,KC,2022 REG,12,2,6,3,5,18,0,1,-1,1,1,1,0,0,0,0,0,0,0,0.4826927225525911,0.5173072774474089
85769,0.6666666666666666,0.37037037037037035,-200,170,0.6419753086419753,0.3580246913580247,away,KC,over,8.5,0.5433789954337899,-119,0.5198077604720502,MIN,KC,2022 REG,11,7,7,3,10,18,1,0,4,-4,1,1,1,0,0,0,0,0,0,0.5198077604720502,0.48019223952794976
85769,0.6666666666666666,0.37037037037037035,-200,170,0.6419753086419753,0.3580246913580247,home,MIN,under,8.5,0.5,100,0.48019223952794976,MIN,KC,2022 REG,11,7,7,3,10,18,1,0,4,-4,1,1,1,0,0,0,0,0,0,0.5198077604720502,0.48019223952794976
85770,0.6254681647940076,0.4132231404958678,-167,142,0.6012679850808645,0.39873201491913546,away,TB,over,7,0.5192307692307692,-108,0.49571111079951763,NYY,TB,2022 REG,4,1,4,3,4,8,0,1,-2,2,1,0,0,0,0,0,0,0,0,0.49571111079951763,0.5042888892004824
85770,0.6254681647940076,0.4132231404958678,-167,142,0.6012679850808645,0.39873201491913546,home,NYY,under,7,0.5260663507109005,-111,0.5042888892004824,NYY,TB,2022 REG,4,1,4,3,4,8,0,1,-2,2,1,0,0,0,0,0,0,0,0,0.49571111079951763,0.5042888892004824
85772,0.4716981132075471,0.5689655172413793,112,-132,0.45251715544861953,0.5474828445513804,away,CLE,over,9,0.5,100,0.4762443438914027,MIN,CLE,2022 REG,10,2,7,3,5,17,0,1,-1,1,1,1,0,0,0,0,0,0,0,0.4762443438914027,0.5237556561085973
85772,0.4716981132075471,0.5689655172413793,112,-132,0.45251715544861953,0.5474828445513804,home,MIN,under,9,0.5475113122171946,-121,0.5237556561085973,MIN,CLE,2022 REG,10,2,7,3,5,17,0,1,-1,1,1,1,0,0,0,0,0,0,0,0.4762443438914027,0.5237556561085973
85773,0.6491228070175439,0.3968253968253968,-185,152,0.6192967799615999,0.38070322003840007,away,DET,over,7,0.5495495495495495,-122,0.5236866555946829,CWS,DET,2022 REG,8,3,9,5,8,17,0,1,-2,2,1,1,1,0,0,0,0,0,0,0.5236866555946829,0.47631334440531714
85773,0.6491228070175439,0.3968253968253968,-185,152,0.6192967799615999,0.38070322003840007,home,CWS,under,7,0.49751243781094534,101,0.47631334440531714,CWS,DET,2022 REG,8,3,9,5,8,17,0,1,-2,2,1,1,1,0,0,0,0,0,0,0.5236866555946829,0.47631334440531714
85774,0.5726495726495727,0.4716981132075471,-134,112,0.5472538892954956,0.45274611070450443,away,NYY,over,8,0.5169082125603864,-107,0.49239402434819424,TOR,NYY,2022 REG,8,1,10,9,10,18,0,1,-8,8,1,0,0,0,0,0,0,0,0,0.49239402434819424,0.5076059756518058
85774,0.5726495726495727,0.4716981132075471,-134,112,0.5472538892954956,0.45274611070450443,home,TOR,under,8,0.5305164319248826,-113,0.5076059756518058,TOR,NYY,2022 REG,8,1,10,9,10,18,0,1,-8,8,1,0,0,0,0,0,0,0,0,0.49239402434819424,0.5076059756518058
85777,0.6000000000000001,0.4444444444444444,-150,125,0.5733333333333334,0.42666666666666664,away,CHC,over,8.5,0.5475113122171946,-121,0.5214983313199976,MIL,CHC,2022 REG,5,5,6,2,7,11,1,0,3,-3,1,1,0,0,0,0,0,0,0,0.5214983313199976,0.47850166868000243
85777,0.6000000000000001,0.4444444444444444,-150,125,0.5733333333333334,0.42666666666666664,home,MIL,under,8.5,0.5,100,0.47850166868000243,MIL,CHC,2022 REG,5,5,6,2,7,11,1,0,3,-3,1,1,0,0,0,0,0,0,0,0.5214983313199976,0.47850166868000243
85778,0.25641025641025644,0.7849462365591398,290,-365,0.2458060274437446,0.7541939725562554,away,NYM,over,8,0.5412844036697247,-118,0.5149381613977361,WSH,NYM,2022 REG,8,5,6,1,6,14,1,0,4,-4,1,0,0,0,0,0,0,0,0,0.5149381613977361,0.48506183860226393
85778,0.25641025641025644,0.7849462365591398,290,-365,0.2458060274437446,0.7541939725562554,home,WSH,under,8,0.5073891625615764,-103,0.48506183860226393,WSH,NYM,2022 REG,8,5,6,1,6,14,1,0,4,-4,1,0,0,0,0,0,0,0,0,0.5149381613977361,0.48506183860226393
85779,0.7222222222222222,0.3225806451612903,-260,210,0.6898645957785743,0.3101354042214257,away,MIA,over,7,0.5145631067961165,-106,0.4913668392989033,ATL,MIA,2022 REG,9,7,3,1,8,12,1,0,6,-6,1,0,0,0,0,0,0,0,0,0.4913668392989033,0.5086331607010968
85779,0.7222222222222222,0.3225806451612903,-260,210,0.6898645957785743,0.3101354042214257,home,ATL,under,7,0.5305164319248826,-113,0.5086331607010968,ATL,MIA,2022 REG,9,7,3,1,8,12,1,0,6,-6,1,0,0,0,0,0,0,0,0,0.4913668392989033,0.5086331607010968
85780,0.6491228070175439,0.37735849056603776,-185,165,0.6319331927966224,0.3680668072033776,away,BAL,over,9.5,0.5391705069124424,-117,0.5140669063204599,BOS,BAL,2022 REG,15,12,7,2,14,22,1,0,10,-10,1,1,0,0,0,0,0,0,0,0.5140669063204599,0.4859330936795401
85780,0.6491228070175439,0.37735849056603776,-185,165,0.6319331927966224,0.3680668072033776,home,BOS,under,9.5,0.5073891625615764,-103,0.4859330936795401,BOS,BAL,2022 REG,15,12,7,2,14,22,1,0,10,-10,1,1,0,0,0,0,0,0,0,0.5140669063204599,0.4859330936795401
85781,0.5192307692307692,0.5169082125603864,-108,-107,0.5004662979161306,0.4995337020838694,away,CLE,over,8.5,0.5238095238095238,-110,0.5000596729920038,KC,CLE,2022 REG,9,7,13,10,17,22,0,1,-3,3,1,1,1,1,1,1,1,0,0,0.5000596729920038,0.4999403270079962
85781,0.5192307692307692,0.5169082125603864,-108,-107,0.5004662979161306,0.4995337020838694,home,KC,under,8.5,0.5215311004784688,-109,0.4999403270079962,KC,CLE,2022 REG,9,7,13,10,17,22,0,1,-3,3,1,1,1,1,1,1,1,0,0,0.5000596729920038,0.4999403270079962
85782,0.49504950495049505,0.5412844036697247,102,-118,0.47706242147513866,0.5229375785248613,away,STL,over,7,0.5535714285714286,-124,0.5293429871948779,KC,STL,2022 REG,15,7,6,1,8,21,1,0,6,-6,1,0,0,0,0,0,0,0,0,0.5293429871948779,0.47065701280512207
85782,0.49504950495049505,0.5412844036697247,102,-118,0.47706242147513866,0.5229375785248613,home,KC,under,7,0.49019607843137253,104,0.47065701280512207,KC,STL,2022 REG,15,7,6,1,8,21,1,0,6,-6,1,0,0,0,0,0,0,0,0,0.5293429871948779,0.47065701280512207
85783,0.35714285714285715,0.6825396825396826,180,-215,0.34297052154195007,0.6570294784580499,away,LAD,over,8.5,0.5348837209302326,-115,0.5097020142727117,LAA,LAD,2022 REG,7,1,7,7,8,14,0,1,-6,6,1,0,0,0,0,0,0,0,0,0.5097020142727117,0.49029798572728833
85783,0.35714285714285715,0.6825396825396826,180,-215,0.34297052154195007,0.6570294784580499,home,LAA,under,8.5,0.5121951219512195,-105,0.49029798572728833,LAA,LAD,2022 REG,7,1,7,7,8,14,0,1,-6,6,1,0,0,0,0,0,0,0,0,0.5097020142727117,0.49029798572728833
85785,0.8198198198198198,0.2173913043478261,-455,360,0.7893134027094074,0.21068659729059258,away,PIT,over,6.5,0.5535714285714286,-124,0.5239158163265306,NYM,PIT,2022 REG,12,7,5,3,10,17,1,0,4,-4,1,1,1,0,0,0,0,0,0,0.5239158163265306,0.4760841836734694
85785,0.8198198198198198,0.2173913043478261,-455,360,0.7893134027094074,0.21068659729059258,home,NYM,under,6.5,0.5,100,0.4760841836734694,NYM,PIT,2022 REG,12,7,5,3,10,17,1,0,4,-4,1,1,1,0,0,0,0,0,0,0.5239158163265306,0.4760841836734694
85787,0.6666666666666666,0.37735849056603776,-200,165,0.6373165618448637,0.36268343815513626,away,CLE,over,7.5,0.5145631067961165,-106,0.4913668392989033,LAA,CLE,2022 REG,14,9,11,5,14,25,1,0,4,-4,1,1,1,1,1,0,0,0,0,0.4913668392989033,0.5086331607010968
85787,0.6666666666666666,0.37735849056603776,-200,165,0.6373165618448637,0.36268343815513626,home,LAA,under,7.5,0.5305164319248826,-113,0.5086331607010968,LAA,CLE,2022 REG,14,9,11,5,14,25,1,0,4,-4,1,1,1,1,1,0,0,0,0,0.4913668392989033,0.5086331607010968
85788,0.4854368932038835,0.5535714285714286,106,-124,0.4665008146721786,0.5334991853278215,away,TEX,over,8,0.5169082125603864,-107,0.49353874091423283,OAK,TEX,2022 REG,5,2,4,0,2,9,1,0,2,-2,0,0,0,0,0,0,0,0,0,0.49353874091423283,0.5064612590857671
85788,0.4854368932038835,0.5535714285714286,106,-124,0.4665008146721786,0.5334991853278215,home,OAK,under,8,0.5283018867924528,-112,0.5064612590857671,OAK,TEX,2022 REG,5,2,4,0,2,9,1,0,2,-2,0,0,0,0,0,0,0,0,0,0.49353874091423283,0.5064612590857671
85789,0.6363636363636364,0.4,-175,150,0.6132231404958678,0.3867768595041322,away,TEX,over,9,0.5412844036697247,-118,0.5162581740877563,TOR,TEX,2022 REG,9,10,8,8,18,17,1,0,2,-2,1,1,1,1,1,1,1,1,0,0.5162581740877563,0.4837418259122437
85789,0.6363636363636364,0.4,-175,150,0.6132231404958678,0.3867768595041322,home,TOR,under,9,0.504950495049505,-102,0.4837418259122437,TOR,TEX,2022 REG,9,10,8,8,18,17,1,0,2,-2,1,1,1,1,1,1,1,1,0,0.5162581740877563,0.4837418259122437
85790,0.37735849056603776,0.6644295302013422,165,-198,0.36158942612551703,0.638410573874483,away,LAD,over,11,0.5348837209302326,-115,0.5097020142727117,COL,LAD,2022 REG,8,3,12,7,10,20,0,1,-4,4,1,1,1,0,0,0,0,0,0,0.5097020142727117,0.49029798572728833
85790,0.37735849056603776,0.6644295302013422,165,-198,0.36158942612551703,0.638410573874483,home,COL,under,11,0.5121951219512195,-105,0.49029798572728833,COL,LAD,2022 REG,8,3,12,7,10,20,0,1,-4,4,1,1,1,0,0,0,0,0,0,0.5097020142727117,0.49029798572728833
85792,0.5098039215686274,0.5283018867924528,-104,-112,0.4903774310316062,0.5096225689683938,away,TB,over,7,0.5073891625615764,-103,0.4826927225525911,NYY,TB,2022 REG,9,2,11,4,6,20,0,1,-2,2,1,1,0,0,0,0,0,0,0,0.4826927225525911,0.5173072774474089
85792,0.5098039215686274,0.5283018867924528,-104,-112,0.4903774310316062,0.5096225689683938,home,NYY,under,7,0.5412844036697247,-118,0.5173072774474089,NYY,TB,2022 REG,9,2,11,4,6,20,0,1,-2,2,1,1,0,0,0,0,0,0,0,0.4826927225525911,0.5173072774474089
85793,0.5884773662551441,0.45454545454545453,-143,120,0.5631594099815408,0.4368405900184592,away,KC,over,8.5,0.5238095238095238,-110,0.5000596729920038,BOS,KC,2022 REG,6,0,15,9,9,21,0,1,-9,9,0,0,0,0,0,0,0,0,0,0.5000596729920038,0.4999403270079962
85793,0.5884773662551441,0.45454545454545453,-143,120,0.5631594099815408,0.4368405900184592,home,BOS,under,8.5,0.5215311004784688,-109,0.4999403270079962,BOS,KC,2022 REG,6,0,15,9,9,21,0,1,-9,9,0,0,0,0,0,0,0,0,0,0.5000596729920038,0.4999403270079962
85794,0.7142857142857143,0.3225806451612903,-250,210,0.6879526003949967,0.3120473996050033,away,CIN,over,7.5,0.5192307692307692,-108,0.49455035168025013,MIL,CIN,2022 REG,17,18,7,4,22,24,1,0,14,-14,1,1,1,1,0,0,0,0,0,0.49455035168025013,0.5054496483197499
85794,0.7142857142857143,0.3225806451612903,-250,210,0.6879526003949967,0.3120473996050033,home,MIL,under,7.5,0.5283018867924528,-112,0.5054496483197499,MIL,CIN,2022 REG,17,18,7,4,22,24,1,0,14,-14,1,1,1,1,0,0,0,0,0,0.49455035168025013,0.5054496483197499
85795,0.5454545454545454,0.49504950495049505,-120,102,0.5233614270517961,0.4766385729482039,away,SEA,over,7,0.5169082125603864,-107,0.49353874091423283,TB,SEA,2022 REG,9,4,10,8,12,19,0,1,-4,4,1,1,1,1,0,0,0,0,0,0.49353874091423283,0.5064612590857671
85795,0.5454545454545454,0.49504950495049505,-120,102,0.5233614270517961,0.4766385729482039,home,TB,under,7,0.5283018867924528,-112,0.5064612590857671,TB,SEA,2022 REG,9,4,10,8,12,19,0,1,-4,4,1,1,1,1,0,0,0,0,0,0.49353874091423283,0.5064612590857671
85797,0.45454545454545453,0.5815899581589958,120,-139,0.43812026695252254,0.5618797330474774,away,STL,over,7.5,0.5454545454545454,-120,0.5206611570247933,KC,STL,2022 REG,4,0,8,10,10,12,0,1,-10,10,0,0,0,0,0,0,0,0,0,0.5206611570247933,0.4793388429752067
85797,0.45454545454545453,0.5815899581589958,120,-139,0.43812026695252254,0.5618797330474774,home,KC,under,7.5,0.5,100,0.4793388429752067,KC,STL,2022 REG,4,0,8,10,10,12,0,1,-10,10,0,0,0,0,0,0,0,0,0,0.5206611570247933,0.4793388429752067
85798,0.5555555555555556,0.4854368932038835,-125,106,0.5327819729114227,0.4672180270885773,away,LAD,over,8.5,0.5305164319248826,-113,0.5066009958897986,PHI,LAD,2022 REG,6,4,13,7,11,19,0,1,-3,3,1,1,1,1,0,0,0,0,0,0.5066009958897986,0.49339900411020143
85798,0.5555555555555556,0.4854368932038835,-125,106,0.5327819729114227,0.4672180270885773,home,PHI,under,8.5,0.5145631067961165,-106,0.49339900411020143,PHI,LAD,2022 REG,6,4,13,7,11,19,0,1,-3,3,1,1,1,1,0,0,0,0,0,0.5066009958897986,0.49339900411020143
85800,0.5391705069124424,0.5,-117,100,0.5180509248444435,0.4819490751555565,away,PHI,over,8.5,0.5169082125603864,-107,0.49353874091423283,STL,PHI,2022 REG,8,4,11,3,7,19,1,0,1,-1,1,1,1,0,0,0,0,0,0,0.49353874091423283,0.5064612590857671
85800,0.5391705069124424,0.5,-117,100,0.5180509248444435,0.4819490751555565,home,STL,under,8.5,0.5283018867924528,-112,0.5064612590857671,STL,PHI,2022 REG,8,4,11,3,7,19,1,0,1,-1,1,1,1,0,0,0,0,0,0,0.49353874091423283,0.5064612590857671
85801,0.47619047619047616,0.5652173913043479,110,-130,0.4564724440500838,0.5435275559499162,away,NYY,over,9,0.5,100,0.4772727272727273,BOS,NYY,2022 REG,7,3,10,5,8,17,0,1,-2,2,1,1,1,0,0,0,0,0,0,0.4772727272727273,0.5227272727272727
85801,0.47619047619047616,0.5652173913043479,110,-130,0.4564724440500838,0.5435275559499162,home,BOS,under,9,0.5454545454545454,-120,0.5227272727272727,BOS,NYY,2022 REG,7,3,10,5,8,17,0,1,-2,2,1,1,1,0,0,0,0,0,0,0.4772727272727273,0.5227272727272727
85803,0.613899613899614,0.42016806722689076,-159,138,0.5929854776095975,0.4070145223904025,away,WSH,over,9,0.5391705069124424,-117,0.5153817639191344,ARI,WSH,2022 REG,10,7,4,2,9,14,1,0,5,-5,1,1,0,0,0,0,0,0,0,0.5153817639191344,0.4846182360808656
85803,0.613899613899614,0.42016806722689076,-159,138,0.5929854776095975,0.4070145223904025,home,ARI,under,9,0.504950495049505,-102,0.4846182360808656,ARI,WSH,2022 REG,10,7,4,2,9,14,1,0,5,-5,1,1,0,0,0,0,0,0,0,0.5153817639191344,0.4846182360808656
85804,0.6666666666666666,0.37037037037037035,-200,170,0.6419753086419753,0.3580246913580247,away,CHC,over,7,0.5098039215686274,-104,0.48483656587239576,MIL,CHC,2022 REG,3,0,5,2,2,8,0,1,-2,2,0,0,0,0,0,0,0,0,0,0.48483656587239576,0.5151634341276042
85804,0.6666666666666666,0.37037037037037035,-200,170,0.6419753086419753,0.3580246913580247,home,MIL,under,7,0.5391705069124424,-117,0.5151634341276042,MIL,CHC,2022 REG,3,0,5,2,2,8,0,1,-2,2,0,0,0,0,0,0,0,0,0,0.48483656587239576,0.5151634341276042
85805,0.6363636363636364,0.40322580645161293,-175,148,0.6111703545721141,0.3888296454278859,away,KC,over,8,0.5073891625615764,-103,0.4837652908580103,SF,KC,2022 REG,5,6,6,2,8,11,1,0,4,-4,1,1,0,0,0,0,0,0,0,0.4837652908580103,0.5162347091419897
85805,0.6363636363636364,0.40322580645161293,-175,148,0.6111703545721141,0.3888296454278859,home,SF,under,8,0.5391705069124424,-117,0.5162347091419897,SF,KC,2022 REG,5,6,6,2,8,11,1,0,4,-4,1,1,0,0,0,0,0,0,0,0.4837652908580103,0.5162347091419897
85806,0.5967741935483871,0.43859649122807015,-148,128,0.5756658816656627,0.4243341183343373,away,CLE,over,7,0.5495495495495495,-122,0.5263803278714742,SEA,CLE,2022 REG,4,4,5,0,4,9,1,0,4,-4,0,0,0,0,0,0,0,0,0,0.5263803278714742,0.47361967212852585
85806,0.5967741935483871,0.43859649122807015,-148,128,0.5756658816656627,0.4243341183343373,home,SEA,under,7,0.4926108374384236,103,0.47361967212852585,SEA,CLE,2022 REG,4,4,5,0,4,9,1,0,4,-4,0,0,0,0,0,0,0,0,0,0.5263803278714742,0.47361967212852585
85807,0.6240601503759399,0.4166666666666667,-166,140,0.5986441668079975,0.4013558331920025,away,TEX,over,8.5,0.5145631067961165,-106,0.4913668392989033,PHI,TEX,2022 REG,11,4,9,6,10,20,0,1,-2,2,1,1,1,1,0,0,0,0,0,0.4913668392989033,0.5086331607010968
85807,0.6240601503759399,0.4166666666666667,-166,140,0.5986441668079975,0.4013558331920025,home,PHI,under,8.5,0.5305164319248826,-113,0.5086331607010968,PHI,TEX,2022 REG,11,4,9,6,10,20,0,1,-2,2,1,1,1,1,0,0,0,0,0,0.4913668392989033,0.5086331607010968
85808,0.6000000000000001,0.4291845493562232,-150,133,0.5824892703862661,0.4175107296137339,away,STL,over,9.5,0.5098039215686274,-104,0.48375889301574193,LAD,STL,2022 REG,7,4,7,1,5,14,1,0,3,-3,1,0,0,0,0,0,0,0,0,0.48375889301574193,0.5162411069842581
85808,0.6000000000000001,0.4291845493562232,-150,133,0.5824892703862661,0.4175107296137339,home,LAD,under,9.5,0.5412844036697247,-118,0.5162411069842581,LAD,STL,2022 REG,7,4,7,1,5,14,1,0,3,-3,1,0,0,0,0,0,0,0,0,0.48375889301574193,0.5162411069842581
85810,0.4166666666666667,0.6240601503759399,140,-166,0.39969715956558066,0.6003028404344193,away,STL,over,9,0.5121951219512195,-105,0.48808156828023186,WSH,STL,2022 REG,8,2,6,6,8,14,0,1,-4,4,1,1,0,0,0,0,0,0,0,0.48808156828023186,0.5119184317197681
85810,0.4166666666666667,0.6240601503759399,140,-166,0.39969715956558066,0.6003028404344193,home,WSH,under,9,0.5348837209302326,-115,0.5119184317197681,WSH,STL,2022 REG,8,2,6,6,8,14,0,1,-4,4,1,1,0,0,0,0,0,0,0,0.48808156828023186,0.5119184317197681
85811,0.7938144329896907,0.24390243902439027,-385,310,0.7638742356176882,0.2361257643823118,away,KC,over,8.5,0.5073891625615764,-103,0.4837652908580103,NYY,KC,2022 REG,11,11,9,5,16,20,1,0,6,-6,1,1,1,1,1,0,0,0,0,0.4837652908580103,0.5162347091419897
85811,0.7938144329896907,0.24390243902439027,-385,310,0.7638742356176882,0.2361257643823118,home,NYY,under,8.5,0.5391705069124424,-117,0.5162347091419897,NYY,KC,2022 REG,11,11,9,5,16,20,1,0,6,-6,1,1,1,1,1,0,0,0,0,0.4837652908580103,0.5162347091419897
85812,0.36363636363636365,0.6721311475409836,175,-205,0.3506299959355101,0.6493700040644899,away,NYY,over,7.5,0.5348837209302326,-115,0.5097020142727117,TEX,NYY,2022 REG,6,3,5,2,5,11,1,0,1,-1,1,1,0,0,0,0,0,0,0,0.5097020142727117,0.49029798572728833
85812,0.36363636363636365,0.6721311475409836,175,-205,0.3506299959355101,0.6493700040644899,home,TEX,under,7.5,0.5121951219512195,-105,0.49029798572728833,TEX,NYY,2022 REG,6,3,5,2,5,11,1,0,1,-1,1,1,0,0,0,0,0,0,0,0.5097020142727117,0.49029798572728833
85813,0.48780487804878053,0.5495495495495495,105,-122,0.4695832060495952,0.5304167939504048,away,NYM,over,10.5,0.5215311004784688,-109,0.4978845547971712,COL,NYM,2022 REG,6,0,7,2,2,13,0,1,-2,2,0,0,0,0,0,0,0,0,0,0.4978845547971712,0.5021154452028288
85813,0.48780487804878053,0.5495495495495495,105,-122,0.4695832060495952,0.5304167939504048,home,COL,under,10.5,0.5238095238095238,-110,0.5021154452028288,COL,NYM,2022 REG,6,0,7,2,2,13,0,1,-2,2,0,0,0,0,0,0,0,0,0,0.4978845547971712,0.5021154452028288
85814,0.6923076923076923,0.3472222222222222,-225,188,0.6649408284023669,0.3350591715976331,away,DET,over,7.5,0.5145631067961165,-106,0.49023796582517226,CLE,DET,2022 REG,11,8,5,4,12,16,1,0,4,-4,1,1,1,1,0,0,0,0,0,0.49023796582517226,0.5097620341748277
85814,0.6923076923076923,0.3472222222222222,-225,188,0.6649408284023669,0.3350591715976331,home,CLE,under,7.5,0.5327102803738317,-114,0.5097620341748277,CLE,DET,2022 REG,11,8,5,4,12,16,1,0,4,-4,1,1,1,1,0,0,0,0,0,0.49023796582517226,0.5097620341748277
85815,0.4587155963302753,0.5815899581589958,118,-139,0.4402268098673069,0.5597731901326931,away,CHC,over,8,0.5121951219512195,-105,0.48808156828023186,WSH,CHC,2022 REG,8,5,7,4,9,15,1,0,1,-1,1,1,1,1,0,0,0,0,0,0.48808156828023186,0.5119184317197681
85815,0.4587155963302753,0.5815899581589958,118,-139,0.4402268098673069,0.5597731901326931,home,WSH,under,8,0.5348837209302326,-115,0.5119184317197681,WSH,CHC,2022 REG,8,5,7,4,9,15,1,0,1,-1,1,1,1,1,0,0,0,0,0,0.48808156828023186,0.5119184317197681
85816,0.7142857142857143,0.3278688524590164,-250,205,0.6841753094680495,0.3158246905319505,away,CHC,over,9,0.5098039215686274,-104,0.48375889301574193,TOR,CHC,2022 REG,9,5,14,4,9,23,1,0,1,-1,1,1,1,1,0,0,0,0,0,0.48375889301574193,0.5162411069842581
85816,0.7142857142857143,0.3278688524590164,-250,205,0.6841753094680495,0.3158246905319505,home,TOR,under,9,0.5412844036697247,-118,0.5162411069842581,TOR,CHC,2022 REG,9,5,14,4,9,23,1,0,1,-1,1,1,1,1,0,0,0,0,0,0.48375889301574193,0.5162411069842581
85817,0.5121951219512195,0.5348837209302326,-105,-115,0.48808156828023186,0.5119184317197681,away,MIA,over,8.5,0.5454545454545454,-120,0.5179608869977906,CHC,MIA,2022 REG,10,4,5,0,4,15,1,0,4,-4,0,0,0,0,0,0,0,0,0,0.5179608869977906,0.48203911300220936
85817,0.5121951219512195,0.5348837209302326,-105,-115,0.48808156828023186,0.5119184317197681,home,CHC,under,8.5,0.504950495049505,-102,0.48203911300220936,CHC,MIA,2022 REG,10,4,5,0,4,15,1,0,4,-4,0,0,0,0,0,0,0,0,0,0.5179608869977906,0.48203911300220936
85818,0.6666666666666666,0.37037037037037035,-200,170,0.6419753086419753,0.3580246913580247,away,CLE,over,8.5,0.5215311004784688,-109,0.4978845547971712,HOU,CLE,2022 REG,4,1,9,6,7,13,0,1,-5,5,1,0,0,0,0,0,0,0,0,0.4978845547971712,0.5021154452028288
85818,0.6666666666666666,0.37037037037037035,-200,170,0.6419753086419753,0.3580246913580247,home,HOU,under,8.5,0.5238095238095238,-110,0.5021154452028288,HOU,CLE,2022 REG,4,1,9,6,7,13,0,1,-5,5,1,0,0,0,0,0,0,0,0,0.4978845547971712,0.5021154452028288
85819,0.6226415094339623,0.42016806722689076,-165,138,0.5959864900036198,0.4040135099963802,away,NYM,over,8.5,0.5454545454545454,-120,0.5179608869977906,ATL,NYM,2022 REG,8,5,3,0,5,11,1,0,5,-5,0,0,0,0,0,0,0,0,0,0.5179608869977906,0.48203911300220936
85819,0.6226415094339623,0.42016806722689076,-165,138,0.5959864900036198,0.4040135099963802,home,ATL,under,8.5,0.504950495049505,-102,0.48203911300220936,ATL,NYM,2022 REG,8,5,3,0,5,11,1,0,5,-5,0,0,0,0,0,0,0,0,0,0.5179608869977906,0.48203911300220936
85820,0.5967741935483871,0.4444444444444444,-148,125,0.5721759741010521,0.42782402589894786,away,SEA,over,8.5,0.5121951219512195,-105,0.48808156828023186,MIN,SEA,2022 REG,4,3,9,4,7,13,0,1,-1,1,1,1,1,0,0,0,0,0,0,0.48808156828023186,0.5119184317197681
85820,0.5967741935483871,0.4444444444444444,-148,125,0.5721759741010521,0.42782402589894786,home,MIN,under,8.5,0.5348837209302326,-115,0.5119184317197681,MIN,SEA,2022 REG,4,3,9,4,7,13,0,1,-1,1,1,1,1,0,0,0,0,0,0,0.48808156828023186,0.5119184317197681
85821,0.6153846153846154,0.4166666666666667,-160,140,0.5956607495069033,0.4043392504930967,away,BAL,over,10.5,0.5238095238095238,-110,0.4988662131519274,BOS,BAL,2022 REG,9,2,7,4,6,16,0,1,-2,2,1,1,0,0,0,0,0,0,0,0.4988662131519274,0.5011337868480725
85821,0.6153846153846154,0.4166666666666667,-160,140,0.5956607495069033,0.4043392504930967,home,BOS,under,10.5,0.5238095238095238,-110,0.5011337868480725,BOS,BAL,2022 REG,9,2,7,4,6,16,0,1,-2,2,1,1,0,0,0,0,0,0,0,0.4988662131519274,0.5011337868480725
85822,0.6031746031746031,0.4347826086956522,-152,130,0.5802797769671475,0.4197202230328525,away,MIL,over,8,0.5238095238095238,-110,0.4988662131519274,PHI,MIL,2022 REG,7,3,9,5,8,16,0,1,-2,2,1,1,1,0,0,0,0,0,0,0.4988662131519274,0.5011337868480725
85822,0.6031746031746031,0.4347826086956522,-152,130,0.5802797769671475,0.4197202230328525,home,PHI,under,8,0.5238095238095238,-110,0.5011337868480725,PHI,MIL,2022 REG,7,3,9,5,8,16,0,1,-2,2,1,1,1,0,0,0,0,0,0,0.4988662131519274,0.5011337868480725
85823,0.49504950495049505,0.5412844036697247,102,-118,0.47706242147513866,0.5229375785248613,away,SD,over,11.5,0.5305164319248826,-113,0.5066009958897986,COL,SD,2022 REG,9,5,10,4,9,19,1,0,1,-1,1,1,1,1,0,0,0,0,0,0.5066009958897986,0.49339900411020143
85823,0.49504950495049505,0.5412844036697247,102,-118,0.47706242147513866,0.5229375785248613,home,COL,under,11.5,0.5145631067961165,-106,0.49339900411020143,COL,SD,2022 REG,9,5,10,4,9,19,1,0,1,-1,1,1,1,1,0,0,0,0,0,0.5066009958897986,0.49339900411020143
85824,0.5454545454545454,0.5,-120,100,0.5206611570247933,0.4793388429752067,away,SEA,over,7,0.49504950495049505,102,0.47297076509898783,MIA,SEA,2022 REG,10,3,12,7,10,22,0,1,-4,4,1,1,1,0,0,0,0,0,0,0.47297076509898783,0.5270292349010122
85824,0.5454545454545454,0.5,-120,100,0.5206611570247933,0.4793388429752067,home,MIA,under,7,0.5495495495495495,-122,0.5270292349010122,MIA,SEA,2022 REG,10,3,12,7,10,22,0,1,-4,4,1,1,1,0,0,0,0,0,0,0.47297076509898783,0.5270292349010122
85825,0.5348837209302326,0.5121951219512195,-115,-105,0.5097020142727117,0.49029798572728833,away,LAA,over,7.5,0.5073891625615764,-103,0.4816299493915137,CLE,LAA,2022 REG,13,5,10,3,8,23,1,0,2,-2,1,1,1,0,0,0,0,0,0,0.4816299493915137,0.5183700506084863
85825,0.5348837209302326,0.5121951219512195,-115,-105,0.5097020142727117,0.49029798572728833,home,CLE,under,7.5,0.5433789954337899,-119,0.5183700506084863,CLE,LAA,2022 REG,13,5,10,3,8,23,1,0,2,-2,1,1,1,0,0,0,0,0,0,0.4816299493915137,0.5183700506084863
85827,0.726027397260274,0.31746031746031744,-265,215,0.6944541249288857,0.3055458750711143,away,LAA,over,9,0.5238095238095238,-110,0.4988662131519274,TOR,LAA,2022 REG,9,3,13,8,11,22,0,1,-5,5,1,1,1,0,0,0,0,0,0,0.4988662131519274,0.5011337868480725
85827,0.726027397260274,0.31746031746031744,-265,215,0.6944541249288857,0.3055458750711143,home,TOR,under,9,0.5238095238095238,-110,0.5011337868480725,TOR,LAA,2022 REG,9,3,13,8,11,22,0,1,-5,5,1,1,1,0,0,0,0,0,0,0.4988662131519274,0.5011337868480725
85828,0.5238095238095238,0.5238095238095238,-110,-110,0.4988662131519274,0.5011337868480725,away,LAA,over,9,0.5073891625615764,-103,0.4837652908580103,BAL,LAA,2022 REG,11,9,8,5,14,19,1,0,4,-4,1,1,1,1,1,0,0,0,0,0.4837652908580103,0.5162347091419897
85828,0.5238095238095238,0.5238095238095238,-110,-110,0.4988662131519274,0.5011337868480725,home,BAL,under,9,0.5391705069124424,-117,0.5162347091419897,BAL,LAA,2022 REG,11,9,8,5,14,19,1,0,4,-4,1,1,1,1,1,0,0,0,0,0.4837652908580103,0.5162347091419897
85829,0.7448979591836734,0.29850746268656714,-292,235,0.7125653490150249,0.2874346509849751,away,CIN,over,8,0.5238095238095238,-110,0.5012646084074657,STL,CIN,2022 REG,3,2,7,3,5,10,0,1,-1,1,1,1,0,0,0,0,0,0,0,0.5012646084074657,0.4987353915925343
85829,0.7448979591836734,0.29850746268656714,-292,235,0.7125653490150249,0.2874346509849751,home,STL,under,8,0.5192307692307692,-108,0.4987353915925343,STL,CIN,2022 REG,3,2,7,3,5,10,0,1,-1,1,1,1,0,0,0,0,0,0,0,0.5012646084074657,0.4987353915925343
85830,0.6453900709219857,0.3921568627450981,-182,155,0.6211576527396834,0.3788423472603166,away,TEX,over,8,0.5305164319248826,-113,0.5053568787472517,HOU,TEX,2022 REG,8,0,5,3,3,13,0,1,-3,3,0,0,0,0,0,0,0,0,0,0.5053568787472517,0.49464312125274834
85830,0.6453900709219857,0.3921568627450981,-182,155,0.6211576527396834,0.3788423472603166,home,HOU,under,8,0.5169082125603864,-107,0.49464312125274834,HOU,TEX,2022 REG,8,0,5,3,3,13,0,1,-3,3,0,0,0,0,0,0,0,0,0,0.5053568787472517,0.49464312125274834
85831,0.7354497354497355,0.30303030303030304,-278,230,0.7071496013294954,0.29285039867050455,away,SEA,over,8,0.5327102803738317,-114,0.5075272610403079,HOU,SEA,2022 REG,7,4,6,1,5,13,1,0,3,-3,1,0,0,0,0,0,0,0,0,0.5075272610403079,0.4924727389596921
85831,0.7354497354497355,0.30303030303030304,-278,230,0.7071496013294954,0.29285039867050455,home,HOU,under,8,0.5145631067961165,-106,0.4924727389596921,HOU,SEA,2022 REG,7,4,6,1,5,13,1,0,3,-3,1,0,0,0,0,0,0,0,0,0.5075272610403079,0.4924727389596921
85833,0.4608294930875576,0.5798319327731092,117,-138,0.4420915088199692,0.5579084911800307,away,ATL,over,7.5,0.5348837209302326,-115,0.5109810284308424,MIA,ATL,2022 REG,5,2,11,5,7,16,0,1,-3,3,1,1,0,0,0,0,0,0,0,0.5109810284308424,0.48901897156915763
85833,0.4608294930875576,0.5798319327731092,117,-138,0.4420915088199692,0.5579084911800307,home,MIA,under,7.5,0.5098039215686274,-104,0.48901897156915763,MIA,ATL,2022 REG,5,2,11,5,7,16,0,1,-3,3,1,1,0,0,0,0,0,0,0,0.5109810284308424,0.48901897156915763
85834,0.5726495726495727,0.46511627906976744,-134,115,0.5510229738017454,0.44897702619825464,away,MIN,over,8,0.5327102803738317,-114,0.5075272610403079,CWS,MIN,2022 REG,7,1,12,5,6,19,0,1,-4,4,1,0,0,0,0,0,0,0,0,0.5075272610403079,0.4924727389596921
85834,0.5726495726495727,0.46511627906976744,-134,115,0.5510229738017454,0.44897702619825464,home,CWS,under,8,0.5145631067961165,-106,0.4924727389596921,CWS,MIN,2022 REG,7,1,12,5,6,19,0,1,-4,4,1,0,0,0,0,0,0,0,0,0.5075272610403079,0.4924727389596921
85835,0.6551724137931035,0.3846153846153846,-190,160,0.6291045458703008,0.37089545412969915,away,BAL,over,8,0.5238095238095238,-110,0.5000596729920038,HOU,BAL,2022 REG,4,0,7,2,2,11,0,1,-2,2,0,0,0,0,0,0,0,0,0,0.5000596729920038,0.4999403270079962
85835,0.6551724137931035,0.3846153846153846,-190,160,0.6291045458703008,0.37089545412969915,home,HOU,under,8,0.5215311004784688,-109,0.4999403270079962,HOU,BAL,2022 REG,4,0,7,2,2,11,0,1,-2,2,0,0,0,0,0,0,0,0,0,0.5000596729920038,0.4999403270079962
85836,0.5454545454545454,0.5,-120,100,0.5206611570247933,0.4793388429752067,away,SD,over,8,0.5305164319248826,-113,0.5078572507605655,ATL,SD,2022 REG,5,3,7,7,10,12,0,1,-4,4,1,1,1,0,0,0,0,0,0,0.5078572507605655,0.49214274923943446
85836,0.5454545454545454,0.5,-120,100,0.5206611570247933,0.4793388429752067,home,ATL,under,8,0.5121951219512195,-105,0.49214274923943446,ATL,SD,2022 REG,5,3,7,7,10,12,0,1,-4,4,1,1,1,0,0,0,0,0,0,0.5078572507605655,0.49214274923943446
85838,0.5391705069124424,0.5,-117,100,0.5180509248444435,0.4819490751555565,away,LAA,over,8.5,0.5348837209302326,-115,0.5097020142727117,CWS,LAA,2022 REG,10,4,6,0,4,16,1,0,4,-4,0,0,0,0,0,0,0,0,0,0.5097020142727117,0.49029798572728833
85838,0.5391705069124424,0.5,-117,100,0.5180509248444435,0.4819490751555565,home,CWS,under,8.5,0.5121951219512195,-105,0.49029798572728833,CWS,LAA,2022 REG,10,4,6,0,4,16,1,0,4,-4,0,0,0,0,0,0,0,0,0,0.5097020142727117,0.49029798572728833
85840,0.43859649122807015,0.6000000000000001,128,-150,0.4216682056017235,0.5783317943982764,away,SD,over,7.5,0.5121951219512195,-105,0.48919479393107135,MIA,SD,2022 REG,6,4,10,3,7,16,1,0,1,-1,1,1,1,0,0,0,0,0,0,0.48919479393107135,0.5108052060689287
85840,0.43859649122807015,0.6000000000000001,128,-150,0.4216682056017235,0.5783317943982764,home,MIA,under,7.5,0.5327102803738317,-114,0.5108052060689287,MIA,SD,2022 REG,6,4,10,3,7,16,1,0,1,-1,1,1,1,0,0,0,0,0,0,0.48919479393107135,0.5108052060689287
85842,0.5192307692307692,0.5192307692307692,-108,-108,0.4992603550295858,0.5007396449704142,away,NYM,over,7,0.5327102803738317,-114,0.508788710910954,STL,NYM,2022 REG,3,0,8,3,3,11,0,1,-3,3,0,0,0,0,0,0,0,0,0,0.508788710910954,0.491211289089046
85842,0.5192307692307692,0.5192307692307692,-108,-108,0.4992603550295858,0.5007396449704142,home,STL,under,7,0.5121951219512195,-105,0.491211289089046,STL,NYM,2022 REG,3,0,8,3,3,11,0,1,-3,3,0,0,0,0,0,0,0,0,0,0.508788710910954,0.491211289089046
85844,0.5454545454545454,0.5,-120,100,0.5206611570247933,0.4793388429752067,away,SD,over,8.5,0.5348837209302326,-115,0.5097020142727117,PHI,SD,2022 REG,5,0,8,3,3,13,0,1,-3,3,0,0,0,0,0,0,0,0,0,0.5097020142727117,0.49029798572728833
85844,0.5454545454545454,0.5,-120,100,0.5206611570247933,0.4793388429752067,home,PHI,under,8.5,0.5121951219512195,-105,0.49029798572728833,PHI,SD,2022 REG,5,0,8,3,3,13,0,1,-3,3,0,0,0,0,0,0,0,0,0,0.5097020142727117,0.49029798572728833
85845,0.6453900709219857,0.3921568627450981,-182,155,0.6211576527396834,0.3788423472603166,away,KC,over,8,0.5121951219512195,-105,0.48919479393107135,MIN,KC,2022 REG,15,10,13,7,17,28,1,0,3,-3,1,1,1,1,1,1,1,0,0,0.48919479393107135,0.5108052060689287
85845,0.6453900709219857,0.3921568627450981,-182,155,0.6211576527396834,0.3788423472603166,home,MIN,under,8,0.5327102803738317,-114,0.5108052060689287,MIN,KC,2022 REG,15,10,13,7,17,28,1,0,3,-3,1,1,1,1,1,1,1,0,0,0.48919479393107135,0.5108052060689287
85850,0.5815899581589958,0.46511627906976744,-139,115,0.5544260796033553,0.4455739203966447,away,SD,over,9,0.5,100,0.4772727272727273,LAD,SD,2022 REG,11,4,2,0,4,13,1,0,4,-4,0,0,0,0,0,0,0,0,0,0.4772727272727273,0.5227272727272727
85850,0.5815899581589958,0.46511627906976744,-139,115,0.5544260796033553,0.4455739203966447,home,LAD,under,9,0.5454545454545454,-120,0.5227272727272727,LAD,SD,2022 REG,11,4,2,0,4,13,1,0,4,-4,0,0,0,0,0,0,0,0,0,0.4772727272727273,0.5227272727272727
85851,0.6551724137931035,0.37878787878787884,-190,164,0.6329225669297013,0.3670774330702987,away,DET,over,8.5,0.5121951219512195,-105,0.48808156828023186,LAA,DET,2022 REG,16,10,4,0,10,20,1,0,10,-10,0,0,0,0,0,0,0,0,0,0.48808156828023186,0.5119184317197681
85851,0.6551724137931035,0.37878787878787884,-190,164,0.6329225669297013,0.3670774330702987,home,LAA,under,8.5,0.5348837209302326,-115,0.5119184317197681,LAA,DET,2022 REG,16,10,4,0,10,20,1,0,10,-10,0,0,0,0,0,0,0,0,0,0.48808156828023186,0.5119184317197681
85852,0.5454545454545454,0.49504950495049505,-120,102,0.5233614270517961,0.4766385729482039,away,NYY,over,7.5,0.49504950495049505,102,0.4719707862985384,TB,NYY,2022 REG,2,0,6,2,2,8,0,1,-2,2,0,0,0,0,0,0,0,0,0,0.4719707862985384,0.5280292137014616
85852,0.5454545454545454,0.49504950495049505,-120,102,0.5233614270517961,0.4766385729482039,home,TB,under,7.5,0.5515695067264574,-123,0.5280292137014616,TB,NYY,2022 REG,2,0,6,2,2,8,0,1,-2,2,0,0,0,0,0,0,0,0,0,0.4719707862985384,0.5280292137014616
85853,0.6402877697841727,0.4,-178,150,0.6144920035194866,0.38550799648051337,away,MIN,over,7.5,0.5121951219512195,-105,0.48808156828023186,TB,MIN,2022 REG,4,1,14,9,10,18,0,1,-8,8,1,0,0,0,0,0,0,0,0,0.48808156828023186,0.5119184317197681
85853,0.6402877697841727,0.4,-178,150,0.6144920035194866,0.38550799648051337,home,TB,under,7.5,0.5348837209302326,-115,0.5119184317197681,TB,MIN,2022 REG,4,1,14,9,10,18,0,1,-8,8,1,0,0,0,0,0,0,0,0,0.48808156828023186,0.5119184317197681
85854,0.49019607843137253,0.5495495495495495,104,-122,0.4707129274603323,0.5292870725396677,away,SEA,over,9,0.5024875621890548,-101,0.47839724939301687,BAL,SEA,2022 REG,8,6,12,7,13,20,0,1,-1,1,1,1,1,1,1,1,0,0,0,0.47839724939301687,0.5216027506069831
85854,0.49019607843137253,0.5495495495495495,104,-122,0.4707129274603323,0.5292870725396677,home,BAL,under,9,0.5454545454545454,-120,0.5216027506069831,BAL,SEA,2022 REG,8,6,12,7,13,20,0,1,-1,1,1,1,1,1,1,1,0,0,0,0.47839724939301687,0.5216027506069831
85855,0.35714285714285715,0.6875,180,-220,0.3411989795918367,0.6588010204081634,away,MIL,over,9,0.5348837209302326,-115,0.5097020142727117,PIT,MIL,2022 REG,9,7,11,4,11,20,1,0,3,-3,1,1,1,1,0,0,0,0,0,0.5097020142727117,0.49029798572728833
85855,0.35714285714285715,0.6875,180,-220,0.3411989795918367,0.6588010204081634,home,PIT,under,9,0.5121951219512195,-105,0.49029798572728833,PIT,MIL,2022 REG,9,7,11,4,11,20,1,0,3,-3,1,1,1,1,0,0,0,0,0,0.5097020142727117,0.49029798572728833
85856,0.45454545454545453,0.5815899581589958,120,-139,0.43812026695252254,0.5618797330474774,away,MIL,over,11.5,0.5348837209302326,-115,0.5097020142727117,COL,MIL,2022 REG,9,8,7,4,12,16,1,0,4,-4,1,1,1,1,0,0,0,0,0,0.5097020142727117,0.49029798572728833
85856,0.45454545454545453,0.5815899581589958,120,-139,0.43812026695252254,0.5618797330474774,home,COL,under,11.5,0.5121951219512195,-105,0.49029798572728833,COL,MIL,2022 REG,9,8,7,4,12,16,1,0,4,-4,1,1,1,1,0,0,0,0,0,0.5097020142727117,0.49029798572728833
85857,0.5215311004784688,0.5192307692307692,-109,-108,0.50027251771145,0.49972748228855,away,NYY,over,7,0.5348837209302326,-115,0.5097020142727117,TEX,NYY,2022 REG,8,4,8,5,9,16,0,1,-1,1,1,1,1,1,0,0,0,0,0,0.5097020142727117,0.49029798572728833
85857,0.5215311004784688,0.5192307692307692,-109,-108,0.50027251771145,0.49972748228855,home,TEX,under,7,0.5121951219512195,-105,0.49029798572728833,TEX,NYY,2022 REG,8,4,8,5,9,16,0,1,-1,1,1,1,1,1,0,0,0,0,0,0.5097020142727117,0.49029798572728833
85858,0.6491228070175439,0.3921568627450981,-185,155,0.6223272319084604,0.3776727680915396,away,ARI,over,7.5,0.5,100,0.4772727272727273,MIA,ARI,2022 REG,6,4,9,5,9,15,0,1,-1,1,1,1,1,1,0,0,0,0,0,0.4772727272727273,0.5227272727272727
85858,0.6491228070175439,0.3921568627450981,-185,155,0.6223272319084604,0.3776727680915396,home,MIA,under,7.5,0.5454545454545454,-120,0.5227272727272727,MIA,ARI,2022 REG,6,4,9,5,9,15,0,1,-1,1,1,1,1,1,0,0,0,0,0,0.4772727272727273,0.5227272727272727
85859,0.49504950495049505,0.5475113122171946,102,-121,0.4739797934813417,0.5260202065186583,away,LAD,over,8,0.5169082125603864,-107,0.49353874091423283,SD,LAD,2022 REG,5,3,5,2,5,10,1,0,1,-1,1,1,0,0,0,0,0,0,0,0.49353874091423283,0.5064612590857671
85859,0.49504950495049505,0.5475113122171946,102,-121,0.4739797934813417,0.5260202065186583,home,SD,under,8,0.5283018867924528,-112,0.5064612590857671,SD,LAD,2022 REG,5,3,5,2,5,10,1,0,1,-1,1,1,0,0,0,0,0,0,0,0.49353874091423283,0.5064612590857671
85860,0.5283018867924528,0.5121951219512195,-112,-105,0.5069072406637203,0.4930927593362797,away,PHI,over,8,0.5192307692307692,-108,0.49455035168025013,MIA,PHI,2022 REG,5,0,15,10,10,20,0,1,-10,10,0,0,0,0,0,0,0,0,0,0.49455035168025013,0.5054496483197499
85860,0.5283018867924528,0.5121951219512195,-112,-105,0.5069072406637203,0.4930927593362797,home,MIA,under,8,0.5283018867924528,-112,0.5054496483197499,MIA,PHI,2022 REG,5,0,15,10,10,20,0,1,-10,10,0,0,0,0,0,0,0,0,0,0.49455035168025013,0.5054496483197499
85861,0.7530864197530864,0.28169014084507044,-305,255,0.7268966642408942,0.27310333575910584,away,PIT,over,8.5,0.5454545454545454,-120,0.5179608869977906,ATL,PIT,2022 REG,6,3,8,1,4,14,1,0,2,-2,1,0,0,0,0,0,0,0,0,0.5179608869977906,0.48203911300220936
85861,0.7530864197530864,0.28169014084507044,-305,255,0.7268966642408942,0.27310333575910584,home,ATL,under,8.5,0.504950495049505,-102,0.48203911300220936,ATL,PIT,2022 REG,6,3,8,1,4,14,1,0,2,-2,1,0,0,0,0,0,0,0,0,0.5179608869977906,0.48203911300220936
85862,0.6575342465753424,0.38167938931297707,-192,162,0.6317499380460364,0.3682500619539636,away,PIT,over,9,0.5238095238095238,-110,0.4988662131519274,BAL,PIT,2022 REG,4,1,9,8,9,13,0,1,-7,7,1,0,0,0,0,0,0,0,0,0.4988662131519274,0.5011337868480725
85862,0.6575342465753424,0.38167938931297707,-192,162,0.6317499380460364,0.3682500619539636,home,BAL,under,9,0.5238095238095238,-110,0.5011337868480725,BAL,PIT,2022 REG,4,1,9,8,9,13,0,1,-7,7,1,0,0,0,0,0,0,0,0,0.4988662131519274,0.5011337868480725
85864,0.6551724137931035,0.3846153846153846,-190,160,0.6291045458703008,0.37089545412969915,away,CHC,over,7.5,0.5,100,0.4772727272727273,STL,CHC,2022 REG,7,2,2,0,2,9,1,0,2,-2,0,0,0,0,0,0,0,0,0,0.4772727272727273,0.5227272727272727
85864,0.6551724137931035,0.3846153846153846,-190,160,0.6291045458703008,0.37089545412969915,home,STL,under,7.5,0.5454545454545454,-120,0.5227272727272727,STL,CHC,2022 REG,7,2,2,0,2,9,1,0,2,-2,0,0,0,0,0,0,0,0,0,0.4772727272727273,0.5227272727272727
85866,0.6453900709219857,0.3921568627450981,-182,155,0.6211576527396834,0.3788423472603166,away,DET,over,8.5,0.5238095238095238,-110,0.5000596729920038,MIN,DET,2022 REG,7,5,10,4,9,17,1,0,1,-1,1,1,1,1,0,0,0,0,0,0.5000596729920038,0.4999403270079962
85866,0.6453900709219857,0.3921568627450981,-182,155,0.6211576527396834,0.3788423472603166,home,MIN,under,8.5,0.5215311004784688,-109,0.4999403270079962,MIN,DET,2022 REG,7,5,10,4,9,17,1,0,1,-1,1,1,1,1,0,0,0,0,0,0.5000596729920038,0.4999403270079962
85867,0.6453900709219857,0.4,-182,150,0.6160957698304913,0.3839042301695087,away,SF,over,8,0.5169082125603864,-107,0.49239402434819424,LAD,SF,2022 REG,7,4,5,2,6,12,1,0,2,-2,1,1,0,0,0,0,0,0,0,0.49239402434819424,0.5076059756518058
85867,0.6453900709219857,0.4,-182,150,0.6160957698304913,0.3839042301695087,home,LAD,under,8,0.5305164319248826,-113,0.5076059756518058,LAD,SF,2022 REG,7,4,5,2,6,12,1,0,2,-2,1,1,0,0,0,0,0,0,0,0.49239402434819424,0.5076059756518058
85868,0.4587155963302753,0.5833333333333333,118,-140,0.4394270964845833,0.5605729035154168,away,SF,over,10,0.5098039215686274,-104,0.4870219861770517,COL,SF,2022 REG,5,1,15,6,7,20,0,1,-5,5,1,0,0,0,0,0,0,0,0,0.4870219861770517,0.5129780138229483
85868,0.4587155963302753,0.5833333333333333,118,-140,0.4394270964845833,0.5605729035154168,home,COL,under,10,0.5348837209302326,-115,0.5129780138229483,COL,SF,2022 REG,5,1,15,6,7,20,0,1,-5,5,1,0,0,0,0,0,0,0,0,0.4870219861770517,0.5129780138229483
85869,0.6825396825396826,0.35714285714285715,-215,180,0.6554547745023935,0.34454522549760647,away,DET,over,8.5,0.5348837209302326,-115,0.5084354177277668,MIN,DET,2022 REG,7,4,4,1,5,11,1,0,3,-3,1,0,0,0,0,0,0,0,0,0.5084354177277668,0.4915645822722332
85869,0.6825396825396826,0.35714285714285715,-215,180,0.6554547745023935,0.34454522549760647,home,MIN,under,8.5,0.5145631067961165,-106,0.4915645822722332,MIN,DET,2022 REG,7,4,4,1,5,11,1,0,3,-3,1,0,0,0,0,0,0,0,0,0.5084354177277668,0.4915645822722332
85870,0.6825396825396826,0.35714285714285715,-215,180,0.6554547745023935,0.34454522549760647,away,OAK,over,10,0.5098039215686274,-104,0.4870219861770517,TOR,OAK,2022 REG,11,4,6,1,5,17,1,0,3,-3,1,0,0,0,0,0,0,0,0,0.4870219861770517,0.5129780138229483
85870,0.6825396825396826,0.35714285714285715,-215,180,0.6554547745023935,0.34454522549760647,home,TOR,under,10,0.5348837209302326,-115,0.5129780138229483,TOR,OAK,2022 REG,11,4,6,1,5,17,1,0,3,-3,1,0,0,0,0,0,0,0,0,0.4870219861770517,0.5129780138229483
85871,0.5454545454545454,0.49504950495049505,-120,102,0.5233614270517961,0.4766385729482039,away,ARI,over,7.5,0.5348837209302326,-115,0.5097020142727117,SF,ARI,2022 REG,8,4,12,8,12,20,0,1,-4,4,1,1,1,1,0,0,0,0,0,0.5097020142727117,0.49029798572728833
85871,0.5454545454545454,0.49504950495049505,-120,102,0.5233614270517961,0.4766385729482039,home,SF,under,7.5,0.5121951219512195,-105,0.49029798572728833,SF,ARI,2022 REG,8,4,12,8,12,20,0,1,-4,4,1,1,1,1,0,0,0,0,0,0.5097020142727117,0.49029798572728833
85872,0.37735849056603776,0.6610169491525424,165,-195,0.36287719255902645,0.6371228074409736,away,SF,over,8,0.5169082125603864,-107,0.49353874091423283,ARI,SF,2022 REG,11,8,7,3,11,18,1,0,5,-5,1,1,1,0,0,0,0,0,0,0.49353874091423283,0.5064612590857671
85872,0.37735849056603776,0.6610169491525424,165,-195,0.36287719255902645,0.6371228074409736,home,ARI,under,8,0.5283018867924528,-112,0.5064612590857671,ARI,SF,2022 REG,11,8,7,3,11,18,1,0,5,-5,1,1,1,0,0,0,0,0,0,0.49353874091423283,0.5064612590857671
85873,0.30303030303030304,0.7354497354497355,230,-278,0.29136968530907925,0.7086303146909207,away,TOR,over,8.5,0.5145631067961165,-106,0.4913668392989033,DET,TOR,2022 REG,8,3,9,1,4,17,1,0,2,-2,1,0,0,0,0,0,0,0,0,0.4913668392989033,0.5086331607010968
85873,0.30303030303030304,0.7354497354497355,230,-278,0.29136968530907925,0.7086303146909207,home,DET,under,8.5,0.5305164319248826,-113,0.5086331607010968,DET,TOR,2022 REG,8,3,9,1,4,17,1,0,2,-2,1,0,0,0,0,0,0,0,0,0.4913668392989033,0.5086331607010968
85874,0.5412844036697247,0.5,-118,100,0.5189377998484975,0.4810622001515025,away,OAK,over,7.5,0.5412844036697247,-118,0.5189377998484975,LAA,OAK,2022 REG,7,3,7,1,4,14,1,0,2,-2,1,0,0,0,0,0,0,0,0,0.5189377998484975,0.4810622001515025
85874,0.5412844036697247,0.5,-118,100,0.5189377998484975,0.4810622001515025,home,LAA,under,7.5,0.5,100,0.4810622001515025,LAA,OAK,2022 REG,7,3,7,1,4,14,1,0,2,-2,1,0,0,0,0,0,0,0,0,0.5189377998484975,0.4810622001515025
85875,0.6000000000000001,0.4444444444444444,-150,125,0.5733333333333334,0.42666666666666664,away,TB,over,9,0.5121951219512195,-105,0.48808156828023186,TOR,TB,2022 REG,11,9,9,2,11,20,1,0,7,-7,1,1,0,0,0,0,0,0,0,0.48808156828023186,0.5119184317197681
85875,0.6000000000000001,0.4444444444444444,-150,125,0.5733333333333334,0.42666666666666664,home,TOR,under,9,0.5348837209302326,-115,0.5119184317197681,TOR,TB,2022 REG,11,9,9,2,11,20,1,0,7,-7,1,1,0,0,0,0,0,0,0,0.48808156828023186,0.5119184317197681
85876,0.4347826086956522,0.6031746031746031,130,-152,0.418279473099889,0.581720526900111,away,STL,over,9,0.5412844036697247,-118,0.5175913212324037,PIT,STL,2022 REG,8,4,20,18,22,28,0,1,-14,14,1,1,1,1,0,0,0,0,0,0.5175913212324037,0.4824086787675963
85876,0.4347826086956522,0.6031746031746031,130,-152,0.418279473099889,0.581720526900111,home,PIT,under,9,0.5024875621890548,-101,0.4824086787675963,PIT,STL,2022 REG,8,4,20,18,22,28,0,1,-14,14,1,1,1,1,0,0,0,0,0,0.5175913212324037,0.4824086787675963
85877,0.7014925373134329,0.3401360544217687,-235,194,0.6722903908723213,0.32770960912767866,away,ARI,over,8,0.5348837209302326,-115,0.5097020142727117,ATL,ARI,2022 REG,5,1,4,0,1,9,1,0,1,-1,0,0,0,0,0,0,0,0,0,0.5097020142727117,0.49029798572728833
85877,0.7014925373134329,0.3401360544217687,-235,194,0.6722903908723213,0.32770960912767866,home,ATL,under,8,0.5121951219512195,-105,0.49029798572728833,ATL,ARI,2022 REG,5,1,4,0,1,9,1,0,1,-1,0,0,0,0,0,0,0,0,0,0.5097020142727117,0.49029798572728833
85878,0.6389891696750902,0.4,-177,150,0.614075512518083,0.385924487481917,away,BOS,over,8,0.5073891625615764,-103,0.4826927225525911,NYY,BOS,2022 REG,6,2,1,0,2,7,1,0,2,-2,0,0,0,0,0,0,0,0,0,0.4826927225525911,0.5173072774474089
85878,0.6389891696750902,0.4,-177,150,0.614075512518083,0.385924487481917,home,NYY,under,8,0.5412844036697247,-118,0.5173072774474089,NYY,BOS,2022 REG,6,2,1,0,2,7,1,0,2,-2,0,0,0,0,0,0,0,0,0,0.4826927225525911,0.5173072774474089
85879,0.7468354430379747,0.29411764705882354,-295,240,0.7162502238517583,0.2837497761482417,away,TEX,over,8,0.5327102803738317,-114,0.508788710910954,HOU,TEX,2022 REG,4,4,5,3,7,9,1,0,1,-1,1,1,1,0,0,0,0,0,0,0.508788710910954,0.491211289089046
85879,0.7468354430379747,0.29411764705882354,-295,240,0.7162502238517583,0.2837497761482417,home,HOU,under,8,0.5121951219512195,-105,0.491211289089046,HOU,TEX,2022 REG,4,4,5,3,7,9,1,0,1,-1,1,1,1,0,0,0,0,0,0,0.508788710910954,0.491211289089046
85880,0.6363636363636364,0.4,-175,150,0.6132231404958678,0.3867768595041322,away,BAL,over,8.5,0.5145631067961165,-106,0.49023796582517226,TOR,BAL,2022 REG,8,6,4,1,7,12,1,0,5,-5,1,0,0,0,0,0,0,0,0,0.49023796582517226,0.5097620341748277
85880,0.6363636363636364,0.4,-175,150,0.6132231404958678,0.3867768595041322,home,TOR,under,8.5,0.5327102803738317,-114,0.5097620341748277,TOR,BAL,2022 REG,8,6,4,1,7,12,1,0,5,-5,1,0,0,0,0,0,0,0,0,0.49023796582517226,0.5097620341748277
85881,0.6774193548387096,0.36363636363636365,-210,175,0.6496074165168858,0.3503925834831142,away,OAK,over,8,0.5121951219512195,-105,0.48808156828023186,HOU,OAK,2022 REG,4,1,9,5,6,13,0,1,-4,4,1,0,0,0,0,0,0,0,0,0.48808156828023186,0.5119184317197681
85881,0.6774193548387096,0.36363636363636365,-210,175,0.6496074165168858,0.3503925834831142,home,HOU,under,8,0.5348837209302326,-115,0.5119184317197681,HOU,OAK,2022 REG,4,1,9,5,6,13,0,1,-4,4,1,0,0,0,0,0,0,0,0,0.48808156828023186,0.5119184317197681
85882,0.48780487804878053,0.5555555555555556,105,-125,0.4666534470222751,0.5333465529777248,away,ATL,over,7.5,0.49751243781094534,101,0.476135829221149,PHI,ATL,2022 REG,5,3,10,6,9,15,0,1,-3,3,1,1,1,0,0,0,0,0,0,0.476135829221149,0.523864170778851
85882,0.48780487804878053,0.5555555555555556,105,-125,0.4666534470222751,0.5333465529777248,home,PHI,under,7.5,0.5454545454545454,-120,0.523864170778851,PHI,ATL,2022 REG,5,3,10,6,9,15,0,1,-3,3,1,1,1,0,0,0,0,0,0,0.476135829221149,0.523864170778851
85883,0.4716981132075471,0.5689655172413793,112,-132,0.45251715544861953,0.5474828445513804,away,PHI,over,7,0.5238095238095238,-110,0.5000596729920038,SD,PHI,2022 REG,7,1,5,0,1,12,1,0,1,-1,0,0,0,0,0,0,0,0,0,0.5000596729920038,0.4999403270079962
85883,0.4716981132075471,0.5689655172413793,112,-132,0.45251715544861953,0.5474828445513804,home,SD,under,7,0.5215311004784688,-109,0.4999403270079962,SD,PHI,2022 REG,7,1,5,0,1,12,1,0,1,-1,0,0,0,0,0,0,0,0,0,0.5000596729920038,0.4999403270079962
85884,0.4854368932038835,0.5535714285714286,106,-124,0.4665008146721786,0.5334991853278215,away,TOR,over,7.5,0.5121951219512195,-105,0.48808156828023186,BAL,TOR,2022 REG,3,1,10,5,6,13,0,1,-4,4,1,0,0,0,0,0,0,0,0,0.48808156828023186,0.5119184317197681
85884,0.4854368932038835,0.5535714285714286,106,-124,0.4665008146721786,0.5334991853278215,home,BAL,under,7.5,0.5348837209302326,-115,0.5119184317197681,BAL,TOR,2022 REG,3,1,10,5,6,13,0,1,-4,4,1,0,0,0,0,0,0,0,0,0.48808156828023186,0.5119184317197681
85885,0.37037037037037035,0.6666666666666666,170,-200,0.35665294924554186,0.6433470507544581,away,NYY,over,8,0.5412844036697247,-118,0.5175913212324037,KC,NYY,2022 REG,8,2,10,12,14,18,0,1,-10,10,1,1,0,0,0,0,0,0,0,0.5175913212324037,0.4824086787675963
85885,0.37037037037037035,0.6666666666666666,170,-200,0.35665294924554186,0.6433470507544581,home,KC,under,8,0.5024875621890548,-101,0.4824086787675963,KC,NYY,2022 REG,8,2,10,12,14,18,0,1,-10,10,1,1,0,0,0,0,0,0,0,0.5175913212324037,0.4824086787675963
85886,0.574468085106383,0.46511627906976744,-135,115,0.5517281312179562,0.44827186878204384,away,ATL,over,7,0.5145631067961165,-106,0.49023796582517226,NYM,ATL,2022 REG,8,6,7,2,8,15,1,0,4,-4,1,1,0,0,0,0,0,0,0,0.49023796582517226,0.5097620341748277
85886,0.574468085106383,0.46511627906976744,-135,115,0.5517281312179562,0.44827186878204384,home,NYM,under,7,0.5327102803738317,-114,0.5097620341748277,NYM,ATL,2022 REG,8,6,7,2,8,15,1,0,4,-4,1,1,0,0,0,0,0,0,0,0.49023796582517226,0.5097620341748277
85889,0.4807692307692307,0.5555555555555556,108,-125,0.4633053911900066,0.5366946088099934,away,MIL,over,9,0.5348837209302326,-115,0.5097020142727117,CHC,MIL,2022 REG,8,6,4,5,11,12,1,0,1,-1,1,1,1,1,1,0,0,0,0,0.5097020142727117,0.49029798572728833
85889,0.4807692307692307,0.5555555555555556,108,-125,0.4633053911900066,0.5366946088099934,home,CHC,under,9,0.5121951219512195,-105,0.49029798572728833,CHC,MIL,2022 REG,8,6,4,5,11,12,1,0,1,-1,1,1,1,1,1,0,0,0,0,0.5097020142727117,0.49029798572728833
85890,0.6453900709219857,0.3921568627450981,-182,155,0.6211576527396834,0.3788423472603166,away,BOS,over,8,0.5348837209302326,-115,0.5109810284308424,TOR,BOS,2022 REG,8,6,9,5,11,17,1,0,1,-1,1,1,1,1,1,0,0,0,0,0.5109810284308424,0.48901897156915763
85890,0.6453900709219857,0.3921568627450981,-182,155,0.6211576527396834,0.3788423472603166,home,TOR,under,8,0.5098039215686274,-104,0.48901897156915763,TOR,BOS,2022 REG,8,6,9,5,11,17,1,0,1,-1,1,1,1,1,1,0,0,0,0,0.5109810284308424,0.48901897156915763
85891,0.4587155963302753,0.5780590717299579,118,-137,0.4418464825411775,0.5581535174588226,away,MIN,over,8,0.5215311004784688,-109,0.4978845547971712,KC,MIN,2022 REG,7,2,9,9,11,16,0,1,-7,7,1,1,0,0,0,0,0,0,0,0.4978845547971712,0.5021154452028288
85891,0.4587155963302753,0.5780590717299579,118,-137,0.4418464825411775,0.5581535174588226,home,KC,under,8,0.5238095238095238,-110,0.5021154452028288,KC,MIN,2022 REG,7,2,9,9,11,16,0,1,-7,7,1,1,0,0,0,0,0,0,0,0.4978845547971712,0.5021154452028288
85892,0.5689655172413793,0.4716981132075471,-132,112,0.5458293137100936,0.4541706862899064,away,SEA,over,8.5,0.5495495495495495,-122,0.5236866555946829,BOS,SEA,2022 REG,16,12,10,6,18,26,1,0,6,-6,1,1,1,1,1,1,0,0,0,0.5236866555946829,0.47631334440531714
85892,0.5689655172413793,0.4716981132075471,-132,112,0.5458293137100936,0.4541706862899064,home,BOS,under,8.5,0.49751243781094534,101,0.47631334440531714,BOS,SEA,2022 REG,16,12,10,6,18,26,1,0,6,-6,1,1,1,1,1,1,0,0,0,0.5236866555946829,0.47631334440531714
85893,0.4347826086956522,0.6031746031746031,130,-152,0.418279473099889,0.581720526900111,away,STL,over,8,0.5412844036697247,-118,0.5189377998484975,PIT,STL,2022 REG,7,3,10,5,8,17,0,1,-2,2,1,1,1,0,0,0,0,0,0,0.5189377998484975,0.4810622001515025
85893,0.4347826086956522,0.6031746031746031,130,-152,0.418279473099889,0.581720526900111,home,PIT,under,8,0.5,100,0.4810622001515025,PIT,STL,2022 REG,7,3,10,5,8,17,0,1,-2,2,1,1,1,0,0,0,0,0,0,0.5189377998484975,0.4810622001515025
85894,0.37735849056603776,0.6551724137931035,165,-190,0.3650826776003241,0.6349173223996759,away,SD,over,8,0.5412844036697247,-118,0.5149381613977361,ARI,SD,2022 REG,7,3,17,12,15,24,0,1,-9,9,1,1,1,0,0,0,0,0,0,0.5149381613977361,0.48506183860226393
85894,0.37735849056603776,0.6551724137931035,165,-190,0.3650826776003241,0.6349173223996759,home,ARI,under,8,0.5073891625615764,-103,0.48506183860226393,ARI,SD,2022 REG,7,3,17,12,15,24,0,1,-9,9,1,1,1,0,0,0,0,0,0,0.5149381613977361,0.48506183860226393
85895,0.47619047619047616,0.5594713656387665,110,-127,0.4592086467479796,0.5407913532520203,away,MIA,over,7.5,0.504950495049505,-102,0.4826715732667395,WSH,MIA,2022 REG,8,2,9,5,7,17,0,1,-3,3,1,1,0,0,0,0,0,0,0,0.4826715732667395,0.5173284267332605
85895,0.47619047619047616,0.5594713656387665,110,-127,0.4592086467479796,0.5407913532520203,home,WSH,under,7.5,0.5391705069124424,-117,0.5173284267332605,WSH,MIA,2022 REG,8,2,9,5,7,17,0,1,-3,3,1,1,0,0,0,0,0,0,0,0.4826715732667395,0.5173284267332605
85896,0.3389830508474576,0.7014925373134329,195,-235,0.3252625124878337,0.6747374875121663,away,ATL,over,8,0.5283018867924528,-112,0.5056562298022652,OAK,ATL,2022 REG,9,9,13,10,19,22,0,1,-1,1,1,1,1,1,1,1,1,1,1,0.5056562298022652,0.4943437701977348
85896,0.3389830508474576,0.7014925373134329,195,-235,0.3252625124878337,0.6747374875121663,home,OAK,under,8,0.5145631067961165,-106,0.4943437701977348,OAK,ATL,2022 REG,9,9,13,10,19,22,0,1,-1,1,1,1,1,1,1,1,1,1,1,0.5056562298022652,0.4943437701977348
85897,0.5348837209302326,0.5073891625615764,-115,-103,0.5122726437136835,0.48772735628631647,away,BOS,over,8.5,0.5305164319248826,-113,0.5053568787472517,TEX,BOS,2022 REG,7,3,14,11,14,21,0,1,-8,8,1,1,1,0,0,0,0,0,0,0.5053568787472517,0.49464312125274834
85897,0.5348837209302326,0.5073891625615764,-115,-103,0.5122726437136835,0.48772735628631647,home,TEX,under,8.5,0.5169082125603864,-107,0.49464312125274834,TEX,BOS,2022 REG,7,3,14,11,14,21,0,1,-8,8,1,1,1,0,0,0,0,0,0,0.5053568787472517,0.49464312125274834
85898,0.5652173913043479,0.4807692307692307,-130,108,0.5392249527410209,0.4607750472589791,away,MIA,over,9,0.5412844036697247,-118,0.5175913212324037,WSH,MIA,2022 REG,5,3,12,6,9,17,0,1,-3,3,1,1,1,0,0,0,0,0,0,0.5175913212324037,0.4824086787675963
85898,0.5652173913043479,0.4807692307692307,-130,108,0.5392249527410209,0.4607750472589791,home,WSH,under,9,0.5024875621890548,-101,0.4824086787675963,WSH,MIA,2022 REG,5,3,12,6,9,17,0,1,-3,3,1,1,1,0,0,0,0,0,0,0.5175913212324037,0.4824086787675963
85899,0.43859649122807015,0.6000000000000001,128,-150,0.4216682056017235,0.5783317943982764,away,CHC,over,9.5,0.5,100,0.4772727272727273,CIN,CHC,2022 REG,13,8,12,5,13,25,1,0,3,-3,1,1,1,1,1,0,0,0,0,0.4772727272727273,0.5227272727272727
85899,0.43859649122807015,0.6000000000000001,128,-150,0.4216682056017235,0.5783317943982764,home,CIN,under,9.5,0.5454545454545454,-120,0.5227272727272727,CIN,CHC,2022 REG,13,8,12,5,13,25,1,0,3,-3,1,1,1,1,1,0,0,0,0,0.4772727272727273,0.5227272727272727
85900,0.47619047619047616,0.5652173913043479,110,-130,0.4564724440500838,0.5435275559499162,away,ARI,over,7.5,0.5,100,0.4772727272727273,KC,ARI,2022 REG,7,5,5,3,8,12,1,0,2,-2,1,1,1,0,0,0,0,0,0,0.4772727272727273,0.5227272727272727
85900,0.47619047619047616,0.5652173913043479,110,-130,0.4564724440500838,0.5435275559499162,home,KC,under,7.5,0.5454545454545454,-120,0.5227272727272727,KC,ARI,2022 REG,7,5,5,3,8,12,1,0,2,-2,1,1,1,0,0,0,0,0,0,0.4772727272727273,0.5227272727272727
85901,0.6923076923076923,0.3472222222222222,-225,188,0.6649408284023669,0.3350591715976331,away,STL,over,8.5,0.5412844036697247,-118,0.5189377998484975,TOR,STL,2022 REG,14,10,8,3,13,22,1,0,7,-7,1,1,1,0,0,0,0,0,0,0.5189377998484975,0.4810622001515025
85901,0.6923076923076923,0.3472222222222222,-225,188,0.6649408284023669,0.3350591715976331,home,TOR,under,8.5,0.5,100,0.4810622001515025,TOR,STL,2022 REG,14,10,8,3,13,22,1,0,7,-7,1,1,1,0,0,0,0,0,0,0.5189377998484975,0.4810622001515025
85902,0.6254681647940076,0.41152263374485604,-167,143,0.6023315979176397,0.3976684020823603,away,PIT,over,12,0.5283018867924528,-112,0.5031902949311281,COL,PIT,2022 REG,9,3,16,8,11,25,0,1,-5,5,1,1,1,0,0,0,0,0,0,0.5031902949311281,0.4968097050688719
85902,0.6254681647940076,0.41152263374485604,-167,143,0.6023315979176397,0.3976684020823603,home,COL,under,12,0.5192307692307692,-108,0.4968097050688719,COL,PIT,2022 REG,9,3,16,8,11,25,0,1,-5,5,1,1,1,0,0,0,0,0,0,0.5031902949311281,0.4968097050688719
85903,0.7354497354497355,0.3076923076923077,-278,225,0.7037209312341587,0.2962790687658413,away,WSH,over,9,0.504950495049505,-102,0.48160416005266615,LAD,WSH,2022 REG,11,7,5,1,8,16,1,0,6,-6,1,0,0,0,0,0,0,0,0,0.48160416005266615,0.5183958399473338
85903,0.7354497354497355,0.3076923076923077,-278,225,0.7037209312341587,0.2962790687658413,home,LAD,under,9,0.5412844036697247,-118,0.5183958399473338,LAD,WSH,2022 REG,11,7,5,1,8,16,1,0,6,-6,1,0,0,0,0,0,0,0,0,0.48160416005266615,0.5183958399473338
85904,0.48780487804878053,0.5555555555555556,105,-125,0.4666534470222751,0.5333465529777248,away,CWS,over,6.5,0.5454545454545454,-120,0.5206611570247933,MIN,CWS,2022 REG,10,4,2,0,4,12,1,0,4,-4,0,0,0,0,0,0,0,0,0,0.5206611570247933,0.4793388429752067
85904,0.48780487804878053,0.5555555555555556,105,-125,0.4666534470222751,0.5333465529777248,home,MIN,under,6.5,0.5,100,0.4793388429752067,MIN,CWS,2022 REG,10,4,2,0,4,12,1,0,4,-4,0,0,0,0,0,0,0,0,0,0.5206611570247933,0.4793388429752067
85905,0.6108949416342413,0.425531914893617,-157,135,0.5886419592417365,0.41135804075826354,away,OAK,over,7.5,0.5121951219512195,-105,0.48808156828023186,LAA,OAK,2022 REG,8,5,7,3,8,15,1,0,2,-2,1,1,1,0,0,0,0,0,0,0.48808156828023186,0.5119184317197681
85905,0.6108949416342413,0.425531914893617,-157,135,0.5886419592417365,0.41135804075826354,home,LAA,under,7.5,0.5348837209302326,-115,0.5119184317197681,LAA,OAK,2022 REG,8,5,7,3,8,15,1,0,2,-2,1,1,1,0,0,0,0,0,0,0.48808156828023186,0.5119184317197681
85906,0.6153846153846154,0.425531914893617,-160,135,0.5902052121364724,0.40979478786352763,away,BAL,over,9,0.5238095238095238,-110,0.5000596729920038,TOR,BAL,2022 REG,8,3,8,7,10,16,0,1,-4,4,1,1,1,0,0,0,0,0,0,0.5000596729920038,0.4999403270079962
85906,0.6153846153846154,0.425531914893617,-160,135,0.5902052121364724,0.40979478786352763,home,TOR,under,9,0.5215311004784688,-109,0.4999403270079962,TOR,BAL,2022 REG,8,3,8,7,10,16,0,1,-4,4,1,1,1,0,0,0,0,0,0,0.5000596729920038,0.4999403270079962
85907,0.4716981132075471,0.5726495726495727,112,-134,0.4507793934636226,0.5492206065363774,away,LAA,over,8.5,0.5145631067961165,-106,0.4913668392989033,TEX,LAA,2022 REG,11,10,11,5,15,22,1,0,5,-5,1,1,1,1,1,0,0,0,0,0.4913668392989033,0.5086331607010968
85907,0.4716981132075471,0.5726495726495727,112,-134,0.4507793934636226,0.5492206065363774,home,TEX,under,8.5,0.5305164319248826,-113,0.5086331607010968,TEX,LAA,2022 REG,11,10,11,5,15,22,1,0,5,-5,1,1,1,1,1,0,0,0,0,0.4913668392989033,0.5086331607010968
85908,0.6428571428571428,0.3921568627450981,-180,155,0.6203481392557023,0.3796518607442977,away,PIT,over,8.5,0.504950495049505,-102,0.48160416005266615,MIL,PIT,2022 REG,6,6,8,1,7,14,1,0,5,-5,1,0,0,0,0,0,0,0,0,0.48160416005266615,0.5183958399473338
85908,0.6428571428571428,0.3921568627450981,-180,155,0.6203481392557023,0.3796518607442977,home,MIL,under,8.5,0.5412844036697247,-118,0.5183958399473338,MIL,PIT,2022 REG,6,6,8,1,7,14,1,0,5,-5,1,0,0,0,0,0,0,0,0,0.48160416005266615,0.5183958399473338
85910,0.47619047619047616,0.5633187772925764,110,-129,0.45737654596045113,0.5426234540395489,away,MIN,over,7.5,0.49504950495049505,102,0.4719707862985384,OAK,MIN,2022 REG,4,1,8,3,4,12,0,1,-2,2,1,0,0,0,0,0,0,0,0,0.4719707862985384,0.5280292137014616
85910,0.47619047619047616,0.5633187772925764,110,-129,0.45737654596045113,0.5426234540395489,home,OAK,under,7.5,0.5515695067264574,-123,0.5280292137014616,OAK,MIN,2022 REG,4,1,8,3,4,12,0,1,-2,2,1,0,0,0,0,0,0,0,0,0.4719707862985384,0.5280292137014616
85911,0.49504950495049505,0.5454545454545454,102,-120,0.47499799484898986,0.5250020051510101,away,BOS,over,7.5,0.5,100,0.4772727272727273,TB,BOS,2022 REG,6,3,6,2,5,12,1,0,1,-1,1,1,0,0,0,0,0,0,0,0.4772727272727273,0.5227272727272727
85911,0.49504950495049505,0.5454545454545454,102,-120,0.47499799484898986,0.5250020051510101,home,TB,under,7.5,0.5454545454545454,-120,0.5227272727272727,TB,BOS,2022 REG,6,3,6,2,5,12,1,0,1,-1,1,1,0,0,0,0,0,0,0,0.4772727272727273,0.5227272727272727
85912,0.6363636363636364,0.4065040650406504,-175,146,0.6090841900154538,0.3909158099845462,away,CIN,over,8.5,0.5121951219512195,-105,0.48808156828023186,STL,CIN,2022 REG,12,11,4,3,14,16,1,0,8,-8,1,1,1,0,0,0,0,0,0,0.48808156828023186,0.5119184317197681
85912,0.6363636363636364,0.4065040650406504,-175,146,0.6090841900154538,0.3909158099845462,home,STL,under,8.5,0.5348837209302326,-115,0.5119184317197681,STL,CIN,2022 REG,12,11,4,3,14,16,1,0,8,-8,1,1,1,0,0,0,0,0,0,0.48808156828023186,0.5119184317197681
85913,0.5305164319248826,0.5073891625615764,-113,-103,0.5104068911879349,0.4895931088120651,away,BAL,over,9,0.5348837209302326,-115,0.5097020142727117,CIN,BAL,2022 REG,13,8,6,2,10,19,1,0,6,-6,1,1,0,0,0,0,0,0,0,0.5097020142727117,0.49029798572728833
85913,0.5305164319248826,0.5073891625615764,-113,-103,0.5104068911879349,0.4895931088120651,home,CIN,under,9,0.5121951219512195,-105,0.49029798572728833,CIN,BAL,2022 REG,13,8,6,2,10,19,1,0,6,-6,1,1,0,0,0,0,0,0,0,0.5097020142727117,0.49029798572728833
85914,0.6108949416342413,0.43103448275862066,-157,132,0.5852804683670066,0.41471953163299335,away,OAK,over,7,0.5192307692307692,-108,0.49571111079951763,SEA,OAK,2022 REG,9,5,13,7,12,22,0,1,-2,2,1,1,1,1,1,0,0,0,0,0.49571111079951763,0.5042888892004824
85914,0.6108949416342413,0.43103448275862066,-157,132,0.5852804683670066,0.41471953163299335,home,SEA,under,7,0.5260663507109005,-111,0.5042888892004824,SEA,OAK,2022 REG,9,5,13,7,12,22,0,1,-2,2,1,1,1,1,1,0,0,0,0,0.49571111079951763,0.5042888892004824
85915,0.6666666666666666,0.37037037037037035,-200,170,0.6419753086419753,0.3580246913580247,away,MIN,over,6.5,0.5,100,0.4772727272727273,NYY,MIN,2022 REG,6,7,8,1,8,14,1,0,6,-6,1,0,0,0,0,0,0,0,0,0.4772727272727273,0.5227272727272727
85915,0.6666666666666666,0.37037037037037035,-200,170,0.6419753086419753,0.3580246913580247,home,NYY,under,6.5,0.5454545454545454,-120,0.5227272727272727,NYY,MIN,2022 REG,6,7,8,1,8,14,1,0,6,-6,1,0,0,0,0,0,0,0,0,0.4772727272727273,0.5227272727272727
85917,0.6226415094339623,0.4166666666666667,-165,140,0.5981666073335706,0.40183339266642937,away,MIA,over,7.5,0.5073891625615764,-103,0.4826927225525911,LAD,MIA,2022 REG,16,10,6,3,13,22,1,0,7,-7,1,1,1,0,0,0,0,0,0,0.4826927225525911,0.5173072774474089
85917,0.6226415094339623,0.4166666666666667,-165,140,0.5981666073335706,0.40183339266642937,home,LAD,under,7.5,0.5412844036697247,-118,0.5173072774474089,LAD,MIA,2022 REG,16,10,6,3,13,22,1,0,7,-7,1,1,1,0,0,0,0,0,0,0.4826927225525911,0.5173072774474089
85918,0.4347826086956522,0.6000000000000001,130,-150,0.4196597353497164,0.5803402646502835,away,SD,over,10.5,0.5238095238095238,-110,0.4988662131519274,COL,SD,2022 REG,12,6,17,13,19,29,0,1,-7,7,1,1,1,1,1,1,0,0,0,0.4988662131519274,0.5011337868480725
85918,0.4347826086956522,0.6000000000000001,130,-150,0.4196597353497164,0.5803402646502835,home,COL,under,10.5,0.5238095238095238,-110,0.5011337868480725,COL,SD,2022 REG,12,6,17,13,19,29,0,1,-7,7,1,1,1,1,1,1,0,0,0,0.4988662131519274,0.5011337868480725
85919,0.4098360655737705,0.6363636363636364,144,-175,0.3909017615010627,0.6090982384989373,away,LAD,over,12,0.5238095238095238,-110,0.5012646084074657,COL,LAD,2022 REG,10,9,10,4,13,20,1,0,5,-5,1,1,1,1,0,0,0,0,0,0.5012646084074657,0.4987353915925343
85919,0.4098360655737705,0.6363636363636364,144,-175,0.3909017615010627,0.6090982384989373,home,COL,under,12,0.5192307692307692,-108,0.4987353915925343,COL,LAD,2022 REG,10,9,10,4,13,20,1,0,5,-5,1,1,1,1,0,0,0,0,0,0.5012646084074657,0.4987353915925343
85920,0.5535714285714286,0.48780487804878053,-124,105,0.53066668740667,0.46933331259333,away,KC,over,8,0.5145631067961165,-106,0.49023796582517226,DET,KC,2022 REG,7,2,9,3,5,16,0,1,-1,1,1,1,0,0,0,0,0,0,0,0.49023796582517226,0.5097620341748277
85920,0.5535714285714286,0.48780487804878053,-124,105,0.53066668740667,0.46933331259333,home,DET,under,8,0.5327102803738317,-114,0.5097620341748277,DET,KC,2022 REG,7,2,9,3,5,16,0,1,-1,1,1,1,0,0,0,0,0,0,0,0.49023796582517226,0.5097620341748277
85921,0.7752808988764045,0.2631578947368421,-345,280,0.7454800364122021,0.25451996358779794,away,WSH,over,8.5,0.5305164319248826,-113,0.5053568787472517,ATL,WSH,2022 REG,7,3,8,2,5,15,1,0,1,-1,1,1,0,0,0,0,0,0,0,0.5053568787472517,0.49464312125274834
85921,0.7752808988764045,0.2631578947368421,-345,280,0.7454800364122021,0.25451996358779794,home,ATL,under,8.5,0.5169082125603864,-107,0.49464312125274834,ATL,WSH,2022 REG,7,3,8,2,5,15,1,0,1,-1,1,1,0,0,0,0,0,0,0,0.5053568787472517,0.49464312125274834
85922,0.5098039215686274,0.5305164319248826,-104,-113,0.4892484472386027,0.5107515527613973,away,DET,over,8.5,0.5327102803738317,-114,0.508788710910954,CLE,DET,2022 REG,10,6,3,1,7,13,1,0,5,-5,1,0,0,0,0,0,0,0,0,0.508788710910954,0.491211289089046
85922,0.5098039215686274,0.5305164319248826,-104,-113,0.4892484472386027,0.5107515527613973,home,CLE,under,8.5,0.5121951219512195,-105,0.491211289089046,CLE,DET,2022 REG,10,6,3,1,7,13,1,0,5,-5,1,0,0,0,0,0,0,0,0,0.508788710910954,0.491211289089046
85923,0.4291845493562232,0.607843137254902,133,-155,0.41329283836432396,0.586707161635676,away,BOS,over,8.5,0.5192307692307692,-108,0.49571111079951763,BAL,BOS,2022 REG,13,9,11,5,14,24,1,0,4,-4,1,1,1,1,1,0,0,0,0,0.49571111079951763,0.5042888892004824
85923,0.4291845493562232,0.607843137254902,133,-155,0.41329283836432396,0.586707161635676,home,BAL,under,8.5,0.5260663507109005,-111,0.5042888892004824,BAL,BOS,2022 REG,13,9,11,5,14,24,1,0,4,-4,1,1,1,1,1,0,0,0,0,0.49571111079951763,0.5042888892004824
85924,0.6491228070175439,0.4,-185,150,0.6172360726377346,0.3827639273622654,away,KC,over,7.5,0.5283018867924528,-112,0.5031902949311281,SEA,KC,2022 REG,10,5,9,4,9,19,1,0,1,-1,1,1,1,1,0,0,0,0,0,0.5031902949311281,0.4968097050688719
85924,0.6491228070175439,0.4,-185,150,0.6172360726377346,0.3827639273622654,home,SEA,under,7.5,0.5192307692307692,-108,0.4968097050688719,SEA,KC,2022 REG,10,5,9,4,9,19,1,0,1,-1,1,1,1,1,0,0,0,0,0,0.5031902949311281,0.4968097050688719
85925,0.5833333333333333,0.4587155963302753,-140,118,0.5588047910295616,0.4411952089704384,away,TB,over,6.5,0.5495495495495495,-122,0.5236866555946829,NYY,TB,2022 REG,3,4,7,3,7,10,1,0,1,-1,1,1,1,0,0,0,0,0,0,0.5236866555946829,0.47631334440531714
85925,0.5833333333333333,0.4587155963302753,-140,118,0.5588047910295616,0.4411952089704384,home,NYY,under,6.5,0.49751243781094534,101,0.47631334440531714,NYY,TB,2022 REG,3,4,7,3,7,10,1,0,1,-1,1,1,1,0,0,0,0,0,0,0.5236866555946829,0.47631334440531714
85926,0.782608695652174,0.2531645569620253,-360,295,0.7546122370845398,0.24538776291546016,away,DET,over,8.5,0.5348837209302326,-115,0.5097020142727117,TOR,DET,2022 REG,4,2,9,4,6,13,0,1,-2,2,1,1,0,0,0,0,0,0,0,0.5097020142727117,0.49029798572728833
85926,0.782608695652174,0.2531645569620253,-360,295,0.7546122370845398,0.24538776291546016,home,TOR,under,8.5,0.5121951219512195,-105,0.49029798572728833,TOR,DET,2022 REG,4,2,9,4,6,13,0,1,-2,2,1,1,0,0,0,0,0,0,0,0.5097020142727117,0.49029798572728833
85927,0.7142857142857143,0.31746031746031744,-250,215,0.6916099773242631,0.3083900226757369,away,TEX,over,7.5,0.5283018867924528,-112,0.5044173060022736,HOU,TEX,2022 REG,6,2,10,1,3,16,1,0,1,-1,1,0,0,0,0,0,0,0,0,0.5044173060022736,0.49558269399772636
85927,0.7142857142857143,0.31746031746031744,-250,215,0.6916099773242631,0.3083900226757369,home,HOU,under,7.5,0.5169082125603864,-107,0.49558269399772636,HOU,TEX,2022 REG,6,2,10,1,3,16,1,0,1,-1,1,0,0,0,0,0,0,0,0,0.5044173060022736,0.49558269399772636
85928,0.5169082125603864,0.5192307692307692,-107,-108,0.4982276760789678,0.5017723239210322,away,TOR,over,8.5,0.5121951219512195,-105,0.48808156828023186,LAA,TOR,2022 REG,13,5,10,6,11,23,0,1,-1,1,1,1,1,1,1,0,0,0,0,0.48808156828023186,0.5119184317197681
85928,0.5169082125603864,0.5192307692307692,-107,-108,0.4982276760789678,0.5017723239210322,home,LAA,under,8.5,0.5348837209302326,-115,0.5119184317197681,LAA,TOR,2022 REG,13,5,10,6,11,23,0,1,-1,1,1,1,1,1,1,0,0,0,0,0.48808156828023186,0.5119184317197681
85929,0.42372881355932196,0.6183206106870228,136,-162,0.40591126091256574,0.5940887390874343,away,CLE,over,6.5,0.5412844036697247,-118,0.5149381613977361,OAK,CLE,2022 REG,8,1,9,3,4,17,0,1,-2,2,1,0,0,0,0,0,0,0,0,0.5149381613977361,0.48506183860226393
85929,0.42372881355932196,0.6183206106870228,136,-162,0.40591126091256574,0.5940887390874343,home,OAK,under,6.5,0.5073891625615764,-103,0.48506183860226393,OAK,CLE,2022 REG,8,1,9,3,4,17,0,1,-2,2,1,0,0,0,0,0,0,0,0,0.5149381613977361,0.48506183860226393
85931,0.607843137254902,0.43103448275862066,-155,132,0.5842116427368785,0.41578835726312147,away,KC,over,7.5,0.504950495049505,-102,0.4826715732667395,SEA,KC,2022 REG,16,13,10,7,20,26,1,0,6,-6,1,1,1,1,1,1,1,0,0,0.4826715732667395,0.5173284267332605
85931,0.607843137254902,0.43103448275862066,-155,132,0.5842116427368785,0.41578835726312147,home,SEA,under,7.5,0.5391705069124424,-117,0.5173284267332605,SEA,KC,2022 REG,16,13,10,7,20,26,1,0,6,-6,1,1,1,1,1,1,1,0,0,0.4826715732667395,0.5173284267332605
85932,0.5967741935483871,0.4444444444444444,-148,125,0.5721759741010521,0.42782402589894786,away,COL,over,8,0.5348837209302326,-115,0.5109810284308424,ARI,COL,2022 REG,6,4,7,1,5,13,1,0,3,-3,1,0,0,0,0,0,0,0,0,0.5109810284308424,0.48901897156915763
85932,0.5967741935483871,0.4444444444444444,-148,125,0.5721759741010521,0.42782402589894786,home,ARI,under,8,0.5098039215686274,-104,0.48901897156915763,ARI,COL,2022 REG,6,4,7,1,5,13,1,0,3,-3,1,0,0,0,0,0,0,0,0,0.5109810284308424,0.48901897156915763
85933,0.5169082125603864,0.5192307692307692,-107,-108,0.4982276760789678,0.5017723239210322,away,ATL,over,7.5,0.5412844036697247,-118,0.5189377998484975,SD,ATL,2022 REG,4,2,9,5,7,13,0,1,-3,3,1,1,0,0,0,0,0,0,0,0.5189377998484975,0.4810622001515025
85933,0.5169082125603864,0.5192307692307692,-107,-108,0.4982276760789678,0.5017723239210322,home,SD,under,7.5,0.5,100,0.4810622001515025,SD,ATL,2022 REG,4,2,9,5,7,13,0,1,-3,3,1,1,0,0,0,0,0,0,0,0.5189377998484975,0.4810622001515025
85935,0.5454545454545454,0.49504950495049505,-120,102,0.5233614270517961,0.4766385729482039,away,DET,over,8,0.5073891625615764,-103,0.4837652908580103,KC,DET,2022 REG,8,5,8,2,7,16,1,0,3,-3,1,1,0,0,0,0,0,0,0,0.4837652908580103,0.5162347091419897
85935,0.5454545454545454,0.49504950495049505,-120,102,0.5233614270517961,0.4766385729482039,home,KC,under,8,0.5391705069124424,-117,0.5162347091419897,KC,DET,2022 REG,8,5,8,2,7,16,1,0,3,-3,1,1,0,0,0,0,0,0,0,0.4837652908580103,0.5162347091419897
85936,0.4347826086956522,0.6000000000000001,130,-150,0.4196597353497164,0.5803402646502835,away,MIA,over,10.5,0.5098039215686274,-104,0.4870219861770517,COL,MIA,2022 REG,10,7,5,1,8,15,1,0,6,-6,1,0,0,0,0,0,0,0,0,0.4870219861770517,0.5129780138229483
85936,0.4347826086956522,0.6000000000000001,130,-150,0.4196597353497164,0.5803402646502835,home,COL,under,10.5,0.5348837209302326,-115,0.5129780138229483,COL,MIA,2022 REG,10,7,5,1,8,15,1,0,6,-6,1,0,0,0,0,0,0,0,0,0.4870219861770517,0.5129780138229483
85938,0.5412844036697247,0.5,-118,100,0.5189377998484975,0.4810622001515025,away,LAD,over,7,0.5370370370370371,-116,0.5118817074154765,MIL,LAD,2022 REG,6,5,6,3,8,12,1,0,2,-2,1,1,1,0,0,0,0,0,0,0.5118817074154765,0.48811829258452355
85938,0.5412844036697247,0.5,-118,100,0.5189377998484975,0.4810622001515025,home,MIL,under,7,0.5098039215686274,-104,0.48811829258452355,MIL,LAD,2022 REG,6,5,6,3,8,12,1,0,2,-2,1,1,1,0,0,0,0,0,0,0.5118817074154765,0.48811829258452355
85939,0.4587155963302753,0.5780590717299579,118,-137,0.4418464825411775,0.5581535174588226,away,MIN,over,8.5,0.5215311004784688,-109,0.4978845547971712,KC,MIN,2022 REG,6,2,5,0,2,11,1,0,2,-2,0,0,0,0,0,0,0,0,0,0.4978845547971712,0.5021154452028288
85939,0.4587155963302753,0.5780590717299579,118,-137,0.4418464825411775,0.5581535174588226,home,KC,under,8.5,0.5238095238095238,-110,0.5021154452028288,KC,MIN,2022 REG,6,2,5,0,2,11,1,0,2,-2,0,0,0,0,0,0,0,0,0,0.4978845547971712,0.5021154452028288
85940,0.4444444444444444,0.6000000000000001,125,-150,0.4246913580246913,0.5753086419753086,away,BOS,over,9.5,0.5121951219512195,-105,0.48808156828023186,KC,BOS,2022 REG,8,5,8,4,9,16,1,0,1,-1,1,1,1,1,0,0,0,0,0,0.48808156828023186,0.5119184317197681
85940,0.4444444444444444,0.6000000000000001,125,-150,0.4246913580246913,0.5753086419753086,home,KC,under,9.5,0.5348837209302326,-115,0.5119184317197681,KC,BOS,2022 REG,8,5,8,4,9,16,1,0,1,-1,1,1,1,1,0,0,0,0,0,0.48808156828023186,0.5119184317197681
85941,0.5475113122171946,0.48780487804878053,-121,105,0.5281752985421585,0.4718247014578415,away,CLE,over,8.5,0.5327102803738317,-114,0.508788710910954,KC,CLE,2022 REG,6,1,5,0,1,11,1,0,1,-1,0,0,0,0,0,0,0,0,0,0.508788710910954,0.491211289089046
85941,0.5475113122171946,0.48780487804878053,-121,105,0.5281752985421585,0.4718247014578415,home,KC,under,8.5,0.5121951219512195,-105,0.491211289089046,KC,CLE,2022 REG,6,1,5,0,1,11,1,0,1,-1,0,0,0,0,0,0,0,0,0,0.508788710910954,0.491211289089046
85942,0.5689655172413793,0.46511627906976744,-132,115,0.5495741503746924,0.45042584962530763,away,BOS,over,9,0.5098039215686274,-104,0.48375889301574193,MIN,BOS,2022 REG,9,10,7,5,15,16,1,0,5,-5,1,1,1,1,1,0,0,0,0,0.48375889301574193,0.5162411069842581
85942,0.5689655172413793,0.46511627906976744,-132,115,0.5495741503746924,0.45042584962530763,home,MIN,under,9,0.5412844036697247,-118,0.5162411069842581,MIN,BOS,2022 REG,9,10,7,5,15,16,1,0,5,-5,1,1,1,1,1,0,0,0,0,0.48375889301574193,0.5162411069842581
85943,0.6363636363636364,0.40322580645161293,-175,148,0.6111703545721141,0.3888296454278859,away,KC,over,7,0.5145631067961165,-106,0.4925063625223866,CWS,KC,2022 REG,9,7,4,3,10,13,1,0,4,-4,1,1,1,0,0,0,0,0,0,0.4925063625223866,0.5074936374776133
85943,0.6363636363636364,0.40322580645161293,-175,148,0.6111703545721141,0.3888296454278859,home,CWS,under,7,0.5283018867924528,-112,0.5074936374776133,CWS,KC,2022 REG,9,7,4,3,10,13,1,0,4,-4,1,1,1,0,0,0,0,0,0,0.4925063625223866,0.5074936374776133
85944,0.726027397260274,0.3125,-265,220,0.6980554513041847,0.30194454869581533,away,ARI,over,7.5,0.5,100,0.4772727272727273,MIL,ARI,2022 REG,7,6,7,5,11,14,1,0,1,-1,1,1,1,1,1,0,0,0,0,0.4772727272727273,0.5227272727272727
85944,0.726027397260274,0.3125,-265,220,0.6980554513041847,0.30194454869581533,home,MIL,under,7.5,0.5454545454545454,-120,0.5227272727272727,MIL,ARI,2022 REG,7,6,7,5,11,14,1,0,1,-1,1,1,1,1,1,0,0,0,0,0.4772727272727273,0.5227272727272727
85947,0.4444444444444444,0.5967741935483871,125,-148,0.42612504978096366,0.5738749502190363,away,MIL,over,7.5,0.5192307692307692,-108,0.49688292476754015,STL,MIL,2022 REG,5,4,8,2,6,13,1,0,2,-2,1,1,0,0,0,0,0,0,0,0.49688292476754015,0.5031170752324599
85947,0.4444444444444444,0.5967741935483871,125,-148,0.42612504978096366,0.5738749502190363,home,STL,under,7.5,0.5238095238095238,-110,0.5031170752324599,STL,MIL,2022 REG,5,4,8,2,6,13,1,0,2,-2,1,1,0,0,0,0,0,0,0,0.49688292476754015,0.5031170752324599
85948,0.5652173913043479,0.47619047619047616,-130,110,0.5418129444594474,0.4581870555405526,away,PIT,over,8.5,0.5454545454545454,-120,0.5206611570247933,WSH,PIT,2022 REG,6,3,6,1,4,12,1,0,2,-2,1,0,0,0,0,0,0,0,0,0.5206611570247933,0.4793388429752067
85948,0.5652173913043479,0.47619047619047616,-130,110,0.5418129444594474,0.4581870555405526,home,WSH,under,8.5,0.5,100,0.4793388429752067,WSH,PIT,2022 REG,6,3,6,1,4,12,1,0,2,-2,1,0,0,0,0,0,0,0,0,0.5206611570247933,0.4793388429752067
85949,0.5238095238095238,0.5192307692307692,-110,-108,0.5012646084074657,0.4987353915925343,away,BOS,over,8.5,0.5454545454545454,-120,0.5220180091279142,BAL,BOS,2022 REG,18,15,19,10,25,37,1,0,5,-5,1,1,1,1,1,1,1,1,1,0.5220180091279142,0.4779819908720858
85949,0.5238095238095238,0.5192307692307692,-110,-108,0.5012646084074657,0.4987353915925343,home,BAL,under,8.5,0.49751243781094534,101,0.4779819908720858,BAL,BOS,2022 REG,18,15,19,10,25,37,1,0,5,-5,1,1,1,1,1,1,1,1,1,0.5220180091279142,0.4779819908720858
85951,0.6183206106870228,0.4166666666666667,-162,140,0.5966872559874133,0.40331274401258665,away,OAK,over,8.5,0.5145631067961165,-106,0.4913668392989033,KC,OAK,2022 REG,6,3,8,5,8,14,0,1,-2,2,1,1,1,0,0,0,0,0,0,0.4913668392989033,0.5086331607010968
85951,0.6183206106870228,0.4166666666666667,-162,140,0.5966872559874133,0.40331274401258665,home,KC,under,8.5,0.5305164319248826,-113,0.5086331607010968,KC,OAK,2022 REG,6,3,8,5,8,14,0,1,-2,2,1,1,1,0,0,0,0,0,0,0.4913668392989033,0.5086331607010968
85952,0.7894736842105263,0.25641025641025644,-375,290,0.75324952056254,0.24675047943745998,away,OAK,over,7,0.5535714285714286,-124,0.5266562689432208,HOU,OAK,2022 REG,8,5,3,0,5,11,1,0,5,-5,0,0,0,0,0,0,0,0,0,0.5266562689432208,0.4733437310567792
85952,0.7894736842105263,0.25641025641025644,-375,290,0.75324952056254,0.24675047943745998,home,HOU,under,7,0.49504950495049505,102,0.4733437310567792,HOU,OAK,2022 REG,8,5,3,0,5,11,1,0,5,-5,0,0,0,0,0,0,0,0,0,0.5266562689432208,0.4733437310567792
85953,0.5495495495495495,0.4854368932038835,-122,106,0.5303227656940593,0.46967723430594066,away,NYM,over,8.5,0.5215311004784688,-109,0.49670754937970685,PHI,NYM,2022 REG,9,6,9,9,15,18,0,1,-3,3,1,1,1,1,1,1,0,0,0,0.49670754937970685,0.5032924506202932
85953,0.5495495495495495,0.4854368932038835,-122,106,0.5303227656940593,0.46967723430594066,home,PHI,under,8.5,0.5260663507109005,-111,0.5032924506202932,PHI,NYM,2022 REG,9,6,9,9,15,18,0,1,-3,3,1,1,1,1,1,1,0,0,0,0.49670754937970685,0.5032924506202932
85954,0.3921568627450981,0.6453900709219857,155,-182,0.37743257503251615,0.6225674249674839,away,HOU,over,7,0.5145631067961165,-106,0.4913668392989033,OAK,HOU,2022 REG,2,1,6,5,6,8,0,1,-4,4,1,0,0,0,0,0,0,0,0,0.4913668392989033,0.5086331607010968
85954,0.3921568627450981,0.6453900709219857,155,-182,0.37743257503251615,0.6225674249674839,home,OAK,under,7,0.5305164319248826,-113,0.5086331607010968,OAK,HOU,2022 REG,2,1,6,5,6,8,0,1,-4,4,1,0,0,0,0,0,0,0,0,0.4913668392989033,0.5086331607010968
85955,0.5555555555555556,0.47619047619047616,-125,110,0.5379188712522047,0.4620811287477953,away,SEA,over,7.5,0.5192307692307692,-108,0.49688292476754015,KC,SEA,2022 REG,10,5,6,1,6,16,1,0,4,-4,1,0,0,0,0,0,0,0,0,0.49688292476754015,0.5031170752324599
85955,0.5555555555555556,0.47619047619047616,-125,110,0.5379188712522047,0.4620811287477953,home,KC,under,7.5,0.5238095238095238,-110,0.5031170752324599,KC,SEA,2022 REG,10,5,6,1,6,16,1,0,4,-4,1,0,0,0,0,0,0,0,0,0.49688292476754015,0.5031170752324599
85956,0.4347826086956522,0.6000000000000001,130,-150,0.4196597353497164,0.5803402646502835,away,MIL,over,7,0.4926108374384236,103,0.46986095270450623,CHC,MIL,2022 REG,5,2,7,5,7,12,0,1,-3,3,1,1,0,0,0,0,0,0,0,0.46986095270450623,0.5301390472954938
85956,0.4347826086956522,0.6000000000000001,130,-150,0.4196597353497164,0.5803402646502835,home,CHC,under,7,0.5535714285714286,-124,0.5301390472954938,CHC,MIL,2022 REG,5,2,7,5,7,12,0,1,-3,3,1,1,0,0,0,0,0,0,0,0.46986095270450623,0.5301390472954938
85959,0.5884773662551441,0.4484304932735426,-143,123,0.5667579262855877,0.43324207371441226,away,MIA,over,7.5,0.5,100,0.4772727272727273,SF,MIA,2022 REG,6,6,9,5,11,15,1,0,1,-1,1,1,1,1,1,0,0,0,0,0.4772727272727273,0.5227272727272727
85959,0.5884773662551441,0.4484304932735426,-143,123,0.5667579262855877,0.43324207371441226,home,SF,under,7.5,0.5454545454545454,-120,0.5227272727272727,SF,MIA,2022 REG,6,6,9,5,11,15,1,0,1,-1,1,1,1,1,1,0,0,0,0,0.4772727272727273,0.5227272727272727
85960,0.4081632653061224,0.6363636363636364,145,-175,0.3899890197266291,0.6100109802733709,away,ATL,over,9,0.5145631067961165,-106,0.49023796582517226,ARI,ATL,2022 REG,12,8,14,7,15,26,1,0,1,-1,1,1,1,1,1,1,1,0,0,0.49023796582517226,0.5097620341748277
85960,0.4081632653061224,0.6363636363636364,145,-175,0.3899890197266291,0.6100109802733709,home,ARI,under,9,0.5327102803738317,-114,0.5097620341748277,ARI,ATL,2022 REG,12,8,14,7,15,26,1,0,1,-1,1,1,1,1,1,1,1,0,0,0.49023796582517226,0.5097620341748277
85961,0.5726495726495727,0.4672897196261683,-134,114,0.5497783539959433,0.4502216460040567,away,NYM,over,7,0.5348837209302326,-115,0.5097020142727117,SD,NYM,2022 REG,16,13,5,2,15,21,1,0,11,-11,1,1,0,0,0,0,0,0,0,0.5097020142727117,0.49029798572728833
85961,0.5726495726495727,0.4672897196261683,-134,114,0.5497783539959433,0.4502216460040567,home,SD,under,7,0.5121951219512195,-105,0.49029798572728833,SD,NYM,2022 REG,16,13,5,2,15,21,1,0,11,-11,1,1,0,0,0,0,0,0,0,0.5097020142727117,0.49029798572728833
85962,0.48309178743961345,0.5535714285714286,107,-124,0.4653800888835545,0.5346199111164456,away,MIL,over,7,0.5121951219512195,-105,0.48808156828023186,STL,MIL,2022 REG,10,4,10,1,5,20,1,0,3,-3,1,0,0,0,0,0,0,0,0,0.48808156828023186,0.5119184317197681
85962,0.48309178743961345,0.5535714285714286,107,-124,0.4653800888835545,0.5346199111164456,home,STL,under,7,0.5348837209302326,-115,0.5119184317197681,STL,MIL,2022 REG,10,4,10,1,5,20,1,0,3,-3,1,0,0,0,0,0,0,0,0,0.48808156828023186,0.5119184317197681
85963,0.4716981132075471,0.574468085106383,112,-135,0.44992160456890085,0.5500783954310992,away,TOR,over,9.5,0.5098039215686274,-104,0.48375889301574193,BAL,TOR,2022 REG,9,7,12,4,11,21,1,0,3,-3,1,1,1,1,0,0,0,0,0,0.48375889301574193,0.5162411069842581
85963,0.4716981132075471,0.574468085106383,112,-135,0.44992160456890085,0.5500783954310992,home,BAL,under,9.5,0.5412844036697247,-118,0.5162411069842581,BAL,TOR,2022 REG,9,7,12,4,11,21,1,0,3,-3,1,1,1,1,0,0,0,0,0,0.48375889301574193,0.5162411069842581
85964,0.5535714285714286,0.48309178743961345,-124,107,0.5332757197081732,0.4667242802918268,away,CWS,over,8.5,0.5454545454545454,-120,0.5179608869977906,LAA,CWS,2022 REG,9,4,17,11,15,26,0,1,-7,7,1,1,1,1,0,0,0,0,0,0.5179608869977906,0.48203911300220936
85964,0.5535714285714286,0.48309178743961345,-124,107,0.5332757197081732,0.4667242802918268,home,LAA,under,8.5,0.504950495049505,-102,0.48203911300220936,LAA,CWS,2022 REG,9,4,17,11,15,26,0,1,-7,7,1,1,1,1,0,0,0,0,0,0.5179608869977906,0.48203911300220936
85965,0.5918367346938775,0.45454545454545453,-145,120,0.5643860512665178,0.43561394873348225,away,NYM,over,8,0.5391705069124424,-117,0.5140669063204599,PHI,NYM,2022 REG,12,7,11,8,15,23,0,1,-1,1,1,1,1,1,1,1,1,0,0,0.5140669063204599,0.4859330936795401
85965,0.5918367346938775,0.45454545454545453,-145,120,0.5643860512665178,0.43561394873348225,home,PHI,under,8,0.5073891625615764,-103,0.4859330936795401,PHI,NYM,2022 REG,12,7,11,8,15,23,0,1,-1,1,1,1,1,1,1,1,1,0,0,0.5140669063204599,0.4859330936795401
85966,0.5121951219512195,0.5454545454545454,-105,-120,0.4826672435238765,0.5173327564761234,away,NYM,over,15.5,0.5815899581589958,-139,0.5479854377632778,COL,NYM,2022 REG,12,11,8,3,14,20,1,0,8,-8,1,1,1,0,0,0,0,0,0,0.5479854377632778,0.4520145622367222
85966,0.5121951219512195,0.5454545454545454,-105,-120,0.4826672435238765,0.5173327564761234,home,COL,under,15.5,0.47619047619047616,110,0.4520145622367222,COL,NYM,2022 REG,12,11,8,3,14,20,1,0,8,-8,1,1,1,0,0,0,0,0,0,0.5479854377632778,0.4520145622367222
85967,0.7752808988764045,0.2631578947368421,-345,280,0.7454800364122021,0.25451996358779794,away,WSH,over,7.5,0.5454545454545454,-120,0.5179608869977906,SD,WSH,2022 REG,4,3,9,6,9,13,0,1,-3,3,1,1,1,0,0,0,0,0,0,0.5179608869977906,0.48203911300220936
85967,0.7752808988764045,0.2631578947368421,-345,280,0.7454800364122021,0.25451996358779794,home,SD,under,7.5,0.504950495049505,-102,0.48203911300220936,SD,WSH,2022 REG,4,3,9,6,9,13,0,1,-3,3,1,1,1,0,0,0,0,0,0,0.5179608869977906,0.48203911300220936
85969,0.37037037037037035,0.6610169491525424,170,-195,0.35874543721373603,0.641254562786264,away,MIL,over,11,0.5348837209302326,-115,0.5097020142727117,COL,MIL,2022 REG,10,10,9,7,17,19,1,0,3,-3,1,1,1,1,1,1,1,0,0,0.5097020142727117,0.49029798572728833
85969,0.37037037037037035,0.6610169491525424,170,-195,0.35874543721373603,0.641254562786264,home,COL,under,11,0.5121951219512195,-105,0.49029798572728833,COL,MIL,2022 REG,10,10,9,7,17,19,1,0,3,-3,1,1,1,1,1,1,1,0,0,0.5097020142727117,0.49029798572728833
85970,0.4081632653061224,0.6363636363636364,145,-175,0.3899890197266291,0.6100109802733709,away,LAD,over,7.5,0.5238095238095238,-110,0.4988662131519274,MIL,LAD,2022 REG,4,0,6,4,4,10,0,1,-4,4,0,0,0,0,0,0,0,0,0,0.4988662131519274,0.5011337868480725
85970,0.4081632653061224,0.6363636363636364,145,-175,0.3899890197266291,0.6100109802733709,home,MIL,under,7.5,0.5238095238095238,-110,0.5011337868480725,MIL,LAD,2022 REG,4,0,6,4,4,10,0,1,-4,4,0,0,0,0,0,0,0,0,0,0.4988662131519274,0.5011337868480725
85971,0.3846153846153846,0.6551724137931035,160,-190,0.3693123852275045,0.6306876147724956,away,LAD,over,9,0.5454545454545454,-120,0.5206611570247933,ARI,LAD,2022 REG,8,1,24,14,15,32,0,1,-13,13,1,0,0,0,0,0,0,0,0,0.5206611570247933,0.4793388429752067
85971,0.3846153846153846,0.6551724137931035,160,-190,0.3693123852275045,0.6306876147724956,home,ARI,under,9,0.5,100,0.4793388429752067,ARI,LAD,2022 REG,8,1,24,14,15,32,0,1,-13,13,1,0,0,0,0,0,0,0,0,0.5206611570247933,0.4793388429752067
85972,0.5689655172413793,0.4716981132075471,-132,112,0.5458293137100936,0.4541706862899064,away,ARI,over,8.5,0.5454545454545454,-120,0.5206611570247933,WSH,ARI,2022 REG,6,3,9,4,7,15,0,1,-1,1,1,1,1,0,0,0,0,0,0,0.5206611570247933,0.4793388429752067
85972,0.5689655172413793,0.4716981132075471,-132,112,0.5458293137100936,0.4541706862899064,home,WSH,under,8.5,0.5,100,0.4793388429752067,WSH,ARI,2022 REG,6,3,9,4,7,15,0,1,-1,1,1,1,1,0,0,0,0,0,0,0.5206611570247933,0.4793388429752067
85973,0.7297297297297298,0.3125,-270,220,0.6989134404674946,0.3010865595325054,away,BAL,over,8.5,0.5,100,0.47935779816513757,NYY,BAL,2022 REG,11,7,7,6,13,18,1,0,1,-1,1,1,1,1,1,1,0,0,0,0.47935779816513757,0.5206422018348624
85973,0.7297297297297298,0.3125,-270,220,0.6989134404674946,0.3010865595325054,home,NYY,under,8.5,0.5412844036697247,-118,0.5206422018348624,NYY,BAL,2022 REG,11,7,7,6,13,18,1,0,1,-1,1,1,1,1,1,1,0,0,0,0.47935779816513757,0.5206422018348624
85974,0.6666666666666666,0.37037037037037035,-200,170,0.6419753086419753,0.3580246913580247,away,COL,over,7.5,0.5121951219512195,-105,0.48808156828023186,SF,COL,2022 REG,9,5,8,2,7,17,1,0,3,-3,1,1,0,0,0,0,0,0,0,0.48808156828023186,0.5119184317197681
85974,0.6666666666666666,0.37037037037037035,-200,170,0.6419753086419753,0.3580246913580247,home,SF,under,7.5,0.5348837209302326,-115,0.5119184317197681,SF,COL,2022 REG,9,5,8,2,7,17,1,0,3,-3,1,1,0,0,0,0,0,0,0,0.48808156828023186,0.5119184317197681
85976,0.8947368421052632,0.16129032258064516,-850,520,0.8446072737020821,0.1553927262979179,away,SF,over,8.5,0.613899613899614,-159,0.5804861333070473,MIL,SF,2022 REG,6,4,4,2,6,10,1,0,2,-2,1,1,0,0,0,0,0,0,0,0.5804861333070473,0.41951386669295265
85976,0.8947368421052632,0.16129032258064516,-850,520,0.8446072737020821,0.1553927262979179,home,MIL,under,8.5,0.44052863436123346,127,0.41951386669295265,MIL,SF,2022 REG,6,4,4,2,6,10,1,0,2,-2,1,1,0,0,0,0,0,0,0,0.5804861333070473,0.41951386669295265
85977,0.4608294930875576,0.576271186440678,117,-136,0.4437324057473569,0.5562675942526432,away,TOR,over,7,0.5475113122171946,-121,0.5242087833606768,TB,TOR,2022 REG,2,1,8,3,4,10,0,1,-2,2,1,0,0,0,0,0,0,0,0,0.5242087833606768,0.4757912166393232
85977,0.4608294930875576,0.576271186440678,117,-136,0.4437324057473569,0.5562675942526432,home,TB,under,7,0.49504950495049505,102,0.4757912166393232,TB,TOR,2022 REG,2,1,8,3,4,10,0,1,-2,2,1,0,0,0,0,0,0,0,0,0.5242087833606768,0.4757912166393232
85978,0.6254681647940076,0.4166666666666667,-167,140,0.5991141690863948,0.4008858309136052,away,MIA,over,8,0.5283018867924528,-112,0.5044173060022736,ATL,MIA,2022 REG,9,7,14,9,16,23,0,1,-2,2,1,1,1,1,1,1,1,0,0,0.5044173060022736,0.49558269399772636
85978,0.6254681647940076,0.4166666666666667,-167,140,0.5991141690863948,0.4008858309136052,home,ATL,under,8,0.5169082125603864,-107,0.49558269399772636,ATL,MIA,2022 REG,9,7,14,9,16,23,0,1,-2,2,1,1,1,1,1,1,1,0,0,0.5044173060022736,0.49558269399772636
85979,0.48309178743961345,0.5555555555555556,107,-125,0.4644215734322854,0.5355784265677146,away,MIN,over,8,0.5348837209302326,-115,0.5097020142727117,KC,MIN,2022 REG,10,4,2,1,5,12,1,0,3,-3,1,0,0,0,0,0,0,0,0,0.5097020142727117,0.49029798572728833
85979,0.48309178743961345,0.5555555555555556,107,-125,0.4644215734322854,0.5355784265677146,home,KC,under,8,0.5121951219512195,-105,0.49029798572728833,KC,MIN,2022 REG,10,4,2,1,5,12,1,0,3,-3,1,0,0,0,0,0,0,0,0,0.5097020142727117,0.49029798572728833
85980,0.7058823529411764,0.3389830508474576,-240,195,0.6742126561491995,0.32578734385080055,away,ARI,over,7.5,0.5,100,0.4772727272727273,SF,ARI,2022 REG,8,2,6,3,5,14,0,1,-1,1,1,1,0,0,0,0,0,0,0,0.4772727272727273,0.5227272727272727
85980,0.7058823529411764,0.3389830508474576,-240,195,0.6742126561491995,0.32578734385080055,home,SF,under,7.5,0.5454545454545454,-120,0.5227272727272727,SF,ARI,2022 REG,8,2,6,3,5,14,0,1,-1,1,1,1,0,0,0,0,0,0,0,0.4772727272727273,0.5227272727272727
85981,0.6453900709219857,0.3921568627450981,-182,155,0.6211576527396834,0.3788423472603166,away,TEX,over,8.5,0.5121951219512195,-105,0.48808156828023186,MIN,TEX,2022 REG,4,0,11,7,7,15,0,1,-7,7,0,0,0,0,0,0,0,0,0,0.48808156828023186,0.5119184317197681
85981,0.6453900709219857,0.3921568627450981,-182,155,0.6211576527396834,0.3788423472603166,home,MIN,under,8.5,0.5348837209302326,-115,0.5119184317197681,MIN,TEX,2022 REG,4,0,11,7,7,15,0,1,-7,7,0,0,0,0,0,0,0,0,0,0.48808156828023186,0.5119184317197681
85982,0.4444444444444444,0.6031746031746031,125,-152,0.4232804232804233,0.5767195767195767,away,LAA,over,8,0.5327102803738317,-114,0.508788710910954,BOS,LAA,2022 REG,6,0,8,8,8,14,0,1,-8,8,0,0,0,0,0,0,0,0,0,0.508788710910954,0.491211289089046
85982,0.4444444444444444,0.6031746031746031,125,-152,0.4232804232804233,0.5767195767195767,home,BOS,under,8,0.5121951219512195,-105,0.491211289089046,BOS,LAA,2022 REG,6,0,8,8,8,14,0,1,-8,8,0,0,0,0,0,0,0,0,0,0.508788710910954,0.491211289089046
85984,0.6183206106870228,0.4132231404958678,-162,142,0.5988164591922583,0.40118354080774166,away,CLE,over,8,0.5348837209302326,-115,0.5097020142727117,MIN,CLE,2022 REG,13,12,9,8,20,22,1,0,4,-4,1,1,1,1,1,1,1,1,0,0.5097020142727117,0.49029798572728833
85984,0.6183206106870228,0.4132231404958678,-162,142,0.5988164591922583,0.40118354080774166,home,MIN,under,8,0.5121951219512195,-105,0.49029798572728833,MIN,CLE,2022 REG,13,12,9,8,20,22,1,0,4,-4,1,1,1,1,1,1,1,1,0,0.5097020142727117,0.49029798572728833
85985,0.6254681647940076,0.4166666666666667,-167,140,0.5991141690863948,0.4008858309136052,away,MIA,over,8,0.5215311004784688,-109,0.4978845547971712,ATL,MIA,2022 REG,7,2,5,1,3,12,1,0,1,-1,1,0,0,0,0,0,0,0,0,0.4978845547971712,0.5021154452028288
85985,0.6254681647940076,0.4166666666666667,-167,140,0.5991141690863948,0.4008858309136052,home,ATL,under,8,0.5238095238095238,-110,0.5021154452028288,ATL,MIA,2022 REG,7,2,5,1,3,12,1,0,1,-1,1,0,0,0,0,0,0,0,0,0.4978845547971712,0.5021154452028288
85986,0.5348837209302326,0.5073891625615764,-115,-103,0.5122726437136835,0.48772735628631647,away,LAA,over,7.5,0.5169082125603864,-107,0.49586088023391106,NYY,LAA,2022 REG,7,2,2,1,3,9,1,0,1,-1,1,0,0,0,0,0,0,0,0,0.49586088023391106,0.5041391197660889
85986,0.5348837209302326,0.5073891625615764,-115,-103,0.5122726437136835,0.48772735628631647,home,NYY,under,7.5,0.5238095238095238,-110,0.5041391197660889,NYY,LAA,2022 REG,7,2,2,1,3,9,1,0,1,-1,1,0,0,0,0,0,0,0,0,0.49586088023391106,0.5041391197660889
85987,0.4854368932038835,0.5555555555555556,106,-125,0.465537646233282,0.534462353766718,away,SF,over,11,0.5327102803738317,-114,0.508788710910954,COL,SF,2022 REG,16,7,15,10,17,31,0,1,-3,3,1,1,1,1,1,1,1,0,0,0.508788710910954,0.491211289089046
85987,0.4854368932038835,0.5555555555555556,106,-125,0.465537646233282,0.534462353766718,home,COL,under,11,0.5121951219512195,-105,0.491211289089046,COL,SF,2022 REG,16,7,15,10,17,31,0,1,-3,3,1,1,1,1,1,1,1,0,0,0.508788710910954,0.491211289089046
85988,0.6453900709219857,0.3921568627450981,-182,155,0.6211576527396834,0.3788423472603166,away,PIT,over,7.5,0.49019607843137253,104,0.46874141813588177,TB,PIT,2022 REG,14,6,8,5,11,22,1,0,1,-1,1,1,1,1,1,0,0,0,0,0.46874141813588177,0.5312585818641182
85988,0.6453900709219857,0.3921568627450981,-182,155,0.6211576527396834,0.3788423472603166,home,TB,under,7.5,0.5535714285714286,-124,0.5312585818641182,TB,PIT,2022 REG,14,6,8,5,11,22,1,0,1,-1,1,1,1,1,1,0,0,0,0,0.46874141813588177,0.5312585818641182
85990,0.5283018867924528,0.5121951219512195,-112,-105,0.5069072406637203,0.4930927593362797,away,BAL,over,9.5,0.5,100,0.4772727272727273,KC,BAL,2022 REG,10,7,10,5,12,20,1,0,2,-2,1,1,1,1,1,0,0,0,0,0.4772727272727273,0.5227272727272727
85990,0.5283018867924528,0.5121951219512195,-112,-105,0.5069072406637203,0.4930927593362797,home,KC,under,9.5,0.5454545454545454,-120,0.5227272727272727,KC,BAL,2022 REG,10,7,10,5,12,20,1,0,2,-2,1,1,1,1,1,0,0,0,0,0.4772727272727273,0.5227272727272727
85991,0.4716981132075471,0.5652173913043479,112,-130,0.4542851393811816,0.5457148606188185,away,SD,over,7.5,0.5098039215686274,-104,0.4870219861770517,SF,SD,2022 REG,7,3,9,4,7,16,0,1,-1,1,1,1,1,0,0,0,0,0,0,0.4870219861770517,0.5129780138229483
85991,0.4716981132075471,0.5652173913043479,112,-130,0.4542851393811816,0.5457148606188185,home,SF,under,7.5,0.5348837209302326,-115,0.5129780138229483,SF,SD,2022 REG,7,3,9,4,7,16,0,1,-1,1,1,1,1,0,0,0,0,0,0,0.4870219861770517,0.5129780138229483
85992,0.6551724137931035,0.3921568627450981,-190,155,0.6241635774404887,0.37583642255951133,away,ARI,over,8,0.5169082125603864,-107,0.49239402434819424,SD,ARI,2022 REG,8,4,10,3,7,18,1,0,1,-1,1,1,1,0,0,0,0,0,0,0.49239402434819424,0.5076059756518058
85992,0.6551724137931035,0.3921568627450981,-190,155,0.6241635774404887,0.37583642255951133,home,SD,under,8,0.5305164319248826,-113,0.5076059756518058,SD,ARI,2022 REG,8,4,10,3,7,18,1,0,1,-1,1,1,1,0,0,0,0,0,0,0.49239402434819424,0.5076059756518058
85993,0.5555555555555556,0.48780487804878053,-125,105,0.5314664257753688,0.46853357422463116,away,NYM,over,9,0.5475113122171946,-121,0.5242087833606768,LAA,NYM,2022 REG,6,1,11,4,5,17,0,1,-3,3,1,0,0,0,0,0,0,0,0,0.5242087833606768,0.4757912166393232
85993,0.5555555555555556,0.48780487804878053,-125,105,0.5314664257753688,0.46853357422463116,home,LAA,under,9,0.49504950495049505,102,0.4757912166393232,LAA,NYM,2022 REG,6,1,11,4,5,17,0,1,-3,3,1,0,0,0,0,0,0,0,0,0.5242087833606768,0.4757912166393232
85994,0.46511627906976744,0.576271186440678,115,-136,0.44586629511142073,0.5541337048885793,away,CHC,over,9,0.5348837209302326,-115,0.5097020142727117,PIT,CHC,2022 REG,5,5,13,14,19,18,0,1,-9,9,1,1,1,1,1,0,0,0,0,0.5097020142727117,0.49029798572728833
85994,0.46511627906976744,0.576271186440678,115,-136,0.44586629511142073,0.5541337048885793,home,PIT,under,9,0.5121951219512195,-105,0.49029798572728833,PIT,CHC,2022 REG,5,5,13,14,19,18,0,1,-9,9,1,1,1,1,1,0,0,0,0,0.5097020142727117,0.49029798572728833
85995,0.5215311004784688,0.5121951219512195,-109,-105,0.5039418265797319,0.49605817342026814,away,SD,over,7.5,0.4926108374384236,103,0.4718421738975501,SEA,SD,2022 REG,3,0,8,2,2,11,0,1,-2,2,0,0,0,0,0,0,0,0,0,0.4718421738975501,0.5281578261024499
85995,0.5215311004784688,0.5121951219512195,-109,-105,0.5039418265797319,0.49605817342026814,home,SEA,under,7.5,0.5495495495495495,-122,0.5281578261024499,SEA,SD,2022 REG,3,0,8,2,2,11,0,1,-2,2,0,0,0,0,0,0,0,0,0,0.4718421738975501,0.5281578261024499
85997,0.3389830508474576,0.7014925373134329,195,-235,0.3252625124878337,0.6747374875121663,away,LAD,over,7.5,0.5238095238095238,-110,0.4988662131519274,PIT,LAD,2022 REG,15,5,4,1,6,19,1,0,4,-4,1,0,0,0,0,0,0,0,0,0.4988662131519274,0.5011337868480725
85997,0.3389830508474576,0.7014925373134329,195,-235,0.3252625124878337,0.6747374875121663,home,PIT,under,7.5,0.5238095238095238,-110,0.5011337868480725,PIT,LAD,2022 REG,15,5,4,1,6,19,1,0,4,-4,1,0,0,0,0,0,0,0,0,0.4988662131519274,0.5011337868480725
85998,0.4716981132075471,0.5652173913043479,112,-130,0.4542851393811816,0.5457148606188185,away,NYM,over,8.5,0.5283018867924528,-112,0.5031902949311281,LAA,NYM,2022 REG,9,3,13,7,10,22,0,1,-4,4,1,1,1,0,0,0,0,0,0,0.5031902949311281,0.4968097050688719
85998,0.4716981132075471,0.5652173913043479,112,-130,0.4542851393811816,0.5457148606188185,home,LAA,under,8.5,0.5192307692307692,-108,0.4968097050688719,LAA,NYM,2022 REG,9,3,13,7,10,22,0,1,-4,4,1,1,1,0,0,0,0,0,0,0.5031902949311281,0.4968097050688719
85999,0.4484304932735426,0.5918367346938775,123,-145,0.43037344037335423,0.5696265596266458,away,HOU,over,8,0.5348837209302326,-115,0.5097020142727117,NYM,HOU,2022 REG,2,0,7,2,2,9,0,1,-2,2,0,0,0,0,0,0,0,0,0,0.5097020142727117,0.49029798572728833
85999,0.4484304932735426,0.5918367346938775,123,-145,0.43037344037335423,0.5696265596266458,home,NYM,under,8,0.5121951219512195,-105,0.49029798572728833,NYM,HOU,2022 REG,2,0,7,2,2,9,0,1,-2,2,0,0,0,0,0,0,0,0,0,0.5097020142727117,0.49029798572728833
86000,0.6254681647940076,0.4098360655737705,-167,144,0.6033864926164085,0.39661350738359147,away,SD,over,7.5,0.5,100,0.4772727272727273,SEA,SD,2022 REG,8,6,7,1,7,15,1,0,5,-5,1,0,0,0,0,0,0,0,0,0.4772727272727273,0.5227272727272727
86000,0.6254681647940076,0.4098360655737705,-167,144,0.6033864926164085,0.39661350738359147,home,SEA,under,7.5,0.5454545454545454,-120,0.5227272727272727,SEA,SD,2022 REG,8,6,7,1,7,15,1,0,5,-5,1,0,0,0,0,0,0,0,0,0.4772727272727273,0.5227272727272727
86002,0.7727272727272727,0.27027027027027023,-340,270,0.7395018985928078,0.2604981014071922,away,CIN,over,9,0.5073891625615764,-103,0.4837652908580103,NYY,CIN,2022 REG,6,7,10,6,13,16,1,0,1,-1,1,1,1,1,1,1,0,0,0,0.4837652908580103,0.5162347091419897
86002,0.7727272727272727,0.27027027027027023,-340,270,0.7395018985928078,0.2604981014071922,home,NYY,under,9,0.5391705069124424,-117,0.5162347091419897,NYY,CIN,2022 REG,6,7,10,6,13,16,1,0,1,-1,1,1,1,1,1,1,0,0,0,0.4837652908580103,0.5162347091419897
86003,0.08,0.9696969696969697,1150,-3200,0.07602424242424241,0.9239757575757576,away,COL,over,10.5,0.5121951219512195,-105,0.47850981558596073,SD,COL,2022 REG,4,2,9,6,8,13,0,1,-4,4,1,1,0,0,0,0,0,0,0,0.47850981558596073,0.5214901844140393
86003,0.08,0.9696969696969697,1150,-3200,0.07602424242424241,0.9239757575757576,home,SD,under,10.5,0.5535714285714286,-124,0.5214901844140393,SD,COL,2022 REG,4,2,9,6,8,13,0,1,-4,4,1,1,0,0,0,0,0,0,0,0.47850981558596073,0.5214901844140393
86004,0.6000000000000001,0.4444444444444444,-150,125,0.5733333333333334,0.42666666666666664,away,MIA,over,8.5,0.5121951219512195,-105,0.48808156828023186,ATL,MIA,2022 REG,6,3,5,0,3,11,1,0,3,-3,0,0,0,0,0,0,0,0,0,0.48808156828023186,0.5119184317197681
86004,0.6000000000000001,0.4444444444444444,-150,125,0.5733333333333334,0.42666666666666664,home,ATL,under,8.5,0.5348837209302326,-115,0.5119184317197681,ATL,MIA,2022 REG,6,3,5,0,3,11,1,0,3,-3,0,0,0,0,0,0,0,0,0,0.48808156828023186,0.5119184317197681
86005,0.47619047619047616,0.5652173913043479,110,-130,0.4564724440500838,0.5435275559499162,away,CWS,over,11.5,0.5238095238095238,-110,0.4988662131519274,COL,CWS,2022 REG,11,6,11,5,11,22,1,0,1,-1,1,1,1,1,1,0,0,0,0,0.4988662131519274,0.5011337868480725
86005,0.47619047619047616,0.5652173913043479,110,-130,0.4564724440500838,0.5435275559499162,home,COL,under,11.5,0.5238095238095238,-110,0.5011337868480725,COL,CWS,2022 REG,11,6,11,5,11,22,1,0,1,-1,1,1,1,1,1,0,0,0,0,0.4988662131519274,0.5011337868480725
86006,0.7938144329896907,0.25,-385,300,0.7590339037092146,0.24096609629078536,away,WSH,over,8.5,0.5348837209302326,-115,0.5097020142727117,ATL,WSH,2022 REG,10,5,9,2,7,19,1,0,3,-3,1,1,0,0,0,0,0,0,0,0.5097020142727117,0.49029798572728833
86006,0.7938144329896907,0.25,-385,300,0.7590339037092146,0.24096609629078536,home,ATL,under,8.5,0.5121951219512195,-105,0.49029798572728833,ATL,WSH,2022 REG,10,5,9,2,7,19,1,0,3,-3,1,1,0,0,0,0,0,0,0,0.5097020142727117,0.49029798572728833
86007,0.35211267605633806,0.6923076923076923,184,-225,0.33647170128027104,0.663528298719729,away,HOU,over,7,0.5121951219512195,-105,0.48808156828023186,OAK,HOU,2022 REG,8,4,5,2,6,13,1,0,2,-2,1,1,0,0,0,0,0,0,0,0.48808156828023186,0.5119184317197681
86007,0.35211267605633806,0.6923076923076923,184,-225,0.33647170128027104,0.663528298719729,home,OAK,under,7,0.5348837209302326,-115,0.5119184317197681,OAK,HOU,2022 REG,8,4,5,2,6,13,1,0,2,-2,1,1,0,0,0,0,0,0,0,0.48808156828023186,0.5119184317197681
86009,0.5348837209302326,0.5121951219512195,-115,-105,0.5097020142727117,0.49029798572728833,away,BOS,over,7.5,0.5412844036697247,-118,0.5149381613977361,TB,BOS,2022 REG,14,10,9,5,15,23,1,0,5,-5,1,1,1,1,1,0,0,0,0,0.5149381613977361,0.48506183860226393
86009,0.5348837209302326,0.5121951219512195,-115,-105,0.5097020142727117,0.49029798572728833,home,TB,under,7.5,0.5073891625615764,-103,0.48506183860226393,TB,BOS,2022 REG,14,10,9,5,15,23,1,0,5,-5,1,1,1,1,1,0,0,0,0,0.5149381613977361,0.48506183860226393
86010,0.4672897196261683,0.574468085106383,114,-135,0.4477767267604901,0.5522232732395099,away,MIN,over,9,0.5192307692307692,-108,0.49688292476754015,LAA,MIN,2022 REG,8,4,5,2,6,13,1,0,2,-2,1,1,0,0,0,0,0,0,0,0.49688292476754015,0.5031170752324599
86010,0.4672897196261683,0.574468085106383,114,-135,0.4477767267604901,0.5522232732395099,home,LAA,under,9,0.5238095238095238,-110,0.5031170752324599,LAA,MIN,2022 REG,8,4,5,2,6,13,1,0,2,-2,1,1,0,0,0,0,0,0,0,0.49688292476754015,0.5031170752324599
86011,0.7468354430379747,0.29411764705882354,-295,240,0.7162502238517583,0.2837497761482417,away,PIT,over,9,0.5412844036697247,-118,0.5175913212324037,PHI,PIT,2022 REG,7,6,6,0,6,13,1,0,6,-6,0,0,0,0,0,0,0,0,0,0.5175913212324037,0.4824086787675963
86011,0.7468354430379747,0.29411764705882354,-295,240,0.7162502238517583,0.2837497761482417,home,PHI,under,9,0.5024875621890548,-101,0.4824086787675963,PHI,PIT,2022 REG,7,6,6,0,6,13,1,0,6,-6,0,0,0,0,0,0,0,0,0,0.5175913212324037,0.4824086787675963
86012,0.3333333333333333,0.7014925373134329,200,-235,0.32172470978441126,0.6782752902155887,away,HOU,over,7,0.5454545454545454,-120,0.5193043049216726,DET,HOU,2022 REG,6,0,13,7,7,19,0,1,-7,7,0,0,0,0,0,0,0,0,0,0.5193043049216726,0.48069569507832743
86012,0.3333333333333333,0.7014925373134329,200,-235,0.32172470978441126,0.6782752902155887,home,DET,under,7,0.5024875621890548,-101,0.48069569507832743,DET,HOU,2022 REG,6,0,13,7,7,19,0,1,-7,7,0,0,0,0,0,0,0,0,0,0.5193043049216726,0.48069569507832743
86013,0.6153846153846154,0.42016806722689076,-160,138,0.5935060414698423,0.4064939585301577,away,CHC,over,9,0.5,100,0.4772727272727273,BAL,CHC,2022 REG,6,2,8,3,5,14,0,1,-1,1,1,1,0,0,0,0,0,0,0,0.4772727272727273,0.5227272727272727
86013,0.6153846153846154,0.42016806722689076,-160,138,0.5935060414698423,0.4064939585301577,home,BAL,under,9,0.5454545454545454,-120,0.5227272727272727,BAL,CHC,2022 REG,6,2,8,3,5,14,0,1,-1,1,1,1,0,0,0,0,0,0,0,0.4772727272727273,0.5227272727272727
86014,0.4716981132075471,0.5652173913043479,112,-130,0.4542851393811816,0.5457148606188185,away,TOR,over,9,0.5238095238095238,-110,0.4988662131519274,CWS,TOR,2022 REG,15,7,8,6,13,23,1,0,1,-1,1,1,1,1,1,1,0,0,0,0.4988662131519274,0.5011337868480725
86014,0.4716981132075471,0.5652173913043479,112,-130,0.4542851393811816,0.5457148606188185,home,CWS,under,9,0.5238095238095238,-110,0.5011337868480725,CWS,TOR,2022 REG,15,7,8,6,13,23,1,0,1,-1,1,1,1,1,1,1,0,0,0,0.4988662131519274,0.5011337868480725
86015,0.4081632653061224,0.6254681647940076,145,-167,0.39443615097953877,0.6055638490204612,away,SD,over,8,0.5192307692307692,-108,0.49688292476754015,CIN,SD,2022 REG,8,6,12,9,15,20,0,1,-3,3,1,1,1,1,1,1,0,0,0,0.49688292476754015,0.5031170752324599
86015,0.4081632653061224,0.6254681647940076,145,-167,0.39443615097953877,0.6055638490204612,home,CIN,under,8,0.5238095238095238,-110,0.5031170752324599,CIN,SD,2022 REG,8,6,12,9,15,20,0,1,-3,3,1,1,1,1,1,1,0,0,0,0.49688292476754015,0.5031170752324599
86016,0.5454545454545454,0.5,-120,100,0.5206611570247933,0.4793388429752067,away,BOS,over,7.5,0.5,100,0.4772727272727273,TB,BOS,2022 REG,3,3,2,2,5,5,1,0,1,-1,1,1,0,0,0,0,0,0,0,0.4772727272727273,0.5227272727272727
86016,0.5454545454545454,0.5,-120,100,0.5206611570247933,0.4793388429752067,home,TB,under,7.5,0.5454545454545454,-120,0.5227272727272727,TB,BOS,2022 REG,3,3,2,2,5,5,1,0,1,-1,1,1,0,0,0,0,0,0,0,0.4772727272727273,0.5227272727272727
86018,0.7468354430379747,0.2898550724637681,-295,245,0.719433665637939,0.280566334362061,away,MIA,over,8.5,0.5073891625615764,-103,0.4837652908580103,HOU,MIA,2022 REG,8,1,6,5,6,14,0,1,-4,4,1,0,0,0,0,0,0,0,0,0.4837652908580103,0.5162347091419897
86018,0.7468354430379747,0.2898550724637681,-295,245,0.719433665637939,0.280566334362061,home,HOU,under,8.5,0.5391705069124424,-117,0.5162347091419897,HOU,MIA,2022 REG,8,1,6,5,6,14,0,1,-4,4,1,0,0,0,0,0,0,0,0,0.4837652908580103,0.5162347091419897
86019,0.5238095238095238,0.5169082125603864,-110,-107,0.5024811857109994,0.4975188142890006,away,KC,over,8,0.5260663507109005,-111,0.5022370601254724,OAK,KC,2022 REG,2,0,7,2,2,9,0,1,-2,2,0,0,0,0,0,0,0,0,0,0.5022370601254724,0.4977629398745276
86019,0.5238095238095238,0.5169082125603864,-110,-107,0.5024811857109994,0.4975188142890006,home,OAK,under,8,0.5192307692307692,-108,0.4977629398745276,OAK,KC,2022 REG,2,0,7,2,2,9,0,1,-2,2,0,0,0,0,0,0,0,0,0,0.5022370601254724,0.4977629398745276
86020,0.4484304932735426,0.5815899581589958,123,-139,0.434968407429355,0.5650315925706451,away,PHI,over,9.5,0.5121951219512195,-105,0.48808156828023186,ARI,PHI,2022 REG,8,2,24,18,20,32,0,1,-16,16,1,1,0,0,0,0,0,0,0,0.48808156828023186,0.5119184317197681
86020,0.4484304932735426,0.5815899581589958,123,-139,0.434968407429355,0.5650315925706451,home,ARI,under,9.5,0.5348837209302326,-115,0.5119184317197681,ARI,PHI,2022 REG,8,2,24,18,20,32,0,1,-16,16,1,1,0,0,0,0,0,0,0,0.48808156828023186,0.5119184317197681
86021,0.6825396825396826,0.35714285714285715,-215,180,0.6554547745023935,0.34454522549760647,away,LAA,over,8.5,0.5192307692307692,-108,0.49455035168025013,ATL,LAA,2022 REG,11,7,8,2,9,19,1,0,5,-5,1,1,0,0,0,0,0,0,0,0.49455035168025013,0.5054496483197499
86021,0.6825396825396826,0.35714285714285715,-215,180,0.6554547745023935,0.34454522549760647,home,ATL,under,8.5,0.5283018867924528,-112,0.5054496483197499,ATL,LAA,2022 REG,11,7,8,2,9,19,1,0,5,-5,1,1,0,0,0,0,0,0,0,0.49455035168025013,0.5054496483197499
86022,0.5412844036697247,0.49504950495049505,-118,102,0.5216174256092387,0.47838257439076126,away,CLE,over,12,0.5305164319248826,-113,0.5066009958897986,COL,CLE,2022 REG,11,5,11,7,12,22,0,1,-2,2,1,1,1,1,1,0,0,0,0,0.5066009958897986,0.49339900411020143
86022,0.5412844036697247,0.49504950495049505,-118,102,0.5216174256092387,0.47838257439076126,home,COL,under,12,0.5145631067961165,-106,0.49339900411020143,COL,CLE,2022 REG,11,5,11,7,12,22,0,1,-2,2,1,1,1,1,1,0,0,0,0,0.5066009958897986,0.49339900411020143
86023,0.5370370370370371,0.504950495049505,-116,-102,0.514488177212783,0.48551182278721705,away,ATL,over,8,0.5391705069124424,-117,0.5140669063204599,SD,ATL,2022 REG,6,2,9,5,7,15,0,1,-3,3,1,1,0,0,0,0,0,0,0,0.5140669063204599,0.4859330936795401
86023,0.5370370370370371,0.504950495049505,-116,-102,0.514488177212783,0.48551182278721705,home,SD,under,8,0.5073891625615764,-103,0.4859330936795401,SD,ATL,2022 REG,6,2,9,5,7,15,0,1,-3,3,1,1,0,0,0,0,0,0,0,0.5140669063204599,0.4859330936795401
86024,0.7938144329896907,0.25,-385,300,0.7590339037092146,0.24096609629078536,away,OAK,over,7.5,0.5098039215686274,-104,0.48375889301574193,HOU,OAK,2022 REG,6,5,7,0,5,13,1,0,5,-5,0,0,0,0,0,0,0,0,0,0.48375889301574193,0.5162411069842581
86024,0.7938144329896907,0.25,-385,300,0.7590339037092146,0.24096609629078536,home,HOU,under,7.5,0.5412844036697247,-118,0.5162411069842581,HOU,OAK,2022 REG,6,5,7,0,5,13,1,0,5,-5,0,0,0,0,0,0,0,0,0,0.48375889301574193,0.5162411069842581
86025,0.4,0.6363636363636364,150,-175,0.3854545454545455,0.6145454545454545,away,CLE,over,11,0.5327102803738317,-114,0.5075272610403079,COL,CLE,2022 REG,9,3,12,4,7,21,0,1,-1,1,1,1,1,0,0,0,0,0,0,0.5075272610403079,0.4924727389596921
86025,0.4,0.6363636363636364,150,-175,0.3854545454545455,0.6145454545454545,home,COL,under,11,0.5145631067961165,-106,0.4924727389596921,COL,CLE,2022 REG,9,3,12,4,7,21,0,1,-1,1,1,1,1,0,0,0,0,0,0,0.5075272610403079,0.4924727389596921
86026,0.4629629629629629,0.576271186440678,116,-136,0.4447990049057217,0.5552009950942782,away,LAD,over,9.5,0.5348837209302326,-115,0.5097020142727117,PHI,LAD,2022 REG,8,4,6,3,7,14,1,0,1,-1,1,1,1,0,0,0,0,0,0,0.5097020142727117,0.49029798572728833
86026,0.4629629629629629,0.576271186440678,116,-136,0.4447990049057217,0.5552009950942782,home,PHI,under,9.5,0.5121951219512195,-105,0.49029798572728833,PHI,LAD,2022 REG,8,4,6,3,7,14,1,0,1,-1,1,1,1,0,0,0,0,0,0,0.5097020142727117,0.49029798572728833
86027,0.5652173913043479,0.47619047619047616,-130,110,0.5418129444594474,0.4581870555405526,away,SF,over,7.5,0.5192307692307692,-108,0.49571111079951763,MIN,SF,2022 REG,9,9,4,0,9,13,1,0,9,-9,0,0,0,0,0,0,0,0,0,0.49571111079951763,0.5042888892004824
86027,0.5652173913043479,0.47619047619047616,-130,110,0.5418129444594474,0.4581870555405526,home,MIN,under,7.5,0.5260663507109005,-111,0.5042888892004824,MIN,SF,2022 REG,9,9,4,0,9,13,1,0,9,-9,0,0,0,0,0,0,0,0,0,0.49571111079951763,0.5042888892004824
86028,0.7142857142857143,0.3225806451612903,-250,210,0.6879526003949967,0.3120473996050033,away,BAL,over,9,0.5098039215686274,-104,0.48483656587239576,MIN,BAL,2022 REG,10,4,7,3,7,17,1,0,1,-1,1,1,1,0,0,0,0,0,0,0.48483656587239576,0.5151634341276042
86028,0.7142857142857143,0.3225806451612903,-250,210,0.6879526003949967,0.3120473996050033,home,MIN,under,9,0.5391705069124424,-117,0.5151634341276042,MIN,BAL,2022 REG,10,4,7,3,7,17,1,0,1,-1,1,1,1,0,0,0,0,0,0,0.48483656587239576,0.5151634341276042
86030,0.5815899581589958,0.45454545454545453,-139,120,0.5605739649961564,0.4394260350038436,away,DET,over,7,0.5283018867924528,-112,0.5044173060022736,MIN,DET,2022 REG,12,7,11,1,8,23,1,0,6,-6,1,0,0,0,0,0,0,0,0,0.5044173060022736,0.49558269399772636
86030,0.5815899581589958,0.45454545454545453,-139,120,0.5605739649961564,0.4394260350038436,home,MIN,under,7,0.5169082125603864,-107,0.49558269399772636,MIN,DET,2022 REG,12,7,11,1,8,23,1,0,6,-6,1,0,0,0,0,0,0,0,0,0.5044173060022736,0.49558269399772636
86031,0.3508771929824561,0.6875,185,-220,0.3374115112342259,0.662588488765774,away,LAD,over,11,0.5348837209302326,-115,0.5097020142727117,COL,LAD,2022 REG,11,7,9,4,11,20,1,0,3,-3,1,1,1,1,0,0,0,0,0,0.5097020142727117,0.49029798572728833
86031,0.3508771929824561,0.6875,185,-220,0.3374115112342259,0.662588488765774,home,COL,under,11,0.5121951219512195,-105,0.49029798572728833,COL,LAD,2022 REG,11,7,9,4,11,20,1,0,3,-3,1,1,1,1,0,0,0,0,0,0.5097020142727117,0.49029798572728833
86032,0.5073891625615764,0.5348837209302326,-103,-115,0.4859403596076043,0.5140596403923957,away,TB,over,9,0.5121951219512195,-105,0.48808156828023186,MIN,TB,2022 REG,5,0,7,6,6,12,0,1,-6,6,0,0,0,0,0,0,0,0,0,0.48808156828023186,0.5119184317197681
86032,0.5073891625615764,0.5348837209302326,-103,-115,0.4859403596076043,0.5140596403923957,home,MIN,under,9,0.5348837209302326,-115,0.5119184317197681,MIN,TB,2022 REG,5,0,7,6,6,12,0,1,-6,6,0,0,0,0,0,0,0,0,0,0.48808156828023186,0.5119184317197681
86033,0.7590361445783133,0.2777777777777778,-315,260,0.7310930468863406,0.2689069531136594,away,DET,over,8.5,0.5305164319248826,-113,0.5053568787472517,NYY,DET,2022 REG,7,5,8,4,9,15,1,0,1,-1,1,1,1,1,0,0,0,0,0,0.5053568787472517,0.49464312125274834
86033,0.7590361445783133,0.2777777777777778,-315,260,0.7310930468863406,0.2689069531136594,home,NYY,under,8.5,0.5169082125603864,-107,0.49464312125274834,NYY,DET,2022 REG,7,5,8,4,9,15,1,0,1,-1,1,1,1,1,0,0,0,0,0,0.5053568787472517,0.49464312125274834
86034,0.48309178743961345,0.5535714285714286,107,-124,0.4653800888835545,0.5346199111164456,away,CWS,over,7.5,0.5073891625615764,-103,0.4837652908580103,SEA,CWS,2022 REG,6,2,5,3,5,11,0,1,-1,1,1,1,0,0,0,0,0,0,0,0.4837652908580103,0.5162347091419897
86034,0.48309178743961345,0.5535714285714286,107,-124,0.4653800888835545,0.5346199111164456,home,SEA,under,7.5,0.5391705069124424,-117,0.5162347091419897,SEA,CWS,2022 REG,6,2,5,3,5,11,0,1,-1,1,1,1,0,0,0,0,0,0,0,0.4837652908580103,0.5162347091419897
86035,0.5495495495495495,0.48780487804878053,-122,105,0.529021440689206,0.470978559310794,away,WSH,over,9.5,0.5283018867924528,-112,0.5031902949311281,ARI,WSH,2022 REG,10,3,9,4,7,19,0,1,-1,1,1,1,1,0,0,0,0,0,0,0.5031902949311281,0.4968097050688719
86035,0.5495495495495495,0.48780487804878053,-122,105,0.529021440689206,0.470978559310794,home,ARI,under,9.5,0.5192307692307692,-108,0.4968097050688719,ARI,WSH,2022 REG,10,3,9,4,7,19,0,1,-1,1,1,1,1,0,0,0,0,0,0,0.5031902949311281,0.4968097050688719
86036,0.5348837209302326,0.5073891625615764,-115,-103,0.5122726437136835,0.48772735628631647,away,TOR,over,8,0.5305164319248826,-113,0.5066009958897986,STL,TOR,2022 REG,10,7,4,3,10,14,1,0,4,-4,1,1,1,0,0,0,0,0,0,0.5066009958897986,0.49339900411020143
86036,0.5348837209302326,0.5073891625615764,-115,-103,0.5122726437136835,0.48772735628631647,home,STL,under,8,0.5145631067961165,-106,0.49339900411020143,STL,TOR,2022 REG,10,7,4,3,10,14,1,0,4,-4,1,1,1,0,0,0,0,0,0,0.5066009958897986,0.49339900411020143
86037,0.978002639683238,0.07418397626112759,-4446,1248,0.926963991533513,0.07303600846648695,away,DET,over,8.5,0.5833333333333333,-140,0.5486111111111112,KC,DET,2022 REG,11,7,11,3,10,22,1,0,4,-4,1,1,1,0,0,0,0,0,0,0.5486111111111112,0.45138888888888884
86037,0.978002639683238,0.07418397626112759,-4446,1248,0.926963991533513,0.07303600846648695,home,KC,under,8.5,0.47619047619047616,110,0.45138888888888884,KC,DET,2022 REG,11,7,11,3,10,22,1,0,4,-4,1,1,1,0,0,0,0,0,0,0.5486111111111112,0.45138888888888884
86038,0.7275204359673024,0.31746031746031744,-267,215,0.6947960186235027,0.3052039813764973,away,MIL,over,8.5,0.5327102803738317,-114,0.508788710910954,LAD,MIL,2022 REG,13,12,9,6,18,22,1,0,6,-6,1,1,1,1,1,1,0,0,0,0.508788710910954,0.491211289089046
86038,0.7275204359673024,0.31746031746031744,-267,215,0.6947960186235027,0.3052039813764973,home,LAD,under,8.5,0.5121951219512195,-105,0.491211289089046,LAD,MIL,2022 REG,13,12,9,6,18,22,1,0,6,-6,1,1,1,1,1,1,0,0,0,0.508788710910954,0.491211289089046
86039,0.49504950495049505,0.5454545454545454,102,-120,0.47499799484898986,0.5250020051510101,away,LAA,over,8,0.5327102803738317,-114,0.508788710910954,BAL,LAA,2022 REG,5,1,5,0,1,10,1,0,1,-1,0,0,0,0,0,0,0,0,0,0.508788710910954,0.491211289089046
86039,0.49504950495049505,0.5454545454545454,102,-120,0.47499799484898986,0.5250020051510101,home,BAL,under,8,0.5121951219512195,-105,0.491211289089046,BAL,LAA,2022 REG,5,1,5,0,1,10,1,0,1,-1,0,0,0,0,0,0,0,0,0,0.508788710910954,0.491211289089046
86040,0.576271186440678,0.4608294930875576,-136,117,0.5548911338311863,0.44510886616881373,away,CIN,over,8,0.5169082125603864,-107,0.49353874091423283,CHC,CIN,2022 REG,8,8,12,3,11,20,1,0,5,-5,1,1,1,0,0,0,0,0,0,0.49353874091423283,0.5064612590857671
86040,0.576271186440678,0.4608294930875576,-136,117,0.5548911338311863,0.44510886616881373,home,CHC,under,8,0.5283018867924528,-112,0.5064612590857671,CHC,CIN,2022 REG,8,8,12,3,11,20,1,0,5,-5,1,1,1,0,0,0,0,0,0,0.49353874091423283,0.5064612590857671
86041,0.5121951219512195,0.5238095238095238,-105,-110,0.4937537180249852,0.5062462819750149,away,ARI,over,11,0.5454545454545454,-120,0.5206611570247933,COL,ARI,2022 REG,9,4,5,1,5,14,1,0,3,-3,1,0,0,0,0,0,0,0,0,0.5206611570247933,0.4793388429752067
86041,0.5121951219512195,0.5238095238095238,-105,-110,0.4937537180249852,0.5062462819750149,home,COL,under,11,0.5,100,0.4793388429752067,COL,ARI,2022 REG,9,4,5,1,5,14,1,0,3,-3,1,0,0,0,0,0,0,0,0,0.5206611570247933,0.4793388429752067
86042,0.5495495495495495,0.49019607843137253,-122,104,0.5277073575960698,0.4722926424039302,away,BOS,over,8,0.5327102803738317,-114,0.5075272610403079,SEA,BOS,2022 REG,13,7,8,6,13,21,1,0,1,-1,1,1,1,1,1,1,0,0,0,0.5075272610403079,0.4924727389596921
86042,0.5495495495495495,0.49019607843137253,-122,104,0.5277073575960698,0.4722926424039302,home,SEA,under,8,0.5145631067961165,-106,0.4924727389596921,SEA,BOS,2022 REG,13,7,8,6,13,21,1,0,1,-1,1,1,1,1,1,1,0,0,0,0.5075272610403079,0.4924727389596921
86043,0.5283018867924528,0.5098039215686274,-112,-104,0.5081705163375425,0.4918294836624575,away,MIN,over,8.5,0.5475113122171946,-121,0.5214983313199976,TEX,MIN,2022 REG,8,5,10,6,11,18,0,1,-1,1,1,1,1,1,1,0,0,0,0,0.5214983313199976,0.47850166868000243
86043,0.5283018867924528,0.5098039215686274,-112,-104,0.5081705163375425,0.4918294836624575,home,TEX,under,8.5,0.5,100,0.47850166868000243,TEX,MIN,2022 REG,8,5,10,6,11,18,0,1,-1,1,1,1,1,1,1,0,0,0,0,0.5214983313199976,0.47850166868000243
86044,0.7333333333333333,0.30303030303030304,-275,230,0.7066666666666666,0.29333333333333345,away,WSH,over,9,0.5454545454545454,-120,0.5206611570247933,ATL,WSH,2022 REG,10,2,6,3,5,16,0,1,-1,1,1,1,0,0,0,0,0,0,0,0.5206611570247933,0.4793388429752067
86044,0.7333333333333333,0.30303030303030304,-275,230,0.7066666666666666,0.29333333333333345,home,ATL,under,9,0.5,100,0.4793388429752067,ATL,WSH,2022 REG,10,2,6,3,5,16,0,1,-1,1,1,1,0,0,0,0,0,0,0,0.5206611570247933,0.4793388429752067
86045,0.6363636363636364,0.4081632653061224,-175,145,0.6080283353010626,0.3919716646989374,away,CHC,over,8,0.5121951219512195,-105,0.48919479393107135,ATL,CHC,2022 REG,6,3,4,1,4,10,1,0,2,-2,1,0,0,0,0,0,0,0,0,0.48919479393107135,0.5108052060689287
86045,0.6363636363636364,0.4081632653061224,-175,145,0.6080283353010626,0.3919716646989374,home,ATL,under,8,0.5327102803738317,-114,0.5108052060689287,ATL,CHC,2022 REG,6,3,4,1,4,10,1,0,2,-2,1,0,0,0,0,0,0,0,0,0.48919479393107135,0.5108052060689287
86046,0.7701149425287357,0.2777777777777778,-335,260,0.7332320429823401,0.2667679570176599,away,PIT,over,8,0.5145631067961165,-106,0.4925063625223866,NYM,PIT,2022 REG,5,5,4,1,6,9,1,0,4,-4,1,0,0,0,0,0,0,0,0,0.4925063625223866,0.5074936374776133
86046,0.7701149425287357,0.2777777777777778,-335,260,0.7332320429823401,0.2667679570176599,home,NYM,under,8,0.5283018867924528,-112,0.5074936374776133,NYM,PIT,2022 REG,5,5,4,1,6,9,1,0,4,-4,1,0,0,0,0,0,0,0,0,0.4925063625223866,0.5074936374776133
86047,0.6226415094339623,0.4166666666666667,-165,140,0.5981666073335706,0.40183339266642937,away,CHC,over,8.5,0.5412844036697247,-118,0.5162581740877563,STL,CHC,2022 REG,5,0,8,3,3,13,0,1,-3,3,0,0,0,0,0,0,0,0,0,0.5162581740877563,0.4837418259122437
86047,0.6226415094339623,0.4166666666666667,-165,140,0.5981666073335706,0.40183339266642937,home,STL,under,8.5,0.504950495049505,-102,0.4837418259122437,STL,CHC,2022 REG,5,0,8,3,3,13,0,1,-3,3,0,0,0,0,0,0,0,0,0,0.5162581740877563,0.4837418259122437
86048,0.425531914893617,0.613899613899614,135,-159,0.40875254093905067,0.5912474590609493,away,NYY,over,8.5,0.5327102803738317,-114,0.508788710910954,BOS,NYY,2022 REG,5,5,7,6,11,12,0,1,-1,1,1,1,1,1,1,0,0,0,0,0.508788710910954,0.491211289089046
86048,0.425531914893617,0.613899613899614,135,-159,0.40875254093905067,0.5912474590609493,home,BOS,under,8.5,0.5121951219512195,-105,0.491211289089046,BOS,NYY,2022 REG,5,5,7,6,11,12,0,1,-1,1,1,1,1,1,1,0,0,0,0,0.508788710910954,0.491211289089046
86049,0.7101449275362319,0.3389830508474576,-245,195,0.6752569428869452,0.32474305711305484,away,CIN,over,8.5,0.5454545454545454,-120,0.5193043049216726,MIL,CIN,2022 REG,7,5,7,1,6,14,1,0,4,-4,1,0,0,0,0,0,0,0,0,0.5193043049216726,0.48069569507832743
86049,0.7101449275362319,0.3389830508474576,-245,195,0.6752569428869452,0.32474305711305484,home,MIL,under,8.5,0.5024875621890548,-101,0.48069569507832743,MIL,CIN,2022 REG,7,5,7,1,6,14,1,0,4,-4,1,0,0,0,0,0,0,0,0,0.5193043049216726,0.48069569507832743
86050,0.6610169491525424,0.3846153846153846,-195,160,0.6308532031025568,0.36914679689744323,away,OAK,over,9.5,0.5305164319248826,-113,0.5053568787472517,BOS,OAK,2022 REG,13,10,7,1,11,20,1,0,9,-9,1,0,0,0,0,0,0,0,0,0.5053568787472517,0.49464312125274834
86050,0.6610169491525424,0.3846153846153846,-195,160,0.6308532031025568,0.36914679689744323,home,BOS,under,9.5,0.5169082125603864,-107,0.49464312125274834,BOS,OAK,2022 REG,13,10,7,1,11,20,1,0,9,-9,1,0,0,0,0,0,0,0,0,0.5053568787472517,0.49464312125274834
86051,0.35714285714285715,0.6825396825396826,180,-215,0.34297052154195007,0.6570294784580499,away,ATL,over,9,0.5192307692307692,-108,0.49688292476754015,WSH,ATL,2022 REG,4,2,14,8,10,18,0,1,-6,6,1,1,0,0,0,0,0,0,0,0.49688292476754015,0.5031170752324599
86051,0.35714285714285715,0.6825396825396826,180,-215,0.34297052154195007,0.6570294784580499,home,WSH,under,9,0.5238095238095238,-110,0.5031170752324599,WSH,ATL,2022 REG,4,2,14,8,10,18,0,1,-6,6,1,1,0,0,0,0,0,0,0,0.49688292476754015,0.5031170752324599
86052,0.6923076923076923,0.3472222222222222,-225,188,0.6649408284023669,0.3350591715976331,away,CHC,over,8.5,0.5238095238095238,-110,0.4988662131519274,NYY,CHC,2022 REG,17,18,12,4,22,29,1,0,14,-14,1,1,1,1,0,0,0,0,0,0.4988662131519274,0.5011337868480725
86052,0.6923076923076923,0.3472222222222222,-225,188,0.6649408284023669,0.3350591715976331,home,NYY,under,8.5,0.5238095238095238,-110,0.5011337868480725,NYY,CHC,2022 REG,17,18,12,4,22,29,1,0,14,-14,1,1,1,1,0,0,0,0,0,0.4988662131519274,0.5011337868480725
86053,0.5305164319248826,0.5121951219512195,-113,-105,0.5078572507605655,0.49214274923943446,away,TB,over,8,0.5098039215686274,-104,0.48592421718142587,TOR,TB,2022 REG,8,2,9,4,6,17,0,1,-2,2,1,1,0,0,0,0,0,0,0,0.48592421718142587,0.5140757828185741
86053,0.5305164319248826,0.5121951219512195,-113,-105,0.5078572507605655,0.49214274923943446,home,TOR,under,8,0.5370370370370371,-116,0.5140757828185741,TOR,TB,2022 REG,8,2,9,4,6,17,0,1,-2,2,1,1,0,0,0,0,0,0,0,0.48592421718142587,0.5140757828185741
86054,0.36363636363636365,0.6721311475409836,175,-205,0.3506299959355101,0.6493700040644899,away,CWS,over,7,0.5283018867924528,-112,0.5056562298022652,OAK,CWS,2022 REG,6,2,21,14,16,27,0,1,-12,12,1,1,0,0,0,0,0,0,0,0.5056562298022652,0.4943437701977348
86054,0.36363636363636365,0.6721311475409836,175,-205,0.3506299959355101,0.6493700040644899,home,OAK,under,7,0.5145631067961165,-106,0.4943437701977348,OAK,CWS,2022 REG,6,2,21,14,16,27,0,1,-12,12,1,1,0,0,0,0,0,0,0,0.5056562298022652,0.4943437701977348
86055,0.425531914893617,0.6108949416342413,135,-157,0.41003112488176247,0.5899688751182375,away,CWS,over,8.5,0.5348837209302326,-115,0.5097020142727117,DET,CWS,2022 REG,5,5,12,11,16,17,0,1,-6,6,1,1,1,1,1,0,0,0,0,0.5097020142727117,0.49029798572728833
86055,0.425531914893617,0.6108949416342413,135,-157,0.41003112488176247,0.5899688751182375,home,DET,under,8.5,0.5121951219512195,-105,0.49029798572728833,DET,CWS,2022 REG,5,5,12,11,16,17,0,1,-6,6,1,1,1,1,1,0,0,0,0,0.5097020142727117,0.49029798572728833
86056,0.6363636363636364,0.4,-175,150,0.6132231404958678,0.3867768595041322,away,CWS,over,8.5,0.5121951219512195,-105,0.48808156828023186,BOS,CWS,2022 REG,6,2,10,4,6,16,0,1,-2,2,1,1,0,0,0,0,0,0,0,0.48808156828023186,0.5119184317197681
86056,0.6363636363636364,0.4,-175,150,0.6132231404958678,0.3867768595041322,home,BOS,under,8.5,0.5348837209302326,-115,0.5119184317197681,BOS,CWS,2022 REG,6,2,10,4,6,16,0,1,-2,2,1,1,0,0,0,0,0,0,0,0.48808156828023186,0.5119184317197681
86057,0.6428571428571428,0.3921568627450981,-180,155,0.6203481392557023,0.3796518607442977,away,MIN,over,7.5,0.5073891625615764,-103,0.4826927225525911,CLE,MIN,2022 REG,14,5,4,1,6,18,1,0,4,-4,1,0,0,0,0,0,0,0,0,0.4826927225525911,0.5173072774474089
86057,0.6428571428571428,0.3921568627450981,-180,155,0.6203481392557023,0.3796518607442977,home,CLE,under,7.5,0.5412844036697247,-118,0.5173072774474089,CLE,MIN,2022 REG,14,5,4,1,6,18,1,0,4,-4,1,0,0,0,0,0,0,0,0,0.4826927225525911,0.5173072774474089
86058,0.4608294930875576,0.5798319327731092,117,-138,0.4420915088199692,0.5579084911800307,away,SEA,over,7,0.5412844036697247,-118,0.5149381613977361,OAK,SEA,2022 REG,7,0,13,9,9,20,0,1,-9,9,0,0,0,0,0,0,0,0,0,0.5149381613977361,0.48506183860226393
86058,0.4608294930875576,0.5798319327731092,117,-138,0.4420915088199692,0.5579084911800307,home,OAK,under,7,0.5073891625615764,-103,0.48506183860226393,OAK,SEA,2022 REG,7,0,13,9,9,20,0,1,-9,9,0,0,0,0,0,0,0,0,0,0.5149381613977361,0.48506183860226393
86059,0.6402877697841727,0.4,-178,150,0.6144920035194866,0.38550799648051337,away,PIT,over,9,0.5024875621890548,-101,0.48049269377245407,MIL,PIT,2022 REG,7,2,7,4,6,14,0,1,-2,2,1,1,0,0,0,0,0,0,0,0.48049269377245407,0.5195073062275459
86059,0.6402877697841727,0.4,-178,150,0.6144920035194866,0.38550799648051337,home,MIL,under,9,0.5412844036697247,-118,0.5195073062275459,MIL,PIT,2022 REG,7,2,7,4,6,14,0,1,-2,2,1,1,0,0,0,0,0,0,0,0.48049269377245407,0.5195073062275459
86060,0.3921568627450981,0.6428571428571428,155,-180,0.37842588015598405,0.6215741198440159,away,LAD,over,9.5,0.5145631067961165,-106,0.4913668392989033,ARI,LAD,2022 REG,5,2,10,3,5,15,0,1,-1,1,1,1,0,0,0,0,0,0,0,0.4913668392989033,0.5086331607010968
86060,0.3921568627450981,0.6428571428571428,155,-180,0.37842588015598405,0.6215741198440159,home,ARI,under,9.5,0.5305164319248826,-113,0.5086331607010968,ARI,LAD,2022 REG,5,2,10,3,5,15,0,1,-1,1,1,1,0,0,0,0,0,0,0,0.4913668392989033,0.5086331607010968
86061,0.4444444444444444,0.5884773662551441,125,-143,0.4298125285779606,0.5701874714220394,away,SD,over,8,0.5073891625615764,-103,0.4837652908580103,CLE,SD,2022 REG,11,6,5,5,11,16,1,0,1,-1,1,1,1,1,1,0,0,0,0,0.4837652908580103,0.5162347091419897
86061,0.4444444444444444,0.5884773662551441,125,-143,0.4298125285779606,0.5701874714220394,home,CLE,under,8,0.5391705069124424,-117,0.5162347091419897,CLE,SD,2022 REG,11,6,5,5,11,16,1,0,1,-1,1,1,1,1,1,0,0,0,0,0.4837652908580103,0.5162347091419897
86062,0.5652173913043479,0.4807692307692307,-130,108,0.5392249527410209,0.4607750472589791,away,MIL,over,7.5,0.5412844036697247,-118,0.5136310900085983,STL,MIL,2022 REG,7,3,12,4,7,19,0,1,-1,1,1,1,1,0,0,0,0,0,0,0.5136310900085983,0.4863689099914017
86062,0.5652173913043479,0.4807692307692307,-130,108,0.5392249527410209,0.4607750472589791,home,STL,under,7.5,0.5098039215686274,-104,0.4863689099914017,STL,MIL,2022 REG,7,3,12,4,7,19,0,1,-1,1,1,1,1,0,0,0,0,0,0,0.5136310900085983,0.4863689099914017
86063,0.7333333333333333,0.3125,-275,220,0.6997222222222221,0.30027777777777787,away,CHC,over,7.5,0.5073891625615764,-103,0.4837652908580103,MIL,CHC,2022 REG,6,1,6,2,3,12,0,1,-1,1,1,0,0,0,0,0,0,0,0,0.4837652908580103,0.5162347091419897
86063,0.7333333333333333,0.3125,-275,220,0.6997222222222221,0.30027777777777787,home,MIL,under,7.5,0.5391705069124424,-117,0.5162347091419897,MIL,CHC,2022 REG,6,1,6,2,3,12,0,1,-1,1,1,0,0,0,0,0,0,0,0,0.4837652908580103,0.5162347091419897
86064,0.7354497354497355,0.30303030303030304,-278,230,0.7071496013294954,0.29285039867050455,away,OAK,over,8,0.5327102803738317,-114,0.508788710910954,HOU,OAK,2022 REG,8,3,8,4,7,16,0,1,-1,1,1,1,1,0,0,0,0,0,0,0.508788710910954,0.491211289089046
86064,0.7354497354497355,0.30303030303030304,-278,230,0.7071496013294954,0.29285039867050455,home,HOU,under,8,0.5121951219512195,-105,0.491211289089046,HOU,OAK,2022 REG,8,3,8,4,7,16,0,1,-1,1,1,1,1,0,0,0,0,0,0,0.508788710910954,0.491211289089046
86065,0.36363636363636365,0.6666666666666666,175,-200,0.3526170798898072,0.6473829201101928,away,LAD,over,8,0.5412844036697247,-118,0.5175913212324037,ARI,LAD,2022 REG,3,0,9,4,4,12,0,1,-4,4,0,0,0,0,0,0,0,0,0,0.5175913212324037,0.4824086787675963
86065,0.36363636363636365,0.6666666666666666,175,-200,0.3526170798898072,0.6473829201101928,home,ARI,under,8,0.5024875621890548,-101,0.4824086787675963,ARI,LAD,2022 REG,3,0,9,4,4,12,0,1,-4,4,0,0,0,0,0,0,0,0,0,0.5175913212324037,0.4824086787675963
86066,0.607843137254902,0.425531914893617,-155,135,0.5875563408509002,0.41244365914909975,away,CHC,over,8.5,0.5238095238095238,-110,0.5000596729920038,CWS,CHC,2022 REG,7,1,10,5,6,17,0,1,-4,4,1,0,0,0,0,0,0,0,0,0.5000596729920038,0.4999403270079962
86066,0.607843137254902,0.425531914893617,-155,135,0.5875563408509002,0.41244365914909975,home,CWS,under,8.5,0.5215311004784688,-109,0.4999403270079962,CWS,CHC,2022 REG,7,1,10,5,6,17,0,1,-4,4,1,0,0,0,0,0,0,0,0,0.5000596729920038,0.4999403270079962
86067,0.576271186440678,0.4629629629629629,-136,116,0.553661676614851,0.446338323385149,away,CIN,over,7.5,0.49504950495049505,102,0.4739797934813417,ARI,CIN,2022 REG,8,7,5,4,11,13,1,0,3,-3,1,1,1,1,0,0,0,0,0,0.4739797934813417,0.5260202065186583
86067,0.576271186440678,0.4629629629629629,-136,116,0.553661676614851,0.446338323385149,home,ARI,under,7.5,0.5475113122171946,-121,0.5260202065186583,ARI,CIN,2022 REG,8,7,5,4,11,13,1,0,3,-3,1,1,1,1,0,0,0,0,0,0.4739797934813417,0.5260202065186583
86068,0.5555555555555556,0.48780487804878053,-125,105,0.5314664257753688,0.46853357422463116,away,BAL,over,8,0.5238095238095238,-110,0.5000596729920038,TB,BAL,2022 REG,10,4,8,6,10,18,0,1,-2,2,1,1,1,1,0,0,0,0,0,0.5000596729920038,0.4999403270079962
86068,0.5555555555555556,0.48780487804878053,-125,105,0.5314664257753688,0.46853357422463116,home,TB,under,8,0.5215311004784688,-109,0.4999403270079962,TB,BAL,2022 REG,10,4,8,6,10,18,0,1,-2,2,1,1,1,1,0,0,0,0,0,0.5000596729920038,0.4999403270079962
86069,0.4347826086956522,0.607843137254902,130,-155,0.41624967567367205,0.583750324326328,away,SEA,over,8,0.5238095238095238,-110,0.4988662131519274,TEX,SEA,2022 REG,9,2,11,6,8,20,0,1,-4,4,1,1,0,0,0,0,0,0,0,0.4988662131519274,0.5011337868480725
86069,0.4347826086956522,0.607843137254902,130,-155,0.41624967567367205,0.583750324326328,home,TEX,under,8,0.5238095238095238,-110,0.5011337868480725,TEX,SEA,2022 REG,9,2,11,6,8,20,0,1,-4,4,1,1,0,0,0,0,0,0,0,0.4988662131519274,0.5011337868480725
86070,0.49019607843137253,0.5495495495495495,104,-122,0.4707129274603323,0.5292870725396677,away,LAA,over,9,0.5348837209302326,-115,0.5097020142727117,TEX,LAA,2022 REG,6,2,12,7,9,18,0,1,-5,5,1,1,0,0,0,0,0,0,0,0.5097020142727117,0.49029798572728833
86070,0.49019607843137253,0.5495495495495495,104,-122,0.4707129274603323,0.5292870725396677,home,TEX,under,9,0.5121951219512195,-105,0.49029798572728833,TEX,LAA,2022 REG,6,2,12,7,9,18,0,1,-5,5,1,1,0,0,0,0,0,0,0,0.5097020142727117,0.49029798572728833
86071,0.6923076923076923,0.3448275862068966,-225,190,0.6665986533360538,0.33340134666394616,away,CWS,over,9,0.5238095238095238,-110,0.5000596729920038,NYY,CWS,2022 REG,8,7,11,5,12,19,1,0,2,-2,1,1,1,1,1,0,0,0,0,0.5000596729920038,0.4999403270079962
86071,0.6923076923076923,0.3448275862068966,-225,190,0.6665986533360538,0.33340134666394616,home,NYY,under,9,0.5215311004784688,-109,0.4999403270079962,NYY,CWS,2022 REG,8,7,11,5,12,19,1,0,2,-2,1,1,1,1,1,0,0,0,0,0.5000596729920038,0.4999403270079962
86072,0.3921568627450981,0.6428571428571428,155,-180,0.37842588015598405,0.6215741198440159,away,MIL,over,9,0.5238095238095238,-110,0.4988662131519274,CHC,MIL,2022 REG,8,5,10,4,9,18,1,0,1,-1,1,1,1,1,0,0,0,0,0,0.4988662131519274,0.5011337868480725
86072,0.3921568627450981,0.6428571428571428,155,-180,0.37842588015598405,0.6215741198440159,home,CHC,under,9,0.5238095238095238,-110,0.5011337868480725,CHC,MIL,2022 REG,8,5,10,4,9,18,1,0,1,-1,1,1,1,1,0,0,0,0,0,0.4988662131519274,0.5011337868480725
86073,0.37037037037037035,0.6666666666666666,170,-200,0.35665294924554186,0.6433470507544581,away,TB,over,6.5,0.5098039215686274,-104,0.4870219861770517,MIA,TB,2022 REG,9,2,14,7,9,23,0,1,-5,5,1,1,0,0,0,0,0,0,0,0.4870219861770517,0.5129780138229483
86073,0.37037037037037035,0.6666666666666666,170,-200,0.35665294924554186,0.6433470507544581,home,MIA,under,6.5,0.5348837209302326,-115,0.5129780138229483,MIA,TB,2022 REG,9,2,14,7,9,23,0,1,-5,5,1,1,0,0,0,0,0,0,0,0.4870219861770517,0.5129780138229483
86074,0.46511627906976744,0.574468085106383,115,-135,0.44670494689481377,0.5532950531051862,away,SD,over,10.5,0.5348837209302326,-115,0.5097020142727117,CHC,SD,2022 REG,10,5,15,12,17,25,0,1,-7,7,1,1,1,1,1,0,0,0,0,0.5097020142727117,0.49029798572728833
86074,0.46511627906976744,0.574468085106383,115,-135,0.44670494689481377,0.5532950531051862,home,CHC,under,10.5,0.5121951219512195,-105,0.49029798572728833,CHC,SD,2022 REG,10,5,15,12,17,25,0,1,-7,7,1,1,1,1,1,0,0,0,0,0.5097020142727117,0.49029798572728833
86075,0.46511627906976744,0.574468085106383,115,-135,0.44670494689481377,0.5532950531051862,away,SEA,over,8.5,0.5192307692307692,-108,0.49688292476754015,OAK,SEA,2022 REG,7,2,12,8,10,19,0,1,-6,6,1,1,0,0,0,0,0,0,0,0.49688292476754015,0.5031170752324599
86075,0.46511627906976744,0.574468085106383,115,-135,0.44670494689481377,0.5532950531051862,home,OAK,under,8.5,0.5238095238095238,-110,0.5031170752324599,OAK,SEA,2022 REG,7,2,12,8,10,19,0,1,-6,6,1,1,0,0,0,0,0,0,0,0.49688292476754015,0.5031170752324599
86076,0.3389830508474576,0.7014925373134329,195,-235,0.3252625124878337,0.6747374875121663,away,NYY,over,8,0.5348837209302326,-115,0.5097020142727117,OAK,NYY,2022 REG,6,3,2,2,5,8,1,0,1,-1,1,1,0,0,0,0,0,0,0,0.5097020142727117,0.49029798572728833
86076,0.3389830508474576,0.7014925373134329,195,-235,0.3252625124878337,0.6747374875121663,home,OAK,under,8,0.5121951219512195,-105,0.49029798572728833,OAK,NYY,2022 REG,6,3,2,2,5,8,1,0,1,-1,1,1,0,0,0,0,0,0,0,0.5097020142727117,0.49029798572728833
86077,0.4081632653061224,0.6254681647940076,145,-167,0.39443615097953877,0.6055638490204612,away,NYY,over,9,0.5121951219512195,-105,0.48808156828023186,LAA,NYY,2022 REG,7,4,9,7,11,16,0,1,-3,3,1,1,1,1,0,0,0,0,0,0.48808156828023186,0.5119184317197681
86077,0.4081632653061224,0.6254681647940076,145,-167,0.39443615097953877,0.6055638490204612,home,LAA,under,9,0.5348837209302326,-115,0.5119184317197681,LAA,NYY,2022 REG,7,4,9,7,11,16,0,1,-3,3,1,1,1,1,0,0,0,0,0,0.48808156828023186,0.5119184317197681
86078,0.5967741935483871,0.4444444444444444,-148,125,0.5721759741010521,0.42782402589894786,away,CIN,over,7,0.5535714285714286,-124,0.5293429871948779,MIA,CIN,2022 REG,5,1,3,2,3,8,0,1,-1,1,1,0,0,0,0,0,0,0,0,0.5293429871948779,0.47065701280512207
86078,0.5967741935483871,0.4444444444444444,-148,125,0.5721759741010521,0.42782402589894786,home,MIA,under,7,0.49019607843137253,104,0.47065701280512207,MIA,CIN,2022 REG,5,1,3,2,3,8,0,1,-1,1,1,0,0,0,0,0,0,0,0,0.5293429871948779,0.47065701280512207
86079,0.5555555555555556,0.48780487804878053,-125,105,0.5314664257753688,0.46853357422463116,away,ARI,over,8,0.5145631067961165,-106,0.4913668392989033,SF,ARI,2022 REG,7,2,5,1,3,12,1,0,1,-1,1,0,0,0,0,0,0,0,0,0.4913668392989033,0.5086331607010968
86079,0.5555555555555556,0.48780487804878053,-125,105,0.5314664257753688,0.46853357422463116,home,SF,under,8,0.5305164319248826,-113,0.5086331607010968,SF,ARI,2022 REG,7,2,5,1,3,12,1,0,1,-1,1,0,0,0,0,0,0,0,0,0.4913668392989033,0.5086331607010968
86080,0.47619047619047616,0.5633187772925764,110,-129,0.45737654596045113,0.5426234540395489,away,NYY,over,7.5,0.5327102803738317,-114,0.5075272610403079,TB,NYY,2022 REG,6,2,6,7,9,12,0,1,-5,5,1,1,0,0,0,0,0,0,0,0.5075272610403079,0.4924727389596921
86080,0.47619047619047616,0.5633187772925764,110,-129,0.45737654596045113,0.5426234540395489,home,TB,under,7.5,0.5145631067961165,-106,0.4924727389596921,TB,NYY,2022 REG,6,2,6,7,9,12,0,1,-5,5,1,1,0,0,0,0,0,0,0,0.5075272610403079,0.4924727389596921
86081,0.6551724137931035,0.3802281368821293,-190,163,0.6319789495576061,0.36802105044239386,away,BOS,over,9.5,0.5121951219512195,-105,0.48808156828023186,TOR,BOS,2022 REG,10,7,8,2,9,18,1,0,5,-5,1,1,0,0,0,0,0,0,0,0.48808156828023186,0.5119184317197681
86081,0.6551724137931035,0.3802281368821293,-190,163,0.6319789495576061,0.36802105044239386,home,TOR,under,9.5,0.5348837209302326,-115,0.5119184317197681,TOR,BOS,2022 REG,10,7,8,2,9,18,1,0,5,-5,1,1,0,0,0,0,0,0,0,0.48808156828023186,0.5119184317197681
86082,0.6551724137931035,0.3846153846153846,-190,160,0.6291045458703008,0.37089545412969915,away,CIN,over,7.5,0.5433789954337899,-119,0.5198077604720502,NYY,CIN,2022 REG,6,6,11,7,13,17,0,1,-1,1,1,1,1,1,1,1,0,0,0,0.5198077604720502,0.48019223952794976
86082,0.6551724137931035,0.3846153846153846,-190,160,0.6291045458703008,0.37089545412969915,home,NYY,under,7.5,0.5,100,0.48019223952794976,NYY,CIN,2022 REG,6,6,11,7,13,17,0,1,-1,1,1,1,1,1,1,1,0,0,0,0.5198077604720502,0.48019223952794976
86083,0.6000000000000001,0.4444444444444444,-150,125,0.5733333333333334,0.42666666666666664,away,MIA,over,8.5,0.5121951219512195,-105,0.48808156828023186,CIN,MIA,2022 REG,8,5,7,3,8,15,1,0,2,-2,1,1,1,0,0,0,0,0,0,0.48808156828023186,0.5119184317197681
86083,0.6000000000000001,0.4444444444444444,-150,125,0.5733333333333334,0.42666666666666664,home,CIN,under,8.5,0.5348837209302326,-115,0.5119184317197681,CIN,MIA,2022 REG,8,5,7,3,8,15,1,0,2,-2,1,1,1,0,0,0,0,0,0,0.48808156828023186,0.5119184317197681
86084,0.5495495495495495,0.49019607843137253,-122,104,0.5277073575960698,0.4722926424039302,away,TOR,over,8.5,0.5215311004784688,-109,0.4978845547971712,LAA,TOR,2022 REG,12,10,13,11,21,25,0,1,-1,1,1,1,1,1,1,1,1,1,1,0.4978845547971712,0.5021154452028288
86084,0.5495495495495495,0.49019607843137253,-122,104,0.5277073575960698,0.4722926424039302,home,LAA,under,8.5,0.5238095238095238,-110,0.5021154452028288,LAA,TOR,2022 REG,12,10,13,11,21,25,0,1,-1,1,1,1,1,1,1,1,1,1,1,0.4978845547971712,0.5021154452028288
86085,0.4424778761061947,0.6000000000000001,126,-150,0.42368235570522356,0.5763176442947764,away,SD,over,12,0.5169082125603864,-107,0.49353874091423283,COL,SD,2022 REG,14,10,8,4,14,22,1,0,6,-6,1,1,1,1,0,0,0,0,0,0.49353874091423283,0.5064612590857671
86085,0.4424778761061947,0.6000000000000001,126,-150,0.42368235570522356,0.5763176442947764,home,COL,under,12,0.5283018867924528,-112,0.5064612590857671,COL,SD,2022 REG,14,10,8,4,14,22,1,0,6,-6,1,1,1,1,0,0,0,0,0,0.49353874091423283,0.5064612590857671
86086,0.7058823529411764,0.3333333333333333,-240,200,0.6782006920415226,0.32179930795847744,away,ARI,over,9,0.5348837209302326,-115,0.5097020142727117,LAD,ARI,2022 REG,9,7,6,6,13,15,1,0,1,-1,1,1,1,1,1,1,0,0,0,0.5097020142727117,0.49029798572728833
86086,0.7058823529411764,0.3333333333333333,-240,200,0.6782006920415226,0.32179930795847744,home,LAD,under,9,0.5121951219512195,-105,0.49029798572728833,LAD,ARI,2022 REG,9,7,6,6,13,15,1,0,1,-1,1,1,1,1,1,1,0,0,0,0.5097020142727117,0.49029798572728833
86087,0.5555555555555556,0.48780487804878053,-125,105,0.5314664257753688,0.46853357422463116,away,COL,over,7.5,0.5348837209302326,-115,0.5097020142727117,MIA,COL,2022 REG,13,9,13,8,17,26,1,0,1,-1,1,1,1,1,1,1,1,1,0,0.5097020142727117,0.49029798572728833
86087,0.5555555555555556,0.48780487804878053,-125,105,0.5314664257753688,0.46853357422463116,home,MIA,under,7.5,0.5121951219512195,-105,0.49029798572728833,MIA,COL,2022 REG,13,9,13,8,17,26,1,0,1,-1,1,1,1,1,1,1,1,1,0,0.5097020142727117,0.49029798572728833
86088,0.6226415094339623,0.4166666666666667,-165,140,0.5981666073335706,0.40183339266642937,away,SEA,over,8.5,0.5238095238095238,-110,0.4988662131519274,NYY,SEA,2022 REG,10,6,8,8,14,18,0,1,-2,2,1,1,1,1,1,1,0,0,0,0.4988662131519274,0.5011337868480725
86088,0.6226415094339623,0.4166666666666667,-165,140,0.5981666073335706,0.40183339266642937,home,NYY,under,8.5,0.5238095238095238,-110,0.5011337868480725,NYY,SEA,2022 REG,10,6,8,8,14,18,0,1,-2,2,1,1,1,1,1,1,0,0,0,0.4988662131519274,0.5011337868480725
86089,0.7333333333333333,0.3076923076923077,-275,225,0.7032478632478633,0.29675213675213674,away,WSH,over,9,0.5121951219512195,-105,0.48808156828023186,PHI,WSH,2022 REG,13,11,13,5,16,26,1,0,6,-6,1,1,1,1,1,0,0,0,0,0.48808156828023186,0.5119184317197681
86089,0.7333333333333333,0.3076923076923077,-275,225,0.7032478632478633,0.29675213675213674,home,PHI,under,9,0.5348837209302326,-115,0.5119184317197681,PHI,WSH,2022 REG,13,11,13,5,16,26,1,0,6,-6,1,1,1,1,1,0,0,0,0,0.48808156828023186,0.5119184317197681
86091,0.6031746031746031,0.4347826086956522,-152,130,0.5802797769671475,0.4197202230328525,away,ARI,over,7,0.5238095238095238,-110,0.4988662131519274,SF,ARI,2022 REG,4,0,13,5,5,17,0,1,-5,5,0,0,0,0,0,0,0,0,0,0.4988662131519274,0.5011337868480725
86091,0.6031746031746031,0.4347826086956522,-152,130,0.5802797769671475,0.4197202230328525,home,SF,under,7,0.5238095238095238,-110,0.5011337868480725,SF,ARI,2022 REG,4,0,13,5,5,17,0,1,-5,5,0,0,0,0,0,0,0,0,0,0.4988662131519274,0.5011337868480725
86092,0.6503496503496503,0.3846153846153846,-186,160,0.6276101520856765,0.3723898479143235,away,OAK,over,8.5,0.5073891625615764,-103,0.4837652908580103,PHI,OAK,2022 REG,11,9,6,5,14,17,1,0,4,-4,1,1,1,1,1,0,0,0,0,0.4837652908580103,0.5162347091419897
86092,0.6503496503496503,0.3846153846153846,-186,160,0.6276101520856765,0.3723898479143235,home,PHI,under,8.5,0.5391705069124424,-117,0.5162347091419897,PHI,OAK,2022 REG,11,9,6,5,14,17,1,0,4,-4,1,1,1,1,1,0,0,0,0,0.4837652908580103,0.5162347091419897
86094,0.5348837209302326,0.5098039215686274,-115,-104,0.5109810284308424,0.48901897156915763,away,MIL,over,7.5,0.5391705069124424,-117,0.5140669063204599,SD,MIL,2022 REG,9,3,8,2,5,17,1,0,1,-1,1,1,0,0,0,0,0,0,0,0.5140669063204599,0.4859330936795401
86094,0.5348837209302326,0.5098039215686274,-115,-104,0.5109810284308424,0.48901897156915763,home,SD,under,7.5,0.5073891625615764,-103,0.4859330936795401,SD,MIL,2022 REG,9,3,8,2,5,17,1,0,1,-1,1,1,0,0,0,0,0,0,0,0.5140669063204599,0.4859330936795401
86095,0.6825396825396826,0.35714285714285715,-215,180,0.6554547745023935,0.34454522549760647,away,CLE,over,7,0.5391705069124424,-117,0.5140669063204599,NYY,CLE,2022 REG,13,10,6,2,12,19,1,0,8,-8,1,1,0,0,0,0,0,0,0,0.5140669063204599,0.4859330936795401
86095,0.6825396825396826,0.35714285714285715,-215,180,0.6554547745023935,0.34454522549760647,home,NYY,under,7,0.5073891625615764,-103,0.4859330936795401,NYY,CLE,2022 REG,13,10,6,2,12,19,1,0,8,-8,1,1,0,0,0,0,0,0,0,0.5140669063204599,0.4859330936795401
86096,0.6875,0.3508771929824561,-220,185,0.6611156798245614,0.33888432017543857,away,MIN,over,9.5,0.5169082125603864,-107,0.49353874091423283,TOR,MIN,2022 REG,4,3,12,9,12,16,0,1,-6,6,1,1,1,0,0,0,0,0,0,0.49353874091423283,0.5064612590857671
86096,0.6875,0.3508771929824561,-220,185,0.6611156798245614,0.33888432017543857,home,TOR,under,9.5,0.5283018867924528,-112,0.5064612590857671,TOR,MIN,2022 REG,4,3,12,9,12,16,0,1,-6,6,1,1,1,0,0,0,0,0,0,0.49353874091423283,0.5064612590857671
86097,0.5652173913043479,0.4672897196261683,-130,114,0.5468438068653605,0.4531561931346395,away,KC,over,7.5,0.5098039215686274,-104,0.48483656587239576,DET,KC,2022 REG,12,10,9,3,13,21,1,0,7,-7,1,1,1,0,0,0,0,0,0,0.48483656587239576,0.5151634341276042
86097,0.5652173913043479,0.4672897196261683,-130,114,0.5468438068653605,0.4531561931346395,home,DET,under,7.5,0.5391705069124424,-117,0.5151634341276042,DET,KC,2022 REG,12,10,9,3,13,21,1,0,7,-7,1,1,1,0,0,0,0,0,0,0.48483656587239576,0.5151634341276042
86098,0.6666666666666666,0.37037037037037035,-200,170,0.6419753086419753,0.3580246913580247,away,CIN,over,8.5,0.5454545454545454,-120,0.5220180091279142,LAD,CIN,2022 REG,10,9,4,1,10,14,1,0,8,-8,1,0,0,0,0,0,0,0,0,0.5220180091279142,0.4779819908720858
86098,0.6666666666666666,0.37037037037037035,-200,170,0.6419753086419753,0.3580246913580247,home,LAD,under,8.5,0.49751243781094534,101,0.4779819908720858,LAD,CIN,2022 REG,10,9,4,1,10,14,1,0,8,-8,1,0,0,0,0,0,0,0,0,0.5220180091279142,0.4779819908720858
86099,0.7058823529411764,0.3333333333333333,-240,200,0.6782006920415226,0.32179930795847744,away,COL,over,9,0.504950495049505,-102,0.48160416005266615,SF,COL,2022 REG,7,2,6,1,3,13,1,0,1,-1,1,0,0,0,0,0,0,0,0,0.48160416005266615,0.5183958399473338
86099,0.7058823529411764,0.3333333333333333,-240,200,0.6782006920415226,0.32179930795847744,home,SF,under,9,0.5412844036697247,-118,0.5183958399473338,SF,COL,2022 REG,7,2,6,1,3,13,1,0,1,-1,1,0,0,0,0,0,0,0,0,0.48160416005266615,0.5183958399473338
86101,0.4854368932038835,0.5555555555555556,106,-125,0.465537646233282,0.534462353766718,away,MIN,over,8,0.5121951219512195,-105,0.48808156828023186,KC,MIN,2022 REG,3,0,8,1,1,11,0,1,-1,1,0,0,0,0,0,0,0,0,0,0.48808156828023186,0.5119184317197681
86101,0.4854368932038835,0.5555555555555556,106,-125,0.465537646233282,0.534462353766718,home,KC,under,8,0.5348837209302326,-115,0.5119184317197681,KC,MIN,2022 REG,3,0,8,1,1,11,0,1,-1,1,0,0,0,0,0,0,0,0,0,0.48808156828023186,0.5119184317197681
86102,0.6491228070175439,0.3968253968253968,-185,152,0.6192967799615999,0.38070322003840007,away,OAK,over,8.5,0.5283018867924528,-112,0.5044173060022736,TEX,OAK,2022 REG,9,10,12,8,18,21,1,0,2,-2,1,1,1,1,1,1,1,1,0,0.5044173060022736,0.49558269399772636
86102,0.6491228070175439,0.3968253968253968,-185,152,0.6192967799615999,0.38070322003840007,home,TEX,under,8.5,0.5169082125603864,-107,0.49558269399772636,TEX,OAK,2022 REG,9,10,12,8,18,21,1,0,2,-2,1,1,1,1,1,1,1,1,0,0.5044173060022736,0.49558269399772636
86103,0.6254681647940076,0.4166666666666667,-167,140,0.5991141690863948,0.4008858309136052,away,CWS,over,7.5,0.5348837209302326,-115,0.5097020142727117,TOR,CWS,2022 REG,12,6,13,5,11,25,1,0,1,-1,1,1,1,1,1,0,0,0,0,0.5097020142727117,0.49029798572728833
86103,0.6254681647940076,0.4166666666666667,-167,140,0.5991141690863948,0.4008858309136052,home,TOR,under,7.5,0.5121951219512195,-105,0.49029798572728833,TOR,CWS,2022 REG,12,6,13,5,11,25,1,0,1,-1,1,1,1,1,1,0,0,0,0,0.5097020142727117,0.49029798572728833
86104,0.4807692307692307,0.5555555555555556,108,-125,0.4633053911900066,0.5366946088099934,away,NYM,over,10,0.5283018867924528,-112,0.5044173060022736,COL,NYM,2022 REG,9,1,13,5,6,22,0,1,-4,4,1,0,0,0,0,0,0,0,0,0.5044173060022736,0.49558269399772636
86104,0.4807692307692307,0.5555555555555556,108,-125,0.4633053911900066,0.5366946088099934,home,COL,under,10,0.5169082125603864,-107,0.49558269399772636,COL,NYM,2022 REG,9,1,13,5,6,22,0,1,-4,4,1,0,0,0,0,0,0,0,0,0.5044173060022736,0.49558269399772636
86105,0.5238095238095238,0.5192307692307692,-110,-108,0.5012646084074657,0.4987353915925343,away,BOS,over,7.5,0.5169082125603864,-107,0.49239402434819424,TB,BOS,2022 REG,9,4,7,3,7,16,1,0,1,-1,1,1,1,0,0,0,0,0,0,0.49239402434819424,0.5076059756518058
86105,0.5238095238095238,0.5192307692307692,-110,-108,0.5012646084074657,0.4987353915925343,home,TB,under,7.5,0.5305164319248826,-113,0.5076059756518058,TB,BOS,2022 REG,9,4,7,3,7,16,1,0,1,-1,1,1,1,0,0,0,0,0,0,0.49239402434819424,0.5076059756518058
86106,0.6226415094339623,0.4166666666666667,-165,140,0.5981666073335706,0.40183339266642937,away,PIT,over,8,0.5238095238095238,-110,0.4988662131519274,MIA,PIT,2022 REG,5,2,7,3,5,12,0,1,-1,1,1,1,0,0,0,0,0,0,0,0.4988662131519274,0.5011337868480725
86106,0.6226415094339623,0.4166666666666667,-165,140,0.5981666073335706,0.40183339266642937,home,MIA,under,8,0.5238095238095238,-110,0.5011337868480725,MIA,PIT,2022 REG,5,2,7,3,5,12,0,1,-1,1,1,1,0,0,0,0,0,0,0,0.4988662131519274,0.5011337868480725
86107,0.4444444444444444,0.6000000000000001,125,-150,0.4246913580246913,0.5753086419753086,away,MIL,over,9,0.5327102803738317,-114,0.5075272610403079,BAL,MIL,2022 REG,6,2,6,0,2,12,1,0,2,-2,0,0,0,0,0,0,0,0,0,0.5075272610403079,0.4924727389596921
86107,0.4444444444444444,0.6000000000000001,125,-150,0.4246913580246913,0.5753086419753086,home,BAL,under,9,0.5145631067961165,-106,0.4924727389596921,BAL,MIL,2022 REG,6,2,6,0,2,12,1,0,2,-2,0,0,0,0,0,0,0,0,0,0.5075272610403079,0.4924727389596921
86108,0.49019607843137253,0.5495495495495495,104,-122,0.4707129274603323,0.5292870725396677,away,NYM,over,6.5,0.504950495049505,-102,0.48054649490447493,MIA,NYM,2022 REG,7,4,11,6,10,18,0,1,-2,2,1,1,1,1,0,0,0,0,0,0.48054649490447493,0.5194535050955251
86108,0.49019607843137253,0.5495495495495495,104,-122,0.4707129274603323,0.5292870725396677,home,MIA,under,6.5,0.5433789954337899,-119,0.5194535050955251,MIA,NYM,2022 REG,7,4,11,6,10,18,0,1,-2,2,1,1,1,1,0,0,0,0,0,0.48054649490447493,0.5194535050955251
86109,0.47619047619047616,0.5594713656387665,110,-127,0.4592086467479796,0.5407913532520203,away,BAL,over,10,0.5348837209302326,-115,0.5097020142727117,CIN,BAL,2022 REG,7,2,9,6,8,16,0,1,-4,4,1,1,0,0,0,0,0,0,0,0.5097020142727117,0.49029798572728833
86109,0.47619047619047616,0.5594713656387665,110,-127,0.4592086467479796,0.5407913532520203,home,CIN,under,10,0.5121951219512195,-105,0.49029798572728833,CIN,BAL,2022 REG,7,2,9,6,8,16,0,1,-4,4,1,1,0,0,0,0,0,0,0,0.5097020142727117,0.49029798572728833
86110,0.5594713656387665,0.4807692307692307,-127,108,0.5369579042122659,0.46304209578773414,away,MIL,over,8,0.5073891625615764,-103,0.4837652908580103,TB,MIL,2022 REG,7,3,7,5,8,14,0,1,-2,2,1,1,1,0,0,0,0,0,0,0.4837652908580103,0.5162347091419897
86110,0.5594713656387665,0.4807692307692307,-127,108,0.5369579042122659,0.46304209578773414,home,TB,under,8,0.5391705069124424,-117,0.5162347091419897,TB,MIL,2022 REG,7,3,7,5,8,14,0,1,-2,2,1,1,1,0,0,0,0,0,0,0.4837652908580103,0.5162347091419897
86111,0.5815899581589958,0.45454545454545453,-139,120,0.5605739649961564,0.4394260350038436,away,SEA,over,7.5,0.5348837209302326,-115,0.5109810284308424,TB,SEA,2022 REG,7,2,6,1,3,13,1,0,1,-1,1,0,0,0,0,0,0,0,0,0.5109810284308424,0.48901897156915763
86111,0.5815899581589958,0.45454545454545453,-139,120,0.5605739649961564,0.4394260350038436,home,TB,under,7.5,0.5098039215686274,-104,0.48901897156915763,TB,SEA,2022 REG,7,2,6,1,3,13,1,0,1,-1,1,0,0,0,0,0,0,0,0,0.5109810284308424,0.48901897156915763
86112,0.5555555555555556,0.48780487804878053,-125,105,0.5314664257753688,0.46853357422463116,away,BAL,over,7.5,0.49019607843137253,104,0.46874141813588177,TB,BAL,2022 REG,8,5,10,4,9,18,1,0,1,-1,1,1,1,1,0,0,0,0,0,0.46874141813588177,0.5312585818641182
86112,0.5555555555555556,0.48780487804878053,-125,105,0.5314664257753688,0.46853357422463116,home,TB,under,7.5,0.5535714285714286,-124,0.5312585818641182,TB,BAL,2022 REG,8,5,10,4,9,18,1,0,1,-1,1,1,1,1,0,0,0,0,0,0.46874141813588177,0.5312585818641182
86113,0.5815899581589958,0.45454545454545453,-139,120,0.5605739649961564,0.4394260350038436,away,CIN,over,8,0.5348837209302326,-115,0.5109810284308424,CHC,CIN,2022 REG,7,3,9,4,7,16,0,1,-1,1,1,1,1,0,0,0,0,0,0,0.5109810284308424,0.48901897156915763
86113,0.5815899581589958,0.45454545454545453,-139,120,0.5605739649961564,0.4394260350038436,home,CHC,under,8,0.5098039215686274,-104,0.48901897156915763,CHC,CIN,2022 REG,7,3,9,4,7,16,0,1,-1,1,1,1,1,0,0,0,0,0,0,0.5109810284308424,0.48901897156915763
86115,0.5833333333333333,0.45454545454545453,-140,120,0.5612373737373737,0.4387626262626263,away,BOS,over,9.5,0.49751243781094534,101,0.476135829221149,NYY,BOS,2022 REG,11,3,5,4,7,16,0,1,-1,1,1,1,1,0,0,0,0,0,0,0.476135829221149,0.523864170778851
86115,0.5833333333333333,0.45454545454545453,-140,120,0.5612373737373737,0.4387626262626263,home,NYY,under,9.5,0.5454545454545454,-120,0.523864170778851,NYY,BOS,2022 REG,11,3,5,4,7,16,0,1,-1,1,1,1,1,0,0,0,0,0,0,0.476135829221149,0.523864170778851
86116,0.7142857142857143,0.3278688524590164,-250,205,0.6841753094680495,0.3158246905319505,away,WSH,over,13.5,0.5121951219512195,-105,0.4774935554233591,MIL,WSH,2022 REG,8,2,14,8,10,22,0,1,-6,6,1,1,0,0,0,0,0,0,0,0.4774935554233591,0.522506444576641
86116,0.7142857142857143,0.3278688524590164,-250,205,0.6841753094680495,0.3158246905319505,home,MIL,under,13.5,0.5555555555555556,-125,0.522506444576641,MIL,WSH,2022 REG,8,2,14,8,10,22,0,1,-6,6,1,1,0,0,0,0,0,0,0,0.4774935554233591,0.522506444576641
86117,0.5726495726495727,0.46511627906976744,-134,115,0.5510229738017454,0.44897702619825464,away,STL,over,8.5,0.5370370370370371,-116,0.5118817074154765,MIL,STL,2022 REG,7,6,5,5,11,12,1,0,1,-1,1,1,1,1,1,0,0,0,0,0.5118817074154765,0.48811829258452355
86117,0.5726495726495727,0.46511627906976744,-134,115,0.5510229738017454,0.44897702619825464,home,MIL,under,8.5,0.5098039215686274,-104,0.48811829258452355,MIL,STL,2022 REG,7,6,5,5,11,12,1,0,1,-1,1,1,1,1,1,0,0,0,0,0.5118817074154765,0.48811829258452355
86118,0.35714285714285715,0.6774193548387096,180,-210,0.3447992100065833,0.6552007899934167,away,LAD,over,11.5,0.5121951219512195,-105,0.48919479393107135,COL,LAD,2022 REG,10,4,11,8,12,21,0,1,-4,4,1,1,1,1,0,0,0,0,0,0.48919479393107135,0.5108052060689287
86118,0.35714285714285715,0.6774193548387096,180,-210,0.3447992100065833,0.6552007899934167,home,COL,under,11.5,0.5327102803738317,-114,0.5108052060689287,COL,LAD,2022 REG,10,4,11,8,12,21,0,1,-4,4,1,1,1,1,0,0,0,0,0,0.48919479393107135,0.5108052060689287
86119,0.7058823529411764,0.3472222222222222,-240,188,0.6683967704728951,0.33160322952710486,away,WSH,over,9.5,0.5121951219512195,-105,0.48808156828023186,ATL,WSH,2022 REG,9,4,12,3,7,21,1,0,1,-1,1,1,1,0,0,0,0,0,0,0.48808156828023186,0.5119184317197681
86119,0.7058823529411764,0.3472222222222222,-240,188,0.6683967704728951,0.33160322952710486,home,ATL,under,9.5,0.5348837209302326,-115,0.5119184317197681,ATL,WSH,2022 REG,9,4,12,3,7,21,1,0,1,-1,1,1,1,0,0,0,0,0,0,0.48808156828023186,0.5119184317197681
86120,0.4166666666666667,0.6153846153846154,140,-160,0.40331196581196577,0.5966880341880343,away,NYY,over,9,0.49751243781094534,101,0.476135829221149,MIN,NYY,2022 REG,12,4,14,10,14,26,0,1,-6,6,1,1,1,1,0,0,0,0,0,0.476135829221149,0.523864170778851
86120,0.4166666666666667,0.6153846153846154,140,-160,0.40331196581196577,0.5966880341880343,home,MIN,under,9,0.5454545454545454,-120,0.523864170778851,MIN,NYY,2022 REG,12,4,14,10,14,26,0,1,-6,6,1,1,1,1,0,0,0,0,0,0.476135829221149,0.523864170778851
86121,0.5,0.5412844036697247,100,-118,0.47935779816513757,0.5206422018348624,away,MIN,over,9,0.5454545454545454,-120,0.5206611570247933,KC,MIN,2022 REG,11,5,11,4,9,22,1,0,1,-1,1,1,1,1,0,0,0,0,0,0.5206611570247933,0.4793388429752067
86121,0.5,0.5412844036697247,100,-118,0.47935779816513757,0.5206422018348624,home,KC,under,9,0.5,100,0.4793388429752067,KC,MIN,2022 REG,11,5,11,4,9,22,1,0,1,-1,1,1,1,1,0,0,0,0,0,0.5206611570247933,0.4793388429752067
86122,0.4166666666666667,0.6183206106870228,140,-162,0.40208863443596277,0.5979113655640372,away,MIN,over,8,0.5283018867924528,-112,0.5044173060022736,BAL,MIN,2022 REG,11,5,9,3,8,20,1,0,2,-2,1,1,1,0,0,0,0,0,0,0.5044173060022736,0.49558269399772636
86122,0.4166666666666667,0.6183206106870228,140,-162,0.40208863443596277,0.5979113655640372,home,BAL,under,8,0.5169082125603864,-107,0.49558269399772636,BAL,MIN,2022 REG,11,5,9,3,8,20,1,0,2,-2,1,1,1,0,0,0,0,0,0,0.5044173060022736,0.49558269399772636
86123,0.4347826086956522,0.6000000000000001,130,-150,0.4196597353497164,0.5803402646502835,away,HOU,over,8,0.5283018867924528,-112,0.5031902949311281,CWS,HOU,2022 REG,8,2,5,3,5,13,0,1,-1,1,1,1,0,0,0,0,0,0,0,0.5031902949311281,0.4968097050688719
86123,0.4347826086956522,0.6000000000000001,130,-150,0.4196597353497164,0.5803402646502835,home,CWS,under,8,0.5192307692307692,-108,0.4968097050688719,CWS,HOU,2022 REG,8,2,5,3,5,13,0,1,-1,1,1,1,0,0,0,0,0,0,0,0.5031902949311281,0.4968097050688719
86124,0.6363636363636364,0.4081632653061224,-175,145,0.6080283353010626,0.3919716646989374,away,CLE,over,7.5,0.5192307692307692,-108,0.49571111079951763,LAD,CLE,2022 REG,8,3,11,5,8,19,0,1,-2,2,1,1,1,0,0,0,0,0,0,0.49571111079951763,0.5042888892004824
86124,0.6363636363636364,0.4081632653061224,-175,145,0.6080283353010626,0.3919716646989374,home,LAD,under,7.5,0.5260663507109005,-111,0.5042888892004824,LAD,CLE,2022 REG,8,3,11,5,8,19,0,1,-2,2,1,1,1,0,0,0,0,0,0,0.49571111079951763,0.5042888892004824
86125,0.6254681647940076,0.41152263374485604,-167,143,0.6023315979176397,0.3976684020823603,away,DET,over,8.5,0.5238095238095238,-110,0.5012646084074657,TEX,DET,2022 REG,10,8,13,9,17,23,0,1,-1,1,1,1,1,1,1,1,1,1,0,0.5012646084074657,0.4987353915925343
86125,0.6254681647940076,0.41152263374485604,-167,143,0.6023315979176397,0.3976684020823603,home,TEX,under,8.5,0.5192307692307692,-108,0.4987353915925343,TEX,DET,2022 REG,10,8,13,9,17,23,0,1,-1,1,1,1,1,1,1,1,1,1,0,0.5012646084074657,0.4987353915925343
86126,0.5967741935483871,0.43859649122807015,-148,128,0.5756658816656627,0.4243341183343373,away,COL,over,9.5,0.5192307692307692,-108,0.49455035168025013,CHC,COL,2022 REG,9,1,5,3,4,14,0,1,-2,2,1,0,0,0,0,0,0,0,0,0.49455035168025013,0.5054496483197499
86126,0.5967741935483871,0.43859649122807015,-148,128,0.5756658816656627,0.4243341183343373,home,CHC,under,9.5,0.5283018867924528,-112,0.5054496483197499,CHC,COL,2022 REG,9,1,5,3,4,14,0,1,-2,2,1,0,0,0,0,0,0,0,0,0.49455035168025013,0.5054496483197499
86127,0.5555555555555556,0.48780487804878053,-125,105,0.5314664257753688,0.46853357422463116,away,MIA,over,7.5,0.5121951219512195,-105,0.48919479393107135,PHI,MIA,2022 REG,8,4,9,3,7,17,1,0,1,-1,1,1,1,0,0,0,0,0,0,0.48919479393107135,0.5108052060689287
86127,0.5555555555555556,0.48780487804878053,-125,105,0.5314664257753688,0.46853357422463116,home,PHI,under,7.5,0.5327102803738317,-114,0.5108052060689287,PHI,MIA,2022 REG,8,4,9,3,7,17,1,0,1,-1,1,1,1,0,0,0,0,0,0,0.48919479393107135,0.5108052060689287
86128,0.46511627906976744,0.574468085106383,115,-135,0.44670494689481377,0.5532950531051862,away,LAD,over,9,0.49504950495049505,102,0.47297076509898783,CWS,LAD,2022 REG,10,9,12,11,20,22,0,1,-2,2,1,1,1,1,1,1,1,1,1,0.47297076509898783,0.5270292349010122
86128,0.46511627906976744,0.574468085106383,115,-135,0.44670494689481377,0.5532950531051862,home,CWS,under,9,0.5495495495495495,-122,0.5270292349010122,CWS,LAD,2022 REG,10,9,12,11,20,22,0,1,-2,2,1,1,1,1,1,1,1,1,1,0.47297076509898783,0.5270292349010122
86129,0.5884773662551441,0.4484304932735426,-143,123,0.5667579262855877,0.43324207371441226,away,BOS,over,8.5,0.5370370370370371,-116,0.5118817074154765,TOR,BOS,2022 REG,5,1,13,7,8,18,0,1,-6,6,1,0,0,0,0,0,0,0,0,0.5118817074154765,0.48811829258452355
86129,0.5884773662551441,0.4484304932735426,-143,123,0.5667579262855877,0.43324207371441226,home,TOR,under,8.5,0.5098039215686274,-104,0.48811829258452355,TOR,BOS,2022 REG,5,1,13,7,8,18,0,1,-6,6,1,0,0,0,0,0,0,0,0,0.5118817074154765,0.48811829258452355
86130,0.5555555555555556,0.48309178743961345,-125,107,0.5340848094471283,0.46591519055287167,away,BAL,over,9,0.5,100,0.4772727272727273,TEX,BAL,2022 REG,10,2,9,8,10,19,0,1,-6,6,1,1,0,0,0,0,0,0,0,0.4772727272727273,0.5227272727272727
86130,0.5555555555555556,0.48309178743961345,-125,107,0.5340848094471283,0.46591519055287167,home,TEX,under,9,0.5454545454545454,-120,0.5227272727272727,TEX,BAL,2022 REG,10,2,9,8,10,19,0,1,-6,6,1,1,0,0,0,0,0,0,0,0.4772727272727273,0.5227272727272727
86131,0.37735849056603776,0.6610169491525424,165,-195,0.36287719255902645,0.6371228074409736,away,HOU,over,7.5,0.5238095238095238,-110,0.4988662131519274,BAL,HOU,2022 REG,17,10,12,11,21,29,0,1,-1,1,1,1,1,1,1,1,1,1,1,0.4988662131519274,0.5011337868480725
86131,0.37735849056603776,0.6610169491525424,165,-195,0.36287719255902645,0.6371228074409736,home,BAL,under,7.5,0.5238095238095238,-110,0.5011337868480725,BAL,HOU,2022 REG,17,10,12,11,21,29,0,1,-1,1,1,1,1,1,1,1,1,1,1,0.4988662131519274,0.5011337868480725
86132,0.5495495495495495,0.48309178743961345,-122,107,0.53161151751046,0.46838848248954,away,COL,over,9.5,0.5327102803738317,-114,0.508788710910954,CHC,COL,2022 REG,6,3,6,4,7,12,0,1,-1,1,1,1,1,0,0,0,0,0,0,0.508788710910954,0.491211289089046
86132,0.5495495495495495,0.48309178743961345,-122,107,0.53161151751046,0.46838848248954,home,CHC,under,9.5,0.5121951219512195,-105,0.491211289089046,CHC,COL,2022 REG,6,3,6,4,7,12,0,1,-1,1,1,1,1,0,0,0,0,0,0,0.508788710910954,0.491211289089046
86133,0.41152263374485604,0.6296296296296295,143,-170,0.39458754593642575,0.6054124540635742,away,SD,over,11,0.5348837209302326,-115,0.5084354177277668,COL,SD,2022 REG,8,4,6,3,7,14,1,0,1,-1,1,1,1,0,0,0,0,0,0,0.5084354177277668,0.4915645822722332
86133,0.41152263374485604,0.6296296296296295,143,-170,0.39458754593642575,0.6054124540635742,home,COL,under,11,0.5145631067961165,-106,0.4915645822722332,COL,SD,2022 REG,8,4,6,3,7,14,1,0,1,-1,1,1,1,0,0,0,0,0,0,0.5084354177277668,0.4915645822722332
86134,0.5555555555555556,0.4854368932038835,-125,106,0.5327819729114227,0.4672180270885773,away,ARI,over,7.5,0.49751243781094534,101,0.47511256217505476,CHC,ARI,2022 REG,8,5,8,4,9,16,1,0,1,-1,1,1,1,1,0,0,0,0,0,0.47511256217505476,0.5248874378249453
86134,0.5555555555555556,0.4854368932038835,-125,106,0.5327819729114227,0.4672180270885773,home,CHC,under,7.5,0.5475113122171946,-121,0.5248874378249453,CHC,ARI,2022 REG,8,5,8,4,9,16,1,0,1,-1,1,1,1,1,0,0,0,0,0,0.47511256217505476,0.5248874378249453
86136,0.6551724137931035,0.3802281368821293,-190,163,0.6319789495576061,0.36802105044239386,away,KC,over,7,0.5391705069124424,-117,0.5140669063204599,CLE,KC,2022 REG,8,5,6,3,8,14,1,0,2,-2,1,1,1,0,0,0,0,0,0,0.5140669063204599,0.4859330936795401
86136,0.6551724137931035,0.3802281368821293,-190,163,0.6319789495576061,0.36802105044239386,home,CLE,under,7,0.5073891625615764,-103,0.4859330936795401,CLE,KC,2022 REG,8,5,6,3,8,14,1,0,2,-2,1,1,1,0,0,0,0,0,0,0.5140669063204599,0.4859330936795401
86138,0.5370370370370371,0.5073891625615764,-116,-103,0.5131785224377817,0.4868214775622183,away,NYY,over,8.5,0.5283018867924528,-112,0.5031902949311281,STL,NYY,2022 REG,5,1,2,0,1,7,1,0,1,-1,0,0,0,0,0,0,0,0,0,0.5031902949311281,0.4968097050688719
86138,0.5370370370370371,0.5073891625615764,-116,-103,0.5131785224377817,0.4868214775622183,home,STL,under,8.5,0.5192307692307692,-108,0.4968097050688719,STL,NYY,2022 REG,5,1,2,0,1,7,1,0,1,-1,0,0,0,0,0,0,0,0,0,0.5031902949311281,0.4968097050688719
86139,0.696969696969697,0.3448275862068966,-230,190,0.6678382571799499,0.33216174282005007,away,OAK,over,8,0.5412844036697247,-118,0.5175913212324037,BAL,OAK,2022 REG,11,8,8,1,9,19,1,0,7,-7,1,0,0,0,0,0,0,0,0,0.5175913212324037,0.4824086787675963
86139,0.696969696969697,0.3448275862068966,-230,190,0.6678382571799499,0.33216174282005007,home,BAL,under,8,0.5024875621890548,-101,0.4824086787675963,BAL,OAK,2022 REG,11,8,8,1,9,19,1,0,7,-7,1,0,0,0,0,0,0,0,0,0.5175913212324037,0.4824086787675963
86140,0.46511627906976744,0.574468085106383,115,-135,0.44670494689481377,0.5532950531051862,away,SEA,over,7.5,0.5121951219512195,-105,0.48808156828023186,CLE,SEA,2022 REG,9,1,7,6,7,16,0,1,-5,5,1,0,0,0,0,0,0,0,0,0.48808156828023186,0.5119184317197681
86140,0.46511627906976744,0.574468085106383,115,-135,0.44670494689481377,0.5532950531051862,home,CLE,under,7.5,0.5348837209302326,-115,0.5119184317197681,CLE,SEA,2022 REG,9,1,7,6,7,16,0,1,-5,5,1,0,0,0,0,0,0,0,0,0.48808156828023186,0.5119184317197681
86141,0.7468354430379747,0.29850746268656714,-295,235,0.7129717539525574,0.2870282460474426,away,KC,over,9,0.5169082125603864,-107,0.49353874091423283,NYY,KC,2022 REG,8,8,7,2,10,15,1,0,6,-6,1,1,0,0,0,0,0,0,0,0.49353874091423283,0.5064612590857671
86141,0.7468354430379747,0.29850746268656714,-295,235,0.7129717539525574,0.2870282460474426,home,NYY,under,9,0.5283018867924528,-112,0.5064612590857671,NYY,KC,2022 REG,8,8,7,2,10,15,1,0,6,-6,1,1,0,0,0,0,0,0,0,0.49353874091423283,0.5064612590857671
86142,0.4347826086956522,0.6000000000000001,130,-150,0.4196597353497164,0.5803402646502835,away,TEX,over,8.5,0.5305164319248826,-113,0.5053568787472517,DET,TEX,2022 REG,8,7,5,3,10,13,1,0,4,-4,1,1,1,0,0,0,0,0,0,0.5053568787472517,0.49464312125274834
86142,0.4347826086956522,0.6000000000000001,130,-150,0.4196597353497164,0.5803402646502835,home,DET,under,8.5,0.5169082125603864,-107,0.49464312125274834,DET,TEX,2022 REG,8,7,5,3,10,13,1,0,4,-4,1,1,1,0,0,0,0,0,0,0.5053568787472517,0.49464312125274834
86143,0.5495495495495495,0.48780487804878053,-122,105,0.529021440689206,0.470978559310794,away,KC,over,8.5,0.5169082125603864,-107,0.49353874091423283,DET,KC,2022 REG,8,2,15,12,14,23,0,1,-10,10,1,1,0,0,0,0,0,0,0,0.49353874091423283,0.5064612590857671
86143,0.5495495495495495,0.48780487804878053,-122,105,0.529021440689206,0.470978559310794,home,DET,under,8.5,0.5283018867924528,-112,0.5064612590857671,DET,KC,2022 REG,8,2,15,12,14,23,0,1,-10,10,1,1,0,0,0,0,0,0,0,0.49353874091423283,0.5064612590857671
86144,0.5454545454545454,0.49019607843137253,-120,104,0.526008750607681,0.47399124939231896,away,SF,over,6.5,0.5412844036697247,-118,0.5136310900085983,NYM,SF,2022 REG,8,3,2,1,4,10,1,0,2,-2,1,0,0,0,0,0,0,0,0,0.5136310900085983,0.4863689099914017
86144,0.5454545454545454,0.49019607843137253,-120,104,0.526008750607681,0.47399124939231896,home,NYM,under,6.5,0.5098039215686274,-104,0.4863689099914017,NYM,SF,2022 REG,8,3,2,1,4,10,1,0,2,-2,1,0,0,0,0,0,0,0,0,0.5136310900085983,0.4863689099914017
86145,0.7752808988764045,0.27027027027027023,-345,270,0.7399659475154994,0.2600340524845006,away,KC,over,8,0.5238095238095238,-110,0.4988662131519274,TOR,KC,2022 REG,16,8,5,1,9,21,1,0,7,-7,1,0,0,0,0,0,0,0,0,0.4988662131519274,0.5011337868480725
86145,0.7752808988764045,0.27027027027027023,-345,270,0.7399659475154994,0.2600340524845006,home,TOR,under,8,0.5238095238095238,-110,0.5011337868480725,TOR,KC,2022 REG,16,8,5,1,9,21,1,0,7,-7,1,0,0,0,0,0,0,0,0,0.4988662131519274,0.5011337868480725
86146,0.49504950495049505,0.5454545454545454,102,-120,0.47499799484898986,0.5250020051510101,away,LAA,over,8.5,0.5454545454545454,-120,0.5206611570247933,TEX,LAA,2022 REG,5,2,13,5,7,18,0,1,-3,3,1,1,0,0,0,0,0,0,0,0.5206611570247933,0.4793388429752067
86146,0.49504950495049505,0.5454545454545454,102,-120,0.47499799484898986,0.5250020051510101,home,TEX,under,8.5,0.5,100,0.4793388429752067,TEX,LAA,2022 REG,5,2,13,5,7,18,0,1,-3,3,1,1,0,0,0,0,0,0,0,0.5206611570247933,0.4793388429752067
86147,0.6666666666666666,0.37735849056603776,-200,165,0.6373165618448637,0.36268343815513626,away,COL,over,7.5,0.5238095238095238,-110,0.5000596729920038,MIA,COL,2022 REG,11,7,6,4,11,17,1,0,3,-3,1,1,1,1,0,0,0,0,0,0.5000596729920038,0.4999403270079962
86147,0.6666666666666666,0.37735849056603776,-200,165,0.6373165618448637,0.36268343815513626,home,MIA,under,7.5,0.5215311004784688,-109,0.4999403270079962,MIA,COL,2022 REG,11,7,6,4,11,17,1,0,3,-3,1,1,1,1,0,0,0,0,0,0.5000596729920038,0.4999403270079962
86148,0.4347826086956522,0.607843137254902,130,-155,0.41624967567367205,0.583750324326328,away,CWS,over,7.5,0.5391705069124424,-117,0.5153817639191344,DET,CWS,2022 REG,6,3,6,2,5,12,1,0,1,-1,1,1,0,0,0,0,0,0,0,0.5153817639191344,0.4846182360808656
86148,0.4347826086956522,0.607843137254902,130,-155,0.41624967567367205,0.583750324326328,home,DET,under,7.5,0.504950495049505,-102,0.4846182360808656,DET,CWS,2022 REG,6,3,6,2,5,12,1,0,1,-1,1,1,0,0,0,0,0,0,0,0.5153817639191344,0.4846182360808656
86149,0.5555555555555556,0.4854368932038835,-125,106,0.5327819729114227,0.4672180270885773,away,CHC,over,10,0.5238095238095238,-110,0.4988662131519274,COL,CHC,2022 REG,11,6,13,5,11,24,1,0,1,-1,1,1,1,1,1,0,0,0,0,0.4988662131519274,0.5011337868480725
86149,0.5555555555555556,0.4854368932038835,-125,106,0.5327819729114227,0.4672180270885773,home,COL,under,10,0.5238095238095238,-110,0.5011337868480725,COL,CHC,2022 REG,11,6,13,5,11,24,1,0,1,-1,1,1,1,1,1,0,0,0,0,0.4988662131519274,0.5011337868480725
86150,0.5833333333333333,0.4587155963302753,-140,118,0.5588047910295616,0.4411952089704384,away,CHC,over,7.5,0.5073891625615764,-103,0.4826927225525911,SF,CHC,2022 REG,13,2,6,4,6,19,0,1,-2,2,1,1,0,0,0,0,0,0,0,0.4826927225525911,0.5173072774474089
86150,0.5833333333333333,0.4587155963302753,-140,118,0.5588047910295616,0.4411952089704384,home,SF,under,7.5,0.5412844036697247,-118,0.5173072774474089,SF,CHC,2022 REG,13,2,6,4,6,19,0,1,-2,2,1,1,0,0,0,0,0,0,0,0.4826927225525911,0.5173072774474089
86152,0.29411764705882354,0.7468354430379747,240,-295,0.28207262055976523,0.7179273794402348,away,SD,over,9,0.5192307692307692,-108,0.49455035168025013,WSH,SD,2022 REG,10,5,14,10,15,24,0,1,-5,5,1,1,1,1,1,0,0,0,0,0.49455035168025013,0.5054496483197499
86152,0.29411764705882354,0.7468354430379747,240,-295,0.28207262055976523,0.7179273794402348,home,WSH,under,9,0.5283018867924528,-112,0.5054496483197499,WSH,SD,2022 REG,10,5,14,10,15,24,0,1,-5,5,1,1,1,1,1,0,0,0,0,0.49455035168025013,0.5054496483197499
86153,0.5850622406639003,0.4484304932735426,-141,123,0.5654669067005001,0.43453309329949985,away,NYM,over,7,0.5305164319248826,-113,0.5066009958897986,MIA,NYM,2022 REG,11,3,6,5,8,17,0,1,-2,2,1,1,1,0,0,0,0,0,0,0.5066009958897986,0.49339900411020143
86153,0.5850622406639003,0.4484304932735426,-141,123,0.5654669067005001,0.43453309329949985,home,MIA,under,7,0.5145631067961165,-106,0.49339900411020143,MIA,NYM,2022 REG,11,3,6,5,8,17,0,1,-2,2,1,1,1,0,0,0,0,0,0,0.5066009958897986,0.49339900411020143
86154,0.6721311475409836,0.37037037037037035,-205,170,0.6435645535349916,0.35643544646500835,away,SF,over,7,0.5348837209302326,-115,0.5097020142727117,MIL,SF,2022 REG,5,2,6,4,6,11,0,1,-2,2,1,1,0,0,0,0,0,0,0,0.5097020142727117,0.49029798572728833
86154,0.6721311475409836,0.37037037037037035,-205,170,0.6435645535349916,0.35643544646500835,home,MIL,under,7,0.5121951219512195,-105,0.49029798572728833,MIL,SF,2022 REG,5,2,6,4,6,11,0,1,-2,2,1,1,0,0,0,0,0,0,0,0.5097020142727117,0.49029798572728833
86155,0.425531914893617,0.613899613899614,135,-159,0.40875254093905067,0.5912474590609493,away,NYY,over,8.5,0.5238095238095238,-110,0.4988662131519274,STL,NYY,2022 REG,5,4,10,3,7,15,1,0,1,-1,1,1,1,0,0,0,0,0,0,0.4988662131519274,0.5011337868480725
86155,0.425531914893617,0.613899613899614,135,-159,0.40875254093905067,0.5912474590609493,home,STL,under,8.5,0.5238095238095238,-110,0.5011337868480725,STL,NYY,2022 REG,5,4,10,3,7,15,1,0,1,-1,1,1,1,0,0,0,0,0,0,0.4988662131519274,0.5011337868480725
86156,0.6491228070175439,0.3846153846153846,-185,160,0.6272225773610816,0.37277742263891844,away,LAA,over,8,0.5283018867924528,-112,0.5044173060022736,PHI,LAA,2022 REG,7,7,7,2,9,14,1,0,5,-5,1,1,0,0,0,0,0,0,0,0.5044173060022736,0.49558269399772636
86156,0.6491228070175439,0.3846153846153846,-185,160,0.6272225773610816,0.37277742263891844,home,PHI,under,8,0.5169082125603864,-107,0.49558269399772636,PHI,LAA,2022 REG,7,7,7,2,9,14,1,0,5,-5,1,1,0,0,0,0,0,0,0,0.5044173060022736,0.49558269399772636
86157,0.7354497354497355,0.29850746268656714,-278,235,0.7104759230637776,0.2895240769362224,away,CIN,over,8.5,0.5121951219512195,-105,0.48919479393107135,STL,CIN,2022 REG,8,6,8,5,11,16,1,0,1,-1,1,1,1,1,1,0,0,0,0,0.48919479393107135,0.5108052060689287
86157,0.7354497354497355,0.29850746268656714,-278,235,0.7104759230637776,0.2895240769362224,home,STL,under,8.5,0.5327102803738317,-114,0.5108052060689287,STL,CIN,2022 REG,8,6,8,5,11,16,1,0,1,-1,1,1,1,1,1,0,0,0,0,0.48919479393107135,0.5108052060689287
86158,0.5535714285714286,0.48780487804878053,-124,105,0.53066668740667,0.46933331259333,away,WSH,over,9.5,0.49751243781094534,101,0.476135829221149,PIT,WSH,2022 REG,14,9,8,4,13,22,1,0,5,-5,1,1,1,1,0,0,0,0,0,0.476135829221149,0.523864170778851
86158,0.5535714285714286,0.48780487804878053,-124,105,0.53066668740667,0.46933331259333,home,PIT,under,9.5,0.5454545454545454,-120,0.523864170778851,PIT,WSH,2022 REG,14,9,8,4,13,22,1,0,5,-5,1,1,1,1,0,0,0,0,0,0.476135829221149,0.523864170778851
86159,0.4291845493562232,0.607843137254902,133,-155,0.41329283836432396,0.586707161635676,away,ATL,over,9,0.5475113122171946,-121,0.5242087833606768,ARI,ATL,2022 REG,3,0,12,6,6,15,0,1,-6,6,0,0,0,0,0,0,0,0,0,0.5242087833606768,0.4757912166393232
86159,0.4291845493562232,0.607843137254902,133,-155,0.41329283836432396,0.586707161635676,home,ARI,under,9,0.49504950495049505,102,0.4757912166393232,ARI,ATL,2022 REG,3,0,12,6,6,15,0,1,-6,6,0,0,0,0,0,0,0,0,0,0.5242087833606768,0.4757912166393232
86160,0.726027397260274,0.31746031746031744,-265,215,0.6944541249288857,0.3055458750711143,away,WSH,over,9,0.5348837209302326,-115,0.5097020142727117,ATL,WSH,2022 REG,15,12,5,2,14,20,1,0,10,-10,1,1,0,0,0,0,0,0,0,0.5097020142727117,0.49029798572728833
86160,0.726027397260274,0.31746031746031744,-265,215,0.6944541249288857,0.3055458750711143,home,ATL,under,9,0.5121951219512195,-105,0.49029798572728833,ATL,WSH,2022 REG,15,12,5,2,14,20,1,0,10,-10,1,1,0,0,0,0,0,0,0,0.5097020142727117,0.49029798572728833
86161,0.37735849056603776,0.6610169491525424,165,-195,0.36287719255902645,0.6371228074409736,away,NYM,over,8,0.5238095238095238,-110,0.4988662131519274,MIA,NYM,2022 REG,4,0,9,4,4,13,0,1,-4,4,0,0,0,0,0,0,0,0,0,0.4988662131519274,0.5011337868480725
86161,0.37735849056603776,0.6610169491525424,165,-195,0.36287719255902645,0.6371228074409736,home,MIA,under,8,0.5238095238095238,-110,0.5011337868480725,MIA,NYM,2022 REG,4,0,9,4,4,13,0,1,-4,4,0,0,0,0,0,0,0,0,0,0.4988662131519274,0.5011337868480725
86162,0.6000000000000001,0.4347826086956522,-150,130,0.5791304347826086,0.4208695652173914,away,SD,over,7.5,0.5348837209302326,-115,0.5097020142727117,NYM,SD,2022 REG,8,1,4,2,3,12,0,1,-1,1,1,0,0,0,0,0,0,0,0,0.5097020142727117,0.49029798572728833
86162,0.6000000000000001,0.4347826086956522,-150,130,0.5791304347826086,0.4208695652173914,home,NYM,under,7.5,0.5121951219512195,-105,0.49029798572728833,NYM,SD,2022 REG,8,1,4,2,3,12,0,1,-1,1,1,0,0,0,0,0,0,0,0,0.5097020142727117,0.49029798572728833
86163,0.7058823529411764,0.33783783783783783,-240,196,0.6750210418030487,0.32497895819695133,away,BAL,over,6.5,0.5412844036697247,-118,0.5175913212324037,NYY,BAL,2022 REG,14,8,3,0,8,17,1,0,8,-8,0,0,0,0,0,0,0,0,0,0.5175913212324037,0.4824086787675963
86163,0.7058823529411764,0.33783783783783783,-240,196,0.6750210418030487,0.32497895819695133,home,NYY,under,6.5,0.5024875621890548,-101,0.4824086787675963,NYY,BAL,2022 REG,14,8,3,0,8,17,1,0,8,-8,0,0,0,0,0,0,0,0,0,0.5175913212324037,0.4824086787675963
86164,0.6923076923076923,0.3472222222222222,-225,188,0.6649408284023669,0.3350591715976331,away,MIN,over,8,0.5215311004784688,-109,0.49670754937970685,MIL,MIN,2022 REG,8,10,7,4,14,15,1,0,6,-6,1,1,1,1,0,0,0,0,0,0.49670754937970685,0.5032924506202932
86164,0.6923076923076923,0.3472222222222222,-225,188,0.6649408284023669,0.3350591715976331,home,MIL,under,8,0.5260663507109005,-111,0.5032924506202932,MIL,MIN,2022 REG,8,10,7,4,14,15,1,0,6,-6,1,1,1,1,0,0,0,0,0,0.49670754937970685,0.5032924506202932
86165,0.3333333333333333,0.7101449275362319,200,-245,0.3188405797101449,0.6811594202898551,away,STL,over,9.5,0.5215311004784688,-109,0.4978845547971712,CIN,STL,2022 REG,14,3,8,5,8,22,0,1,-2,2,1,1,1,0,0,0,0,0,0,0.4978845547971712,0.5021154452028288
86165,0.3333333333333333,0.7101449275362319,200,-245,0.3188405797101449,0.6811594202898551,home,CIN,under,9.5,0.5238095238095238,-110,0.5021154452028288,CIN,STL,2022 REG,14,3,8,5,8,22,0,1,-2,2,1,1,1,0,0,0,0,0,0,0.4978845547971712,0.5021154452028288
86166,0.3472222222222222,0.6923076923076923,188,-225,0.3334965574548908,0.6665034425451092,away,LAD,over,9,0.5,100,0.47935779816513757,ARI,LAD,2022 REG,5,0,7,6,6,12,0,1,-6,6,0,0,0,0,0,0,0,0,0,0.47935779816513757,0.5206422018348624
86166,0.3472222222222222,0.6923076923076923,188,-225,0.3334965574548908,0.6665034425451092,home,ARI,under,9,0.5412844036697247,-118,0.5206422018348624,ARI,LAD,2022 REG,5,0,7,6,6,12,0,1,-6,6,0,0,0,0,0,0,0,0,0,0.47935779816513757,0.5206422018348624
86167,0.35714285714285715,0.6774193548387096,180,-210,0.3447992100065833,0.6552007899934167,away,LAD,over,11.5,0.5024875621890548,-101,0.48049269377245407,COL,LAD,2022 REG,7,3,8,5,8,15,0,1,-2,2,1,1,1,0,0,0,0,0,0,0.48049269377245407,0.5195073062275459
86167,0.35714285714285715,0.6774193548387096,180,-210,0.3447992100065833,0.6552007899934167,home,COL,under,11.5,0.5412844036697247,-118,0.5195073062275459,COL,LAD,2022 REG,7,3,8,5,8,15,0,1,-2,2,1,1,1,0,0,0,0,0,0,0.48049269377245407,0.5195073062275459
86168,0.4739336492890995,0.5670995670995671,111,-131,0.4544866273039494,0.5455133726960506,away,HOU,over,7.5,0.5454545454545454,-120,0.5206611570247933,CLE,HOU,2022 REG,8,1,2,0,1,10,1,0,1,-1,0,0,0,0,0,0,0,0,0,0.5206611570247933,0.4793388429752067
86168,0.4739336492890995,0.5670995670995671,111,-131,0.4544866273039494,0.5455133726960506,home,CLE,under,7.5,0.5,100,0.4793388429752067,CLE,HOU,2022 REG,8,1,2,0,1,10,1,0,1,-1,0,0,0,0,0,0,0,0,0,0.5206611570247933,0.4793388429752067
86169,0.6226415094339623,0.4166666666666667,-165,140,0.5981666073335706,0.40183339266642937,away,LAA,over,7.5,0.5305164319248826,-113,0.5066009958897986,HOU,LAA,2022 REG,11,8,2,1,9,13,1,0,7,-7,1,0,0,0,0,0,0,0,0,0.5066009958897986,0.49339900411020143
86169,0.6226415094339623,0.4166666666666667,-165,140,0.5981666073335706,0.40183339266642937,home,HOU,under,7.5,0.5145631067961165,-106,0.49339900411020143,HOU,LAA,2022 REG,11,8,2,1,9,13,1,0,7,-7,1,0,0,0,0,0,0,0,0,0.5066009958897986,0.49339900411020143
86170,0.5689655172413793,0.46511627906976744,-132,115,0.5495741503746924,0.45042584962530763,away,TEX,over,7,0.5238095238095238,-110,0.5000596729920038,TB,TEX,2022 REG,7,5,6,1,6,13,1,0,4,-4,1,0,0,0,0,0,0,0,0,0.5000596729920038,0.4999403270079962
86170,0.5689655172413793,0.46511627906976744,-132,115,0.5495741503746924,0.45042584962530763,home,TB,under,7,0.5215311004784688,-109,0.4999403270079962,TB,TEX,2022 REG,7,5,6,1,6,13,1,0,4,-4,1,0,0,0,0,0,0,0,0,0.5000596729920038,0.4999403270079962
86171,0.45454545454545453,0.5833333333333333,120,-140,0.43732782369146006,0.5626721763085399,away,NYY,over,6.5,0.5121951219512195,-105,0.48808156828023186,TB,NYY,2022 REG,3,2,7,4,6,10,0,1,-2,2,1,1,0,0,0,0,0,0,0,0.48808156828023186,0.5119184317197681
86171,0.45454545454545453,0.5833333333333333,120,-140,0.43732782369146006,0.5626721763085399,home,TB,under,6.5,0.5348837209302326,-115,0.5119184317197681,TB,NYY,2022 REG,3,2,7,4,6,10,0,1,-2,2,1,1,0,0,0,0,0,0,0,0.48808156828023186,0.5119184317197681
86172,0.35714285714285715,0.6825396825396826,180,-215,0.34297052154195007,0.6570294784580499,away,ATL,over,8.5,0.5283018867924528,-112,0.5031902949311281,WSH,ATL,2022 REG,5,3,6,2,5,11,1,0,1,-1,1,1,0,0,0,0,0,0,0,0.5031902949311281,0.4968097050688719
86172,0.35714285714285715,0.6825396825396826,180,-215,0.34297052154195007,0.6570294784580499,home,WSH,under,8.5,0.5192307692307692,-108,0.4968097050688719,WSH,ATL,2022 REG,5,3,6,2,5,11,1,0,1,-1,1,1,0,0,0,0,0,0,0,0.5031902949311281,0.4968097050688719
86173,0.6774193548387096,0.36363636363636365,-210,175,0.6496074165168858,0.3503925834831142,away,NYM,over,8.5,0.504950495049505,-102,0.47949844489399435,ATL,NYM,2022 REG,5,4,5,1,5,10,1,0,3,-3,1,0,0,0,0,0,0,0,0,0.47949844489399435,0.5205015551060057
86173,0.6774193548387096,0.36363636363636365,-210,175,0.6496074165168858,0.3503925834831142,home,ATL,under,8.5,0.5454545454545454,-120,0.5205015551060057,ATL,NYM,2022 REG,5,4,5,1,5,10,1,0,3,-3,1,0,0,0,0,0,0,0,0,0.47949844489399435,0.5205015551060057
86174,0.5454545454545454,0.49504950495049505,-120,102,0.5233614270517961,0.4766385729482039,away,HOU,over,8.5,0.5098039215686274,-104,0.48483656587239576,TOR,HOU,2022 REG,13,7,14,11,18,27,0,1,-4,4,1,1,1,1,1,1,1,0,0,0.48483656587239576,0.5151634341276042
86174,0.5454545454545454,0.49504950495049505,-120,102,0.5233614270517961,0.4766385729482039,home,TOR,under,8.5,0.5391705069124424,-117,0.5151634341276042,TOR,HOU,2022 REG,13,7,14,11,18,27,0,1,-4,4,1,1,1,1,1,1,1,0,0,0.48483656587239576,0.5151634341276042
86175,0.5884773662551441,0.4504504504504505,-143,122,0.5655692272061728,0.43443077279382725,away,TB,over,8,0.5238095238095238,-110,0.4988662131519274,BOS,TB,2022 REG,10,6,7,3,9,17,1,0,3,-3,1,1,1,0,0,0,0,0,0,0.4988662131519274,0.5011337868480725
86175,0.5884773662551441,0.4504504504504505,-143,122,0.5655692272061728,0.43443077279382725,home,BOS,under,8,0.5238095238095238,-110,0.5011337868480725,BOS,TB,2022 REG,10,6,7,3,9,17,1,0,3,-3,1,1,1,0,0,0,0,0,0,0.4988662131519274,0.5011337868480725
86176,0.574468085106383,0.46511627906976744,-135,115,0.5517281312179562,0.44827186878204384,away,PIT,over,8,0.5412844036697247,-118,0.5136310900085983,CIN,PIT,2022 REG,6,7,3,3,10,9,1,0,4,-4,1,1,1,0,0,0,0,0,0,0.5136310900085983,0.4863689099914017
86176,0.574468085106383,0.46511627906976744,-135,115,0.5517281312179562,0.44827186878204384,home,CIN,under,8,0.5098039215686274,-104,0.4863689099914017,CIN,PIT,2022 REG,6,7,3,3,10,9,1,0,4,-4,1,1,1,0,0,0,0,0,0,0.5136310900085983,0.4863689099914017
86177,0.4716981132075471,0.5652173913043479,112,-130,0.4542851393811816,0.5457148606188185,away,TB,over,8,0.5238095238095238,-110,0.4988662131519274,CHC,TB,2022 REG,5,5,10,6,11,15,0,1,-1,1,1,1,1,1,1,0,0,0,0,0.4988662131519274,0.5011337868480725
86177,0.4716981132075471,0.5652173913043479,112,-130,0.4542851393811816,0.5457148606188185,home,CHC,under,8,0.5238095238095238,-110,0.5011337868480725,CHC,TB,2022 REG,5,5,10,6,11,15,0,1,-1,1,1,1,1,1,1,0,0,0,0,0.4988662131519274,0.5011337868480725
86178,0.6774193548387096,0.36363636363636365,-210,175,0.6496074165168858,0.3503925834831142,away,CHC,over,8.5,0.5238095238095238,-110,0.5000596729920038,ATL,CHC,2022 REG,8,3,11,6,9,19,0,1,-3,3,1,1,1,0,0,0,0,0,0,0.5000596729920038,0.4999403270079962
86178,0.6774193548387096,0.36363636363636365,-210,175,0.6496074165168858,0.3503925834831142,home,ATL,under,8.5,0.5215311004784688,-109,0.4999403270079962,ATL,CHC,2022 REG,8,3,11,6,9,19,0,1,-3,3,1,1,1,0,0,0,0,0,0,0.5000596729920038,0.4999403270079962
86179,0.46511627906976744,0.5689655172413793,115,-132,0.4492642807855131,0.5507357192144868,away,STL,over,7.5,0.5169082125603864,-107,0.49353874091423283,ARI,STL,2022 REG,8,4,12,6,10,20,0,1,-2,2,1,1,1,1,0,0,0,0,0,0.49353874091423283,0.5064612590857671
86179,0.46511627906976744,0.5689655172413793,115,-132,0.4492642807855131,0.5507357192144868,home,ARI,under,7.5,0.5283018867924528,-112,0.5064612590857671,ARI,STL,2022 REG,8,4,12,6,10,20,0,1,-2,2,1,1,1,1,0,0,0,0,0,0.49353874091423283,0.5064612590857671
86180,0.6610169491525424,0.37735849056603776,-195,165,0.6356501330673793,0.3643498669326207,away,BAL,over,9.5,0.5305164319248826,-113,0.5078572507605655,BOS,BAL,2022 REG,13,5,7,3,8,20,1,0,2,-2,1,1,1,0,0,0,0,0,0,0.5078572507605655,0.49214274923943446
86180,0.6610169491525424,0.37735849056603776,-195,165,0.6356501330673793,0.3643498669326207,home,BOS,under,9.5,0.5121951219512195,-105,0.49214274923943446,BOS,BAL,2022 REG,13,5,7,3,8,20,1,0,2,-2,1,1,1,0,0,0,0,0,0,0.5078572507605655,0.49214274923943446
86181,0.4854368932038835,0.5495495495495495,106,-122,0.4684531831294015,0.5315468168705986,away,STL,over,8.5,0.5391705069124424,-117,0.5140669063204599,CIN,STL,2022 REG,9,2,10,4,6,19,0,1,-2,2,1,1,0,0,0,0,0,0,0,0.5140669063204599,0.4859330936795401
86181,0.4854368932038835,0.5495495495495495,106,-122,0.4684531831294015,0.5315468168705986,home,CIN,under,8.5,0.5073891625615764,-103,0.4859330936795401,CIN,STL,2022 REG,9,2,10,4,6,19,0,1,-2,2,1,1,0,0,0,0,0,0,0,0.5140669063204599,0.4859330936795401
86182,0.4587155963302753,0.5798319327731092,118,-138,0.4410332435305576,0.5589667564694424,away,MIL,over,7,0.5391705069124424,-117,0.5127649394825569,ARI,MIL,2022 REG,10,5,4,0,5,14,1,0,5,-5,0,0,0,0,0,0,0,0,0,0.5127649394825569,0.48723506051744314
86182,0.4587155963302753,0.5798319327731092,118,-138,0.4410332435305576,0.5589667564694424,home,ARI,under,7,0.5098039215686274,-104,0.48723506051744314,ARI,MIL,2022 REG,10,5,4,0,5,14,1,0,5,-5,0,0,0,0,0,0,0,0,0,0.5127649394825569,0.48723506051744314
86183,0.4444444444444444,0.5918367346938775,125,-145,0.42831947593852354,0.5716805240614764,away,CWS,over,9,0.5121951219512195,-105,0.48808156828023186,TEX,CWS,2022 REG,12,3,5,2,5,17,1,0,1,-1,1,1,0,0,0,0,0,0,0,0.48808156828023186,0.5119184317197681
86183,0.4444444444444444,0.5918367346938775,125,-145,0.42831947593852354,0.5716805240614764,home,TEX,under,9,0.5348837209302326,-115,0.5119184317197681,TEX,CWS,2022 REG,12,3,5,2,5,17,1,0,1,-1,1,1,0,0,0,0,0,0,0,0.48808156828023186,0.5119184317197681
86184,0.5815899581589958,0.4587155963302753,-139,118,0.5581486524100054,0.44185134758999456,away,CLE,over,7.5,0.5238095238095238,-110,0.4988662131519274,MIN,CLE,2022 REG,4,3,6,1,4,10,1,0,2,-2,1,0,0,0,0,0,0,0,0,0.4988662131519274,0.5011337868480725
86184,0.5815899581589958,0.4587155963302753,-139,118,0.5581486524100054,0.44185134758999456,home,MIN,under,7.5,0.5238095238095238,-110,0.5011337868480725,MIN,CLE,2022 REG,4,3,6,1,4,10,1,0,2,-2,1,0,0,0,0,0,0,0,0,0.4988662131519274,0.5011337868480725
86185,0.4444444444444444,0.5967741935483871,125,-148,0.42612504978096366,0.5738749502190363,away,SD,over,6.5,0.5145631067961165,-106,0.4913668392989033,MIA,SD,2022 REG,9,3,5,0,3,14,1,0,3,-3,0,0,0,0,0,0,0,0,0,0.4913668392989033,0.5086331607010968
86185,0.4444444444444444,0.5967741935483871,125,-148,0.42612504978096366,0.5738749502190363,home,MIA,under,6.5,0.5305164319248826,-113,0.5086331607010968,MIA,SD,2022 REG,9,3,5,0,3,14,1,0,3,-3,0,0,0,0,0,0,0,0,0,0.4913668392989033,0.5086331607010968
86186,0.33783783783783783,0.7058823529411764,196,-240,0.32306750311519783,0.6769324968848022,away,TOR,over,8,0.5121951219512195,-105,0.48808156828023186,PIT,TOR,2022 REG,5,0,9,4,4,14,0,1,-4,4,0,0,0,0,0,0,0,0,0,0.48808156828023186,0.5119184317197681
86186,0.33783783783783783,0.7058823529411764,196,-240,0.32306750311519783,0.6769324968848022,home,PIT,under,8,0.5348837209302326,-115,0.5119184317197681,PIT,TOR,2022 REG,5,0,9,4,4,14,0,1,-4,4,0,0,0,0,0,0,0,0,0,0.48808156828023186,0.5119184317197681
86187,0.6254681647940076,0.4166666666666667,-167,140,0.5991141690863948,0.4008858309136052,away,BOS,over,9,0.5238095238095238,-110,0.4988662131519274,NYY,BOS,2022 REG,12,14,3,1,15,15,1,0,13,-13,1,0,0,0,0,0,0,0,0,0.4988662131519274,0.5011337868480725
86187,0.6254681647940076,0.4166666666666667,-167,140,0.5991141690863948,0.4008858309136052,home,NYY,under,9,0.5238095238095238,-110,0.5011337868480725,NYY,BOS,2022 REG,12,14,3,1,15,15,1,0,13,-13,1,0,0,0,0,0,0,0,0,0.4988662131519274,0.5011337868480725
86188,0.4,0.6428571428571428,150,-180,0.38285714285714295,0.617142857142857,away,LAD,over,9,0.5238095238095238,-110,0.4988662131519274,CIN,LAD,2022 REG,5,2,17,8,10,22,0,1,-6,6,1,1,0,0,0,0,0,0,0,0.4988662131519274,0.5011337868480725
86188,0.4,0.6428571428571428,150,-180,0.38285714285714295,0.617142857142857,home,CIN,under,9,0.5238095238095238,-110,0.5011337868480725,CIN,LAD,2022 REG,5,2,17,8,10,22,0,1,-6,6,1,1,0,0,0,0,0,0,0,0.4988662131519274,0.5011337868480725
86190,0.42016806722689076,0.6254681647940076,138,-167,0.40099317982315197,0.599006820176848,away,NYY,over,7.5,0.5238095238095238,-110,0.49651307063705985,CLE,NYY,2022 REG,7,2,1,0,2,8,1,0,2,-2,0,0,0,0,0,0,0,0,0,0.49651307063705985,0.5034869293629401
86190,0.42016806722689076,0.6254681647940076,138,-167,0.40099317982315197,0.599006820176848,home,CLE,under,7.5,0.5283018867924528,-112,0.5034869293629401,CLE,NYY,2022 REG,7,2,1,0,2,8,1,0,2,-2,0,0,0,0,0,0,0,0,0,0.49651307063705985,0.5034869293629401
86191,0.7142857142857143,0.3333333333333333,-250,200,0.6802721088435374,0.3197278911564626,away,BAL,over,9.5,0.5192307692307692,-108,0.49688292476754015,MIN,BAL,2022 REG,5,3,4,2,5,9,1,0,1,-1,1,1,0,0,0,0,0,0,0,0.49688292476754015,0.5031170752324599
86191,0.7142857142857143,0.3333333333333333,-250,200,0.6802721088435374,0.3197278911564626,home,MIN,under,9.5,0.5238095238095238,-110,0.5031170752324599,MIN,BAL,2022 REG,5,3,4,2,5,9,1,0,1,-1,1,1,0,0,0,0,0,0,0,0.49688292476754015,0.5031170752324599
86192,0.6153846153846154,0.425531914893617,-160,135,0.5902052121364724,0.40979478786352763,away,CWS,over,7,0.49504950495049505,102,0.4739797934813417,SD,CWS,2022 REG,7,1,5,2,3,12,0,1,-1,1,1,0,0,0,0,0,0,0,0,0.4739797934813417,0.5260202065186583
86192,0.6153846153846154,0.425531914893617,-160,135,0.5902052121364724,0.40979478786352763,home,SD,under,7,0.5475113122171946,-121,0.5260202065186583,SD,CWS,2022 REG,7,1,5,2,3,12,0,1,-1,1,1,0,0,0,0,0,0,0,0,0.4739797934813417,0.5260202065186583
86193,0.726027397260274,0.3076923076923077,-265,225,0.7015459676371667,0.2984540323628333,away,DET,over,7,0.5145631067961165,-106,0.49023796582517226,TB,DET,2022 REG,11,8,7,1,9,18,1,0,7,-7,1,0,0,0,0,0,0,0,0,0.49023796582517226,0.5097620341748277
86193,0.726027397260274,0.3076923076923077,-265,225,0.7015459676371667,0.2984540323628333,home,TB,under,7,0.5327102803738317,-114,0.5097620341748277,TB,DET,2022 REG,11,8,7,1,9,18,1,0,7,-7,1,0,0,0,0,0,0,0,0,0.49023796582517226,0.5097620341748277
86194,0.48780487804878053,0.5535714285714286,105,-124,0.4676213138438005,0.5323786861561994,away,TOR,over,8.5,0.5238095238095238,-110,0.4988662131519274,MIN,TOR,2022 REG,11,6,11,5,11,22,1,0,1,-1,1,1,1,1,1,0,0,0,0,0.4988662131519274,0.5011337868480725
86194,0.48780487804878053,0.5535714285714286,105,-124,0.4676213138438005,0.5323786861561994,home,MIN,under,8.5,0.5238095238095238,-110,0.5011337868480725,MIN,TOR,2022 REG,11,6,11,5,11,22,1,0,1,-1,1,1,1,1,1,0,0,0,0,0.4988662131519274,0.5011337868480725
86195,0.37037037037037035,0.6666666666666666,170,-200,0.35665294924554186,0.6433470507544581,away,LAD,over,7.5,0.5121951219512195,-105,0.48808156828023186,CHC,LAD,2022 REG,4,1,10,7,8,14,0,1,-6,6,1,0,0,0,0,0,0,0,0,0.48808156828023186,0.5119184317197681
86195,0.37037037037037035,0.6666666666666666,170,-200,0.35665294924554186,0.6433470507544581,home,CHC,under,7.5,0.5348837209302326,-115,0.5119184317197681,CHC,LAD,2022 REG,4,1,10,7,8,14,0,1,-6,6,1,0,0,0,0,0,0,0,0,0.48808156828023186,0.5119184317197681
86196,0.6774193548387096,0.36363636363636365,-210,175,0.6496074165168858,0.3503925834831142,away,TEX,over,8.5,0.5098039215686274,-104,0.48483656587239576,MIN,TEX,2022 REG,7,1,6,2,3,13,0,1,-1,1,1,0,0,0,0,0,0,0,0,0.48483656587239576,0.5151634341276042
86196,0.6774193548387096,0.36363636363636365,-210,175,0.6496074165168858,0.3503925834831142,home,MIN,under,8.5,0.5391705069124424,-117,0.5151634341276042,MIN,TEX,2022 REG,7,1,6,2,3,13,0,1,-1,1,1,0,0,0,0,0,0,0,0,0.48483656587239576,0.5151634341276042
86197,0.5391705069124424,0.49504950495049505,-117,102,0.5207200857697526,0.4792799142302474,away,ATL,over,8.5,0.5024875621890548,-101,0.48049269377245407,MIL,ATL,2022 REG,5,0,6,3,3,11,0,1,-3,3,0,0,0,0,0,0,0,0,0,0.48049269377245407,0.5195073062275459
86197,0.5391705069124424,0.49504950495049505,-117,102,0.5207200857697526,0.4792799142302474,home,MIL,under,8.5,0.5412844036697247,-118,0.5195073062275459,MIL,ATL,2022 REG,5,0,6,3,3,11,0,1,-3,3,0,0,0,0,0,0,0,0,0,0.48049269377245407,0.5195073062275459
86198,0.6453900709219857,0.38759689922480617,-182,158,0.6241006079194462,0.3758993920805538,away,STL,over,7,0.5283018867924528,-112,0.5031902949311281,MIL,STL,2022 REG,9,5,9,1,6,18,1,0,4,-4,1,0,0,0,0,0,0,0,0,0.5031902949311281,0.4968097050688719
86198,0.6453900709219857,0.38759689922480617,-182,158,0.6241006079194462,0.3758993920805538,home,MIL,under,7,0.5192307692307692,-108,0.4968097050688719,MIL,STL,2022 REG,9,5,9,1,6,18,1,0,4,-4,1,0,0,0,0,0,0,0,0,0.5031902949311281,0.4968097050688719
86199,0.4166666666666667,0.6226415094339623,140,-165,0.4002882599580712,0.5997117400419287,away,LAD,over,9,0.5391705069124424,-117,0.5140669063204599,CIN,LAD,2022 REG,7,4,9,8,12,16,0,1,-4,4,1,1,1,1,0,0,0,0,0,0.5140669063204599,0.4859330936795401
86199,0.4166666666666667,0.6226415094339623,140,-165,0.4002882599580712,0.5997117400419287,home,CIN,under,9,0.5073891625615764,-103,0.4859330936795401,CIN,LAD,2022 REG,7,4,9,8,12,16,0,1,-4,4,1,1,1,1,0,0,0,0,0,0.5140669063204599,0.4859330936795401
86200,0.47619047619047616,0.5652173913043479,110,-130,0.4564724440500838,0.5435275559499162,away,CLE,over,9,0.5454545454545454,-120,0.5206611570247933,BOS,CLE,2022 REG,6,4,5,2,6,11,1,0,2,-2,1,1,0,0,0,0,0,0,0,0.5206611570247933,0.4793388429752067
86200,0.47619047619047616,0.5652173913043479,110,-130,0.4564724440500838,0.5435275559499162,home,BOS,under,9,0.5,100,0.4793388429752067,BOS,CLE,2022 REG,6,4,5,2,6,11,1,0,2,-2,1,1,0,0,0,0,0,0,0,0.5206611570247933,0.4793388429752067
86201,0.42016806722689076,0.6183206106870228,138,-162,0.4039963538176834,0.5960036461823166,away,NYM,over,9.5,0.5073891625615764,-103,0.4837652908580103,WSH,NYM,2022 REG,4,0,9,5,5,13,0,1,-5,5,0,0,0,0,0,0,0,0,0,0.4837652908580103,0.5162347091419897
86201,0.42016806722689076,0.6183206106870228,138,-162,0.4039963538176834,0.5960036461823166,home,WSH,under,9.5,0.5391705069124424,-117,0.5162347091419897,WSH,NYM,2022 REG,4,0,9,5,5,13,0,1,-5,5,0,0,0,0,0,0,0,0,0,0.4837652908580103,0.5162347091419897
86202,0.4716981132075471,0.5652173913043479,112,-130,0.4542851393811816,0.5457148606188185,away,TB,over,6.5,0.5215311004784688,-109,0.49670754937970685,CLE,TB,2022 REG,6,2,4,1,3,10,1,0,1,-1,1,0,0,0,0,0,0,0,0,0.49670754937970685,0.5032924506202932
86202,0.4716981132075471,0.5652173913043479,112,-130,0.4542851393811816,0.5457148606188185,home,CLE,under,6.5,0.5260663507109005,-111,0.5032924506202932,CLE,TB,2022 REG,6,2,4,1,3,10,1,0,1,-1,1,0,0,0,0,0,0,0,0,0.49670754937970685,0.5032924506202932
86203,0.5495495495495495,0.4854368932038835,-122,106,0.5303227656940593,0.46967723430594066,away,CIN,over,9,0.5098039215686274,-104,0.48483656587239576,ARI,CIN,2022 REG,5,3,13,5,8,18,0,1,-2,2,1,1,1,0,0,0,0,0,0,0.48483656587239576,0.5151634341276042
86203,0.5495495495495495,0.4854368932038835,-122,106,0.5303227656940593,0.46967723430594066,home,ARI,under,9,0.5391705069124424,-117,0.5151634341276042,ARI,CIN,2022 REG,5,3,13,5,8,18,0,1,-2,2,1,1,1,0,0,0,0,0,0,0.48483656587239576,0.5151634341276042
86204,0.8181818181818181,0.2222222222222222,-450,350,0.7851239669421488,0.2148760330578512,away,COL,over,7,0.5,100,0.47935779816513757,NYM,COL,2022 REG,8,3,6,1,4,14,1,0,2,-2,1,0,0,0,0,0,0,0,0,0.47935779816513757,0.5206422018348624
86204,0.8181818181818181,0.2222222222222222,-450,350,0.7851239669421488,0.2148760330578512,home,NYM,under,7,0.5412844036697247,-118,0.5206422018348624,NYM,COL,2022 REG,8,3,6,1,4,14,1,0,2,-2,1,0,0,0,0,0,0,0,0,0.47935779816513757,0.5206422018348624
86205,0.3333333333333333,0.7142857142857143,200,-250,0.31746031746031744,0.6825396825396826,away,ATL,over,8.5,0.5412844036697247,-118,0.5136310900085983,WSH,ATL,2022 REG,7,3,9,6,9,16,0,1,-3,3,1,1,1,0,0,0,0,0,0,0.5136310900085983,0.4863689099914017
86205,0.3333333333333333,0.7142857142857143,200,-250,0.31746031746031744,0.6825396825396826,home,WSH,under,8.5,0.5098039215686274,-104,0.4863689099914017,WSH,ATL,2022 REG,7,3,9,6,9,16,0,1,-3,3,1,1,1,0,0,0,0,0,0,0.5136310900085983,0.4863689099914017
86206,0.7058823529411764,0.3225806451612903,-240,210,0.685790824868847,0.314209175131153,away,PIT,over,7,0.5238095238095238,-110,0.4988662131519274,SD,PIT,2022 REG,10,2,8,4,6,18,0,1,-2,2,1,1,0,0,0,0,0,0,0,0.4988662131519274,0.5011337868480725
86206,0.7058823529411764,0.3225806451612903,-240,210,0.685790824868847,0.314209175131153,home,SD,under,7,0.5238095238095238,-110,0.5011337868480725,SD,PIT,2022 REG,10,2,8,4,6,18,0,1,-2,2,1,1,0,0,0,0,0,0,0,0.4988662131519274,0.5011337868480725
86207,0.47619047619047616,0.5652173913043479,110,-130,0.4564724440500838,0.5435275559499162,away,MIL,over,9.5,0.5215311004784688,-109,0.4978845547971712,WSH,MIL,2022 REG,8,1,9,4,5,17,0,1,-3,3,1,0,0,0,0,0,0,0,0,0.4978845547971712,0.5021154452028288
86207,0.47619047619047616,0.5652173913043479,110,-130,0.4564724440500838,0.5435275559499162,home,WSH,under,9.5,0.5238095238095238,-110,0.5021154452028288,WSH,MIL,2022 REG,8,1,9,4,5,17,0,1,-3,3,1,0,0,0,0,0,0,0,0,0.4978845547971712,0.5021154452028288
86208,0.5575221238938054,0.4807692307692307,-126,108,0.5361738465152985,0.46382615348470146,away,SEA,over,8.5,0.5073891625615764,-103,0.4837652908580103,TEX,SEA,2022 REG,12,5,11,6,11,23,0,1,-1,1,1,1,1,1,1,0,0,0,0,0.4837652908580103,0.5162347091419897
86208,0.5575221238938054,0.4807692307692307,-126,108,0.5361738465152985,0.46382615348470146,home,TEX,under,8.5,0.5391705069124424,-117,0.5162347091419897,TEX,SEA,2022 REG,12,5,11,6,11,23,0,1,-1,1,1,1,1,1,1,0,0,0,0,0.4837652908580103,0.5162347091419897
86209,0.5391705069124424,0.5,-117,100,0.5180509248444435,0.4819490751555565,away,CIN,over,7,0.5454545454545454,-120,0.5206611570247933,MIA,CIN,2022 REG,6,1,9,3,4,15,0,1,-2,2,1,0,0,0,0,0,0,0,0,0.5206611570247933,0.4793388429752067
86209,0.5391705069124424,0.5,-117,100,0.5180509248444435,0.4819490751555565,home,MIA,under,7,0.5,100,0.4793388429752067,MIA,CIN,2022 REG,6,1,9,3,4,15,0,1,-2,2,1,0,0,0,0,0,0,0,0,0.5206611570247933,0.4793388429752067
86210,0.47619047619047616,0.5652173913043479,110,-130,0.4564724440500838,0.5435275559499162,away,NYY,over,8,0.5145631067961165,-106,0.4913668392989033,STL,NYY,2022 REG,11,12,16,9,21,27,1,0,3,-3,1,1,1,1,1,1,1,1,1,0.4913668392989033,0.5086331607010968
86210,0.47619047619047616,0.5652173913043479,110,-130,0.4564724440500838,0.5435275559499162,home,STL,under,8,0.5305164319248826,-113,0.5086331607010968,STL,NYY,2022 REG,11,12,16,9,21,27,1,0,3,-3,1,1,1,1,1,1,1,1,1,0.4913668392989033,0.5086331607010968
86211,0.6153846153846154,0.4166666666666667,-160,140,0.5956607495069033,0.4043392504930967,away,COL,over,10,0.5238095238095238,-110,0.4988662131519274,TEX,COL,2022 REG,4,1,7,4,5,11,0,1,-3,3,1,0,0,0,0,0,0,0,0,0.4988662131519274,0.5011337868480725
86211,0.6153846153846154,0.4166666666666667,-160,140,0.5956607495069033,0.4043392504930967,home,TEX,under,10,0.5238095238095238,-110,0.5011337868480725,TEX,COL,2022 REG,4,1,7,4,5,11,0,1,-3,3,1,0,0,0,0,0,0,0,0,0.4988662131519274,0.5011337868480725
86212,0.4587155963302753,0.5780590717299579,118,-137,0.4418464825411775,0.5581535174588226,away,CLE,over,8.5,0.5305164319248826,-113,0.5066009958897986,BAL,CLE,2022 REG,5,3,14,6,9,19,0,1,-3,3,1,1,1,0,0,0,0,0,0,0.5066009958897986,0.49339900411020143
86212,0.4587155963302753,0.5780590717299579,118,-137,0.4418464825411775,0.5581535174588226,home,BAL,under,8.5,0.5145631067961165,-106,0.49339900411020143,BAL,CLE,2022 REG,5,3,14,6,9,19,0,1,-3,3,1,1,1,0,0,0,0,0,0,0.5066009958897986,0.49339900411020143
86213,0.5283018867924528,0.5121951219512195,-112,-105,0.5069072406637203,0.4930927593362797,away,CWS,over,7.5,0.5348837209302326,-115,0.5097020142727117,MIN,CWS,2022 REG,12,8,9,4,12,21,1,0,4,-4,1,1,1,1,0,0,0,0,0,0.5097020142727117,0.49029798572728833
86213,0.5283018867924528,0.5121951219512195,-112,-105,0.5069072406637203,0.4930927593362797,home,MIN,under,7.5,0.5121951219512195,-105,0.49029798572728833,MIN,CWS,2022 REG,12,8,9,4,12,21,1,0,4,-4,1,1,1,1,0,0,0,0,0,0.5097020142727117,0.49029798572728833
86214,0.4081632653061224,0.6254681647940076,145,-167,0.39443615097953877,0.6055638490204612,away,TOR,over,9.5,0.5121951219512195,-105,0.48808156828023186,BOS,TOR,2022 REG,7,1,7,4,5,14,0,1,-3,3,1,0,0,0,0,0,0,0,0,0.48808156828023186,0.5119184317197681
86214,0.4081632653061224,0.6254681647940076,145,-167,0.39443615097953877,0.6055638490204612,home,BOS,under,9.5,0.5348837209302326,-115,0.5119184317197681,BOS,TOR,2022 REG,7,1,7,4,5,14,0,1,-3,3,1,0,0,0,0,0,0,0,0,0.48808156828023186,0.5119184317197681
86215,0.4672897196261683,0.5726495726495727,114,-134,0.44862649893656975,0.5513735010634302,away,MIN,over,8.5,0.5,100,0.4783105022831051,KC,MIN,2022 REG,11,4,7,6,10,18,0,1,-2,2,1,1,1,1,0,0,0,0,0,0.4783105022831051,0.5216894977168949
86215,0.4672897196261683,0.5726495726495727,114,-134,0.44862649893656975,0.5513735010634302,home,KC,under,8.5,0.5433789954337899,-119,0.5216894977168949,KC,MIN,2022 REG,11,4,7,6,10,18,0,1,-2,2,1,1,1,1,0,0,0,0,0,0.4783105022831051,0.5216894977168949
86216,0.574468085106383,0.47619047619047616,-135,110,0.5453663584039321,0.4546336415960679,away,BAL,over,10,0.5098039215686274,-104,0.48592421718142587,KC,BAL,2022 REG,10,7,15,10,17,25,0,1,-3,3,1,1,1,1,1,1,1,0,0,0.48592421718142587,0.5140757828185741
86216,0.574468085106383,0.47619047619047616,-135,110,0.5453663584039321,0.4546336415960679,home,KC,under,10,0.5370370370370371,-116,0.5140757828185741,KC,BAL,2022 REG,10,7,15,10,17,25,0,1,-3,3,1,1,1,1,1,1,1,0,0,0.48592421718142587,0.5140757828185741
86217,0.6363636363636364,0.4,-175,150,0.6132231404958678,0.3867768595041322,away,OAK,over,8,0.5121951219512195,-105,0.48808156828023186,CWS,OAK,2022 REG,9,3,8,2,5,17,1,0,1,-1,1,1,0,0,0,0,0,0,0,0.48808156828023186,0.5119184317197681
86217,0.6363636363636364,0.4,-175,150,0.6132231404958678,0.3867768595041322,home,CWS,under,8,0.5348837209302326,-115,0.5119184317197681,CWS,OAK,2022 REG,9,3,8,2,5,17,1,0,1,-1,1,1,0,0,0,0,0,0,0,0.48808156828023186,0.5119184317197681
86218,0.7142857142857143,0.3278688524590164,-250,205,0.6841753094680495,0.3158246905319505,away,STL,over,9,0.5495495495495495,-122,0.5223196169142115,ATL,STL,2022 REG,8,2,8,3,5,16,0,1,-1,1,1,1,0,0,0,0,0,0,0,0.5223196169142115,0.47768038308578853
86218,0.7142857142857143,0.3278688524590164,-250,205,0.6841753094680495,0.3158246905319505,home,ATL,under,9,0.5,100,0.47768038308578853,ATL,STL,2022 REG,8,2,8,3,5,16,0,1,-1,1,1,1,0,0,0,0,0,0,0,0.5223196169142115,0.47768038308578853
86220,0.43859649122807015,0.6000000000000001,128,-150,0.4216682056017235,0.5783317943982764,away,ATL,over,9,0.5391705069124424,-117,0.5153817639191344,BOS,ATL,2022 REG,9,4,12,8,12,21,0,1,-4,4,1,1,1,1,0,0,0,0,0,0.5153817639191344,0.4846182360808656
86220,0.43859649122807015,0.6000000000000001,128,-150,0.4216682056017235,0.5783317943982764,home,BOS,under,9,0.504950495049505,-102,0.4846182360808656,BOS,ATL,2022 REG,9,4,12,8,12,21,0,1,-4,4,1,1,1,1,0,0,0,0,0,0.5153817639191344,0.4846182360808656
86221,0.5348837209302326,0.5,-115,100,0.5162249864791779,0.4837750135208221,away,STL,over,10.5,0.5238095238095238,-110,0.4988662131519274,BOS,STL,2022 REG,11,6,10,5,11,21,1,0,1,-1,1,1,1,1,1,0,0,0,0,0.4988662131519274,0.5011337868480725
86221,0.5348837209302326,0.5,-115,100,0.5162249864791779,0.4837750135208221,home,BOS,under,10.5,0.5238095238095238,-110,0.5011337868480725,BOS,STL,2022 REG,11,6,10,5,11,21,1,0,1,-1,1,1,1,1,1,0,0,0,0,0.4988662131519274,0.5011337868480725
86222,0.6527777777777778,0.3921568627450981,-188,155,0.6234454429920115,0.37655455700798846,away,MIA,over,6,0.5192307692307692,-108,0.49571111079951763,MIL,MIA,2022 REG,5,1,5,0,1,10,1,0,1,-1,0,0,0,0,0,0,0,0,0,0.49571111079951763,0.5042888892004824
86222,0.6527777777777778,0.3921568627450981,-188,155,0.6234454429920115,0.37655455700798846,home,MIL,under,6,0.5260663507109005,-111,0.5042888892004824,MIL,MIA,2022 REG,5,1,5,0,1,10,1,0,1,-1,0,0,0,0,0,0,0,0,0,0.49571111079951763,0.5042888892004824
86223,0.574468085106383,0.46511627906976744,-135,115,0.5517281312179562,0.44827186878204384,away,LAA,over,7,0.5454545454545454,-120,0.5206611570247933,HOU,LAA,2022 REG,7,1,11,6,7,18,0,1,-5,5,1,0,0,0,0,0,0,0,0,0.5206611570247933,0.4793388429752067
86223,0.574468085106383,0.46511627906976744,-135,115,0.5517281312179562,0.44827186878204384,home,HOU,under,7,0.5,100,0.4793388429752067,HOU,LAA,2022 REG,7,1,11,6,7,18,0,1,-5,5,1,0,0,0,0,0,0,0,0,0.5206611570247933,0.4793388429752067
86224,0.29411764705882354,0.75,240,-300,0.2811418685121107,0.7188581314878892,away,ATL,over,9,0.5,100,0.4772727272727273,WSH,ATL,2022 REG,7,4,13,10,14,20,0,1,-6,6,1,1,1,1,0,0,0,0,0,0.4772727272727273,0.5227272727272727
86224,0.29411764705882354,0.75,240,-300,0.2811418685121107,0.7188581314878892,home,WSH,under,9,0.5454545454545454,-120,0.5227272727272727,WSH,ATL,2022 REG,7,4,13,10,14,20,0,1,-6,6,1,1,1,1,0,0,0,0,0,0.4772727272727273,0.5227272727272727
86225,0.5192307692307692,0.5238095238095238,-108,-110,0.49688292476754015,0.5031170752324599,away,NYY,over,8,0.5098039215686274,-104,0.4870219861770517,TEX,NYY,2022 REG,11,4,5,2,6,16,1,0,2,-2,1,1,0,0,0,0,0,0,0,0.4870219861770517,0.5129780138229483
86225,0.5192307692307692,0.5238095238095238,-108,-110,0.49688292476754015,0.5031170752324599,home,TEX,under,8,0.5348837209302326,-115,0.5129780138229483,TEX,NYY,2022 REG,11,4,5,2,6,16,1,0,2,-2,1,1,0,0,0,0,0,0,0,0.4870219861770517,0.5129780138229483
86226,0.6666666666666666,0.37037037037037035,-200,170,0.6419753086419753,0.3580246913580247,away,PHI,over,7.5,0.5098039215686274,-104,0.48483656587239576,HOU,PHI,2022 REG,12,3,4,2,5,16,1,0,1,-1,1,1,0,0,0,0,0,0,0,0.48483656587239576,0.5151634341276042
86226,0.6666666666666666,0.37037037037037035,-200,170,0.6419753086419753,0.3580246913580247,home,HOU,under,7.5,0.5391705069124424,-117,0.5151634341276042,HOU,PHI,2022 REG,12,3,4,2,5,16,1,0,1,-1,1,1,0,0,0,0,0,0,0,0.48483656587239576,0.5151634341276042
86227,0.6825396825396826,0.35714285714285715,-215,180,0.6554547745023935,0.34454522549760647,away,CIN,over,8,0.5098039215686274,-104,0.48483656587239576,PHI,CIN,2022 REG,7,7,11,6,13,18,1,0,1,-1,1,1,1,1,1,1,0,0,0,0.48483656587239576,0.5151634341276042
86227,0.6825396825396826,0.35714285714285715,-215,180,0.6554547745023935,0.34454522549760647,home,PHI,under,8,0.5391705069124424,-117,0.5151634341276042,PHI,CIN,2022 REG,7,7,11,6,13,18,1,0,1,-1,1,1,1,1,1,1,0,0,0,0.48483656587239576,0.5151634341276042
86228,0.607843137254902,0.43103448275862066,-155,132,0.5842116427368785,0.41578835726312147,away,CWS,over,7.5,0.5192307692307692,-108,0.49455035168025013,SEA,CWS,2022 REG,6,3,7,0,3,13,1,0,3,-3,0,0,0,0,0,0,0,0,0,0.49455035168025013,0.5054496483197499
86228,0.607843137254902,0.43103448275862066,-155,132,0.5842116427368785,0.41578835726312147,home,SEA,under,7.5,0.5283018867924528,-112,0.5054496483197499,SEA,CWS,2022 REG,6,3,7,0,3,13,1,0,3,-3,0,0,0,0,0,0,0,0,0,0.49455035168025013,0.5054496483197499
86229,0.7354497354497355,0.30303030303030304,-278,230,0.7071496013294954,0.29285039867050455,away,KC,over,7.5,0.5327102803738317,-114,0.508788710910954,HOU,KC,2022 REG,7,4,9,7,11,16,0,1,-3,3,1,1,1,1,0,0,0,0,0,0.508788710910954,0.491211289089046
86229,0.7354497354497355,0.30303030303030304,-278,230,0.7071496013294954,0.29285039867050455,home,HOU,under,7.5,0.5121951219512195,-105,0.491211289089046,HOU,KC,2022 REG,7,4,9,7,11,16,0,1,-3,3,1,1,1,1,0,0,0,0,0,0.508788710910954,0.491211289089046
86230,0.5575221238938054,0.4807692307692307,-126,108,0.5361738465152985,0.46382615348470146,away,CIN,over,10.5,0.5192307692307692,-108,0.49688292476754015,CHC,CIN,2022 REG,23,15,12,7,22,35,1,0,8,-8,1,1,1,1,1,1,1,0,0,0.49688292476754015,0.5031170752324599
86230,0.5575221238938054,0.4807692307692307,-126,108,0.5361738465152985,0.46382615348470146,home,CHC,under,10.5,0.5238095238095238,-110,0.5031170752324599,CHC,CIN,2022 REG,23,15,12,7,22,35,1,0,8,-8,1,1,1,1,1,1,1,0,0,0.49688292476754015,0.5031170752324599
86231,0.4807692307692307,0.5575221238938054,108,-126,0.46235992564277106,0.5376400743572289,away,LAD,over,9,0.5121951219512195,-105,0.48808156828023186,ARI,LAD,2022 REG,5,5,5,3,8,10,1,0,2,-2,1,1,1,0,0,0,0,0,0,0.48808156828023186,0.5119184317197681
86231,0.4807692307692307,0.5575221238938054,108,-126,0.46235992564277106,0.5376400743572289,home,ARI,under,9,0.5348837209302326,-115,0.5119184317197681,ARI,LAD,2022 REG,5,5,5,3,8,10,1,0,2,-2,1,1,1,0,0,0,0,0,0,0.48808156828023186,0.5119184317197681
86232,0.4166666666666667,0.6226415094339623,140,-165,0.4002882599580712,0.5997117400419287,away,NYM,over,7.5,0.5,100,0.4772727272727273,NYY,NYM,2022 REG,8,4,4,2,6,12,1,0,2,-2,1,1,0,0,0,0,0,0,0,0.4772727272727273,0.5227272727272727
86232,0.4166666666666667,0.6226415094339623,140,-165,0.4002882599580712,0.5997117400419287,home,NYY,under,7.5,0.5454545454545454,-120,0.5227272727272727,NYY,NYM,2022 REG,8,4,4,2,6,12,1,0,2,-2,1,1,0,0,0,0,0,0,0,0.4772727272727273,0.5227272727272727
86233,0.5391705069124424,0.5,-117,100,0.5180509248444435,0.4819490751555565,away,ATL,over,6.5,0.5475113122171946,-121,0.5242087833606768,NYM,ATL,2022 REG,5,2,8,5,7,13,0,1,-3,3,1,1,0,0,0,0,0,0,0,0.5242087833606768,0.4757912166393232
86233,0.5391705069124424,0.5,-117,100,0.5180509248444435,0.4819490751555565,home,NYM,under,6.5,0.49504950495049505,102,0.4757912166393232,NYM,ATL,2022 REG,5,2,8,5,7,13,0,1,-3,3,1,1,0,0,0,0,0,0,0,0.5242087833606768,0.4757912166393232
86234,0.574468085106383,0.46511627906976744,-135,115,0.5517281312179562,0.44827186878204384,away,BAL,over,9,0.5327102803738317,-114,0.5075272610403079,BOS,BAL,2022 REG,7,3,7,1,4,14,1,0,2,-2,1,0,0,0,0,0,0,0,0,0.5075272610403079,0.4924727389596921
86234,0.574468085106383,0.46511627906976744,-135,115,0.5517281312179562,0.44827186878204384,home,BOS,under,9,0.5145631067961165,-106,0.4924727389596921,BOS,BAL,2022 REG,7,3,7,1,4,14,1,0,2,-2,1,0,0,0,0,0,0,0,0,0.5075272610403079,0.4924727389596921
86235,0.5633187772925764,0.4807692307692307,-129,108,0.5384831744979339,0.4615168255020661,away,SEA,over,8.5,0.5327102803738317,-114,0.5100625279371946,LAA,SEA,2022 REG,8,5,6,1,6,14,1,0,4,-4,1,0,0,0,0,0,0,0,0,0.5100625279371946,0.48993747206280536
86235,0.5633187772925764,0.4807692307692307,-129,108,0.5384831744979339,0.4615168255020661,home,LAA,under,8.5,0.5098039215686274,-104,0.48993747206280536,LAA,SEA,2022 REG,8,5,6,1,6,14,1,0,4,-4,1,0,0,0,0,0,0,0,0,0.5100625279371946,0.48993747206280536
86236,0.5073891625615764,0.5391705069124424,-103,-117,0.4837652908580103,0.5162347091419897,away,CWS,over,7,0.5535714285714286,-124,0.5293429871948779,TB,CWS,2022 REG,9,5,16,6,11,25,0,1,-1,1,1,1,1,1,1,0,0,0,0,0.5293429871948779,0.47065701280512207
86236,0.5073891625615764,0.5391705069124424,-103,-117,0.4837652908580103,0.5162347091419897,home,TB,under,7,0.49019607843137253,104,0.47065701280512207,TB,CWS,2022 REG,9,5,16,6,11,25,0,1,-1,1,1,1,1,1,1,0,0,0,0,0.5293429871948779,0.47065701280512207
86237,0.5,0.5370370370370371,100,-116,0.4814814814814814,0.5185185185185186,away,LAA,over,8.5,0.5121951219512195,-105,0.48808156828023186,MIN,LAA,2022 REG,11,3,16,10,13,27,0,1,-7,7,1,1,1,0,0,0,0,0,0,0.48808156828023186,0.5119184317197681
86237,0.5,0.5370370370370371,100,-116,0.4814814814814814,0.5185185185185186,home,MIN,under,8.5,0.5348837209302326,-115,0.5119184317197681,MIN,LAA,2022 REG,11,3,16,10,13,27,0,1,-7,7,1,1,1,0,0,0,0,0,0,0.48808156828023186,0.5119184317197681
86238,0.5283018867924528,0.5098039215686274,-112,-104,0.5081705163375425,0.4918294836624575,away,MIA,over,7,0.5,100,0.4772727272727273,NYM,MIA,2022 REG,7,0,6,2,2,13,0,1,-2,2,0,0,0,0,0,0,0,0,0,0.4772727272727273,0.5227272727272727
86238,0.5283018867924528,0.5098039215686274,-112,-104,0.5081705163375425,0.4918294836624575,home,NYM,under,7,0.5454545454545454,-120,0.5227272727272727,NYM,MIA,2022 REG,7,0,6,2,2,13,0,1,-2,2,0,0,0,0,0,0,0,0,0,0.4772727272727273,0.5227272727272727
86240,0.7142857142857143,0.3333333333333333,-250,200,0.6802721088435374,0.3197278911564626,away,OAK,over,7,0.5169082125603864,-107,0.49239402434819424,SEA,OAK,2022 REG,6,2,3,1,3,9,1,0,1,-1,1,0,0,0,0,0,0,0,0,0.49239402434819424,0.5076059756518058
86240,0.7142857142857143,0.3333333333333333,-250,200,0.6802721088435374,0.3197278911564626,home,SEA,under,7,0.5305164319248826,-113,0.5076059756518058,SEA,OAK,2022 REG,6,2,3,1,3,9,1,0,1,-1,1,0,0,0,0,0,0,0,0,0.49239402434819424,0.5076059756518058
86241,0.6721311475409836,0.37735849056603776,-205,165,0.6388676202887233,0.36113237971127665,away,BOS,over,8.5,0.5238095238095238,-110,0.4988662131519274,HOU,BOS,2022 REG,12,6,4,1,7,16,1,0,5,-5,1,0,0,0,0,0,0,0,0,0.4988662131519274,0.5011337868480725
86241,0.6721311475409836,0.37735849056603776,-205,165,0.6388676202887233,0.36113237971127665,home,HOU,under,8.5,0.5238095238095238,-110,0.5011337868480725,HOU,BOS,2022 REG,12,6,4,1,7,16,1,0,5,-5,1,0,0,0,0,0,0,0,0,0.4988662131519274,0.5011337868480725
86242,0.47619047619047616,0.5652173913043479,110,-130,0.4564724440500838,0.5435275559499162,away,TOR,over,8.5,0.5073891625615764,-103,0.4826927225525911,MIN,TOR,2022 REG,3,3,13,9,12,16,0,1,-6,6,1,1,1,0,0,0,0,0,0,0.4826927225525911,0.5173072774474089
86242,0.47619047619047616,0.5652173913043479,110,-130,0.4564724440500838,0.5435275559499162,home,MIN,under,8.5,0.5412844036697247,-118,0.5173072774474089,MIN,TOR,2022 REG,3,3,13,9,12,16,0,1,-6,6,1,1,1,0,0,0,0,0,0,0.4826927225525911,0.5173072774474089
86243,0.5689655172413793,0.4672897196261683,-132,114,0.5483375376443265,0.45166246235567353,away,COL,over,8.5,0.5024875621890548,-101,0.48049269377245407,DET,COL,2022 REG,7,2,11,6,8,18,0,1,-4,4,1,1,0,0,0,0,0,0,0,0.48049269377245407,0.5195073062275459
86243,0.5689655172413793,0.4672897196261683,-132,114,0.5483375376443265,0.45166246235567353,home,DET,under,8.5,0.5412844036697247,-118,0.5195073062275459,DET,COL,2022 REG,7,2,11,6,8,18,0,1,-4,4,1,1,0,0,0,0,0,0,0,0.48049269377245407,0.5195073062275459
86244,0.6254681647940076,0.41152263374485604,-167,143,0.6023315979176397,0.3976684020823603,away,BOS,over,7.5,0.5238095238095238,-110,0.5012646084074657,TB,BOS,2022 REG,9,5,6,2,7,15,1,0,3,-3,1,1,0,0,0,0,0,0,0,0.5012646084074657,0.4987353915925343
86244,0.6254681647940076,0.41152263374485604,-167,143,0.6023315979176397,0.3976684020823603,home,TB,under,7.5,0.5192307692307692,-108,0.4987353915925343,TB,BOS,2022 REG,9,5,6,2,7,15,1,0,3,-3,1,1,0,0,0,0,0,0,0,0.5012646084074657,0.4987353915925343
86245,0.5412844036697247,0.5,-118,100,0.5189377998484975,0.4810622001515025,away,PHI,over,7.5,0.5412844036697247,-118,0.5162581740877563,SF,PHI,2022 REG,11,13,5,1,14,16,1,0,12,-12,1,0,0,0,0,0,0,0,0,0.5162581740877563,0.4837418259122437
86245,0.5412844036697247,0.5,-118,100,0.5189377998484975,0.4810622001515025,home,SF,under,7.5,0.504950495049505,-102,0.4837418259122437,SF,PHI,2022 REG,11,13,5,1,14,16,1,0,12,-12,1,0,0,0,0,0,0,0,0,0.5162581740877563,0.4837418259122437
86246,0.5689655172413793,0.47619047619047616,-132,110,0.5432733140818753,0.4567266859181247,away,LAA,over,7.5,0.5098039215686274,-104,0.4816329383803432,OAK,LAA,2022 REG,2,0,5,1,1,7,0,1,-1,1,0,0,0,0,0,0,0,0,0,0.4816329383803432,0.5183670616196567
86246,0.5689655172413793,0.47619047619047616,-132,110,0.5432733140818753,0.4567266859181247,home,OAK,under,7.5,0.5454545454545454,-120,0.5183670616196567,OAK,LAA,2022 REG,2,0,5,1,1,7,0,1,-1,1,0,0,0,0,0,0,0,0,0,0.4816329383803432,0.5183670616196567
86247,0.425531914893617,0.607843137254902,135,-155,0.4113297650431834,0.5886702349568166,away,LAD,over,8.5,0.5348837209302326,-115,0.5109810284308424,SD,LAD,2022 REG,8,5,6,4,9,14,1,0,1,-1,1,1,1,1,0,0,0,0,0,0.5109810284308424,0.48901897156915763
86247,0.425531914893617,0.607843137254902,135,-155,0.4113297650431834,0.5886702349568166,home,SD,under,8.5,0.5098039215686274,-104,0.48901897156915763,SD,LAD,2022 REG,8,5,6,4,9,14,1,0,1,-1,1,1,1,1,0,0,0,0,0,0.5109810284308424,0.48901897156915763
86248,0.4166666666666667,0.6153846153846154,140,-160,0.40331196581196577,0.5966880341880343,away,LAD,over,7.5,0.5238095238095238,-110,0.4988662131519274,SF,LAD,2022 REG,2,0,9,5,5,11,0,1,-5,5,0,0,0,0,0,0,0,0,0,0.4988662131519274,0.5011337868480725
86248,0.4166666666666667,0.6153846153846154,140,-160,0.40331196581196577,0.5966880341880343,home,SF,under,7.5,0.5238095238095238,-110,0.5011337868480725,SF,LAD,2022 REG,2,0,9,5,5,11,0,1,-5,5,0,0,0,0,0,0,0,0,0,0.4988662131519274,0.5011337868480725
86249,0.504950495049505,0.5370370370370371,-102,-116,0.4837488699364985,0.5162511300635015,away,SEA,over,9,0.5121951219512195,-105,0.4858858974112951,CWS,SEA,2022 REG,10,6,8,4,10,18,1,0,2,-2,1,1,1,1,0,0,0,0,0,0.4858858974112951,0.5141141025887048
86249,0.504950495049505,0.5370370370370371,-102,-116,0.4837488699364985,0.5162511300635015,home,CWS,under,9,0.5391705069124424,-117,0.5141141025887048,CWS,SEA,2022 REG,10,6,8,4,10,18,1,0,2,-2,1,1,1,1,0,0,0,0,0,0.4858858974112951,0.5141141025887048
86250,0.5238095238095238,0.5169082125603864,-110,-107,0.5024811857109994,0.4975188142890006,away,CLE,over,9.5,0.5,100,0.47935779816513757,BOS,CLE,2022 REG,6,3,8,1,4,14,1,0,2,-2,1,0,0,0,0,0,0,0,0,0.47935779816513757,0.5206422018348624
86250,0.5238095238095238,0.5169082125603864,-110,-107,0.5024811857109994,0.4975188142890006,home,BOS,under,9.5,0.5412844036697247,-118,0.5206422018348624,BOS,CLE,2022 REG,6,3,8,1,4,14,1,0,2,-2,1,0,0,0,0,0,0,0,0,0.47935779816513757,0.5206422018348624
86251,0.5454545454545454,0.49504950495049505,-120,102,0.5233614270517961,0.4766385729482039,away,ARI,over,9.5,0.5121951219512195,-105,0.48808156828023186,CIN,ARI,2022 REG,5,0,11,7,7,16,0,1,-7,7,0,0,0,0,0,0,0,0,0,0.48808156828023186,0.5119184317197681
86251,0.5454545454545454,0.49504950495049505,-120,102,0.5233614270517961,0.4766385729482039,home,CIN,under,9.5,0.5348837209302326,-115,0.5119184317197681,CIN,ARI,2022 REG,5,0,11,7,7,16,0,1,-7,7,0,0,0,0,0,0,0,0,0,0.48808156828023186,0.5119184317197681
86252,0.613899613899614,0.425531914893617,-159,135,0.589692613597978,0.410307386402022,away,ARI,over,12,0.5238095238095238,-110,0.5012646084074657,COL,ARI,2022 REG,12,11,9,7,18,21,1,0,4,-4,1,1,1,1,1,1,1,0,0,0.5012646084074657,0.4987353915925343
86252,0.613899613899614,0.425531914893617,-159,135,0.589692613597978,0.410307386402022,home,COL,under,12,0.5192307692307692,-108,0.4987353915925343,COL,ARI,2022 REG,12,11,9,7,18,21,1,0,4,-4,1,1,1,1,1,1,1,0,0,0.5012646084074657,0.4987353915925343
86253,0.6389891696750902,0.4,-177,150,0.614075512518083,0.385924487481917,away,BAL,over,8,0.5412844036697247,-118,0.5189377998484975,CLE,BAL,2022 REG,5,0,8,4,4,13,0,1,-4,4,0,0,0,0,0,0,0,0,0,0.5189377998484975,0.4810622001515025
86253,0.6389891696750902,0.4,-177,150,0.614075512518083,0.385924487481917,home,CLE,under,8,0.5,100,0.4810622001515025,CLE,BAL,2022 REG,5,0,8,4,4,13,0,1,-4,4,0,0,0,0,0,0,0,0,0,0.5189377998484975,0.4810622001515025
86255,0.5073891625615764,0.5412844036697247,-103,-118,0.4826927225525911,0.5173072774474089,away,NYM,over,7,0.5391705069124424,-117,0.5140669063204599,STL,NYM,2022 REG,16,10,11,5,15,27,1,0,5,-5,1,1,1,1,1,0,0,0,0,0.5140669063204599,0.4859330936795401
86255,0.5073891625615764,0.5412844036697247,-103,-118,0.4826927225525911,0.5173072774474089,home,STL,under,7,0.5073891625615764,-103,0.4859330936795401,STL,NYM,2022 REG,16,10,11,5,15,27,1,0,5,-5,1,1,1,1,1,0,0,0,0,0.5140669063204599,0.4859330936795401
86256,0.5454545454545454,0.49019607843137253,-120,104,0.526008750607681,0.47399124939231896,away,TB,over,7.5,0.5238095238095238,-110,0.5000596729920038,SEA,TB,2022 REG,8,2,5,1,3,13,1,0,1,-1,1,0,0,0,0,0,0,0,0,0.5000596729920038,0.4999403270079962
86256,0.5454545454545454,0.49019607843137253,-120,104,0.526008750607681,0.47399124939231896,home,SEA,under,7.5,0.5215311004784688,-109,0.4999403270079962,SEA,TB,2022 REG,8,2,5,1,3,13,1,0,1,-1,1,0,0,0,0,0,0,0,0,0.5000596729920038,0.4999403270079962
86257,0.6363636363636364,0.4,-175,150,0.6132231404958678,0.3867768595041322,away,CHC,over,8,0.5238095238095238,-110,0.5000596729920038,STL,CHC,2022 REG,6,4,9,3,7,15,1,0,1,-1,1,1,1,0,0,0,0,0,0,0.5000596729920038,0.4999403270079962
86257,0.6363636363636364,0.4,-175,150,0.6132231404958678,0.3867768595041322,home,STL,under,8,0.5215311004784688,-109,0.4999403270079962,STL,CHC,2022 REG,6,4,9,3,7,15,1,0,1,-1,1,1,1,0,0,0,0,0,0,0.5000596729920038,0.4999403270079962
86258,0.696969696969697,0.3448275862068966,-230,190,0.6678382571799499,0.33216174282005007,away,COL,over,8.5,0.5327102803738317,-114,0.508788710910954,LAD,COL,2022 REG,8,5,8,2,7,16,1,0,3,-3,1,1,0,0,0,0,0,0,0,0.508788710910954,0.491211289089046
86258,0.696969696969697,0.3448275862068966,-230,190,0.6678382571799499,0.33216174282005007,home,LAD,under,8.5,0.5121951219512195,-105,0.491211289089046,LAD,COL,2022 REG,8,5,8,2,7,16,1,0,3,-3,1,1,0,0,0,0,0,0,0,0.508788710910954,0.491211289089046
86259,0.6226415094339623,0.41152263374485604,-165,143,0.6013694957565848,0.3986305042434152,away,BAL,over,8,0.5370370370370371,-116,0.5118817074154765,TOR,BAL,2022 REG,9,6,9,3,9,18,1,0,3,-3,1,1,1,0,0,0,0,0,0,0.5118817074154765,0.48811829258452355
86259,0.6226415094339623,0.41152263374485604,-165,143,0.6013694957565848,0.3986305042434152,home,TOR,under,8,0.5098039215686274,-104,0.48811829258452355,TOR,BAL,2022 REG,9,6,9,3,9,18,1,0,3,-3,1,1,1,0,0,0,0,0,0,0.5118817074154765,0.48811829258452355
86260,0.5967741935483871,0.43859649122807015,-148,128,0.5756658816656627,0.4243341183343373,away,CLE,over,7.5,0.5,100,0.4772727272727273,CWS,CLE,2022 REG,8,6,11,3,9,19,1,0,3,-3,1,1,1,0,0,0,0,0,0,0.4772727272727273,0.5227272727272727
86260,0.5967741935483871,0.43859649122807015,-148,128,0.5756658816656627,0.4243341183343373,home,CWS,under,7.5,0.5454545454545454,-120,0.5227272727272727,CWS,CLE,2022 REG,8,6,11,3,9,19,1,0,3,-3,1,1,1,0,0,0,0,0,0,0.4772727272727273,0.5227272727272727
86261,0.635036496350365,0.40322580645161293,-174,148,0.6107385376367002,0.38926146236329984,away,LAA,over,7.5,0.5305164319248826,-113,0.5053568787472517,SEA,LAA,2022 REG,2,0,9,4,4,11,0,1,-4,4,0,0,0,0,0,0,0,0,0,0.5053568787472517,0.49464312125274834
86261,0.635036496350365,0.40322580645161293,-174,148,0.6107385376367002,0.38926146236329984,home,SEA,under,7.5,0.5169082125603864,-107,0.49464312125274834,SEA,LAA,2022 REG,2,0,9,4,4,11,0,1,-4,4,0,0,0,0,0,0,0,0,0,0.5053568787472517,0.49464312125274834
86262,0.6551724137931035,0.3802281368821293,-190,163,0.6319789495576061,0.36802105044239386,away,DET,over,8,0.5391705069124424,-117,0.5127649394825569,SF,DET,2022 REG,7,2,9,3,5,16,0,1,-1,1,1,1,0,0,0,0,0,0,0,0.5127649394825569,0.48723506051744314
86262,0.6551724137931035,0.3802281368821293,-190,163,0.6319789495576061,0.36802105044239386,home,SF,under,8,0.5098039215686274,-104,0.48723506051744314,SF,DET,2022 REG,7,2,9,3,5,16,0,1,-1,1,1,1,0,0,0,0,0,0,0,0.5127649394825569,0.48723506051744314
86263,0.6124031007751938,0.4273504273504274,-158,134,0.5880579168843095,0.41194208311569047,away,BOS,over,8,0.5121951219512195,-105,0.48919479393107135,TOR,BOS,2022 REG,6,1,4,0,1,10,1,0,1,-1,0,0,0,0,0,0,0,0,0,0.48919479393107135,0.5108052060689287
86263,0.6124031007751938,0.4273504273504274,-158,134,0.5880579168843095,0.41194208311569047,home,TOR,under,8,0.5327102803738317,-114,0.5108052060689287,TOR,BOS,2022 REG,6,1,4,0,1,10,1,0,1,-1,0,0,0,0,0,0,0,0,0,0.48919479393107135,0.5108052060689287
86264,0.7142857142857143,0.3278688524590164,-250,205,0.6841753094680495,0.3158246905319505,away,KC,over,8.5,0.5098039215686274,-104,0.48592421718142587,SF,KC,2022 REG,5,4,8,2,6,13,1,0,2,-2,1,1,0,0,0,0,0,0,0,0.48592421718142587,0.5140757828185741
86264,0.7142857142857143,0.3278688524590164,-250,205,0.6841753094680495,0.3158246905319505,home,SF,under,8.5,0.5370370370370371,-116,0.5140757828185741,SF,KC,2022 REG,5,4,8,2,6,13,1,0,2,-2,1,1,0,0,0,0,0,0,0,0.48592421718142587,0.5140757828185741
86265,0.6254681647940076,0.4166666666666667,-167,140,0.5991141690863948,0.4008858309136052,away,COL,over,9.5,0.5,100,0.4772727272727273,MIN,COL,2022 REG,10,6,1,0,6,11,1,0,6,-6,0,0,0,0,0,0,0,0,0,0.4772727272727273,0.5227272727272727
86265,0.6254681647940076,0.4166666666666667,-167,140,0.5991141690863948,0.4008858309136052,home,MIN,under,9.5,0.5454545454545454,-120,0.5227272727272727,MIN,COL,2022 REG,10,6,1,0,6,11,1,0,6,-6,0,0,0,0,0,0,0,0,0,0.4772727272727273,0.5227272727272727
86266,0.5726495726495727,0.46511627906976744,-134,115,0.5510229738017454,0.44897702619825464,away,DET,over,8.5,0.5454545454545454,-120,0.5206611570247933,KC,DET,2022 REG,9,3,4,1,4,13,1,0,2,-2,1,0,0,0,0,0,0,0,0,0.5206611570247933,0.4793388429752067
86266,0.5726495726495727,0.46511627906976744,-134,115,0.5510229738017454,0.44897702619825464,home,KC,under,8.5,0.5,100,0.4793388429752067,KC,DET,2022 REG,9,3,4,1,4,13,1,0,2,-2,1,0,0,0,0,0,0,0,0,0.5206611570247933,0.4793388429752067
86267,0.45454545454545453,0.5833333333333333,120,-140,0.43732782369146006,0.5626721763085399,away,ATL,over,8.5,0.5495495495495495,-122,0.5236866555946829,PHI,ATL,2022 REG,10,7,11,8,15,21,0,1,-1,1,1,1,1,1,1,1,1,0,0,0.5236866555946829,0.47631334440531714
86267,0.45454545454545453,0.5833333333333333,120,-140,0.43732782369146006,0.5626721763085399,home,PHI,under,8.5,0.49751243781094534,101,0.47631334440531714,PHI,ATL,2022 REG,10,7,11,8,15,21,0,1,-1,1,1,1,1,1,1,1,1,0,0,0.5236866555946829,0.47631334440531714
86268,0.6666666666666666,0.37037037037037035,-200,170,0.6419753086419753,0.3580246913580247,away,BAL,over,9.5,0.5283018867924528,-112,0.5044173060022736,BOS,BAL,2022 REG,14,8,15,12,20,29,0,1,-4,4,1,1,1,1,1,1,1,1,0,0.5044173060022736,0.49558269399772636
86268,0.6666666666666666,0.37037037037037035,-200,170,0.6419753086419753,0.3580246913580247,home,BOS,under,9.5,0.5169082125603864,-107,0.49558269399772636,BOS,BAL,2022 REG,14,8,15,12,20,29,0,1,-4,4,1,1,1,1,1,1,1,1,0,0.5044173060022736,0.49558269399772636
86269,0.7333333333333333,0.30303030303030304,-275,230,0.7066666666666666,0.29333333333333345,away,WSH,over,8,0.5412844036697247,-118,0.5175913212324037,STL,WSH,2022 REG,3,0,14,6,6,17,0,1,-6,6,0,0,0,0,0,0,0,0,0,0.5175913212324037,0.4824086787675963
86269,0.7333333333333333,0.30303030303030304,-275,230,0.7066666666666666,0.29333333333333345,home,STL,under,8,0.5024875621890548,-101,0.4824086787675963,STL,WSH,2022 REG,3,0,14,6,6,17,0,1,-6,6,0,0,0,0,0,0,0,0,0,0.5175913212324037,0.4824086787675963
86270,0.5884773662551441,0.4484304932735426,-143,123,0.5667579262855877,0.43324207371441226,away,STL,over,7.5,0.5348837209302326,-115,0.5109810284308424,TB,STL,2022 REG,18,11,8,3,14,26,1,0,8,-8,1,1,1,0,0,0,0,0,0,0.5109810284308424,0.48901897156915763
86270,0.5884773662551441,0.4484304932735426,-143,123,0.5667579262855877,0.43324207371441226,home,TB,under,7.5,0.5098039215686274,-104,0.48901897156915763,TB,STL,2022 REG,18,11,8,3,14,26,1,0,8,-8,1,1,1,0,0,0,0,0,0,0.5109810284308424,0.48901897156915763
86271,0.41152263374485604,0.6226415094339623,143,-165,0.39746331556427233,0.6025366844357276,away,TB,over,6.5,0.5283018867924528,-112,0.5044173060022736,MIA,TB,2022 REG,5,1,10,2,3,15,0,1,-1,1,1,0,0,0,0,0,0,0,0,0.5044173060022736,0.49558269399772636
86271,0.41152263374485604,0.6226415094339623,143,-165,0.39746331556427233,0.6025366844357276,home,MIA,under,6.5,0.5169082125603864,-107,0.49558269399772636,MIA,TB,2022 REG,5,1,10,2,3,15,0,1,-1,1,1,0,0,0,0,0,0,0,0,0.5044173060022736,0.49558269399772636
86272,0.6923076923076923,0.35714285714285715,-225,180,0.658072696534235,0.34192730346576505,away,DET,over,7.5,0.5192307692307692,-108,0.49688292476754015,CLE,DET,2022 REG,9,4,3,1,5,12,1,0,3,-3,1,0,0,0,0,0,0,0,0,0.49688292476754015,0.5031170752324599
86272,0.6923076923076923,0.35714285714285715,-225,180,0.658072696534235,0.34192730346576505,home,CLE,under,7.5,0.5238095238095238,-110,0.5031170752324599,CLE,DET,2022 REG,9,4,3,1,5,12,1,0,3,-3,1,0,0,0,0,0,0,0,0,0.49688292476754015,0.5031170752324599
86273,0.4081632653061224,0.6226415094339623,145,-165,0.3955898878611898,0.6044101121388101,away,ATL,over,7,0.5215311004784688,-109,0.4978845547971712,STL,ATL,2022 REG,10,4,16,11,15,26,0,1,-7,7,1,1,1,1,0,0,0,0,0,0.4978845547971712,0.5021154452028288
86273,0.4081632653061224,0.6226415094339623,145,-165,0.3955898878611898,0.6044101121388101,home,STL,under,7,0.5238095238095238,-110,0.5021154452028288,STL,ATL,2022 REG,10,4,16,11,15,26,0,1,-7,7,1,1,1,1,0,0,0,0,0,0.4978845547971712,0.5021154452028288
86274,0.4347826086956522,0.6000000000000001,130,-150,0.4196597353497164,0.5803402646502835,away,LAD,over,11.5,0.5073891625615764,-103,0.4837652908580103,COL,LAD,2022 REG,8,3,7,2,5,15,1,0,1,-1,1,1,0,0,0,0,0,0,0,0.4837652908580103,0.5162347091419897
86274,0.4347826086956522,0.6000000000000001,130,-150,0.4196597353497164,0.5803402646502835,home,COL,under,11.5,0.5391705069124424,-117,0.5162347091419897,COL,LAD,2022 REG,8,3,7,2,5,15,1,0,1,-1,1,1,0,0,0,0,0,0,0,0.4837652908580103,0.5162347091419897
86275,0.6363636363636364,0.4081632653061224,-175,145,0.6080283353010626,0.3919716646989374,away,BAL,over,7.5,0.5238095238095238,-110,0.4988662131519274,TB,BAL,2022 REG,8,4,1,1,5,9,1,0,3,-3,1,0,0,0,0,0,0,0,0,0.4988662131519274,0.5011337868480725
86275,0.6363636363636364,0.4081632653061224,-175,145,0.6080283353010626,0.3919716646989374,home,TB,under,7.5,0.5238095238095238,-110,0.5011337868480725,TB,BAL,2022 REG,8,4,1,1,5,9,1,0,3,-3,1,0,0,0,0,0,0,0,0,0.4988662131519274,0.5011337868480725
86276,0.4,0.6363636363636364,150,-175,0.3854545454545455,0.6145454545454545,away,PHI,over,8.5,0.5391705069124424,-117,0.5153817639191344,ARI,PHI,2022 REG,10,13,11,7,20,21,1,0,6,-6,1,1,1,1,1,1,1,0,0,0.5153817639191344,0.4846182360808656
86276,0.4,0.6363636363636364,150,-175,0.3854545454545455,0.6145454545454545,home,ARI,under,8.5,0.504950495049505,-102,0.4846182360808656,ARI,PHI,2022 REG,10,13,11,7,20,21,1,0,6,-6,1,1,1,1,1,1,1,0,0,0.5153817639191344,0.4846182360808656
86277,0.6774193548387096,0.3623188405797102,-210,176,0.6504999321359091,0.34950006786409094,away,LAA,over,8.5,0.5454545454545454,-120,0.5206611570247933,LAD,LAA,2022 REG,6,4,3,1,5,9,1,0,3,-3,1,0,0,0,0,0,0,0,0,0.5206611570247933,0.4793388429752067
86277,0.6774193548387096,0.3623188405797102,-210,176,0.6504999321359091,0.34950006786409094,home,LAD,under,8.5,0.5,100,0.4793388429752067,LAD,LAA,2022 REG,6,4,3,1,5,9,1,0,3,-3,1,0,0,0,0,0,0,0,0,0.5206611570247933,0.4793388429752067
86278,0.613899613899614,0.4347826086956522,-159,130,0.5840136162446051,0.4159863837553949,away,SF,over,8,0.5238095238095238,-110,0.5012646084074657,LAD,SF,2022 REG,8,5,7,1,6,15,1,0,4,-4,1,0,0,0,0,0,0,0,0,0.5012646084074657,0.4987353915925343
86278,0.613899613899614,0.4347826086956522,-159,130,0.5840136162446051,0.4159863837553949,home,LAD,under,8,0.5192307692307692,-108,0.4987353915925343,LAD,SF,2022 REG,8,5,7,1,6,15,1,0,4,-4,1,0,0,0,0,0,0,0,0,0.5012646084074657,0.4987353915925343
86279,0.4444444444444444,0.5934959349593496,125,-146,0.42758205359831375,0.5724179464016863,away,MIN,over,7.5,0.5348837209302326,-115,0.5109810284308424,SEA,MIN,2022 REG,5,0,8,5,5,13,0,1,-5,5,0,0,0,0,0,0,0,0,0,0.5109810284308424,0.48901897156915763
86279,0.4444444444444444,0.5934959349593496,125,-146,0.42758205359831375,0.5724179464016863,home,SEA,under,7.5,0.5098039215686274,-104,0.48901897156915763,SEA,MIN,2022 REG,5,0,8,5,5,13,0,1,-5,5,0,0,0,0,0,0,0,0,0,0.5109810284308424,0.48901897156915763
86280,0.6825396825396826,0.35714285714285715,-215,180,0.6554547745023935,0.34454522549760647,away,DET,over,8,0.5412844036697247,-118,0.5189377998484975,BAL,DET,2022 REG,2,0,14,11,11,16,0,1,-11,11,0,0,0,0,0,0,0,0,0,0.5189377998484975,0.4810622001515025
86280,0.6825396825396826,0.35714285714285715,-215,180,0.6554547745023935,0.34454522549760647,home,BAL,under,8,0.5,100,0.4810622001515025,BAL,DET,2022 REG,2,0,14,11,11,16,0,1,-11,11,0,0,0,0,0,0,0,0,0,0.5189377998484975,0.4810622001515025
86281,0.6666666666666666,0.37735849056603776,-200,165,0.6373165618448637,0.36268343815513626,away,WSH,over,8.5,0.5454545454545454,-120,0.5220180091279142,LAA,WSH,2022 REG,8,5,11,4,9,19,1,0,1,-1,1,1,1,1,0,0,0,0,0,0.5220180091279142,0.4779819908720858
86281,0.6666666666666666,0.37735849056603776,-200,165,0.6373165618448637,0.36268343815513626,home,LAA,under,8.5,0.49751243781094534,101,0.4779819908720858,LAA,WSH,2022 REG,8,5,11,4,9,19,1,0,1,-1,1,1,1,1,0,0,0,0,0,0.5220180091279142,0.4779819908720858
86282,0.4672897196261683,0.5652173913043479,114,-130,0.45209948087359064,0.5479005191264094,away,ATL,over,8.5,0.5238095238095238,-110,0.4988662131519274,SEA,ATL,2022 REG,9,8,6,7,15,15,1,0,1,-1,1,1,1,1,1,1,1,0,0,0.4988662131519274,0.5011337868480725
86282,0.4672897196261683,0.5652173913043479,114,-130,0.45209948087359064,0.5479005191264094,home,SEA,under,8.5,0.5238095238095238,-110,0.5011337868480725,SEA,ATL,2022 REG,9,8,6,7,15,15,1,0,1,-1,1,1,1,1,1,1,1,0,0,0.4988662131519274,0.5011337868480725
86283,0.5475113122171946,0.48780487804878053,-121,105,0.5281752985421585,0.4718247014578415,away,TB,over,10,0.5121951219512195,-105,0.48808156828023186,BOS,TB,2022 REG,11,4,2,0,4,13,1,0,4,-4,0,0,0,0,0,0,0,0,0,0.48808156828023186,0.5119184317197681
86283,0.5475113122171946,0.48780487804878053,-121,105,0.5281752985421585,0.4718247014578415,home,BOS,under,10,0.5348837209302326,-115,0.5119184317197681,BOS,TB,2022 REG,11,4,2,0,4,13,1,0,4,-4,0,0,0,0,0,0,0,0,0,0.48808156828023186,0.5119184317197681
86284,0.425531914893617,0.6153846153846154,135,-160,0.4081206254135181,0.5918793745864819,away,CHC,over,8.5,0.5238095238095238,-110,0.4988662131519274,WSH,CHC,2022 REG,13,5,10,7,12,23,0,1,-2,2,1,1,1,1,1,0,0,0,0,0.4988662131519274,0.5011337868480725
86284,0.425531914893617,0.6153846153846154,135,-160,0.4081206254135181,0.5918793745864819,home,WSH,under,8.5,0.5238095238095238,-110,0.5011337868480725,WSH,CHC,2022 REG,13,5,10,7,12,23,0,1,-2,2,1,1,1,1,1,0,0,0,0,0.4988662131519274,0.5011337868480725
86285,0.5652173913043479,0.47619047619047616,-130,110,0.5418129444594474,0.4581870555405526,away,OAK,over,7.5,0.5098039215686274,-104,0.4870219861770517,CLE,OAK,2022 REG,9,5,13,10,15,22,0,1,-5,5,1,1,1,1,1,0,0,0,0,0.4870219861770517,0.5129780138229483
86285,0.5652173913043479,0.47619047619047616,-130,110,0.5418129444594474,0.4581870555405526,home,CLE,under,7.5,0.5348837209302326,-115,0.5129780138229483,CLE,OAK,2022 REG,9,5,13,10,15,22,0,1,-5,5,1,1,1,1,1,0,0,0,0,0.4870219861770517,0.5129780138229483
86286,0.5073891625615764,0.5327102803738317,-103,-114,0.487043139791394,0.512956860208606,away,TEX,over,9.5,0.5,100,0.47935779816513757,KC,TEX,2022 REG,7,2,5,1,3,12,1,0,1,-1,1,0,0,0,0,0,0,0,0,0.47935779816513757,0.5206422018348624
86286,0.5073891625615764,0.5327102803738317,-103,-114,0.487043139791394,0.512956860208606,home,KC,under,9.5,0.5412844036697247,-118,0.5206422018348624,KC,TEX,2022 REG,7,2,5,1,3,12,1,0,1,-1,1,0,0,0,0,0,0,0,0,0.47935779816513757,0.5206422018348624
86287,0.613899613899614,0.425531914893617,-159,135,0.589692613597978,0.410307386402022,away,MIA,over,9,0.5121951219512195,-105,0.48808156828023186,LAA,MIA,2022 REG,4,4,5,3,7,9,1,0,1,-1,1,1,1,0,0,0,0,0,0,0.48808156828023186,0.5119184317197681
86287,0.613899613899614,0.425531914893617,-159,135,0.589692613597978,0.410307386402022,home,LAA,under,9,0.5348837209302326,-115,0.5119184317197681,LAA,MIA,2022 REG,4,4,5,3,7,9,1,0,1,-1,1,1,1,0,0,0,0,0,0,0.48808156828023186,0.5119184317197681
86288,0.4807692307692307,0.5594713656387665,108,-127,0.46142279018846283,0.5385772098115371,away,PHI,over,8,0.5348837209302326,-115,0.5097020142727117,MIL,PHI,2022 REG,5,0,14,10,10,19,0,1,-10,10,0,0,0,0,0,0,0,0,0,0.5097020142727117,0.49029798572728833
86288,0.4807692307692307,0.5594713656387665,108,-127,0.46142279018846283,0.5385772098115371,home,MIL,under,8,0.5121951219512195,-105,0.49029798572728833,MIL,PHI,2022 REG,5,0,14,10,10,19,0,1,-10,10,0,0,0,0,0,0,0,0,0,0.5097020142727117,0.49029798572728833
86289,0.36363636363636365,0.6721311475409836,175,-205,0.3506299959355101,0.6493700040644899,away,LAD,over,7.5,0.5098039215686274,-104,0.48483656587239576,LAA,LAD,2022 REG,2,1,13,9,10,15,0,1,-8,8,1,0,0,0,0,0,0,0,0,0.48483656587239576,0.5151634341276042
86289,0.36363636363636365,0.6721311475409836,175,-205,0.3506299959355101,0.6493700040644899,home,LAA,under,7.5,0.5391705069124424,-117,0.5151634341276042,LAA,LAD,2022 REG,2,1,13,9,10,15,0,1,-8,8,1,0,0,0,0,0,0,0,0,0.48483656587239576,0.5151634341276042
86290,0.43859649122807015,0.6000000000000001,128,-150,0.4216682056017235,0.5783317943982764,away,CWS,over,7.5,0.5283018867924528,-112,0.5044173060022736,CLE,CWS,2022 REG,10,2,13,8,10,23,0,1,-6,6,1,1,0,0,0,0,0,0,0,0.5044173060022736,0.49558269399772636
86290,0.43859649122807015,0.6000000000000001,128,-150,0.4216682056017235,0.5783317943982764,home,CLE,under,7.5,0.5169082125603864,-107,0.49558269399772636,CLE,CWS,2022 REG,10,2,13,8,10,23,0,1,-6,6,1,1,0,0,0,0,0,0,0,0.5044173060022736,0.49558269399772636
86291,0.5348837209302326,0.5121951219512195,-115,-105,0.5097020142727117,0.49029798572728833,away,STL,over,8.5,0.5,100,0.4772727272727273,CHC,STL,2022 REG,12,4,11,7,11,23,0,1,-3,3,1,1,1,1,0,0,0,0,0,0.4772727272727273,0.5227272727272727
86291,0.5348837209302326,0.5121951219512195,-115,-105,0.5097020142727117,0.49029798572728833,home,CHC,under,8.5,0.5454545454545454,-120,0.5227272727272727,CHC,STL,2022 REG,12,4,11,7,11,23,0,1,-3,3,1,1,1,1,0,0,0,0,0,0.4772727272727273,0.5227272727272727
86292,0.6774193548387096,0.36363636363636365,-210,175,0.6496074165168858,0.3503925834831142,away,TEX,over,9,0.5454545454545454,-120,0.5206611570247933,TOR,TEX,2022 REG,9,4,9,3,7,18,1,0,1,-1,1,1,1,0,0,0,0,0,0,0.5206611570247933,0.4793388429752067
86292,0.6774193548387096,0.36363636363636365,-210,175,0.6496074165168858,0.3503925834831142,home,TOR,under,9,0.5,100,0.4793388429752067,TOR,TEX,2022 REG,9,4,9,3,7,18,1,0,1,-1,1,1,1,0,0,0,0,0,0,0.5206611570247933,0.4793388429752067
86293,0.6453900709219857,0.3921568627450981,-182,155,0.6211576527396834,0.3788423472603166,away,TEX,over,8,0.5215311004784688,-109,0.4978845547971712,HOU,TEX,2022 REG,8,1,3,0,1,11,1,0,1,-1,0,0,0,0,0,0,0,0,0,0.4978845547971712,0.5021154452028288
86293,0.6453900709219857,0.3921568627450981,-182,155,0.6211576527396834,0.3788423472603166,home,HOU,under,8,0.5238095238095238,-110,0.5021154452028288,HOU,TEX,2022 REG,8,1,3,0,1,11,1,0,1,-1,0,0,0,0,0,0,0,0,0,0.4978845547971712,0.5021154452028288
86294,0.6108949416342413,0.425531914893617,-157,135,0.5886419592417365,0.41135804075826354,away,CLE,over,8.5,0.5145631067961165,-106,0.49023796582517226,LAA,CLE,2022 REG,8,4,4,1,5,12,1,0,3,-3,1,0,0,0,0,0,0,0,0,0.49023796582517226,0.5097620341748277
86294,0.6108949416342413,0.425531914893617,-157,135,0.5886419592417365,0.41135804075826354,home,LAA,under,8.5,0.5327102803738317,-114,0.5097620341748277,LAA,CLE,2022 REG,8,4,4,1,5,12,1,0,3,-3,1,0,0,0,0,0,0,0,0,0.49023796582517226,0.5097620341748277
86295,0.5575221238938054,0.4807692307692307,-126,108,0.5361738465152985,0.46382615348470146,away,MIN,over,7,0.5412844036697247,-118,0.5149381613977361,SEA,MIN,2022 REG,6,5,4,0,5,10,1,0,5,-5,0,0,0,0,0,0,0,0,0,0.5149381613977361,0.48506183860226393
86295,0.5575221238938054,0.4807692307692307,-126,108,0.5361738465152985,0.46382615348470146,home,SEA,under,7,0.5073891625615764,-103,0.48506183860226393,SEA,MIN,2022 REG,6,5,4,0,5,10,1,0,5,-5,0,0,0,0,0,0,0,0,0,0.5149381613977361,0.48506183860226393
86296,0.5391705069124424,0.49504950495049505,-117,102,0.5207200857697526,0.4792799142302474,away,COL,over,8,0.5238095238095238,-110,0.4988662131519274,CIN,COL,2022 REG,4,4,8,8,12,12,0,1,-4,4,1,1,1,1,0,0,0,0,0,0.4988662131519274,0.5011337868480725
86296,0.5391705069124424,0.49504950495049505,-117,102,0.5207200857697526,0.4792799142302474,home,CIN,under,8,0.5238095238095238,-110,0.5011337868480725,CIN,COL,2022 REG,4,4,8,8,12,12,0,1,-4,4,1,1,1,1,0,0,0,0,0,0.4988662131519274,0.5011337868480725
86297,0.5850622406639003,0.45454545454545453,-141,120,0.5618892737571823,0.43811072624281766,away,DET,over,9,0.5145631067961165,-106,0.4913668392989033,ARI,DET,2022 REG,13,11,8,7,18,21,1,0,4,-4,1,1,1,1,1,1,1,0,0,0.4913668392989033,0.5086331607010968
86297,0.5850622406639003,0.45454545454545453,-141,120,0.5618892737571823,0.43811072624281766,home,ARI,under,9,0.5305164319248826,-113,0.5086331607010968,ARI,DET,2022 REG,13,11,8,7,18,21,1,0,4,-4,1,1,1,1,1,1,1,0,0,0.4913668392989033,0.5086331607010968
86298,0.7333333333333333,0.3125,-275,220,0.6997222222222221,0.30027777777777787,away,STL,over,8,0.5348837209302326,-115,0.5097020142727117,TOR,STL,2022 REG,5,1,13,6,7,18,0,1,-5,5,1,0,0,0,0,0,0,0,0,0.5097020142727117,0.49029798572728833
86298,0.7333333333333333,0.3125,-275,220,0.6997222222222221,0.30027777777777787,home,TOR,under,8,0.5121951219512195,-105,0.49029798572728833,TOR,STL,2022 REG,5,1,13,6,7,18,0,1,-5,5,1,0,0,0,0,0,0,0,0,0.5097020142727117,0.49029798572728833
86299,0.5348837209302326,0.5073891625615764,-115,-103,0.5122726437136835,0.48772735628631647,away,PHI,over,7.5,0.5169082125603864,-107,0.49239402434819424,SF,PHI,2022 REG,8,5,9,3,8,17,1,0,2,-2,1,1,1,0,0,0,0,0,0,0.49239402434819424,0.5076059756518058
86299,0.5348837209302326,0.5073891625615764,-115,-103,0.5122726437136835,0.48772735628631647,home,SF,under,7.5,0.5305164319248826,-113,0.5076059756518058,SF,PHI,2022 REG,8,5,9,3,8,17,1,0,2,-2,1,1,1,0,0,0,0,0,0,0.49239402434819424,0.5076059756518058
86300,0.5815899581589958,0.45454545454545453,-139,120,0.5605739649961564,0.4394260350038436,away,BAL,over,8,0.5192307692307692,-108,0.49688292476754015,OAK,BAL,2022 REG,7,0,5,1,1,12,0,1,-1,1,0,0,0,0,0,0,0,0,0,0.49688292476754015,0.5031170752324599
86300,0.5815899581589958,0.45454545454545453,-139,120,0.5605739649961564,0.4394260350038436,home,OAK,under,8,0.5238095238095238,-110,0.5031170752324599,OAK,BAL,2022 REG,7,0,5,1,1,12,0,1,-1,1,0,0,0,0,0,0,0,0,0,0.49688292476754015,0.5031170752324599
86301,0.6453900709219857,0.3921568627450981,-182,155,0.6211576527396834,0.3788423472603166,away,OAK,over,7,0.5121951219512195,-105,0.48808156828023186,MIN,OAK,2022 REG,9,4,8,3,7,17,1,0,1,-1,1,1,1,0,0,0,0,0,0,0.48808156828023186,0.5119184317197681
86301,0.6453900709219857,0.3921568627450981,-182,155,0.6211576527396834,0.3788423472603166,home,MIN,under,7,0.5348837209302326,-115,0.5119184317197681,MIN,OAK,2022 REG,9,4,8,3,7,17,1,0,1,-1,1,1,1,0,0,0,0,0,0,0.48808156828023186,0.5119184317197681
86302,0.4854368932038835,0.5495495495495495,106,-122,0.4684531831294015,0.5315468168705986,away,SF,over,7.5,0.5238095238095238,-110,0.5000596729920038,CHC,SF,2022 REG,7,2,11,5,7,18,0,1,-3,3,1,1,0,0,0,0,0,0,0,0.5000596729920038,0.4999403270079962
86302,0.4854368932038835,0.5495495495495495,106,-122,0.4684531831294015,0.5315468168705986,home,CHC,under,7.5,0.5215311004784688,-109,0.4999403270079962,CHC,SF,2022 REG,7,2,11,5,7,18,0,1,-3,3,1,1,0,0,0,0,0,0,0,0.5000596729920038,0.4999403270079962
86303,0.5918367346938775,0.45454545454545453,-145,120,0.5643860512665178,0.43561394873348225,away,TOR,over,7.5,0.5098039215686274,-104,0.4870219861770517,NYY,TOR,2022 REG,8,5,9,3,8,17,1,0,2,-2,1,1,1,0,0,0,0,0,0,0.4870219861770517,0.5129780138229483
86303,0.5918367346938775,0.45454545454545453,-145,120,0.5643860512665178,0.43561394873348225,home,NYY,under,7.5,0.5348837209302326,-115,0.5129780138229483,NYY,TOR,2022 REG,8,5,9,3,8,17,1,0,2,-2,1,1,1,0,0,0,0,0,0,0.4870219861770517,0.5129780138229483
86304,0.613899613899614,0.425531914893617,-159,135,0.589692613597978,0.410307386402022,away,MIA,over,8.5,0.5283018867924528,-112,0.5044173060022736,NYM,MIA,2022 REG,9,6,7,0,6,16,1,0,6,-6,0,0,0,0,0,0,0,0,0,0.5044173060022736,0.49558269399772636
86304,0.613899613899614,0.425531914893617,-159,135,0.589692613597978,0.410307386402022,home,NYM,under,8.5,0.5169082125603864,-107,0.49558269399772636,NYM,MIA,2022 REG,9,6,7,0,6,16,1,0,6,-6,0,0,0,0,0,0,0,0,0,0.5044173060022736,0.49558269399772636
86305,0.6666666666666666,0.37037037037037035,-200,170,0.6419753086419753,0.3580246913580247,away,TEX,over,7,0.5,100,0.4772727272727273,TB,TEX,2022 REG,10,5,6,3,8,16,1,0,2,-2,1,1,1,0,0,0,0,0,0,0.4772727272727273,0.5227272727272727
86305,0.6666666666666666,0.37037037037037035,-200,170,0.6419753086419753,0.3580246913580247,home,TB,under,7,0.5454545454545454,-120,0.5227272727272727,TB,TEX,2022 REG,10,5,6,3,8,16,1,0,2,-2,1,1,1,0,0,0,0,0,0,0.4772727272727273,0.5227272727272727
86306,0.6527777777777778,0.3921568627450981,-188,155,0.6234454429920115,0.37655455700798846,away,SF,over,7.5,0.5370370370370371,-116,0.5105975442470474,SD,SF,2022 REG,5,0,7,1,1,12,0,1,-1,1,0,0,0,0,0,0,0,0,0,0.5105975442470474,0.4894024557529526
86306,0.6527777777777778,0.3921568627450981,-188,155,0.6234454429920115,0.37655455700798846,home,SD,under,7.5,0.5121951219512195,-105,0.4894024557529526,SD,SF,2022 REG,5,0,7,1,1,12,0,1,-1,1,0,0,0,0,0,0,0,0,0,0.5105975442470474,0.4894024557529526
86307,0.2898550724637681,0.7468354430379747,245,-295,0.27922014043427745,0.7207798595657225,away,MIL,over,7.5,0.5327102803738317,-114,0.5075272610403079,PIT,MIL,2022 REG,4,5,9,3,8,13,1,0,2,-2,1,1,1,0,0,0,0,0,0,0.5075272610403079,0.4924727389596921
86307,0.2898550724637681,0.7468354430379747,245,-295,0.27922014043427745,0.7207798595657225,home,PIT,under,7.5,0.5145631067961165,-106,0.4924727389596921,PIT,MIL,2022 REG,4,5,9,3,8,13,1,0,2,-2,1,1,1,0,0,0,0,0,0,0.5075272610403079,0.4924727389596921
86308,0.6323529411764706,0.4081632653061224,-172,145,0.6067323988418897,0.3932676011581103,away,ARI,over,7,0.5,100,0.4772727272727273,MIL,ARI,2022 REG,7,2,11,4,6,18,0,1,-2,2,1,1,0,0,0,0,0,0,0,0.4772727272727273,0.5227272727272727
86308,0.6323529411764706,0.4081632653061224,-172,145,0.6067323988418897,0.3932676011581103,home,MIL,under,7,0.5454545454545454,-120,0.5227272727272727,MIL,ARI,2022 REG,7,2,11,4,6,18,0,1,-2,2,1,1,0,0,0,0,0,0,0,0.4772727272727273,0.5227272727272727
86309,0.6551724137931035,0.3846153846153846,-190,160,0.6291045458703008,0.37089545412969915,away,SEA,over,8,0.5121951219512195,-105,0.48808156828023186,HOU,SEA,2022 REG,9,4,8,5,9,17,0,1,-1,1,1,1,1,1,0,0,0,0,0,0.48808156828023186,0.5119184317197681
86309,0.6551724137931035,0.3846153846153846,-190,160,0.6291045458703008,0.37089545412969915,home,HOU,under,8,0.5348837209302326,-115,0.5119184317197681,HOU,SEA,2022 REG,9,4,8,5,9,17,0,1,-1,1,1,1,1,1,0,0,0,0,0,0.48808156828023186,0.5119184317197681
86310,0.43859649122807015,0.6000000000000001,128,-150,0.4216682056017235,0.5783317943982764,away,HOU,over,7,0.5535714285714286,-124,0.5293429871948779,TEX,HOU,2022 REG,7,2,8,4,6,15,0,1,-2,2,1,1,0,0,0,0,0,0,0,0.5293429871948779,0.47065701280512207
86310,0.43859649122807015,0.6000000000000001,128,-150,0.4216682056017235,0.5783317943982764,home,TEX,under,7,0.49019607843137253,104,0.47065701280512207,TEX,HOU,2022 REG,7,2,8,4,6,15,0,1,-2,2,1,1,0,0,0,0,0,0,0,0.5293429871948779,0.47065701280512207
86311,0.576271186440678,0.4629629629629629,-136,116,0.553661676614851,0.446338323385149,away,CLE,over,8.5,0.5238095238095238,-110,0.4988662131519274,BOS,CLE,2022 REG,9,6,12,7,13,21,0,1,-1,1,1,1,1,1,1,1,0,0,0,0.4988662131519274,0.5011337868480725
86311,0.576271186440678,0.4629629629629629,-136,116,0.553661676614851,0.446338323385149,home,BOS,under,8.5,0.5238095238095238,-110,0.5011337868480725,BOS,CLE,2022 REG,9,6,12,7,13,21,0,1,-1,1,1,1,1,1,1,1,0,0,0,0.4988662131519274,0.5011337868480725
86312,0.4,0.6389891696750902,150,-177,0.3844043321299639,0.6155956678700361,away,LAD,over,7.5,0.5283018867924528,-112,0.5044173060022736,SF,LAD,2022 REG,6,3,6,4,7,12,0,1,-1,1,1,1,1,0,0,0,0,0,0,0.5044173060022736,0.49558269399772636
86312,0.4,0.6389891696750902,150,-177,0.3844043321299639,0.6155956678700361,home,SF,under,7.5,0.5169082125603864,-107,0.49558269399772636,SF,LAD,2022 REG,6,3,6,4,7,12,0,1,-1,1,1,1,1,0,0,0,0,0,0,0.5044173060022736,0.49558269399772636
86313,0.5652173913043479,0.47619047619047616,-130,110,0.5418129444594474,0.4581870555405526,away,ARI,over,8.5,0.5098039215686274,-104,0.48592421718142587,WSH,ARI,2022 REG,9,2,10,11,13,19,0,1,-9,9,1,1,0,0,0,0,0,0,0,0.48592421718142587,0.5140757828185741
86313,0.5652173913043479,0.47619047619047616,-130,110,0.5418129444594474,0.4581870555405526,home,WSH,under,8.5,0.5370370370370371,-116,0.5140757828185741,WSH,ARI,2022 REG,9,2,10,11,13,19,0,1,-9,9,1,1,0,0,0,0,0,0,0,0.48592421718142587,0.5140757828185741
86314,0.37037037037037035,0.6666666666666666,170,-200,0.35665294924554186,0.6433470507544581,away,MIL,over,7.5,0.5238095238095238,-110,0.5000596729920038,PIT,MIL,2022 REG,3,2,16,19,21,19,0,1,-17,17,1,1,0,0,0,0,0,0,0,0.5000596729920038,0.4999403270079962
86314,0.37037037037037035,0.6666666666666666,170,-200,0.35665294924554186,0.6433470507544581,home,PIT,under,7.5,0.5215311004784688,-109,0.4999403270079962,PIT,MIL,2022 REG,3,2,16,19,21,19,0,1,-17,17,1,1,0,0,0,0,0,0,0,0.5000596729920038,0.4999403270079962
86315,0.46511627906976744,0.5798319327731092,115,-138,0.44421013402656906,0.5557898659734309,away,CWS,over,8,0.5238095238095238,-110,0.4988662131519274,TEX,CWS,2022 REG,9,2,15,8,10,24,0,1,-6,6,1,1,0,0,0,0,0,0,0,0.4988662131519274,0.5011337868480725
86315,0.46511627906976744,0.5798319327731092,115,-138,0.44421013402656906,0.5557898659734309,home,TEX,under,8,0.5238095238095238,-110,0.5011337868480725,TEX,CWS,2022 REG,9,2,15,8,10,24,0,1,-6,6,1,1,0,0,0,0,0,0,0,0.4988662131519274,0.5011337868480725
86316,0.35714285714285715,0.6774193548387096,180,-210,0.3447992100065833,0.6552007899934167,away,NYY,over,8,0.5305164319248826,-113,0.5053568787472517,OAK,NYY,2022 REG,8,4,4,1,5,12,1,0,3,-3,1,0,0,0,0,0,0,0,0,0.5053568787472517,0.49464312125274834
86316,0.35714285714285715,0.6774193548387096,180,-210,0.3447992100065833,0.6552007899934167,home,OAK,under,8,0.5169082125603864,-107,0.49464312125274834,OAK,NYY,2022 REG,8,4,4,1,5,12,1,0,3,-3,1,0,0,0,0,0,0,0,0,0.5053568787472517,0.49464312125274834
86317,0.5348837209302326,0.5073891625615764,-115,-103,0.5122726437136835,0.48772735628631647,away,MIN,over,8.5,0.5192307692307692,-108,0.49455035168025013,SEA,MIN,2022 REG,6,2,9,3,5,15,0,1,-1,1,1,1,0,0,0,0,0,0,0,0.49455035168025013,0.5054496483197499
86317,0.5348837209302326,0.5073891625615764,-115,-103,0.5122726437136835,0.48772735628631647,home,SEA,under,8.5,0.5283018867924528,-112,0.5054496483197499,SEA,MIN,2022 REG,6,2,9,3,5,15,0,1,-1,1,1,1,0,0,0,0,0,0,0,0.49455035168025013,0.5054496483197499
86318,0.6124031007751938,0.4273504273504274,-158,134,0.5880579168843095,0.41194208311569047,away,ATL,over,7,0.5,100,0.4772727272727273,NYM,ATL,2022 REG,10,5,2,2,7,12,1,0,3,-3,1,1,0,0,0,0,0,0,0,0.4772727272727273,0.5227272727272727
86318,0.6124031007751938,0.4273504273504274,-158,134,0.5880579168843095,0.41194208311569047,home,NYM,under,7,0.5454545454545454,-120,0.5227272727272727,NYM,ATL,2022 REG,10,5,2,2,7,12,1,0,3,-3,1,1,0,0,0,0,0,0,0,0.4772727272727273,0.5227272727272727
86319,0.5918367346938775,0.4504504504504505,-145,122,0.566809625118663,0.43319037488133705,away,ATL,over,8.5,0.5412844036697247,-118,0.5149381613977361,STL,ATL,2022 REG,6,6,10,3,9,16,1,0,3,-3,1,1,1,0,0,0,0,0,0,0.5149381613977361,0.48506183860226393
86319,0.5918367346938775,0.4504504504504505,-145,122,0.566809625118663,0.43319037488133705,home,STL,under,8.5,0.5073891625615764,-103,0.48506183860226393,STL,ATL,2022 REG,6,6,10,3,9,16,1,0,3,-3,1,1,1,0,0,0,0,0,0,0.5149381613977361,0.48506183860226393
86320,0.7297297297297298,0.3125,-270,220,0.6989134404674946,0.3010865595325054,away,TEX,over,8,0.5098039215686274,-104,0.4870219861770517,HOU,TEX,2022 REG,10,7,8,3,10,18,1,0,4,-4,1,1,1,0,0,0,0,0,0,0.4870219861770517,0.5129780138229483
86320,0.7297297297297298,0.3125,-270,220,0.6989134404674946,0.3010865595325054,home,HOU,under,8,0.5348837209302326,-115,0.5129780138229483,HOU,TEX,2022 REG,10,7,8,3,10,18,1,0,4,-4,1,1,1,0,0,0,0,0,0,0.4870219861770517,0.5129780138229483
86321,0.6666666666666666,0.37735849056603776,-200,165,0.6373165618448637,0.36268343815513626,away,COL,over,8,0.5370370370370371,-116,0.5118817074154765,MIL,COL,2022 REG,5,0,5,2,2,10,0,1,-2,2,0,0,0,0,0,0,0,0,0,0.5118817074154765,0.48811829258452355
86321,0.6666666666666666,0.37735849056603776,-200,165,0.6373165618448637,0.36268343815513626,home,MIL,under,8,0.5098039215686274,-104,0.48811829258452355,MIL,COL,2022 REG,5,0,5,2,2,10,0,1,-2,2,0,0,0,0,0,0,0,0,0,0.5118817074154765,0.48811829258452355
86322,0.7142857142857143,0.3278688524590164,-250,205,0.6841753094680495,0.3158246905319505,away,CIN,over,9,0.5098039215686274,-104,0.4870219861770517,LAD,CIN,2022 REG,8,5,4,2,7,12,1,0,3,-3,1,1,0,0,0,0,0,0,0,0.4870219861770517,0.5129780138229483
86322,0.7142857142857143,0.3278688524590164,-250,205,0.6841753094680495,0.3158246905319505,home,LAD,under,9,0.5348837209302326,-115,0.5129780138229483,LAD,CIN,2022 REG,8,5,4,2,7,12,1,0,3,-3,1,1,0,0,0,0,0,0,0,0.4870219861770517,0.5129780138229483
86323,0.6610169491525424,0.3846153846153846,-195,160,0.6308532031025568,0.36914679689744323,away,TEX,over,8,0.5412844036697247,-118,0.5149381613977361,HOU,TEX,2022 REG,8,5,9,2,7,17,1,0,3,-3,1,1,0,0,0,0,0,0,0,0.5149381613977361,0.48506183860226393
86323,0.6610169491525424,0.3846153846153846,-195,160,0.6308532031025568,0.36914679689744323,home,HOU,under,8,0.5073891625615764,-103,0.48506183860226393,HOU,TEX,2022 REG,8,5,9,2,7,17,1,0,3,-3,1,1,0,0,0,0,0,0,0,0.5149381613977361,0.48506183860226393
86324,0.6254681647940076,0.41152263374485604,-167,143,0.6023315979176397,0.3976684020823603,away,BAL,over,9,0.5024875621890548,-101,0.48049269377245407,TOR,BAL,2022 REG,8,6,5,3,9,13,1,0,3,-3,1,1,1,0,0,0,0,0,0,0.48049269377245407,0.5195073062275459
86324,0.6254681647940076,0.41152263374485604,-167,143,0.6023315979176397,0.3976684020823603,home,TOR,under,9,0.5412844036697247,-118,0.5195073062275459,TOR,BAL,2022 REG,8,6,5,3,9,13,1,0,3,-3,1,1,1,0,0,0,0,0,0,0.48049269377245407,0.5195073062275459
86325,0.5633187772925764,0.4807692307692307,-129,108,0.5384831744979339,0.4615168255020661,away,STL,over,7.5,0.5073891625615764,-103,0.4837652908580103,MIA,STL,2022 REG,7,5,5,0,5,12,1,0,5,-5,0,0,0,0,0,0,0,0,0,0.4837652908580103,0.5162347091419897
86325,0.5633187772925764,0.4807692307692307,-129,108,0.5384831744979339,0.4615168255020661,home,MIA,under,7.5,0.5391705069124424,-117,0.5162347091419897,MIA,STL,2022 REG,7,5,5,0,5,12,1,0,5,-5,0,0,0,0,0,0,0,0,0,0.4837652908580103,0.5162347091419897
86326,0.49504950495049505,0.5454545454545454,102,-120,0.47499799484898986,0.5250020051510101,away,CLE,over,7.5,0.5121951219512195,-105,0.48808156828023186,MIN,CLE,2022 REG,12,4,7,6,10,19,0,1,-2,2,1,1,1,1,0,0,0,0,0,0.48808156828023186,0.5119184317197681
86326,0.49504950495049505,0.5454545454545454,102,-120,0.47499799484898986,0.5250020051510101,home,MIN,under,7.5,0.5348837209302326,-115,0.5119184317197681,MIN,CLE,2022 REG,12,4,7,6,10,19,0,1,-2,2,1,1,1,1,0,0,0,0,0,0.48808156828023186,0.5119184317197681
86327,0.6153846153846154,0.42016806722689076,-160,138,0.5935060414698423,0.4064939585301577,away,WSH,over,8.5,0.5305164319248826,-113,0.5066009958897986,ARI,WSH,2022 REG,12,10,3,1,11,15,1,0,9,-9,1,0,0,0,0,0,0,0,0,0.5066009958897986,0.49339900411020143
86327,0.6153846153846154,0.42016806722689076,-160,138,0.5935060414698423,0.4064939585301577,home,ARI,under,8.5,0.5145631067961165,-106,0.49339900411020143,ARI,WSH,2022 REG,12,10,3,1,11,15,1,0,9,-9,1,0,0,0,0,0,0,0,0,0.5066009958897986,0.49339900411020143
86328,0.7275204359673024,0.3076923076923077,-267,225,0.701902445348458,0.298097554651542,away,COL,over,7.5,0.5073891625615764,-103,0.4837652908580103,CWS,COL,2022 REG,8,0,7,3,3,15,0,1,-3,3,0,0,0,0,0,0,0,0,0,0.4837652908580103,0.5162347091419897
86328,0.7275204359673024,0.3076923076923077,-267,225,0.701902445348458,0.298097554651542,home,CWS,under,7.5,0.5391705069124424,-117,0.5162347091419897,CWS,COL,2022 REG,8,0,7,3,3,15,0,1,-3,3,0,0,0,0,0,0,0,0,0,0.4837652908580103,0.5162347091419897
86329,0.5412844036697247,0.49504950495049505,-118,102,0.5216174256092387,0.47838257439076126,away,PHI,over,7.5,0.5121951219512195,-105,0.48919479393107135,NYM,PHI,2022 REG,7,5,5,4,9,12,1,0,1,-1,1,1,1,1,0,0,0,0,0,0.48919479393107135,0.5108052060689287
86329,0.5412844036697247,0.49504950495049505,-118,102,0.5216174256092387,0.47838257439076126,home,NYM,under,7.5,0.5327102803738317,-114,0.5108052060689287,NYM,PHI,2022 REG,7,5,5,4,9,12,1,0,1,-1,1,1,1,1,0,0,0,0,0,0.48919479393107135,0.5108052060689287
86330,0.607843137254902,0.4273504273504274,-155,134,0.5864509705340155,0.4135490294659845,away,CIN,over,10.5,0.5348837209302326,-115,0.5097020142727117,COL,CIN,2022 REG,12,10,4,1,11,16,1,0,9,-9,1,0,0,0,0,0,0,0,0,0.5097020142727117,0.49029798572728833
86330,0.607843137254902,0.4273504273504274,-155,134,0.5864509705340155,0.4135490294659845,home,COL,under,10.5,0.5121951219512195,-105,0.49029798572728833,COL,CIN,2022 REG,12,10,4,1,11,16,1,0,9,-9,1,0,0,0,0,0,0,0,0,0.5097020142727117,0.49029798572728833
86331,0.7530864197530864,0.29411764705882354,-305,240,0.7175376780799196,0.28246232192008036,away,COL,over,8,0.5073891625615764,-103,0.4837652908580103,SD,COL,2022 REG,9,3,14,7,10,23,0,1,-4,4,1,1,1,0,0,0,0,0,0,0.4837652908580103,0.5162347091419897
86331,0.7530864197530864,0.29411764705882354,-305,240,0.7175376780799196,0.28246232192008036,home,SD,under,8,0.5391705069124424,-117,0.5162347091419897,SD,COL,2022 REG,9,3,14,7,10,23,0,1,-4,4,1,1,1,0,0,0,0,0,0,0.4837652908580103,0.5162347091419897
86332,0.5652173913043479,0.4716981132075471,-130,112,0.5443521061454507,0.4556478938545493,away,SD,over,7,0.5454545454545454,-120,0.5193043049216726,SF,SD,2022 REG,11,5,7,6,11,18,0,1,-1,1,1,1,1,1,1,0,0,0,0,0.5193043049216726,0.48069569507832743
86332,0.5652173913043479,0.4716981132075471,-130,112,0.5443521061454507,0.4556478938545493,home,SF,under,7,0.5024875621890548,-101,0.48069569507832743,SF,SD,2022 REG,11,5,7,6,11,18,0,1,-1,1,1,1,1,1,1,0,0,0,0,0.5193043049216726,0.48069569507832743
86333,0.5884773662551441,0.45454545454545453,-143,120,0.5631594099815408,0.4368405900184592,away,MIA,over,7.5,0.5145631067961165,-106,0.4913668392989033,CHC,MIA,2022 REG,4,2,7,1,3,11,1,0,1,-1,1,0,0,0,0,0,0,0,0,0.4913668392989033,0.5086331607010968
86333,0.5884773662551441,0.45454545454545453,-143,120,0.5631594099815408,0.4368405900184592,home,CHC,under,7.5,0.5305164319248826,-113,0.5086331607010968,CHC,MIA,2022 REG,4,2,7,1,3,11,1,0,1,-1,1,0,0,0,0,0,0,0,0,0.4913668392989033,0.5086331607010968
86334,0.7590361445783133,0.2777777777777778,-315,260,0.7310930468863406,0.2689069531136594,away,SF,over,9,0.5073891625615764,-103,0.4837652908580103,LAD,SF,2022 REG,8,6,8,3,9,16,1,0,3,-3,1,1,1,0,0,0,0,0,0,0.4837652908580103,0.5162347091419897
86334,0.7590361445783133,0.2777777777777778,-315,260,0.7310930468863406,0.2689069531136594,home,LAD,under,9,0.5391705069124424,-117,0.5162347091419897,LAD,SF,2022 REG,8,6,8,3,9,16,1,0,3,-3,1,1,1,0,0,0,0,0,0,0.4837652908580103,0.5162347091419897
86335,0.425531914893617,0.613899613899614,135,-159,0.40875254093905067,0.5912474590609493,away,TOR,over,10.5,0.5370370370370371,-116,0.5118817074154765,BOS,TOR,2022 REG,9,4,15,8,12,24,0,1,-4,4,1,1,1,1,0,0,0,0,0,0.5118817074154765,0.48811829258452355
86335,0.425531914893617,0.613899613899614,135,-159,0.40875254093905067,0.5912474590609493,home,BOS,under,10.5,0.5098039215686274,-104,0.48811829258452355,BOS,TOR,2022 REG,9,4,15,8,12,24,0,1,-4,4,1,1,1,1,0,0,0,0,0,0.5118817074154765,0.48811829258452355
86336,0.5215311004784688,0.5121951219512195,-109,-105,0.5039418265797319,0.49605817342026814,away,TB,over,8.5,0.5,100,0.4783105022831051,BOS,TB,2022 REG,13,4,17,12,16,30,0,1,-8,8,1,1,1,1,0,0,0,0,0,0.4783105022831051,0.5216894977168949
86336,0.5215311004784688,0.5121951219512195,-109,-105,0.5039418265797319,0.49605817342026814,home,BOS,under,8.5,0.5433789954337899,-119,0.5216894977168949,BOS,TB,2022 REG,13,4,17,12,16,30,0,1,-8,8,1,1,1,1,0,0,0,0,0,0.4783105022831051,0.5216894977168949
86337,0.6774193548387096,0.35714285714285715,-210,180,0.6540062434963579,0.34599375650364206,away,PIT,over,9,0.5,100,0.4772727272727273,STL,PIT,2022 REG,14,9,1,1,10,15,1,0,8,-8,1,0,0,0,0,0,0,0,0,0.4772727272727273,0.5227272727272727
86337,0.6774193548387096,0.35714285714285715,-210,180,0.6540062434963579,0.34599375650364206,home,STL,under,9,0.5454545454545454,-120,0.5227272727272727,STL,PIT,2022 REG,14,9,1,1,10,15,1,0,8,-8,1,0,0,0,0,0,0,0,0,0.4772727272727273,0.5227272727272727
86338,0.6254681647940076,0.425531914893617,-167,135,0.5935692385474408,0.4064307614525592,away,CLE,over,9.5,0.49751243781094534,101,0.4740985137509976,MIN,CLE,2022 REG,9,5,12,6,11,21,0,1,-1,1,1,1,1,1,1,0,0,0,0,0.4740985137509976,0.5259014862490023
86338,0.6254681647940076,0.425531914893617,-167,135,0.5935692385474408,0.4064307614525592,home,MIN,under,9.5,0.5495495495495495,-122,0.5259014862490023,MIN,CLE,2022 REG,9,5,12,6,11,21,0,1,-1,1,1,1,1,1,1,0,0,0,0,0.4740985137509976,0.5259014862490023
86339,0.504950495049505,0.5391705069124424,-102,-117,0.4826715732667395,0.5173284267332605,away,KC,over,7,0.5348837209302326,-115,0.5097020142727117,BAL,KC,2022 REG,15,4,11,6,10,26,0,1,-2,2,1,1,1,1,0,0,0,0,0,0.5097020142727117,0.49029798572728833
86339,0.504950495049505,0.5391705069124424,-102,-117,0.4826715732667395,0.5173284267332605,home,BAL,under,7,0.5121951219512195,-105,0.49029798572728833,BAL,KC,2022 REG,15,4,11,6,10,26,0,1,-2,2,1,1,1,1,0,0,0,0,0,0.5097020142727117,0.49029798572728833
86340,0.5121951219512195,0.5348837209302326,-105,-115,0.48808156828023186,0.5119184317197681,away,MIL,over,9.5,0.5348837209302326,-115,0.5097020142727117,CIN,MIL,2022 REG,8,4,7,5,9,15,0,1,-1,1,1,1,1,1,0,0,0,0,0,0.5097020142727117,0.49029798572728833
86340,0.5121951219512195,0.5348837209302326,-105,-115,0.48808156828023186,0.5119184317197681,home,CIN,under,9.5,0.5121951219512195,-105,0.49029798572728833,CIN,MIL,2022 REG,8,4,7,5,9,15,0,1,-1,1,1,1,1,1,0,0,0,0,0,0.5097020142727117,0.49029798572728833
86341,0.5121951219512195,0.5238095238095238,-105,-110,0.4937537180249852,0.5062462819750149,away,NYY,over,7.5,0.5370370370370371,-116,0.5118817074154765,NYM,NYY,2022 REG,10,6,9,3,9,19,1,0,3,-3,1,1,1,0,0,0,0,0,0,0.5118817074154765,0.48811829258452355
86341,0.5121951219512195,0.5238095238095238,-105,-110,0.4937537180249852,0.5062462819750149,home,NYM,under,7.5,0.5098039215686274,-104,0.48811829258452355,NYM,NYY,2022 REG,10,6,9,3,9,19,1,0,3,-3,1,1,1,0,0,0,0,0,0,0.5118817074154765,0.48811829258452355
86342,0.7752808988764045,0.2631578947368421,-345,280,0.7454800364122021,0.25451996358779794,away,OAK,over,8.5,0.5283018867924528,-112,0.5044173060022736,HOU,OAK,2022 REG,11,7,11,5,12,22,1,0,2,-2,1,1,1,1,1,0,0,0,0,0.5044173060022736,0.49558269399772636
86342,0.7752808988764045,0.2631578947368421,-345,280,0.7454800364122021,0.25451996358779794,home,HOU,under,8.5,0.5169082125603864,-107,0.49558269399772636,HOU,OAK,2022 REG,11,7,11,5,12,22,1,0,2,-2,1,1,1,1,1,0,0,0,0,0.5044173060022736,0.49558269399772636
86343,0.425531914893617,0.613899613899614,135,-159,0.40875254093905067,0.5912474590609493,away,CLE,over,7.5,0.5305164319248826,-113,0.5066009958897986,DET,CLE,2022 REG,4,2,7,1,3,11,1,0,1,-1,1,0,0,0,0,0,0,0,0,0.5066009958897986,0.49339900411020143
86343,0.425531914893617,0.613899613899614,135,-159,0.40875254093905067,0.5912474590609493,home,DET,under,7.5,0.5145631067961165,-106,0.49339900411020143,DET,CLE,2022 REG,4,2,7,1,3,11,1,0,1,-1,1,0,0,0,0,0,0,0,0,0.5066009958897986,0.49339900411020143
86344,0.6389891696750902,0.4,-177,150,0.614075512518083,0.385924487481917,away,COL,over,8.5,0.5454545454545454,-120,0.5206611570247933,ARI,COL,2022 REG,9,5,9,6,11,18,0,1,-1,1,1,1,1,1,1,0,0,0,0,0.5206611570247933,0.4793388429752067
86344,0.6389891696750902,0.4,-177,150,0.614075512518083,0.385924487481917,home,ARI,under,8.5,0.5,100,0.4793388429752067,ARI,COL,2022 REG,9,5,9,6,11,18,0,1,-1,1,1,1,1,1,1,0,0,0,0,0.5206611570247933,0.4793388429752067
86345,0.4,0.6428571428571428,150,-180,0.38285714285714295,0.617142857142857,away,MIL,over,7.5,0.49504950495049505,102,0.47297076509898783,PIT,MIL,2022 REG,13,8,14,12,20,27,0,1,-4,4,1,1,1,1,1,1,1,1,0,0.47297076509898783,0.5270292349010122
86345,0.4,0.6428571428571428,150,-180,0.38285714285714295,0.617142857142857,home,PIT,under,7.5,0.5495495495495495,-122,0.5270292349010122,PIT,MIL,2022 REG,13,8,14,12,20,27,0,1,-4,4,1,1,1,1,1,1,1,1,0,0.47297076509898783,0.5270292349010122
86346,0.6000000000000001,0.43859649122807015,-150,128,0.5768421052631579,0.42315789473684207,away,MIA,over,8.5,0.5327102803738317,-114,0.5075272610403079,ATL,MIA,2022 REG,6,6,5,4,10,11,1,0,2,-2,1,1,1,1,0,0,0,0,0,0.5075272610403079,0.4924727389596921
86346,0.6000000000000001,0.43859649122807015,-150,128,0.5768421052631579,0.42315789473684207,home,ATL,under,8.5,0.5145631067961165,-106,0.4924727389596921,ATL,MIA,2022 REG,6,6,5,4,10,11,1,0,2,-2,1,1,1,1,0,0,0,0,0,0.5075272610403079,0.4924727389596921
86347,0.613899613899614,0.425531914893617,-159,135,0.589692613597978,0.410307386402022,away,NYM,over,8,0.5073891625615764,-103,0.4837652908580103,ATL,NYM,2022 REG,8,3,8,7,10,16,0,1,-4,4,1,1,1,0,0,0,0,0,0,0.4837652908580103,0.5162347091419897
86347,0.613899613899614,0.425531914893617,-159,135,0.589692613597978,0.410307386402022,home,ATL,under,8,0.5391705069124424,-117,0.5162347091419897,ATL,NYM,2022 REG,8,3,8,7,10,16,0,1,-4,4,1,1,1,0,0,0,0,0,0,0.4837652908580103,0.5162347091419897
86348,0.6721311475409836,0.37037037037037035,-205,170,0.6435645535349916,0.35643544646500835,away,WSH,over,7.5,0.5145631067961165,-106,0.4913668392989033,MIL,WSH,2022 REG,12,5,9,1,6,21,1,0,4,-4,1,0,0,0,0,0,0,0,0,0.4913668392989033,0.5086331607010968
86348,0.6721311475409836,0.37037037037037035,-205,170,0.6435645535349916,0.35643544646500835,home,MIL,under,7.5,0.5305164319248826,-113,0.5086331607010968,MIL,WSH,2022 REG,12,5,9,1,6,21,1,0,4,-4,1,0,0,0,0,0,0,0,0,0.4913668392989033,0.5086331607010968
86349,0.7142857142857143,0.3225806451612903,-250,210,0.6879526003949967,0.3120473996050033,away,PIT,over,7.5,0.5121951219512195,-105,0.48808156828023186,NYM,PIT,2022 REG,7,4,5,3,7,12,1,0,1,-1,1,1,1,0,0,0,0,0,0,0.48808156828023186,0.5119184317197681
86349,0.7142857142857143,0.3225806451612903,-250,210,0.6879526003949967,0.3120473996050033,home,NYM,under,7.5,0.5348837209302326,-115,0.5119184317197681,NYM,PIT,2022 REG,7,4,5,3,7,12,1,0,1,-1,1,1,1,0,0,0,0,0,0,0.48808156828023186,0.5119184317197681
86350,0.7590361445783133,0.2777777777777778,-315,260,0.7310930468863406,0.2689069531136594,away,CIN,over,8.5,0.5348837209302326,-115,0.5097020142727117,NYM,CIN,2022 REG,9,6,8,2,8,17,1,0,4,-4,1,1,0,0,0,0,0,0,0,0.5097020142727117,0.49029798572728833
86350,0.7590361445783133,0.2777777777777778,-315,260,0.7310930468863406,0.2689069531136594,home,NYM,under,8.5,0.5121951219512195,-105,0.49029798572728833,NYM,CIN,2022 REG,9,6,8,2,8,17,1,0,4,-4,1,1,0,0,0,0,0,0,0,0.5097020142727117,0.49029798572728833
86351,0.5633187772925764,0.47619047619047616,-129,110,0.5410624729287608,0.45893752707123925,away,SD,over,8,0.5121951219512195,-105,0.48919479393107135,ATL,SD,2022 REG,9,6,4,5,11,13,1,0,1,-1,1,1,1,1,1,0,0,0,0,0.48919479393107135,0.5108052060689287
86351,0.5633187772925764,0.47619047619047616,-129,110,0.5410624729287608,0.45893752707123925,home,ATL,under,8,0.5327102803738317,-114,0.5108052060689287,ATL,SD,2022 REG,9,6,4,5,11,13,1,0,1,-1,1,1,1,1,1,0,0,0,0,0.48919479393107135,0.5108052060689287
86352,0.6153846153846154,0.42016806722689076,-160,138,0.5935060414698423,0.4064939585301577,away,MIA,over,7.5,0.5283018867924528,-112,0.5031902949311281,HOU,MIA,2022 REG,11,4,7,7,11,18,0,1,-3,3,1,1,1,1,0,0,0,0,0,0.5031902949311281,0.4968097050688719
86352,0.6153846153846154,0.42016806722689076,-160,138,0.5935060414698423,0.4064939585301577,home,HOU,under,7.5,0.5192307692307692,-108,0.4968097050688719,HOU,MIA,2022 REG,11,4,7,7,11,18,0,1,-3,3,1,1,1,1,0,0,0,0,0,0.5031902949311281,0.4968097050688719
86353,0.4672897196261683,0.574468085106383,114,-135,0.4477767267604901,0.5522232732395099,away,NYY,over,9.5,0.5073891625615764,-103,0.4837652908580103,BOS,NYY,2022 REG,6,3,2,0,3,8,1,0,3,-3,0,0,0,0,0,0,0,0,0,0.4837652908580103,0.5162347091419897
86353,0.4672897196261683,0.574468085106383,114,-135,0.4477767267604901,0.5522232732395099,home,BOS,under,9.5,0.5391705069124424,-117,0.5162347091419897,BOS,NYY,2022 REG,6,3,2,0,3,8,1,0,3,-3,0,0,0,0,0,0,0,0,0,0.4837652908580103,0.5162347091419897
86354,0.4166666666666667,0.6183206106870228,140,-162,0.40208863443596277,0.5979113655640372,away,SF,over,11.5,0.5238095238095238,-110,0.4988662131519274,COL,SF,2022 REG,12,7,14,10,17,26,0,1,-3,3,1,1,1,1,1,1,1,0,0,0.4988662131519274,0.5011337868480725
86354,0.4166666666666667,0.6183206106870228,140,-162,0.40208863443596277,0.5979113655640372,home,COL,under,11.5,0.5238095238095238,-110,0.5011337868480725,COL,SF,2022 REG,12,7,14,10,17,26,0,1,-3,3,1,1,1,1,1,1,1,0,0,0.4988662131519274,0.5011337868480725
86355,0.4807692307692307,0.5555555555555556,108,-125,0.4633053911900066,0.5366946088099934,away,BOS,over,9,0.5238095238095238,-110,0.5012646084074657,DET,BOS,2022 REG,5,3,9,5,8,14,0,1,-2,2,1,1,1,0,0,0,0,0,0,0.5012646084074657,0.4987353915925343
86355,0.4807692307692307,0.5555555555555556,108,-125,0.4633053911900066,0.5366946088099934,home,DET,under,9,0.5192307692307692,-108,0.4987353915925343,DET,BOS,2022 REG,5,3,9,5,8,14,0,1,-2,2,1,1,1,0,0,0,0,0,0,0.5012646084074657,0.4987353915925343
86356,0.7014925373134329,0.33557046979865773,-235,198,0.6754931144139067,0.3245068855860933,away,SD,over,8.5,0.5391705069124424,-117,0.5127649394825569,LAD,SD,2022 REG,13,12,2,1,13,15,1,0,11,-11,1,0,0,0,0,0,0,0,0,0.5127649394825569,0.48723506051744314
86356,0.7014925373134329,0.33557046979865773,-235,198,0.6754931144139067,0.3245068855860933,home,LAD,under,8.5,0.5098039215686274,-104,0.48723506051744314,LAD,SD,2022 REG,13,12,2,1,13,15,1,0,11,-11,1,0,0,0,0,0,0,0,0,0.5127649394825569,0.48723506051744314
86358,0.6610169491525424,0.37735849056603776,-195,165,0.6356501330673793,0.3643498669326207,away,CHC,over,9,0.5098039215686274,-104,0.48483656587239576,STL,CHC,2022 REG,10,5,8,3,8,18,1,0,2,-2,1,1,1,0,0,0,0,0,0,0.48483656587239576,0.5151634341276042
86358,0.6610169491525424,0.37735849056603776,-195,165,0.6356501330673793,0.3643498669326207,home,STL,under,9,0.5391705069124424,-117,0.5151634341276042,STL,CHC,2022 REG,10,5,8,3,8,18,1,0,2,-2,1,1,1,0,0,0,0,0,0,0.48483656587239576,0.5151634341276042
86359,0.39370078740157477,0.647887323943662,154,-184,0.3773275152184107,0.6226724847815893,away,HOU,over,8,0.5283018867924528,-112,0.5031902949311281,CLE,HOU,2022 REG,3,0,11,6,6,14,0,1,-6,6,0,0,0,0,0,0,0,0,0,0.5031902949311281,0.4968097050688719
86359,0.39370078740157477,0.647887323943662,154,-184,0.3773275152184107,0.6226724847815893,home,CLE,under,8,0.5192307692307692,-108,0.4968097050688719,CLE,HOU,2022 REG,3,0,11,6,6,14,0,1,-6,6,0,0,0,0,0,0,0,0,0,0.5031902949311281,0.4968097050688719
86360,0.41152263374485604,0.6254681647940076,143,-167,0.39630008290581753,0.6036999170941825,away,HOU,over,7,0.49504950495049505,102,0.4739797934813417,OAK,HOU,2022 REG,6,5,7,3,8,13,1,0,2,-2,1,1,1,0,0,0,0,0,0,0.4739797934813417,0.5260202065186583
86360,0.41152263374485604,0.6254681647940076,143,-167,0.39630008290581753,0.6036999170941825,home,OAK,under,7,0.5475113122171946,-121,0.5260202065186583,OAK,HOU,2022 REG,6,5,7,3,8,13,1,0,2,-2,1,1,1,0,0,0,0,0,0,0.4739797934813417,0.5260202065186583
86361,0.5454545454545454,0.49504950495049505,-120,102,0.5233614270517961,0.4766385729482039,away,TOR,over,7.5,0.5348837209302326,-115,0.5097020142727117,NYY,TOR,2022 REG,6,4,5,2,6,11,1,0,2,-2,1,1,0,0,0,0,0,0,0,0.5097020142727117,0.49029798572728833
86361,0.5454545454545454,0.49504950495049505,-120,102,0.5233614270517961,0.4766385729482039,home,NYY,under,7.5,0.5121951219512195,-105,0.49029798572728833,NYY,TOR,2022 REG,6,4,5,2,6,11,1,0,2,-2,1,1,0,0,0,0,0,0,0,0.5097020142727117,0.49029798572728833
86362,0.5780590717299579,0.4608294930875576,-137,117,0.5555791840506346,0.44442081594936544,away,SF,over,6.5,0.5495495495495495,-122,0.5250401592387142,LAD,SF,2022 REG,5,3,6,1,4,11,1,0,2,-2,1,0,0,0,0,0,0,0,0,0.5250401592387142,0.47495984076128583
86362,0.5780590717299579,0.4608294930875576,-137,117,0.5555791840506346,0.44442081594936544,home,LAD,under,6.5,0.49504950495049505,102,0.47495984076128583,LAD,SF,2022 REG,5,3,6,1,4,11,1,0,2,-2,1,0,0,0,0,0,0,0,0,0.5250401592387142,0.47495984076128583
86363,0.7142857142857143,0.3278688524590164,-250,205,0.6841753094680495,0.3158246905319505,away,PIT,over,9,0.5121951219512195,-105,0.4903184724049234,ATL,PIT,2022 REG,7,5,7,3,8,14,1,0,2,-2,1,1,1,0,0,0,0,0,0,0.4903184724049234,0.5096815275950766
86363,0.7142857142857143,0.3278688524590164,-250,205,0.6841753094680495,0.3158246905319505,home,ATL,under,9,0.5305164319248826,-113,0.5096815275950766,ATL,PIT,2022 REG,7,5,7,3,8,14,1,0,2,-2,1,1,1,0,0,0,0,0,0,0.4903184724049234,0.5096815275950766
86364,0.6153846153846154,0.42372881355932196,-160,136,0.591314812957577,0.40868518704242296,away,DET,over,7,0.5391705069124424,-117,0.5127649394825569,SEA,DET,2022 REG,12,7,10,6,13,22,1,0,1,-1,1,1,1,1,1,1,0,0,0,0.5127649394825569,0.48723506051744314
86364,0.6153846153846154,0.42372881355932196,-160,136,0.591314812957577,0.40868518704242296,home,SEA,under,7,0.5098039215686274,-104,0.48723506051744314,SEA,DET,2022 REG,12,7,10,6,13,22,1,0,1,-1,1,1,1,1,1,1,0,0,0,0.5127649394825569,0.48723506051744314
86365,0.696969696969697,0.3424657534246575,-230,192,0.6694843830584802,0.33051561694151976,away,OAK,over,6.5,0.5535714285714286,-124,0.5266562689432208,SEA,OAK,2022 REG,7,5,2,1,6,9,1,0,4,-4,1,0,0,0,0,0,0,0,0,0.5266562689432208,0.4733437310567792
86365,0.696969696969697,0.3424657534246575,-230,192,0.6694843830584802,0.33051561694151976,home,SEA,under,6.5,0.49504950495049505,102,0.4733437310567792,SEA,OAK,2022 REG,7,5,2,1,6,9,1,0,4,-4,1,0,0,0,0,0,0,0,0,0.5266562689432208,0.4733437310567792
86366,0.3333333333333333,0.7058823529411764,200,-240,0.32026143790849676,0.6797385620915033,away,NYY,over,8.5,0.5260663507109005,-111,0.5022370601254724,BAL,NYY,2022 REG,10,6,11,3,9,21,1,0,3,-3,1,1,1,0,0,0,0,0,0,0.5022370601254724,0.4977629398745276
86366,0.3333333333333333,0.7058823529411764,200,-240,0.32026143790849676,0.6797385620915033,home,BAL,under,8.5,0.5192307692307692,-108,0.4977629398745276,BAL,NYY,2022 REG,10,6,11,3,9,21,1,0,3,-3,1,1,1,0,0,0,0,0,0,0.5022370601254724,0.4977629398745276
86367,0.4672897196261683,0.5689655172413793,114,-132,0.4503480201553517,0.5496519798446483,away,TOR,over,7.5,0.5283018867924528,-112,0.5044173060022736,SEA,TOR,2022 REG,3,2,5,1,3,8,1,0,1,-1,1,0,0,0,0,0,0,0,0,0.5044173060022736,0.49558269399772636
86367,0.4672897196261683,0.5689655172413793,114,-132,0.4503480201553517,0.5496519798446483,home,SEA,under,7.5,0.5169082125603864,-107,0.49558269399772636,SEA,TOR,2022 REG,3,2,5,1,3,8,1,0,1,-1,1,0,0,0,0,0,0,0,0,0.5044173060022736,0.49558269399772636
86368,0.613899613899614,0.42016806722689076,-159,138,0.5929854776095975,0.4070145223904025,away,SEA,over,8.5,0.5238095238095238,-110,0.4988662131519274,HOU,SEA,2022 REG,5,4,4,0,4,9,1,0,4,-4,0,0,0,0,0,0,0,0,0,0.4988662131519274,0.5011337868480725
86368,0.613899613899614,0.42016806722689076,-159,138,0.5929854776095975,0.4070145223904025,home,HOU,under,8.5,0.5238095238095238,-110,0.5011337868480725,HOU,SEA,2022 REG,5,4,4,0,4,9,1,0,4,-4,0,0,0,0,0,0,0,0,0,0.4988662131519274,0.5011337868480725
86369,0.6774193548387096,0.35714285714285715,-210,180,0.6540062434963579,0.34599375650364206,away,PIT,over,7,0.5475113122171946,-121,0.5214983313199976,STL,PIT,2022 REG,6,2,6,1,3,12,1,0,1,-1,1,0,0,0,0,0,0,0,0,0.5214983313199976,0.47850166868000243
86369,0.6774193548387096,0.35714285714285715,-210,180,0.6540062434963579,0.34599375650364206,home,STL,under,7,0.5,100,0.47850166868000243,STL,PIT,2022 REG,6,2,6,1,3,12,1,0,1,-1,1,0,0,0,0,0,0,0,0,0.5214983313199976,0.47850166868000243
86370,0.4716981132075471,0.5652173913043479,112,-130,0.4542851393811816,0.5457148606188185,away,TOR,over,7.5,0.5098039215686274,-104,0.4870219861770517,TB,TOR,2022 REG,6,3,5,0,3,11,1,0,3,-3,0,0,0,0,0,0,0,0,0,0.4870219861770517,0.5129780138229483
86370,0.4716981132075471,0.5652173913043479,112,-130,0.4542851393811816,0.5457148606188185,home,TB,under,7.5,0.5348837209302326,-115,0.5129780138229483,TB,TOR,2022 REG,6,3,5,0,3,11,1,0,3,-3,0,0,0,0,0,0,0,0,0,0.4870219861770517,0.5129780138229483
86371,0.6363636363636364,0.41152263374485604,-175,143,0.6058905553855048,0.39410944461449515,away,DET,over,8.5,0.5238095238095238,-110,0.4988662131519274,CWS,DET,2022 REG,11,8,6,0,8,17,1,0,8,-8,0,0,0,0,0,0,0,0,0,0.4988662131519274,0.5011337868480725
86371,0.6363636363636364,0.41152263374485604,-175,143,0.6058905553855048,0.39410944461449515,home,CWS,under,8.5,0.5238095238095238,-110,0.5011337868480725,CWS,DET,2022 REG,11,8,6,0,8,17,1,0,8,-8,0,0,0,0,0,0,0,0,0,0.4988662131519274,0.5011337868480725
86372,0.4854368932038835,0.5495495495495495,106,-122,0.4684531831294015,0.5315468168705986,away,MIN,over,7.5,0.5192307692307692,-108,0.49455035168025013,TEX,MIN,2022 REG,8,6,11,5,11,19,1,0,1,-1,1,1,1,1,1,0,0,0,0,0.49455035168025013,0.5054496483197499
86372,0.4854368932038835,0.5495495495495495,106,-122,0.4684531831294015,0.5315468168705986,home,TEX,under,7.5,0.5283018867924528,-112,0.5054496483197499,TEX,MIN,2022 REG,8,6,11,5,11,19,1,0,1,-1,1,1,1,1,1,0,0,0,0,0.49455035168025013,0.5054496483197499
86373,0.5348837209302326,0.5,-115,100,0.5162249864791779,0.4837750135208221,away,MIN,over,9.5,0.5073891625615764,-103,0.4837652908580103,MIL,MIN,2022 REG,11,7,7,6,13,18,1,0,1,-1,1,1,1,1,1,1,0,0,0,0.4837652908580103,0.5162347091419897
86373,0.5348837209302326,0.5,-115,100,0.5162249864791779,0.4837750135208221,home,MIL,under,9.5,0.5391705069124424,-117,0.5162347091419897,MIL,MIN,2022 REG,11,7,7,6,13,18,1,0,1,-1,1,1,1,1,1,1,0,0,0,0.4837652908580103,0.5162347091419897
86374,0.7014925373134329,0.3389830508474576,-235,195,0.6730992142751963,0.32690078572480374,away,BAL,over,8.5,0.5121951219512195,-105,0.48808156828023186,TB,BAL,2022 REG,8,5,8,3,8,16,1,0,2,-2,1,1,1,0,0,0,0,0,0,0.48808156828023186,0.5119184317197681
86374,0.7014925373134329,0.3389830508474576,-235,195,0.6730992142751963,0.32690078572480374,home,TB,under,8.5,0.5348837209302326,-115,0.5119184317197681,TB,BAL,2022 REG,8,5,8,3,8,16,1,0,2,-2,1,1,1,0,0,0,0,0,0,0.48808156828023186,0.5119184317197681
86375,0.6666666666666666,0.37037037037037035,-200,170,0.6419753086419753,0.3580246913580247,away,TEX,over,8.5,0.5192307692307692,-108,0.49455035168025013,HOU,TEX,2022 REG,10,5,6,1,6,16,1,0,4,-4,1,0,0,0,0,0,0,0,0,0.49455035168025013,0.5054496483197499
86375,0.6666666666666666,0.37037037037037035,-200,170,0.6419753086419753,0.3580246913580247,home,HOU,under,8.5,0.5283018867924528,-112,0.5054496483197499,HOU,TEX,2022 REG,10,5,6,1,6,16,1,0,4,-4,1,0,0,0,0,0,0,0,0,0.49455035168025013,0.5054496483197499
86376,0.5454545454545454,0.49504950495049505,-120,102,0.5233614270517961,0.4766385729482039,away,SF,over,8,0.5391705069124424,-117,0.5140669063204599,PHI,SF,2022 REG,10,6,5,5,11,15,1,0,1,-1,1,1,1,1,1,0,0,0,0,0.5140669063204599,0.4859330936795401
86376,0.5454545454545454,0.49504950495049505,-120,102,0.5233614270517961,0.4766385729482039,home,PHI,under,8,0.5073891625615764,-103,0.4859330936795401,PHI,SF,2022 REG,10,6,5,5,11,15,1,0,1,-1,1,1,1,1,1,0,0,0,0,0.5140669063204599,0.4859330936795401
86377,0.7701149425287357,0.26666666666666666,-335,275,0.741788875677104,0.25821112432289595,away,WSH,over,7.5,0.5327102803738317,-114,0.508788710910954,STL,WSH,2022 REG,9,6,10,5,11,19,1,0,1,-1,1,1,1,1,1,0,0,0,0,0.508788710910954,0.491211289089046
86377,0.7701149425287357,0.26666666666666666,-335,275,0.741788875677104,0.25821112432289595,home,STL,under,7.5,0.5121951219512195,-105,0.491211289089046,STL,WSH,2022 REG,9,6,10,5,11,19,1,0,1,-1,1,1,1,1,1,0,0,0,0,0.508788710910954,0.491211289089046
86378,0.6183206106870228,0.42372881355932196,-162,136,0.5923205850079852,0.40767941499201477,away,PHI,over,7,0.5121951219512195,-105,0.48808156828023186,SD,PHI,2022 REG,7,2,8,6,8,15,0,1,-4,4,1,1,0,0,0,0,0,0,0,0.48808156828023186,0.5119184317197681
86378,0.6183206106870228,0.42372881355932196,-162,136,0.5923205850079852,0.40767941499201477,home,SD,under,7,0.5348837209302326,-115,0.5119184317197681,SD,PHI,2022 REG,7,2,8,6,8,15,0,1,-4,4,1,1,0,0,0,0,0,0,0,0.48808156828023186,0.5119184317197681
86379,0.5850622406639003,0.4484304932735426,-141,123,0.5654669067005001,0.43453309329949985,away,WSH,over,7,0.5192307692307692,-108,0.49455035168025013,MIA,WSH,2022 REG,9,5,8,2,7,17,1,0,3,-3,1,1,0,0,0,0,0,0,0,0.49455035168025013,0.5054496483197499
86379,0.5850622406639003,0.4484304932735426,-141,123,0.5654669067005001,0.43453309329949985,home,MIA,under,7,0.5283018867924528,-112,0.5054496483197499,MIA,WSH,2022 REG,9,5,8,2,7,17,1,0,3,-3,1,1,0,0,0,0,0,0,0,0.49455035168025013,0.5054496483197499
86380,0.5535714285714286,0.48780487804878053,-124,105,0.53066668740667,0.46933331259333,away,NYM,over,10,0.5098039215686274,-104,0.48592421718142587,PHI,NYM,2022 REG,14,9,16,10,19,30,0,1,-1,1,1,1,1,1,1,1,1,1,1,0.48592421718142587,0.5140757828185741
86380,0.5535714285714286,0.48780487804878053,-124,105,0.53066668740667,0.46933331259333,home,PHI,under,10,0.5370370370370371,-116,0.5140757828185741,PHI,NYM,2022 REG,14,9,16,10,19,30,0,1,-1,1,1,1,1,1,1,1,1,1,1,0.48592421718142587,0.5140757828185741
86381,0.49504950495049505,0.5454545454545454,102,-120,0.47499799484898986,0.5250020051510101,away,HOU,over,8,0.5348837209302326,-115,0.5097020142727117,LAA,HOU,2022 REG,6,2,2,0,2,8,1,0,2,-2,0,0,0,0,0,0,0,0,0,0.5097020142727117,0.49029798572728833
86381,0.49504950495049505,0.5454545454545454,102,-120,0.47499799484898986,0.5250020051510101,home,LAA,under,8,0.5121951219512195,-105,0.49029798572728833,LAA,HOU,2022 REG,6,2,2,0,2,8,1,0,2,-2,0,0,0,0,0,0,0,0,0,0.5097020142727117,0.49029798572728833
86382,0.6153846153846154,0.425531914893617,-160,135,0.5902052121364724,0.40979478786352763,away,CHC,over,7,0.5,100,0.4772727272727273,MIA,CHC,2022 REG,9,1,6,2,3,15,0,1,-1,1,1,0,0,0,0,0,0,0,0,0.4772727272727273,0.5227272727272727
86382,0.6153846153846154,0.425531914893617,-160,135,0.5902052121364724,0.40979478786352763,home,MIA,under,7,0.5454545454545454,-120,0.5227272727272727,MIA,CHC,2022 REG,9,1,6,2,3,15,0,1,-1,1,1,0,0,0,0,0,0,0,0,0.4772727272727273,0.5227272727272727
86383,0.6389891696750902,0.4,-177,150,0.614075512518083,0.385924487481917,away,KC,over,9,0.5495495495495495,-122,0.5250401592387142,CWS,KC,2022 REG,10,1,6,2,3,16,0,1,-1,1,1,0,0,0,0,0,0,0,0,0.5250401592387142,0.47495984076128583
86383,0.6389891696750902,0.4,-177,150,0.614075512518083,0.385924487481917,home,CWS,under,9,0.49504950495049505,102,0.47495984076128583,CWS,KC,2022 REG,10,1,6,2,3,16,0,1,-1,1,1,0,0,0,0,0,0,0,0,0.5250401592387142,0.47495984076128583
86384,0.3968253968253968,0.6428571428571428,152,-180,0.3810783572688335,0.6189216427311666,away,CWS,over,8,0.5073891625615764,-103,0.4837652908580103,DET,CWS,2022 REG,9,1,12,5,6,21,0,1,-4,4,1,0,0,0,0,0,0,0,0,0.4837652908580103,0.5162347091419897
86384,0.3968253968253968,0.6428571428571428,152,-180,0.3810783572688335,0.6189216427311666,home,DET,under,8,0.5391705069124424,-117,0.5162347091419897,DET,CWS,2022 REG,9,1,12,5,6,21,0,1,-4,4,1,0,0,0,0,0,0,0,0,0.4837652908580103,0.5162347091419897
86385,0.6363636363636364,0.40322580645161293,-175,148,0.6111703545721141,0.3888296454278859,away,KC,over,8.5,0.5348837209302326,-115,0.5097020142727117,MIN,KC,2022 REG,8,3,6,2,5,14,1,0,1,-1,1,1,0,0,0,0,0,0,0,0.5097020142727117,0.49029798572728833
86385,0.6363636363636364,0.40322580645161293,-175,148,0.6111703545721141,0.3888296454278859,home,MIN,under,8.5,0.5121951219512195,-105,0.49029798572728833,MIN,KC,2022 REG,8,3,6,2,5,14,1,0,1,-1,1,1,0,0,0,0,0,0,0,0.5097020142727117,0.49029798572728833
86386,0.7354497354497355,0.29850746268656714,-278,235,0.7104759230637776,0.2895240769362224,away,BAL,over,8.5,0.5238095238095238,-110,0.4988662131519274,TOR,BAL,2022 REG,19,11,5,1,12,24,1,0,10,-10,1,0,0,0,0,0,0,0,0,0.4988662131519274,0.5011337868480725
86386,0.7354497354497355,0.29850746268656714,-278,235,0.7104759230637776,0.2895240769362224,home,TOR,under,8.5,0.5238095238095238,-110,0.5011337868480725,TOR,BAL,2022 REG,19,11,5,1,12,24,1,0,10,-10,1,0,0,0,0,0,0,0,0,0.4988662131519274,0.5011337868480725
86387,0.607843137254902,0.43103448275862066,-155,132,0.5842116427368785,0.41578835726312147,away,MIA,over,7.5,0.5145631067961165,-106,0.49023796582517226,NYM,MIA,2022 REG,9,10,10,4,14,19,1,0,6,-6,1,1,1,1,0,0,0,0,0,0.49023796582517226,0.5097620341748277
86387,0.607843137254902,0.43103448275862066,-155,132,0.5842116427368785,0.41578835726312147,home,NYM,under,7.5,0.5327102803738317,-114,0.5097620341748277,NYM,MIA,2022 REG,9,10,10,4,14,19,1,0,6,-6,1,1,1,1,0,0,0,0,0,0.49023796582517226,0.5097620341748277
86388,0.6875,0.3472222222222222,-220,188,0.6636284722222221,0.3363715277777779,away,DET,over,9,0.5073891625615764,-103,0.4837652908580103,LAA,DET,2022 REG,11,4,13,5,9,24,0,1,-1,1,1,1,1,1,0,0,0,0,0,0.4837652908580103,0.5162347091419897
86388,0.6875,0.3472222222222222,-220,188,0.6636284722222221,0.3363715277777779,home,LAA,under,9,0.5391705069124424,-117,0.5162347091419897,LAA,DET,2022 REG,11,4,13,5,9,24,0,1,-1,1,1,1,1,1,0,0,0,0,0,0.4837652908580103,0.5162347091419897
86389,0.7530864197530864,0.2777777777777778,-305,260,0.7298430117360157,0.27015698826398427,away,TEX,over,7.5,0.5,100,0.47935779816513757,HOU,TEX,2022 REG,8,4,12,8,12,20,0,1,-4,4,1,1,1,1,0,0,0,0,0,0.47935779816513757,0.5206422018348624
86389,0.7530864197530864,0.2777777777777778,-305,260,0.7298430117360157,0.27015698826398427,home,HOU,under,7.5,0.5412844036697247,-118,0.5206422018348624,HOU,TEX,2022 REG,8,4,12,8,12,20,0,1,-4,4,1,1,1,1,0,0,0,0,0,0.47935779816513757,0.5206422018348624
86390,0.5535714285714286,0.48780487804878053,-124,105,0.53066668740667,0.46933331259333,away,MIN,over,7.5,0.5305164319248826,-113,0.5066009958897986,CWS,MIN,2022 REG,8,1,10,10,11,18,0,1,-9,9,1,0,0,0,0,0,0,0,0,0.5066009958897986,0.49339900411020143
86390,0.5535714285714286,0.48780487804878053,-124,105,0.53066668740667,0.46933331259333,home,CWS,under,7.5,0.5145631067961165,-106,0.49339900411020143,CWS,MIN,2022 REG,8,1,10,10,11,18,0,1,-9,9,1,0,0,0,0,0,0,0,0,0.5066009958897986,0.49339900411020143
86391,0.6254681647940076,0.4081632653061224,-167,145,0.6044327759298813,0.3955672240701187,away,ARI,over,7.5,0.5238095238095238,-110,0.4988662131519274,SD,ARI,2022 REG,16,10,8,4,14,24,1,0,6,-6,1,1,1,1,0,0,0,0,0,0.4988662131519274,0.5011337868480725
86391,0.6254681647940076,0.4081632653061224,-167,145,0.6044327759298813,0.3955672240701187,home,SD,under,7.5,0.5238095238095238,-110,0.5011337868480725,SD,ARI,2022 REG,16,10,8,4,14,24,1,0,6,-6,1,1,1,1,0,0,0,0,0,0.4988662131519274,0.5011337868480725
86392,0.46511627906976744,0.576271186440678,115,-136,0.44586629511142073,0.5541337048885793,away,MIN,over,7.5,0.5,100,0.47935779816513757,BAL,MIN,2022 REG,12,9,8,4,13,20,1,0,5,-5,1,1,1,1,0,0,0,0,0,0.47935779816513757,0.5206422018348624
86392,0.46511627906976744,0.576271186440678,115,-136,0.44586629511142073,0.5541337048885793,home,BAL,under,7.5,0.5412844036697247,-118,0.5206422018348624,BAL,MIN,2022 REG,12,9,8,4,13,20,1,0,5,-5,1,1,1,1,0,0,0,0,0,0.47935779816513757,0.5206422018348624
86393,0.5238095238095238,0.5145631067961165,-110,-106,0.5037095744446646,0.4962904255553354,away,TB,over,8.5,0.5098039215686274,-104,0.4870219861770517,CWS,TB,2022 REG,3,3,12,9,12,15,0,1,-6,6,1,1,1,0,0,0,0,0,0,0.4870219861770517,0.5129780138229483
86393,0.5238095238095238,0.5145631067961165,-110,-106,0.5037095744446646,0.4962904255553354,home,CWS,under,8.5,0.5348837209302326,-115,0.5129780138229483,CWS,TB,2022 REG,3,3,12,9,12,15,0,1,-6,6,1,1,1,0,0,0,0,0,0,0.4870219861770517,0.5129780138229483
86394,0.4166666666666667,0.6226415094339623,140,-165,0.4002882599580712,0.5997117400419287,away,HOU,over,7,0.5145631067961165,-106,0.49023796582517226,SEA,HOU,2022 REG,4,1,7,3,4,11,0,1,-2,2,1,0,0,0,0,0,0,0,0,0.49023796582517226,0.5097620341748277
86394,0.4166666666666667,0.6226415094339623,140,-165,0.4002882599580712,0.5997117400419287,home,SEA,under,7,0.5327102803738317,-114,0.5097620341748277,SEA,HOU,2022 REG,4,1,7,3,4,11,0,1,-2,2,1,0,0,0,0,0,0,0,0,0.49023796582517226,0.5097620341748277
86395,0.6503496503496503,0.38759689922480617,-186,158,0.6256711251019269,0.3743288748980731,away,SD,over,7,0.5192307692307692,-108,0.49455035168025013,NYM,SD,2022 REG,4,1,8,4,5,12,0,1,-3,3,1,0,0,0,0,0,0,0,0,0.49455035168025013,0.5054496483197499
86395,0.6503496503496503,0.38759689922480617,-186,158,0.6256711251019269,0.3743288748980731,home,NYM,under,7,0.5283018867924528,-112,0.5054496483197499,NYM,SD,2022 REG,4,1,8,4,5,12,0,1,-3,3,1,0,0,0,0,0,0,0,0,0.49455035168025013,0.5054496483197499
86396,0.574468085106383,0.46511627906976744,-135,115,0.5517281312179562,0.44827186878204384,away,CHC,over,9,0.5348837209302326,-115,0.5097020142727117,PHI,CHC,2022 REG,6,2,19,15,17,25,0,1,-13,13,1,1,0,0,0,0,0,0,0,0.5097020142727117,0.49029798572728833
86396,0.574468085106383,0.46511627906976744,-135,115,0.5517281312179562,0.44827186878204384,home,PHI,under,9,0.5121951219512195,-105,0.49029798572728833,PHI,CHC,2022 REG,6,2,19,15,17,25,0,1,-13,13,1,1,0,0,0,0,0,0,0,0.5097020142727117,0.49029798572728833
86397,0.4504504504504505,0.5884773662551441,122,-143,0.4329153978803628,0.5670846021196372,away,BOS,over,8,0.5121951219512195,-105,0.48808156828023186,PIT,BOS,2022 REG,4,3,5,5,8,9,0,1,-2,2,1,1,1,0,0,0,0,0,0,0.48808156828023186,0.5119184317197681
86397,0.4504504504504505,0.5884773662551441,122,-143,0.4329153978803628,0.5670846021196372,home,PIT,under,8,0.5348837209302326,-115,0.5119184317197681,PIT,BOS,2022 REG,4,3,5,5,8,9,0,1,-2,2,1,1,1,0,0,0,0,0,0,0.48808156828023186,0.5119184317197681
86398,0.5884773662551441,0.4484304932735426,-143,123,0.5667579262855877,0.43324207371441226,away,NYY,over,7.5,0.5121951219512195,-105,0.48808156828023186,MIL,NYY,2022 REG,4,4,5,1,5,9,1,0,3,-3,1,0,0,0,0,0,0,0,0,0.48808156828023186,0.5119184317197681
86398,0.5884773662551441,0.4484304932735426,-143,123,0.5667579262855877,0.43324207371441226,home,MIL,under,7.5,0.5348837209302326,-115,0.5119184317197681,MIL,NYY,2022 REG,4,4,5,1,5,9,1,0,3,-3,1,0,0,0,0,0,0,0,0,0.48808156828023186,0.5119184317197681
86399,0.4166666666666667,0.6226415094339623,140,-165,0.4002882599580712,0.5997117400419287,away,STL,over,7.5,0.5238095238095238,-110,0.5000596729920038,PIT,STL,2022 REG,7,3,7,4,7,14,0,1,-1,1,1,1,1,0,0,0,0,0,0,0.5000596729920038,0.4999403270079962
86399,0.4166666666666667,0.6226415094339623,140,-165,0.4002882599580712,0.5997117400419287,home,PIT,under,7.5,0.5215311004784688,-109,0.4999403270079962,PIT,STL,2022 REG,7,3,7,4,7,14,0,1,-1,1,1,1,1,0,0,0,0,0,0,0.5000596729920038,0.4999403270079962
86400,0.6551724137931035,0.38167938931297707,-190,162,0.6310281289994645,0.3689718710005355,away,TOR,over,8,0.5121951219512195,-105,0.48808156828023186,NYY,TOR,2022 REG,9,2,7,5,7,16,0,1,-3,3,1,1,0,0,0,0,0,0,0,0.48808156828023186,0.5119184317197681
86400,0.6551724137931035,0.38167938931297707,-190,162,0.6310281289994645,0.3689718710005355,home,NYY,under,8,0.5348837209302326,-115,0.5119184317197681,NYY,TOR,2022 REG,9,2,7,5,7,16,0,1,-3,3,1,1,0,0,0,0,0,0,0,0.48808156828023186,0.5119184317197681
86401,0.5633187772925764,0.47619047619047616,-129,110,0.5410624729287608,0.45893752707123925,away,SD,over,7,0.5391705069124424,-117,0.5140669063204599,SF,SD,2022 REG,4,2,5,1,3,9,1,0,1,-1,1,0,0,0,0,0,0,0,0,0.5140669063204599,0.4859330936795401
86401,0.5633187772925764,0.47619047619047616,-129,110,0.5410624729287608,0.45893752707123925,home,SF,under,7,0.5073891625615764,-103,0.4859330936795401,SF,SD,2022 REG,4,2,5,1,3,9,1,0,1,-1,1,0,0,0,0,0,0,0,0,0.5140669063204599,0.4859330936795401
86402,0.5121951219512195,0.5327102803738317,-105,-114,0.48919479393107135,0.5108052060689287,away,MIN,over,7.5,0.5370370370370371,-116,0.5118817074154765,KC,MIN,2022 REG,8,6,12,7,13,20,0,1,-1,1,1,1,1,1,1,1,0,0,0,0.5118817074154765,0.48811829258452355
86402,0.5121951219512195,0.5327102803738317,-105,-114,0.48919479393107135,0.5108052060689287,home,KC,under,7.5,0.5098039215686274,-104,0.48811829258452355,KC,MIN,2022 REG,8,6,12,7,13,20,0,1,-1,1,1,1,1,1,1,1,0,0,0,0.5118817074154765,0.48811829258452355
86403,0.4672897196261683,0.5689655172413793,114,-132,0.4503480201553517,0.5496519798446483,away,PHI,over,7.5,0.5121951219512195,-105,0.48919479393107135,MIA,PHI,2022 REG,8,1,8,6,7,16,0,1,-5,5,1,0,0,0,0,0,0,0,0,0.48919479393107135,0.5108052060689287
86403,0.4672897196261683,0.5689655172413793,114,-132,0.4503480201553517,0.5496519798446483,home,MIA,under,7.5,0.5327102803738317,-114,0.5108052060689287,MIA,PHI,2022 REG,8,1,8,6,7,16,0,1,-5,5,1,0,0,0,0,0,0,0,0,0.48919479393107135,0.5108052060689287
86404,0.4716981132075471,0.5652173913043479,112,-130,0.4542851393811816,0.5457148606188185,away,CWS,over,9,0.5283018867924528,-112,0.5044173060022736,KC,CWS,2022 REG,6,3,10,5,8,16,0,1,-2,2,1,1,1,0,0,0,0,0,0,0.5044173060022736,0.49558269399772636
86404,0.4716981132075471,0.5652173913043479,112,-130,0.4542851393811816,0.5457148606188185,home,KC,under,9,0.5169082125603864,-107,0.49558269399772636,KC,CWS,2022 REG,6,3,10,5,8,16,0,1,-2,2,1,1,1,0,0,0,0,0,0,0.5044173060022736,0.49558269399772636
86405,0.3846153846153846,0.6598639455782314,160,-194,0.3675079499255323,0.6324920500744677,away,SD,over,11,0.5192307692307692,-108,0.49455035168025013,CHC,SD,2022 REG,7,4,11,6,10,18,0,1,-2,2,1,1,1,1,0,0,0,0,0,0.49455035168025013,0.5054496483197499
86405,0.3846153846153846,0.6598639455782314,160,-194,0.3675079499255323,0.6324920500744677,home,CHC,under,11,0.5283018867924528,-112,0.5054496483197499,CHC,SD,2022 REG,7,4,11,6,10,18,0,1,-2,2,1,1,1,1,0,0,0,0,0,0.49455035168025013,0.5054496483197499
86406,0.6226415094339623,0.4166666666666667,-165,140,0.5981666073335706,0.40183339266642937,away,CHC,over,7.5,0.5283018867924528,-112,0.5031902949311281,MIL,CHC,2022 REG,12,9,6,1,10,18,1,0,8,-8,1,0,0,0,0,0,0,0,0,0.5031902949311281,0.4968097050688719
86406,0.6226415094339623,0.4166666666666667,-165,140,0.5981666073335706,0.40183339266642937,home,MIL,under,7.5,0.5192307692307692,-108,0.4968097050688719,MIL,CHC,2022 REG,12,9,6,1,10,18,1,0,8,-8,1,0,0,0,0,0,0,0,0,0.5031902949311281,0.4968097050688719
86407,0.5454545454545454,0.49504950495049505,-120,102,0.5233614270517961,0.4766385729482039,away,TEX,over,9,0.5121951219512195,-105,0.48808156828023186,LAA,TEX,2022 REG,14,8,4,3,11,18,1,0,5,-5,1,1,1,0,0,0,0,0,0,0.48808156828023186,0.5119184317197681
86407,0.5454545454545454,0.49504950495049505,-120,102,0.5233614270517961,0.4766385729482039,home,LAA,under,9,0.5348837209302326,-115,0.5119184317197681,LAA,TEX,2022 REG,14,8,4,3,11,18,1,0,5,-5,1,1,1,0,0,0,0,0,0,0.48808156828023186,0.5119184317197681
86408,0.6875,0.35714285714285715,-220,180,0.6568080357142857,0.3431919642857143,away,OAK,over,8.5,0.5215311004784688,-109,0.4978845547971712,TB,OAK,2022 REG,13,9,8,8,17,21,1,0,1,-1,1,1,1,1,1,1,1,1,0,0.4978845547971712,0.5021154452028288
86408,0.6875,0.35714285714285715,-220,180,0.6568080357142857,0.3431919642857143,home,TB,under,8.5,0.5238095238095238,-110,0.5021154452028288,TB,OAK,2022 REG,13,9,8,8,17,21,1,0,1,-1,1,1,1,1,1,1,1,1,0,0.4978845547971712,0.5021154452028288
86409,0.5454545454545454,0.49504950495049505,-120,102,0.5233614270517961,0.4766385729482039,away,SF,over,7.5,0.5121951219512195,-105,0.48919479393107135,ARI,SF,2022 REG,7,5,4,2,7,11,1,0,3,-3,1,1,0,0,0,0,0,0,0,0.48919479393107135,0.5108052060689287
86409,0.5454545454545454,0.49504950495049505,-120,102,0.5233614270517961,0.4766385729482039,home,ARI,under,7.5,0.5327102803738317,-114,0.5108052060689287,ARI,SF,2022 REG,7,5,4,2,7,11,1,0,3,-3,1,1,0,0,0,0,0,0,0,0.48919479393107135,0.5108052060689287
86410,0.49504950495049505,0.5454545454545454,102,-120,0.47499799484898986,0.5250020051510101,away,CWS,over,8,0.5391705069124424,-117,0.5140669063204599,MIN,CWS,2022 REG,1,0,16,11,11,17,0,1,-11,11,0,0,0,0,0,0,0,0,0,0.5140669063204599,0.4859330936795401
86410,0.49504950495049505,0.5454545454545454,102,-120,0.47499799484898986,0.5250020051510101,home,MIN,under,8,0.5073891625615764,-103,0.4859330936795401,MIN,CWS,2022 REG,1,0,16,11,11,17,0,1,-11,11,0,0,0,0,0,0,0,0,0,0.5140669063204599,0.4859330936795401
86411,0.4854368932038835,0.5495495495495495,106,-122,0.4684531831294015,0.5315468168705986,away,TB,over,7,0.5192307692307692,-108,0.49571111079951763,SEA,TB,2022 REG,6,2,10,8,10,16,0,1,-6,6,1,1,0,0,0,0,0,0,0,0.49571111079951763,0.5042888892004824
86411,0.4854368932038835,0.5495495495495495,106,-122,0.4684531831294015,0.5315468168705986,home,SEA,under,7,0.5260663507109005,-111,0.5042888892004824,SEA,TB,2022 REG,6,2,10,8,10,16,0,1,-6,6,1,1,0,0,0,0,0,0,0,0.49571111079951763,0.5042888892004824
86412,0.7916666666666667,0.2531645569620253,-380,295,0.7561752812939522,0.24382471870604783,away,COL,over,8.5,0.5121951219512195,-105,0.4837303301198733,ATL,COL,2022 REG,7,2,11,3,5,18,0,1,-1,1,1,1,0,0,0,0,0,0,0,0.4837303301198733,0.5162696698801267
86412,0.7916666666666667,0.2531645569620253,-380,295,0.7561752812939522,0.24382471870604783,home,ATL,under,8.5,0.5433789954337899,-119,0.5162696698801267,ATL,COL,2022 REG,7,2,11,3,5,18,0,1,-1,1,1,1,0,0,0,0,0,0,0,0.4837303301198733,0.5162696698801267
86413,0.42016806722689076,0.6183206106870228,138,-162,0.4039963538176834,0.5960036461823166,away,ATL,over,9,0.5121951219512195,-105,0.48808156828023186,CHC,ATL,2022 REG,6,0,9,6,6,15,0,1,-6,6,0,0,0,0,0,0,0,0,0,0.48808156828023186,0.5119184317197681
86413,0.42016806722689076,0.6183206106870228,138,-162,0.4039963538176834,0.5960036461823166,home,CHC,under,9,0.5348837209302326,-115,0.5119184317197681,CHC,ATL,2022 REG,6,0,9,6,6,15,0,1,-6,6,0,0,0,0,0,0,0,0,0,0.48808156828023186,0.5119184317197681
86414,0.5918367346938775,0.4464285714285714,-145,124,0.5691899208663057,0.4308100791336943,away,TOR,over,7.5,0.5,100,0.4772727272727273,TB,TOR,2022 REG,11,10,8,6,16,19,1,0,4,-4,1,1,1,1,1,1,0,0,0,0.4772727272727273,0.5227272727272727
86414,0.5918367346938775,0.4464285714285714,-145,124,0.5691899208663057,0.4308100791336943,home,TB,under,7.5,0.5454545454545454,-120,0.5227272727272727,TB,TOR,2022 REG,11,10,8,6,16,19,1,0,4,-4,1,1,1,1,1,1,0,0,0,0.4772727272727273,0.5227272727272727
86415,0.5454545454545454,0.5,-120,100,0.5206611570247933,0.4793388429752067,away,MIL,over,8,0.5412844036697247,-118,0.5175913212324037,ATL,MIL,2022 REG,10,9,4,2,11,14,1,0,7,-7,1,1,0,0,0,0,0,0,0,0.5175913212324037,0.4824086787675963
86415,0.5454545454545454,0.5,-120,100,0.5206611570247933,0.4793388429752067,home,ATL,under,8,0.5024875621890548,-101,0.4824086787675963,ATL,MIL,2022 REG,10,9,4,2,11,14,1,0,7,-7,1,1,0,0,0,0,0,0,0,0.5175913212324037,0.4824086787675963
86416,0.4,0.6389891696750902,150,-177,0.3844043321299639,0.6155956678700361,away,SF,over,9,0.5260663507109005,-111,0.5022370601254724,CIN,SF,2022 REG,5,3,12,2,5,17,1,0,1,-1,1,1,0,0,0,0,0,0,0,0.5022370601254724,0.4977629398745276
86416,0.4,0.6389891696750902,150,-177,0.3844043321299639,0.6155956678700361,home,CIN,under,9,0.5192307692307692,-108,0.4977629398745276,CIN,SF,2022 REG,5,3,12,2,5,17,1,0,1,-1,1,1,0,0,0,0,0,0,0,0.5022370601254724,0.4977629398745276
86417,0.5726495726495727,0.46511627906976744,-134,115,0.5510229738017454,0.44897702619825464,away,CIN,over,8.5,0.5169082125603864,-107,0.49353874091423283,PIT,CIN,2022 REG,0,1,4,0,1,4,1,0,1,-1,0,0,0,0,0,0,0,0,0,0.49353874091423283,0.5064612590857671
86417,0.5726495726495727,0.46511627906976744,-134,115,0.5510229738017454,0.44897702619825464,home,PIT,under,8.5,0.5283018867924528,-112,0.5064612590857671,PIT,CIN,2022 REG,0,1,4,0,1,4,1,0,1,-1,0,0,0,0,0,0,0,0,0,0.49353874091423283,0.5064612590857671
86418,0.6000000000000001,0.4347826086956522,-150,130,0.5791304347826086,0.4208695652173914,away,BOS,over,8,0.5327102803738317,-114,0.508788710910954,NYY,BOS,2022 REG,9,5,8,4,9,17,1,0,1,-1,1,1,1,1,0,0,0,0,0,0.508788710910954,0.491211289089046
86418,0.6000000000000001,0.4347826086956522,-150,130,0.5791304347826086,0.4208695652173914,home,NYY,under,8,0.5121951219512195,-105,0.491211289089046,NYY,BOS,2022 REG,9,5,8,4,9,17,1,0,1,-1,1,1,1,1,0,0,0,0,0,0.508788710910954,0.491211289089046
86419,0.5815899581589958,0.4587155963302753,-139,118,0.5581486524100054,0.44185134758999456,away,NYM,over,7.5,0.5348837209302326,-115,0.5097020142727117,SF,NYM,2022 REG,7,3,18,13,16,25,0,1,-10,10,1,1,1,0,0,0,0,0,0,0.5097020142727117,0.49029798572728833
86419,0.5815899581589958,0.4587155963302753,-139,118,0.5581486524100054,0.44185134758999456,home,SF,under,7.5,0.5121951219512195,-105,0.49029798572728833,SF,NYM,2022 REG,7,3,18,13,16,25,0,1,-10,10,1,1,1,0,0,0,0,0,0,0.5097020142727117,0.49029798572728833
86420,0.425531914893617,0.6153846153846154,135,-160,0.4081206254135181,0.5918793745864819,away,ATL,over,7,0.5454545454545454,-120,0.5206611570247933,MIA,ATL,2022 REG,9,4,4,0,4,13,1,0,4,-4,0,0,0,0,0,0,0,0,0,0.5206611570247933,0.4793388429752067
86420,0.425531914893617,0.6153846153846154,135,-160,0.4081206254135181,0.5918793745864819,home,MIA,under,7,0.5,100,0.4793388429752067,MIA,ATL,2022 REG,9,4,4,0,4,13,1,0,4,-4,0,0,0,0,0,0,0,0,0,0.5206611570247933,0.4793388429752067
86421,0.5652173913043479,0.4672897196261683,-130,114,0.5468438068653605,0.4531561931346395,away,COL,over,8.5,0.5454545454545454,-120,0.5206611570247933,CHC,COL,2022 REG,7,2,4,1,3,11,1,0,1,-1,1,0,0,0,0,0,0,0,0,0.5206611570247933,0.4793388429752067
86421,0.5652173913043479,0.4672897196261683,-130,114,0.5468438068653605,0.4531561931346395,home,CHC,under,8.5,0.5,100,0.4793388429752067,CHC,COL,2022 REG,7,2,4,1,3,11,1,0,1,-1,1,0,0,0,0,0,0,0,0,0.5206611570247933,0.4793388429752067
86422,0.5412844036697247,0.5,-118,100,0.5189377998484975,0.4810622001515025,away,STL,over,9,0.5215311004784688,-109,0.4978845547971712,MIL,STL,2022 REG,7,4,7,5,9,14,0,1,-1,1,1,1,1,1,0,0,0,0,0,0.4978845547971712,0.5021154452028288
86422,0.5412844036697247,0.5,-118,100,0.5189377998484975,0.4810622001515025,home,MIL,under,9,0.5238095238095238,-110,0.5021154452028288,MIL,STL,2022 REG,7,4,7,5,9,14,0,1,-1,1,1,1,1,1,0,0,0,0,0,0.4978845547971712,0.5021154452028288
86423,0.3448275862068966,0.696969696969697,190,-230,0.3304147299391057,0.6695852700608943,away,HOU,over,8,0.5238095238095238,-110,0.5000596729920038,OAK,HOU,2022 REG,10,7,7,5,12,17,1,0,2,-2,1,1,1,1,1,0,0,0,0,0.5000596729920038,0.4999403270079962
86423,0.3448275862068966,0.696969696969697,190,-230,0.3304147299391057,0.6695852700608943,home,OAK,under,8,0.5215311004784688,-109,0.4999403270079962,OAK,HOU,2022 REG,10,7,7,5,12,17,1,0,2,-2,1,1,1,1,1,0,0,0,0,0.5000596729920038,0.4999403270079962
86424,0.576271186440678,0.4629629629629629,-136,116,0.553661676614851,0.446338323385149,away,CHC,over,11.5,0.5305164319248826,-113,0.5066009958897986,COL,CHC,2022 REG,11,9,13,6,15,24,1,0,3,-3,1,1,1,1,1,1,0,0,0,0.5066009958897986,0.49339900411020143
86424,0.576271186440678,0.4629629629629629,-136,116,0.553661676614851,0.446338323385149,home,COL,under,11.5,0.5145631067961165,-106,0.49339900411020143,COL,CHC,2022 REG,11,9,13,6,15,24,1,0,3,-3,1,1,1,1,1,1,0,0,0,0.5066009958897986,0.49339900411020143
86425,0.5454545454545454,0.49504950495049505,-120,102,0.5233614270517961,0.4766385729482039,away,ATL,over,8,0.5370370370370371,-116,0.5131785224377817,NYM,ATL,2022 REG,9,6,7,4,10,16,1,0,2,-2,1,1,1,1,0,0,0,0,0,0.5131785224377817,0.4868214775622183
86425,0.5454545454545454,0.49504950495049505,-120,102,0.5233614270517961,0.4766385729482039,home,NYM,under,8,0.5073891625615764,-103,0.4868214775622183,NYM,ATL,2022 REG,9,6,7,4,10,16,1,0,2,-2,1,1,1,1,0,0,0,0,0,0.5131785224377817,0.4868214775622183
86426,0.4444444444444444,0.5967741935483871,125,-148,0.42612504978096366,0.5738749502190363,away,SF,over,7,0.5283018867924528,-112,0.5044173060022736,STL,SF,2022 REG,17,15,7,6,21,24,1,0,9,-9,1,1,1,1,1,1,0,0,0,0.5044173060022736,0.49558269399772636
86426,0.4444444444444444,0.5967741935483871,125,-148,0.42612504978096366,0.5738749502190363,home,STL,under,7,0.5169082125603864,-107,0.49558269399772636,STL,SF,2022 REG,17,15,7,6,21,24,1,0,9,-9,1,1,1,1,1,1,0,0,0,0.5044173060022736,0.49558269399772636
86427,0.6108949416342413,0.425531914893617,-157,135,0.5886419592417365,0.41135804075826354,away,ARI,over,7.5,0.5238095238095238,-110,0.4988662131519274,SF,ARI,2022 REG,8,3,10,4,7,18,0,1,-1,1,1,1,1,0,0,0,0,0,0,0.4988662131519274,0.5011337868480725
86427,0.6108949416342413,0.425531914893617,-157,135,0.5886419592417365,0.41135804075826354,home,SF,under,7.5,0.5238095238095238,-110,0.5011337868480725,SF,ARI,2022 REG,8,3,10,4,7,18,0,1,-1,1,1,1,1,0,0,0,0,0,0,0.4988662131519274,0.5011337868480725
86428,0.4,0.6389891696750902,150,-177,0.3844043321299639,0.6155956678700361,away,TB,over,7.5,0.5073891625615764,-103,0.4826927225525911,CIN,TB,2022 REG,4,2,5,1,3,9,1,0,1,-1,1,0,0,0,0,0,0,0,0,0.4826927225525911,0.5173072774474089
86428,0.4,0.6389891696750902,150,-177,0.3844043321299639,0.6155956678700361,home,CIN,under,7.5,0.5412844036697247,-118,0.5173072774474089,CIN,TB,2022 REG,4,2,5,1,3,9,1,0,1,-1,1,0,0,0,0,0,0,0,0,0.4826927225525911,0.5173072774474089
86429,0.6491228070175439,0.3921568627450981,-185,155,0.6223272319084604,0.3776727680915396,away,TEX,over,9.5,0.5169082125603864,-107,0.49353874091423283,NYM,TEX,2022 REG,6,4,6,3,7,12,1,0,1,-1,1,1,1,0,0,0,0,0,0,0.49353874091423283,0.5064612590857671
86429,0.6491228070175439,0.3921568627450981,-185,155,0.6223272319084604,0.3776727680915396,home,NYM,under,9.5,0.5283018867924528,-112,0.5064612590857671,NYM,TEX,2022 REG,6,4,6,3,7,12,1,0,1,-1,1,1,1,0,0,0,0,0,0,0.49353874091423283,0.5064612590857671
86430,0.37735849056603776,0.6621621621621622,165,-196,0.36244503670633965,0.6375549632936603,away,CLE,over,7,0.5121951219512195,-105,0.48808156828023186,DET,CLE,2022 REG,6,2,11,5,7,17,0,1,-3,3,1,1,0,0,0,0,0,0,0,0.48808156828023186,0.5119184317197681
86430,0.37735849056603776,0.6621621621621622,165,-196,0.36244503670633965,0.6375549632936603,home,DET,under,7,0.5348837209302326,-115,0.5119184317197681,DET,CLE,2022 REG,6,2,11,5,7,17,0,1,-3,3,1,1,0,0,0,0,0,0,0,0.48808156828023186,0.5119184317197681
86431,0.6000000000000001,0.4444444444444444,-150,125,0.5733333333333334,0.42666666666666664,away,SD,over,8,0.5260663507109005,-111,0.5022370601254724,SF,SD,2022 REG,10,2,10,4,6,20,0,1,-2,2,1,1,0,0,0,0,0,0,0,0.5022370601254724,0.4977629398745276
86431,0.6000000000000001,0.4444444444444444,-150,125,0.5733333333333334,0.42666666666666664,home,SF,under,8,0.5192307692307692,-108,0.4977629398745276,SF,SD,2022 REG,10,2,10,4,6,20,0,1,-2,2,1,1,0,0,0,0,0,0,0,0.5022370601254724,0.4977629398745276
86432,0.5918367346938775,0.45454545454545453,-145,120,0.5643860512665178,0.43561394873348225,away,ARI,over,7,0.4926108374384236,103,0.4718421738975501,SD,ARI,2022 REG,5,3,4,2,5,9,1,0,1,-1,1,1,0,0,0,0,0,0,0,0.4718421738975501,0.5281578261024499
86432,0.5918367346938775,0.45454545454545453,-145,120,0.5643860512665178,0.43561394873348225,home,SD,under,7,0.5495495495495495,-122,0.5281578261024499,SD,ARI,2022 REG,5,3,4,2,5,9,1,0,1,-1,1,1,0,0,0,0,0,0,0,0.4718421738975501,0.5281578261024499
86433,0.37735849056603776,0.6610169491525424,165,-195,0.36287719255902645,0.6371228074409736,away,LAD,over,9.5,0.5192307692307692,-108,0.49455035168025013,ARI,LAD,2022 REG,4,5,9,3,8,13,1,0,2,-2,1,1,1,0,0,0,0,0,0,0.49455035168025013,0.5054496483197499
86433,0.37735849056603776,0.6610169491525424,165,-195,0.36287719255902645,0.6371228074409736,home,ARI,under,9.5,0.5283018867924528,-112,0.5054496483197499,ARI,LAD,2022 REG,4,5,9,3,8,13,1,0,2,-2,1,1,1,0,0,0,0,0,0,0.49455035168025013,0.5054496483197499
86434,0.5633187772925764,0.47619047619047616,-129,110,0.5410624729287608,0.45893752707123925,away,OAK,over,7,0.5238095238095238,-110,0.4988662131519274,DET,OAK,2022 REG,4,0,6,2,2,10,0,1,-2,2,0,0,0,0,0,0,0,0,0,0.4988662131519274,0.5011337868480725
86434,0.5633187772925764,0.47619047619047616,-129,110,0.5410624729287608,0.45893752707123925,home,DET,under,7,0.5238095238095238,-110,0.5011337868480725,DET,OAK,2022 REG,4,0,6,2,2,10,0,1,-2,2,0,0,0,0,0,0,0,0,0,0.4988662131519274,0.5011337868480725
86435,0.38759689922480617,0.6551724137931035,158,-190,0.37101964611708926,0.6289803538829107,away,CWS,over,8,0.5073891625615764,-103,0.48057683780462784,TEX,CWS,2022 REG,3,1,6,2,3,9,0,1,-1,1,1,0,0,0,0,0,0,0,0,0.48057683780462784,0.5194231621953722
86435,0.38759689922480617,0.6551724137931035,158,-190,0.37101964611708926,0.6289803538829107,home,TEX,under,8,0.5454545454545454,-120,0.5194231621953722,TEX,CWS,2022 REG,3,1,6,2,3,9,0,1,-1,1,1,0,0,0,0,0,0,0,0,0.48057683780462784,0.5194231621953722
86436,0.6721311475409836,0.37037037037037035,-205,170,0.6435645535349916,0.35643544646500835,away,WSH,over,7.5,0.5121951219512195,-105,0.48808156828023186,SF,WSH,2022 REG,11,4,22,14,18,33,0,1,-10,10,1,1,1,1,0,0,0,0,0,0.48808156828023186,0.5119184317197681
86436,0.6721311475409836,0.37037037037037035,-205,170,0.6435645535349916,0.35643544646500835,home,SF,under,7.5,0.5348837209302326,-115,0.5119184317197681,SF,WSH,2022 REG,11,4,22,14,18,33,0,1,-10,10,1,1,1,1,0,0,0,0,0,0.48808156828023186,0.5119184317197681
86437,0.5594713656387665,0.47619047619047616,-127,110,0.5395195862893665,0.46048041371063353,away,HOU,over,8,0.5348837209302326,-115,0.5109810284308424,NYY,HOU,2022 REG,5,1,5,3,4,10,0,1,-2,2,1,0,0,0,0,0,0,0,0,0.5109810284308424,0.48901897156915763
86437,0.5594713656387665,0.47619047619047616,-127,110,0.5395195862893665,0.46048041371063353,home,NYY,under,8,0.5098039215686274,-104,0.48901897156915763,NYY,HOU,2022 REG,5,1,5,3,4,10,0,1,-2,2,1,0,0,0,0,0,0,0,0,0.5109810284308424,0.48901897156915763
86438,0.696969696969697,0.3389830508474576,-230,195,0.6719117212183469,0.32808827878165314,away,CIN,over,8,0.5121951219512195,-105,0.48919479393107135,SF,CIN,2022 REG,9,9,5,2,11,14,1,0,7,-7,1,1,0,0,0,0,0,0,0,0.48919479393107135,0.5108052060689287
86438,0.696969696969697,0.3389830508474576,-230,195,0.6719117212183469,0.32808827878165314,home,SF,under,8,0.5327102803738317,-114,0.5108052060689287,SF,CIN,2022 REG,9,9,5,2,11,14,1,0,7,-7,1,1,0,0,0,0,0,0,0,0.48919479393107135,0.5108052060689287
86439,0.574468085106383,0.4587155963302753,-135,118,0.5554051191746856,0.4445948808253144,away,STL,over,7.5,0.5238095238095238,-110,0.4988662131519274,SD,STL,2022 REG,5,1,2,0,1,7,1,0,1,-1,0,0,0,0,0,0,0,0,0,0.4988662131519274,0.5011337868480725
86439,0.574468085106383,0.4587155963302753,-135,118,0.5554051191746856,0.4445948808253144,home,SD,under,7.5,0.5238095238095238,-110,0.5011337868480725,SD,STL,2022 REG,5,1,2,0,1,7,1,0,1,-1,0,0,0,0,0,0,0,0,0,0.4988662131519274,0.5011337868480725
86440,0.5348837209302326,0.5192307692307692,-115,-108,0.5059387610766736,0.49406123892332643,away,CWS,over,9,0.5260663507109005,-111,0.49286978180084795,CLE,CWS,2022 REG,12,8,8,4,12,20,1,0,4,-4,1,1,1,1,0,0,0,0,0,0.49286978180084795,0.507130218199152
86440,0.5348837209302326,0.5192307692307692,-115,-108,0.5059387610766736,0.49406123892332643,home,CLE,under,9,0.5370370370370371,-116,0.507130218199152,CLE,CWS,2022 REG,12,8,8,4,12,20,1,0,4,-4,1,1,1,1,0,0,0,0,0,0.49286978180084795,0.507130218199152
86441,0.4132231404958678,0.6226415094339623,142,-165,0.3984030372190785,0.6015969627809215,away,TOR,over,8.5,0.5121951219512195,-105,0.48808156828023186,PIT,TOR,2022 REG,7,1,6,4,5,13,0,1,-3,3,1,0,0,0,0,0,0,0,0,0.48808156828023186,0.5119184317197681
86441,0.4132231404958678,0.6226415094339623,142,-165,0.3984030372190785,0.6015969627809215,home,PIT,under,8.5,0.5348837209302326,-115,0.5119184317197681,PIT,TOR,2022 REG,7,1,6,4,5,13,0,1,-3,3,1,0,0,0,0,0,0,0,0,0.48808156828023186,0.5119184317197681
86442,0.6666666666666666,0.36363636363636365,-200,175,0.6464646464646464,0.3535353535353536,away,WSH,over,8,0.5391705069124424,-117,0.5140669063204599,MIL,WSH,2022 REG,9,7,6,0,7,15,1,0,7,-7,0,0,0,0,0,0,0,0,0,0.5140669063204599,0.4859330936795401
86442,0.6666666666666666,0.36363636363636365,-200,175,0.6464646464646464,0.3535353535353536,home,MIL,under,8,0.5073891625615764,-103,0.4859330936795401,MIL,WSH,2022 REG,9,7,6,0,7,15,1,0,7,-7,0,0,0,0,0,0,0,0,0,0.5140669063204599,0.4859330936795401
86443,0.45454545454545453,0.5850622406639003,120,-141,0.4365419567230205,0.5634580432769796,away,CWS,over,8.5,0.5454545454545454,-120,0.5206611570247933,KC,CWS,2022 REG,15,8,7,3,11,22,1,0,5,-5,1,1,1,0,0,0,0,0,0,0.5206611570247933,0.4793388429752067
86443,0.45454545454545453,0.5850622406639003,120,-141,0.4365419567230205,0.5634580432769796,home,KC,under,8.5,0.5,100,0.4793388429752067,KC,CWS,2022 REG,15,8,7,3,11,22,1,0,5,-5,1,1,1,0,0,0,0,0,0,0.5206611570247933,0.4793388429752067
86444,0.4081632653061224,0.635036496350365,145,-174,0.39053070952796426,0.6094692904720358,away,MIL,over,7.5,0.5073891625615764,-103,0.4826927225525911,PIT,MIL,2022 REG,6,2,9,3,5,15,0,1,-1,1,1,1,0,0,0,0,0,0,0,0.4826927225525911,0.5173072774474089
86444,0.4081632653061224,0.635036496350365,145,-174,0.39053070952796426,0.6094692904720358,home,PIT,under,7.5,0.5412844036697247,-118,0.5173072774474089,PIT,MIL,2022 REG,6,2,9,3,5,15,0,1,-1,1,1,1,0,0,0,0,0,0,0,0.4826927225525911,0.5173072774474089
86445,0.4,0.6491228070175439,150,-185,0.38035087719298244,0.6196491228070176,away,NYY,over,8,0.5283018867924528,-112,0.49492081101443036,CWS,NYY,2022 REG,9,4,14,10,14,23,0,1,-6,6,1,1,1,1,0,0,0,0,0,0.49492081101443036,0.5050791889855697
86445,0.4,0.6491228070175439,150,-185,0.38035087719298244,0.6196491228070176,home,CWS,under,8,0.5348837209302326,-115,0.5050791889855697,CWS,NYY,2022 REG,9,4,14,10,14,23,0,1,-6,6,1,1,1,1,0,0,0,0,0,0.49492081101443036,0.5050791889855697
86446,0.4081632653061224,0.6254681647940076,145,-167,0.39443615097953877,0.6055638490204612,away,ATL,over,8,0.5098039215686274,-104,0.48592421718142587,MIA,ATL,2022 REG,4,1,8,2,3,12,0,1,-1,1,1,0,0,0,0,0,0,0,0,0.48592421718142587,0.5140757828185741
86446,0.4081632653061224,0.6254681647940076,145,-167,0.39443615097953877,0.6055638490204612,home,MIA,under,8,0.5370370370370371,-116,0.5140757828185741,MIA,ATL,2022 REG,4,1,8,2,3,12,0,1,-1,1,1,0,0,0,0,0,0,0,0,0.48592421718142587,0.5140757828185741
86447,0.647887323943662,0.3921568627450981,-184,155,0.6219432029903809,0.37805679700961914,away,DET,over,8,0.5305164319248826,-113,0.5078572507605655,BAL,DET,2022 REG,6,2,10,3,5,16,0,1,-1,1,1,1,0,0,0,0,0,0,0,0.5078572507605655,0.49214274923943446
86447,0.647887323943662,0.3921568627450981,-184,155,0.6219432029903809,0.37805679700961914,home,BAL,under,8,0.5121951219512195,-105,0.49214274923943446,BAL,DET,2022 REG,6,2,10,3,5,16,0,1,-1,1,1,1,0,0,0,0,0,0,0,0.5078572507605655,0.49214274923943446
86448,0.5780590717299579,0.4587155963302753,-137,118,0.5568011412478822,0.44319885875211784,away,CWS,over,7.5,0.5,100,0.4772727272727273,CLE,CWS,2022 REG,9,5,7,2,7,16,1,0,3,-3,1,1,0,0,0,0,0,0,0,0.4772727272727273,0.5227272727272727
86448,0.5780590717299579,0.4587155963302753,-137,118,0.5568011412478822,0.44319885875211784,home,CLE,under,7.5,0.5454545454545454,-120,0.5227272727272727,CLE,CWS,2022 REG,9,5,7,2,7,16,1,0,3,-3,1,1,0,0,0,0,0,0,0,0.4772727272727273,0.5227272727272727
86449,0.4081632653061224,0.6363636363636364,145,-175,0.3899890197266291,0.6100109802733709,away,LAA,over,7.5,0.5073891625615764,-103,0.4837652908580103,OAK,LAA,2022 REG,11,5,8,4,9,19,1,0,1,-1,1,1,1,1,0,0,0,0,0,0.4837652908580103,0.5162347091419897
86449,0.4081632653061224,0.6363636363636364,145,-175,0.3899890197266291,0.6100109802733709,home,OAK,under,7.5,0.5391705069124424,-117,0.5162347091419897,OAK,LAA,2022 REG,11,5,8,4,9,19,1,0,1,-1,1,1,1,1,0,0,0,0,0,0.4837652908580103,0.5162347091419897
86450,0.6610169491525424,0.37735849056603776,-195,165,0.6356501330673793,0.3643498669326207,away,COL,over,7,0.5327102803738317,-114,0.508788710910954,SF,COL,2022 REG,12,9,10,2,11,22,1,0,7,-7,1,1,0,0,0,0,0,0,0,0.508788710910954,0.491211289089046
86450,0.6610169491525424,0.37735849056603776,-195,165,0.6356501330673793,0.3643498669326207,home,SF,under,7,0.5121951219512195,-105,0.491211289089046,SF,COL,2022 REG,12,9,10,2,11,22,1,0,7,-7,1,1,0,0,0,0,0,0,0,0.508788710910954,0.491211289089046
86451,0.607843137254902,0.4347826086956522,-155,130,0.5819333701084867,0.41806662989151333,away,SF,over,7.5,0.5348837209302326,-115,0.5097020142727117,LAD,SF,2022 REG,11,9,6,1,10,17,1,0,8,-8,1,0,0,0,0,0,0,0,0,0.5097020142727117,0.49029798572728833
86451,0.607843137254902,0.4347826086956522,-155,130,0.5819333701084867,0.41806662989151333,home,LAD,under,7.5,0.5121951219512195,-105,0.49029798572728833,LAD,SF,2022 REG,11,9,6,1,10,17,1,0,8,-8,1,0,0,0,0,0,0,0,0,0.5097020142727117,0.49029798572728833
86452,0.635036496350365,0.4065040650406504,-174,146,0.6086567237881874,0.39134327621181264,away,KC,over,8.5,0.5283018867924528,-112,0.5044173060022736,CWS,KC,2022 REG,14,9,7,2,11,21,1,0,7,-7,1,1,0,0,0,0,0,0,0,0.5044173060022736,0.49558269399772636
86452,0.635036496350365,0.4065040650406504,-174,146,0.6086567237881874,0.39134327621181264,home,CWS,under,8.5,0.5169082125603864,-107,0.49558269399772636,CWS,KC,2022 REG,14,9,7,2,11,21,1,0,7,-7,1,1,0,0,0,0,0,0,0,0.5044173060022736,0.49558269399772636
86453,0.5454545454545454,0.5,-120,100,0.5206611570247933,0.4793388429752067,away,CHC,over,7.5,0.5121951219512195,-105,0.48808156828023186,PIT,CHC,2022 REG,6,2,7,3,5,13,0,1,-1,1,1,1,0,0,0,0,0,0,0,0.48808156828023186,0.5119184317197681
86453,0.5454545454545454,0.5,-120,100,0.5206611570247933,0.4793388429752067,home,PIT,under,7.5,0.5348837209302326,-115,0.5119184317197681,PIT,CHC,2022 REG,6,2,7,3,5,13,0,1,-1,1,1,1,0,0,0,0,0,0,0,0.48808156828023186,0.5119184317197681
86454,0.6923076923076923,0.3448275862068966,-225,190,0.6665986533360538,0.33340134666394616,away,COL,over,8.5,0.5192307692307692,-108,0.49688292476754015,PHI,COL,2022 REG,12,7,12,3,10,24,1,0,4,-4,1,1,1,0,0,0,0,0,0,0.49688292476754015,0.5031170752324599
86454,0.6923076923076923,0.3448275862068966,-225,190,0.6665986533360538,0.33340134666394616,home,PHI,under,8.5,0.5238095238095238,-110,0.5031170752324599,PHI,COL,2022 REG,12,7,12,3,10,24,1,0,4,-4,1,1,1,0,0,0,0,0,0,0.49688292476754015,0.5031170752324599
86455,0.7142857142857143,0.3225806451612903,-250,210,0.6879526003949967,0.3120473996050033,away,DET,over,7,0.5238095238095238,-110,0.4988662131519274,SEA,DET,2022 REG,7,3,8,4,7,15,0,1,-1,1,1,1,1,0,0,0,0,0,0,0.4988662131519274,0.5011337868480725
86455,0.7142857142857143,0.3225806451612903,-250,210,0.6879526003949967,0.3120473996050033,home,SEA,under,7,0.5238095238095238,-110,0.5011337868480725,SEA,DET,2022 REG,7,3,8,4,7,15,0,1,-1,1,1,1,1,0,0,0,0,0,0,0.4988662131519274,0.5011337868480725
86456,0.6923076923076923,0.3508771929824561,-225,185,0.6624104640298972,0.33758953597010277,away,WSH,over,10,0.5215311004784688,-109,0.4978845547971712,ATL,WSH,2022 REG,12,4,5,3,7,17,1,0,1,-1,1,1,1,0,0,0,0,0,0,0.4978845547971712,0.5021154452028288
86456,0.6923076923076923,0.3508771929824561,-225,185,0.6624104640298972,0.33758953597010277,home,ATL,under,10,0.5238095238095238,-110,0.5021154452028288,ATL,WSH,2022 REG,12,4,5,3,7,17,1,0,1,-1,1,1,1,0,0,0,0,0,0,0.4978845547971712,0.5021154452028288
86457,0.48780487804878053,0.5555555555555556,105,-125,0.4666534470222751,0.5333465529777248,away,MIN,over,7,0.5327102803738317,-114,0.508788710910954,OAK,MIN,2022 REG,11,5,7,2,7,18,1,0,3,-3,1,1,0,0,0,0,0,0,0,0.508788710910954,0.491211289089046
86457,0.48780487804878053,0.5555555555555556,105,-125,0.4666534470222751,0.5333465529777248,home,OAK,under,7,0.5121951219512195,-105,0.491211289089046,OAK,MIN,2022 REG,11,5,7,2,7,18,1,0,3,-3,1,1,0,0,0,0,0,0,0,0.508788710910954,0.491211289089046
86458,0.5121951219512195,0.5305164319248826,-105,-113,0.4903184724049234,0.5096815275950766,away,CHC,over,8.5,0.5327102803738317,-114,0.508788710910954,CIN,CHC,2022 REG,6,3,3,2,5,9,1,0,1,-1,1,1,0,0,0,0,0,0,0,0.508788710910954,0.491211289089046
86458,0.5121951219512195,0.5305164319248826,-105,-113,0.4903184724049234,0.5096815275950766,home,CIN,under,8.5,0.5121951219512195,-105,0.491211289089046,CIN,CHC,2022 REG,6,3,3,2,5,9,1,0,1,-1,1,1,0,0,0,0,0,0,0,0.508788710910954,0.491211289089046
86459,0.696969696969697,0.3424657534246575,-230,192,0.6694843830584802,0.33051561694151976,away,PHI,over,6.5,0.5454545454545454,-120,0.5206611570247933,HOU,PHI,2022 REG,17,10,3,0,10,20,1,0,10,-10,0,0,0,0,0,0,0,0,0,0.5206611570247933,0.4793388429752067
86459,0.696969696969697,0.3424657534246575,-230,192,0.6694843830584802,0.33051561694151976,home,HOU,under,6.5,0.5,100,0.4793388429752067,HOU,PHI,2022 REG,17,10,3,0,10,20,1,0,10,-10,0,0,0,0,0,0,0,0,0,0.5206611570247933,0.4793388429752067
86460,0.5918367346938775,0.4444444444444444,-145,125,0.5703642001018094,0.42963579989819056,away,CIN,over,8,0.5283018867924528,-112,0.5007713302480123,CHC,CIN,2022 REG,12,1,10,7,8,22,0,1,-6,6,1,0,0,0,0,0,0,0,0,0.5007713302480123,0.49922866975198765
86460,0.5918367346938775,0.4444444444444444,-145,125,0.5703642001018094,0.42963579989819056,home,CHC,under,8,0.5238095238095238,-110,0.49922866975198765,CHC,CIN,2022 REG,12,1,10,7,8,22,0,1,-6,6,1,0,0,0,0,0,0,0,0,0.5007713302480123,0.49922866975198765
86461,0.5815899581589958,0.4587155963302753,-139,118,0.5581486524100054,0.44185134758999456,away,LAA,over,8.5,0.5495495495495495,-122,0.5250401592387142,BAL,LAA,2022 REG,10,5,12,4,9,22,1,0,1,-1,1,1,1,1,0,0,0,0,0,0.5250401592387142,0.47495984076128583
86461,0.5815899581589958,0.4587155963302753,-139,118,0.5581486524100054,0.44185134758999456,home,BAL,under,8.5,0.49504950495049505,102,0.47495984076128583,BAL,LAA,2022 REG,10,5,12,4,9,22,1,0,1,-1,1,1,1,1,0,0,0,0,0,0.5250401592387142,0.47495984076128583
86462,0.5283018867924528,0.5121951219512195,-112,-105,0.5069072406637203,0.4930927593362797,away,LAA,over,8,0.5145631067961165,-106,0.49023796582517226,KC,LAA,2022 REG,12,7,5,0,7,17,1,0,7,-7,0,0,0,0,0,0,0,0,0,0.49023796582517226,0.5097620341748277
86462,0.5283018867924528,0.5121951219512195,-112,-105,0.5069072406637203,0.4930927593362797,home,KC,under,8,0.5327102803738317,-114,0.5097620341748277,KC,LAA,2022 REG,12,7,5,0,7,17,1,0,7,-7,0,0,0,0,0,0,0,0,0,0.49023796582517226,0.5097620341748277
86463,0.5348837209302326,0.5,-115,100,0.5162249864791779,0.4837750135208221,away,SEA,over,7,0.5121951219512195,-105,0.4903184724049234,LAA,SEA,2022 REG,4,2,5,1,3,9,1,0,1,-1,1,0,0,0,0,0,0,0,0,0.4903184724049234,0.5096815275950766
86463,0.5348837209302326,0.5,-115,100,0.5162249864791779,0.4837750135208221,home,LAA,under,7,0.5305164319248826,-113,0.5096815275950766,LAA,SEA,2022 REG,4,2,5,1,3,9,1,0,1,-1,1,0,0,0,0,0,0,0,0,0.4903184724049234,0.5096815275950766
86464,0.696969696969697,0.3448275862068966,-230,190,0.6678382571799499,0.33216174282005007,away,BAL,over,9,0.5412844036697247,-118,0.5149381613977361,TOR,BAL,2022 REG,10,5,8,6,11,18,0,1,-1,1,1,1,1,1,1,0,0,0,0,0.5149381613977361,0.48506183860226393
86464,0.696969696969697,0.3448275862068966,-230,190,0.6678382571799499,0.33216174282005007,home,TOR,under,9,0.5073891625615764,-103,0.48506183860226393,TOR,BAL,2022 REG,10,5,8,6,11,18,0,1,-1,1,1,1,1,1,1,0,0,0,0,0.5149381613977361,0.48506183860226393
86465,0.2857142857142857,0.7530864197530864,250,-305,0.27462836986646505,0.7253716301335349,away,HOU,over,8,0.5238095238095238,-110,0.4988662131519274,OAK,HOU,2022 REG,4,3,5,2,5,9,1,0,1,-1,1,1,0,0,0,0,0,0,0,0.4988662131519274,0.5011337868480725
86465,0.2857142857142857,0.7530864197530864,250,-305,0.27462836986646505,0.7253716301335349,home,OAK,under,8,0.5238095238095238,-110,0.5011337868480725,OAK,HOU,2022 REG,4,3,5,2,5,9,1,0,1,-1,1,1,0,0,0,0,0,0,0,0.4988662131519274,0.5011337868480725
86466,0.6226415094339623,0.4166666666666667,-165,140,0.5981666073335706,0.40183339266642937,away,OAK,over,8,0.5391705069124424,-117,0.5140669063204599,TEX,OAK,2022 REG,8,2,3,1,3,11,1,0,1,-1,1,0,0,0,0,0,0,0,0,0.5140669063204599,0.4859330936795401
86466,0.6226415094339623,0.4166666666666667,-165,140,0.5981666073335706,0.40183339266642937,home,TEX,under,8,0.5073891625615764,-103,0.4859330936795401,TEX,OAK,2022 REG,8,2,3,1,3,11,1,0,1,-1,1,0,0,0,0,0,0,0,0,0.5140669063204599,0.4859330936795401
86467,0.5652173913043479,0.47619047619047616,-130,110,0.5418129444594474,0.4581870555405526,away,ATL,over,7.5,0.5348837209302326,-115,0.5097020142727117,MIL,ATL,2022 REG,5,1,2,0,1,7,1,0,1,-1,0,0,0,0,0,0,0,0,0,0.5097020142727117,0.49029798572728833
86467,0.5652173913043479,0.47619047619047616,-130,110,0.5418129444594474,0.4581870555405526,home,MIL,under,7.5,0.5121951219512195,-105,0.49029798572728833,MIL,ATL,2022 REG,5,1,2,0,1,7,1,0,1,-1,0,0,0,0,0,0,0,0,0,0.5097020142727117,0.49029798572728833
86468,0.7142857142857143,0.3225806451612903,-250,210,0.6879526003949967,0.3120473996050033,away,BAL,over,8.5,0.5348837209302326,-115,0.5097020142727117,LAA,BAL,2022 REG,6,4,6,5,9,12,0,1,-1,1,1,1,1,1,0,0,0,0,0,0.5097020142727117,0.49029798572728833
86468,0.7142857142857143,0.3225806451612903,-250,210,0.6879526003949967,0.3120473996050033,home,LAA,under,8.5,0.5121951219512195,-105,0.49029798572728833,LAA,BAL,2022 REG,6,4,6,5,9,12,0,1,-1,1,1,1,1,1,0,0,0,0,0,0.5097020142727117,0.49029798572728833
86469,0.4166666666666667,0.6240601503759399,140,-166,0.39969715956558066,0.6003028404344193,away,NYM,over,7,0.5305164319248826,-113,0.5053568787472517,MIA,NYM,2022 REG,9,3,16,11,14,25,0,1,-8,8,1,1,1,0,0,0,0,0,0,0.5053568787472517,0.49464312125274834
86469,0.4166666666666667,0.6240601503759399,140,-166,0.39969715956558066,0.6003028404344193,home,MIA,under,7,0.5169082125603864,-107,0.49464312125274834,MIA,NYM,2022 REG,9,3,16,11,14,25,0,1,-8,8,1,1,1,0,0,0,0,0,0,0.5053568787472517,0.49464312125274834
86470,0.6402877697841727,0.4,-178,150,0.6144920035194866,0.38550799648051337,away,OAK,over,8,0.5348837209302326,-115,0.5109810284308424,SEA,OAK,2022 REG,4,1,12,3,4,16,0,1,-2,2,1,0,0,0,0,0,0,0,0,0.5109810284308424,0.48901897156915763
86470,0.6402877697841727,0.4,-178,150,0.6144920035194866,0.38550799648051337,home,SEA,under,8,0.5098039215686274,-104,0.48901897156915763,SEA,OAK,2022 REG,4,1,12,3,4,16,0,1,-2,2,1,0,0,0,0,0,0,0,0,0.5109810284308424,0.48901897156915763
86471,0.5726495726495727,0.4716981132075471,-134,112,0.5472538892954956,0.45274611070450443,away,DET,over,8.5,0.5412844036697247,-118,0.5149381613977361,KC,DET,2022 REG,5,1,3,2,3,8,0,1,-1,1,1,0,0,0,0,0,0,0,0,0.5149381613977361,0.48506183860226393
86471,0.5726495726495727,0.4716981132075471,-134,112,0.5472538892954956,0.45274611070450443,home,KC,under,8.5,0.5073891625615764,-103,0.48506183860226393,KC,DET,2022 REG,5,1,3,2,3,8,0,1,-1,1,1,0,0,0,0,0,0,0,0,0.5149381613977361,0.48506183860226393
86472,0.7058823529411764,0.3333333333333333,-240,200,0.6782006920415226,0.32179930795847744,away,WSH,over,9,0.5412844036697247,-118,0.5175913212324037,NYM,WSH,2022 REG,8,5,6,0,5,14,1,0,5,-5,0,0,0,0,0,0,0,0,0,0.5175913212324037,0.4824086787675963
86472,0.7058823529411764,0.3333333333333333,-240,200,0.6782006920415226,0.32179930795847744,home,NYM,under,9,0.5024875621890548,-101,0.4824086787675963,NYM,WSH,2022 REG,8,5,6,0,5,14,1,0,5,-5,0,0,0,0,0,0,0,0,0,0.5175913212324037,0.4824086787675963
86473,0.574468085106383,0.4608294930875576,-135,117,0.5541907529524172,0.44580924704758285,away,SF,over,8,0.5348837209302326,-115,0.5097020142727117,SD,SF,2022 REG,4,1,12,8,9,16,0,1,-7,7,1,0,0,0,0,0,0,0,0,0.5097020142727117,0.49029798572728833
86473,0.574468085106383,0.4608294930875576,-135,117,0.5541907529524172,0.44580924704758285,home,SD,under,8,0.5121951219512195,-105,0.49029798572728833,SD,SF,2022 REG,4,1,12,8,9,16,0,1,-7,7,1,0,0,0,0,0,0,0,0,0.5097020142727117,0.49029798572728833
86474,0.35714285714285715,0.6825396825396826,180,-215,0.34297052154195007,0.6570294784580499,away,NYY,over,7.5,0.5454545454545454,-120,0.5206611570247933,DET,NYY,2022 REG,4,2,6,4,6,10,0,1,-2,2,1,1,0,0,0,0,0,0,0,0.5206611570247933,0.4793388429752067
86474,0.35714285714285715,0.6825396825396826,180,-215,0.34297052154195007,0.6570294784580499,home,DET,under,7.5,0.5,100,0.4793388429752067,DET,NYY,2022 REG,4,2,6,4,6,10,0,1,-2,2,1,1,0,0,0,0,0,0,0,0.5206611570247933,0.4793388429752067
86475,0.7101449275362319,0.3333333333333333,-245,200,0.6792690611216132,0.3207309388783868,away,SEA,over,7.5,NA,NA,NA,NYM,SEA,2022 REG,5,1,4,2,3,9,0,1,-1,1,1,0,0,0,0,0,0,0,0,NA,NA
86475,0.7101449275362319,0.3333333333333333,-245,200,0.6792690611216132,0.3207309388783868,home,NYM,under,7.5,0.5495495495495495,-122,NA,NYM,SEA,2022 REG,5,1,4,2,3,9,0,1,-1,1,1,0,0,0,0,0,0,0,0,NA,NA
86476,0.5780590717299579,0.4629629629629629,-137,116,0.5543459124348938,0.44565408756510616,away,NYM,over,7.5,0.5283018867924528,-112,0.5056562298022652,SD,NYM,2022 REG,6,7,2,0,7,8,1,0,7,-7,0,0,0,0,0,0,0,0,0,0.5056562298022652,0.4943437701977348
86476,0.5780590717299579,0.4629629629629629,-137,116,0.5543459124348938,0.44565408756510616,home,SD,under,7.5,0.5145631067961165,-106,0.4943437701977348,SD,NYM,2022 REG,6,7,2,0,7,8,1,0,7,-7,0,0,0,0,0,0,0,0,0,0.5056562298022652,0.4943437701977348
86477,0.425531914893617,0.6183206106870228,135,-162,0.406871265710366,0.593128734289634,away,SF,over,11,0.5305164319248826,-113,0.5066009958897986,COL,SF,2022 REG,10,7,5,4,11,15,1,0,3,-3,1,1,1,1,0,0,0,0,0,0.5066009958897986,0.49339900411020143
86477,0.425531914893617,0.6183206106870228,135,-162,0.406871265710366,0.593128734289634,home,COL,under,11,0.5145631067961165,-106,0.49339900411020143,COL,SF,2022 REG,10,7,5,4,11,15,1,0,3,-3,1,1,1,1,0,0,0,0,0,0.5066009958897986,0.49339900411020143
86478,0.4854368932038835,0.5555555555555556,106,-125,0.465537646233282,0.534462353766718,away,MIA,over,7,0.5,100,0.47935779816513757,OAK,MIA,2022 REG,4,3,5,2,5,9,1,0,1,-1,1,1,0,0,0,0,0,0,0,0.47935779816513757,0.5206422018348624
86478,0.4854368932038835,0.5555555555555556,106,-125,0.465537646233282,0.534462353766718,home,OAK,under,7,0.5412844036697247,-118,0.5206422018348624,OAK,MIA,2022 REG,4,3,5,2,5,9,1,0,1,-1,1,1,0,0,0,0,0,0,0,0.47935779816513757,0.5206422018348624
86479,0.4166666666666667,0.6183206106870228,140,-162,0.40208863443596277,0.5979113655640372,away,SEA,over,7.5,0.5454545454545454,-120,0.5193043049216726,CLE,SEA,2022 REG,9,0,7,4,4,16,0,1,-4,4,0,0,0,0,0,0,0,0,0,0.5193043049216726,0.48069569507832743
86479,0.4166666666666667,0.6183206106870228,140,-162,0.40208863443596277,0.5979113655640372,home,CLE,under,7.5,0.5024875621890548,-101,0.48069569507832743,CLE,SEA,2022 REG,9,0,7,4,4,16,0,1,-4,4,0,0,0,0,0,0,0,0,0,0.5193043049216726,0.48069569507832743
86480,0.48780487804878053,0.5555555555555556,105,-125,0.4666534470222751,0.5333465529777248,away,PIT,over,8.5,0.5348837209302326,-115,0.5097020142727117,CIN,PIT,2022 REG,8,9,8,2,11,16,1,0,7,-7,1,1,0,0,0,0,0,0,0,0.5097020142727117,0.49029798572728833
86480,0.48780487804878053,0.5555555555555556,105,-125,0.4666534470222751,0.5333465529777248,home,CIN,under,8.5,0.5121951219512195,-105,0.49029798572728833,CIN,PIT,2022 REG,8,9,8,2,11,16,1,0,7,-7,1,1,0,0,0,0,0,0,0,0.5097020142727117,0.49029798572728833
86481,0.4629629629629629,0.574468085106383,116,-135,0.44563377404196935,0.5543662259580306,away,CWS,over,7,0.5454545454545454,-120,0.5206611570247933,BAL,CWS,2022 REG,5,5,11,3,8,16,1,0,2,-2,1,1,1,0,0,0,0,0,0,0.5206611570247933,0.4793388429752067
86481,0.4629629629629629,0.574468085106383,116,-135,0.44563377404196935,0.5543662259580306,home,BAL,under,7,0.5,100,0.4793388429752067,BAL,CWS,2022 REG,5,5,11,3,8,16,1,0,2,-2,1,1,1,0,0,0,0,0,0,0.5206611570247933,0.4793388429752067
86482,0.6031746031746031,0.4291845493562232,-152,133,0.5836563841877556,0.41634361581224444,away,CIN,over,8.5,0.5412844036697247,-118,0.5149381613977361,WSH,CIN,2022 REG,8,3,9,7,10,17,0,1,-4,4,1,1,1,0,0,0,0,0,0,0.5149381613977361,0.48506183860226393
86482,0.6031746031746031,0.4291845493562232,-152,133,0.5836563841877556,0.41634361581224444,home,WSH,under,8.5,0.5073891625615764,-103,0.48506183860226393,WSH,CIN,2022 REG,8,3,9,7,10,17,0,1,-4,4,1,1,1,0,0,0,0,0,0,0.5149381613977361,0.48506183860226393
86483,0.4081632653061224,0.6363636363636364,145,-175,0.3899890197266291,0.6100109802733709,away,SEA,over,7.5,0.5238095238095238,-110,0.5000596729920038,DET,SEA,2022 REG,7,3,11,9,12,18,0,1,-6,6,1,1,1,0,0,0,0,0,0,0.5000596729920038,0.4999403270079962
86483,0.4081632653061224,0.6363636363636364,145,-175,0.3899890197266291,0.6100109802733709,home,DET,under,7.5,0.5215311004784688,-109,0.4999403270079962,DET,SEA,2022 REG,7,3,11,9,12,18,0,1,-6,6,1,1,1,0,0,0,0,0,0,0.5000596729920038,0.4999403270079962
86484,0.6551724137931035,0.3846153846153846,-190,160,0.6291045458703008,0.37089545412969915,away,NYM,over,8.5,0.5283018867924528,-112,0.5056562298022652,LAD,NYM,2022 REG,6,4,13,9,13,19,0,1,-5,5,1,1,1,1,0,0,0,0,0,0.5056562298022652,0.4943437701977348
86484,0.6551724137931035,0.3846153846153846,-190,160,0.6291045458703008,0.37089545412969915,home,LAD,under,8.5,0.5145631067961165,-106,0.4943437701977348,LAD,NYM,2022 REG,6,4,13,9,13,19,0,1,-5,5,1,1,1,1,0,0,0,0,0,0.5056562298022652,0.4943437701977348
86485,0.4166666666666667,0.6254681647940076,140,-167,0.3991104868913858,0.6008895131086143,away,CWS,over,7.5,0.5327102803738317,-114,0.508788710910954,KC,CWS,2022 REG,12,6,10,2,8,22,1,0,4,-4,1,1,0,0,0,0,0,0,0,0.508788710910954,0.491211289089046
86485,0.4166666666666667,0.6254681647940076,140,-167,0.3991104868913858,0.6008895131086143,home,KC,under,7.5,0.5121951219512195,-105,0.491211289089046,KC,CWS,2022 REG,12,6,10,2,8,22,1,0,4,-4,1,1,0,0,0,0,0,0,0,0.508788710910954,0.491211289089046
86486,0.5555555555555556,0.4807692307692307,-125,108,0.5353751187084521,0.4646248812915479,away,TEX,over,7.5,0.5098039215686274,-104,0.4870219861770517,MIA,TEX,2022 REG,5,2,6,3,5,11,0,1,-1,1,1,1,0,0,0,0,0,0,0,0.4870219861770517,0.5129780138229483
86486,0.5555555555555556,0.4807692307692307,-125,108,0.5353751187084521,0.4646248812915479,home,MIA,under,7.5,0.5348837209302326,-115,0.5129780138229483,MIA,TEX,2022 REG,5,2,6,3,5,11,0,1,-1,1,1,1,0,0,0,0,0,0,0,0.4870219861770517,0.5129780138229483
86487,0.5652173913043479,0.47619047619047616,-130,110,0.5418129444594474,0.4581870555405526,away,NYM,over,7.5,0.5238095238095238,-110,0.4988662131519274,ATL,NYM,2022 REG,5,5,11,3,8,16,1,0,2,-2,1,1,1,0,0,0,0,0,0,0.4988662131519274,0.5011337868480725
86487,0.5652173913043479,0.47619047619047616,-130,110,0.5418129444594474,0.4581870555405526,home,ATL,under,7.5,0.5238095238095238,-110,0.5011337868480725,ATL,NYM,2022 REG,5,5,11,3,8,16,1,0,2,-2,1,1,1,0,0,0,0,0,0,0.4988662131519274,0.5011337868480725
86488,0.6666666666666666,0.37037037037037035,-200,170,0.6419753086419753,0.3580246913580247,away,OAK,over,7.5,0.5283018867924528,-112,0.5044173060022736,LAA,OAK,2022 REG,10,4,4,1,5,14,1,0,3,-3,1,0,0,0,0,0,0,0,0,0.5044173060022736,0.49558269399772636
86488,0.6666666666666666,0.37037037037037035,-200,170,0.6419753086419753,0.3580246913580247,home,LAA,under,7.5,0.5169082125603864,-107,0.49558269399772636,LAA,OAK,2022 REG,10,4,4,1,5,14,1,0,3,-3,1,0,0,0,0,0,0,0,0,0.5044173060022736,0.49558269399772636
86489,0.5918367346938775,0.45454545454545453,-145,120,0.5643860512665178,0.43561394873348225,away,MIN,over,9,0.5412844036697247,-118,0.5149381613977361,CWS,MIN,2022 REG,8,3,8,6,9,16,0,1,-3,3,1,1,1,0,0,0,0,0,0,0.5149381613977361,0.48506183860226393
86489,0.5918367346938775,0.45454545454545453,-145,120,0.5643860512665178,0.43561394873348225,home,CWS,under,9,0.5073891625615764,-103,0.48506183860226393,CWS,MIN,2022 REG,8,3,8,6,9,16,0,1,-3,3,1,1,1,0,0,0,0,0,0,0.5149381613977361,0.48506183860226393
86490,0.5238095238095238,0.5169082125603864,-110,-107,0.5024811857109994,0.4975188142890006,away,HOU,over,9.5,0.5283018867924528,-112,0.5056562298022652,LAA,HOU,2022 REG,13,6,14,13,19,27,0,1,-7,7,1,1,1,1,1,1,0,0,0,0.5056562298022652,0.4943437701977348
86490,0.5238095238095238,0.5169082125603864,-110,-107,0.5024811857109994,0.4975188142890006,home,LAA,under,9.5,0.5145631067961165,-106,0.4943437701977348,LAA,HOU,2022 REG,13,6,14,13,19,27,0,1,-7,7,1,1,1,1,1,1,0,0,0,0.5056562298022652,0.4943437701977348
86491,0.5689655172413793,0.4716981132075471,-132,112,0.5458293137100936,0.4541706862899064,away,MIN,over,9,0.5391705069124424,-117,0.5140669063204599,CWS,MIN,2022 REG,10,2,12,8,10,22,0,1,-6,6,1,1,0,0,0,0,0,0,0,0.5140669063204599,0.4859330936795401
86491,0.5689655172413793,0.4716981132075471,-132,112,0.5458293137100936,0.4541706862899064,home,CWS,under,9,0.5073891625615764,-103,0.4859330936795401,CWS,MIN,2022 REG,10,2,12,8,10,22,0,1,-6,6,1,1,0,0,0,0,0,0,0,0.5140669063204599,0.4859330936795401
86492,0.4273504273504274,0.607843137254902,134,-155,0.412310442476355,0.5876895575236449,away,NYY,over,10,0.5121951219512195,-105,0.48808156828023186,BOS,NYY,2022 REG,13,5,14,12,17,27,0,1,-7,7,1,1,1,1,1,0,0,0,0,0.48808156828023186,0.5119184317197681
86492,0.4273504273504274,0.607843137254902,134,-155,0.412310442476355,0.5876895575236449,home,BOS,under,10,0.5348837209302326,-115,0.5119184317197681,BOS,NYY,2022 REG,13,5,14,12,17,27,0,1,-7,7,1,1,1,1,1,0,0,0,0,0.48808156828023186,0.5119184317197681
86493,0.5,0.5370370370370371,100,-116,0.4814814814814814,0.5185185185185186,away,NYY,over,8,0.5283018867924528,-112,0.5044173060022736,TOR,NYY,2022 REG,9,2,8,3,5,17,0,1,-1,1,1,1,0,0,0,0,0,0,0,0.5044173060022736,0.49558269399772636
86493,0.5,0.5370370370370371,100,-116,0.4814814814814814,0.5185185185185186,home,TOR,under,8,0.5169082125603864,-107,0.49558269399772636,TOR,NYY,2022 REG,9,2,8,3,5,17,0,1,-1,1,1,1,0,0,0,0,0,0,0,0.5044173060022736,0.49558269399772636
86494,0.5391705069124424,0.5,-117,100,0.5180509248444435,0.4819490751555565,away,MIL,over,7,0.49019607843137253,104,0.46874141813588177,TB,MIL,2022 REG,5,3,9,5,8,14,0,1,-2,2,1,1,1,0,0,0,0,0,0,0.46874141813588177,0.5312585818641182
86494,0.5391705069124424,0.5,-117,100,0.5180509248444435,0.4819490751555565,home,TB,under,7,0.5535714285714286,-124,0.5312585818641182,TB,MIL,2022 REG,5,3,9,5,8,14,0,1,-2,2,1,1,1,0,0,0,0,0,0,0.46874141813588177,0.5312585818641182
86495,0.576271186440678,0.46511627906976744,-136,115,0.552420782587201,0.44757921741279905,away,PHI,over,7,0.5475113122171946,-121,0.5242087833606768,NYM,PHI,2022 REG,10,6,9,0,6,19,1,0,6,-6,0,0,0,0,0,0,0,0,0,0.5242087833606768,0.4757912166393232
86495,0.576271186440678,0.46511627906976744,-136,115,0.552420782587201,0.44757921741279905,home,NYM,under,7,0.49504950495049505,102,0.4757912166393232,NYM,PHI,2022 REG,10,6,9,0,6,19,1,0,6,-6,0,0,0,0,0,0,0,0,0,0.5242087833606768,0.4757912166393232
86496,0.5145631067961165,0.5238095238095238,-106,-110,0.4948179667757384,0.5051820332242616,away,OAK,over,8.5,0.5073891625615764,-103,0.4826927225525911,WSH,OAK,2022 REG,11,6,13,10,16,24,0,1,-4,4,1,1,1,1,1,1,0,0,0,0.4826927225525911,0.5173072774474089
86496,0.5145631067961165,0.5238095238095238,-106,-110,0.4948179667757384,0.5051820332242616,home,WSH,under,8.5,0.5412844036697247,-118,0.5173072774474089,WSH,OAK,2022 REG,11,6,13,10,16,24,0,1,-4,4,1,1,1,1,1,1,0,0,0,0.4826927225525911,0.5173072774474089
86497,0.4081632653061224,0.6254681647940076,145,-167,0.39443615097953877,0.6055638490204612,away,CWS,over,8.5,0.5073891625615764,-103,0.4837652908580103,CLE,CWS,2022 REG,8,0,9,7,7,17,0,1,-7,7,0,0,0,0,0,0,0,0,0,0.4837652908580103,0.5162347091419897
86497,0.4081632653061224,0.6254681647940076,145,-167,0.39443615097953877,0.6055638490204612,home,CLE,under,8.5,0.5391705069124424,-117,0.5162347091419897,CLE,CWS,2022 REG,8,0,9,7,7,17,0,1,-7,7,0,0,0,0,0,0,0,0,0,0.4837652908580103,0.5162347091419897
86498,0.4291845493562232,0.607843137254902,133,-155,0.41329283836432396,0.586707161635676,away,CWS,over,8,0.5121951219512195,-105,0.48919479393107135,KC,CWS,2022 REG,6,6,10,4,10,16,1,0,2,-2,1,1,1,1,0,0,0,0,0,0.48919479393107135,0.5108052060689287
86498,0.4291845493562232,0.607843137254902,133,-155,0.41329283836432396,0.586707161635676,home,KC,under,8,0.5327102803738317,-114,0.5108052060689287,KC,CWS,2022 REG,6,6,10,4,10,16,1,0,2,-2,1,1,1,1,0,0,0,0,0,0.48919479393107135,0.5108052060689287
86499,0.6666666666666666,0.37037037037037035,-200,170,0.6419753086419753,0.3580246913580247,away,CHC,over,8.5,0.5412844036697247,-118,0.5136310900085983,LAD,CHC,2022 REG,6,4,5,3,7,11,1,0,1,-1,1,1,1,0,0,0,0,0,0,0.5136310900085983,0.4863689099914017
86499,0.6666666666666666,0.37037037037037035,-200,170,0.6419753086419753,0.3580246913580247,home,LAD,under,8.5,0.5098039215686274,-104,0.4863689099914017,LAD,CHC,2022 REG,6,4,5,3,7,11,1,0,1,-1,1,1,1,0,0,0,0,0,0,0.5136310900085983,0.4863689099914017
86500,0.5192307692307692,0.5238095238095238,-108,-110,0.49688292476754015,0.5031170752324599,away,TEX,over,8.5,0.5238095238095238,-110,0.4988662131519274,BAL,TEX,2022 REG,12,7,9,6,13,21,1,0,1,-1,1,1,1,1,1,1,0,0,0,0.4988662131519274,0.5011337868480725
86500,0.5192307692307692,0.5238095238095238,-108,-110,0.49688292476754015,0.5031170752324599,home,BAL,under,8.5,0.5238095238095238,-110,0.5011337868480725,BAL,TEX,2022 REG,12,7,9,6,13,21,1,0,1,-1,1,1,1,1,1,1,0,0,0,0.4988662131519274,0.5011337868480725
86501,0.7468354430379747,0.2898550724637681,-295,245,0.719433665637939,0.280566334362061,away,CIN,over,7.5,0.5412844036697247,-118,0.5162581740877563,MIL,CIN,2022 REG,9,7,9,6,13,18,1,0,1,-1,1,1,1,1,1,1,0,0,0,0.5162581740877563,0.4837418259122437
86501,0.7468354430379747,0.2898550724637681,-295,245,0.719433665637939,0.280566334362061,home,MIL,under,7.5,0.504950495049505,-102,0.4837418259122437,MIL,CIN,2022 REG,9,7,9,6,13,18,1,0,1,-1,1,1,1,1,1,1,0,0,0,0.5162581740877563,0.4837418259122437
86502,0.5867768595041323,0.45454545454545453,-142,120,0.5625298818386723,0.43747011816132775,away,CLE,over,10,0.5169082125603864,-107,0.49353874091423283,BOS,CLE,2022 REG,7,3,12,8,11,19,0,1,-5,5,1,1,1,0,0,0,0,0,0,0.49353874091423283,0.5064612590857671
86502,0.5867768595041323,0.45454545454545453,-142,120,0.5625298818386723,0.43747011816132775,home,BOS,under,10,0.5283018867924528,-112,0.5064612590857671,BOS,CLE,2022 REG,7,3,12,8,11,19,0,1,-5,5,1,1,1,0,0,0,0,0,0,0.49353874091423283,0.5064612590857671
86503,0.3125,0.7333333333333333,220,-275,0.2981770833333333,0.7018229166666667,away,NYM,over,8.5,0.5327102803738317,-114,0.5075272610403079,WSH,NYM,2022 REG,6,3,13,7,10,19,0,1,-4,4,1,1,1,0,0,0,0,0,0,0.5075272610403079,0.4924727389596921
86503,0.3125,0.7333333333333333,220,-275,0.2981770833333333,0.7018229166666667,home,WSH,under,8.5,0.5145631067961165,-106,0.4924727389596921,WSH,NYM,2022 REG,6,3,13,7,10,19,0,1,-4,4,1,1,1,0,0,0,0,0,0,0.5075272610403079,0.4924727389596921
86504,0.45454545454545453,0.5918367346938775,120,-145,0.433462641254849,0.566537358745151,away,STL,over,9.5,0.5238095238095238,-110,0.4988662131519274,PHI,STL,2022 REG,7,5,7,3,8,14,1,0,2,-2,1,1,1,0,0,0,0,0,0,0.4988662131519274,0.5011337868480725
86504,0.45454545454545453,0.5918367346938775,120,-145,0.433462641254849,0.566537358745151,home,PHI,under,9.5,0.5238095238095238,-110,0.5011337868480725,PHI,STL,2022 REG,7,5,7,3,8,14,1,0,2,-2,1,1,1,0,0,0,0,0,0,0.4988662131519274,0.5011337868480725
86505,0.504950495049505,0.5370370370370371,-102,-116,0.4837488699364985,0.5162511300635015,away,LAA,over,10,0.5215311004784688,-109,0.4978845547971712,TEX,LAA,2022 REG,8,6,11,9,15,19,0,1,-3,3,1,1,1,1,1,1,0,0,0,0.4978845547971712,0.5021154452028288
86505,0.504950495049505,0.5370370370370371,-102,-116,0.4837488699364985,0.5162511300635015,home,TEX,under,10,0.5238095238095238,-110,0.5021154452028288,TEX,LAA,2022 REG,8,6,11,9,15,19,0,1,-3,3,1,1,1,1,1,1,0,0,0,0.4978845547971712,0.5021154452028288
86506,0.6153846153846154,0.425531914893617,-160,135,0.5902052121364724,0.40979478786352763,away,WSH,over,9,0.5260663507109005,-111,0.5010269332605688,TEX,WSH,2022 REG,8,1,9,2,3,17,0,1,-1,1,1,0,0,0,0,0,0,0,0,0.5010269332605688,0.4989730667394312
86506,0.6153846153846154,0.425531914893617,-160,135,0.5902052121364724,0.40979478786352763,home,TEX,under,9,0.5215311004784688,-109,0.4989730667394312,TEX,WSH,2022 REG,8,1,9,2,3,17,0,1,-1,1,1,0,0,0,0,0,0,0,0,0.5010269332605688,0.4989730667394312
86507,0.3846153846153846,0.6503496503496503,160,-186,0.3711672942442173,0.6288327057557828,away,NYY,over,9,0.5283018867924528,-112,0.5044173060022736,BAL,NYY,2022 REG,7,2,11,5,7,18,0,1,-3,3,1,1,0,0,0,0,0,0,0,0.5044173060022736,0.49558269399772636
86507,0.3846153846153846,0.6503496503496503,160,-186,0.3711672942442173,0.6288327057557828,home,BAL,under,9,0.5169082125603864,-107,0.49558269399772636,BAL,NYY,2022 REG,7,2,11,5,7,18,0,1,-3,3,1,1,0,0,0,0,0,0,0,0.5044173060022736,0.49558269399772636
86508,0.4629629629629629,0.576271186440678,116,-136,0.4447990049057217,0.5552009950942782,away,NYM,over,9,0.5145631067961165,-106,0.4913668392989033,ARI,NYM,2022 REG,11,5,7,2,7,18,1,0,3,-3,1,1,0,0,0,0,0,0,0,0.4913668392989033,0.5086331607010968
86508,0.4629629629629629,0.576271186440678,116,-136,0.4447990049057217,0.5552009950942782,home,ARI,under,9,0.5305164319248826,-113,0.5086331607010968,ARI,NYM,2022 REG,11,5,7,2,7,18,1,0,3,-3,1,1,0,0,0,0,0,0,0,0.4913668392989033,0.5086331607010968
86509,0.7142857142857143,0.3333333333333333,-250,200,0.6802721088435374,0.3197278911564626,away,DET,over,8,0.5283018867924528,-112,0.5056562298022652,MIN,DET,2022 REG,8,2,5,0,2,13,1,0,2,-2,0,0,0,0,0,0,0,0,0,0.5056562298022652,0.4943437701977348
86509,0.7142857142857143,0.3333333333333333,-250,200,0.6802721088435374,0.3197278911564626,home,MIN,under,8,0.5145631067961165,-106,0.4943437701977348,MIN,DET,2022 REG,8,2,5,0,2,13,1,0,2,-2,0,0,0,0,0,0,0,0,0,0.5056562298022652,0.4943437701977348
86510,0.6551724137931035,0.3846153846153846,-190,160,0.6291045458703008,0.37089545412969915,away,PHI,over,9.5,0.5121951219512195,-105,0.48808156828023186,TOR,PHI,2022 REG,14,4,7,3,7,21,1,0,1,-1,1,1,1,0,0,0,0,0,0,0.48808156828023186,0.5119184317197681
86510,0.6551724137931035,0.3846153846153846,-190,160,0.6291045458703008,0.37089545412969915,home,TOR,under,9.5,0.5348837209302326,-115,0.5119184317197681,TOR,PHI,2022 REG,14,4,7,3,7,21,1,0,1,-1,1,1,1,0,0,0,0,0,0,0.48808156828023186,0.5119184317197681
86511,0.3389830508474576,0.7032640949554896,195,-237,0.3246619844735772,0.6753380155264228,away,LAD,over,6.5,0.5555555555555556,-125,0.5314664257753688,CHC,LAD,2022 REG,5,0,11,7,7,16,0,1,-7,7,0,0,0,0,0,0,0,0,0,0.5314664257753688,0.46853357422463116
86511,0.3389830508474576,0.7032640949554896,195,-237,0.3246619844735772,0.6753380155264228,home,CHC,under,6.5,0.48780487804878053,105,0.46853357422463116,CHC,LAD,2022 REG,5,0,11,7,7,16,0,1,-7,7,0,0,0,0,0,0,0,0,0,0.5314664257753688,0.46853357422463116
86512,0.4672897196261683,0.5689655172413793,114,-132,0.4503480201553517,0.5496519798446483,away,SD,over,8,0.5433789954337899,-119,0.5171177654451503,ARI,SD,2022 REG,4,0,9,4,4,13,0,1,-4,4,0,0,0,0,0,0,0,0,0,0.5171177654451503,0.4828822345548497
86512,0.4672897196261683,0.5689655172413793,114,-132,0.4503480201553517,0.5496519798446483,home,ARI,under,8,0.504950495049505,-102,0.4828822345548497,ARI,SD,2022 REG,4,0,9,4,4,13,0,1,-4,4,0,0,0,0,0,0,0,0,0,0.5171177654451503,0.4828822345548497
86513,0.5073891625615764,0.5348837209302326,-103,-115,0.4859403596076043,0.5140596403923957,away,CHC,over,9,0.5,100,0.4772727272727273,BAL,CHC,2022 REG,9,9,7,3,12,16,1,0,6,-6,1,1,1,0,0,0,0,0,0,0.4772727272727273,0.5227272727272727
86513,0.5073891625615764,0.5348837209302326,-103,-115,0.4859403596076043,0.5140596403923957,home,BAL,under,9,0.5454545454545454,-120,0.5227272727272727,BAL,CHC,2022 REG,9,9,7,3,12,16,1,0,6,-6,1,1,1,0,0,0,0,0,0,0.4772727272727273,0.5227272727272727
86514,0.6240601503759399,0.4166666666666667,-166,140,0.5986441668079975,0.4013558331920025,away,BOS,over,9.5,0.5192307692307692,-108,0.49688292476754015,NYY,BOS,2022 REG,4,4,5,2,6,9,1,0,2,-2,1,1,0,0,0,0,0,0,0,0.49688292476754015,0.5031170752324599
86514,0.6240601503759399,0.4166666666666667,-166,140,0.5986441668079975,0.4013558331920025,home,NYY,under,9.5,0.5238095238095238,-110,0.5031170752324599,NYY,BOS,2022 REG,4,4,5,2,6,9,1,0,2,-2,1,1,0,0,0,0,0,0,0,0.49688292476754015,0.5031170752324599
86515,0.3448275862068966,0.6923076923076923,190,-225,0.3320223177535901,0.6679776822464099,away,NYM,over,8.5,0.5215311004784688,-109,0.4978845547971712,PIT,NYM,2022 REG,12,8,7,2,10,19,1,0,6,-6,1,1,0,0,0,0,0,0,0,0.4978845547971712,0.5021154452028288
86515,0.3448275862068966,0.6923076923076923,190,-225,0.3320223177535901,0.6679776822464099,home,PIT,under,8.5,0.5238095238095238,-110,0.5021154452028288,PIT,NYM,2022 REG,12,8,7,2,10,19,1,0,6,-6,1,1,0,0,0,0,0,0,0,0.4978845547971712,0.5021154452028288
86516,0.6389891696750902,0.4,-177,150,0.614075512518083,0.385924487481917,away,KC,over,7,0.5305164319248826,-113,0.5053568787472517,CWS,KC,2022 REG,5,2,6,5,7,11,0,1,-3,3,1,1,0,0,0,0,0,0,0,0.5053568787472517,0.49464312125274834
86516,0.6389891696750902,0.4,-177,150,0.614075512518083,0.385924487481917,home,CWS,under,7,0.5169082125603864,-107,0.49464312125274834,CWS,KC,2022 REG,5,2,6,5,7,11,0,1,-3,3,1,1,0,0,0,0,0,0,0,0.5053568787472517,0.49464312125274834
86517,0.425531914893617,0.6226415094339623,135,-165,0.40503258539251946,0.5949674146074806,away,SF,over,NA,NA,NA,NA,WSH,SF,2022 REG,7,2,10,5,7,17,0,1,-3,3,1,1,0,0,0,0,0,0,0,NA,NA
86517,0.425531914893617,0.6226415094339623,135,-165,0.40503258539251946,0.5949674146074806,home,WSH,under,NA,NA,NA,NA,WSH,SF,2022 REG,7,2,10,5,7,17,0,1,-3,3,1,1,0,0,0,0,0,0,0,NA,NA
86518,0.3448275862068966,0.6923076923076923,190,-225,0.3320223177535901,0.6679776822464099,away,NYY,over,8.5,0.5283018867924528,-112,0.5031902949311281,CLE,NYY,2022 REG,5,4,14,13,17,19,0,1,-9,9,1,1,1,1,0,0,0,0,0,0.5031902949311281,0.4968097050688719
86518,0.3448275862068966,0.6923076923076923,190,-225,0.3320223177535901,0.6679776822464099,home,CLE,under,8.5,0.5192307692307692,-108,0.4968097050688719,CLE,NYY,2022 REG,5,4,14,13,17,19,0,1,-9,9,1,1,1,1,0,0,0,0,0,0.5031902949311281,0.4968097050688719
86519,0.5555555555555556,0.48780487804878053,-125,105,0.5314664257753688,0.46853357422463116,away,BOS,over,8,0.5238095238095238,-110,0.4988662131519274,MIN,BOS,2022 REG,9,5,13,6,11,22,0,1,-1,1,1,1,1,1,1,0,0,0,0,0.4988662131519274,0.5011337868480725
86519,0.5555555555555556,0.48780487804878053,-125,105,0.5314664257753688,0.46853357422463116,home,MIN,under,8,0.5238095238095238,-110,0.5011337868480725,MIN,BOS,2022 REG,9,5,13,6,11,22,0,1,-1,1,1,1,1,1,1,0,0,0,0,0.4988662131519274,0.5011337868480725
86520,0.8076923076923077,0.23255813953488372,-420,330,0.7751823310857301,0.2248176689142699,away,COL,over,7.5,0.5260663507109005,-111,0.5022370601254724,LAD,COL,2022 REG,15,10,7,1,11,22,1,0,9,-9,1,0,0,0,0,0,0,0,0,0.5022370601254724,0.4977629398745276
86520,0.8076923076923077,0.23255813953488372,-420,330,0.7751823310857301,0.2248176689142699,home,LAD,under,7.5,0.5192307692307692,-108,0.4977629398745276,LAD,COL,2022 REG,15,10,7,1,11,22,1,0,9,-9,1,0,0,0,0,0,0,0,0,0.5022370601254724,0.4977629398745276
86521,0.7142857142857143,0.3333333333333333,-250,200,0.6802721088435374,0.3197278911564626,away,MIA,over,7,0.5391705069124424,-117,0.5127649394825569,PHI,MIA,2022 REG,8,4,5,1,5,13,1,0,3,-3,1,0,0,0,0,0,0,0,0,0.5127649394825569,0.48723506051744314
86521,0.7142857142857143,0.3333333333333333,-250,200,0.6802721088435374,0.3197278911564626,home,PHI,under,7,0.5098039215686274,-104,0.48723506051744314,PHI,MIA,2022 REG,8,4,5,1,5,13,1,0,3,-3,1,0,0,0,0,0,0,0,0,0.5127649394825569,0.48723506051744314
86522,0.6254681647940076,0.4081632653061224,-167,145,0.6044327759298813,0.3955672240701187,away,DET,over,8,0.5391705069124424,-117,0.5127649394825569,ARI,DET,2022 REG,3,1,9,5,6,12,0,1,-4,4,1,0,0,0,0,0,0,0,0,0.5127649394825569,0.48723506051744314
86522,0.6254681647940076,0.4081632653061224,-167,145,0.6044327759298813,0.3955672240701187,home,ARI,under,8,0.5098039215686274,-104,0.48723506051744314,ARI,DET,2022 REG,3,1,9,5,6,12,0,1,-4,4,1,0,0,0,0,0,0,0,0,0.5127649394825569,0.48723506051744314
86523,0.6666666666666666,0.37735849056603776,-200,165,0.6373165618448637,0.36268343815513626,away,OAK,over,7.5,0.5327102803738317,-114,0.508788710910954,NYY,OAK,2022 REG,5,2,6,1,3,11,1,0,1,-1,1,0,0,0,0,0,0,0,0,0.508788710910954,0.491211289089046
86523,0.6666666666666666,0.37735849056603776,-200,165,0.6373165618448637,0.36268343815513626,home,NYY,under,7.5,0.5121951219512195,-105,0.491211289089046,NYY,OAK,2022 REG,5,2,6,1,3,11,1,0,1,-1,1,0,0,0,0,0,0,0,0,0.508788710910954,0.491211289089046
86524,0.5555555555555556,0.48780487804878053,-125,105,0.5314664257753688,0.46853357422463116,away,CHC,over,8,0.5238095238095238,-110,0.4988662131519274,PIT,CHC,2022 REG,6,5,10,6,11,16,0,1,-1,1,1,1,1,1,1,0,0,0,0,0.4988662131519274,0.5011337868480725
86524,0.5555555555555556,0.48780487804878053,-125,105,0.5314664257753688,0.46853357422463116,home,PIT,under,8,0.5238095238095238,-110,0.5011337868480725,PIT,CHC,2022 REG,6,5,10,6,11,16,0,1,-1,1,1,1,1,1,1,0,0,0,0,0.4988662131519274,0.5011337868480725
86525,0.425531914893617,0.613899613899614,135,-159,0.40875254093905067,0.5912474590609493,away,NYM,over,9,0.5073891625615764,-103,0.4826927225525911,ARI,NYM,2022 REG,6,2,10,6,8,16,0,1,-4,4,1,1,0,0,0,0,0,0,0,0.4826927225525911,0.5173072774474089
86525,0.425531914893617,0.613899613899614,135,-159,0.40875254093905067,0.5912474590609493,home,ARI,under,9,0.5412844036697247,-118,0.5173072774474089,ARI,NYM,2022 REG,6,2,10,6,8,16,0,1,-4,4,1,1,0,0,0,0,0,0,0,0.4826927225525911,0.5173072774474089
86526,0.6551724137931035,0.3802281368821293,-190,163,0.6319789495576061,0.36802105044239386,away,KC,over,8.5,0.5169082125603864,-107,0.49353874091423283,MIN,KC,2022 REG,11,6,2,3,9,13,1,0,3,-3,1,1,1,0,0,0,0,0,0,0.49353874091423283,0.5064612590857671
86526,0.6551724137931035,0.3802281368821293,-190,163,0.6319789495576061,0.36802105044239386,home,MIN,under,8.5,0.5283018867924528,-112,0.5064612590857671,MIN,KC,2022 REG,11,6,2,3,9,13,1,0,3,-3,1,1,1,0,0,0,0,0,0,0.49353874091423283,0.5064612590857671
86527,0.6254681647940076,0.41152263374485604,-167,143,0.6023315979176397,0.3976684020823603,away,SEA,over,7.5,0.5098039215686274,-104,0.4870219861770517,NYM,SEA,2022 REG,7,5,9,4,9,16,1,0,1,-1,1,1,1,1,0,0,0,0,0,0.4870219861770517,0.5129780138229483
86527,0.6254681647940076,0.41152263374485604,-167,143,0.6023315979176397,0.3976684020823603,home,NYM,under,7.5,0.5348837209302326,-115,0.5129780138229483,NYM,SEA,2022 REG,7,5,9,4,9,16,1,0,1,-1,1,1,1,1,0,0,0,0,0,0.4870219861770517,0.5129780138229483
86528,0.6551724137931035,0.3846153846153846,-190,160,0.6291045458703008,0.37089545412969915,away,SEA,over,8,0.5215311004784688,-109,0.4978845547971712,SD,SEA,2022 REG,7,2,12,8,10,19,0,1,-6,6,1,1,0,0,0,0,0,0,0,0.4978845547971712,0.5021154452028288
86528,0.6551724137931035,0.3846153846153846,-190,160,0.6291045458703008,0.37089545412969915,home,SD,under,8,0.5238095238095238,-110,0.5021154452028288,SD,SEA,2022 REG,7,2,12,8,10,19,0,1,-6,6,1,1,0,0,0,0,0,0,0,0.4978845547971712,0.5021154452028288
86529,0.6363636363636364,0.4065040650406504,-175,146,0.6090841900154538,0.3909158099845462,away,PIT,over,7.5,0.5348837209302326,-115,0.5097020142727117,MIL,PIT,2022 REG,9,6,13,8,14,22,0,1,-2,2,1,1,1,1,1,1,0,0,0,0.5097020142727117,0.49029798572728833
86529,0.6363636363636364,0.4065040650406504,-175,146,0.6090841900154538,0.3909158099845462,home,MIL,under,7.5,0.5121951219512195,-105,0.49029798572728833,MIL,PIT,2022 REG,9,6,13,8,14,22,0,1,-2,2,1,1,1,1,1,1,0,0,0,0.5097020142727117,0.49029798572728833
86530,0.5,0.5391705069124424,100,-117,0.4804147465437788,0.5195852534562212,away,SEA,over,7.5,0.5121951219512195,-105,0.48808156828023186,MIA,SEA,2022 REG,6,3,5,1,4,11,1,0,2,-2,1,0,0,0,0,0,0,0,0,0.48808156828023186,0.5119184317197681
86530,0.5,0.5391705069124424,100,-117,0.4804147465437788,0.5195852534562212,home,MIA,under,7.5,0.5348837209302326,-115,0.5119184317197681,MIA,SEA,2022 REG,6,3,5,1,4,11,1,0,2,-2,1,0,0,0,0,0,0,0,0,0.48808156828023186,0.5119184317197681
86531,0.5555555555555556,0.4807692307692307,-125,108,0.5353751187084521,0.4646248812915479,away,CLE,over,7.5,0.5073891625615764,-103,0.4826927225525911,TEX,CLE,2022 REG,9,3,7,6,9,16,0,1,-3,3,1,1,1,0,0,0,0,0,0,0.4826927225525911,0.5173072774474089
86531,0.5555555555555556,0.4807692307692307,-125,108,0.5353751187084521,0.4646248812915479,home,TEX,under,7.5,0.5412844036697247,-118,0.5173072774474089,TEX,CLE,2022 REG,9,3,7,6,9,16,0,1,-3,3,1,1,1,0,0,0,0,0,0,0.4826927225525911,0.5173072774474089
86532,0.5555555555555556,0.48780487804878053,-125,105,0.5314664257753688,0.46853357422463116,away,OAK,over,8,0.5391705069124424,-117,0.5140669063204599,LAA,OAK,2022 REG,9,7,8,8,15,17,0,1,-1,1,1,1,1,1,1,1,1,0,0,0.5140669063204599,0.4859330936795401
86532,0.5555555555555556,0.48780487804878053,-125,105,0.5314664257753688,0.46853357422463116,home,LAA,under,8,0.5073891625615764,-103,0.4859330936795401,LAA,OAK,2022 REG,9,7,8,8,15,17,0,1,-1,1,1,1,1,1,1,1,1,0,0,0.5140669063204599,0.4859330936795401
86533,0.5555555555555556,0.48780487804878053,-125,105,0.5314664257753688,0.46853357422463116,away,TEX,over,8.5,0.5305164319248826,-113,0.5066009958897986,LAA,TEX,2022 REG,7,9,8,7,16,15,1,0,2,-2,1,1,1,1,1,1,1,0,0,0.5066009958897986,0.49339900411020143
86533,0.5555555555555556,0.48780487804878053,-125,105,0.5314664257753688,0.46853357422463116,home,LAA,under,8.5,0.5145631067961165,-106,0.49339900411020143,LAA,TEX,2022 REG,7,9,8,7,16,15,1,0,2,-2,1,1,1,1,1,1,1,0,0,0.5066009958897986,0.49339900411020143
86534,0.4444444444444444,0.6000000000000001,125,-150,0.4246913580246913,0.5753086419753086,away,BAL,over,8.5,0.5348837209302326,-115,0.5097020142727117,WSH,BAL,2022 REG,4,2,11,6,8,15,0,1,-4,4,1,1,0,0,0,0,0,0,0,0.5097020142727117,0.49029798572728833
86534,0.4444444444444444,0.6000000000000001,125,-150,0.4246913580246913,0.5753086419753086,home,WSH,under,8.5,0.5121951219512195,-105,0.49029798572728833,WSH,BAL,2022 REG,4,2,11,6,8,15,0,1,-4,4,1,1,0,0,0,0,0,0,0,0.5097020142727117,0.49029798572728833
86535,0.5967741935483871,0.4424778761061947,-148,126,0.5733495713351688,0.42665042866483116,away,BAL,over,7.5,0.5,100,0.4772727272727273,TB,BAL,2022 REG,5,3,19,10,13,24,0,1,-7,7,1,1,1,0,0,0,0,0,0,0.4772727272727273,0.5227272727272727
86535,0.5967741935483871,0.4424778761061947,-148,126,0.5733495713351688,0.42665042866483116,home,TB,under,7.5,0.5454545454545454,-120,0.5227272727272727,TB,BAL,2022 REG,5,3,19,10,13,24,0,1,-7,7,1,1,1,0,0,0,0,0,0,0.4772727272727273,0.5227272727272727
86536,0.6453900709219857,0.3921568627450981,-182,155,0.6211576527396834,0.3788423472603166,away,MIA,over,8,0.5121951219512195,-105,0.48808156828023186,NYM,MIA,2022 REG,5,5,10,4,9,15,1,0,1,-1,1,1,1,1,0,0,0,0,0,0.48808156828023186,0.5119184317197681
86536,0.6453900709219857,0.3921568627450981,-182,155,0.6211576527396834,0.3788423472603166,home,NYM,under,8,0.5348837209302326,-115,0.5119184317197681,NYM,MIA,2022 REG,5,5,10,4,9,15,1,0,1,-1,1,1,1,1,0,0,0,0,0,0.48808156828023186,0.5119184317197681
86537,0.45454545454545453,0.5780590717299579,120,-137,0.439725215329358,0.560274784670642,away,HOU,over,8.5,0.5215311004784688,-109,0.4978845547971712,KC,HOU,2022 REG,6,3,14,10,13,20,0,1,-7,7,1,1,1,0,0,0,0,0,0,0.4978845547971712,0.5021154452028288
86537,0.45454545454545453,0.5780590717299579,120,-137,0.439725215329358,0.560274784670642,home,KC,under,8.5,0.5238095238095238,-110,0.5021154452028288,KC,HOU,2022 REG,6,3,14,10,13,20,0,1,-7,7,1,1,1,0,0,0,0,0,0,0.4978845547971712,0.5021154452028288
86538,0.4672897196261683,0.574468085106383,114,-135,0.4477767267604901,0.5522232732395099,away,PHI,over,11.5,0.5327102803738317,-114,0.508788710910954,COL,PHI,2022 REG,8,6,11,5,11,19,1,0,1,-1,1,1,1,1,1,0,0,0,0,0.508788710910954,0.491211289089046
86538,0.4672897196261683,0.574468085106383,114,-135,0.4477767267604901,0.5522232732395099,home,COL,under,11.5,0.5121951219512195,-105,0.491211289089046,COL,PHI,2022 REG,8,6,11,5,11,19,1,0,1,-1,1,1,1,1,1,0,0,0,0,0.508788710910954,0.491211289089046
86539,0.6551724137931035,0.38759689922480617,-190,158,0.6271511397468869,0.37284886025311315,away,BOS,over,7.5,0.504950495049505,-102,0.48160416005266615,NYY,BOS,2022 REG,14,13,6,2,15,20,1,0,11,-11,1,1,0,0,0,0,0,0,0,0.48160416005266615,0.5183958399473338
86539,0.6551724137931035,0.38759689922480617,-190,158,0.6271511397468869,0.37284886025311315,home,NYY,under,7.5,0.5412844036697247,-118,0.5183958399473338,NYY,BOS,2022 REG,14,13,6,2,15,20,1,0,11,-11,1,1,0,0,0,0,0,0,0,0.48160416005266615,0.5183958399473338
86540,0.6226415094339623,0.4166666666666667,-165,140,0.5981666073335706,0.40183339266642937,away,SD,over,9.5,0.5348837209302326,-115,0.5097020142727117,LAD,SD,2022 REG,9,9,8,4,13,17,1,0,5,-5,1,1,1,1,0,0,0,0,0,0.5097020142727117,0.49029798572728833
86540,0.6226415094339623,0.4166666666666667,-165,140,0.5981666073335706,0.40183339266642937,home,LAD,under,9.5,0.5121951219512195,-105,0.49029798572728833,LAD,SD,2022 REG,9,9,8,4,13,17,1,0,5,-5,1,1,1,1,0,0,0,0,0,0.5097020142727117,0.49029798572728833
86541,0.6875,0.35211267605633806,-220,184,0.6602662852112676,0.3397337147887324,away,DET,over,8,0.5169082125603864,-107,0.49353874091423283,CLE,DET,2022 REG,8,3,11,4,7,19,0,1,-1,1,1,1,1,0,0,0,0,0,0,0.49353874091423283,0.5064612590857671
86541,0.6875,0.35211267605633806,-220,184,0.6602662852112676,0.3397337147887324,home,CLE,under,8,0.5283018867924528,-112,0.5064612590857671,CLE,DET,2022 REG,8,3,11,4,7,19,0,1,-1,1,1,1,1,0,0,0,0,0,0,0.49353874091423283,0.5064612590857671
86542,0.5121951219512195,0.5348837209302326,-105,-115,0.48808156828023186,0.5119184317197681,away,BOS,over,8.5,0.5391705069124424,-117,0.5140669063204599,SEA,BOS,2022 REG,10,3,6,4,7,16,0,1,-1,1,1,1,1,0,0,0,0,0,0,0.5140669063204599,0.4859330936795401
86542,0.5121951219512195,0.5348837209302326,-105,-115,0.48808156828023186,0.5119184317197681,home,SEA,under,8.5,0.5073891625615764,-103,0.4859330936795401,SEA,BOS,2022 REG,10,3,6,4,7,16,0,1,-1,1,1,1,1,0,0,0,0,0,0,0.5140669063204599,0.4859330936795401
86543,0.5726495726495727,0.4672897196261683,-134,114,0.5497783539959433,0.4502216460040567,away,SEA,over,9.5,0.5073891625615764,-103,0.4837652908580103,BOS,SEA,2022 REG,10,8,9,4,12,19,1,0,4,-4,1,1,1,1,0,0,0,0,0,0.4837652908580103,0.5162347091419897
86543,0.5726495726495727,0.4672897196261683,-134,114,0.5497783539959433,0.4502216460040567,home,BOS,under,9.5,0.5391705069124424,-117,0.5162347091419897,BOS,SEA,2022 REG,10,8,9,4,12,19,1,0,4,-4,1,1,1,1,0,0,0,0,0,0.4837652908580103,0.5162347091419897
86544,0.6875,0.3508771929824561,-220,185,0.6611156798245614,0.33888432017543857,away,ARI,over,9,0.5215311004784688,-109,0.4978845547971712,LAD,ARI,2022 REG,13,6,10,5,11,23,1,0,1,-1,1,1,1,1,1,0,0,0,0,0.4978845547971712,0.5021154452028288
86544,0.6875,0.3508771929824561,-220,185,0.6611156798245614,0.33888432017543857,home,LAD,under,9,0.5238095238095238,-110,0.5021154452028288,LAD,ARI,2022 REG,13,6,10,5,11,23,1,0,1,-1,1,1,1,1,1,0,0,0,0,0.4978845547971712,0.5021154452028288
86545,0.5833333333333333,0.4608294930875576,-140,117,0.5575716845878136,0.4424283154121864,away,CWS,over,7.5,0.5169082125603864,-107,0.49353874091423283,CLE,CWS,2022 REG,6,2,3,1,3,9,1,0,1,-1,1,0,0,0,0,0,0,0,0,0.49353874091423283,0.5064612590857671
86545,0.5833333333333333,0.4608294930875576,-140,117,0.5575716845878136,0.4424283154121864,home,CLE,under,7.5,0.5283018867924528,-112,0.5064612590857671,CLE,CWS,2022 REG,6,2,3,1,3,9,1,0,1,-1,1,0,0,0,0,0,0,0,0,0.49353874091423283,0.5064612590857671
86546,0.6226415094339623,0.4166666666666667,-165,140,0.5981666073335706,0.40183339266642937,away,CWS,over,8,0.5121951219512195,-105,0.48808156828023186,HOU,CWS,2022 REG,12,13,8,3,16,20,1,0,10,-10,1,1,1,0,0,0,0,0,0,0.48808156828023186,0.5119184317197681
86546,0.6226415094339623,0.4166666666666667,-165,140,0.5981666073335706,0.40183339266642937,home,HOU,under,8,0.5348837209302326,-115,0.5119184317197681,HOU,CWS,2022 REG,12,13,8,3,16,20,1,0,10,-10,1,1,1,0,0,0,0,0,0,0.48808156828023186,0.5119184317197681
86547,0.5833333333333333,0.45454545454545453,-140,120,0.5612373737373737,0.4387626262626263,away,COL,over,8,0.5238095238095238,-110,0.4988662131519274,DET,COL,2022 REG,20,13,7,0,13,27,1,0,13,-13,0,0,0,0,0,0,0,0,0,0.4988662131519274,0.5011337868480725
86547,0.5833333333333333,0.45454545454545453,-140,120,0.5612373737373737,0.4387626262626263,home,DET,under,8,0.5238095238095238,-110,0.5011337868480725,DET,COL,2022 REG,20,13,7,0,13,27,1,0,13,-13,0,0,0,0,0,0,0,0,0,0.4988662131519274,0.5011337868480725
86548,0.4807692307692307,0.5555555555555556,108,-125,0.4633053911900066,0.5366946088099934,away,TEX,over,8.5,0.5073891625615764,-103,0.4837652908580103,OAK,TEX,2022 REG,2,1,9,8,9,11,0,1,-7,7,1,0,0,0,0,0,0,0,0,0.4837652908580103,0.5162347091419897
86548,0.4807692307692307,0.5555555555555556,108,-125,0.4633053911900066,0.5366946088099934,home,OAK,under,8.5,0.5391705069124424,-117,0.5162347091419897,OAK,TEX,2022 REG,2,1,9,8,9,11,0,1,-7,7,1,0,0,0,0,0,0,0,0,0.4837652908580103,0.5162347091419897
86549,0.5726495726495727,0.47619047619047616,-134,110,0.5446813395531345,0.45531866044686553,away,WSH,over,9.5,0.504950495049505,-102,0.4826715732667395,CIN,WSH,2022 REG,10,8,5,1,9,15,1,0,7,-7,1,0,0,0,0,0,0,0,0,0.4826715732667395,0.5173284267332605
86549,0.5726495726495727,0.47619047619047616,-134,110,0.5446813395531345,0.45531866044686553,home,CIN,under,9.5,0.5391705069124424,-117,0.5173284267332605,CIN,WSH,2022 REG,10,8,5,1,9,15,1,0,7,-7,1,0,0,0,0,0,0,0,0,0.4826715732667395,0.5173284267332605
86550,0.5283018867924528,0.5145631067961165,-112,-106,0.5056562298022652,0.4943437701977348,away,TOR,over,8.5,0.5454545454545454,-120,0.5206611570247933,BAL,TOR,2022 REG,9,9,13,6,15,22,1,0,3,-3,1,1,1,1,1,1,0,0,0,0.5206611570247933,0.4793388429752067
86550,0.5283018867924528,0.5145631067961165,-112,-106,0.5056562298022652,0.4943437701977348,home,BAL,under,8.5,0.5,100,0.4793388429752067,BAL,TOR,2022 REG,9,9,13,6,15,22,1,0,3,-3,1,1,1,1,1,1,0,0,0,0.5206611570247933,0.4793388429752067
86551,0.6428571428571428,0.3921568627450981,-180,155,0.6203481392557023,0.3796518607442977,away,KC,over,7.5,0.5327102803738317,-114,0.5075272610403079,CLE,KC,2022 REG,15,9,6,2,11,21,1,0,7,-7,1,1,0,0,0,0,0,0,0,0.5075272610403079,0.4924727389596921
86551,0.6428571428571428,0.3921568627450981,-180,155,0.6203481392557023,0.3796518607442977,home,CLE,under,7.5,0.5145631067961165,-106,0.4924727389596921,CLE,KC,2022 REG,15,9,6,2,11,21,1,0,7,-7,1,1,0,0,0,0,0,0,0,0.5075272610403079,0.4924727389596921
86552,0.4854368932038835,0.5495495495495495,106,-122,0.4684531831294015,0.5315468168705986,away,SF,over,8,0.5412844036697247,-118,0.5149381613977361,CLE,SF,2022 REG,8,2,5,4,6,13,0,1,-2,2,1,1,0,0,0,0,0,0,0,0.5149381613977361,0.48506183860226393
86552,0.4854368932038835,0.5495495495495495,106,-122,0.4684531831294015,0.5315468168705986,home,CLE,under,8,0.5073891625615764,-103,0.48506183860226393,CLE,SF,2022 REG,8,2,5,4,6,13,0,1,-2,2,1,1,0,0,0,0,0,0,0,0.5149381613977361,0.48506183860226393
86553,0.6551724137931035,0.37735849056603776,-190,165,0.6338590626612524,0.36614093733874764,away,COL,over,8,0.5192307692307692,-108,0.49571111079951763,SD,COL,2022 REG,6,2,9,4,6,15,0,1,-2,2,1,1,0,0,0,0,0,0,0,0.49571111079951763,0.5042888892004824
86553,0.6551724137931035,0.37735849056603776,-190,165,0.6338590626612524,0.36614093733874764,home,SD,under,8,0.5260663507109005,-111,0.5042888892004824,SD,COL,2022 REG,6,2,9,4,6,15,0,1,-2,2,1,1,0,0,0,0,0,0,0,0.49571111079951763,0.5042888892004824
86554,0.3389830508474576,0.7014925373134329,195,-235,0.3252625124878337,0.6747374875121663,away,HOU,over,8,0.5169082125603864,-107,0.49353874091423283,DET,HOU,2022 REG,5,1,5,2,3,10,0,1,-1,1,1,0,0,0,0,0,0,0,0,0.49353874091423283,0.5064612590857671
86554,0.3389830508474576,0.7014925373134329,195,-235,0.3252625124878337,0.6747374875121663,home,DET,under,8,0.5283018867924528,-112,0.5064612590857671,DET,HOU,2022 REG,5,1,5,2,3,10,0,1,-1,1,1,0,0,0,0,0,0,0,0,0.49353874091423283,0.5064612590857671
86555,0.6666666666666666,0.36363636363636365,-200,175,0.6464646464646464,0.3535353535353536,away,LAA,over,6,0.5454545454545454,-120,0.5206611570247933,TB,LAA,2022 REG,7,8,10,3,11,17,1,0,5,-5,1,1,1,0,0,0,0,0,0,0.5206611570247933,0.4793388429752067
86555,0.6666666666666666,0.36363636363636365,-200,175,0.6464646464646464,0.3535353535353536,home,TB,under,6,0.5,100,0.4793388429752067,TB,LAA,2022 REG,7,8,10,3,11,17,1,0,5,-5,1,1,1,0,0,0,0,0,0,0.5206611570247933,0.4793388429752067
86556,0.6226415094339623,0.4166666666666667,-165,140,0.5981666073335706,0.40183339266642937,away,MIN,over,8.5,0.5145631067961165,-106,0.49023796582517226,HOU,MIN,2022 REG,11,6,7,3,9,18,1,0,3,-3,1,1,1,0,0,0,0,0,0,0.49023796582517226,0.5097620341748277
86556,0.6226415094339623,0.4166666666666667,-165,140,0.5981666073335706,0.40183339266642937,home,HOU,under,8.5,0.5327102803738317,-114,0.5097620341748277,HOU,MIN,2022 REG,11,6,7,3,9,18,1,0,3,-3,1,1,1,0,0,0,0,0,0,0.49023796582517226,0.5097620341748277
86557,0.6666666666666666,0.37037037037037035,-200,170,0.6419753086419753,0.3580246913580247,away,OAK,over,8,0.5391705069124424,-117,0.5127649394825569,TB,OAK,2022 REG,7,3,9,6,9,16,0,1,-3,3,1,1,1,0,0,0,0,0,0,0.5127649394825569,0.48723506051744314
86557,0.6666666666666666,0.37037037037037035,-200,170,0.6419753086419753,0.3580246913580247,home,TB,under,8,0.5098039215686274,-104,0.48723506051744314,TB,OAK,2022 REG,7,3,9,6,9,16,0,1,-3,3,1,1,1,0,0,0,0,0,0,0.5127649394825569,0.48723506051744314
86558,0.6108949416342413,0.425531914893617,-157,135,0.5886419592417365,0.41135804075826354,away,ARI,over,7.5,0.5215311004784688,-109,0.4978845547971712,SD,ARI,2022 REG,6,1,6,3,4,12,0,1,-2,2,1,0,0,0,0,0,0,0,0,0.4978845547971712,0.5021154452028288
86558,0.6108949416342413,0.425531914893617,-157,135,0.5886419592417365,0.41135804075826354,home,SD,under,7.5,0.5238095238095238,-110,0.5021154452028288,SD,ARI,2022 REG,6,1,6,3,4,12,0,1,-2,2,1,0,0,0,0,0,0,0,0,0.4978845547971712,0.5021154452028288
86559,0.6825396825396826,0.35714285714285715,-215,180,0.6554547745023935,0.34454522549760647,away,BAL,over,8.5,0.5412844036697247,-118,0.5189377998484975,TOR,BAL,2022 REG,7,2,7,4,6,14,0,1,-2,2,1,1,0,0,0,0,0,0,0,0.5189377998484975,0.4810622001515025
86559,0.6825396825396826,0.35714285714285715,-215,180,0.6554547745023935,0.34454522549760647,home,TOR,under,8.5,0.5,100,0.4810622001515025,TOR,BAL,2022 REG,7,2,7,4,6,14,0,1,-2,2,1,1,0,0,0,0,0,0,0,0.5189377998484975,0.4810622001515025
86560,0.4,0.6363636363636364,150,-175,0.3854545454545455,0.6145454545454545,away,SEA,over,8.5,0.5121951219512195,-105,0.48919479393107135,LAA,SEA,2022 REG,11,8,9,7,15,20,1,0,1,-1,1,1,1,1,1,1,1,0,0,0.48919479393107135,0.5108052060689287
86560,0.4,0.6363636363636364,150,-175,0.3854545454545455,0.6145454545454545,home,LAA,under,8.5,0.5327102803738317,-114,0.5108052060689287,LAA,SEA,2022 REG,11,8,9,7,15,20,1,0,1,-1,1,1,1,1,1,1,1,0,0,0.48919479393107135,0.5108052060689287
86561,0.46511627906976744,0.574468085106383,115,-135,0.44670494689481377,0.5532950531051862,away,TEX,over,11,0.5391705069124424,-117,0.5140669063204599,COL,TEX,2022 REG,9,4,18,16,20,27,0,1,-12,12,1,1,1,1,0,0,0,0,0,0.5140669063204599,0.4859330936795401
86561,0.46511627906976744,0.574468085106383,115,-135,0.44670494689481377,0.5532950531051862,home,COL,under,11,0.5073891625615764,-103,0.4859330936795401,COL,TEX,2022 REG,9,4,18,16,20,27,0,1,-12,12,1,1,1,1,0,0,0,0,0,0.5140669063204599,0.4859330936795401
86562,0.6666666666666666,0.373134328358209,-200,168,0.6401326699834162,0.3598673300165838,away,BAL,over,8.5,0.5283018867924528,-112,0.5044173060022736,NYY,BAL,2022 REG,6,2,5,0,2,11,1,0,2,-2,0,0,0,0,0,0,0,0,0,0.5044173060022736,0.49558269399772636
86562,0.6666666666666666,0.373134328358209,-200,168,0.6401326699834162,0.3598673300165838,home,NYY,under,8.5,0.5169082125603864,-107,0.49558269399772636,NYY,BAL,2022 REG,6,2,5,0,2,11,1,0,2,-2,0,0,0,0,0,0,0,0,0,0.5044173060022736,0.49558269399772636
86564,0.5833333333333333,0.4629629629629629,-140,116,0.5563271604938271,0.44367283950617287,away,MIA,over,9,0.5454545454545454,-120,0.5206611570247933,CIN,MIA,2022 REG,11,6,10,7,13,21,0,1,-1,1,1,1,1,1,1,1,0,0,0,0.5206611570247933,0.4793388429752067
86564,0.5833333333333333,0.4629629629629629,-140,116,0.5563271604938271,0.44367283950617287,home,CIN,under,9,0.5,100,0.4793388429752067,CIN,MIA,2022 REG,11,6,10,7,13,21,0,1,-1,1,1,1,1,1,1,1,0,0,0,0.5206611570247933,0.4793388429752067
86565,0.7333333333333333,0.3125,-275,220,0.6997222222222221,0.30027777777777787,away,PIT,over,8,0.5238095238095238,-110,0.5012646084074657,SF,PIT,2022 REG,13,8,11,7,15,24,1,0,1,-1,1,1,1,1,1,1,1,0,0,0.5012646084074657,0.4987353915925343
86565,0.7333333333333333,0.3125,-275,220,0.6997222222222221,0.30027777777777787,home,SF,under,8,0.5192307692307692,-108,0.4987353915925343,SF,PIT,2022 REG,13,8,11,7,15,24,1,0,1,-1,1,1,1,1,1,1,1,0,0,0.5012646084074657,0.4987353915925343
86566,0.5652173913043479,0.47619047619047616,-130,110,0.5418129444594474,0.4581870555405526,away,SD,over,8.5,0.5121951219512195,-105,0.48808156828023186,STL,SD,2022 REG,7,3,5,2,5,12,1,0,1,-1,1,1,0,0,0,0,0,0,0,0.48808156828023186,0.5119184317197681
86566,0.5652173913043479,0.47619047619047616,-130,110,0.5418129444594474,0.4581870555405526,home,STL,under,8.5,0.5348837209302326,-115,0.5119184317197681,STL,SD,2022 REG,7,3,5,2,5,12,1,0,1,-1,1,1,0,0,0,0,0,0,0,0.48808156828023186,0.5119184317197681
86567,0.7142857142857143,0.3278688524590164,-250,205,0.6841753094680495,0.3158246905319505,away,DET,over,10,0.5215311004784688,-109,0.49907282342437215,TOR,DET,2022 REG,10,5,4,3,8,14,1,0,2,-2,1,1,1,0,0,0,0,0,0,0.49907282342437215,0.5009271765756278
86567,0.7142857142857143,0.3278688524590164,-250,205,0.6841753094680495,0.3158246905319505,home,TOR,under,10,0.5215311004784688,-109,0.5009271765756278,TOR,DET,2022 REG,10,5,4,3,8,14,1,0,2,-2,1,1,1,0,0,0,0,0,0,0.49907282342437215,0.5009271765756278
86568,0.5454545454545454,0.5,-120,100,0.5206611570247933,0.4793388429752067,away,DET,over,7.5,0.5169082125603864,-107,0.49586088023391106,TEX,DET,2022 REG,9,2,18,11,13,27,0,1,-9,9,1,1,0,0,0,0,0,0,0,0.49586088023391106,0.5041391197660889
86568,0.5454545454545454,0.5,-120,100,0.5206611570247933,0.4793388429752067,home,TEX,under,7.5,0.5238095238095238,-110,0.5041391197660889,TEX,DET,2022 REG,9,2,18,11,13,27,0,1,-9,9,1,1,0,0,0,0,0,0,0,0.49586088023391106,0.5041391197660889
86569,0.4807692307692307,0.5555555555555556,108,-125,0.4633053911900066,0.5366946088099934,away,TB,over,7,0.49751243781094534,101,0.47511256217505476,OAK,TB,2022 REG,10,7,14,10,17,24,0,1,-3,3,1,1,1,1,1,1,1,0,0,0.47511256217505476,0.5248874378249453
86569,0.4807692307692307,0.5555555555555556,108,-125,0.4633053911900066,0.5366946088099934,home,OAK,under,7,0.5475113122171946,-121,0.5248874378249453,OAK,TB,2022 REG,10,7,14,10,17,24,0,1,-3,3,1,1,1,1,1,1,1,0,0,0.47511256217505476,0.5248874378249453
86570,0.6226415094339623,0.4166666666666667,-165,140,0.5981666073335706,0.40183339266642937,away,KC,over,9,0.5169082125603864,-107,0.49353874091423283,CLE,KC,2022 REG,8,7,9,3,10,17,1,0,4,-4,1,1,1,0,0,0,0,0,0,0.49353874091423283,0.5064612590857671
86570,0.6226415094339623,0.4166666666666667,-165,140,0.5981666073335706,0.40183339266642937,home,CLE,under,9,0.5283018867924528,-112,0.5064612590857671,CLE,KC,2022 REG,8,7,9,3,10,17,1,0,4,-4,1,1,1,0,0,0,0,0,0,0.49353874091423283,0.5064612590857671
86571,0.45454545454545453,0.5780590717299579,120,-137,0.439725215329358,0.560274784670642,away,LAA,over,9,0.5098039215686274,-104,0.4870219861770517,TEX,LAA,2022 REG,13,10,11,5,15,24,1,0,5,-5,1,1,1,1,1,0,0,0,0,0.4870219861770517,0.5129780138229483
86571,0.45454545454545453,0.5780590717299579,120,-137,0.439725215329358,0.560274784670642,home,TEX,under,9,0.5348837209302326,-115,0.5129780138229483,TEX,LAA,2022 REG,13,10,11,5,15,24,1,0,5,-5,1,1,1,1,1,0,0,0,0,0.4870219861770517,0.5129780138229483
86572,0.4444444444444444,0.5967741935483871,125,-148,0.42612504978096366,0.5738749502190363,away,SD,over,9,0.5169082125603864,-107,0.49353874091423283,ARI,SD,2022 REG,2,0,11,3,3,13,0,1,-3,3,0,0,0,0,0,0,0,0,0,0.49353874091423283,0.5064612590857671
86572,0.4444444444444444,0.5967741935483871,125,-148,0.42612504978096366,0.5738749502190363,home,ARI,under,9,0.5283018867924528,-112,0.5064612590857671,ARI,SD,2022 REG,2,0,11,3,3,13,0,1,-3,3,0,0,0,0,0,0,0,0,0,0.49353874091423283,0.5064612590857671
86573,0.43103448275862066,0.6108949416342413,132,-157,0.41296145500307674,0.5870385449969233,away,NYM,over,8.5,0.5475113122171946,-121,0.5242087833606768,WSH,NYM,2022 REG,4,1,5,4,5,9,0,1,-3,3,1,0,0,0,0,0,0,0,0,0.5242087833606768,0.4757912166393232
86573,0.43103448275862066,0.6108949416342413,132,-157,0.41296145500307674,0.5870385449969233,home,WSH,under,8.5,0.49504950495049505,102,0.4757912166393232,WSH,NYM,2022 REG,4,1,5,4,5,9,0,1,-3,3,1,0,0,0,0,0,0,0,0,0.5242087833606768,0.4757912166393232
86574,0.5454545454545454,0.49019607843137253,-120,104,0.526008750607681,0.47399124939231896,away,NYM,over,7.5,0.5370370370370371,-116,0.5118817074154765,PHI,NYM,2022 REG,9,2,11,7,9,20,0,1,-5,5,1,1,0,0,0,0,0,0,0,0.5118817074154765,0.48811829258452355
86574,0.5454545454545454,0.49019607843137253,-120,104,0.526008750607681,0.47399124939231896,home,PHI,under,7.5,0.5098039215686274,-104,0.48811829258452355,PHI,NYM,2022 REG,9,2,11,7,9,20,0,1,-5,5,1,1,0,0,0,0,0,0,0,0.5118817074154765,0.48811829258452355
86575,0.6923076923076923,0.3472222222222222,-225,188,0.6649408284023669,0.3350591715976331,away,PIT,over,7.5,0.5370370370370371,-116,0.5118817074154765,MIL,PIT,2022 REG,9,4,6,3,7,15,1,0,1,-1,1,1,1,0,0,0,0,0,0,0.5118817074154765,0.48811829258452355
86575,0.6923076923076923,0.3472222222222222,-225,188,0.6649408284023669,0.3350591715976331,home,MIL,under,7.5,0.5098039215686274,-104,0.48811829258452355,MIL,PIT,2022 REG,9,4,6,3,7,15,1,0,1,-1,1,1,1,0,0,0,0,0,0,0.5118817074154765,0.48811829258452355
86576,0.5633187772925764,0.47619047619047616,-129,110,0.5410624729287608,0.45893752707123925,away,CHC,over,8.5,0.5305164319248826,-113,0.5066009958897986,CIN,CHC,2022 REG,7,4,5,3,7,12,1,0,1,-1,1,1,1,0,0,0,0,0,0,0.5066009958897986,0.49339900411020143
86576,0.5633187772925764,0.47619047619047616,-129,110,0.5410624729287608,0.45893752707123925,home,CIN,under,8.5,0.5145631067961165,-106,0.49339900411020143,CIN,CHC,2022 REG,7,4,5,3,7,12,1,0,1,-1,1,1,1,0,0,0,0,0,0,0.5066009958897986,0.49339900411020143
86577,0.7619047619047619,0.28169014084507044,-320,255,0.7286895979048896,0.27131040209511037,away,WSH,over,7,0.5495495495495495,-122,0.5250401592387142,NYM,WSH,2022 REG,8,4,7,2,6,15,1,0,2,-2,1,1,0,0,0,0,0,0,0,0.5250401592387142,0.47495984076128583
86577,0.7619047619047619,0.28169014084507044,-320,255,0.7286895979048896,0.27131040209511037,home,NYM,under,7,0.49504950495049505,102,0.47495984076128583,NYM,WSH,2022 REG,8,4,7,2,6,15,1,0,2,-2,1,1,0,0,0,0,0,0,0,0.5250401592387142,0.47495984076128583
86578,0.5884773662551441,0.45454545454545453,-143,120,0.5631594099815408,0.4368405900184592,away,SEA,over,8.5,0.5454545454545454,-120,0.5193043049216726,MIN,SEA,2022 REG,10,10,7,4,14,17,1,0,6,-6,1,1,1,1,0,0,0,0,0,0.5193043049216726,0.48069569507832743
86578,0.5884773662551441,0.45454545454545453,-143,120,0.5631594099815408,0.4368405900184592,home,MIN,under,8.5,0.5024875621890548,-101,0.48069569507832743,MIN,SEA,2022 REG,10,10,7,4,14,17,1,0,6,-6,1,1,1,1,0,0,0,0,0,0.5193043049216726,0.48069569507832743
86579,0.37037037037037035,0.6721311475409836,170,-205,0.35462906744023925,0.6453709325597607,away,ATL,over,7,0.5412844036697247,-118,0.5149381613977361,CHC,ATL,2022 REG,13,6,9,3,9,22,1,0,3,-3,1,1,1,0,0,0,0,0,0,0.5149381613977361,0.48506183860226393
86579,0.37037037037037035,0.6721311475409836,170,-205,0.35462906744023925,0.6453709325597607,home,CHC,under,7,0.5073891625615764,-103,0.48506183860226393,CHC,ATL,2022 REG,13,6,9,3,9,22,1,0,3,-3,1,1,1,0,0,0,0,0,0,0.5149381613977361,0.48506183860226393
86580,0.6153846153846154,0.42016806722689076,-160,138,0.5935060414698423,0.4064939585301577,away,CIN,over,7,0.5348837209302326,-115,0.5097020142727117,CHC,CIN,2022 REG,8,6,4,1,7,12,1,0,5,-5,1,0,0,0,0,0,0,0,0,0.5097020142727117,0.49029798572728833
86580,0.6153846153846154,0.42016806722689076,-160,138,0.5935060414698423,0.4064939585301577,home,CHC,under,7,0.5121951219512195,-105,0.49029798572728833,CHC,CIN,2022 REG,8,6,4,1,7,12,1,0,5,-5,1,0,0,0,0,0,0,0,0,0.5097020142727117,0.49029798572728833
86581,0.49504950495049505,0.5555555555555556,102,-125,0.46999749479898484,0.5300025052010151,away,MIN,over,8.5,0.5169082125603864,-107,0.4946943078742622,KC,MIN,2022 REG,9,4,9,3,7,18,1,0,1,-1,1,1,1,0,0,0,0,0,0,0.4946943078742622,0.5053056921257377
86581,0.49504950495049505,0.5555555555555556,102,-125,0.46999749479898484,0.5300025052010151,home,KC,under,8.5,0.5260663507109005,-111,0.5053056921257377,KC,MIN,2022 REG,9,4,9,3,7,18,1,0,1,-1,1,1,1,0,0,0,0,0,0,0.4946943078742622,0.5053056921257377
86582,0.7409326424870467,0.29411764705882354,-286,240,0.71496273883388906,0.28503726116611094,away,PIT,over,9,0.5238095238095238,-110,0.4988662131519274,PHI,PIT,2022 REG,11,7,7,4,11,18,1,0,3,-3,1,1,1,1,0,0,0,0,0,0.4988662131519274,0.5011337868480725
86582,0.7409326424870467,0.29411764705882354,-286,240,0.71496273883388906,0.28503726116611094,home,PHI,under,9,0.5238095238095238,-110,0.5011337868480725,PHI,PIT,2022 REG,11,7,7,4,11,18,1,0,3,-3,1,1,1,1,0,0,0,0,0,0.4988662131519274,0.5011337868480725
86583,0.6363636363636364,0.4,-175,150,0.6132231404958678,0.3867768595041322,away,PHI,over,7.5,0.5098039215686274,-104,0.4870219861770517,MIL,PHI,2022 REG,11,3,9,8,11,20,0,1,-5,5,1,1,1,0,0,0,0,0,0,0.4870219861770517,0.5129780138229483
86583,0.6363636363636364,0.4,-175,150,0.6132231404958678,0.3867768595041322,home,MIL,under,7.5,0.5348837209302326,-115,0.5129780138229483,MIL,PHI,2022 REG,11,3,9,8,11,20,0,1,-5,5,1,1,1,0,0,0,0,0,0,0.4870219861770517,0.5129780138229483
86584,0.5633187772925764,0.47619047619047616,-129,110,0.5410624729287608,0.45893752707123925,away,BAL,over,9,0.5370370370370371,-116,0.5118817074154765,BOS,BAL,2022 REG,11,13,15,9,22,26,1,0,4,-4,1,1,1,1,1,1,1,1,1,0.5118817074154765,0.48811829258452355
86584,0.5633187772925764,0.47619047619047616,-129,110,0.5410624729287608,0.45893752707123925,home,BOS,under,9,0.5098039215686274,-104,0.48811829258452355,BOS,BAL,2022 REG,11,13,15,9,22,26,1,0,4,-4,1,1,1,1,1,1,1,1,1,0.5118817074154765,0.48811829258452355
86585,0.5652173913043479,0.47619047619047616,-130,110,0.5418129444594474,0.4581870555405526,away,SF,over,9.5,0.5098039215686274,-104,0.4870219861770517,PHI,SF,2022 REG,9,4,12,7,11,21,0,1,-3,3,1,1,1,1,0,0,0,0,0,0.4870219861770517,0.5129780138229483
86585,0.5652173913043479,0.47619047619047616,-130,110,0.5418129444594474,0.4581870555405526,home,PHI,under,9.5,0.5348837209302326,-115,0.5129780138229483,PHI,SF,2022 REG,9,4,12,7,11,21,0,1,-3,3,1,1,1,1,0,0,0,0,0,0.4870219861770517,0.5129780138229483
86586,0.4098360655737705,0.6323529411764706,144,-172,0.39254548903678643,0.6074545109632136,away,CLE,over,8,0.5348837209302326,-115,0.5097020142727117,DET,CLE,2022 REG,8,2,8,3,5,16,0,1,-1,1,1,1,0,0,0,0,0,0,0,0.5097020142727117,0.49029798572728833
86586,0.4098360655737705,0.6323529411764706,144,-172,0.39254548903678643,0.6074545109632136,home,DET,under,8,0.5121951219512195,-105,0.49029798572728833,DET,CLE,2022 REG,8,2,8,3,5,16,0,1,-1,1,1,1,0,0,0,0,0,0,0,0.5097020142727117,0.49029798572728833
86587,0.4444444444444444,0.5918367346938775,125,-145,0.42831947593852354,0.5716805240614764,away,TOR,over,8.5,0.5454545454545454,-120,0.5206611570247933,KC,TOR,2022 REG,13,8,12,4,12,25,1,0,4,-4,1,1,1,1,0,0,0,0,0,0.5206611570247933,0.4793388429752067
86587,0.4444444444444444,0.5918367346938775,125,-145,0.42831947593852354,0.5716805240614764,home,KC,under,8.5,0.5,100,0.4793388429752067,KC,TOR,2022 REG,13,8,12,4,12,25,1,0,4,-4,1,1,1,1,0,0,0,0,0,0.5206611570247933,0.4793388429752067
86588,0.4347826086956522,0.6000000000000001,130,-150,0.4196597353497164,0.5803402646502835,away,NYY,over,9,0.5283018867924528,-112,0.5007713302480123,BOS,NYY,2022 REG,11,11,11,6,17,22,1,0,5,-5,1,1,1,1,1,1,0,0,0,0.5007713302480123,0.49922866975198765
86588,0.4347826086956522,0.6000000000000001,130,-150,0.4196597353497164,0.5803402646502835,home,BOS,under,9,0.5238095238095238,-110,0.49922866975198765,BOS,NYY,2022 REG,11,11,11,6,17,22,1,0,5,-5,1,1,1,1,1,1,0,0,0,0.5007713302480123,0.49922866975198765
86589,0.5689655172413793,0.4672897196261683,-132,114,0.5483375376443265,0.45166246235567353,away,BOS,over,7.5,0.5121951219512195,-105,0.48808156828023186,LAA,BOS,2022 REG,8,5,6,2,7,14,1,0,3,-3,1,1,0,0,0,0,0,0,0,0.48808156828023186,0.5119184317197681
86589,0.5689655172413793,0.4672897196261683,-132,114,0.5483375376443265,0.45166246235567353,home,LAA,under,7.5,0.5348837209302326,-115,0.5119184317197681,LAA,BOS,2022 REG,8,5,6,2,7,14,1,0,3,-3,1,1,0,0,0,0,0,0,0,0.48808156828023186,0.5119184317197681
86590,0.7590361445783133,0.28169014084507044,-315,255,0.7281234219075522,0.2718765780924478,away,COL,over,7.5,0.5145631067961165,-106,0.4913668392989033,MIL,COL,2022 REG,11,6,9,5,11,20,1,0,1,-1,1,1,1,1,1,0,0,0,0,0.4913668392989033,0.5086331607010968
86590,0.7590361445783133,0.28169014084507044,-315,255,0.7281234219075522,0.2718765780924478,home,MIL,under,7.5,0.5305164319248826,-113,0.5086331607010968,MIL,COL,2022 REG,11,6,9,5,11,20,1,0,1,-1,1,1,1,1,1,0,0,0,0,0.4913668392989033,0.5086331607010968
86591,0.3623188405797102,0.6774193548387096,176,-210,0.34792094368897836,0.6520790563110217,away,NYY,over,8.5,0.5412844036697247,-118,0.5149381613977361,PIT,NYY,2022 REG,4,0,22,16,16,26,0,1,-16,16,0,0,0,0,0,0,0,0,0,0.5149381613977361,0.48506183860226393
86591,0.3623188405797102,0.6774193548387096,176,-210,0.34792094368897836,0.6520790563110217,home,PIT,under,8.5,0.5073891625615764,-103,0.48506183860226393,PIT,NYY,2022 REG,4,0,22,16,16,26,0,1,-16,16,0,0,0,0,0,0,0,0,0,0.5149381613977361,0.48506183860226393
86592,0.4,0.6402877697841727,150,-178,0.383884892086331,0.6161151079136691,away,SEA,over,7.5,0.5454545454545454,-120,0.5206611570247933,LAA,SEA,2022 REG,7,2,9,8,10,16,0,1,-6,6,1,1,0,0,0,0,0,0,0,0.5206611570247933,0.4793388429752067
86592,0.4,0.6402877697841727,150,-178,0.383884892086331,0.6161151079136691,home,LAA,under,7.5,0.5,100,0.4793388429752067,LAA,SEA,2022 REG,7,2,9,8,10,16,0,1,-6,6,1,1,0,0,0,0,0,0,0,0.5206611570247933,0.4793388429752067
86593,0.45454545454545453,0.5833333333333333,120,-140,0.43732782369146006,0.5626721763085399,away,CLE,over,8.5,0.5454545454545454,-120,0.5206611570247933,KC,CLE,2022 REG,7,1,23,13,14,30,0,1,-12,12,1,0,0,0,0,0,0,0,0,0.5206611570247933,0.4793388429752067
86593,0.45454545454545453,0.5833333333333333,120,-140,0.43732782369146006,0.5626721763085399,home,KC,under,8.5,0.5,100,0.4793388429752067,KC,CLE,2022 REG,7,1,23,13,14,30,0,1,-12,12,1,0,0,0,0,0,0,0,0,0.5206611570247933,0.4793388429752067
86594,0.6610169491525424,0.3802281368821293,-195,163,0.6337532482143695,0.3662467517856305,away,DET,over,8,0.5412844036697247,-118,0.5175913212324037,MIN,DET,2022 REG,7,2,8,4,6,15,0,1,-2,2,1,1,0,0,0,0,0,0,0,0.5175913212324037,0.4824086787675963
86594,0.6610169491525424,0.3802281368821293,-195,163,0.6337532482143695,0.3662467517856305,home,MIN,under,8,0.5024875621890548,-101,0.4824086787675963,MIN,DET,2022 REG,7,2,8,4,6,15,0,1,-2,2,1,1,0,0,0,0,0,0,0,0.5175913212324037,0.4824086787675963
86595,0.6363636363636364,0.4065040650406504,-175,146,0.6090841900154538,0.3909158099845462,away,CHC,over,7.5,0.5283018867924528,-112,0.5044173060022736,CWS,CHC,2022 REG,10,5,5,4,9,15,1,0,1,-1,1,1,1,1,0,0,0,0,0,0.5044173060022736,0.49558269399772636
86595,0.6363636363636364,0.4065040650406504,-175,146,0.6090841900154538,0.3909158099845462,home,CWS,under,7.5,0.5169082125603864,-107,0.49558269399772636,CWS,CHC,2022 REG,10,5,5,4,9,15,1,0,1,-1,1,1,1,1,0,0,0,0,0,0.5044173060022736,0.49558269399772636
86596,0.3508771929824561,0.6875,185,-220,0.3374115112342259,0.662588488765774,away,NYY,over,7.5,0.5283018867924528,-112,0.5031902949311281,OAK,NYY,2022 REG,8,4,20,13,17,28,0,1,-9,9,1,1,1,1,0,0,0,0,0,0.5031902949311281,0.4968097050688719
86596,0.3508771929824561,0.6875,185,-220,0.3374115112342259,0.662588488765774,home,OAK,under,7.5,0.5192307692307692,-108,0.4968097050688719,OAK,NYY,2022 REG,8,4,20,13,17,28,0,1,-9,9,1,1,1,1,0,0,0,0,0,0.5031902949311281,0.4968097050688719
86597,0.5535714285714286,0.4807692307692307,-124,108,0.5345614207221351,0.4654385792778649,away,ARI,over,8.5,0.5391705069124424,-117,0.5015973647743455,WSH,ARI,2022 REG,4,1,5,0,1,9,1,0,1,-1,0,0,0,0,0,0,0,0,0,0.5015973647743455,0.49840263522565453
86597,0.5535714285714286,0.4807692307692307,-124,108,0.5345614207221351,0.4654385792778649,home,WSH,under,8.5,0.5305164319248826,-113,0.49840263522565453,WSH,ARI,2022 REG,4,1,5,0,1,9,1,0,1,-1,0,0,0,0,0,0,0,0,0,0.5015973647743455,0.49840263522565453
86598,0.6031746031746031,0.43859649122807015,-152,128,0.5779793398841018,0.4220206601158982,away,STL,over,8.5,0.5169082125603864,-107,0.49239402434819424,MIL,STL,2022 REG,6,1,14,10,11,20,0,1,-9,9,1,0,0,0,0,0,0,0,0,0.49239402434819424,0.5076059756518058
86598,0.6031746031746031,0.43859649122807015,-152,128,0.5779793398841018,0.4220206601158982,home,MIL,under,8.5,0.5305164319248826,-113,0.5076059756518058,MIL,STL,2022 REG,6,1,14,10,11,20,0,1,-9,9,1,0,0,0,0,0,0,0,0,0.49239402434819424,0.5076059756518058
86599,0.48780487804878053,0.5535714285714286,105,-124,0.4676213138438005,0.5323786861561994,away,SEA,over,8,0.5192307692307692,-108,0.49688292476754015,TEX,SEA,2022 REG,7,3,5,4,7,12,0,1,-1,1,1,1,1,0,0,0,0,0,0,0.49688292476754015,0.5031170752324599
86599,0.48780487804878053,0.5535714285714286,105,-124,0.4676213138438005,0.5323786861561994,home,TEX,under,8,0.5238095238095238,-110,0.5031170752324599,TEX,SEA,2022 REG,7,3,5,4,7,12,0,1,-1,1,1,1,1,0,0,0,0,0,0,0.49688292476754015,0.5031170752324599
86600,0.6453900709219857,0.3921568627450981,-182,155,0.6211576527396834,0.3788423472603166,away,DET,over,7,0.5475113122171946,-121,0.5242087833606768,MIN,DET,2022 REG,9,5,2,0,5,11,1,0,5,-5,0,0,0,0,0,0,0,0,0,0.5242087833606768,0.4757912166393232
86600,0.6453900709219857,0.3921568627450981,-182,155,0.6211576527396834,0.3788423472603166,home,MIN,under,7,0.49504950495049505,102,0.4757912166393232,MIN,DET,2022 REG,9,5,2,0,5,11,1,0,5,-5,0,0,0,0,0,0,0,0,0,0.5242087833606768,0.4757912166393232
86601,0.6153846153846154,0.42016806722689076,-160,138,0.5935060414698423,0.4064939585301577,away,CWS,over,8.5,0.5305164319248826,-113,0.5053568787472517,MIN,CWS,2022 REG,11,2,17,12,14,28,0,1,-10,10,1,1,0,0,0,0,0,0,0,0.5053568787472517,0.49464312125274834
86601,0.6153846153846154,0.42016806722689076,-160,138,0.5935060414698423,0.4064939585301577,home,MIN,under,8.5,0.5169082125603864,-107,0.49464312125274834,MIN,CWS,2022 REG,11,2,17,12,14,28,0,1,-10,10,1,1,0,0,0,0,0,0,0,0.5053568787472517,0.49464312125274834
86602,0.613899613899614,0.425531914893617,-159,135,0.589692613597978,0.410307386402022,away,HOU,over,7.5,0.5215311004784688,-109,0.49907282342437215,TOR,HOU,2022 REG,3,3,8,2,5,11,1,0,1,-1,1,1,0,0,0,0,0,0,0,0.49907282342437215,0.5009271765756278
86602,0.613899613899614,0.425531914893617,-159,135,0.589692613597978,0.410307386402022,home,TOR,under,7.5,0.5215311004784688,-109,0.5009271765756278,TOR,HOU,2022 REG,3,3,8,2,5,11,1,0,1,-1,1,1,0,0,0,0,0,0,0,0.49907282342437215,0.5009271765756278
86603,0.4347826086956522,0.607843137254902,130,-155,0.41624967567367205,0.583750324326328,away,NYY,over,8,0.5121951219512195,-105,0.48808156828023186,TEX,NYY,2022 REG,2,1,8,3,4,10,0,1,-2,2,1,0,0,0,0,0,0,0,0,0.48808156828023186,0.5119184317197681
86603,0.4347826086956522,0.607843137254902,130,-155,0.41624967567367205,0.583750324326328,home,TEX,under,8,0.5348837209302326,-115,0.5119184317197681,TEX,NYY,2022 REG,2,1,8,3,4,10,0,1,-2,2,1,0,0,0,0,0,0,0,0,0.48808156828023186,0.5119184317197681
86604,0.4166666666666667,0.6226415094339623,140,-165,0.4002882599580712,0.5997117400419287,away,NYY,over,9,0.5215311004784688,-109,0.4978845547971712,BOS,NYY,2022 REG,10,6,10,5,11,20,1,0,1,-1,1,1,1,1,1,0,0,0,0,0.4978845547971712,0.5021154452028288
86604,0.4166666666666667,0.6226415094339623,140,-165,0.4002882599580712,0.5997117400419287,home,BOS,under,9,0.5238095238095238,-110,0.5021154452028288,BOS,NYY,2022 REG,10,6,10,5,11,20,1,0,1,-1,1,1,1,1,1,0,0,0,0,0.4978845547971712,0.5021154452028288
86605,0.4629629629629629,0.576271186440678,116,-136,0.4447990049057217,0.5552009950942782,away,ATL,over,9,0.5215311004784688,-109,0.49907282342437215,TEX,ATL,2022 REG,11,7,6,3,10,17,1,0,4,-4,1,1,1,0,0,0,0,0,0,0.49907282342437215,0.5009271765756278
86605,0.4629629629629629,0.576271186440678,116,-136,0.4447990049057217,0.5552009950942782,home,TEX,under,9,0.5215311004784688,-109,0.5009271765756278,TEX,ATL,2022 REG,11,7,6,3,10,17,1,0,4,-4,1,1,1,0,0,0,0,0,0,0.49907282342437215,0.5009271765756278
86606,0.6721311475409836,0.37037037037037035,-205,170,0.6435645535349916,0.35643544646500835,away,KC,over,6.5,0.5121951219512195,-105,0.48808156828023186,TB,KC,2022 REG,6,2,4,3,5,10,0,1,-1,1,1,1,0,0,0,0,0,0,0,0.48808156828023186,0.5119184317197681
86606,0.6721311475409836,0.37037037037037035,-205,170,0.6435645535349916,0.35643544646500835,home,TB,under,6.5,0.5348837209302326,-115,0.5119184317197681,TB,KC,2022 REG,6,2,4,3,5,10,0,1,-1,1,1,1,0,0,0,0,0,0,0,0.48808156828023186,0.5119184317197681
86607,0.6226415094339623,0.4166666666666667,-165,140,0.5981666073335706,0.40183339266642937,away,STL,over,7,0.5327102803738317,-114,0.508788710910954,NYM,STL,2022 REG,11,7,13,6,13,24,1,0,1,-1,1,1,1,1,1,1,0,0,0,0.508788710910954,0.491211289089046
86607,0.6226415094339623,0.4166666666666667,-165,140,0.5981666073335706,0.40183339266642937,home,NYM,under,7,0.5121951219512195,-105,0.491211289089046,NYM,STL,2022 REG,11,7,13,6,13,24,1,0,1,-1,1,1,1,1,1,1,0,0,0,0.508788710910954,0.491211289089046
86608,0.46511627906976744,0.5833333333333333,115,-140,0.44258157562646483,0.5574184243735352,away,MIA,over,8,0.5348837209302326,-115,0.5097020142727117,ARI,MIA,2022 REG,11,9,9,3,12,20,1,0,6,-6,1,1,1,0,0,0,0,0,0,0.5097020142727117,0.49029798572728833
86608,0.46511627906976744,0.5833333333333333,115,-140,0.44258157562646483,0.5574184243735352,home,ARI,under,8,0.5121951219512195,-105,0.49029798572728833,ARI,MIA,2022 REG,11,9,9,3,12,20,1,0,6,-6,1,1,1,0,0,0,0,0,0,0.5097020142727117,0.49029798572728833
86609,0.5689655172413793,0.4672897196261683,-132,114,0.5483375376443265,0.45166246235567353,away,SD,over,8,0.5098039215686274,-104,0.48592421718142587,NYM,SD,2022 REG,12,8,13,5,13,25,1,0,3,-3,1,1,1,1,1,0,0,0,0,0.48592421718142587,0.5140757828185741
86609,0.5689655172413793,0.4672897196261683,-132,114,0.5483375376443265,0.45166246235567353,home,NYM,under,8,0.5370370370370371,-116,0.5140757828185741,NYM,SD,2022 REG,12,8,13,5,13,25,1,0,3,-3,1,1,1,1,1,0,0,0,0,0.48592421718142587,0.5140757828185741
86610,0.3921568627450981,0.647887323943662,155,-184,0.37645326012205493,0.6235467398779451,away,PHI,over,9,0.5348837209302326,-115,0.5097020142727117,CIN,PHI,2022 REG,9,3,12,4,7,21,0,1,-1,1,1,1,1,0,0,0,0,0,0,0.5097020142727117,0.49029798572728833
86610,0.3921568627450981,0.647887323943662,155,-184,0.37645326012205493,0.6235467398779451,home,CIN,under,9,0.5121951219512195,-105,0.49029798572728833,CIN,PHI,2022 REG,9,3,12,4,7,21,0,1,-1,1,1,1,1,0,0,0,0,0,0,0.5097020142727117,0.49029798572728833
86611,0.5967741935483871,0.4444444444444444,-148,125,0.5721759741010521,0.42782402589894786,away,STL,over,7.5,0.5283018867924528,-112,0.5044173060022736,TB,STL,2022 REG,3,4,9,2,6,12,1,0,2,-2,1,1,0,0,0,0,0,0,0,0.5044173060022736,0.49558269399772636
86611,0.5967741935483871,0.4444444444444444,-148,125,0.5721759741010521,0.42782402589894786,home,TB,under,7.5,0.5169082125603864,-107,0.49558269399772636,TB,STL,2022 REG,3,4,9,2,6,12,1,0,2,-2,1,1,0,0,0,0,0,0,0,0.5044173060022736,0.49558269399772636
86612,0.6666666666666666,0.37735849056603776,-200,165,0.6373165618448637,0.36268343815513626,away,LAA,over,7,0.5121951219512195,-105,0.48808156828023186,SEA,LAA,2022 REG,6,3,8,4,7,14,0,1,-1,1,1,1,1,0,0,0,0,0,0,0.48808156828023186,0.5119184317197681
86612,0.6666666666666666,0.37735849056603776,-200,165,0.6373165618448637,0.36268343815513626,home,SEA,under,7,0.5348837209302326,-115,0.5119184317197681,SEA,LAA,2022 REG,6,3,8,4,7,14,0,1,-1,1,1,1,1,0,0,0,0,0,0,0.48808156828023186,0.5119184317197681
86613,0.6610169491525424,0.37735849056603776,-195,165,0.6356501330673793,0.3643498669326207,away,TEX,over,9.5,0.5024875621890548,-101,0.48049269377245407,BOS,TEX,2022 REG,13,9,6,1,10,19,1,0,8,-8,1,0,0,0,0,0,0,0,0,0.48049269377245407,0.5195073062275459
86613,0.6610169491525424,0.37735849056603776,-195,165,0.6356501330673793,0.3643498669326207,home,BOS,under,9.5,0.5412844036697247,-118,0.5195073062275459,BOS,TEX,2022 REG,13,9,6,1,10,19,1,0,8,-8,1,0,0,0,0,0,0,0,0,0.48049269377245407,0.5195073062275459
86614,0.6226415094339623,0.42016806722689076,-165,138,0.5959864900036198,0.4040135099963802,away,BOS,over,8.5,0.5121951219512195,-105,0.48808156828023186,TOR,BOS,2022 REG,10,5,8,6,11,18,0,1,-1,1,1,1,1,1,1,0,0,0,0,0.48808156828023186,0.5119184317197681
86614,0.6226415094339623,0.42016806722689076,-165,138,0.5959864900036198,0.4040135099963802,home,TOR,under,8.5,0.5348837209302326,-115,0.5119184317197681,TOR,BOS,2022 REG,10,5,8,6,11,18,0,1,-1,1,1,1,1,1,1,0,0,0,0,0.48808156828023186,0.5119184317197681
86615,0.46511627906976744,0.576271186440678,115,-136,0.44586629511142073,0.5541337048885793,away,HOU,over,7,0.5475113122171946,-121,0.5214983313199976,OAK,HOU,2022 REG,8,1,7,3,4,15,0,1,-2,2,1,0,0,0,0,0,0,0,0,0.5214983313199976,0.47850166868000243
86615,0.46511627906976744,0.576271186440678,115,-136,0.44586629511142073,0.5541337048885793,home,OAK,under,7,0.5,100,0.47850166868000243,OAK,HOU,2022 REG,8,1,7,3,4,15,0,1,-2,2,1,0,0,0,0,0,0,0,0,0.5214983313199976,0.47850166868000243
86616,0.5169082125603864,0.5215311004784688,-107,-109,0.49703861596542265,0.5029613840345774,away,MIL,over,6.5,0.5238095238095238,-110,0.5000596729920038,ATL,MIL,2022 REG,8,3,7,2,5,15,1,0,1,-1,1,1,0,0,0,0,0,0,0,0.5000596729920038,0.4999403270079962
86616,0.5169082125603864,0.5215311004784688,-107,-109,0.49703861596542265,0.5029613840345774,home,ATL,under,6.5,0.5215311004784688,-109,0.4999403270079962,ATL,MIL,2022 REG,8,3,7,2,5,15,1,0,1,-1,1,1,0,0,0,0,0,0,0,0.5000596729920038,0.4999403270079962
86617,0.6551724137931035,0.38759689922480617,-190,158,0.6271511397468869,0.37284886025311315,away,PIT,over,7,0.5238095238095238,-110,0.5000596729920038,STL,PIT,2022 REG,10,5,9,7,12,19,0,1,-2,2,1,1,1,1,1,0,0,0,0,0.5000596729920038,0.4999403270079962
86617,0.6551724137931035,0.38759689922480617,-190,158,0.6271511397468869,0.37284886025311315,home,STL,under,7,0.5215311004784688,-109,0.4999403270079962,STL,PIT,2022 REG,10,5,9,7,12,19,0,1,-2,2,1,1,1,1,1,0,0,0,0,0.5000596729920038,0.4999403270079962
86618,0.6825396825396826,0.35714285714285715,-215,180,0.6554547745023935,0.34454522549760647,away,COL,over,7.5,0.5238095238095238,-110,0.5000596729920038,SD,COL,2022 REG,6,4,7,1,5,13,1,0,3,-3,1,0,0,0,0,0,0,0,0,0.5000596729920038,0.4999403270079962
86618,0.6825396825396826,0.35714285714285715,-215,180,0.6554547745023935,0.34454522549760647,home,SD,under,7.5,0.5215311004784688,-109,0.4999403270079962,SD,COL,2022 REG,6,4,7,1,5,13,1,0,3,-3,1,0,0,0,0,0,0,0,0,0.5000596729920038,0.4999403270079962
86619,0.45454545454545453,0.5833333333333333,120,-140,0.43732782369146006,0.5626721763085399,away,MIL,over,11.5,0.5121951219512195,-105,0.48808156828023186,CHC,MIL,2022 REG,12,6,7,7,13,19,0,1,-1,1,1,1,1,1,1,1,0,0,0,0.48808156828023186,0.5119184317197681
86619,0.45454545454545453,0.5833333333333333,120,-140,0.43732782369146006,0.5626721763085399,home,CHC,under,11.5,0.5348837209302326,-115,0.5119184317197681,CHC,MIL,2022 REG,12,6,7,7,13,19,0,1,-1,1,1,1,1,1,1,1,0,0,0,0.48808156828023186,0.5119184317197681
86620,0.5283018867924528,0.5121951219512195,-112,-105,0.5069072406637203,0.4930927593362797,away,TOR,over,8.5,0.5121951219512195,-105,0.48919479393107135,PHI,TOR,2022 REG,12,4,7,3,7,19,1,0,1,-1,1,1,1,0,0,0,0,0,0,0.48919479393107135,0.5108052060689287
86620,0.5283018867924528,0.5121951219512195,-112,-105,0.5069072406637203,0.4930927593362797,home,PHI,under,8.5,0.5327102803738317,-114,0.5108052060689287,PHI,TOR,2022 REG,12,4,7,3,7,19,1,0,1,-1,1,1,1,0,0,0,0,0,0,0.48919479393107135,0.5108052060689287
86621,0.576271186440678,0.46511627906976744,-136,115,0.552420782587201,0.44757921741279905,away,SF,over,7,0.5454545454545454,-120,0.5206611570247933,MIA,SF,2022 REG,7,3,3,0,3,10,1,0,3,-3,0,0,0,0,0,0,0,0,0,0.5206611570247933,0.4793388429752067
86621,0.576271186440678,0.46511627906976744,-136,115,0.552420782587201,0.44757921741279905,home,MIA,under,7,0.5,100,0.4793388429752067,MIA,SF,2022 REG,7,3,3,0,3,10,1,0,3,-3,0,0,0,0,0,0,0,0,0,0.5206611570247933,0.4793388429752067
86622,0.6721311475409836,0.36363636363636365,-205,175,0.6480906892086682,0.3519093107913318,away,CHC,over,7.5,0.5283018867924528,-112,0.5031902949311281,NYM,CHC,2022 REG,8,3,7,6,9,15,0,1,-3,3,1,1,1,0,0,0,0,0,0,0.5031902949311281,0.4968097050688719
86622,0.6721311475409836,0.36363636363636365,-205,175,0.6480906892086682,0.3519093107913318,home,NYM,under,7.5,0.5192307692307692,-108,0.4968097050688719,NYM,CHC,2022 REG,8,3,7,6,9,15,0,1,-3,3,1,1,1,0,0,0,0,0,0,0.5031902949311281,0.4968097050688719
86623,0.4484304932735426,0.5884773662551441,123,-143,0.43187988361942303,0.5681201163805769,away,TEX,over,9,0.5,100,0.4783105022831051,KC,TEX,2022 REG,8,4,15,10,14,23,0,1,-6,6,1,1,1,1,0,0,0,0,0,0.4783105022831051,0.5216894977168949
86623,0.4484304932735426,0.5884773662551441,123,-143,0.43187988361942303,0.5681201163805769,home,KC,under,9,0.5433789954337899,-119,0.5216894977168949,KC,TEX,2022 REG,8,4,15,10,14,23,0,1,-6,6,1,1,1,1,0,0,0,0,0,0.4783105022831051,0.5216894977168949
86624,0.6363636363636364,0.40322580645161293,-175,148,0.6111703545721141,0.3888296454278859,away,PIT,over,7,0.5238095238095238,-110,0.4988662131519274,MIA,PIT,2022 REG,7,5,6,4,9,13,1,0,1,-1,1,1,1,1,0,0,0,0,0,0.4988662131519274,0.5011337868480725
86624,0.6363636363636364,0.40322580645161293,-175,148,0.6111703545721141,0.3888296454278859,home,MIA,under,7,0.5238095238095238,-110,0.5011337868480725,MIA,PIT,2022 REG,7,5,6,4,9,13,1,0,1,-1,1,1,1,1,0,0,0,0,0,0.4988662131519274,0.5011337868480725
86625,0.42016806722689076,0.6153846153846154,138,-160,0.4052299652892831,0.5947700347107169,away,MIL,over,9,0.5475113122171946,-121,0.5228602997583487,WSH,MIL,2022 REG,9,8,11,6,14,20,1,0,2,-2,1,1,1,1,1,1,0,0,0,0.5228602997583487,0.4771397002416513
86625,0.42016806722689076,0.6153846153846154,138,-160,0.4052299652892831,0.5947700347107169,home,WSH,under,9,0.49751243781094534,101,0.4771397002416513,WSH,MIL,2022 REG,9,8,11,6,14,20,1,0,2,-2,1,1,1,1,1,1,0,0,0,0.5228602997583487,0.4771397002416513
86626,0.47619047619047616,0.5652173913043479,110,-130,0.4564724440500838,0.5435275559499162,away,LAD,over,8,0.5348837209302326,-115,0.5097020142727117,SD,LAD,2022 REG,6,2,12,11,13,18,0,1,-9,9,1,1,0,0,0,0,0,0,0,0.5097020142727117,0.49029798572728833
86626,0.47619047619047616,0.5652173913043479,110,-130,0.4564724440500838,0.5435275559499162,home,SD,under,8,0.5121951219512195,-105,0.49029798572728833,SD,LAD,2022 REG,6,2,12,11,13,18,0,1,-9,9,1,1,0,0,0,0,0,0,0,0.5097020142727117,0.49029798572728833
86627,0.5454545454545454,0.49019607843137253,-120,104,0.526008750607681,0.47399124939231896,away,SD,over,7.5,0.5327102803738317,-114,0.5075272610403079,SF,SD,2022 REG,15,13,5,2,15,20,1,0,11,-11,1,1,0,0,0,0,0,0,0,0.5075272610403079,0.4924727389596921
86627,0.5454545454545454,0.49019607843137253,-120,104,0.526008750607681,0.47399124939231896,home,SF,under,7.5,0.5145631067961165,-106,0.4924727389596921,SF,SD,2022 REG,15,13,5,2,15,20,1,0,11,-11,1,1,0,0,0,0,0,0,0,0.5075272610403079,0.4924727389596921
86628,0.6875,0.35714285714285715,-220,180,0.6568080357142857,0.3431919642857143,away,CHC,over,7.5,0.5348837209302326,-115,0.5097020142727117,TOR,CHC,2022 REG,6,5,7,3,8,13,1,0,2,-2,1,1,1,0,0,0,0,0,0,0.5097020142727117,0.49029798572728833
86628,0.6875,0.35714285714285715,-220,180,0.6568080357142857,0.3431919642857143,home,TOR,under,7.5,0.5121951219512195,-105,0.49029798572728833,TOR,CHC,2022 REG,6,5,7,3,8,13,1,0,2,-2,1,1,1,0,0,0,0,0,0,0.5097020142727117,0.49029798572728833
86629,0.45454545454545453,0.5918367346938775,120,-145,0.433462641254849,0.566537358745151,away,MIN,over,9,0.5305164319248826,-113,0.5066009958897986,DET,MIN,2022 REG,8,2,9,8,10,17,0,1,-6,6,1,1,0,0,0,0,0,0,0,0.5066009958897986,0.49339900411020143
86629,0.45454545454545453,0.5918367346938775,120,-145,0.433462641254849,0.566537358745151,home,DET,under,9,0.5145631067961165,-106,0.49339900411020143,DET,MIN,2022 REG,8,2,9,8,10,17,0,1,-6,6,1,1,0,0,0,0,0,0,0,0.5066009958897986,0.49339900411020143
86630,0.6000000000000001,0.43859649122807015,-150,128,0.5768421052631579,0.42315789473684207,away,SD,over,8,0.5238095238095238,-110,0.4988662131519274,PHI,SD,2022 REG,5,3,4,0,3,9,1,0,3,-3,0,0,0,0,0,0,0,0,0,0.4988662131519274,0.5011337868480725
86630,0.6000000000000001,0.43859649122807015,-150,128,0.5768421052631579,0.42315789473684207,home,PHI,under,8,0.5238095238095238,-110,0.5011337868480725,PHI,SD,2022 REG,5,3,4,0,3,9,1,0,3,-3,0,0,0,0,0,0,0,0,0,0.4988662131519274,0.5011337868480725
86631,0.4444444444444444,0.5967741935483871,125,-148,0.42612504978096366,0.5738749502190363,away,ATL,over,9.5,0.5348837209302326,-115,0.5097020142727117,WSH,ATL,2022 REG,10,5,10,9,14,20,0,1,-4,4,1,1,1,1,1,0,0,0,0,0.5097020142727117,0.49029798572728833
86631,0.4444444444444444,0.5967741935483871,125,-148,0.42612504978096366,0.5738749502190363,home,WSH,under,9.5,0.5121951219512195,-105,0.49029798572728833,WSH,ATL,2022 REG,10,5,10,9,14,20,0,1,-4,4,1,1,1,1,1,0,0,0,0,0.5097020142727117,0.49029798572728833
86632,0.5495495495495495,0.48780487804878053,-122,105,0.529021440689206,0.470978559310794,away,BAL,over,10,0.5192307692307692,-108,0.49571111079951763,BOS,BAL,2022 REG,15,8,14,14,22,29,0,1,-6,6,1,1,1,1,1,1,1,1,0,0.49571111079951763,0.5042888892004824
86632,0.5495495495495495,0.48780487804878053,-122,105,0.529021440689206,0.470978559310794,home,BOS,under,10,0.5260663507109005,-111,0.5042888892004824,BOS,BAL,2022 REG,15,8,14,14,22,29,0,1,-6,6,1,1,1,1,1,1,1,1,0,0.49571111079951763,0.5042888892004824
86633,0.4672897196261683,0.5689655172413793,114,-132,0.4503480201553517,0.5496519798446483,away,HOU,over,7,0.5121951219512195,-105,0.48808156828023186,CWS,HOU,2022 REG,10,4,9,3,7,19,1,0,1,-1,1,1,1,0,0,0,0,0,0,0.48808156828023186,0.5119184317197681
86633,0.4672897196261683,0.5689655172413793,114,-132,0.4503480201553517,0.5496519798446483,home,CWS,under,7,0.5348837209302326,-115,0.5119184317197681,CWS,HOU,2022 REG,10,4,9,3,7,19,1,0,1,-1,1,1,1,0,0,0,0,0,0,0.48808156828023186,0.5119184317197681
86634,0.31746031746031744,0.7183098591549296,215,-255,0.30610470583642946,0.6938952941635705,away,TB,over,7.5,0.5,100,0.4772727272727273,DET,TB,2022 REG,12,9,9,1,10,21,1,0,8,-8,1,0,0,0,0,0,0,0,0,0.4772727272727273,0.5227272727272727
86634,0.31746031746031744,0.7183098591549296,215,-255,0.30610470583642946,0.6938952941635705,home,DET,under,7.5,0.5454545454545454,-120,0.5227272727272727,DET,TB,2022 REG,12,9,9,1,10,21,1,0,8,-8,1,0,0,0,0,0,0,0,0,0.4772727272727273,0.5227272727272727
86635,0.6031746031746031,0.43859649122807015,-152,128,0.5779793398841018,0.4220206601158982,away,CHC,over,9,0.5121951219512195,-105,0.48808156828023186,PIT,CHC,2022 REG,7,7,6,1,8,13,1,0,6,-6,1,0,0,0,0,0,0,0,0,0.48808156828023186,0.5119184317197681
86635,0.6031746031746031,0.43859649122807015,-152,128,0.5779793398841018,0.4220206601158982,home,PIT,under,9,0.5348837209302326,-115,0.5119184317197681,PIT,CHC,2022 REG,7,7,6,1,8,13,1,0,6,-6,1,0,0,0,0,0,0,0,0,0.48808156828023186,0.5119184317197681
86636,0.4347826086956522,0.6031746031746031,130,-152,0.418279473099889,0.581720526900111,away,CLE,over,7.5,0.5073891625615764,-103,0.4837652908580103,DET,CLE,2022 REG,10,1,11,8,9,21,0,1,-7,7,1,0,0,0,0,0,0,0,0,0.4837652908580103,0.5162347091419897
86636,0.4347826086956522,0.6031746031746031,130,-152,0.418279473099889,0.581720526900111,home,DET,under,7.5,0.5391705069124424,-117,0.5162347091419897,DET,CLE,2022 REG,10,1,11,8,9,21,0,1,-7,7,1,0,0,0,0,0,0,0,0,0.4837652908580103,0.5162347091419897
86637,0.7142857142857143,0.3225806451612903,-250,210,0.6879526003949967,0.3120473996050033,away,CIN,over,9.5,0.49504950495049505,102,0.4739797934813417,LAD,CIN,2022 REG,7,3,5,1,4,12,1,0,2,-2,1,0,0,0,0,0,0,0,0,0.4739797934813417,0.5260202065186583
86637,0.7142857142857143,0.3225806451612903,-250,210,0.6879526003949967,0.3120473996050033,home,LAD,under,9.5,0.5475113122171946,-121,0.5260202065186583,LAD,CIN,2022 REG,7,3,5,1,4,12,1,0,2,-2,1,0,0,0,0,0,0,0,0,0.4739797934813417,0.5260202065186583
86638,0.48780487804878053,0.5535714285714286,105,-124,0.4676213138438005,0.5323786861561994,away,HOU,over,8,0.5283018867924528,-112,0.5044173060022736,NYM,HOU,2022 REG,8,1,12,9,10,20,0,1,-8,8,1,0,0,0,0,0,0,0,0,0.5044173060022736,0.49558269399772636
86638,0.48780487804878053,0.5535714285714286,105,-124,0.4676213138438005,0.5323786861561994,home,NYM,under,8,0.5169082125603864,-107,0.49558269399772636,NYM,HOU,2022 REG,8,1,12,9,10,20,0,1,-8,8,1,0,0,0,0,0,0,0,0,0.5044173060022736,0.49558269399772636
86639,0.5726495726495727,0.4672897196261683,-134,114,0.5497783539959433,0.4502216460040567,away,MIA,over,7.5,0.5145631067961165,-106,0.4925063625223866,STL,MIA,2022 REG,11,9,8,0,9,19,1,0,9,-9,0,0,0,0,0,0,0,0,0,0.4925063625223866,0.5074936374776133
86639,0.5726495726495727,0.4672897196261683,-134,114,0.5497783539959433,0.4502216460040567,home,STL,under,7.5,0.5283018867924528,-112,0.5074936374776133,STL,MIA,2022 REG,11,9,8,0,9,19,1,0,9,-9,0,0,0,0,0,0,0,0,0,0.4925063625223866,0.5074936374776133
86640,0.5689655172413793,0.4629629629629629,-132,116,0.5507993129871847,0.44920068701281535,away,PHI,over,8,0.5121951219512195,-105,0.48808156828023186,NYM,PHI,2022 REG,9,8,9,6,14,18,1,0,2,-2,1,1,1,1,1,1,0,0,0,0.48808156828023186,0.5119184317197681
86640,0.5689655172413793,0.4629629629629629,-132,116,0.5507993129871847,0.44920068701281535,home,NYM,under,8,0.5348837209302326,-115,0.5119184317197681,NYM,PHI,2022 REG,9,8,9,6,14,18,1,0,2,-2,1,1,1,1,1,1,0,0,0,0.48808156828023186,0.5119184317197681
86641,0.45454545454545453,0.5815899581589958,120,-139,0.43812026695252254,0.5618797330474774,away,SD,over,9,0.5192307692307692,-108,0.49455035168025013,ARI,SD,2022 REG,3,4,4,2,6,7,1,0,2,-2,1,1,0,0,0,0,0,0,0,0.49455035168025013,0.5054496483197499
86641,0.45454545454545453,0.5815899581589958,120,-139,0.43812026695252254,0.5618797330474774,home,ARI,under,9,0.5283018867924528,-112,0.5054496483197499,ARI,SD,2022 REG,3,4,4,2,6,7,1,0,2,-2,1,1,0,0,0,0,0,0,0,0.49455035168025013,0.5054496483197499
86642,0.6226415094339623,0.4166666666666667,-165,140,0.5981666073335706,0.40183339266642937,away,OAK,over,9.5,0.5215311004784688,-109,0.4978845547971712,KC,OAK,2022 REG,10,7,13,9,16,23,0,1,-2,2,1,1,1,1,1,1,1,0,0,0.4978845547971712,0.5021154452028288
86642,0.6226415094339623,0.4166666666666667,-165,140,0.5981666073335706,0.40183339266642937,home,KC,under,9.5,0.5238095238095238,-110,0.5021154452028288,KC,OAK,2022 REG,10,7,13,9,16,23,0,1,-2,2,1,1,1,1,1,1,1,0,0,0.4978845547971712,0.5021154452028288
86643,0.5348837209302326,0.5121951219512195,-115,-105,0.5097020142727117,0.49029798572728833,away,MIN,over,7,0.5454545454545454,-120,0.5206611570247933,CWS,MIN,2022 REG,5,3,7,2,5,12,1,0,1,-1,1,1,0,0,0,0,0,0,0,0.5206611570247933,0.4793388429752067
86643,0.5348837209302326,0.5121951219512195,-115,-105,0.5097020142727117,0.49029798572728833,home,CWS,under,7,0.5,100,0.4793388429752067,CWS,MIN,2022 REG,5,3,7,2,5,12,1,0,1,-1,1,1,0,0,0,0,0,0,0,0.5206611570247933,0.4793388429752067
86644,0.5305164319248826,0.5098039215686274,-113,-104,0.5091258218555558,0.49087417814444423,away,ARI,over,10,0.5238095238095238,-110,0.4988662131519274,COL,ARI,2022 REG,14,13,9,10,23,23,1,0,3,-3,1,1,1,1,1,1,1,1,1,0.4988662131519274,0.5011337868480725
86644,0.5305164319248826,0.5098039215686274,-113,-104,0.5091258218555558,0.49087417814444423,home,COL,under,10,0.5238095238095238,-110,0.5011337868480725,COL,ARI,2022 REG,14,13,9,10,23,23,1,0,3,-3,1,1,1,1,1,1,1,1,1,0.4988662131519274,0.5011337868480725
86645,0.7468354430379747,0.29411764705882354,-295,240,0.7162502238517583,0.2837497761482417,away,OAK,over,8.5,0.5348837209302326,-115,0.5097020142727117,HOU,OAK,2022 REG,12,8,5,0,8,17,1,0,8,-8,0,0,0,0,0,0,0,0,0,0.5097020142727117,0.49029798572728833
86645,0.7468354430379747,0.29411764705882354,-295,240,0.7162502238517583,0.2837497761482417,home,HOU,under,8.5,0.5121951219512195,-105,0.49029798572728833,HOU,OAK,2022 REG,12,8,5,0,8,17,1,0,8,-8,0,0,0,0,0,0,0,0,0,0.5097020142727117,0.49029798572728833
86646,0.5555555555555556,0.4807692307692307,-125,108,0.5353751187084521,0.4646248812915479,away,SF,over,6.5,0.5,100,0.47935779816513757,NYM,SF,2022 REG,8,5,9,4,9,17,1,0,1,-1,1,1,1,1,0,0,0,0,0,0.47935779816513757,0.5206422018348624
86646,0.5555555555555556,0.4807692307692307,-125,108,0.5353751187084521,0.4646248812915479,home,NYM,under,6.5,0.5412844036697247,-118,0.5206422018348624,NYM,SF,2022 REG,8,5,9,4,9,17,1,0,1,-1,1,1,1,1,0,0,0,0,0,0.47935779816513757,0.5206422018348624
86647,0.5348837209302326,0.5121951219512195,-115,-105,0.5097020142727117,0.49029798572728833,away,MIA,over,10.5,0.5121951219512195,-105,0.48808156828023186,COL,MIA,2022 REG,3,1,21,14,15,24,0,1,-13,13,1,0,0,0,0,0,0,0,0,0.48808156828023186,0.5119184317197681
86647,0.5348837209302326,0.5121951219512195,-115,-105,0.5097020142727117,0.49029798572728833,home,COL,under,10.5,0.5348837209302326,-115,0.5119184317197681,COL,MIA,2022 REG,3,1,21,14,15,24,0,1,-13,13,1,0,0,0,0,0,0,0,0,0.48808156828023186,0.5119184317197681
86648,0.38759689922480617,0.6503496503496503,158,-186,0.3728889342734665,0.6271110657265335,away,HOU,over,8,0.5283018867924528,-112,0.5031902949311281,LAA,HOU,2022 REG,8,2,7,3,5,15,0,1,-1,1,1,1,0,0,0,0,0,0,0,0.5031902949311281,0.4968097050688719
86648,0.38759689922480617,0.6503496503496503,158,-186,0.3728889342734665,0.6271110657265335,home,LAA,under,8,0.5192307692307692,-108,0.4968097050688719,LAA,HOU,2022 REG,8,2,7,3,5,15,0,1,-1,1,1,1,0,0,0,0,0,0,0,0.5031902949311281,0.4968097050688719
86649,0.5,0.5454545454545454,100,-120,0.4772727272727273,0.5227272727272727,away,CHC,over,8.5,0.5391705069124424,-117,0.5114756747601454,PIT,CHC,2022 REG,6,1,8,2,3,14,0,1,-1,1,1,0,0,0,0,0,0,0,0,0.5114756747601454,0.48852432523985456
86649,0.5,0.5454545454545454,100,-120,0.4772727272727273,0.5227272727272727,home,PIT,under,8.5,0.5121951219512195,-105,0.48852432523985456,PIT,CHC,2022 REG,6,1,8,2,3,14,0,1,-1,1,1,0,0,0,0,0,0,0,0,0.5114756747601454,0.48852432523985456
86650,0.46511627906976744,0.574468085106383,115,-135,0.44670494689481377,0.5532950531051862,away,SD,over,7,0.5348837209302326,-115,0.5097020142727117,CLE,SD,2022 REG,7,4,6,5,9,13,0,1,-1,1,1,1,1,1,0,0,0,0,0,0.5097020142727117,0.49029798572728833
86650,0.46511627906976744,0.574468085106383,115,-135,0.44670494689481377,0.5532950531051862,home,CLE,under,7,0.5121951219512195,-105,0.49029798572728833,CLE,SD,2022 REG,7,4,6,5,9,13,0,1,-1,1,1,1,1,1,0,0,0,0,0,0.5097020142727117,0.49029798572728833
86651,0.5454545454545454,0.49019607843137253,-120,104,0.526008750607681,0.47399124939231896,away,SF,over,7.5,0.5283018867924528,-112,0.5044173060022736,SD,SF,2022 REG,6,0,17,12,12,23,0,1,-12,12,0,0,0,0,0,0,0,0,0,0.5044173060022736,0.49558269399772636
86651,0.5454545454545454,0.49019607843137253,-120,104,0.526008750607681,0.47399124939231896,home,SD,under,7.5,0.5169082125603864,-107,0.49558269399772636,SD,SF,2022 REG,6,0,17,12,12,23,0,1,-12,12,0,0,0,0,0,0,0,0,0,0.5044173060022736,0.49558269399772636
86652,0.6610169491525424,0.37735849056603776,-195,165,0.6356501330673793,0.3643498669326207,away,PHI,over,7,0.4926108374384236,103,0.4708471211010438,NYM,PHI,2022 REG,15,10,8,6,16,23,1,0,4,-4,1,1,1,1,1,1,0,0,0,0.4708471211010438,0.5291528788989561
86652,0.6610169491525424,0.37735849056603776,-195,165,0.6356501330673793,0.3643498669326207,home,NYM,under,7,0.5515695067264574,-123,0.5291528788989561,NYM,PHI,2022 REG,15,10,8,6,16,23,1,0,4,-4,1,1,1,1,1,1,0,0,0,0.4708471211010438,0.5291528788989561
86653,0.5555555555555556,0.48780487804878053,-125,105,0.5314664257753688,0.46853357422463116,away,SEA,over,8,0.5283018867924528,-112,0.5044173060022736,LAA,SEA,2022 REG,10,3,11,5,8,21,0,1,-2,2,1,1,1,0,0,0,0,0,0,0.5044173060022736,0.49558269399772636
86653,0.5555555555555556,0.48780487804878053,-125,105,0.5314664257753688,0.46853357422463116,home,LAA,under,8,0.5169082125603864,-107,0.49558269399772636,LAA,SEA,2022 REG,10,3,11,5,8,21,0,1,-2,2,1,1,1,0,0,0,0,0,0,0.5044173060022736,0.49558269399772636
86654,0.4504504504504505,0.5918367346938775,122,-145,0.43140216885390636,0.5685978311460936,away,MIL,over,9.5,0.5169082125603864,-107,0.49239402434819424,BOS,MIL,2022 REG,11,7,11,2,9,22,1,0,5,-5,1,1,0,0,0,0,0,0,0,0.49239402434819424,0.5076059756518058
86654,0.4504504504504505,0.5918367346938775,122,-145,0.43140216885390636,0.5685978311460936,home,BOS,under,9.5,0.5305164319248826,-113,0.5076059756518058,BOS,MIL,2022 REG,11,7,11,2,9,22,1,0,5,-5,1,1,0,0,0,0,0,0,0,0.49239402434819424,0.5076059756518058
86655,0.607843137254902,0.4347826086956522,-155,130,0.5819333701084867,0.41806662989151333,away,LAA,over,8,0.5454545454545454,-120,0.5206611570247933,SEA,LAA,2022 REG,8,6,8,3,9,16,1,0,3,-3,1,1,1,0,0,0,0,0,0,0.5206611570247933,0.4793388429752067
86655,0.607843137254902,0.4347826086956522,-155,130,0.5819333701084867,0.41806662989151333,home,SEA,under,8,0.5,100,0.4793388429752067,SEA,LAA,2022 REG,8,6,8,3,9,16,1,0,3,-3,1,1,1,0,0,0,0,0,0,0.5206611570247933,0.4793388429752067
86656,0.4,0.6453900709219857,150,-182,0.38184397163120565,0.6181560283687944,away,NYM,over,9,0.5098039215686274,-104,0.48592421718142587,WSH,NYM,2022 REG,5,3,13,7,10,18,0,1,-4,4,1,1,1,0,0,0,0,0,0,0.48592421718142587,0.5140757828185741
86656,0.4,0.6453900709219857,150,-182,0.38184397163120565,0.6181560283687944,home,WSH,under,9,0.5370370370370371,-116,0.5140757828185741,WSH,NYM,2022 REG,5,3,13,7,10,18,0,1,-4,4,1,1,1,0,0,0,0,0,0,0.48592421718142587,0.5140757828185741
86657,0.7101449275362319,0.3333333333333333,-245,200,0.6792690611216132,0.3207309388783868,away,PIT,over,8,0.5348837209302326,-115,0.5097020142727117,ARI,PIT,2022 REG,6,3,3,0,3,9,1,0,3,-3,0,0,0,0,0,0,0,0,0,0.5097020142727117,0.49029798572728833
86657,0.7101449275362319,0.3333333333333333,-245,200,0.6792690611216132,0.3207309388783868,home,ARI,under,8,0.5121951219512195,-105,0.49029798572728833,ARI,PIT,2022 REG,6,3,3,0,3,9,1,0,3,-3,0,0,0,0,0,0,0,0,0,0.5097020142727117,0.49029798572728833
86658,0.4081632653061224,0.6363636363636364,145,-175,0.3899890197266291,0.6100109802733709,away,MIN,over,9,0.5098039215686274,-104,0.4881300146960012,DET,MIN,2022 REG,6,4,11,8,12,17,0,1,-4,4,1,1,1,1,0,0,0,0,0,0.4881300146960012,0.5118699853039987
86658,0.4081632653061224,0.6363636363636364,145,-175,0.3899890197266291,0.6100109802733709,home,DET,under,9,0.5327102803738317,-114,0.5118699853039987,DET,MIN,2022 REG,6,4,11,8,12,17,0,1,-4,4,1,1,1,1,0,0,0,0,0,0.4881300146960012,0.5118699853039987
86659,0.7590361445783133,0.3076923076923077,-315,225,0.7083868374331432,0.29161316256685677,away,CHC,over,8.5,0.5215311004784688,-109,0.4978845547971712,STL,CHC,2022 REG,10,7,2,2,9,12,1,0,5,-5,1,1,0,0,0,0,0,0,0,0.4978845547971712,0.5021154452028288
86659,0.7590361445783133,0.3076923076923077,-315,225,0.7083868374331432,0.29161316256685677,home,STL,under,8.5,0.5238095238095238,-110,0.5021154452028288,STL,CHC,2022 REG,10,7,2,2,9,12,1,0,5,-5,1,1,0,0,0,0,0,0,0,0.4978845547971712,0.5021154452028288
86660,0.49504950495049505,0.5454545454545454,102,-120,0.47499799484898986,0.5250020051510101,away,TOR,over,8,0.5305164319248826,-113,0.5066009958897986,TEX,TOR,2022 REG,9,4,7,1,5,16,1,0,3,-3,1,0,0,0,0,0,0,0,0,0.5066009958897986,0.49339900411020143
86660,0.49504950495049505,0.5454545454545454,102,-120,0.47499799484898986,0.5250020051510101,home,TEX,under,8,0.5145631067961165,-106,0.49339900411020143,TEX,TOR,2022 REG,9,4,7,1,5,16,1,0,3,-3,1,0,0,0,0,0,0,0,0,0.5066009958897986,0.49339900411020143
86661,0.7959183673469388,0.24390243902439027,-390,310,0.764224256153432,0.23577574384656796,away,WSH,over,8,0.5238095238095238,-110,0.4988662131519274,SD,WSH,2022 REG,3,1,6,3,4,9,0,1,-2,2,1,0,0,0,0,0,0,0,0,0.4988662131519274,0.5011337868480725
86661,0.7959183673469388,0.24390243902439027,-390,310,0.764224256153432,0.23577574384656796,home,SD,under,8,0.5238095238095238,-110,0.5011337868480725,SD,WSH,2022 REG,3,1,6,3,4,9,0,1,-2,2,1,0,0,0,0,0,0,0,0,0.4988662131519274,0.5011337868480725
86662,0.45454545454545453,0.5833333333333333,120,-140,0.43732782369146006,0.5626721763085399,away,TB,over,8.5,0.5121951219512195,-105,0.48808156828023186,CIN,TB,2022 REG,14,10,12,5,15,26,1,0,5,-5,1,1,1,1,1,0,0,0,0,0.48808156828023186,0.5119184317197681
86662,0.45454545454545453,0.5833333333333333,120,-140,0.43732782369146006,0.5626721763085399,home,CIN,under,8.5,0.5348837209302326,-115,0.5119184317197681,CIN,TB,2022 REG,14,10,12,5,15,26,1,0,5,-5,1,1,1,1,1,0,0,0,0,0.48808156828023186,0.5119184317197681
86663,0.7894736842105263,0.25,-375,300,0.7583102493074793,0.24168975069252074,away,COL,over,8,0.5098039215686274,-104,0.48592421718142587,LAD,COL,2022 REG,5,2,9,5,7,14,0,1,-3,3,1,1,0,0,0,0,0,0,0,0.48592421718142587,0.5140757828185741
86663,0.7894736842105263,0.25,-375,300,0.7583102493074793,0.24168975069252074,home,LAD,under,8,0.5370370370370371,-116,0.5140757828185741,LAD,COL,2022 REG,5,2,9,5,7,14,0,1,-3,3,1,1,0,0,0,0,0,0,0,0.48592421718142587,0.5140757828185741
86664,0.6000000000000001,0.4424778761061947,-150,126,0.5745132743362832,0.4254867256637168,away,TB,over,6.5,0.5454545454545454,-120,0.5206611570247933,HOU,TB,2022 REG,6,2,4,1,3,10,1,0,1,-1,1,0,0,0,0,0,0,0,0,0.5206611570247933,0.4793388429752067
86664,0.6000000000000001,0.4424778761061947,-150,126,0.5745132743362832,0.4254867256637168,home,HOU,under,6.5,0.5,100,0.4793388429752067,HOU,TB,2022 REG,6,2,4,1,3,10,1,0,1,-1,1,0,0,0,0,0,0,0,0,0.5206611570247933,0.4793388429752067
86665,0.5918367346938775,0.4444444444444444,-145,125,0.5703642001018094,0.42963579989819056,away,CLE,over,10,0.5098039215686274,-104,0.48592421718142587,MIN,CLE,2022 REG,5,1,5,0,1,10,1,0,1,-1,0,0,0,0,0,0,0,0,0,0.48592421718142587,0.5140757828185741
86665,0.5918367346938775,0.4444444444444444,-145,125,0.5703642001018094,0.42963579989819056,home,MIN,under,10,0.5370370370370371,-116,0.5140757828185741,MIN,CLE,2022 REG,5,1,5,0,1,10,1,0,1,-1,0,0,0,0,0,0,0,0,0,0.48592421718142587,0.5140757828185741
86666,0.5238095238095238,0.5192307692307692,-110,-108,0.5012646084074657,0.4987353915925343,away,SD,over,7.5,0.5283018867924528,-112,0.5031902949311281,ARI,SD,2022 REG,9,7,10,6,13,19,1,0,1,-1,1,1,1,1,1,1,0,0,0,0.5031902949311281,0.4968097050688719
86666,0.5238095238095238,0.5192307692307692,-110,-108,0.5012646084074657,0.4987353915925343,home,ARI,under,7.5,0.5192307692307692,-108,0.4968097050688719,ARI,SD,2022 REG,9,7,10,6,13,19,1,0,1,-1,1,1,1,1,1,1,0,0,0,0.5031902949311281,0.4968097050688719
86667,0.6296296296296295,0.41152263374485604,-170,143,0.6037189452827312,0.3962810547172688,away,TEX,over,6.5,0.5260663507109005,-111,0.5010269332605688,SEA,TEX,2022 REG,5,3,5,1,4,10,1,0,2,-2,1,0,0,0,0,0,0,0,0,0.5010269332605688,0.4989730667394312
86667,0.6296296296296295,0.41152263374485604,-170,143,0.6037189452827312,0.3962810547172688,home,SEA,under,6.5,0.5215311004784688,-109,0.4989730667394312,SEA,TEX,2022 REG,5,3,5,1,4,10,1,0,2,-2,1,0,0,0,0,0,0,0,0,0.5010269332605688,0.4989730667394312
86668,0.6721311475409836,0.37037037037037035,-205,170,0.6435645535349916,0.35643544646500835,away,KC,over,7,0.5454545454545454,-120,0.5206611570247933,TB,KC,2022 REG,10,5,4,2,7,14,1,0,3,-3,1,1,0,0,0,0,0,0,0,0.5206611570247933,0.4793388429752067
86668,0.6721311475409836,0.37037037037037035,-205,170,0.6435645535349916,0.35643544646500835,home,TB,under,7,0.5,100,0.4793388429752067,TB,KC,2022 REG,10,5,4,2,7,14,1,0,3,-3,1,1,0,0,0,0,0,0,0,0.5206611570247933,0.4793388429752067
86669,0.6031746031746031,0.43859649122807015,-152,128,0.5779793398841018,0.4220206601158982,away,CIN,over,8,0.5238095238095238,-110,0.4988662131519274,MIL,CIN,2022 REG,5,2,17,8,10,22,0,1,-6,6,1,1,0,0,0,0,0,0,0,0.4988662131519274,0.5011337868480725
86669,0.6031746031746031,0.43859649122807015,-152,128,0.5779793398841018,0.4220206601158982,home,MIL,under,8,0.5238095238095238,-110,0.5011337868480725,MIL,CIN,2022 REG,5,2,17,8,10,22,0,1,-6,6,1,1,0,0,0,0,0,0,0,0.4988662131519274,0.5011337868480725
86670,0.7590361445783133,0.2777777777777778,-315,260,0.7310930468863406,0.2689069531136594,away,KC,over,9,0.5475113122171946,-121,0.5242087833606768,TOR,KC,2022 REG,12,6,9,5,11,21,1,0,1,-1,1,1,1,1,1,0,0,0,0,0.5242087833606768,0.4757912166393232
86670,0.7590361445783133,0.2777777777777778,-315,260,0.7310930468863406,0.2689069531136594,home,TOR,under,9,0.49504950495049505,102,0.4757912166393232,TOR,KC,2022 REG,12,6,9,5,11,21,1,0,1,-1,1,1,1,1,1,0,0,0,0,0.5242087833606768,0.4757912166393232
86671,0.4,0.6389891696750902,150,-177,0.3844043321299639,0.6155956678700361,away,NYM,over,10,0.5121951219512195,-105,0.48919479393107135,CIN,NYM,2022 REG,7,4,12,7,11,19,0,1,-3,3,1,1,1,1,0,0,0,0,0,0.48919479393107135,0.5108052060689287
86671,0.4,0.6389891696750902,150,-177,0.3844043321299639,0.6155956678700361,home,CIN,under,10,0.5327102803738317,-114,0.5108052060689287,CIN,NYM,2022 REG,7,4,12,7,11,19,0,1,-3,3,1,1,1,1,0,0,0,0,0,0.48919479393107135,0.5108052060689287
86672,0.6610169491525424,0.37735849056603776,-195,165,0.6356501330673793,0.3643498669326207,away,PIT,over,8,0.5370370370370371,-116,0.5118817074154765,CHC,PIT,2022 REG,10,4,4,2,6,14,1,0,2,-2,1,1,0,0,0,0,0,0,0,0.5118817074154765,0.48811829258452355
86672,0.6610169491525424,0.37735849056603776,-195,165,0.6356501330673793,0.3643498669326207,home,CHC,under,8,0.5098039215686274,-104,0.48811829258452355,CHC,PIT,2022 REG,10,4,4,2,6,14,1,0,2,-2,1,1,0,0,0,0,0,0,0,0.5118817074154765,0.48811829258452355
86673,0.6183206106870228,0.4166666666666667,-162,140,0.5966872559874133,0.40331274401258665,away,CHC,over,7.5,0.5,100,0.4783105022831051,SD,CHC,2022 REG,11,5,10,4,9,21,1,0,1,-1,1,1,1,1,0,0,0,0,0,0.4783105022831051,0.5216894977168949
86673,0.6183206106870228,0.4166666666666667,-162,140,0.5966872559874133,0.40331274401258665,home,SD,under,7.5,0.5433789954337899,-119,0.5216894977168949,SD,CHC,2022 REG,11,5,10,4,9,21,1,0,1,-1,1,1,1,1,0,0,0,0,0,0.4783105022831051,0.5216894977168949
86674,0.49504950495049505,0.5454545454545454,102,-120,0.47499799484898986,0.5250020051510101,away,TOR,over,8.5,0.5348837209302326,-115,0.5109810284308424,PHI,TOR,2022 REG,15,11,21,18,29,36,0,1,-7,7,1,1,1,1,1,1,1,1,1,0.5109810284308424,0.48901897156915763
86674,0.49504950495049505,0.5454545454545454,102,-120,0.47499799484898986,0.5250020051510101,home,PHI,under,8.5,0.5098039215686274,-104,0.48901897156915763,PHI,TOR,2022 REG,15,11,21,18,29,36,0,1,-7,7,1,1,1,1,1,1,1,1,1,0.5109810284308424,0.48901897156915763
86675,0.5145631067961165,0.5169082125603864,-106,-107,0.4983691269330616,0.5016308730669383,away,ATL,over,7,0.5348837209302326,-115,0.5097020142727117,STL,ATL,2022 REG,9,6,10,5,11,19,1,0,1,-1,1,1,1,1,1,0,0,0,0,0.5097020142727117,0.49029798572728833
86675,0.5145631067961165,0.5169082125603864,-106,-107,0.4983691269330616,0.5016308730669383,home,STL,under,7,0.5121951219512195,-105,0.49029798572728833,STL,ATL,2022 REG,9,6,10,5,11,19,1,0,1,-1,1,1,1,1,1,0,0,0,0,0.5097020142727117,0.49029798572728833
86676,0.7354497354497355,0.29850746268656714,-278,235,0.7104759230637776,0.2895240769362224,away,PIT,over,7.5,0.5024875621890548,-101,0.48049269377245407,SF,PIT,2022 REG,7,5,10,3,8,17,1,0,2,-2,1,1,1,0,0,0,0,0,0,0.48049269377245407,0.5195073062275459
86676,0.7354497354497355,0.29850746268656714,-278,235,0.7104759230637776,0.2895240769362224,home,SF,under,7.5,0.5412844036697247,-118,0.5195073062275459,SF,PIT,2022 REG,7,5,10,3,8,17,1,0,2,-2,1,1,1,0,0,0,0,0,0,0.48049269377245407,0.5195073062275459
86677,0.48780487804878053,0.5495495495495495,105,-122,0.4695832060495952,0.5304167939504048,away,TEX,over,7,0.5238095238095238,-110,0.5000596729920038,MIA,TEX,2022 REG,10,10,8,6,16,18,1,0,4,-4,1,1,1,1,1,1,0,0,0,0.5000596729920038,0.4999403270079962
86677,0.48780487804878053,0.5495495495495495,105,-122,0.4695832060495952,0.5304167939504048,home,MIA,under,7,0.5215311004784688,-109,0.4999403270079962,MIA,TEX,2022 REG,10,10,8,6,16,18,1,0,4,-4,1,1,1,1,1,1,0,0,0,0.5000596729920038,0.4999403270079962
86678,0.5918367346938775,0.45454545454545453,-145,120,0.5643860512665178,0.43561394873348225,away,CLE,over,7.5,0.5,100,0.4772727272727273,TB,CLE,2022 REG,10,6,11,4,10,21,1,0,2,-2,1,1,1,1,0,0,0,0,0,0.4772727272727273,0.5227272727272727
86678,0.5918367346938775,0.45454545454545453,-145,120,0.5643860512665178,0.43561394873348225,home,TB,under,7.5,0.5454545454545454,-120,0.5227272727272727,TB,CLE,2022 REG,10,6,11,4,10,21,1,0,2,-2,1,1,1,1,0,0,0,0,0,0.4772727272727273,0.5227272727272727
86679,0.5833333333333333,0.45454545454545453,-140,120,0.5612373737373737,0.4387626262626263,away,KC,over,10.5,0.5238095238095238,-110,0.4988662131519274,COL,KC,2022 REG,13,10,18,14,24,31,0,1,-4,4,1,1,1,1,1,1,1,1,1,0.4988662131519274,0.5011337868480725
86679,0.5833333333333333,0.45454545454545453,-140,120,0.5612373737373737,0.4387626262626263,home,COL,under,10.5,0.5238095238095238,-110,0.5011337868480725,COL,KC,2022 REG,13,10,18,14,24,31,0,1,-4,4,1,1,1,1,1,1,1,1,1,0.4988662131519274,0.5011337868480725
86680,0.6183206106870228,0.42016806722689076,-162,138,0.5945222678547557,0.4054777321452443,away,NYM,over,8.5,0.5169082125603864,-107,0.49353874091423283,LAD,NYM,2022 REG,8,6,5,1,7,13,1,0,5,-5,1,0,0,0,0,0,0,0,0,0.49353874091423283,0.5064612590857671
86680,0.6183206106870228,0.42016806722689076,-162,138,0.5945222678547557,0.4054777321452443,home,LAD,under,8.5,0.5283018867924528,-112,0.5064612590857671,LAD,NYM,2022 REG,8,6,5,1,7,13,1,0,5,-5,1,0,0,0,0,0,0,0,0,0.49353874091423283,0.5064612590857671
86681,0.46511627906976744,0.5815899581589958,115,-139,0.44339244780057524,0.5566075521994247,away,TOR,over,9.5,0.5145631067961165,-106,0.4913668392989033,MIL,TOR,2022 REG,13,10,6,3,13,19,1,0,7,-7,1,1,1,0,0,0,0,0,0,0.4913668392989033,0.5086331607010968
86681,0.46511627906976744,0.5815899581589958,115,-139,0.44339244780057524,0.5566075521994247,home,MIL,under,9.5,0.5305164319248826,-113,0.5086331607010968,MIL,TOR,2022 REG,13,10,6,3,13,19,1,0,7,-7,1,1,1,0,0,0,0,0,0,0.4913668392989033,0.5086331607010968
86682,0.48309178743961345,0.5555555555555556,107,-125,0.4644215734322854,0.5355784265677146,away,NYY,over,7,0.5370370370370371,-116,0.5118817074154765,TOR,NYY,2022 REG,4,3,11,8,11,15,0,1,-5,5,1,1,1,0,0,0,0,0,0,0.5118817074154765,0.48811829258452355
86682,0.48309178743961345,0.5555555555555556,107,-125,0.4644215734322854,0.5355784265677146,home,TOR,under,7,0.5098039215686274,-104,0.48811829258452355,TOR,NYY,2022 REG,4,3,11,8,11,15,0,1,-5,5,1,1,1,0,0,0,0,0,0,0.5118817074154765,0.48811829258452355
86683,0.5934959349593496,0.4464285714285714,-146,124,0.5698009027128599,0.4301990972871401,away,KC,over,9,0.5238095238095238,-110,0.5000596729920038,CLE,KC,2022 REG,8,4,7,0,4,15,1,0,4,-4,0,0,0,0,0,0,0,0,0,0.5000596729920038,0.4999403270079962
86683,0.5934959349593496,0.4464285714285714,-146,124,0.5698009027128599,0.4301990972871401,home,CLE,under,9,0.5215311004784688,-109,0.4999403270079962,CLE,KC,2022 REG,8,4,7,0,4,15,1,0,4,-4,0,0,0,0,0,0,0,0,0,0.5000596729920038,0.4999403270079962
86684,0.6240601503759399,0.4166666666666667,-166,140,0.5986441668079975,0.4013558331920025,away,OAK,over,8.5,0.5348837209302326,-115,0.5097020142727117,TEX,OAK,2022 REG,9,7,13,14,21,22,0,1,-7,7,1,1,1,1,1,1,1,0,0,0.5097020142727117,0.49029798572728833
86684,0.6240601503759399,0.4166666666666667,-166,140,0.5986441668079975,0.4013558331920025,home,TEX,under,8.5,0.5121951219512195,-105,0.49029798572728833,TEX,OAK,2022 REG,9,7,13,14,21,22,0,1,-7,7,1,1,1,1,1,1,1,0,0,0.5097020142727117,0.49029798572728833
86685,0.6666666666666666,0.37037037037037035,-200,170,0.6419753086419753,0.3580246913580247,away,PIT,over,7,0.5238095238095238,-110,0.5012646084074657,SD,PIT,2022 REG,8,4,4,3,7,12,1,0,1,-1,1,1,1,0,0,0,0,0,0,0.5012646084074657,0.4987353915925343
86685,0.6666666666666666,0.37037037037037035,-200,170,0.6419753086419753,0.3580246913580247,home,SD,under,7,0.5192307692307692,-108,0.4987353915925343,SD,PIT,2022 REG,8,4,4,3,7,12,1,0,1,-1,1,1,1,0,0,0,0,0,0,0.5012646084074657,0.4987353915925343
86686,0.7619047619047619,0.2777777777777778,-320,260,0.7316704459561603,0.26832955404383974,away,COL,over,9,0.5283018867924528,-112,0.5031902949311281,LAD,COL,2022 REG,8,2,1,1,3,9,1,0,1,-1,1,0,0,0,0,0,0,0,0,0.5031902949311281,0.4968097050688719
86686,0.7619047619047619,0.2777777777777778,-320,260,0.7316704459561603,0.26832955404383974,home,LAD,under,9,0.5192307692307692,-108,0.4968097050688719,LAD,COL,2022 REG,8,2,1,1,3,9,1,0,1,-1,1,0,0,0,0,0,0,0,0,0.5031902949311281,0.4968097050688719
86687,0.626865671641791,0.41152263374485604,-168,143,0.6028013608024003,0.3971986391975997,away,PIT,over,9,0.5283018867924528,-112,0.5031902949311281,STL,PIT,2022 REG,7,3,7,1,4,14,1,0,2,-2,1,0,0,0,0,0,0,0,0,0.5031902949311281,0.4968097050688719
86687,0.626865671641791,0.41152263374485604,-168,143,0.6028013608024003,0.3971986391975997,home,STL,under,9,0.5192307692307692,-108,0.4968097050688719,STL,PIT,2022 REG,7,3,7,1,4,14,1,0,2,-2,1,0,0,0,0,0,0,0,0,0.5031902949311281,0.4968097050688719
86688,0.6402877697841727,0.4,-178,150,0.6144920035194866,0.38550799648051337,away,DET,over,7.5,0.5454545454545454,-120,0.5179608869977906,SEA,DET,2022 REG,12,9,8,6,15,20,1,0,3,-3,1,1,1,1,1,1,0,0,0,0.5179608869977906,0.48203911300220936
86688,0.6402877697841727,0.4,-178,150,0.6144920035194866,0.38550799648051337,home,SEA,under,7.5,0.504950495049505,-102,0.48203911300220936,SEA,DET,2022 REG,12,9,8,6,15,20,1,0,3,-3,1,1,1,1,1,1,0,0,0,0.5179608869977906,0.48203911300220936
86689,0.6666666666666666,0.36363636363636365,-200,175,0.6464646464646464,0.3535353535353536,away,DET,over,8,0.5192307692307692,-108,0.49455035168025013,HOU,DET,2022 REG,4,3,11,2,5,15,1,0,1,-1,1,1,0,0,0,0,0,0,0,0.49455035168025013,0.5054496483197499
86689,0.6666666666666666,0.36363636363636365,-200,175,0.6464646464646464,0.3535353535353536,home,HOU,under,8,0.5283018867924528,-112,0.5054496483197499,HOU,DET,2022 REG,4,3,11,2,5,15,1,0,1,-1,1,1,0,0,0,0,0,0,0,0.49455035168025013,0.5054496483197499
86690,0.6551724137931035,0.3846153846153846,-190,160,0.6291045458703008,0.37089545412969915,away,COL,over,9,0.5327102803738317,-114,0.508788710910954,MIL,COL,2022 REG,12,10,13,9,19,25,1,0,1,-1,1,1,1,1,1,1,1,1,1,0.508788710910954,0.491211289089046
86690,0.6551724137931035,0.3846153846153846,-190,160,0.6291045458703008,0.37089545412969915,home,MIL,under,9,0.5121951219512195,-105,0.491211289089046,MIL,COL,2022 REG,12,10,13,9,19,25,1,0,1,-1,1,1,1,1,1,1,1,1,1,0.508788710910954,0.491211289089046
86691,0.425531914893617,0.6124031007751938,135,-158,0.4093893550345486,0.5906106449654513,away,SD,over,7,0.5238095238095238,-110,0.4988662131519274,MIA,SD,2022 REG,7,3,11,10,13,18,0,1,-7,7,1,1,1,0,0,0,0,0,0,0.4988662131519274,0.5011337868480725
86691,0.425531914893617,0.6124031007751938,135,-158,0.4093893550345486,0.5906106449654513,home,MIA,under,7,0.5238095238095238,-110,0.5011337868480725,MIA,SD,2022 REG,7,3,11,10,13,18,0,1,-7,7,1,1,1,0,0,0,0,0,0,0.4988662131519274,0.5011337868480725
86692,0.7333333333333333,0.30303030303030304,-275,230,0.7066666666666666,0.29333333333333345,away,LAA,over,8,0.5238095238095238,-110,0.4988662131519274,HOU,LAA,2022 REG,12,12,11,4,16,23,1,0,8,-8,1,1,1,1,0,0,0,0,0,0.4988662131519274,0.5011337868480725
86692,0.7333333333333333,0.30303030303030304,-275,230,0.7066666666666666,0.29333333333333345,home,HOU,under,8,0.5238095238095238,-110,0.5011337868480725,HOU,LAA,2022 REG,12,12,11,4,16,23,1,0,8,-8,1,1,1,1,0,0,0,0,0,0.4988662131519274,0.5011337868480725
86693,0.47619047619047616,0.5652173913043479,110,-130,0.4564724440500838,0.5435275559499162,away,SD,over,9,0.5495495495495495,-122,0.5250401592387142,CHC,SD,2022 REG,5,1,10,4,5,15,0,1,-3,3,1,0,0,0,0,0,0,0,0,0.5250401592387142,0.47495984076128583
86693,0.47619047619047616,0.5652173913043479,110,-130,0.4564724440500838,0.5435275559499162,home,CHC,under,9,0.49504950495049505,102,0.47495984076128583,CHC,SD,2022 REG,5,1,10,4,5,15,0,1,-3,3,1,0,0,0,0,0,0,0,0,0.5250401592387142,0.47495984076128583
86694,0.6610169491525424,0.3802281368821293,-195,163,0.6337532482143695,0.3662467517856305,away,PIT,over,8.5,0.5412844036697247,-118,0.5175913212324037,STL,PIT,2022 REG,9,4,7,6,10,16,0,1,-2,2,1,1,1,1,0,0,0,0,0,0.5175913212324037,0.4824086787675963
86694,0.6610169491525424,0.3802281368821293,-195,163,0.6337532482143695,0.3662467517856305,home,STL,under,8.5,0.5024875621890548,-101,0.4824086787675963,STL,PIT,2022 REG,9,4,7,6,10,16,0,1,-2,2,1,1,1,1,0,0,0,0,0,0.5175913212324037,0.4824086787675963
86695,0.3921568627450981,0.6453900709219857,155,-182,0.37743257503251615,0.6225674249674839,away,ATL,over,8.5,0.5215311004784688,-109,0.4978845547971712,CHC,ATL,2022 REG,3,1,2,0,1,5,1,0,1,-1,0,0,0,0,0,0,0,0,0,0.4978845547971712,0.5021154452028288
86695,0.3921568627450981,0.6453900709219857,155,-182,0.37743257503251615,0.6225674249674839,home,CHC,under,8.5,0.5238095238095238,-110,0.5021154452028288,CHC,ATL,2022 REG,3,1,2,0,1,5,1,0,1,-1,0,0,0,0,0,0,0,0,0,0.4978845547971712,0.5021154452028288
86696,0.5555555555555556,0.4854368932038835,-125,106,0.5327819729114227,0.4672180270885773,away,MIL,over,7.5,0.5238095238095238,-110,0.4988662131519274,SD,MIL,2022 REG,5,1,4,2,3,9,0,1,-1,1,1,0,0,0,0,0,0,0,0,0.4988662131519274,0.5011337868480725
86696,0.5555555555555556,0.4854368932038835,-125,106,0.5327819729114227,0.4672180270885773,home,SD,under,7.5,0.5238095238095238,-110,0.5011337868480725,SD,MIL,2022 REG,5,1,4,2,3,9,0,1,-1,1,1,0,0,0,0,0,0,0,0,0.4988662131519274,0.5011337868480725
86697,0.45454545454545453,0.5918367346938775,120,-145,0.433462641254849,0.566537358745151,away,TOR,over,7.5,0.5348837209302326,-115,0.5097020142727117,BAL,TOR,2022 REG,3,1,9,4,5,12,0,1,-3,3,1,0,0,0,0,0,0,0,0,0.5097020142727117,0.49029798572728833
86697,0.45454545454545453,0.5918367346938775,120,-145,0.433462641254849,0.566537358745151,home,BAL,under,7.5,0.5121951219512195,-105,0.49029798572728833,BAL,TOR,2022 REG,3,1,9,4,5,12,0,1,-3,3,1,0,0,0,0,0,0,0,0,0.5097020142727117,0.49029798572728833
86698,0.647887323943662,0.3921568627450981,-184,155,0.6219432029903809,0.37805679700961914,away,OAK,over,8.5,0.5192307692307692,-108,0.49455035168025013,LAA,OAK,2022 REG,7,4,5,1,5,12,1,0,3,-3,1,0,0,0,0,0,0,0,0,0.49455035168025013,0.5054496483197499
86698,0.647887323943662,0.3921568627450981,-184,155,0.6219432029903809,0.37805679700961914,home,LAA,under,8.5,0.5283018867924528,-112,0.5054496483197499,LAA,OAK,2022 REG,7,4,5,1,5,12,1,0,3,-3,1,0,0,0,0,0,0,0,0,0.49455035168025013,0.5054496483197499
86699,0.45454545454545453,0.5833333333333333,120,-140,0.43732782369146006,0.5626721763085399,away,PHI,over,10.5,0.5238095238095238,-110,0.4988662131519274,WSH,PHI,2022 REG,10,7,7,8,15,17,0,1,-1,1,1,1,1,1,1,1,1,0,0,0.4988662131519274,0.5011337868480725
86699,0.45454545454545453,0.5833333333333333,120,-140,0.43732782369146006,0.5626721763085399,home,WSH,under,10.5,0.5238095238095238,-110,0.5011337868480725,WSH,PHI,2022 REG,10,7,7,8,15,17,0,1,-1,1,1,1,1,1,1,1,1,0,0,0.4988662131519274,0.5011337868480725
86700,0.6402877697841727,0.4,-178,150,0.6144920035194866,0.38550799648051337,away,WSH,over,7.5,0.49019607843137253,104,0.4707129274603323,MIA,WSH,2022 REG,6,1,13,6,7,19,0,1,-5,5,1,0,0,0,0,0,0,0,0,0.4707129274603323,0.5292870725396677
86700,0.6402877697841727,0.4,-178,150,0.6144920035194866,0.38550799648051337,home,MIA,under,7.5,0.5495495495495495,-122,0.5292870725396677,MIA,WSH,2022 REG,6,1,13,6,7,19,0,1,-5,5,1,0,0,0,0,0,0,0,0,0.4707129274603323,0.5292870725396677
86701,0.6226415094339623,0.4166666666666667,-165,140,0.5981666073335706,0.40183339266642937,away,SD,over,7.5,0.5305164319248826,-113,0.5053568787472517,LAD,SD,2022 REG,4,1,7,7,8,11,0,1,-6,6,1,0,0,0,0,0,0,0,0,0.5053568787472517,0.49464312125274834
86701,0.6226415094339623,0.4166666666666667,-165,140,0.5981666073335706,0.40183339266642937,home,LAD,under,7.5,0.5169082125603864,-107,0.49464312125274834,LAD,SD,2022 REG,4,1,7,7,8,11,0,1,-6,6,1,0,0,0,0,0,0,0,0,0.5053568787472517,0.49464312125274834
86702,0.47619047619047616,0.5652173913043479,110,-130,0.4564724440500838,0.5435275559499162,away,PHI,over,7.5,0.5412844036697247,-118,0.5175913212324037,STL,PHI,2022 REG,9,6,8,1,7,17,1,0,5,-5,1,0,0,0,0,0,0,0,0,0.5175913212324037,0.4824086787675963
86702,0.47619047619047616,0.5652173913043479,110,-130,0.4564724440500838,0.5435275559499162,home,STL,under,7.5,0.5024875621890548,-101,0.4824086787675963,STL,PHI,2022 REG,9,6,8,1,7,17,1,0,5,-5,1,0,0,0,0,0,0,0,0,0.5175913212324037,0.4824086787675963
86703,0.6774193548387096,0.35714285714285715,-210,180,0.6540062434963579,0.34599375650364206,away,ARI,over,8.5,0.5169082125603864,-107,0.49353874091423283,HOU,ARI,2022 REG,14,10,6,2,12,20,1,0,8,-8,1,1,0,0,0,0,0,0,0,0.49353874091423283,0.5064612590857671
86703,0.6774193548387096,0.35714285714285715,-210,180,0.6540062434963579,0.34599375650364206,home,HOU,under,8.5,0.5283018867924528,-112,0.5064612590857671,HOU,ARI,2022 REG,14,10,6,2,12,20,1,0,8,-8,1,1,0,0,0,0,0,0,0,0.49353874091423283,0.5064612590857671
86704,0.29850746268656714,0.7448979591836734,235,-292,0.28555062033724166,0.7144493796627583,away,ATL,over,9,0.5192307692307692,-108,0.49455035168025013,WSH,ATL,2022 REG,7,7,6,3,10,13,1,0,4,-4,1,1,1,0,0,0,0,0,0,0.49455035168025013,0.5054496483197499
86704,0.29850746268656714,0.7448979591836734,235,-292,0.28555062033724166,0.7144493796627583,home,WSH,under,9,0.5283018867924528,-112,0.5054496483197499,WSH,ATL,2022 REG,7,7,6,3,10,13,1,0,4,-4,1,1,1,0,0,0,0,0,0,0.49455035168025013,0.5054496483197499
86705,0.5918367346938775,0.45454545454545453,-145,120,0.5643860512665178,0.43561394873348225,away,CWS,over,7,0.5169082125603864,-107,0.49239402434819424,SF,CWS,2022 REG,8,3,8,5,8,16,0,1,-2,2,1,1,1,0,0,0,0,0,0,0.49239402434819424,0.5076059756518058
86705,0.5918367346938775,0.45454545454545453,-145,120,0.5643860512665178,0.43561394873348225,home,SF,under,7,0.5305164319248826,-113,0.5076059756518058,SF,CWS,2022 REG,8,3,8,5,8,16,0,1,-2,2,1,1,1,0,0,0,0,0,0,0.49239402434819424,0.5076059756518058
86706,0.6000000000000001,0.4424778761061947,-150,126,0.5745132743362832,0.4254867256637168,away,PIT,over,8,0.5145631067961165,-106,0.49023796582517226,ARI,PIT,2022 REG,7,4,11,6,10,18,0,1,-2,2,1,1,1,1,0,0,0,0,0,0.49023796582517226,0.5097620341748277
86706,0.6000000000000001,0.4424778761061947,-150,126,0.5745132743362832,0.4254867256637168,home,ARI,under,8,0.5327102803738317,-114,0.5097620341748277,ARI,PIT,2022 REG,7,4,11,6,10,18,0,1,-2,2,1,1,1,1,0,0,0,0,0,0.49023796582517226,0.5097620341748277
86707,0.5833333333333333,0.45454545454545453,-140,120,0.5612373737373737,0.4387626262626263,away,KC,over,7,0.504950495049505,-102,0.4826715732667395,CLE,KC,2022 REG,9,6,4,3,9,13,1,0,3,-3,1,1,1,0,0,0,0,0,0,0.4826715732667395,0.5173284267332605
86707,0.5833333333333333,0.45454545454545453,-140,120,0.5612373737373737,0.4387626262626263,home,CLE,under,7,0.5391705069124424,-117,0.5173284267332605,CLE,KC,2022 REG,9,6,4,3,9,13,1,0,3,-3,1,1,1,0,0,0,0,0,0,0.4826715732667395,0.5173284267332605
86708,0.6363636363636364,0.4,-175,150,0.6132231404958678,0.3867768595041322,away,MIA,over,9.5,0.504950495049505,-102,0.4826715732667395,PHI,MIA,2022 REG,8,3,7,1,4,15,1,0,2,-2,1,0,0,0,0,0,0,0,0,0.4826715732667395,0.5173284267332605
86708,0.6363636363636364,0.4,-175,150,0.6132231404958678,0.3867768595041322,home,PHI,under,9.5,0.5391705069124424,-117,0.5173284267332605,PHI,MIA,2022 REG,8,3,7,1,4,15,1,0,2,-2,1,0,0,0,0,0,0,0,0,0.4826715732667395,0.5173284267332605
86709,0.6402877697841727,0.4,-178,150,0.6144920035194866,0.38550799648051337,away,SF,over,7.5,0.5121951219512195,-105,0.4858858974112951,SD,SF,2022 REG,11,7,9,4,11,20,1,0,3,-3,1,1,1,1,0,0,0,0,0,0.4858858974112951,0.5141141025887048
86709,0.6402877697841727,0.4,-178,150,0.6144920035194866,0.38550799648051337,home,SD,under,7.5,0.5391705069124424,-117,0.5141141025887048,SD,SF,2022 REG,11,7,9,4,11,20,1,0,3,-3,1,1,1,1,0,0,0,0,0,0.4858858974112951,0.5141141025887048
86710,0.7142857142857143,0.3225806451612903,-250,210,0.6879526003949967,0.3120473996050033,away,COL,over,8,0.5145631067961165,-106,0.4913668392989033,SF,COL,2022 REG,5,3,8,5,8,13,0,1,-2,2,1,1,1,0,0,0,0,0,0,0.4913668392989033,0.5086331607010968
86710,0.7142857142857143,0.3225806451612903,-250,210,0.6879526003949967,0.3120473996050033,home,SF,under,8,0.5305164319248826,-113,0.5086331607010968,SF,COL,2022 REG,5,3,8,5,8,13,0,1,-2,2,1,1,1,0,0,0,0,0,0,0.4913668392989033,0.5086331607010968
86711,0.7701149425287357,0.26666666666666666,-335,275,0.741788875677104,0.25821112432289595,away,PIT,over,8,0.5327102803738317,-114,0.5075272610403079,LAD,PIT,2022 REG,10,5,9,6,11,19,0,1,-1,1,1,1,1,1,1,0,0,0,0,0.5075272610403079,0.4924727389596921
86711,0.7701149425287357,0.26666666666666666,-335,275,0.741788875677104,0.25821112432289595,home,LAD,under,8,0.5145631067961165,-106,0.4924727389596921,LAD,PIT,2022 REG,10,5,9,6,11,19,0,1,-1,1,1,1,1,1,1,0,0,0,0,0.5075272610403079,0.4924727389596921
86712,0.5454545454545454,0.49504950495049505,-120,102,0.5233614270517961,0.4766385729482039,away,BAL,over,7.5,0.5327102803738317,-114,0.508788710910954,DET,BAL,2022 REG,7,3,4,0,3,11,1,0,3,-3,0,0,0,0,0,0,0,0,0,0.508788710910954,0.491211289089046
86712,0.5454545454545454,0.49504950495049505,-120,102,0.5233614270517961,0.4766385729482039,home,DET,under,7.5,0.5121951219512195,-105,0.491211289089046,DET,BAL,2022 REG,7,3,4,0,3,11,1,0,3,-3,0,0,0,0,0,0,0,0,0,0.508788710910954,0.491211289089046
86713,0.607843137254902,0.4347826086956522,-155,130,0.5819333701084867,0.41806662989151333,away,SEA,over,9,0.5283018867924528,-112,0.5031902949311281,BOS,SEA,2022 REG,11,6,12,5,11,23,1,0,1,-1,1,1,1,1,1,0,0,0,0,0.5031902949311281,0.4968097050688719
86713,0.607843137254902,0.4347826086956522,-155,130,0.5819333701084867,0.41806662989151333,home,BOS,under,9,0.5192307692307692,-108,0.4968097050688719,BOS,SEA,2022 REG,11,6,12,5,11,23,1,0,1,-1,1,1,1,1,1,0,0,0,0,0.5031902949311281,0.4968097050688719
86714,0.4444444444444444,0.5918367346938775,125,-145,0.42831947593852354,0.5716805240614764,away,CWS,over,7,0.5,100,0.4772727272727273,CHC,CWS,2022 REG,5,3,9,4,7,14,0,1,-1,1,1,1,1,0,0,0,0,0,0,0.4772727272727273,0.5227272727272727
86714,0.4444444444444444,0.5918367346938775,125,-145,0.42831947593852354,0.5716805240614764,home,CHC,under,7,0.5454545454545454,-120,0.5227272727272727,CHC,CWS,2022 REG,5,3,9,4,7,14,0,1,-1,1,1,1,1,0,0,0,0,0,0,0.4772727272727273,0.5227272727272727
86715,0.647887323943662,0.3921568627450981,-184,155,0.6219432029903809,0.37805679700961914,away,MIA,over,7.5,0.5,100,0.4772727272727273,MIL,MIA,2022 REG,7,3,4,4,7,11,0,1,-1,1,1,1,1,0,0,0,0,0,0,0.4772727272727273,0.5227272727272727
86715,0.647887323943662,0.3921568627450981,-184,155,0.6219432029903809,0.37805679700961914,home,MIL,under,7.5,0.5454545454545454,-120,0.5227272727272727,MIL,MIA,2022 REG,7,3,4,4,7,11,0,1,-1,1,1,1,1,0,0,0,0,0,0,0.4772727272727273,0.5227272727272727
86716,0.5283018867924528,0.5121951219512195,-112,-105,0.5069072406637203,0.4930927593362797,away,CHC,over,8.5,0.5454545454545454,-120,0.5206611570247933,CIN,CHC,2022 REG,7,2,10,4,6,17,0,1,-2,2,1,1,0,0,0,0,0,0,0,0.5206611570247933,0.4793388429752067
86716,0.5283018867924528,0.5121951219512195,-112,-105,0.5069072406637203,0.4930927593362797,home,CIN,under,8.5,0.5,100,0.4793388429752067,CIN,CHC,2022 REG,7,2,10,4,6,17,0,1,-2,2,1,1,0,0,0,0,0,0,0,0.5206611570247933,0.4793388429752067
86717,0.46511627906976744,0.5726495726495727,115,-134,0.4475507666421673,0.5524492333578327,away,TEX,over,8,0.5121951219512195,-105,0.48808156828023186,OAK,TEX,2022 REG,6,3,7,1,4,13,1,0,2,-2,1,0,0,0,0,0,0,0,0,0.48808156828023186,0.5119184317197681
86717,0.46511627906976744,0.5726495726495727,115,-134,0.4475507666421673,0.5524492333578327,home,OAK,under,8,0.5348837209302326,-115,0.5119184317197681,OAK,TEX,2022 REG,6,3,7,1,4,13,1,0,2,-2,1,0,0,0,0,0,0,0,0,0.48808156828023186,0.5119184317197681
86718,0.6825396825396826,0.35714285714285715,-215,180,0.6554547745023935,0.34454522549760647,away,CHC,over,7.5,0.5,100,0.4772727272727273,STL,CHC,2022 REG,9,8,10,4,12,19,1,0,4,-4,1,1,1,1,0,0,0,0,0,0.4772727272727273,0.5227272727272727
86718,0.6825396825396826,0.35714285714285715,-215,180,0.6554547745023935,0.34454522549760647,home,STL,under,7.5,0.5454545454545454,-120,0.5227272727272727,STL,CHC,2022 REG,9,8,10,4,12,19,1,0,4,-4,1,1,1,1,0,0,0,0,0,0.4772727272727273,0.5227272727272727
86719,0.425531914893617,0.613899613899614,135,-159,0.40875254093905067,0.5912474590609493,away,SF,over,8,0.5348837209302326,-115,0.5097020142727117,DET,SF,2022 REG,7,6,8,1,7,15,1,0,5,-5,1,0,0,0,0,0,0,0,0,0.5097020142727117,0.49029798572728833
86719,0.425531914893617,0.613899613899614,135,-159,0.40875254093905067,0.5912474590609493,home,DET,under,8,0.5121951219512195,-105,0.49029798572728833,DET,SF,2022 REG,7,6,8,1,7,15,1,0,5,-5,1,0,0,0,0,0,0,0,0,0.5097020142727117,0.49029798572728833
86720,0.5689655172413793,0.4672897196261683,-132,114,0.5483375376443265,0.45166246235567353,away,KC,over,8.5,0.5121951219512195,-105,0.48808156828023186,TEX,KC,2022 REG,6,3,5,1,4,11,1,0,2,-2,1,0,0,0,0,0,0,0,0,0.48808156828023186,0.5119184317197681
86720,0.5689655172413793,0.4672897196261683,-132,114,0.5483375376443265,0.45166246235567353,home,TEX,under,8.5,0.5348837209302326,-115,0.5119184317197681,TEX,KC,2022 REG,6,3,5,1,4,11,1,0,2,-2,1,0,0,0,0,0,0,0,0,0.48808156828023186,0.5119184317197681
86721,0.6666666666666666,0.37735849056603776,-200,165,0.6373165618448637,0.36268343815513626,away,BAL,over,8,0.5215311004784688,-109,0.49907282342437215,STL,BAL,2022 REG,11,10,5,1,11,16,1,0,9,-9,1,0,0,0,0,0,0,0,0,0.49907282342437215,0.5009271765756278
86721,0.6666666666666666,0.37735849056603776,-200,165,0.6373165618448637,0.36268343815513626,home,STL,under,8,0.5215311004784688,-109,0.5009271765756278,STL,BAL,2022 REG,11,10,5,1,11,16,1,0,9,-9,1,0,0,0,0,0,0,0,0,0.49907282342437215,0.5009271765756278
86722,0.6721311475409836,0.36363636363636365,-205,175,0.6480906892086682,0.3519093107913318,away,KC,over,8.5,0.5169082125603864,-107,0.49353874091423283,CWS,KC,2022 REG,9,4,6,2,6,15,1,0,2,-2,1,1,0,0,0,0,0,0,0,0.49353874091423283,0.5064612590857671
86722,0.6721311475409836,0.36363636363636365,-205,175,0.6480906892086682,0.3519093107913318,home,CWS,under,8.5,0.5283018867924528,-112,0.5064612590857671,CWS,KC,2022 REG,9,4,6,2,6,15,1,0,2,-2,1,1,0,0,0,0,0,0,0,0.49353874091423283,0.5064612590857671
86723,0.6363636363636364,0.4,-175,150,0.6132231404958678,0.3867768595041322,away,WSH,over,9.5,0.5,100,0.4772727272727273,ATL,WSH,2022 REG,19,16,9,4,20,28,1,0,12,-12,1,1,1,1,0,0,0,0,0,0.4772727272727273,0.5227272727272727
86723,0.6363636363636364,0.4,-175,150,0.6132231404958678,0.3867768595041322,home,ATL,under,9.5,0.5454545454545454,-120,0.5227272727272727,ATL,WSH,2022 REG,19,16,9,4,20,28,1,0,12,-12,1,1,1,1,0,0,0,0,0,0.4772727272727273,0.5227272727272727
86725,0.35714285714285715,0.6774193548387096,180,-210,0.3447992100065833,0.6552007899934167,away,TOR,over,8,0.5215311004784688,-109,0.4978845547971712,PIT,TOR,2022 REG,5,3,9,4,7,14,0,1,-1,1,1,1,1,0,0,0,0,0,0,0.4978845547971712,0.5021154452028288
86725,0.35714285714285715,0.6774193548387096,180,-210,0.3447992100065833,0.6552007899934167,home,PIT,under,8,0.5238095238095238,-110,0.5021154452028288,PIT,TOR,2022 REG,5,3,9,4,7,14,0,1,-1,1,1,1,1,0,0,0,0,0,0,0.4978845547971712,0.5021154452028288
86726,0.5555555555555556,0.4807692307692307,-125,108,0.5353751187084521,0.4646248812915479,away,CHC,over,11.5,0.5073891625615764,-103,0.4837652908580103,COL,CHC,2022 REG,10,2,10,5,7,20,0,1,-3,3,1,1,0,0,0,0,0,0,0,0.4837652908580103,0.5162347091419897
86726,0.5555555555555556,0.4807692307692307,-125,108,0.5353751187084521,0.4646248812915479,home,COL,under,11.5,0.5391705069124424,-117,0.5162347091419897,COL,CHC,2022 REG,10,2,10,5,7,20,0,1,-3,3,1,1,0,0,0,0,0,0,0,0.4837652908580103,0.5162347091419897
86727,0.607843137254902,0.4347826086956522,-155,130,0.5819333701084867,0.41806662989151333,away,BAL,over,9,0.5098039215686274,-104,0.48592421718142587,MIN,BAL,2022 REG,4,1,7,3,4,11,0,1,-2,2,1,0,0,0,0,0,0,0,0,0.48592421718142587,0.5140757828185741
86727,0.607843137254902,0.4347826086956522,-155,130,0.5819333701084867,0.41806662989151333,home,MIN,under,9,0.5370370370370371,-116,0.5140757828185741,MIN,BAL,2022 REG,4,1,7,3,4,11,0,1,-2,2,1,0,0,0,0,0,0,0,0,0.48592421718142587,0.5140757828185741
86728,0.5348837209302326,0.5098039215686274,-115,-104,0.5109810284308424,0.48901897156915763,away,MIA,over,8,0.5348837209302326,-115,0.5109810284308424,WSH,MIA,2022 REG,8,2,10,3,5,18,0,1,-1,1,1,1,0,0,0,0,0,0,0,0.5109810284308424,0.48901897156915763
86728,0.5348837209302326,0.5098039215686274,-115,-104,0.5109810284308424,0.48901897156915763,home,WSH,under,8,0.5098039215686274,-104,0.48901897156915763,WSH,MIA,2022 REG,8,2,10,3,5,18,0,1,-1,1,1,1,0,0,0,0,0,0,0,0.5109810284308424,0.48901897156915763
86729,0.4166666666666667,0.6226415094339623,140,-165,0.4002882599580712,0.5997117400419287,away,SF,over,9,0.5495495495495495,-122,0.5250401592387142,ARI,SF,2022 REG,9,6,6,2,8,15,1,0,4,-4,1,1,0,0,0,0,0,0,0,0.5250401592387142,0.47495984076128583
86729,0.4166666666666667,0.6226415094339623,140,-165,0.4002882599580712,0.5997117400419287,home,ARI,under,9,0.49504950495049505,102,0.47495984076128583,ARI,SF,2022 REG,9,6,6,2,8,15,1,0,4,-4,1,1,0,0,0,0,0,0,0,0.5250401592387142,0.47495984076128583
86730,0.5238095238095238,0.5305164319248826,-110,-113,0.4953530708057871,0.5046469291942128,away,TEX,over,7.5,0.5370370370370371,-116,0.5105975442470474,LAA,TEX,2022 REG,4,2,10,7,9,14,0,1,-5,5,1,1,0,0,0,0,0,0,0,0.5105975442470474,0.4894024557529526
86730,0.5238095238095238,0.5305164319248826,-110,-113,0.4953530708057871,0.5046469291942128,home,LAA,under,7.5,0.5121951219512195,-105,0.4894024557529526,LAA,TEX,2022 REG,4,2,10,7,9,14,0,1,-5,5,1,1,0,0,0,0,0,0,0,0.5105975442470474,0.4894024557529526
86731,0.4484304932735426,0.5918367346938775,123,-145,0.43037344037335423,0.5696265596266458,away,NYY,over,9,0.5238095238095238,-110,0.4988662131519274,BOS,NYY,2022 REG,8,2,6,3,5,14,0,1,-1,1,1,1,0,0,0,0,0,0,0,0.4988662131519274,0.5011337868480725
86731,0.4484304932735426,0.5918367346938775,123,-145,0.43037344037335423,0.5696265596266458,home,BOS,under,9,0.5238095238095238,-110,0.5011337868480725,BOS,NYY,2022 REG,8,2,6,3,5,14,0,1,-1,1,1,1,0,0,0,0,0,0,0,0.4988662131519274,0.5011337868480725
86732,0.4132231404958678,0.6254681647940076,142,-167,0.3972349978141011,0.6027650021858989,away,LAA,over,7.5,0.5238095238095238,-110,0.4988662131519274,DET,LAA,2022 REG,11,4,7,3,7,18,1,0,1,-1,1,1,1,0,0,0,0,0,0,0.4988662131519274,0.5011337868480725
86732,0.4132231404958678,0.6254681647940076,142,-167,0.3972349978141011,0.6027650021858989,home,DET,under,7.5,0.5238095238095238,-110,0.5011337868480725,DET,LAA,2022 REG,11,4,7,3,7,18,1,0,1,-1,1,1,1,0,0,0,0,0,0,0.4988662131519274,0.5011337868480725
86733,0.5348837209302326,0.5098039215686274,-115,-104,0.5109810284308424,0.48901897156915763,away,PHI,over,8.5,0.5412844036697247,-118,0.5149381613977361,MIL,PHI,2022 REG,7,2,9,3,5,16,0,1,-1,1,1,1,0,0,0,0,0,0,0,0.5149381613977361,0.48506183860226393
86733,0.5348837209302326,0.5098039215686274,-115,-104,0.5109810284308424,0.48901897156915763,home,MIL,under,8.5,0.5073891625615764,-103,0.48506183860226393,MIL,PHI,2022 REG,7,2,9,3,5,16,0,1,-1,1,1,1,0,0,0,0,0,0,0,0.5149381613977361,0.48506183860226393
86734,0.4,0.6402877697841727,150,-178,0.383884892086331,0.6161151079136691,away,PHI,over,9,0.5454545454545454,-120,0.5206611570247933,CIN,PHI,2022 REG,9,4,18,11,15,27,0,1,-7,7,1,1,1,1,0,0,0,0,0,0.5206611570247933,0.4793388429752067
86734,0.4,0.6402877697841727,150,-178,0.383884892086331,0.6161151079136691,home,CIN,under,9,0.5,100,0.4793388429752067,CIN,PHI,2022 REG,9,4,18,11,15,27,0,1,-7,7,1,1,1,1,0,0,0,0,0,0.5206611570247933,0.4793388429752067
86735,0.5121951219512195,0.5238095238095238,-105,-110,0.4937537180249852,0.5062462819750149,away,CWS,over,8,0.5073891625615764,-103,0.4837652908580103,MIN,CWS,2022 REG,5,2,6,1,3,11,1,0,1,-1,1,0,0,0,0,0,0,0,0,0.4837652908580103,0.5162347091419897
86735,0.5121951219512195,0.5238095238095238,-105,-110,0.4937537180249852,0.5062462819750149,home,MIN,under,8,0.5391705069124424,-117,0.5162347091419897,MIN,CWS,2022 REG,5,2,6,1,3,11,1,0,1,-1,1,0,0,0,0,0,0,0,0,0.4837652908580103,0.5162347091419897
86736,0.7101449275362319,0.3278688524590164,-245,205,0.6831496344961281,0.3168503655038719,away,CIN,over,8.5,0.5348837209302326,-115,0.5097020142727117,PHI,CIN,2022 REG,8,4,3,1,5,11,1,0,3,-3,1,0,0,0,0,0,0,0,0,0.5097020142727117,0.49029798572728833
86736,0.7101449275362319,0.3278688524590164,-245,205,0.6831496344961281,0.3168503655038719,home,PHI,under,8.5,0.5121951219512195,-105,0.49029798572728833,PHI,CIN,2022 REG,8,4,3,1,5,11,1,0,3,-3,1,0,0,0,0,0,0,0,0,0.5097020142727117,0.49029798572728833
86737,0.6000000000000001,0.43859649122807015,-150,128,0.5768421052631579,0.42315789473684207,away,DET,over,7,0.5495495495495495,-122,0.5250401592387142,MIN,DET,2022 REG,5,5,8,4,9,13,1,0,1,-1,1,1,1,1,0,0,0,0,0,0.5250401592387142,0.47495984076128583
86737,0.6000000000000001,0.43859649122807015,-150,128,0.5768421052631579,0.42315789473684207,home,MIN,under,7,0.49504950495049505,102,0.47495984076128583,MIN,DET,2022 REG,5,5,8,4,9,13,1,0,1,-1,1,1,1,1,0,0,0,0,0,0.5250401592387142,0.47495984076128583
86738,0.5475113122171946,0.48780487804878053,-121,105,0.5281752985421585,0.4718247014578415,away,TOR,over,8,0.5412844036697247,-118,0.5149381613977361,TB,TOR,2022 REG,6,1,7,5,6,13,0,1,-4,4,1,0,0,0,0,0,0,0,0,0.5149381613977361,0.48506183860226393
86738,0.5475113122171946,0.48780487804878053,-121,105,0.5281752985421585,0.4718247014578415,home,TB,under,8,0.5073891625615764,-103,0.48506183860226393,TB,TOR,2022 REG,6,1,7,5,6,13,0,1,-4,4,1,0,0,0,0,0,0,0,0,0.5149381613977361,0.48506183860226393
86739,0.6666666666666666,0.37037037037037035,-200,170,0.6419753086419753,0.3580246913580247,away,BAL,over,8.5,0.5412844036697247,-118,0.5175913212324037,TB,BAL,2022 REG,11,8,6,0,8,17,1,0,8,-8,0,0,0,0,0,0,0,0,0,0.5175913212324037,0.4824086787675963
86739,0.6666666666666666,0.37037037037037035,-200,170,0.6419753086419753,0.3580246913580247,home,TB,under,8.5,0.5024875621890548,-101,0.4824086787675963,TB,BAL,2022 REG,11,8,6,0,8,17,1,0,8,-8,0,0,0,0,0,0,0,0,0,0.5175913212324037,0.4824086787675963
86740,0.6363636363636364,0.4,-175,150,0.6132231404958678,0.3867768595041322,away,TEX,over,8.5,0.5454545454545454,-120,0.5206611570247933,MIN,TEX,2022 REG,6,3,11,4,7,17,0,1,-1,1,1,1,1,0,0,0,0,0,0,0.5206611570247933,0.4793388429752067
86740,0.6363636363636364,0.4,-175,150,0.6132231404958678,0.3867768595041322,home,MIN,under,8.5,0.5,100,0.4793388429752067,MIN,TEX,2022 REG,6,3,11,4,7,17,0,1,-1,1,1,1,1,0,0,0,0,0,0,0.5206611570247933,0.4793388429752067
86741,0.6453900709219857,0.3921568627450981,-182,155,0.6211576527396834,0.3788423472603166,away,PHI,over,8,0.5348837209302326,-115,0.5097020142727117,LAD,PHI,2022 REG,5,3,10,8,11,15,0,1,-5,5,1,1,1,0,0,0,0,0,0,0.5097020142727117,0.49029798572728833
86741,0.6453900709219857,0.3921568627450981,-182,155,0.6211576527396834,0.3788423472603166,home,LAD,under,8,0.5121951219512195,-105,0.49029798572728833,LAD,PHI,2022 REG,5,3,10,8,11,15,0,1,-5,5,1,1,1,0,0,0,0,0,0,0.5097020142727117,0.49029798572728833
86742,0.49504950495049505,0.5412844036697247,102,-118,0.47706242147513866,0.5229375785248613,away,BOS,over,8,0.5283018867924528,-112,0.5044173060022736,DET,BOS,2022 REG,11,7,12,9,16,23,0,1,-2,2,1,1,1,1,1,1,1,0,0,0.5044173060022736,0.49558269399772636
86742,0.49504950495049505,0.5412844036697247,102,-118,0.47706242147513866,0.5229375785248613,home,DET,under,8,0.5169082125603864,-107,0.49558269399772636,DET,BOS,2022 REG,11,7,12,9,16,23,0,1,-2,2,1,1,1,1,1,1,1,0,0,0.5044173060022736,0.49558269399772636
86743,0.37735849056603776,0.6610169491525424,165,-195,0.36287719255902645,0.6371228074409736,away,LAD,over,8.5,0.5454545454545454,-120,0.5206611570247933,ARI,LAD,2022 REG,3,0,9,4,4,12,0,1,-4,4,0,0,0,0,0,0,0,0,0,0.5206611570247933,0.4793388429752067
86743,0.37735849056603776,0.6610169491525424,165,-195,0.36287719255902645,0.6371228074409736,home,ARI,under,8.5,0.5,100,0.4793388429752067,ARI,LAD,2022 REG,3,0,9,4,4,12,0,1,-4,4,0,0,0,0,0,0,0,0,0,0.5206611570247933,0.4793388429752067
86744,0.5454545454545454,0.49504950495049505,-120,102,0.5233614270517961,0.4766385729482039,away,PHI,over,7.5,0.5283018867924528,-112,0.5044173060022736,SD,PHI,2022 REG,4,2,7,4,6,11,0,1,-2,2,1,1,0,0,0,0,0,0,0,0.5044173060022736,0.49558269399772636
86744,0.5454545454545454,0.49504950495049505,-120,102,0.5233614270517961,0.4766385729482039,home,SD,under,7.5,0.5169082125603864,-107,0.49558269399772636,SD,PHI,2022 REG,4,2,7,4,6,11,0,1,-2,2,1,1,0,0,0,0,0,0,0,0.5044173060022736,0.49558269399772636
86745,0.4,0.6428571428571428,150,-180,0.38285714285714295,0.617142857142857,away,LAD,over,8.5,0.5073891625615764,-103,0.4837652908580103,CWS,LAD,2022 REG,4,1,6,4,5,10,0,1,-3,3,1,0,0,0,0,0,0,0,0,0.4837652908580103,0.5162347091419897
86745,0.4,0.6428571428571428,150,-180,0.38285714285714295,0.617142857142857,home,CWS,under,8.5,0.5391705069124424,-117,0.5162347091419897,CWS,LAD,2022 REG,4,1,6,4,5,10,0,1,-3,3,1,0,0,0,0,0,0,0,0,0.4837652908580103,0.5162347091419897
86746,0.5967741935483871,0.4444444444444444,-148,125,0.5721759741010521,0.42782402589894786,away,SD,over,6.5,0.5454545454545454,-120,0.5206611570247933,MIL,SD,2022 REG,1,0,13,7,7,14,0,1,-7,7,0,0,0,0,0,0,0,0,0,0.5206611570247933,0.4793388429752067
86746,0.5967741935483871,0.4444444444444444,-148,125,0.5721759741010521,0.42782402589894786,home,MIL,under,6.5,0.5,100,0.4793388429752067,MIL,SD,2022 REG,1,0,13,7,7,14,0,1,-7,7,0,0,0,0,0,0,0,0,0,0.5206611570247933,0.4793388429752067
86747,0.5967741935483871,0.4484304932735426,-148,123,0.5697972030256225,0.43020279697437747,away,ARI,over,10.5,0.5215311004784688,-109,0.4978845547971712,CIN,ARI,2022 REG,16,14,10,8,22,26,1,0,6,-6,1,1,1,1,1,1,1,1,0,0.4978845547971712,0.5021154452028288
86747,0.5967741935483871,0.4484304932735426,-148,123,0.5697972030256225,0.43020279697437747,home,CIN,under,10.5,0.5238095238095238,-110,0.5021154452028288,CIN,ARI,2022 REG,16,14,10,8,22,26,1,0,6,-6,1,1,1,1,1,1,1,1,0,0.4978845547971712,0.5021154452028288
86748,0.6226415094339623,0.4166666666666667,-165,140,0.5981666073335706,0.40183339266642937,away,CLE,over,8.5,0.5192307692307692,-108,0.49688292476754015,CWS,CLE,2022 REG,7,2,15,8,10,22,0,1,-6,6,1,1,0,0,0,0,0,0,0,0.49688292476754015,0.5031170752324599
86748,0.6226415094339623,0.4166666666666667,-165,140,0.5981666073335706,0.40183339266642937,home,CWS,under,8.5,0.5238095238095238,-110,0.5031170752324599,CWS,CLE,2022 REG,7,2,15,8,10,22,0,1,-6,6,1,1,0,0,0,0,0,0,0,0.49688292476754015,0.5031170752324599
86749,0.5454545454545454,0.48780487804878053,-120,105,0.5273130417254586,0.47268695827454144,away,MIN,over,7,0.5121951219512195,-105,0.48808156828023186,CLE,MIN,2022 REG,14,11,10,4,15,24,1,0,7,-7,1,1,1,1,0,0,0,0,0,0.48808156828023186,0.5119184317197681
86749,0.5454545454545454,0.48780487804878053,-120,105,0.5273130417254586,0.47268695827454144,home,CLE,under,7,0.5348837209302326,-115,0.5119184317197681,CLE,MIN,2022 REG,14,11,10,4,15,24,1,0,7,-7,1,1,1,1,0,0,0,0,0,0.48808156828023186,0.5119184317197681
86750,0.42016806722689076,0.6153846153846154,138,-160,0.4052299652892831,0.5947700347107169,away,NYY,over,8.5,0.5327102803738317,-114,0.5075272610403079,BOS,NYY,2022 REG,6,6,8,7,13,14,0,1,-1,1,1,1,1,1,1,1,0,0,0,0.5075272610403079,0.4924727389596921
86750,0.42016806722689076,0.6153846153846154,138,-160,0.4052299652892831,0.5947700347107169,home,BOS,under,8.5,0.5145631067961165,-106,0.4924727389596921,BOS,NYY,2022 REG,6,6,8,7,13,14,0,1,-1,1,1,1,1,1,1,1,0,0,0,0.5075272610403079,0.4924727389596921
86751,0.7058823529411764,0.3333333333333333,-240,200,0.6782006920415226,0.32179930795847744,away,LAA,over,7.5,0.5412844036697247,-118,0.5136310900085983,HOU,LAA,2022 REG,10,4,4,2,6,14,1,0,2,-2,1,1,0,0,0,0,0,0,0,0.5136310900085983,0.4863689099914017
86751,0.7058823529411764,0.3333333333333333,-240,200,0.6782006920415226,0.32179930795847744,home,HOU,under,7.5,0.5098039215686274,-104,0.4863689099914017,HOU,LAA,2022 REG,10,4,4,2,6,14,1,0,2,-2,1,1,0,0,0,0,0,0,0,0.5136310900085983,0.4863689099914017
86752,0.3389830508474576,0.7014925373134329,195,-235,0.3252625124878337,0.6747374875121663,away,LAD,over,9,0.5121951219512195,-105,0.48808156828023186,KC,LAD,2022 REG,8,4,3,0,4,11,1,0,4,-4,0,0,0,0,0,0,0,0,0,0.48808156828023186,0.5119184317197681
86752,0.3389830508474576,0.7014925373134329,195,-235,0.3252625124878337,0.6747374875121663,home,KC,under,9,0.5348837209302326,-115,0.5119184317197681,KC,LAD,2022 REG,8,4,3,0,4,11,1,0,4,-4,0,0,0,0,0,0,0,0,0,0.48808156828023186,0.5119184317197681
86753,0.6551724137931035,0.38759689922480617,-190,158,0.6271511397468869,0.37284886025311315,away,BAL,over,7.5,0.5,100,0.4772727272727273,CLE,BAL,2022 REG,2,0,7,3,3,9,0,1,-3,3,0,0,0,0,0,0,0,0,0,0.4772727272727273,0.5227272727272727
86753,0.6551724137931035,0.38759689922480617,-190,158,0.6271511397468869,0.37284886025311315,home,CLE,under,7.5,0.5454545454545454,-120,0.5227272727272727,CLE,BAL,2022 REG,2,0,7,3,3,9,0,1,-3,3,0,0,0,0,0,0,0,0,0,0.4772727272727273,0.5227272727272727
86754,0.36363636363636365,0.6774193548387096,175,-210,0.3487070114636097,0.6512929885363903,away,HOU,over,8.5,0.5073891625615764,-103,0.4816299493915137,CLE,HOU,2022 REG,8,3,14,9,12,22,0,1,-6,6,1,1,1,0,0,0,0,0,0,0.4816299493915137,0.5183700506084863
86754,0.36363636363636365,0.6774193548387096,175,-210,0.3487070114636097,0.6512929885363903,home,CLE,under,8.5,0.5433789954337899,-119,0.5183700506084863,CLE,HOU,2022 REG,8,3,14,9,12,22,0,1,-6,6,1,1,1,0,0,0,0,0,0,0.4816299493915137,0.5183700506084863
86755,0.5901639344262295,0.4484304932735426,-144,123,0.5673868951280033,0.43261310487199667,away,NYY,over,8,0.5169082125603864,-107,0.49353874091423283,CWS,NYY,2022 REG,8,7,15,15,22,23,0,1,-8,8,1,1,1,1,1,1,1,0,0,0.49353874091423283,0.5064612590857671
86755,0.5901639344262295,0.4484304932735426,-144,123,0.5673868951280033,0.43261310487199667,home,CWS,under,8,0.5283018867924528,-112,0.5064612590857671,CWS,NYY,2022 REG,8,7,15,15,22,23,0,1,-8,8,1,1,1,1,1,1,1,0,0,0.49353874091423283,0.5064612590857671
86756,0.3846153846153846,0.6503496503496503,160,-186,0.3711672942442173,0.6288327057557828,away,SF,over,8.5,0.5260663507109005,-111,0.5022370601254724,ARI,SF,2022 REG,5,7,7,3,10,12,1,0,4,-4,1,1,1,0,0,0,0,0,0,0.5022370601254724,0.4977629398745276
86756,0.3846153846153846,0.6503496503496503,160,-186,0.3711672942442173,0.6288327057557828,home,ARI,under,8.5,0.5192307692307692,-108,0.4977629398745276,ARI,SF,2022 REG,5,7,7,3,10,12,1,0,4,-4,1,1,1,0,0,0,0,0,0,0.5022370601254724,0.4977629398745276
86757,0.3921568627450981,0.6428571428571428,155,-180,0.37842588015598405,0.6215741198440159,away,MIL,over,7.5,0.5145631067961165,-106,0.4913668392989033,PIT,MIL,2022 REG,1,1,4,3,4,5,0,1,-2,2,1,0,0,0,0,0,0,0,0,0.4913668392989033,0.5086331607010968
86757,0.3921568627450981,0.6428571428571428,155,-180,0.37842588015598405,0.6215741198440159,home,PIT,under,7.5,0.5305164319248826,-113,0.5086331607010968,PIT,MIL,2022 REG,1,1,4,3,4,5,0,1,-2,2,1,0,0,0,0,0,0,0,0,0.4913668392989033,0.5086331607010968
86758,0.6491228070175439,0.3921568627450981,-185,155,0.6223272319084604,0.3776727680915396,away,KC,over,7.5,0.5,100,0.4772727272727273,TB,KC,2022 REG,9,3,4,2,5,13,1,0,1,-1,1,1,0,0,0,0,0,0,0,0.4772727272727273,0.5227272727272727
86758,0.6491228070175439,0.3921568627450981,-185,155,0.6223272319084604,0.3776727680915396,home,TB,under,7.5,0.5454545454545454,-120,0.5227272727272727,TB,KC,2022 REG,9,3,4,2,5,13,1,0,1,-1,1,1,0,0,0,0,0,0,0,0.4772727272727273,0.5227272727272727
86759,0.5,0.5412844036697247,100,-118,0.47935779816513757,0.5206422018348624,away,CIN,over,8,0.5121951219512195,-105,0.48919479393107135,PIT,CIN,2022 REG,5,3,4,1,4,9,1,0,2,-2,1,0,0,0,0,0,0,0,0,0.48919479393107135,0.5108052060689287
86759,0.5,0.5412844036697247,100,-118,0.47935779816513757,0.5206422018348624,home,PIT,under,8,0.5327102803738317,-114,0.5108052060689287,PIT,CIN,2022 REG,5,3,4,1,4,9,1,0,2,-2,1,0,0,0,0,0,0,0,0,0.48919479393107135,0.5108052060689287
86760,0.5535714285714286,0.49019607843137253,-124,104,0.5293429871948779,0.47065701280512207,away,PHI,over,9,0.49751243781094534,101,0.47511256217505476,STL,PHI,2022 REG,2,0,5,1,1,7,0,1,-1,1,0,0,0,0,0,0,0,0,0,0.47511256217505476,0.5248874378249453
86760,0.5535714285714286,0.49019607843137253,-124,104,0.5293429871948779,0.47065701280512207,home,STL,under,9,0.5475113122171946,-121,0.5248874378249453,STL,PHI,2022 REG,2,0,5,1,1,7,0,1,-1,1,0,0,0,0,0,0,0,0,0,0.47511256217505476,0.5248874378249453
86761,0.5495495495495495,0.49019607843137253,-122,104,0.5277073575960698,0.4722926424039302,away,CLE,over,7,0.5,100,0.4772727272727273,TB,CLE,2022 REG,6,1,8,4,5,14,0,1,-3,3,1,0,0,0,0,0,0,0,0,0.4772727272727273,0.5227272727272727
86761,0.5495495495495495,0.49019607843137253,-122,104,0.5277073575960698,0.4722926424039302,home,TB,under,7,0.5454545454545454,-120,0.5227272727272727,TB,CLE,2022 REG,6,1,8,4,5,14,0,1,-3,3,1,0,0,0,0,0,0,0,0,0.4772727272727273,0.5227272727272727
86762,0.4464285714285714,0.5934959349593496,124,-146,0.42860513107682097,0.571394868923179,away,NYM,over,8,0.5238095238095238,-110,0.5000596729920038,CHC,NYM,2022 REG,7,3,9,2,5,16,1,0,1,-1,1,1,0,0,0,0,0,0,0,0.5000596729920038,0.4999403270079962
86762,0.4464285714285714,0.5934959349593496,124,-146,0.42860513107682097,0.571394868923179,home,CHC,under,8,0.5215311004784688,-109,0.4999403270079962,CHC,NYM,2022 REG,7,3,9,2,5,16,1,0,1,-1,1,1,0,0,0,0,0,0,0,0.5000596729920038,0.4999403270079962
86763,0.5348837209302326,0.5121951219512195,-115,-105,0.5097020142727117,0.49029798572728833,away,MIN,over,8.5,0.5283018867924528,-112,0.5031902949311281,CLE,MIN,2022 REG,5,3,6,2,5,11,1,0,1,-1,1,1,0,0,0,0,0,0,0,0.5031902949311281,0.4968097050688719
86763,0.5348837209302326,0.5121951219512195,-115,-105,0.5097020142727117,0.49029798572728833,home,CLE,under,8.5,0.5192307692307692,-108,0.4968097050688719,CLE,MIN,2022 REG,5,3,6,2,5,11,1,0,1,-1,1,1,0,0,0,0,0,0,0,0.5031902949311281,0.4968097050688719
86764,0.49019607843137253,0.5454545454545454,104,-120,0.4727202824088637,0.5272797175911363,away,CHC,over,9,0.5169082125603864,-107,0.49586088023391106,CIN,CHC,2022 REG,5,4,8,7,11,13,0,1,-3,3,1,1,1,1,0,0,0,0,0,0.49586088023391106,0.5041391197660889
86764,0.49019607843137253,0.5454545454545454,104,-120,0.4727202824088637,0.5272797175911363,home,CIN,under,9,0.5238095238095238,-110,0.5041391197660889,CIN,CHC,2022 REG,5,4,8,7,11,13,0,1,-3,3,1,1,1,1,0,0,0,0,0,0.49586088023391106,0.5041391197660889
86765,0.5454545454545454,0.5,-120,100,0.5206611570247933,0.4793388429752067,away,STL,over,8.5,0.5327102803738317,-114,0.508788710910954,MIL,STL,2022 REG,5,1,8,2,3,13,0,1,-1,1,1,0,0,0,0,0,0,0,0,0.508788710910954,0.491211289089046
86765,0.5454545454545454,0.5,-120,100,0.5206611570247933,0.4793388429752067,home,MIL,under,8.5,0.5121951219512195,-105,0.491211289089046,MIL,STL,2022 REG,5,1,8,2,3,13,0,1,-1,1,1,0,0,0,0,0,0,0,0,0.508788710910954,0.491211289089046
86766,0.726027397260274,0.3125,-265,220,0.6980554513041847,0.30194454869581533,away,BAL,over,8,0.5391705069124424,-117,0.5153817639191344,NYY,BAL,2022 REG,8,5,5,2,7,13,1,0,3,-3,1,1,0,0,0,0,0,0,0,0.5153817639191344,0.4846182360808656
86766,0.726027397260274,0.3125,-265,220,0.6980554513041847,0.30194454869581533,home,NYY,under,8,0.504950495049505,-102,0.4846182360808656,NYY,BAL,2022 REG,8,5,5,2,7,13,1,0,3,-3,1,1,0,0,0,0,0,0,0,0.5153817639191344,0.4846182360808656
86767,0.696969696969697,0.3389830508474576,-230,195,0.6719117212183469,0.32808827878165314,away,SEA,over,8,0.5,100,0.47935779816513757,TOR,SEA,2022 REG,7,1,10,5,6,17,0,1,-4,4,1,0,0,0,0,0,0,0,0,0.47935779816513757,0.5206422018348624
86767,0.696969696969697,0.3389830508474576,-230,195,0.6719117212183469,0.32808827878165314,home,TOR,under,8,0.5412844036697247,-118,0.5206422018348624,TOR,SEA,2022 REG,7,1,10,5,6,17,0,1,-4,4,1,0,0,0,0,0,0,0,0,0.47935779816513757,0.5206422018348624
86768,0.7014925373134329,0.3401360544217687,-235,194,0.6722903908723213,0.32770960912767866,away,WSH,over,9,0.5305164319248826,-113,0.5053568787472517,PHI,WSH,2022 REG,7,5,11,4,9,18,1,0,1,-1,1,1,1,1,0,0,0,0,0,0.5053568787472517,0.49464312125274834
86768,0.7014925373134329,0.3401360544217687,-235,194,0.6722903908723213,0.32770960912767866,home,PHI,under,9,0.5169082125603864,-107,0.49464312125274834,PHI,WSH,2022 REG,7,5,11,4,9,18,1,0,1,-1,1,1,1,1,0,0,0,0,0,0.5053568787472517,0.49464312125274834
86769,0.4484304932735426,0.5884773662551441,123,-143,0.43187988361942303,0.5681201163805769,away,HOU,over,8.5,0.5412844036697247,-118,0.5149381613977361,LAA,HOU,2022 REG,7,2,7,4,6,14,0,1,-2,2,1,1,0,0,0,0,0,0,0,0.5149381613977361,0.48506183860226393
86769,0.4484304932735426,0.5884773662551441,123,-143,0.43187988361942303,0.5681201163805769,home,LAA,under,8.5,0.5073891625615764,-103,0.48506183860226393,LAA,HOU,2022 REG,7,2,7,4,6,14,0,1,-2,2,1,1,0,0,0,0,0,0,0,0.5149381613977361,0.48506183860226393
86770,0.48780487804878053,0.5475113122171946,105,-121,0.470577468162939,0.529422531837061,away,BOS,over,9.5,0.5145631067961165,-106,0.4925063625223866,DET,BOS,2022 REG,8,3,4,1,4,12,1,0,2,-2,1,0,0,0,0,0,0,0,0,0.4925063625223866,0.5074936374776133
86770,0.48780487804878053,0.5475113122171946,105,-121,0.470577468162939,0.529422531837061,home,DET,under,9.5,0.5283018867924528,-112,0.5074936374776133,DET,BOS,2022 REG,8,3,4,1,4,12,1,0,2,-2,1,0,0,0,0,0,0,0,0,0.4925063625223866,0.5074936374776133
86771,0.4504504504504505,0.5918367346938775,122,-145,0.43140216885390636,0.5685978311460936,away,ATL,over,7,0.5535714285714286,-124,0.5266562689432208,MIA,ATL,2022 REG,12,3,8,4,7,20,0,1,-1,1,1,1,1,0,0,0,0,0,0,0.5266562689432208,0.4733437310567792
86771,0.4504504504504505,0.5918367346938775,122,-145,0.43140216885390636,0.5685978311460936,home,MIA,under,7,0.49504950495049505,102,0.4733437310567792,MIA,ATL,2022 REG,12,3,8,4,7,20,0,1,-1,1,1,1,1,0,0,0,0,0,0,0.5266562689432208,0.4733437310567792
86772,0.7630331753554502,0.27624309392265195,-322,262,0.7330640788920643,0.26693592110793574,away,WSH,over,8.5,0.5348837209302326,-115,0.5097020142727117,PHI,WSH,2022 REG,13,13,7,1,14,20,1,0,12,-12,1,0,0,0,0,0,0,0,0,0.5097020142727117,0.49029798572728833
86772,0.7630331753554502,0.27624309392265195,-322,262,0.7330640788920643,0.26693592110793574,home,PHI,under,8.5,0.5121951219512195,-105,0.49029798572728833,PHI,WSH,2022 REG,13,13,7,1,14,20,1,0,12,-12,1,0,0,0,0,0,0,0,0,0.5097020142727117,0.49029798572728833
86773,0.4444444444444444,0.5918367346938775,125,-145,0.42831947593852354,0.5716805240614764,away,NYM,over,8,0.5121951219512195,-105,0.48919479393107135,MIA,NYM,2022 REG,6,3,11,5,8,17,0,1,-2,2,1,1,1,0,0,0,0,0,0,0.48919479393107135,0.5108052060689287
86773,0.4444444444444444,0.5918367346938775,125,-145,0.42831947593852354,0.5716805240614764,home,MIA,under,8,0.5327102803738317,-114,0.5108052060689287,MIA,NYM,2022 REG,6,3,11,5,8,17,0,1,-2,2,1,1,1,0,0,0,0,0,0,0.48919479393107135,0.5108052060689287
86774,0.5575221238938054,0.4807692307692307,-126,108,0.5361738465152985,0.46382615348470146,away,MIA,over,7.5,0.5192307692307692,-108,0.49455035168025013,PHI,MIA,2022 REG,10,3,6,2,5,16,1,0,1,-1,1,1,0,0,0,0,0,0,0,0.49455035168025013,0.5054496483197499
86774,0.5575221238938054,0.4807692307692307,-126,108,0.5361738465152985,0.46382615348470146,home,PHI,under,7.5,0.5283018867924528,-112,0.5054496483197499,PHI,MIA,2022 REG,10,3,6,2,5,16,1,0,1,-1,1,1,0,0,0,0,0,0,0,0.49455035168025013,0.5054496483197499
86775,0.5535714285714286,0.48309178743961345,-124,107,0.5332757197081732,0.4667242802918268,away,KC,over,7,0.5327102803738317,-114,0.508788710910954,BAL,KC,2022 REG,8,4,7,2,6,15,1,0,2,-2,1,1,0,0,0,0,0,0,0,0.508788710910954,0.491211289089046
86775,0.5535714285714286,0.48309178743961345,-124,107,0.5332757197081732,0.4667242802918268,home,BAL,under,7,0.5121951219512195,-105,0.491211289089046,BAL,KC,2022 REG,8,4,7,2,6,15,1,0,2,-2,1,1,0,0,0,0,0,0,0,0.508788710910954,0.491211289089046
86776,0.4273504273504274,0.6124031007751938,134,-158,0.41036174011725596,0.5896382598827441,away,SEA,over,8.5,0.5348837209302326,-115,0.5097020142727117,DET,SEA,2022 REG,8,3,8,5,8,16,0,1,-2,2,1,1,1,0,0,0,0,0,0,0.5097020142727117,0.49029798572728833
86776,0.4273504273504274,0.6124031007751938,134,-158,0.41036174011725596,0.5896382598827441,home,DET,under,8.5,0.5121951219512195,-105,0.49029798572728833,DET,SEA,2022 REG,8,3,8,5,8,16,0,1,-2,2,1,1,1,0,0,0,0,0,0,0.5097020142727117,0.49029798572728833
86777,0.3921568627450981,0.6389891696750902,155,-177,0.37994273238423987,0.6200572676157601,away,LAD,over,7.5,0.5215311004784688,-109,0.49670754937970685,CHC,LAD,2022 REG,6,2,3,6,8,9,0,1,-4,4,1,1,0,0,0,0,0,0,0,0.49670754937970685,0.5032924506202932
86777,0.3921568627450981,0.6389891696750902,155,-177,0.37994273238423987,0.6200572676157601,home,CHC,under,7.5,0.5260663507109005,-111,0.5032924506202932,CHC,LAD,2022 REG,6,2,3,6,8,9,0,1,-4,4,1,1,0,0,0,0,0,0,0,0.49670754937970685,0.5032924506202932
86778,0.4,0.6402877697841727,150,-178,0.383884892086331,0.6161151079136691,away,SEA,over,8,0.5412844036697247,-118,0.5149381613977361,KC,SEA,2022 REG,9,5,11,6,11,20,0,1,-1,1,1,1,1,1,1,0,0,0,0,0.5149381613977361,0.48506183860226393
86778,0.4,0.6402877697841727,150,-178,0.383884892086331,0.6161151079136691,home,KC,under,8,0.5073891625615764,-103,0.48506183860226393,KC,SEA,2022 REG,9,5,11,6,11,20,0,1,-1,1,1,1,1,1,1,0,0,0,0,0.5149381613977361,0.48506183860226393
86779,0.5555555555555556,0.48780487804878053,-125,105,0.5314664257753688,0.46853357422463116,away,MIA,over,6.5,0.5454545454545454,-120,0.5206611570247933,SD,MIA,2022 REG,5,3,6,2,5,11,1,0,1,-1,1,1,0,0,0,0,0,0,0,0.5206611570247933,0.4793388429752067
86779,0.5555555555555556,0.48780487804878053,-125,105,0.5314664257753688,0.46853357422463116,home,SD,under,6.5,0.5,100,0.4793388429752067,SD,MIA,2022 REG,5,3,6,2,5,11,1,0,1,-1,1,1,0,0,0,0,0,0,0,0.5206611570247933,0.4793388429752067
86780,0.6363636363636364,0.4081632653061224,-175,145,0.6080283353010626,0.3919716646989374,away,WSH,over,9.5,0.5098039215686274,-104,0.48483656587239576,NYM,WSH,2022 REG,17,10,7,0,10,24,1,0,10,-10,0,0,0,0,0,0,0,0,0,0.48483656587239576,0.5151634341276042
86780,0.6363636363636364,0.4081632653061224,-175,145,0.6080283353010626,0.3919716646989374,home,NYM,under,9.5,0.5391705069124424,-117,0.5151634341276042,NYM,WSH,2022 REG,17,10,7,0,10,24,1,0,10,-10,0,0,0,0,0,0,0,0,0,0.48483656587239576,0.5151634341276042
86781,0.6453900709219857,0.3921568627450981,-182,155,0.6211576527396834,0.3788423472603166,away,OAK,over,8,0.5121951219512195,-105,0.48808156828023186,LAA,OAK,2022 REG,6,2,8,4,6,14,0,1,-2,2,1,1,0,0,0,0,0,0,0,0.48808156828023186,0.5119184317197681
86781,0.6453900709219857,0.3921568627450981,-182,155,0.6211576527396834,0.3788423472603166,home,LAA,under,8,0.5348837209302326,-115,0.5119184317197681,LAA,OAK,2022 REG,6,2,8,4,6,14,0,1,-2,2,1,1,0,0,0,0,0,0,0,0.48808156828023186,0.5119184317197681
86782,0.45454545454545453,0.5867768595041323,120,-142,0.43576258452291505,0.564237415477085,away,TB,over,7.5,0.5,100,0.4762443438914027,BOS,TB,2022 REG,9,4,5,3,7,14,1,0,1,-1,1,1,1,0,0,0,0,0,0,0.4762443438914027,0.5237556561085973
86782,0.45454545454545453,0.5867768595041323,120,-142,0.43576258452291505,0.564237415477085,home,BOS,under,7.5,0.5475113122171946,-121,0.5237556561085973,BOS,TB,2022 REG,9,4,5,3,7,14,1,0,1,-1,1,1,1,0,0,0,0,0,0,0.4762443438914027,0.5237556561085973
86783,0.8,0.23255813953488372,-400,330,0.7739534883720931,0.2260465116279069,away,COL,over,8,0.5348837209302326,-115,0.5097020142727117,ATL,COL,2022 REG,5,3,2,0,3,7,1,0,3,-3,0,0,0,0,0,0,0,0,0,0.5097020142727117,0.49029798572728833
86783,0.8,0.23255813953488372,-400,330,0.7739534883720931,0.2260465116279069,home,ATL,under,8,0.5121951219512195,-105,0.49029798572728833,ATL,COL,2022 REG,5,3,2,0,3,7,1,0,3,-3,0,0,0,0,0,0,0,0,0,0.5097020142727117,0.49029798572728833
86785,0.5,0.5391705069124424,100,-117,0.4804147465437788,0.5195852534562212,away,BAL,over,9.5,0.5192307692307692,-108,0.49455035168025013,KC,BAL,2022 REG,10,4,10,6,10,20,0,1,-2,2,1,1,1,1,0,0,0,0,0,0.49455035168025013,0.5054496483197499
86785,0.5,0.5391705069124424,100,-117,0.4804147465437788,0.5195852534562212,home,KC,under,9.5,0.5283018867924528,-112,0.5054496483197499,KC,BAL,2022 REG,10,4,10,6,10,20,0,1,-2,2,1,1,1,1,0,0,0,0,0,0.49455035168025013,0.5054496483197499
86786,0.6254681647940076,0.41152263374485604,-167,143,0.6023315979176397,0.3976684020823603,away,NYM,over,8.5,0.5327102803738317,-114,0.508788710910954,LAD,NYM,2022 REG,9,2,3,0,2,12,1,0,2,-2,0,0,0,0,0,0,0,0,0,0.508788710910954,0.491211289089046
86786,0.6254681647940076,0.41152263374485604,-167,143,0.6023315979176397,0.3976684020823603,home,LAD,under,8.5,0.5121951219512195,-105,0.491211289089046,LAD,NYM,2022 REG,9,2,3,0,2,12,1,0,2,-2,0,0,0,0,0,0,0,0,0,0.508788710910954,0.491211289089046
86787,0.504950495049505,0.5348837209302326,-102,-115,0.48483618797062755,0.5151638120293724,away,LAA,over,8.5,0.5454545454545454,-120,0.5206611570247933,SEA,LAA,2022 REG,5,0,7,3,3,12,0,1,-3,3,0,0,0,0,0,0,0,0,0,0.5206611570247933,0.4793388429752067
86787,0.504950495049505,0.5348837209302326,-102,-115,0.48483618797062755,0.5151638120293724,home,SEA,under,8.5,0.5,100,0.4793388429752067,SEA,LAA,2022 REG,5,0,7,3,3,12,0,1,-3,3,0,0,0,0,0,0,0,0,0,0.5206611570247933,0.4793388429752067
86788,0.46511627906976744,0.5689655172413793,115,-132,0.4492642807855131,0.5507357192144868,away,NYM,over,9,0.49751243781094534,101,0.476135829221149,MIL,NYM,2022 REG,7,6,4,0,6,11,1,0,6,-6,0,0,0,0,0,0,0,0,0,0.476135829221149,0.523864170778851
86788,0.46511627906976744,0.5689655172413793,115,-132,0.4492642807855131,0.5507357192144868,home,MIL,under,9,0.5454545454545454,-120,0.523864170778851,MIL,NYM,2022 REG,7,6,4,0,6,11,1,0,6,-6,0,0,0,0,0,0,0,0,0,0.476135829221149,0.523864170778851
86789,0.5495495495495495,0.49019607843137253,-122,104,0.5277073575960698,0.4722926424039302,away,MIA,over,8.5,0.5145631067961165,-106,0.4925063625223866,ATL,MIA,2022 REG,5,1,8,4,5,13,0,1,-3,3,1,0,0,0,0,0,0,0,0,0.4925063625223866,0.5074936374776133
86789,0.5495495495495495,0.49019607843137253,-122,104,0.5277073575960698,0.4722926424039302,home,ATL,under,8.5,0.5283018867924528,-112,0.5074936374776133,ATL,MIA,2022 REG,5,1,8,4,5,13,0,1,-3,3,1,0,0,0,0,0,0,0,0,0.4925063625223866,0.5074936374776133
86790,0.6875,0.35714285714285715,-220,180,0.6568080357142857,0.3431919642857143,away,CIN,over,7.5,0.5145631067961165,-106,0.49023796582517226,SF,CIN,2022 REG,6,2,6,4,6,12,0,1,-2,2,1,1,0,0,0,0,0,0,0,0.49023796582517226,0.5097620341748277
86790,0.6875,0.35714285714285715,-220,180,0.6568080357142857,0.3431919642857143,home,SF,under,7.5,0.5327102803738317,-114,0.5097620341748277,SF,CIN,2022 REG,6,2,6,4,6,12,0,1,-2,2,1,1,0,0,0,0,0,0,0,0.49023796582517226,0.5097620341748277
86791,0.7849462365591398,0.25641025641025644,-365,290,0.7524836130455277,0.2475163869544723,away,COL,over,8,0.5370370370370371,-116,0.5118817074154765,LAD,COL,2022 REG,6,1,9,2,3,15,0,1,-1,1,1,0,0,0,0,0,0,0,0,0.5118817074154765,0.48811829258452355
86791,0.7849462365591398,0.25641025641025644,-365,290,0.7524836130455277,0.2475163869544723,home,LAD,under,8,0.5098039215686274,-104,0.48811829258452355,LAD,COL,2022 REG,6,1,9,2,3,15,0,1,-1,1,1,0,0,0,0,0,0,0,0,0.5118817074154765,0.48811829258452355
86792,0.4716981132075471,0.5726495726495727,112,-134,0.4507793934636226,0.5492206065363774,away,LAA,over,7,0.5238095238095238,-110,0.5012646084074657,OAK,LAA,2022 REG,5,1,9,4,5,14,0,1,-3,3,1,0,0,0,0,0,0,0,0,0.5012646084074657,0.4987353915925343
86792,0.4716981132075471,0.5726495726495727,112,-134,0.4507793934636226,0.5492206065363774,home,OAK,under,7,0.5192307692307692,-108,0.4987353915925343,OAK,LAA,2022 REG,5,1,9,4,5,14,0,1,-3,3,1,0,0,0,0,0,0,0,0,0.5012646084074657,0.4987353915925343
86793,0.5348837209302326,0.5098039215686274,-115,-104,0.5109810284308424,0.48901897156915763,away,CWS,over,8.5,0.5348837209302326,-115,0.5097020142727117,DET,CWS,2022 REG,4,0,22,13,13,26,0,1,-13,13,0,0,0,0,0,0,0,0,0,0.5097020142727117,0.49029798572728833
86793,0.5348837209302326,0.5098039215686274,-115,-104,0.5109810284308424,0.48901897156915763,home,DET,under,8.5,0.5121951219512195,-105,0.49029798572728833,DET,CWS,2022 REG,4,0,22,13,13,26,0,1,-13,13,0,0,0,0,0,0,0,0,0,0.5097020142727117,0.49029798572728833
86794,0.3225806451612903,0.7142857142857143,210,-250,0.3106882711461275,0.6893117288538725,away,SEA,over,7,0.5454545454545454,-120,0.5206611570247933,OAK,SEA,2022 REG,9,5,11,9,14,20,0,1,-4,4,1,1,1,1,1,0,0,0,0,0.5206611570247933,0.4793388429752067
86794,0.3225806451612903,0.7142857142857143,210,-250,0.3106882711461275,0.6893117288538725,home,OAK,under,7,0.5,100,0.4793388429752067,OAK,SEA,2022 REG,9,5,11,9,14,20,0,1,-4,4,1,1,1,1,1,0,0,0,0,0.5206611570247933,0.4793388429752067
86795,0.6774193548387096,0.35714285714285715,-210,180,0.6540062434963579,0.34599375650364206,away,BAL,over,8.5,0.5121951219512195,-105,0.48808156828023186,STL,BAL,2022 REG,6,2,8,3,5,14,0,1,-1,1,1,1,0,0,0,0,0,0,0,0.48808156828023186,0.5119184317197681
86795,0.6774193548387096,0.35714285714285715,-210,180,0.6540062434963579,0.34599375650364206,home,STL,under,8.5,0.5348837209302326,-115,0.5119184317197681,STL,BAL,2022 REG,6,2,8,3,5,14,0,1,-1,1,1,1,0,0,0,0,0,0,0,0.48808156828023186,0.5119184317197681
86796,0.425531914893617,0.6153846153846154,135,-160,0.4081206254135181,0.5918793745864819,away,MIL,over,7,0.5305164319248826,-113,0.5066009958897986,MIA,MIL,2022 REG,5,3,9,7,10,14,0,1,-4,4,1,1,1,0,0,0,0,0,0,0.5066009958897986,0.49339900411020143
86796,0.425531914893617,0.6153846153846154,135,-160,0.4081206254135181,0.5918793745864819,home,MIA,under,7,0.5145631067961165,-106,0.49339900411020143,MIA,MIL,2022 REG,5,3,9,7,10,14,0,1,-4,4,1,1,1,0,0,0,0,0,0,0.5066009958897986,0.49339900411020143
86797,0.6610169491525424,0.3802281368821293,-195,163,0.6337532482143695,0.3662467517856305,away,ARI,over,7.5,0.5,100,0.4772727272727273,SD,ARI,2022 REG,8,5,6,3,8,14,1,0,2,-2,1,1,1,0,0,0,0,0,0,0.4772727272727273,0.5227272727272727
86797,0.6610169491525424,0.3802281368821293,-195,163,0.6337532482143695,0.3662467517856305,home,SD,under,7.5,0.5454545454545454,-120,0.5227272727272727,SD,ARI,2022 REG,8,5,6,3,8,14,1,0,2,-2,1,1,1,0,0,0,0,0,0,0.4772727272727273,0.5227272727272727
86798,0.425531914893617,0.613899613899614,135,-159,0.40875254093905067,0.5912474590609493,away,NYY,over,7,0.5454545454545454,-120,0.5206611570247933,TB,NYY,2022 REG,10,4,7,5,9,17,0,1,-1,1,1,1,1,1,0,0,0,0,0,0.5206611570247933,0.4793388429752067
86798,0.425531914893617,0.613899613899614,135,-159,0.40875254093905067,0.5912474590609493,home,TB,under,7,0.5,100,0.4793388429752067,TB,NYY,2022 REG,10,4,7,5,9,17,0,1,-1,1,1,1,1,1,0,0,0,0,0,0.5206611570247933,0.4793388429752067
86799,0.4166666666666667,0.6153846153846154,140,-160,0.40331196581196577,0.5966880341880343,away,HOU,over,9,0.49504950495049505,102,0.47499799484898986,TEX,HOU,2022 REG,5,2,9,9,11,14,0,1,-7,7,1,1,0,0,0,0,0,0,0,0.47499799484898986,0.5250020051510101
86799,0.4166666666666667,0.6153846153846154,140,-160,0.40331196581196577,0.5966880341880343,home,TEX,under,9,0.5454545454545454,-120,0.5250020051510101,TEX,HOU,2022 REG,5,2,9,9,11,14,0,1,-7,7,1,1,0,0,0,0,0,0,0,0.47499799484898986,0.5250020051510101
86800,0.5884773662551441,0.4484304932735426,-143,123,0.5667579262855877,0.43324207371441226,away,NYM,over,9,0.5,100,0.4772727272727273,HOU,NYM,2022 REG,10,8,8,2,10,18,1,0,6,-6,1,1,0,0,0,0,0,0,0,0.4772727272727273,0.5227272727272727
86800,0.5884773662551441,0.4484304932735426,-143,123,0.5667579262855877,0.43324207371441226,home,HOU,under,9,0.5454545454545454,-120,0.5227272727272727,HOU,NYM,2022 REG,10,8,8,2,10,18,1,0,6,-6,1,1,0,0,0,0,0,0,0,0.4772727272727273,0.5227272727272727
86801,0.4081632653061224,0.6363636363636364,145,-175,0.3899890197266291,0.6100109802733709,away,NYY,over,8,0.5391705069124424,-117,0.5140669063204599,DET,NYY,2022 REG,7,3,7,0,3,14,1,0,3,-3,0,0,0,0,0,0,0,0,0,0.5140669063204599,0.4859330936795401
86801,0.4081632653061224,0.6363636363636364,145,-175,0.3899890197266291,0.6100109802733709,home,DET,under,8,0.5073891625615764,-103,0.4859330936795401,DET,NYY,2022 REG,7,3,7,0,3,14,1,0,3,-3,0,0,0,0,0,0,0,0,0,0.5140669063204599,0.4859330936795401
86802,0.6610169491525424,0.3802281368821293,-195,163,0.6337532482143695,0.3662467517856305,away,STL,over,7,0.5215311004784688,-109,0.4978845547971712,NYM,STL,2022 REG,11,11,10,4,15,21,1,0,7,-7,1,1,1,1,0,0,0,0,0,0.4978845547971712,0.5021154452028288
86802,0.6610169491525424,0.3802281368821293,-195,163,0.6337532482143695,0.3662467517856305,home,NYM,under,7,0.5238095238095238,-110,0.5021154452028288,NYM,STL,2022 REG,11,11,10,4,15,21,1,0,7,-7,1,1,1,1,0,0,0,0,0,0.4978845547971712,0.5021154452028288
86803,0.6721311475409836,0.36363636363636365,-205,175,0.6480906892086682,0.3519093107913318,away,OAK,over,8,0.5348837209302326,-115,0.5097020142727117,LAA,OAK,2022 REG,12,4,9,3,7,21,1,0,1,-1,1,1,1,0,0,0,0,0,0,0.5097020142727117,0.49029798572728833
86803,0.6721311475409836,0.36363636363636365,-205,175,0.6480906892086682,0.3519093107913318,home,LAA,under,8,0.5121951219512195,-105,0.49029798572728833,LAA,OAK,2022 REG,12,4,9,3,7,21,1,0,1,-1,1,1,1,0,0,0,0,0,0,0.5097020142727117,0.49029798572728833
86804,0.5475113122171946,0.49504950495049505,-121,102,0.5242087833606768,0.4757912166393232,away,COL,over,9,0.5145631067961165,-106,0.4913668392989033,WSH,COL,2022 REG,9,6,10,5,11,19,1,0,1,-1,1,1,1,1,1,0,0,0,0,0.4913668392989033,0.5086331607010968
86804,0.5475113122171946,0.49504950495049505,-121,102,0.5242087833606768,0.4757912166393232,home,WSH,under,9,0.5305164319248826,-113,0.5086331607010968,WSH,COL,2022 REG,9,6,10,5,11,19,1,0,1,-1,1,1,1,1,1,0,0,0,0,0.4913668392989033,0.5086331607010968
86805,0.6666666666666666,0.37037037037037035,-200,170,0.6419753086419753,0.3580246913580247,away,BAL,over,7.5,0.49751243781094534,101,0.476135829221149,OAK,BAL,2022 REG,5,5,7,1,6,12,1,0,4,-4,1,0,0,0,0,0,0,0,0,0.476135829221149,0.523864170778851
86805,0.6666666666666666,0.37037037037037035,-200,170,0.6419753086419753,0.3580246913580247,home,OAK,under,7.5,0.5454545454545454,-120,0.523864170778851,OAK,BAL,2022 REG,5,5,7,1,6,12,1,0,4,-4,1,0,0,0,0,0,0,0,0,0.476135829221149,0.523864170778851
86806,0.5454545454545454,0.5,-120,100,0.5206611570247933,0.4793388429752067,away,DET,over,9,0.5,100,0.4762443438914027,KC,DET,2022 REG,9,5,11,7,12,20,0,1,-2,2,1,1,1,1,1,0,0,0,0,0.4762443438914027,0.5237556561085973
86806,0.5454545454545454,0.5,-120,100,0.5206611570247933,0.4793388429752067,home,KC,under,9,0.5475113122171946,-121,0.5237556561085973,KC,DET,2022 REG,9,5,11,7,12,20,0,1,-2,2,1,1,1,1,1,0,0,0,0,0.4762443438914027,0.5237556561085973
86807,0.5412844036697247,0.49504950495049505,-118,102,0.5216174256092387,0.47838257439076126,away,ARI,over,10,0.5283018867924528,-112,0.5031902949311281,CIN,ARI,2022 REG,12,7,1,0,7,13,1,0,7,-7,0,0,0,0,0,0,0,0,0,0.5031902949311281,0.4968097050688719
86807,0.5412844036697247,0.49504950495049505,-118,102,0.5216174256092387,0.47838257439076126,home,CIN,under,10,0.5192307692307692,-108,0.4968097050688719,CIN,ARI,2022 REG,12,7,1,0,7,13,1,0,7,-7,0,0,0,0,0,0,0,0,0,0.5031902949311281,0.4968097050688719
86808,0.4608294930875576,0.5780590717299579,117,-137,0.44290849547579936,0.5570915045242006,away,MIN,over,9,0.5391705069124424,-117,0.5140669063204599,ARI,MIN,2022 REG,11,7,10,2,9,21,1,0,5,-5,1,1,0,0,0,0,0,0,0,0.5140669063204599,0.4859330936795401
86808,0.4608294930875576,0.5780590717299579,117,-137,0.44290849547579936,0.5570915045242006,home,ARI,under,9,0.5073891625615764,-103,0.4859330936795401,ARI,MIN,2022 REG,11,7,10,2,9,21,1,0,5,-5,1,1,0,0,0,0,0,0,0,0.5140669063204599,0.4859330936795401
86809,0.4444444444444444,0.5918367346938775,125,-145,0.42831947593852354,0.5716805240614764,away,SD,over,11.5,0.5215311004784688,-109,0.49907282342437215,COL,SD,2022 REG,7,5,10,3,8,17,1,0,2,-2,1,1,1,0,0,0,0,0,0,0.49907282342437215,0.5009271765756278
86809,0.4444444444444444,0.5918367346938775,125,-145,0.42831947593852354,0.5716805240614764,home,COL,under,11.5,0.5215311004784688,-109,0.5009271765756278,COL,SD,2022 REG,7,5,10,3,8,17,1,0,2,-2,1,1,1,0,0,0,0,0,0,0.49907282342437215,0.5009271765756278
86810,0.24390243902439027,0.8,310,-400,0.2331945270672219,0.7668054729327781,away,NYM,over,7,0.5454545454545454,-120,0.5206611570247933,PIT,NYM,2022 REG,4,0,17,10,10,21,0,1,-10,10,0,0,0,0,0,0,0,0,0,0.5206611570247933,0.4793388429752067
86810,0.24390243902439027,0.8,310,-400,0.2331945270672219,0.7668054729327781,home,PIT,under,7,0.5,100,0.4793388429752067,PIT,NYM,2022 REG,4,0,17,10,10,21,0,1,-10,10,0,0,0,0,0,0,0,0,0,0.5206611570247933,0.4793388429752067
86811,0.7354497354497355,0.30303030303030304,-278,230,0.7071496013294954,0.29285039867050455,away,WSH,over,7.5,0.5327102803738317,-114,0.508788710910954,NYM,WSH,2022 REG,10,7,10,3,10,20,1,0,4,-4,1,1,1,0,0,0,0,0,0,0.508788710910954,0.491211289089046
86811,0.7354497354497355,0.30303030303030304,-278,230,0.7071496013294954,0.29285039867050455,home,NYM,under,7.5,0.5121951219512195,-105,0.491211289089046,NYM,WSH,2022 REG,10,7,10,3,10,20,1,0,4,-4,1,1,1,0,0,0,0,0,0,0.508788710910954,0.491211289089046
86812,0.4484304932735426,0.5918367346938775,123,-145,0.43037344037335423,0.5696265596266458,away,HOU,over,6.5,0.5454545454545454,-120,0.5206611570247933,MIN,HOU,2022 REG,3,0,7,5,5,10,0,1,-5,5,0,0,0,0,0,0,0,0,0,0.5206611570247933,0.4793388429752067
86812,0.4484304932735426,0.5918367346938775,123,-145,0.43037344037335423,0.5696265596266458,home,MIN,under,6.5,0.5,100,0.4793388429752067,MIN,HOU,2022 REG,3,0,7,5,5,10,0,1,-5,5,0,0,0,0,0,0,0,0,0,0.5206611570247933,0.4793388429752067
86813,0.7014925373134329,0.3389830508474576,-235,195,0.6730992142751963,0.32690078572480374,away,CHC,over,8.5,0.5348837209302326,-115,0.5109810284308424,NYY,CHC,2022 REG,11,8,5,0,8,16,1,0,8,-8,0,0,0,0,0,0,0,0,0,0.5109810284308424,0.48901897156915763
86813,0.7014925373134329,0.3389830508474576,-235,195,0.6730992142751963,0.32690078572480374,home,NYY,under,8.5,0.5098039215686274,-104,0.48901897156915763,NYY,CHC,2022 REG,11,8,5,0,8,16,1,0,8,-8,0,0,0,0,0,0,0,0,0,0.5109810284308424,0.48901897156915763
86814,0.6254681647940076,0.41152263374485604,-167,143,0.6023315979176397,0.3976684020823603,away,TEX,over,8.5,0.5073891625615764,-103,0.4826927225525911,SEA,TEX,2022 REG,8,5,7,4,9,15,1,0,1,-1,1,1,1,1,0,0,0,0,0,0.4826927225525911,0.5173072774474089
86814,0.6254681647940076,0.41152263374485604,-167,143,0.6023315979176397,0.3976684020823603,home,SEA,under,8.5,0.5412844036697247,-118,0.5173072774474089,SEA,TEX,2022 REG,8,5,7,4,9,15,1,0,1,-1,1,1,1,1,0,0,0,0,0,0.4826927225525911,0.5173072774474089
86815,0.7014925373134329,0.3389830508474576,-235,195,0.6730992142751963,0.32690078572480374,away,LAA,over,7,0.5412844036697247,-118,0.5189377998484975,TB,LAA,2022 REG,7,2,6,1,3,13,1,0,1,-1,1,0,0,0,0,0,0,0,0,0.5189377998484975,0.4810622001515025
86815,0.7014925373134329,0.3389830508474576,-235,195,0.6730992142751963,0.32690078572480374,home,TB,under,7,0.5,100,0.4810622001515025,TB,LAA,2022 REG,7,2,6,1,3,13,1,0,1,-1,1,0,0,0,0,0,0,0,0,0.5189377998484975,0.4810622001515025
86816,0.6000000000000001,0.43859649122807015,-150,128,0.5768421052631579,0.42315789473684207,away,BAL,over,8,0.5145631067961165,-106,0.4913668392989033,CHC,BAL,2022 REG,6,1,12,7,8,18,0,1,-6,6,1,0,0,0,0,0,0,0,0,0.4913668392989033,0.5086331607010968
86816,0.6000000000000001,0.43859649122807015,-150,128,0.5768421052631579,0.42315789473684207,home,CHC,under,8,0.5305164319248826,-113,0.5086331607010968,CHC,BAL,2022 REG,6,1,12,7,8,18,0,1,-6,6,1,0,0,0,0,0,0,0,0,0.4913668392989033,0.5086331607010968
86817,0.5780590717299579,0.4672897196261683,-137,114,0.55184479149456,0.44815520850544,away,BOS,over,8,0.5121951219512195,-105,0.48919479393107135,ATL,BOS,2022 REG,6,4,11,9,13,17,0,1,-5,5,1,1,1,1,0,0,0,0,0,0.48919479393107135,0.5108052060689287
86817,0.5780590717299579,0.4672897196261683,-137,114,0.55184479149456,0.44815520850544,home,ATL,under,8,0.5327102803738317,-114,0.5108052060689287,ATL,BOS,2022 REG,6,4,11,9,13,17,0,1,-5,5,1,1,1,1,0,0,0,0,0,0.48919479393107135,0.5108052060689287
86818,0.6000000000000001,0.4424778761061947,-150,126,0.5745132743362832,0.4254867256637168,away,MIA,over,8.5,0.5348837209302326,-115,0.5097020142727117,PHI,MIA,2022 REG,13,9,12,11,20,25,0,1,-2,2,1,1,1,1,1,1,1,1,1,0.5097020142727117,0.49029798572728833
86818,0.6000000000000001,0.4424778761061947,-150,126,0.5745132743362832,0.4254867256637168,home,PHI,under,8.5,0.5121951219512195,-105,0.49029798572728833,PHI,MIA,2022 REG,13,9,12,11,20,25,0,1,-2,2,1,1,1,1,1,1,1,1,1,0.5097020142727117,0.49029798572728833
86819,0.35714285714285715,0.6825396825396826,180,-215,0.34297052154195007,0.6570294784580499,away,MIL,over,8,0.5215311004784688,-109,0.4978845547971712,PIT,MIL,2022 REG,9,0,5,2,2,14,0,1,-2,2,0,0,0,0,0,0,0,0,0,0.4978845547971712,0.5021154452028288
86819,0.35714285714285715,0.6825396825396826,180,-215,0.34297052154195007,0.6570294784580499,home,PIT,under,8,0.5238095238095238,-110,0.5021154452028288,PIT,MIL,2022 REG,9,0,5,2,2,14,0,1,-2,2,0,0,0,0,0,0,0,0,0,0.4978845547971712,0.5021154452028288
86820,0.6825396825396826,0.35714285714285715,-215,180,0.6554547745023935,0.34454522549760647,away,CIN,over,6.5,0.5454545454545454,-120,0.5206611570247933,MIA,CIN,2022 REG,7,3,6,0,3,13,1,0,3,-3,0,0,0,0,0,0,0,0,0,0.5206611570247933,0.4793388429752067
86820,0.6825396825396826,0.35714285714285715,-215,180,0.6554547745023935,0.34454522549760647,home,MIA,under,6.5,0.5,100,0.4793388429752067,MIA,CIN,2022 REG,7,3,6,0,3,13,1,0,3,-3,0,0,0,0,0,0,0,0,0,0.5206611570247933,0.4793388429752067
86821,0.49504950495049505,0.5454545454545454,102,-120,0.47499799484898986,0.5250020051510101,away,NYM,over,6.5,0.5238095238095238,-110,0.5000596729920038,ATL,NYM,2022 REG,8,5,8,2,7,16,1,0,3,-3,1,1,0,0,0,0,0,0,0,0.5000596729920038,0.4999403270079962
86821,0.49504950495049505,0.5454545454545454,102,-120,0.47499799484898986,0.5250020051510101,home,ATL,under,6.5,0.5215311004784688,-109,0.4999403270079962,ATL,NYM,2022 REG,8,5,8,2,7,16,1,0,3,-3,1,1,0,0,0,0,0,0,0,0.5000596729920038,0.4999403270079962
86822,0.3623188405797102,0.6774193548387096,176,-210,0.34792094368897836,0.6520790563110217,away,LAD,over,8.5,0.5169082125603864,-107,0.49353874091423283,WSH,LAD,2022 REG,10,4,9,9,13,19,0,1,-5,5,1,1,1,1,0,0,0,0,0,0.49353874091423283,0.5064612590857671
86822,0.3623188405797102,0.6774193548387096,176,-210,0.34792094368897836,0.6520790563110217,home,WSH,under,8.5,0.5283018867924528,-112,0.5064612590857671,WSH,LAD,2022 REG,10,4,9,9,13,19,0,1,-5,5,1,1,1,1,0,0,0,0,0,0.49353874091423283,0.5064612590857671
86823,0.576271186440678,0.4629629629629629,-136,116,0.553661676614851,0.446338323385149,away,TB,over,8,0.5412844036697247,-118,0.5149381613977361,TEX,TB,2022 REG,7,3,3,0,3,10,1,0,3,-3,0,0,0,0,0,0,0,0,0,0.5149381613977361,0.48506183860226393
86823,0.576271186440678,0.4629629629629629,-136,116,0.553661676614851,0.446338323385149,home,TEX,under,8,0.5073891625615764,-103,0.48506183860226393,TEX,TB,2022 REG,7,3,3,0,3,10,1,0,3,-3,0,0,0,0,0,0,0,0,0,0.5149381613977361,0.48506183860226393
86824,0.5652173913043479,0.47619047619047616,-130,110,0.5418129444594474,0.4581870555405526,away,WSH,over,9.5,0.5,100,0.4772727272727273,BAL,WSH,2022 REG,4,0,6,3,3,10,0,1,-3,3,0,0,0,0,0,0,0,0,0,0.4772727272727273,0.5227272727272727
86824,0.5652173913043479,0.47619047619047616,-130,110,0.5418129444594474,0.4581870555405526,home,BAL,under,9.5,0.5454545454545454,-120,0.5227272727272727,BAL,WSH,2022 REG,4,0,6,3,3,10,0,1,-3,3,0,0,0,0,0,0,0,0,0,0.4772727272727273,0.5227272727272727
86825,0.6254681647940076,0.4098360655737705,-167,144,0.6033864926164085,0.39661350738359147,away,MIA,over,7.5,0.5121951219512195,-105,0.48919479393107135,PHI,MIA,2022 REG,8,4,10,3,7,18,1,0,1,-1,1,1,1,0,0,0,0,0,0,0.48919479393107135,0.5108052060689287
86825,0.6254681647940076,0.4098360655737705,-167,144,0.6033864926164085,0.39661350738359147,home,PHI,under,7.5,0.5327102803738317,-114,0.5108052060689287,PHI,MIA,2022 REG,8,4,10,3,7,18,1,0,1,-1,1,1,1,0,0,0,0,0,0,0.48919479393107135,0.5108052060689287
86826,0.425531914893617,0.6108949416342413,135,-157,0.41003112488176247,0.5899688751182375,away,SD,over,8.5,0.5073891625615764,-103,0.4826927225525911,ARI,SD,2022 REG,4,1,8,6,7,12,0,1,-5,5,1,0,0,0,0,0,0,0,0,0.4826927225525911,0.5173072774474089
86826,0.425531914893617,0.6108949416342413,135,-157,0.41003112488176247,0.5899688751182375,home,ARI,under,8.5,0.5412844036697247,-118,0.5173072774474089,ARI,SD,2022 REG,4,1,8,6,7,12,0,1,-5,5,1,0,0,0,0,0,0,0,0,0.4826927225525911,0.5173072774474089
86827,0.4,0.6363636363636364,150,-175,0.3854545454545455,0.6145454545454545,away,BOS,over,8.5,0.5024875621890548,-101,0.48049269377245407,LAA,BOS,2022 REG,7,0,7,1,1,14,0,1,-1,1,0,0,0,0,0,0,0,0,0,0.48049269377245407,0.5195073062275459
86827,0.4,0.6363636363636364,150,-175,0.3854545454545455,0.6145454545454545,home,LAA,under,8.5,0.5412844036697247,-118,0.5195073062275459,LAA,BOS,2022 REG,7,0,7,1,1,14,0,1,-1,1,0,0,0,0,0,0,0,0,0,0.48049269377245407,0.5195073062275459
86828,0.5652173913043479,0.47619047619047616,-130,110,0.5418129444594474,0.4581870555405526,away,TB,over,8.5,0.5283018867924528,-112,0.5044173060022736,NYY,TB,2022 REG,8,10,10,4,14,18,1,0,6,-6,1,1,1,1,0,0,0,0,0,0.5044173060022736,0.49558269399772636
86828,0.5652173913043479,0.47619047619047616,-130,110,0.5418129444594474,0.4581870555405526,home,NYY,under,8.5,0.5169082125603864,-107,0.49558269399772636,NYY,TB,2022 REG,8,10,10,4,14,18,1,0,6,-6,1,1,1,1,0,0,0,0,0,0.5044173060022736,0.49558269399772636
86829,0.5145631067961165,0.5215311004784688,-106,-109,0.4959903593635629,0.5040096406364372,away,COL,over,8.5,0.5391705069124424,-117,0.5140669063204599,WSH,COL,2022 REG,14,13,12,7,20,26,1,0,6,-6,1,1,1,1,1,1,1,0,0,0.5140669063204599,0.4859330936795401
86829,0.5145631067961165,0.5215311004784688,-106,-109,0.4959903593635629,0.5040096406364372,home,WSH,under,8.5,0.5073891625615764,-103,0.4859330936795401,WSH,COL,2022 REG,14,13,12,7,20,26,1,0,6,-6,1,1,1,1,1,1,1,0,0,0.5140669063204599,0.4859330936795401
86830,0.4608294930875576,0.576271186440678,117,-136,0.4437324057473569,0.5562675942526432,away,TB,over,9,0.5348837209302326,-115,0.5097020142727117,KC,TB,2022 REG,12,3,8,7,10,20,0,1,-4,4,1,1,1,0,0,0,0,0,0,0.5097020142727117,0.49029798572728833
86830,0.4608294930875576,0.576271186440678,117,-136,0.4437324057473569,0.5562675942526432,home,KC,under,9,0.5121951219512195,-105,0.49029798572728833,KC,TB,2022 REG,12,3,8,7,10,20,0,1,-4,4,1,1,1,0,0,0,0,0,0,0.5097020142727117,0.49029798572728833
86831,0.5633187772925764,0.47619047619047616,-129,110,0.5410624729287608,0.45893752707123925,away,MIL,over,7.5,0.5327102803738317,-114,0.508788710910954,NYM,MIL,2022 REG,7,5,11,4,9,18,1,0,1,-1,1,1,1,1,0,0,0,0,0,0.508788710910954,0.491211289089046
86831,0.5633187772925764,0.47619047619047616,-129,110,0.5410624729287608,0.45893752707123925,home,NYM,under,7.5,0.5121951219512195,-105,0.491211289089046,NYM,MIL,2022 REG,7,5,11,4,9,18,1,0,1,-1,1,1,1,1,0,0,0,0,0,0.508788710910954,0.491211289089046
86832,0.3921568627450981,0.6428571428571428,155,-180,0.37842588015598405,0.6215741198440159,away,HOU,over,7.5,0.5121951219512195,-105,0.48808156828023186,OAK,HOU,2022 REG,4,3,14,8,11,18,0,1,-5,5,1,1,1,0,0,0,0,0,0,0.48808156828023186,0.5119184317197681
86832,0.3921568627450981,0.6428571428571428,155,-180,0.37842588015598405,0.6215741198440159,home,OAK,under,7.5,0.5348837209302326,-115,0.5119184317197681,OAK,HOU,2022 REG,4,3,14,8,11,18,0,1,-5,5,1,1,1,0,0,0,0,0,0,0.48808156828023186,0.5119184317197681
86833,0.5412844036697247,0.49504950495049505,-118,102,0.5216174256092387,0.47838257439076126,away,SEA,over,8.5,0.5192307692307692,-108,0.49688292476754015,TEX,SEA,2022 REG,12,7,7,4,11,19,1,0,3,-3,1,1,1,1,0,0,0,0,0,0.49688292476754015,0.5031170752324599
86833,0.5412844036697247,0.49504950495049505,-118,102,0.5216174256092387,0.47838257439076126,home,TEX,under,8.5,0.5238095238095238,-110,0.5031170752324599,TEX,SEA,2022 REG,12,7,7,4,11,19,1,0,3,-3,1,1,1,1,0,0,0,0,0,0.49688292476754015,0.5031170752324599
86834,0.4587155963302753,0.5798319327731092,118,-138,0.4410332435305576,0.5589667564694424,away,MIL,over,7.5,0.5,100,0.4772727272727273,CHC,MIL,2022 REG,4,4,5,5,9,9,0,1,-1,1,1,1,1,1,0,0,0,0,0,0.4772727272727273,0.5227272727272727
86834,0.4587155963302753,0.5798319327731092,118,-138,0.4410332435305576,0.5589667564694424,home,CHC,under,7.5,0.5454545454545454,-120,0.5227272727272727,CHC,MIL,2022 REG,4,4,5,5,9,9,0,1,-1,1,1,1,1,1,0,0,0,0,0,0.4772727272727273,0.5227272727272727
86835,0.5726495726495727,0.4629629629629629,-134,116,0.5522560693500865,0.44774393064991347,away,TB,over,8.5,0.5391705069124424,-117,0.5153817639191344,TOR,TB,2022 REG,11,3,14,7,10,25,0,1,-4,4,1,1,1,0,0,0,0,0,0,0.5153817639191344,0.4846182360808656
86835,0.5726495726495727,0.4629629629629629,-134,116,0.5522560693500865,0.44774393064991347,home,TOR,under,8.5,0.504950495049505,-102,0.4846182360808656,TOR,TB,2022 REG,11,3,14,7,10,25,0,1,-4,4,1,1,1,0,0,0,0,0,0,0.5153817639191344,0.4846182360808656
86836,0.6428571428571428,0.4166666666666667,-180,140,0.6045918367346939,0.39540816326530615,away,KC,over,9,0.5238095238095238,-110,0.4988662131519274,STL,KC,2022 REG,10,6,8,5,11,18,1,0,1,-1,1,1,1,1,1,0,0,0,0,0.4988662131519274,0.5011337868480725
86836,0.6428571428571428,0.4166666666666667,-180,140,0.6045918367346939,0.39540816326530615,home,STL,under,9,0.5238095238095238,-110,0.5011337868480725,STL,KC,2022 REG,10,6,8,5,11,18,1,0,1,-1,1,1,1,1,1,0,0,0,0,0.4988662131519274,0.5011337868480725
86837,0.5867768595041323,0.45454545454545453,-142,120,0.5625298818386723,0.43747011816132775,away,SEA,over,8.5,0.5073891625615764,-103,0.4826927225525911,HOU,SEA,2022 REG,6,4,5,2,6,11,1,0,2,-2,1,1,0,0,0,0,0,0,0,0.4826927225525911,0.5173072774474089
86837,0.5867768595041323,0.45454545454545453,-142,120,0.5625298818386723,0.43747011816132775,home,HOU,under,8.5,0.5412844036697247,-118,0.5173072774474089,HOU,SEA,2022 REG,6,4,5,2,6,11,1,0,2,-2,1,1,0,0,0,0,0,0,0,0.4826927225525911,0.5173072774474089
86838,0.6000000000000001,0.43859649122807015,-150,128,0.5768421052631579,0.42315789473684207,away,PIT,over,9,0.5495495495495495,-122,0.5250401592387142,WSH,PIT,2022 REG,16,7,9,8,15,25,0,1,-1,1,1,1,1,1,1,1,1,0,0,0.5250401592387142,0.47495984076128583
86838,0.6000000000000001,0.43859649122807015,-150,128,0.5768421052631579,0.42315789473684207,home,WSH,under,9,0.49504950495049505,102,0.47495984076128583,WSH,PIT,2022 REG,16,7,9,8,15,25,0,1,-1,1,1,1,1,1,1,1,1,0,0,0.5250401592387142,0.47495984076128583
86839,0.5098039215686274,0.5238095238095238,-104,-110,0.49266765529741313,0.5073323447025868,away,SD,over,8.5,0.5215311004784688,-109,0.50027251771145,STL,SD,2022 REG,10,6,11,3,9,21,1,0,3,-3,1,1,1,0,0,0,0,0,0,0.50027251771145,0.49972748228855
86839,0.5098039215686274,0.5238095238095238,-104,-110,0.49266765529741313,0.5073323447025868,home,STL,under,8.5,0.5192307692307692,-108,0.49972748228855,STL,SD,2022 REG,10,6,11,3,9,21,1,0,3,-3,1,1,1,0,0,0,0,0,0,0.50027251771145,0.49972748228855
86840,0.6363636363636364,0.4,-175,150,0.6132231404958678,0.3867768595041322,away,DET,over,8.5,0.5412844036697247,-118,0.5162581740877563,CWS,DET,2022 REG,5,2,14,7,9,19,0,1,-5,5,1,1,0,0,0,0,0,0,0,0.5162581740877563,0.4837418259122437
86840,0.6363636363636364,0.4,-175,150,0.6132231404958678,0.3867768595041322,home,CWS,under,8.5,0.504950495049505,-102,0.4837418259122437,CWS,DET,2022 REG,5,2,14,7,9,19,0,1,-5,5,1,1,0,0,0,0,0,0,0,0.5162581740877563,0.4837418259122437
86841,0.425531914893617,0.6153846153846154,135,-160,0.4081206254135181,0.5918793745864819,away,MIN,over,7,0.5348837209302326,-115,0.5097020142727117,DET,MIN,2022 REG,6,0,14,7,7,20,0,1,-7,7,0,0,0,0,0,0,0,0,0,0.5097020142727117,0.49029798572728833
86841,0.425531914893617,0.6153846153846154,135,-160,0.4081206254135181,0.5918793745864819,home,DET,under,7,0.5121951219512195,-105,0.49029798572728833,DET,MIN,2022 REG,6,0,14,7,7,20,0,1,-7,7,0,0,0,0,0,0,0,0,0,0.5097020142727117,0.49029798572728833
86842,0.48309178743961345,0.5555555555555556,107,-125,0.4644215734322854,0.5355784265677146,away,ATL,over,7.5,0.5370370370370371,-116,0.5131785224377817,MIA,ATL,2022 REG,5,1,10,3,4,15,0,1,-2,2,1,0,0,0,0,0,0,0,0,0.5131785224377817,0.4868214775622183
86842,0.48309178743961345,0.5555555555555556,107,-125,0.4644215734322854,0.5355784265677146,home,MIA,under,7.5,0.5073891625615764,-103,0.4868214775622183,MIA,ATL,2022 REG,5,1,10,3,4,15,0,1,-2,2,1,0,0,0,0,0,0,0,0,0.5131785224377817,0.4868214775622183
86843,0.425531914893617,0.6108949416342413,135,-157,0.41003112488176247,0.5899688751182375,away,HOU,over,9,0.5283018867924528,-112,0.5044173060022736,ARI,HOU,2022 REG,6,3,6,2,5,12,1,0,1,-1,1,1,0,0,0,0,0,0,0,0.5044173060022736,0.49558269399772636
86843,0.425531914893617,0.6108949416342413,135,-157,0.41003112488176247,0.5899688751182375,home,ARI,under,9,0.5169082125603864,-107,0.49558269399772636,ARI,HOU,2022 REG,6,3,6,2,5,12,1,0,1,-1,1,1,0,0,0,0,0,0,0,0.5044173060022736,0.49558269399772636
86844,0.35714285714285715,0.6825396825396826,180,-215,0.34297052154195007,0.6570294784580499,away,SF,over,8,0.5073891625615764,-103,0.4837652908580103,WSH,SF,2022 REG,7,3,15,12,15,22,0,1,-9,9,1,1,1,0,0,0,0,0,0,0.4837652908580103,0.5162347091419897
86844,0.35714285714285715,0.6825396825396826,180,-215,0.34297052154195007,0.6570294784580499,home,WSH,under,8,0.5391705069124424,-117,0.5162347091419897,WSH,SF,2022 REG,7,3,15,12,15,22,0,1,-9,9,1,1,1,0,0,0,0,0,0,0.4837652908580103,0.5162347091419897
86845,0.425531914893617,0.6183206106870228,135,-162,0.406871265710366,0.593128734289634,away,HOU,over,8.5,0.5215311004784688,-109,0.4955416477869355,CLE,HOU,2022 REG,10,4,6,1,5,16,1,0,3,-3,1,0,0,0,0,0,0,0,0,0.4955416477869355,0.5044583522130646
86845,0.425531914893617,0.6183206106870228,135,-162,0.406871265710366,0.593128734289634,home,CLE,under,8.5,0.5283018867924528,-112,0.5044583522130646,CLE,HOU,2022 REG,10,4,6,1,5,16,1,0,3,-3,1,0,0,0,0,0,0,0,0,0.4955416477869355,0.5044583522130646
86846,0.5918367346938775,0.4504504504504505,-145,122,0.566809625118663,0.43319037488133705,away,TOR,over,7,0.5327102803738317,-114,0.508788710910954,BAL,TOR,2022 REG,4,1,8,5,6,12,0,1,-4,4,1,0,0,0,0,0,0,0,0,0.508788710910954,0.491211289089046
86846,0.5918367346938775,0.4504504504504505,-145,122,0.566809625118663,0.43319037488133705,home,BAL,under,7,0.5121951219512195,-105,0.491211289089046,BAL,TOR,2022 REG,4,1,8,5,6,12,0,1,-4,4,1,0,0,0,0,0,0,0,0,0.508788710910954,0.491211289089046
86847,0.5454545454545454,0.49019607843137253,-120,104,0.526008750607681,0.47399124939231896,away,CHC,over,10,0.5121951219512195,-105,0.4903184724049234,PHI,CHC,2022 REG,9,3,7,4,7,16,0,1,-1,1,1,1,1,0,0,0,0,0,0,0.4903184724049234,0.5096815275950766
86847,0.5454545454545454,0.49019607843137253,-120,104,0.526008750607681,0.47399124939231896,home,PHI,under,10,0.5305164319248826,-113,0.5096815275950766,PHI,CHC,2022 REG,9,3,7,4,7,16,0,1,-1,1,1,1,1,0,0,0,0,0,0,0.4903184724049234,0.5096815275950766
86848,0.696969696969697,0.3389830508474576,-230,195,0.6719117212183469,0.32808827878165314,away,ARI,over,8.5,0.5073891625615764,-103,0.4826927225525911,SD,ARI,2022 REG,10,6,6,3,9,16,1,0,3,-3,1,1,1,0,0,0,0,0,0,0.4826927225525911,0.5173072774474089
86848,0.696969696969697,0.3389830508474576,-230,195,0.6719117212183469,0.32808827878165314,home,SD,under,8.5,0.5412844036697247,-118,0.5173072774474089,SD,ARI,2022 REG,10,6,6,3,9,16,1,0,3,-3,1,1,1,0,0,0,0,0,0,0.4826927225525911,0.5173072774474089
86849,0.6825396825396826,0.35714285714285715,-215,180,0.6554547745023935,0.34454522549760647,away,ARI,over,7,0.5,100,0.4762443438914027,LAD,ARI,2022 REG,6,3,4,2,5,10,1,0,1,-1,1,1,0,0,0,0,0,0,0,0.4762443438914027,0.5237556561085973
86849,0.6825396825396826,0.35714285714285715,-215,180,0.6554547745023935,0.34454522549760647,home,LAD,under,7,0.5475113122171946,-121,0.5237556561085973,LAD,ARI,2022 REG,6,3,4,2,5,10,1,0,1,-1,1,1,0,0,0,0,0,0,0,0.4762443438914027,0.5237556561085973
86850,0.49504950495049505,0.5454545454545454,102,-120,0.47499799484898986,0.5250020051510101,away,MIA,over,8,0.5,100,0.47935779816513757,PIT,MIA,2022 REG,9,1,5,0,1,14,1,0,1,-1,0,0,0,0,0,0,0,0,0,0.47935779816513757,0.5206422018348624
86850,0.49504950495049505,0.5454545454545454,102,-120,0.47499799484898986,0.5250020051510101,home,PIT,under,8,0.5412844036697247,-118,0.5206422018348624,PIT,MIA,2022 REG,9,1,5,0,1,14,1,0,1,-1,0,0,0,0,0,0,0,0,0,0.47935779816513757,0.5206422018348624
86851,0.7183098591549296,0.31746031746031744,-255,215,0.6926157886284845,0.3073842113715155,away,CIN,over,9.5,0.5145631067961165,-106,0.49023796582517226,PHI,CIN,2022 REG,16,7,10,5,12,26,1,0,2,-2,1,1,1,1,1,0,0,0,0,0.49023796582517226,0.5097620341748277
86851,0.7183098591549296,0.31746031746031744,-255,215,0.6926157886284845,0.3073842113715155,home,PHI,under,9.5,0.5327102803738317,-114,0.5097620341748277,PHI,CIN,2022 REG,16,7,10,5,12,26,1,0,2,-2,1,1,1,1,1,0,0,0,0,0.49023796582517226,0.5097620341748277
86852,0.5652173913043479,0.4672897196261683,-130,114,0.5468438068653605,0.4531561931346395,away,NYY,over,7.5,0.5098039215686274,-104,0.4870219861770517,TB,NYY,2022 REG,7,2,3,1,3,10,1,0,1,-1,1,0,0,0,0,0,0,0,0,0.4870219861770517,0.5129780138229483
86852,0.5652173913043479,0.4672897196261683,-130,114,0.5468438068653605,0.4531561931346395,home,TB,under,7.5,0.5348837209302326,-115,0.5129780138229483,TB,NYY,2022 REG,7,2,3,1,3,10,1,0,1,-1,1,0,0,0,0,0,0,0,0,0.4870219861770517,0.5129780138229483
86853,0.3802281368821293,0.6610169491525424,163,-195,0.3645455946636229,0.6354544053363771,away,NYY,over,8,0.5283018867924528,-112,0.5044173060022736,KC,NYY,2022 REG,11,4,8,6,10,19,0,1,-2,2,1,1,1,1,0,0,0,0,0,0.5044173060022736,0.49558269399772636
86853,0.3802281368821293,0.6610169491525424,163,-195,0.3645455946636229,0.6354544053363771,home,KC,under,8,0.5169082125603864,-107,0.49558269399772636,KC,NYY,2022 REG,11,4,8,6,10,19,0,1,-2,2,1,1,1,1,0,0,0,0,0,0.5044173060022736,0.49558269399772636
86854,0.3921568627450981,0.6527777777777778,155,-188,0.37453543508906834,0.6254645649109316,away,TB,over,7.5,0.5305164319248826,-113,0.5078572507605655,BAL,TB,2022 REG,5,5,12,3,8,17,1,0,2,-2,1,1,1,0,0,0,0,0,0,0.5078572507605655,0.49214274923943446
86854,0.3921568627450981,0.6527777777777778,155,-188,0.37453543508906834,0.6254645649109316,home,BAL,under,7.5,0.5121951219512195,-105,0.49214274923943446,BAL,TB,2022 REG,5,5,12,3,8,17,1,0,2,-2,1,1,1,0,0,0,0,0,0,0.5078572507605655,0.49214274923943446
86855,0.3424657534246575,0.7014925373134329,192,-235,0.32741154426777724,0.6725884557322228,away,ATL,over,9.5,0.5348837209302326,-115,0.5109810284308424,WSH,ATL,2022 REG,11,4,6,5,9,17,0,1,-1,1,1,1,1,1,0,0,0,0,0,0.5109810284308424,0.48901897156915763
86855,0.3424657534246575,0.7014925373134329,192,-235,0.32741154426777724,0.6725884557322228,home,WSH,under,9.5,0.5098039215686274,-104,0.48901897156915763,WSH,ATL,2022 REG,11,4,6,5,9,17,0,1,-1,1,1,1,1,1,0,0,0,0,0,0.5109810284308424,0.48901897156915763
86856,0.39370078740157477,0.647887323943662,154,-184,0.3773275152184107,0.6226724847815893,away,NYY,over,7.5,0.5098039215686274,-104,0.48592421718142587,DET,NYY,2022 REG,11,3,6,5,8,17,0,1,-2,2,1,1,1,0,0,0,0,0,0,0.48592421718142587,0.5140757828185741
86856,0.39370078740157477,0.647887323943662,154,-184,0.3773275152184107,0.6226724847815893,home,DET,under,7.5,0.5370370370370371,-116,0.5140757828185741,DET,NYY,2022 REG,11,3,6,5,8,17,0,1,-2,2,1,1,1,0,0,0,0,0,0,0.48592421718142587,0.5140757828185741
86857,0.5495495495495495,0.48780487804878053,-122,105,0.529021440689206,0.470978559310794,away,DET,over,8.5,0.5305164319248826,-113,0.5053568787472517,KC,DET,2022 REG,8,3,4,1,4,12,1,0,2,-2,1,0,0,0,0,0,0,0,0,0.5053568787472517,0.49464312125274834
86857,0.5495495495495495,0.48780487804878053,-122,105,0.529021440689206,0.470978559310794,home,KC,under,8.5,0.5169082125603864,-107,0.49464312125274834,KC,DET,2022 REG,8,3,4,1,4,12,1,0,2,-2,1,0,0,0,0,0,0,0,0,0.5053568787472517,0.49464312125274834
86858,0.6108949416342413,0.425531914893617,-157,135,0.5886419592417365,0.41135804075826354,away,TOR,over,7,0.5412844036697247,-118,0.5136310900085983,BAL,TOR,2022 REG,10,5,13,4,9,23,1,0,1,-1,1,1,1,1,0,0,0,0,0,0.5136310900085983,0.4863689099914017
86858,0.6108949416342413,0.425531914893617,-157,135,0.5886419592417365,0.41135804075826354,home,BAL,under,7,0.5098039215686274,-104,0.4863689099914017,BAL,TOR,2022 REG,10,5,13,4,9,23,1,0,1,-1,1,1,1,1,0,0,0,0,0,0.5136310900085983,0.4863689099914017
86859,0.45454545454545453,0.5884773662551441,120,-143,0.43498962690881876,0.5650103730911813,away,ATL,over,7.5,0.5073891625615764,-103,0.4826927225525911,PHI,ATL,2022 REG,6,1,6,0,1,12,1,0,1,-1,0,0,0,0,0,0,0,0,0,0.4826927225525911,0.5173072774474089
86859,0.45454545454545453,0.5884773662551441,120,-143,0.43498962690881876,0.5650103730911813,home,PHI,under,7.5,0.5412844036697247,-118,0.5173072774474089,PHI,ATL,2022 REG,6,1,6,0,1,12,1,0,1,-1,0,0,0,0,0,0,0,0,0,0.4826927225525911,0.5173072774474089
86860,0.43859649122807015,0.5967741935483871,128,-148,0.4230830329927819,0.5769169670072181,away,CLE,over,7,0.5327102803738317,-114,0.5075272610403079,CWS,CLE,2022 REG,7,2,9,4,6,16,0,1,-2,2,1,1,0,0,0,0,0,0,0,0.5075272610403079,0.4924727389596921
86860,0.43859649122807015,0.5967741935483871,128,-148,0.4230830329927819,0.5769169670072181,home,CWS,under,7,0.5145631067961165,-106,0.4924727389596921,CWS,CLE,2022 REG,7,2,9,4,6,16,0,1,-2,2,1,1,0,0,0,0,0,0,0,0.5075272610403079,0.4924727389596921
86861,0.4166666666666667,0.6226415094339623,140,-165,0.4002882599580712,0.5997117400419287,away,NYY,over,7,0.5348837209302326,-115,0.5097020142727117,TB,NYY,2022 REG,8,5,5,4,9,13,1,0,1,-1,1,1,1,1,0,0,0,0,0,0.5097020142727117,0.49029798572728833
86861,0.4166666666666667,0.6226415094339623,140,-165,0.4002882599580712,0.5997117400419287,home,TB,under,7,0.5121951219512195,-105,0.49029798572728833,TB,NYY,2022 REG,8,5,5,4,9,13,1,0,1,-1,1,1,1,1,0,0,0,0,0,0.5097020142727117,0.49029798572728833
86862,0.6551724137931035,0.3846153846153846,-190,160,0.6291045458703008,0.37089545412969915,away,PIT,over,9.5,0.5024875621890548,-101,0.48049269377245407,STL,PIT,2022 REG,14,7,7,5,12,21,1,0,2,-2,1,1,1,1,1,0,0,0,0,0.48049269377245407,0.5195073062275459
86862,0.6551724137931035,0.3846153846153846,-190,160,0.6291045458703008,0.37089545412969915,home,STL,under,9.5,0.5412844036697247,-118,0.5195073062275459,STL,PIT,2022 REG,14,7,7,5,12,21,1,0,2,-2,1,1,1,1,1,0,0,0,0,0.48049269377245407,0.5195073062275459
86863,0.7354497354497355,0.30303030303030304,-278,230,0.7071496013294954,0.29285039867050455,away,CHC,over,8,0.5412844036697247,-118,0.5189377998484975,LAD,CHC,2022 REG,7,5,6,3,8,13,1,0,2,-2,1,1,1,0,0,0,0,0,0,0.5189377998484975,0.4810622001515025
86863,0.7354497354497355,0.30303030303030304,-278,230,0.7071496013294954,0.29285039867050455,home,LAD,under,8,0.5,100,0.4810622001515025,LAD,CHC,2022 REG,7,5,6,3,8,13,1,0,2,-2,1,1,1,0,0,0,0,0,0,0.5189377998484975,0.4810622001515025
86864,0.5238095238095238,0.5169082125603864,-110,-107,0.5024811857109994,0.4975188142890006,away,COL,over,9,0.49751243781094534,101,0.476135829221149,WSH,COL,2022 REG,9,7,8,3,10,17,1,0,4,-4,1,1,1,0,0,0,0,0,0,0.476135829221149,0.523864170778851
86864,0.5238095238095238,0.5169082125603864,-110,-107,0.5024811857109994,0.4975188142890006,home,WSH,under,9,0.5454545454545454,-120,0.523864170778851,WSH,COL,2022 REG,9,7,8,3,10,17,1,0,4,-4,1,1,1,0,0,0,0,0,0,0.476135829221149,0.523864170778851
86865,0.7297297297297298,0.3125,-270,220,0.6989134404674946,0.3010865595325054,away,MIL,over,8,0.5,100,0.4772727272727273,LAD,MIL,2022 REG,8,0,5,4,4,13,0,1,-4,4,0,0,0,0,0,0,0,0,0,0.4772727272727273,0.5227272727272727
86865,0.7297297297297298,0.3125,-270,220,0.6989134404674946,0.3010865595325054,home,LAD,under,8,0.5454545454545454,-120,0.5227272727272727,LAD,MIL,2022 REG,8,0,5,4,4,13,0,1,-4,4,0,0,0,0,0,0,0,0,0,0.4772727272727273,0.5227272727272727
86866,0.7014925373134329,0.3389830508474576,-235,195,0.6730992142751963,0.32690078572480374,away,OAK,over,7,0.5238095238095238,-110,0.4988662131519274,LAA,OAK,2022 REG,6,1,8,3,4,14,0,1,-2,2,1,0,0,0,0,0,0,0,0,0.4988662131519274,0.5011337868480725
86866,0.7014925373134329,0.3389830508474576,-235,195,0.6730992142751963,0.32690078572480374,home,LAA,under,7,0.5238095238095238,-110,0.5011337868480725,LAA,OAK,2022 REG,6,1,8,3,4,14,0,1,-2,2,1,0,0,0,0,0,0,0,0,0.4988662131519274,0.5011337868480725
86867,0.7183098591549296,0.3225806451612903,-255,210,0.6889378067587716,0.3110621932412284,away,COL,over,8,0.5305164319248826,-113,0.5016956197277562,SF,COL,2022 REG,7,2,10,4,6,17,0,1,-2,2,1,1,0,0,0,0,0,0,0,0.5016956197277562,0.4983043802722438
86867,0.7183098591549296,0.3225806451612903,-255,210,0.6889378067587716,0.3110621932412284,home,SF,under,8,0.5238095238095238,-110,0.4983043802722438,SF,COL,2022 REG,7,2,10,4,6,17,0,1,-2,2,1,1,0,0,0,0,0,0,0,0.5016956197277562,0.4983043802722438
86868,0.4347826086956522,0.6031746031746031,130,-152,0.418279473099889,0.581720526900111,away,TEX,over,9,0.5121951219512195,-105,0.48808156828023186,KC,TEX,2022 REG,7,3,13,8,11,20,0,1,-5,5,1,1,1,0,0,0,0,0,0,0.48808156828023186,0.5119184317197681
86868,0.4347826086956522,0.6031746031746031,130,-152,0.418279473099889,0.581720526900111,home,KC,under,9,0.5348837209302326,-115,0.5119184317197681,KC,TEX,2022 REG,7,3,13,8,11,20,0,1,-5,5,1,1,1,0,0,0,0,0,0,0.48808156828023186,0.5119184317197681
86869,0.46511627906976744,0.574468085106383,115,-135,0.44670494689481377,0.5532950531051862,away,NYM,over,7.5,0.5,100,0.4772727272727273,CHC,NYM,2022 REG,5,1,4,2,3,9,0,1,-1,1,1,0,0,0,0,0,0,0,0,0.4772727272727273,0.5227272727272727
86869,0.46511627906976744,0.574468085106383,115,-135,0.44670494689481377,0.5532950531051862,home,CHC,under,7.5,0.5454545454545454,-120,0.5227272727272727,CHC,NYM,2022 REG,5,1,4,2,3,9,0,1,-1,1,1,0,0,0,0,0,0,0,0,0.4772727272727273,0.5227272727272727
86870,0.5121951219512195,0.5348837209302326,-105,-115,0.48808156828023186,0.5119184317197681,away,CWS,over,11,0.5283018867924528,-112,0.5031902949311281,COL,CWS,2022 REG,9,1,9,2,3,18,0,1,-1,1,1,0,0,0,0,0,0,0,0,0.5031902949311281,0.4968097050688719
86870,0.5121951219512195,0.5348837209302326,-105,-115,0.48808156828023186,0.5119184317197681,home,COL,under,11,0.5192307692307692,-108,0.4968097050688719,COL,CWS,2022 REG,9,1,9,2,3,18,0,1,-1,1,1,0,0,0,0,0,0,0,0,0.5031902949311281,0.4968097050688719
86871,0.7058823529411764,0.3333333333333333,-240,200,0.6782006920415226,0.32179930795847744,away,COL,over,6.5,0.5454545454545454,-120,0.5220180091279142,SF,COL,2022 REG,11,8,11,5,13,22,1,0,3,-3,1,1,1,1,1,0,0,0,0,0.5220180091279142,0.4779819908720858
86871,0.7058823529411764,0.3333333333333333,-240,200,0.6782006920415226,0.32179930795847744,home,SF,under,6.5,0.49751243781094534,101,0.4779819908720858,SF,COL,2022 REG,11,8,11,5,13,22,1,0,3,-3,1,1,1,1,1,0,0,0,0,0.5220180091279142,0.4779819908720858
86872,0.6721311475409836,0.37037037037037035,-205,170,0.6435645535349916,0.35643544646500835,away,TEX,over,7.5,0.5,100,0.4772727272727273,SEA,TEX,2022 REG,5,0,7,5,5,12,0,1,-5,5,0,0,0,0,0,0,0,0,0,0.4772727272727273,0.5227272727272727
86872,0.6721311475409836,0.37037037037037035,-205,170,0.6435645535349916,0.35643544646500835,home,SEA,under,7.5,0.5454545454545454,-120,0.5227272727272727,SEA,TEX,2022 REG,5,0,7,5,5,12,0,1,-5,5,0,0,0,0,0,0,0,0,0,0.4772727272727273,0.5227272727272727
86873,0.9523809523809523,0.10810810810810811,-2000,825,0.8947723233437519,0.1052276766562481,away,STL,over,10.5,0.09960159362549802,904,0.0950245493071743,MIL,STL,2022 REG,8,6,7,4,10,15,1,0,2,-2,1,1,1,1,0,0,0,0,0,0.0950245493071743,0.9049754506928257
86873,0.9523809523809523,0.10810810810810811,-2000,825,0.8947723233437519,0.1052276766562481,home,MIL,under,10.5,0.9463519313304721,-1764,0.9049754506928257,MIL,STL,2022 REG,8,6,7,4,10,15,1,0,2,-2,1,1,1,1,0,0,0,0,0,0.0950245493071743,0.9049754506928257
86874,0.43859649122807015,0.5833333333333333,128,-140,0.42897814712219146,0.5710218528778086,away,MIL,over,6.5,0.5073891625615764,-103,0.4826927225525911,MIA,MIL,2022 REG,5,1,6,2,3,11,0,1,-1,1,1,0,0,0,0,0,0,0,0,0.4826927225525911,0.5173072774474089
86874,0.43859649122807015,0.5833333333333333,128,-140,0.42897814712219146,0.5710218528778086,home,MIA,under,6.5,0.5412844036697247,-118,0.5173072774474089,MIA,MIL,2022 REG,5,1,6,2,3,11,0,1,-1,1,1,0,0,0,0,0,0,0,0,0.4826927225525911,0.5173072774474089
86875,0.607843137254902,0.425531914893617,-155,135,0.5875563408509002,0.41244365914909975,away,MIL,over,7.5,0.5238095238095238,-110,0.5000596729920038,SF,MIL,2022 REG,12,9,9,5,14,21,1,0,4,-4,1,1,1,1,1,0,0,0,0,0.5000596729920038,0.4999403270079962
86875,0.607843137254902,0.425531914893617,-155,135,0.5875563408509002,0.41244365914909975,home,SF,under,7.5,0.5215311004784688,-109,0.4999403270079962,SF,MIL,2022 REG,12,9,9,5,14,21,1,0,4,-4,1,1,1,1,1,0,0,0,0,0.5000596729920038,0.4999403270079962
86876,0.7409326424870467,0.29850746268656714,-286,235,0.7117101811407941,0.2882898188592059,away,WSH,over,7.5,0.5192307692307692,-108,0.49571111079951763,STL,WSH,2022 REG,11,6,18,11,17,29,0,1,-5,5,1,1,1,1,1,1,0,0,0,0.49571111079951763,0.5042888892004824
86876,0.7409326424870467,0.29850746268656714,-286,235,0.7117101811407941,0.2882898188592059,home,STL,under,7.5,0.5260663507109005,-111,0.5042888892004824,STL,WSH,2022 REG,11,6,18,11,17,29,0,1,-5,5,1,1,1,1,1,1,0,0,0,0.49571111079951763,0.5042888892004824
86877,0.613899613899614,0.425531914893617,-159,135,0.589692613597978,0.410307386402022,away,TOR,over,8,0.5391705069124424,-117,0.5140669063204599,MIL,TOR,2022 REG,8,5,7,4,9,15,1,0,1,-1,1,1,1,1,0,0,0,0,0,0.5140669063204599,0.4859330936795401
86877,0.613899613899614,0.425531914893617,-159,135,0.589692613597978,0.410307386402022,home,MIL,under,8,0.5073891625615764,-103,0.4859330936795401,MIL,TOR,2022 REG,8,5,7,4,9,15,1,0,1,-1,1,1,1,1,0,0,0,0,0,0.5140669063204599,0.4859330936795401
86878,0.5555555555555556,0.48780487804878053,-125,105,0.5314664257753688,0.46853357422463116,away,TB,over,7.5,0.5433789954337899,-119,0.5198077604720502,LAA,TB,2022 REG,11,11,10,3,14,21,1,0,8,-8,1,1,1,0,0,0,0,0,0,0.5198077604720502,0.48019223952794976
86878,0.5555555555555556,0.48780487804878053,-125,105,0.5314664257753688,0.46853357422463116,home,LAA,under,7.5,0.5,100,0.48019223952794976,LAA,TB,2022 REG,11,11,10,3,14,21,1,0,8,-8,1,1,1,0,0,0,0,0,0,0.5198077604720502,0.48019223952794976
86879,0.4716981132075471,0.5689655172413793,112,-132,0.45251715544861953,0.5474828445513804,away,MIL,over,7,0.5238095238095238,-110,0.5000596729920038,SF,MIL,2022 REG,11,8,6,5,13,17,1,0,3,-3,1,1,1,1,1,0,0,0,0,0.5000596729920038,0.4999403270079962
86879,0.4716981132075471,0.5689655172413793,112,-132,0.45251715544861953,0.5474828445513804,home,SF,under,7,0.5215311004784688,-109,0.4999403270079962,SF,MIL,2022 REG,11,8,6,5,13,17,1,0,3,-3,1,1,1,1,1,0,0,0,0,0.5000596729920038,0.4999403270079962
86880,0.3076923076923077,0.7333333333333333,225,-275,0.29506903353057207,0.7049309664694279,away,ATL,over,9.5,0.5391705069124424,-117,0.5140669063204599,CIN,ATL,2022 REG,6,1,12,9,10,18,0,1,-8,8,1,0,0,0,0,0,0,0,0,0.5140669063204599,0.4859330936795401
86880,0.3076923076923077,0.7333333333333333,225,-275,0.29506903353057207,0.7049309664694279,home,CIN,under,9.5,0.5073891625615764,-103,0.4859330936795401,CIN,ATL,2022 REG,6,1,12,9,10,18,0,1,-8,8,1,0,0,0,0,0,0,0,0,0.5140669063204599,0.4859330936795401
86882,0.4166666666666667,0.6153846153846154,140,-160,0.40331196581196577,0.5966880341880343,away,NYM,over,7.5,0.5098039215686274,-104,0.4870219861770517,MIA,NYM,2022 REG,10,6,7,3,9,17,1,0,3,-3,1,1,1,0,0,0,0,0,0,0.4870219861770517,0.5129780138229483
86882,0.4166666666666667,0.6153846153846154,140,-160,0.40331196581196577,0.5966880341880343,home,MIA,under,7.5,0.5348837209302326,-115,0.5129780138229483,MIA,NYM,2022 REG,10,6,7,3,9,17,1,0,3,-3,1,1,1,0,0,0,0,0,0,0.4870219861770517,0.5129780138229483
86883,0.4716981132075471,0.5652173913043479,112,-130,0.4542851393811816,0.5457148606188185,away,SEA,over,9,0.5073891625615764,-103,0.4826927225525911,TEX,SEA,2022 REG,7,2,10,6,8,17,0,1,-4,4,1,1,0,0,0,0,0,0,0,0.4826927225525911,0.5173072774474089
86883,0.4716981132075471,0.5652173913043479,112,-130,0.4542851393811816,0.5457148606188185,home,TEX,under,9,0.5412844036697247,-118,0.5173072774474089,TEX,SEA,2022 REG,7,2,10,6,8,17,0,1,-4,4,1,1,0,0,0,0,0,0,0,0.4826927225525911,0.5173072774474089
86884,0.504950495049505,0.5370370370370371,-102,-116,0.4837488699364985,0.5162511300635015,away,CWS,over,8.5,0.5238095238095238,-110,0.4988662131519274,BAL,CWS,2022 REG,6,3,12,5,8,18,0,1,-2,2,1,1,1,0,0,0,0,0,0,0.4988662131519274,0.5011337868480725
86884,0.504950495049505,0.5370370370370371,-102,-116,0.4837488699364985,0.5162511300635015,home,BAL,under,8.5,0.5238095238095238,-110,0.5011337868480725,BAL,CWS,2022 REG,6,3,12,5,8,18,0,1,-2,2,1,1,1,0,0,0,0,0,0,0.4988662131519274,0.5011337868480725
86885,0.5073891625615764,0.5348837209302326,-103,-115,0.4859403596076043,0.5140596403923957,away,CLE,over,9,0.5283018867924528,-112,0.5031902949311281,KC,CLE,2022 REG,11,5,5,1,6,16,1,0,4,-4,1,0,0,0,0,0,0,0,0,0.5031902949311281,0.4968097050688719
86885,0.5073891625615764,0.5348837209302326,-103,-115,0.4859403596076043,0.5140596403923957,home,KC,under,9,0.5192307692307692,-108,0.4968097050688719,KC,CLE,2022 REG,11,5,5,1,6,16,1,0,4,-4,1,0,0,0,0,0,0,0,0,0.5031902949311281,0.4968097050688719
86886,0.38167938931297707,0.6610169491525424,162,-195,0.3653830769215574,0.6346169230784426,away,NYY,over,9,0.5238095238095238,-110,0.4988662131519274,PIT,NYY,2022 REG,9,5,10,2,7,19,1,0,3,-3,1,1,0,0,0,0,0,0,0,0.4988662131519274,0.5011337868480725
86886,0.38167938931297707,0.6610169491525424,162,-195,0.3653830769215574,0.6346169230784426,home,PIT,under,9,0.5238095238095238,-110,0.5011337868480725,PIT,NYY,2022 REG,9,5,10,2,7,19,1,0,3,-3,1,1,0,0,0,0,0,0,0,0.4988662131519274,0.5011337868480725
86887,0.3846153846153846,0.6503496503496503,160,-186,0.3711672942442173,0.6288327057557828,away,PHI,over,11,0.5348837209302326,-115,0.5097020142727117,WSH,PHI,2022 REG,9,3,9,5,8,18,0,1,-2,2,1,1,1,0,0,0,0,0,0,0.5097020142727117,0.49029798572728833
86887,0.3846153846153846,0.6503496503496503,160,-186,0.3711672942442173,0.6288327057557828,home,WSH,under,11,0.5121951219512195,-105,0.49029798572728833,WSH,PHI,2022 REG,9,3,9,5,8,18,0,1,-2,2,1,1,1,0,0,0,0,0,0,0.5097020142727117,0.49029798572728833
86888,0.6666666666666666,0.373134328358209,-200,168,0.6401326699834162,0.3598673300165838,away,KC,over,6.5,0.5454545454545454,-120,0.5206611570247933,CLE,KC,2022 REG,8,2,6,5,7,14,0,1,-3,3,1,1,0,0,0,0,0,0,0,0.5206611570247933,0.4793388429752067
86888,0.6666666666666666,0.373134328358209,-200,168,0.6401326699834162,0.3598673300165838,home,CLE,under,6.5,0.5,100,0.4793388429752067,CLE,KC,2022 REG,8,2,6,5,7,14,0,1,-3,3,1,1,0,0,0,0,0,0,0,0.5206611570247933,0.4793388429752067
86889,0.43103448275862066,0.613899613899614,132,-159,0.4116663376473126,0.5883336623526874,away,ATL,over,12,0.5121951219512195,-105,0.48808156828023186,COL,ATL,2022 REG,3,2,10,6,8,13,0,1,-4,4,1,1,0,0,0,0,0,0,0,0.48808156828023186,0.5119184317197681
86889,0.43103448275862066,0.613899613899614,132,-159,0.4116663376473126,0.5883336623526874,home,COL,under,12,0.5348837209302326,-115,0.5119184317197681,COL,ATL,2022 REG,3,2,10,6,8,13,0,1,-4,4,1,1,0,0,0,0,0,0,0,0.48808156828023186,0.5119184317197681
86890,0.6503496503496503,0.3921568627450981,-186,155,0.6227055544208978,0.3772944455791022,away,SEA,over,7,0.5495495495495495,-122,0.5250401592387142,HOU,SEA,2022 REG,15,11,6,1,12,21,1,0,10,-10,1,0,0,0,0,0,0,0,0,0.5250401592387142,0.47495984076128583
86890,0.6503496503496503,0.3921568627450981,-186,155,0.6227055544208978,0.3772944455791022,home,HOU,under,7,0.49504950495049505,102,0.47495984076128583,HOU,SEA,2022 REG,15,11,6,1,12,21,1,0,10,-10,1,0,0,0,0,0,0,0,0,0.5250401592387142,0.47495984076128583
86891,0.5815899581589958,0.4587155963302753,-139,118,0.5581486524100054,0.44185134758999456,away,COL,over,9.5,0.5305164319248826,-113,0.5066009958897986,TEX,COL,2022 REG,9,4,14,6,10,23,0,1,-2,2,1,1,1,1,0,0,0,0,0,0.5066009958897986,0.49339900411020143
86891,0.5815899581589958,0.4587155963302753,-139,118,0.5581486524100054,0.44185134758999456,home,TEX,under,9.5,0.5145631067961165,-106,0.49339900411020143,TEX,COL,2022 REG,9,4,14,6,10,23,0,1,-2,2,1,1,1,1,0,0,0,0,0,0.5066009958897986,0.49339900411020143
86892,0.7409326424870467,0.29850746268656714,-286,235,0.7117101811407941,0.2882898188592059,away,WSH,over,8.5,0.5121951219512195,-105,0.48808156828023186,SD,WSH,2022 REG,9,2,7,1,3,16,1,0,1,-1,1,0,0,0,0,0,0,0,0,0.48808156828023186,0.5119184317197681
86892,0.7409326424870467,0.29850746268656714,-286,235,0.7117101811407941,0.2882898188592059,home,SD,under,8.5,0.5348837209302326,-115,0.5119184317197681,SD,WSH,2022 REG,9,2,7,1,3,16,1,0,1,-1,1,0,0,0,0,0,0,0,0,0.48808156828023186,0.5119184317197681
86893,0.40322580645161293,0.6389891696750902,148,-177,0.3862036386585874,0.6137963613414126,away,CWS,over,7.5,0.5348837209302326,-115,0.5097020142727117,KC,CWS,2022 REG,8,5,14,3,8,22,1,0,2,-2,1,1,1,0,0,0,0,0,0,0.5097020142727117,0.49029798572728833
86893,0.40322580645161293,0.6389891696750902,148,-177,0.3862036386585874,0.6137963613414126,home,KC,under,7.5,0.5121951219512195,-105,0.49029798572728833,KC,CWS,2022 REG,8,5,14,3,8,22,1,0,2,-2,1,1,1,0,0,0,0,0,0,0.5097020142727117,0.49029798572728833
86894,0.5238095238095238,0.5145631067961165,-110,-106,0.5037095744446646,0.4962904255553354,away,MIL,over,9.5,0.5121951219512195,-105,0.48919479393107135,CIN,MIL,2022 REG,9,3,11,7,10,20,0,1,-4,4,1,1,1,0,0,0,0,0,0,0.48919479393107135,0.5108052060689287
86894,0.5238095238095238,0.5145631067961165,-110,-106,0.5037095744446646,0.4962904255553354,home,CIN,under,9.5,0.5327102803738317,-114,0.5108052060689287,CIN,MIL,2022 REG,9,3,11,7,10,20,0,1,-4,4,1,1,1,0,0,0,0,0,0,0.48919479393107135,0.5108052060689287
86895,0.46511627906976744,0.574468085106383,115,-135,0.44670494689481377,0.5532950531051862,away,NYM,over,10,0.5305164319248826,-113,0.5053568787472517,WSH,NYM,2022 REG,5,4,7,2,6,12,1,0,2,-2,1,1,0,0,0,0,0,0,0,0.5053568787472517,0.49464312125274834
86895,0.46511627906976744,0.574468085106383,115,-135,0.44670494689481377,0.5532950531051862,home,WSH,under,10,0.5169082125603864,-107,0.49464312125274834,WSH,NYM,2022 REG,5,4,7,2,6,12,1,0,2,-2,1,1,0,0,0,0,0,0,0,0.5053568787472517,0.49464312125274834
86896,0.726027397260274,0.3125,-265,220,0.6980554513041847,0.30194454869581533,away,OAK,over,6.5,0.5391705069124424,-117,0.5140669063204599,SF,OAK,2022 REG,7,8,5,2,10,12,1,0,6,-6,1,1,0,0,0,0,0,0,0,0.5140669063204599,0.4859330936795401
86896,0.726027397260274,0.3125,-265,220,0.6980554513041847,0.30194454869581533,home,SF,under,6.5,0.5073891625615764,-103,0.4859330936795401,SF,OAK,2022 REG,7,8,5,2,10,12,1,0,6,-6,1,1,0,0,0,0,0,0,0,0.5140669063204599,0.4859330936795401
86897,0.5454545454545454,0.49504950495049505,-120,102,0.5233614270517961,0.4766385729482039,away,CIN,over,8.5,0.5305164319248826,-113,0.5053568787472517,PIT,CIN,2022 REG,10,5,13,9,14,23,0,1,-4,4,1,1,1,1,1,0,0,0,0,0.5053568787472517,0.49464312125274834
86897,0.5454545454545454,0.49504950495049505,-120,102,0.5233614270517961,0.4766385729482039,home,PIT,under,8.5,0.5169082125603864,-107,0.49464312125274834,PIT,CIN,2022 REG,10,5,13,9,14,23,0,1,-4,4,1,1,1,1,1,0,0,0,0,0.5053568787472517,0.49464312125274834
86898,0.782608695652174,0.2531645569620253,-360,295,0.7546122370845398,0.24538776291546016,away,CIN,over,8,0.5391705069124424,-117,0.5140669063204599,PHI,CIN,2022 REG,7,4,5,0,4,12,1,0,4,-4,0,0,0,0,0,0,0,0,0,0.5140669063204599,0.4859330936795401
86898,0.782608695652174,0.2531645569620253,-360,295,0.7546122370845398,0.24538776291546016,home,PHI,under,8,0.5073891625615764,-103,0.4859330936795401,PHI,CIN,2022 REG,7,4,5,0,4,12,1,0,4,-4,0,0,0,0,0,0,0,0,0,0.5140669063204599,0.4859330936795401
86899,0.6108949416342413,0.425531914893617,-157,135,0.5886419592417365,0.41135804075826354,away,ARI,over,6.5,0.5283018867924528,-112,0.5044173060022736,MIA,ARI,2022 REG,8,4,9,5,9,17,0,1,-1,1,1,1,1,1,0,0,0,0,0,0.5044173060022736,0.49558269399772636
86899,0.6108949416342413,0.425531914893617,-157,135,0.5886419592417365,0.41135804075826354,home,MIA,under,6.5,0.5169082125603864,-107,0.49558269399772636,MIA,ARI,2022 REG,8,4,9,5,9,17,0,1,-1,1,1,1,1,1,0,0,0,0,0,0.5044173060022736,0.49558269399772636
86900,0.6402877697841727,0.4,-178,150,0.6144920035194866,0.38550799648051337,away,TB,over,7,0.5121951219512195,-105,0.48808156828023186,HOU,TB,2022 REG,7,3,10,7,10,17,0,1,-4,4,1,1,1,0,0,0,0,0,0,0.48808156828023186,0.5119184317197681
86900,0.6402877697841727,0.4,-178,150,0.6144920035194866,0.38550799648051337,home,HOU,under,7,0.5348837209302326,-115,0.5119184317197681,HOU,TB,2022 REG,7,3,10,7,10,17,0,1,-4,4,1,1,1,0,0,0,0,0,0,0.48808156828023186,0.5119184317197681
86902,0.6212121212121212,0.425531914893617,-164,135,0.5921741593888595,0.40782584061114047,away,DET,over,8,0.5454545454545454,-120,0.5206611570247933,TEX,DET,2022 REG,11,7,7,6,13,18,1,0,1,-1,1,1,1,1,1,1,0,0,0,0.5206611570247933,0.4793388429752067
86902,0.6212121212121212,0.425531914893617,-164,135,0.5921741593888595,0.40782584061114047,home,TEX,under,8,0.5,100,0.4793388429752067,TEX,DET,2022 REG,11,7,7,6,13,18,1,0,1,-1,1,1,1,1,1,1,0,0,0,0.5206611570247933,0.4793388429752067
86903,0.6666666666666666,0.37037037037037035,-200,170,0.6419753086419753,0.3580246913580247,away,CWS,over,7,0.5283018867924528,-112,0.5031902949311281,SEA,CWS,2022 REG,7,6,8,9,15,15,0,1,-3,3,1,1,1,1,1,1,0,0,0,0.5031902949311281,0.4968097050688719
86903,0.6666666666666666,0.37037037037037035,-200,170,0.6419753086419753,0.3580246913580247,home,SEA,under,7,0.5192307692307692,-108,0.4968097050688719,SEA,CWS,2022 REG,7,6,8,9,15,15,0,1,-3,3,1,1,1,1,1,1,0,0,0,0.5031902949311281,0.4968097050688719
86904,0.6389891696750902,0.4,-177,150,0.614075512518083,0.385924487481917,away,MIA,over,7,0.5238095238095238,-110,0.4988662131519274,MIL,MIA,2022 REG,7,3,10,4,7,17,0,1,-1,1,1,1,1,0,0,0,0,0,0,0.4988662131519274,0.5011337868480725
86904,0.6389891696750902,0.4,-177,150,0.614075512518083,0.385924487481917,home,MIL,under,7,0.5238095238095238,-110,0.5011337868480725,MIL,MIA,2022 REG,7,3,10,4,7,17,0,1,-1,1,1,1,1,0,0,0,0,0,0,0.4988662131519274,0.5011337868480725
86905,0.30303030303030304,0.7354497354497355,230,-278,0.29136968530907925,0.7086303146909207,away,SD,over,9,0.5073891625615764,-103,0.4837652908580103,WSH,SD,2022 REG,7,0,9,6,6,16,0,1,-6,6,0,0,0,0,0,0,0,0,0,0.4837652908580103,0.5162347091419897
86905,0.30303030303030304,0.7354497354497355,230,-278,0.29136968530907925,0.7086303146909207,home,WSH,under,9,0.5391705069124424,-117,0.5162347091419897,WSH,SD,2022 REG,7,0,9,6,6,16,0,1,-6,6,0,0,0,0,0,0,0,0,0,0.4837652908580103,0.5162347091419897
86906,0.4716981132075471,0.5633187772925764,112,-129,0.45518071202824356,0.5448192879717564,away,PHI,over,7.5,0.49019607843137253,104,0.46874141813588177,ARI,PHI,2022 REG,17,12,4,3,15,21,1,0,9,-9,1,1,1,0,0,0,0,0,0,0.46874141813588177,0.5312585818641182
86906,0.4716981132075471,0.5633187772925764,112,-129,0.45518071202824356,0.5448192879717564,home,ARI,under,7.5,0.5535714285714286,-124,0.5312585818641182,ARI,PHI,2022 REG,17,12,4,3,15,21,1,0,9,-9,1,1,1,0,0,0,0,0,0,0.46874141813588177,0.5312585818641182
86907,0.6721311475409836,0.37037037037037035,-205,170,0.6435645535349916,0.35643544646500835,away,WSH,over,9,0.5238095238095238,-110,0.4988662131519274,PHI,WSH,2022 REG,9,7,3,2,9,12,1,0,5,-5,1,1,0,0,0,0,0,0,0,0.4988662131519274,0.5011337868480725
86907,0.6721311475409836,0.37037037037037035,-205,170,0.6435645535349916,0.35643544646500835,home,PHI,under,9,0.5238095238095238,-110,0.5011337868480725,PHI,WSH,2022 REG,9,7,3,2,9,12,1,0,5,-5,1,1,0,0,0,0,0,0,0,0.4988662131519274,0.5011337868480725
86908,0.45454545454545453,0.5833333333333333,120,-140,0.43732782369146006,0.5626721763085399,away,ARI,over,7.5,0.5238095238095238,-110,0.5000596729920038,PIT,ARI,2022 REG,9,3,5,0,3,14,1,0,3,-3,0,0,0,0,0,0,0,0,0,0.5000596729920038,0.4999403270079962
86908,0.45454545454545453,0.5833333333333333,120,-140,0.43732782369146006,0.5626721763085399,home,PIT,under,7.5,0.5215311004784688,-109,0.4999403270079962,PIT,ARI,2022 REG,9,3,5,0,3,14,1,0,3,-3,0,0,0,0,0,0,0,0,0,0.5000596729920038,0.4999403270079962
86909,0.5215311004784688,0.5238095238095238,-109,-110,0.4978845547971712,0.5021154452028288,away,BOS,over,8.5,0.5169082125603864,-107,0.49353874091423283,BAL,BOS,2022 REG,8,4,21,17,21,29,0,1,-13,13,1,1,1,1,0,0,0,0,0,0.49353874091423283,0.5064612590857671
86909,0.5215311004784688,0.5238095238095238,-109,-110,0.4978845547971712,0.5021154452028288,home,BAL,under,8.5,0.5283018867924528,-112,0.5064612590857671,BAL,BOS,2022 REG,8,4,21,17,21,29,0,1,-13,13,1,1,1,1,0,0,0,0,0,0.49353874091423283,0.5064612590857671
86910,0.607843137254902,0.4347826086956522,-155,130,0.5819333701084867,0.41806662989151333,away,MIN,over,8.5,0.5348837209302326,-115,0.5097020142727117,CLE,MIN,2022 REG,3,5,7,3,8,10,1,0,2,-2,1,1,1,0,0,0,0,0,0,0.5097020142727117,0.49029798572728833
86910,0.607843137254902,0.4347826086956522,-155,130,0.5819333701084867,0.41806662989151333,home,CLE,under,8.5,0.5121951219512195,-105,0.49029798572728833,CLE,MIN,2022 REG,3,5,7,3,8,10,1,0,2,-2,1,1,1,0,0,0,0,0,0,0.5097020142727117,0.49029798572728833
86911,0.4166666666666667,0.6254681647940076,140,-167,0.3991104868913858,0.6008895131086143,away,SD,over,9.5,0.5169082125603864,-107,0.4946943078742622,ARI,SD,2022 REG,5,5,8,10,15,13,0,1,-5,5,1,1,1,1,1,0,0,0,0,0.4946943078742622,0.5053056921257377
86911,0.4166666666666667,0.6254681647940076,140,-167,0.3991104868913858,0.6008895131086143,home,ARI,under,9.5,0.5260663507109005,-111,0.5053056921257377,ARI,SD,2022 REG,5,5,8,10,15,13,0,1,-5,5,1,1,1,1,1,0,0,0,0,0.4946943078742622,0.5053056921257377
86912,0.4807692307692307,0.5555555555555556,108,-125,0.4633053911900066,0.5366946088099934,away,SF,over,7.5,0.5348837209302326,-115,0.5097020142727117,STL,SF,2022 REG,6,2,8,8,10,14,0,1,-6,6,1,1,0,0,0,0,0,0,0,0.5097020142727117,0.49029798572728833
86912,0.4807692307692307,0.5555555555555556,108,-125,0.4633053911900066,0.5366946088099934,home,STL,under,7.5,0.5121951219512195,-105,0.49029798572728833,STL,SF,2022 REG,6,2,8,8,10,14,0,1,-6,6,1,1,0,0,0,0,0,0,0,0.5097020142727117,0.49029798572728833
86913,0.5121951219512195,0.5348837209302326,-105,-115,0.48808156828023186,0.5119184317197681,away,NYY,over,9,0.5169082125603864,-107,0.49353874091423283,TOR,NYY,2022 REG,5,3,14,12,15,19,0,1,-9,9,1,1,1,0,0,0,0,0,0,0.49353874091423283,0.5064612590857671
86913,0.5121951219512195,0.5348837209302326,-105,-115,0.48808156828023186,0.5119184317197681,home,TOR,under,9,0.5283018867924528,-112,0.5064612590857671,TOR,NYY,2022 REG,5,3,14,12,15,19,0,1,-9,9,1,1,1,0,0,0,0,0,0,0.49353874091423283,0.5064612590857671
86914,0.7014925373134329,0.33783783783783783,-235,196,0.6739025726550789,0.3260974273449211,away,MIN,over,8,0.5348837209302326,-115,0.5097020142727117,HOU,MIN,2022 REG,6,5,4,3,8,10,1,0,2,-2,1,1,1,0,0,0,0,0,0,0.5097020142727117,0.49029798572728833
86914,0.7014925373134329,0.33783783783783783,-235,196,0.6739025726550789,0.3260974273449211,home,HOU,under,8,0.5121951219512195,-105,0.49029798572728833,HOU,MIN,2022 REG,6,5,4,3,8,10,1,0,2,-2,1,1,1,0,0,0,0,0,0,0.5097020142727117,0.49029798572728833
86915,0.5327102803738317,0.5073891625615764,-114,-103,0.511348894884876,0.488651105115124,away,ARI,over,11.5,0.5348837209302326,-115,0.5097020142727117,COL,ARI,2022 REG,6,3,11,9,12,17,0,1,-6,6,1,1,1,0,0,0,0,0,0,0.5097020142727117,0.49029798572728833
86915,0.5327102803738317,0.5073891625615764,-114,-103,0.511348894884876,0.488651105115124,home,COL,under,11.5,0.5121951219512195,-105,0.49029798572728833,COL,ARI,2022 REG,6,3,11,9,12,17,0,1,-6,6,1,1,1,0,0,0,0,0,0,0.5097020142727117,0.49029798572728833
86916,0.5412844036697247,0.49504950495049505,-118,102,0.5216174256092387,0.47838257439076126,away,CWS,over,7,0.5,100,0.4772727272727273,TB,CWS,2022 REG,4,2,7,3,5,11,0,1,-1,1,1,1,0,0,0,0,0,0,0,0.4772727272727273,0.5227272727272727
86916,0.5412844036697247,0.49504950495049505,-118,102,0.5216174256092387,0.47838257439076126,home,TB,under,7,0.5454545454545454,-120,0.5227272727272727,TB,CWS,2022 REG,4,2,7,3,5,11,0,1,-1,1,1,1,0,0,0,0,0,0,0,0.4772727272727273,0.5227272727272727
86917,0.3125,0.726027397260274,220,-265,0.3004601883561644,0.6995398116438356,away,LAD,over,7,0.504950495049505,-102,0.4826715732667395,MIA,LAD,2022 REG,2,1,14,8,9,16,0,1,-7,7,1,0,0,0,0,0,0,0,0,0.4826715732667395,0.5173284267332605
86917,0.3125,0.726027397260274,220,-265,0.3004601883561644,0.6995398116438356,home,MIA,under,7,0.5391705069124424,-117,0.5173284267332605,MIA,LAD,2022 REG,2,1,14,8,9,16,0,1,-7,7,1,0,0,0,0,0,0,0,0,0.4826715732667395,0.5173284267332605
86918,0.5555555555555556,0.4807692307692307,-125,108,0.5353751187084521,0.4646248812915479,away,BOS,over,7.5,0.49504950495049505,102,0.47499799484898986,TB,BOS,2022 REG,9,5,7,4,9,16,1,0,1,-1,1,1,1,1,0,0,0,0,0,0.47499799484898986,0.5250020051510101
86918,0.5555555555555556,0.4807692307692307,-125,108,0.5353751187084521,0.4646248812915479,home,TB,under,7.5,0.5454545454545454,-120,0.5250020051510101,TB,BOS,2022 REG,9,5,7,4,9,16,1,0,1,-1,1,1,1,1,0,0,0,0,0,0.47499799484898986,0.5250020051510101
86919,0.4132231404958678,0.626865671641791,142,-168,0.39665751564559554,0.6033424843544044,away,LAD,over,8,0.5348837209302326,-115,0.5097020142727117,MIL,LAD,2022 REG,4,1,6,2,3,10,0,1,-1,1,1,0,0,0,0,0,0,0,0,0.5097020142727117,0.49029798572728833
86919,0.4132231404958678,0.626865671641791,142,-168,0.39665751564559554,0.6033424843544044,home,MIL,under,8,0.5121951219512195,-105,0.49029798572728833,MIL,LAD,2022 REG,4,1,6,2,3,10,0,1,-1,1,1,0,0,0,0,0,0,0,0,0.5097020142727117,0.49029798572728833
86920,0.6254681647940076,0.4081632653061224,-167,145,0.6044327759298813,0.3955672240701187,away,OAK,over,9,0.5,100,0.4772727272727273,TEX,OAK,2022 REG,6,2,9,7,9,15,0,1,-5,5,1,1,0,0,0,0,0,0,0,0.4772727272727273,0.5227272727272727
86920,0.6254681647940076,0.4081632653061224,-167,145,0.6044327759298813,0.3955672240701187,home,TEX,under,9,0.5454545454545454,-120,0.5227272727272727,TEX,OAK,2022 REG,6,2,9,7,9,15,0,1,-5,5,1,1,0,0,0,0,0,0,0,0.4772727272727273,0.5227272727272727
86921,0.5,0.5412844036697247,100,-118,0.47935779816513757,0.5206422018348624,away,ATL,over,8.5,0.5073891625615764,-103,0.4826927225525911,ARI,ATL,2022 REG,7,6,8,2,8,15,1,0,4,-4,1,1,0,0,0,0,0,0,0,0.4826927225525911,0.5173072774474089
86921,0.5,0.5412844036697247,100,-118,0.47935779816513757,0.5206422018348624,home,ARI,under,8.5,0.5412844036697247,-118,0.5173072774474089,ARI,ATL,2022 REG,7,6,8,2,8,15,1,0,4,-4,1,1,0,0,0,0,0,0,0,0.4826927225525911,0.5173072774474089
86922,0.6666666666666666,0.36764705882352944,-200,172,0.6437908496732027,0.35620915032679734,away,WSH,over,8.5,0.5412844036697247,-118,0.5189377998484975,PHI,WSH,2022 REG,13,5,10,3,8,23,1,0,2,-2,1,1,1,0,0,0,0,0,0,0.5189377998484975,0.4810622001515025
86922,0.6666666666666666,0.36764705882352944,-200,172,0.6437908496732027,0.35620915032679734,home,PHI,under,8.5,0.5,100,0.4810622001515025,PHI,WSH,2022 REG,13,5,10,3,8,23,1,0,2,-2,1,1,1,0,0,0,0,0,0,0.5189377998484975,0.4810622001515025
86923,0.4854368932038835,0.5495495495495495,106,-122,0.4684531831294015,0.5315468168705986,away,LAA,over,8.5,0.5169082125603864,-107,0.49353874091423283,CWS,LAA,2022 REG,12,5,8,6,11,20,0,1,-1,1,1,1,1,1,1,0,0,0,0,0.49353874091423283,0.5064612590857671
86923,0.4854368932038835,0.5495495495495495,106,-122,0.4684531831294015,0.5315468168705986,home,CWS,under,8.5,0.5283018867924528,-112,0.5064612590857671,CWS,LAA,2022 REG,12,5,8,6,11,20,0,1,-1,1,1,1,1,1,1,0,0,0,0,0.49353874091423283,0.5064612590857671
86924,0.48780487804878053,0.5495495495495495,105,-122,0.4695832060495952,0.5304167939504048,away,TB,over,7,0.5121951219512195,-105,0.48919479393107135,OAK,TB,2022 REG,4,0,6,3,3,10,0,1,-3,3,0,0,0,0,0,0,0,0,0,0.48919479393107135,0.5108052060689287
86924,0.48780487804878053,0.5495495495495495,105,-122,0.4695832060495952,0.5304167939504048,home,OAK,under,7,0.5327102803738317,-114,0.5108052060689287,OAK,TB,2022 REG,4,0,6,3,3,10,0,1,-3,3,0,0,0,0,0,0,0,0,0,0.48919479393107135,0.5108052060689287
86925,0.47619047619047616,0.5633187772925764,110,-129,0.45737654596045113,0.5426234540395489,away,HOU,over,7,0.5,100,0.47522522522522526,TB,HOU,2022 REG,7,2,10,5,7,17,0,1,-3,3,1,1,0,0,0,0,0,0,0,0.47522522522522526,0.5247747747747747
86925,0.47619047619047616,0.5633187772925764,110,-129,0.45737654596045113,0.5426234540395489,home,TB,under,7,0.5495495495495495,-122,0.5247747747747747,TB,HOU,2022 REG,7,2,10,5,7,17,0,1,-3,3,1,1,0,0,0,0,0,0,0,0.47522522522522526,0.5247747747747747
86926,0.6363636363636364,0.4,-175,150,0.6132231404958678,0.3867768595041322,away,BAL,over,8,0.5,100,0.4772727272727273,NYY,BAL,2022 REG,4,1,5,2,3,9,0,1,-1,1,1,0,0,0,0,0,0,0,0,0.4772727272727273,0.5227272727272727
86926,0.6363636363636364,0.4,-175,150,0.6132231404958678,0.3867768595041322,home,NYY,under,8,0.5454545454545454,-120,0.5227272727272727,NYY,BAL,2022 REG,4,1,5,2,3,9,0,1,-1,1,1,0,0,0,0,0,0,0,0,0.4772727272727273,0.5227272727272727
86927,0.46511627906976744,0.5726495726495727,115,-134,0.4475507666421673,0.5524492333578327,away,SEA,over,9,0.5121951219512195,-105,0.48919479393107135,BAL,SEA,2022 REG,5,0,13,10,10,18,0,1,-10,10,0,0,0,0,0,0,0,0,0,0.48919479393107135,0.5108052060689287
86927,0.46511627906976744,0.5726495726495727,115,-134,0.4475507666421673,0.5524492333578327,home,BAL,under,9,0.5327102803738317,-114,0.5108052060689287,BAL,SEA,2022 REG,5,0,13,10,10,18,0,1,-10,10,0,0,0,0,0,0,0,0,0,0.48919479393107135,0.5108052060689287
86928,0.5073891625615764,0.5348837209302326,-103,-115,0.4859403596076043,0.5140596403923957,away,TB,over,9,0.5283018867924528,-112,0.5044173060022736,CHC,TB,2022 REG,4,2,9,8,10,13,0,1,-6,6,1,1,0,0,0,0,0,0,0,0.5044173060022736,0.49558269399772636
86928,0.5073891625615764,0.5348837209302326,-103,-115,0.4859403596076043,0.5140596403923957,home,CHC,under,9,0.5169082125603864,-107,0.49558269399772636,CHC,TB,2022 REG,4,2,9,8,10,13,0,1,-6,6,1,1,0,0,0,0,0,0,0,0.5044173060022736,0.49558269399772636
86929,0.6721311475409836,0.36363636363636365,-205,175,0.6480906892086682,0.3519093107913318,away,DET,over,8.5,0.5121951219512195,-105,0.48808156828023186,CLE,DET,2022 REG,8,5,15,7,12,23,0,1,-2,2,1,1,1,1,1,0,0,0,0,0.48808156828023186,0.5119184317197681
86929,0.6721311475409836,0.36363636363636365,-205,175,0.6480906892086682,0.3519093107913318,home,CLE,under,8.5,0.5348837209302326,-115,0.5119184317197681,CLE,DET,2022 REG,8,5,15,7,12,23,0,1,-2,2,1,1,1,1,1,0,0,0,0,0.48808156828023186,0.5119184317197681
86930,0.6923076923076923,0.3448275862068966,-225,190,0.6665986533360538,0.33340134666394616,away,PHI,over,8,0.5412844036697247,-118,0.5189377998484975,LAD,PHI,2022 REG,12,10,15,12,22,27,0,1,-2,2,1,1,1,1,1,1,1,1,1,0.5189377998484975,0.4810622001515025
86930,0.6923076923076923,0.3448275862068966,-225,190,0.6665986533360538,0.33340134666394616,home,LAD,under,8,0.5,100,0.4810622001515025,LAD,PHI,2022 REG,12,10,15,12,22,27,0,1,-2,2,1,1,1,1,1,1,1,1,1,0.5189377998484975,0.4810622001515025
86931,0.6183206106870228,0.4166666666666667,-162,140,0.5966872559874133,0.40331274401258665,away,PIT,over,8.5,0.5454545454545454,-120,0.5206611570247933,CHC,PIT,2022 REG,13,9,3,0,9,16,1,0,9,-9,0,0,0,0,0,0,0,0,0,0.5206611570247933,0.4793388429752067
86931,0.6183206106870228,0.4166666666666667,-162,140,0.5966872559874133,0.40331274401258665,home,CHC,under,8.5,0.5,100,0.4793388429752067,CHC,PIT,2022 REG,13,9,3,0,9,16,1,0,9,-9,0,0,0,0,0,0,0,0,0,0.5206611570247933,0.4793388429752067
86932,0.7058823529411764,0.3278688524590164,-240,205,0.6820579726586873,0.3179420273413127,away,PHI,over,7,0.5073891625615764,-103,0.4826927225525911,NYM,PHI,2022 REG,5,1,10,2,3,15,0,1,-1,1,1,0,0,0,0,0,0,0,0,0.4826927225525911,0.5173072774474089
86932,0.7058823529411764,0.3278688524590164,-240,205,0.6820579726586873,0.3179420273413127,home,NYM,under,7,0.5412844036697247,-118,0.5173072774474089,NYM,PHI,2022 REG,5,1,10,2,3,15,0,1,-1,1,1,0,0,0,0,0,0,0,0,0.4826927225525911,0.5173072774474089
86933,0.6923076923076923,0.35714285714285715,-225,180,0.658072696534235,0.34192730346576505,away,CIN,over,7.5,0.5,100,0.4772727272727273,SD,CIN,2022 REG,8,6,5,2,8,13,1,0,4,-4,1,1,0,0,0,0,0,0,0,0.4772727272727273,0.5227272727272727
86933,0.6923076923076923,0.35714285714285715,-225,180,0.658072696534235,0.34192730346576505,home,SD,under,7.5,0.5454545454545454,-120,0.5227272727272727,SD,CIN,2022 REG,8,6,5,2,8,13,1,0,4,-4,1,1,0,0,0,0,0,0,0,0.4772727272727273,0.5227272727272727
86935,0.5652173913043479,0.4807692307692307,-130,108,0.5392249527410209,0.4607750472589791,away,MIL,over,8.5,0.5121951219512195,-105,0.48808156828023186,MIN,MIL,2022 REG,10,4,4,1,5,14,1,0,3,-3,1,0,0,0,0,0,0,0,0,0.48808156828023186,0.5119184317197681
86935,0.5652173913043479,0.4807692307692307,-130,108,0.5392249527410209,0.4607750472589791,home,MIN,under,8.5,0.5348837209302326,-115,0.5119184317197681,MIN,MIL,2022 REG,10,4,4,1,5,14,1,0,3,-3,1,0,0,0,0,0,0,0,0,0.48808156828023186,0.5119184317197681
86936,0.6428571428571428,0.3921568627450981,-180,155,0.6203481392557023,0.3796518607442977,away,CWS,over,8,0.5454545454545454,-120,0.5206611570247933,TOR,CWS,2022 REG,12,8,7,3,11,19,1,0,5,-5,1,1,1,0,0,0,0,0,0,0.5206611570247933,0.4793388429752067
86936,0.6428571428571428,0.3921568627450981,-180,155,0.6203481392557023,0.3796518607442977,home,TOR,under,8,0.5,100,0.4793388429752067,TOR,CWS,2022 REG,12,8,7,3,11,19,1,0,5,-5,1,1,1,0,0,0,0,0,0,0.5206611570247933,0.4793388429752067
86937,0.7297297297297298,0.3125,-270,220,0.6989134404674946,0.3010865595325054,away,CIN,over,8.5,0.5348837209302326,-115,0.5097020142727117,LAD,CIN,2022 REG,14,9,6,3,12,20,1,0,6,-6,1,1,1,0,0,0,0,0,0,0.5097020142727117,0.49029798572728833
86937,0.7297297297297298,0.3125,-270,220,0.6989134404674946,0.3010865595325054,home,LAD,under,8.5,0.5121951219512195,-105,0.49029798572728833,LAD,CIN,2022 REG,14,9,6,3,12,20,1,0,6,-6,1,1,1,0,0,0,0,0,0,0.5097020142727117,0.49029798572728833
86938,0.6254681647940076,0.4166666666666667,-167,140,0.5991141690863948,0.4008858309136052,away,STL,over,7,0.49751243781094534,101,0.476135829221149,TB,STL,2022 REG,3,2,2,1,3,5,1,0,1,-1,1,0,0,0,0,0,0,0,0,0.476135829221149,0.523864170778851
86938,0.6254681647940076,0.4166666666666667,-167,140,0.5991141690863948,0.4008858309136052,home,TB,under,7,0.5454545454545454,-120,0.523864170778851,TB,STL,2022 REG,3,2,2,1,3,5,1,0,1,-1,1,0,0,0,0,0,0,0,0,0.476135829221149,0.523864170778851
86939,0.7222222222222222,0.31746031746031744,-260,215,0.693562610229277,0.306437389770723,away,TEX,over,7.5,0.5305164319248826,-113,0.5066009958897986,HOU,TEX,2022 REG,8,3,8,4,7,16,0,1,-1,1,1,1,1,0,0,0,0,0,0,0.5066009958897986,0.49339900411020143
86939,0.7222222222222222,0.31746031746031744,-260,215,0.693562610229277,0.306437389770723,home,HOU,under,7.5,0.5145631067961165,-106,0.49339900411020143,HOU,TEX,2022 REG,8,3,8,4,7,16,0,1,-1,1,1,1,1,0,0,0,0,0,0,0.5066009958897986,0.49339900411020143
86940,0.4587155963302753,0.6000000000000001,118,-150,0.43178183654574526,0.5682181634542547,away,LAA,over,8,0.5121951219512195,-105,0.4925977822950117,OAK,LAA,2022 REG,2,0,6,2,2,8,0,1,-2,2,0,0,0,0,0,0,0,0,0,0.4925977822950117,0.5074022177049883
86940,0.4587155963302753,0.6000000000000001,118,-150,0.43178183654574526,0.5682181634542547,home,OAK,under,8,0.5260663507109005,-111,0.5074022177049883,OAK,LAA,2022 REG,2,0,6,2,2,8,0,1,-2,2,0,0,0,0,0,0,0,0,0,0.4925977822950117,0.5074022177049883
86941,0.5884773662551441,0.45454545454545453,-143,120,0.5631594099815408,0.4368405900184592,away,CHC,over,7,0.5,100,0.4772727272727273,MIA,CHC,2022 REG,14,10,6,3,13,20,1,0,7,-7,1,1,1,0,0,0,0,0,0,0.4772727272727273,0.5227272727272727
86941,0.5884773662551441,0.45454545454545453,-143,120,0.5631594099815408,0.4368405900184592,home,MIA,under,7,0.5454545454545454,-120,0.5227272727272727,MIA,CHC,2022 REG,14,10,6,3,13,20,1,0,7,-7,1,1,1,0,0,0,0,0,0,0.4772727272727273,0.5227272727272727
86942,0.7701149425287357,0.27027027027027023,-335,270,0.7390136866950185,0.26098631330498145,away,KC,over,9,0.5238095238095238,-110,0.5000596729920038,TOR,KC,2022 REG,7,4,7,2,6,14,1,0,2,-2,1,1,0,0,0,0,0,0,0,0.5000596729920038,0.4999403270079962
86942,0.7701149425287357,0.27027027027027023,-335,270,0.7390136866950185,0.26098631330498145,home,TOR,under,9,0.5215311004784688,-109,0.4999403270079962,TOR,KC,2022 REG,7,4,7,2,6,14,1,0,2,-2,1,1,0,0,0,0,0,0,0,0.5000596729920038,0.4999403270079962
86943,0.35714285714285715,0.6825396825396826,180,-215,0.34297052154195007,0.6570294784580499,away,TOR,over,8.5,0.5145631067961165,-106,0.49023796582517226,TEX,TOR,2022 REG,13,7,15,11,18,28,0,1,-4,4,1,1,1,1,1,1,1,0,0,0.49023796582517226,0.5097620341748277
86943,0.35714285714285715,0.6825396825396826,180,-215,0.34297052154195007,0.6570294784580499,home,TEX,under,8.5,0.5327102803738317,-114,0.5097620341748277,TEX,TOR,2022 REG,13,7,15,11,18,28,0,1,-4,4,1,1,1,1,1,1,1,0,0,0.49023796582517226,0.5097620341748277
86944,0.43103448275862066,0.607843137254902,132,-155,0.4142768879252058,0.5857231120747942,away,LAD,over,9,0.5,100,0.4772727272727273,SF,LAD,2022 REG,10,7,6,2,9,16,1,0,5,-5,1,1,0,0,0,0,0,0,0,0.4772727272727273,0.5227272727272727
86944,0.43103448275862066,0.607843137254902,132,-155,0.4142768879252058,0.5857231120747942,home,SF,under,9,0.5454545454545454,-120,0.5227272727272727,SF,LAD,2022 REG,10,7,6,2,9,16,1,0,5,-5,1,1,0,0,0,0,0,0,0,0.4772727272727273,0.5227272727272727
86945,0.6610169491525424,0.3846153846153846,-195,160,0.6308532031025568,0.36914679689744323,away,ARI,over,7.5,0.5327102803738317,-114,0.508788710910954,STL,ARI,2022 REG,9,7,7,5,12,16,1,0,2,-2,1,1,1,1,1,0,0,0,0,0.508788710910954,0.491211289089046
86945,0.6610169491525424,0.3846153846153846,-195,160,0.6308532031025568,0.36914679689744323,home,STL,under,7.5,0.5121951219512195,-105,0.491211289089046,STL,ARI,2022 REG,9,7,7,5,12,16,1,0,2,-2,1,1,1,1,1,0,0,0,0,0.508788710910954,0.491211289089046
86946,0.5098039215686274,0.5283018867924528,-104,-112,0.4903774310316062,0.5096225689683938,away,TB,over,8,0.5348837209302326,-115,0.5097020142727117,LAA,TB,2022 REG,18,12,0,0,12,18,1,0,12,-12,0,0,0,0,0,0,0,0,0,0.5097020142727117,0.49029798572728833
86946,0.5098039215686274,0.5283018867924528,-104,-112,0.4903774310316062,0.5096225689683938,home,LAA,under,8,0.5121951219512195,-105,0.49029798572728833,LAA,TB,2022 REG,18,12,0,0,12,18,1,0,12,-12,0,0,0,0,0,0,0,0,0,0.5097020142727117,0.49029798572728833
86947,0.6031746031746031,0.4347826086956522,-152,130,0.5802797769671475,0.4197202230328525,away,MIL,over,8,0.5348837209302326,-115,0.5097020142727117,PHI,MIL,2022 REG,5,0,3,1,1,8,0,1,-1,1,0,0,0,0,0,0,0,0,0,0.5097020142727117,0.49029798572728833
86947,0.6031746031746031,0.4347826086956522,-152,130,0.5802797769671475,0.4197202230328525,home,PHI,under,8,0.5121951219512195,-105,0.49029798572728833,PHI,MIL,2022 REG,5,0,3,1,1,8,0,1,-1,1,0,0,0,0,0,0,0,0,0,0.5097020142727117,0.49029798572728833
86948,0.726027397260274,0.3125,-265,220,0.6980554513041847,0.30194454869581533,away,OAK,over,8.5,0.5391705069124424,-117,0.5140669063204599,TOR,OAK,2022 REG,7,4,6,3,7,13,1,0,1,-1,1,1,1,0,0,0,0,0,0,0.5140669063204599,0.4859330936795401
86948,0.726027397260274,0.3125,-265,220,0.6980554513041847,0.30194454869581533,home,TOR,under,8.5,0.5073891625615764,-103,0.4859330936795401,TOR,OAK,2022 REG,7,4,6,3,7,13,1,0,1,-1,1,1,1,0,0,0,0,0,0,0.5140669063204599,0.4859330936795401
86949,0.5967741935483871,0.4444444444444444,-148,125,0.5721759741010521,0.42782402589894786,away,KC,over,7.5,0.49504950495049505,102,0.4739797934813417,DET,KC,2022 REG,9,4,11,7,11,20,0,1,-3,3,1,1,1,1,0,0,0,0,0,0.4739797934813417,0.5260202065186583
86949,0.5967741935483871,0.4444444444444444,-148,125,0.5721759741010521,0.42782402589894786,home,DET,under,7.5,0.5475113122171946,-121,0.5260202065186583,DET,KC,2022 REG,9,4,11,7,11,20,0,1,-3,3,1,1,1,1,0,0,0,0,0,0.4739797934813417,0.5260202065186583
86950,0.4166666666666667,0.6226415094339623,140,-165,0.4002882599580712,0.5997117400419287,away,CLE,over,7.5,0.5,100,0.4772727272727273,DET,CLE,2022 REG,9,8,8,2,10,17,1,0,6,-6,1,1,0,0,0,0,0,0,0,0.4772727272727273,0.5227272727272727
86950,0.4166666666666667,0.6226415094339623,140,-165,0.4002882599580712,0.5997117400419287,home,DET,under,7.5,0.5454545454545454,-120,0.5227272727272727,DET,CLE,2022 REG,9,8,8,2,10,17,1,0,6,-6,1,1,0,0,0,0,0,0,0,0.4772727272727273,0.5227272727272727
86951,0.5,0.5495495495495495,100,-122,0.47522522522522526,0.5247747747747747,away,ATL,over,7,0.5121951219512195,-105,0.48808156828023186,SEA,ATL,2022 REG,6,3,3,1,4,9,1,0,2,-2,1,0,0,0,0,0,0,0,0,0.48808156828023186,0.5119184317197681
86951,0.5,0.5495495495495495,100,-122,0.47522522522522526,0.5247747747747747,home,SEA,under,7,0.5348837209302326,-115,0.5119184317197681,SEA,ATL,2022 REG,6,3,3,1,4,9,1,0,2,-2,1,0,0,0,0,0,0,0,0,0.48808156828023186,0.5119184317197681
86952,0.6428571428571428,0.3921568627450981,-180,155,0.6203481392557023,0.3796518607442977,away,CLE,over,8,0.5215311004784688,-109,0.4978845547971712,HOU,CLE,2022 REG,7,2,4,1,3,11,1,0,1,-1,1,0,0,0,0,0,0,0,0,0.4978845547971712,0.5021154452028288
86952,0.6428571428571428,0.3921568627450981,-180,155,0.6203481392557023,0.3796518607442977,home,HOU,under,8,0.5238095238095238,-110,0.5021154452028288,HOU,CLE,2022 REG,7,2,4,1,3,11,1,0,1,-1,1,0,0,0,0,0,0,0,0,0.4978845547971712,0.5021154452028288
86953,0.46511627906976744,0.574468085106383,115,-135,0.44670494689481377,0.5532950531051862,away,STL,over,9,0.504950495049505,-102,0.4826715732667395,CHC,STL,2022 REG,7,3,16,13,16,23,0,1,-10,10,1,1,1,0,0,0,0,0,0,0.4826715732667395,0.5173284267332605
86953,0.46511627906976744,0.574468085106383,115,-135,0.44670494689481377,0.5532950531051862,home,CHC,under,9,0.5391705069124424,-117,0.5173284267332605,CHC,STL,2022 REG,7,3,16,13,16,23,0,1,-10,10,1,1,1,0,0,0,0,0,0,0.4826715732667395,0.5173284267332605
86954,0.4587155963302753,0.5798319327731092,118,-138,0.4410332435305576,0.5589667564694424,away,TOR,over,9.5,0.5238095238095238,-110,0.4988662131519274,BOS,TOR,2022 REG,9,3,13,9,12,22,0,1,-6,6,1,1,1,0,0,0,0,0,0,0.4988662131519274,0.5011337868480725
86954,0.4587155963302753,0.5798319327731092,118,-138,0.4410332435305576,0.5589667564694424,home,BOS,under,9.5,0.5238095238095238,-110,0.5011337868480725,BOS,TOR,2022 REG,9,3,13,9,12,22,0,1,-6,6,1,1,1,0,0,0,0,0,0,0.4988662131519274,0.5011337868480725
86955,0.5689655172413793,0.4672897196261683,-132,114,0.5483375376443265,0.45166246235567353,away,TEX,over,9,0.49504950495049505,102,0.4739797934813417,NYM,TEX,2022 REG,9,3,10,7,10,19,0,1,-4,4,1,1,1,0,0,0,0,0,0,0.4739797934813417,0.5260202065186583
86955,0.5689655172413793,0.4672897196261683,-132,114,0.5483375376443265,0.45166246235567353,home,NYM,under,9,0.5475113122171946,-121,0.5260202065186583,NYM,TEX,2022 REG,9,3,10,7,10,19,0,1,-4,4,1,1,1,0,0,0,0,0,0,0.4739797934813417,0.5260202065186583
86956,0.4347826086956522,0.6062992125984252,130,-154,0.4169209472634447,0.5830790527365552,away,TOR,over,9.5,0.5283018867924528,-112,0.5031902949311281,BOS,TOR,2022 REG,9,2,10,3,5,19,0,1,-1,1,1,1,0,0,0,0,0,0,0,0.5031902949311281,0.4968097050688719
86956,0.4347826086956522,0.6062992125984252,130,-154,0.4169209472634447,0.5830790527365552,home,BOS,under,9.5,0.5192307692307692,-108,0.4968097050688719,BOS,TOR,2022 REG,9,2,10,3,5,19,0,1,-1,1,1,1,0,0,0,0,0,0,0,0.5031902949311281,0.4968097050688719
86957,0.5348837209302326,0.5,-115,100,0.5162249864791779,0.4837750135208221,away,TB,over,8.5,0.5098039215686274,-104,0.48592421718142587,BAL,TB,2022 REG,9,4,11,6,10,20,0,1,-2,2,1,1,1,1,0,0,0,0,0,0.48592421718142587,0.5140757828185741
86957,0.5348837209302326,0.5,-115,100,0.5162249864791779,0.4837750135208221,home,BAL,under,8.5,0.5370370370370371,-116,0.5140757828185741,BAL,TB,2022 REG,9,4,11,6,10,20,0,1,-2,2,1,1,1,1,0,0,0,0,0,0.48592421718142587,0.5140757828185741
86958,0.39370078740157477,0.6428571428571428,154,-180,0.3793079014729458,0.6206920985270542,away,SEA,over,7.5,0.5121951219512195,-105,0.48808156828023186,KC,SEA,2022 REG,14,13,12,12,25,26,1,0,1,-1,1,1,1,1,1,1,1,1,1,0.48808156828023186,0.5119184317197681
86958,0.39370078740157477,0.6428571428571428,154,-180,0.3793079014729458,0.6206920985270542,home,KC,under,7.5,0.5348837209302326,-115,0.5119184317197681,KC,SEA,2022 REG,14,13,12,12,25,26,1,0,1,-1,1,1,1,1,1,1,1,1,1,0.48808156828023186,0.5119184317197681
86959,0.5098039215686274,0.5348837209302326,-104,-115,0.4870219861770517,0.5129780138229483,away,NYY,over,9.5,0.5073891625615764,-103,0.4837652908580103,BOS,NYY,2022 REG,8,3,9,2,5,17,1,0,1,-1,1,1,0,0,0,0,0,0,0,0.4837652908580103,0.5162347091419897
86959,0.5098039215686274,0.5348837209302326,-104,-115,0.4870219861770517,0.5129780138229483,home,BOS,under,9.5,0.5391705069124424,-117,0.5162347091419897,BOS,NYY,2022 REG,8,3,9,2,5,17,1,0,1,-1,1,1,0,0,0,0,0,0,0,0.4837652908580103,0.5162347091419897
86960,0.6363636363636364,0.40322580645161293,-175,148,0.6111703545721141,0.3888296454278859,away,PHI,over,6.5,0.5348837209302326,-115,0.5097020142727117,MIA,PHI,2022 REG,4,1,5,2,3,9,0,1,-1,1,1,0,0,0,0,0,0,0,0,0.5097020142727117,0.49029798572728833
86960,0.6363636363636364,0.40322580645161293,-175,148,0.6111703545721141,0.3888296454278859,home,MIA,under,6.5,0.5121951219512195,-105,0.49029798572728833,MIA,PHI,2022 REG,4,1,5,2,3,9,0,1,-1,1,1,0,0,0,0,0,0,0,0,0.5097020142727117,0.49029798572728833
86961,0.5121951219512195,0.5348837209302326,-105,-115,0.48808156828023186,0.5119184317197681,away,TOR,over,9,0.5145631067961165,-106,0.49023796582517226,MIN,TOR,2022 REG,11,7,7,3,10,18,1,0,4,-4,1,1,1,0,0,0,0,0,0,0.49023796582517226,0.5097620341748277
86961,0.5121951219512195,0.5348837209302326,-105,-115,0.48808156828023186,0.5119184317197681,home,MIN,under,9,0.5327102803738317,-114,0.5097620341748277,MIN,TOR,2022 REG,11,7,7,3,10,18,1,0,4,-4,1,1,1,0,0,0,0,0,0,0.49023796582517226,0.5097620341748277
86962,0.4484304932735426,0.5884773662551441,123,-143,0.43187988361942303,0.5681201163805769,away,SF,over,7.5,0.5238095238095238,-110,0.5000596729920038,MIA,SF,2022 REG,8,6,14,15,21,22,0,1,-9,9,1,1,1,1,1,1,0,0,0,0.5000596729920038,0.4999403270079962
86962,0.4484304932735426,0.5884773662551441,123,-143,0.43187988361942303,0.5681201163805769,home,MIA,under,7.5,0.5215311004784688,-109,0.4999403270079962,MIA,SF,2022 REG,8,6,14,15,21,22,0,1,-9,9,1,1,1,1,1,1,0,0,0,0.5000596729920038,0.4999403270079962
86963,0.35714285714285715,0.6875,180,-220,0.3411989795918367,0.6588010204081634,away,NYY,over,8.5,0.5145631067961165,-106,0.49023796582517226,BAL,NYY,2022 REG,3,2,11,6,8,14,0,1,-4,4,1,1,0,0,0,0,0,0,0,0.49023796582517226,0.5097620341748277
86963,0.35714285714285715,0.6875,180,-220,0.3411989795918367,0.6588010204081634,home,BAL,under,8.5,0.5327102803738317,-114,0.5097620341748277,BAL,NYY,2022 REG,3,2,11,6,8,14,0,1,-4,4,1,1,0,0,0,0,0,0,0,0.49023796582517226,0.5097620341748277
86964,0.5555555555555556,0.4807692307692307,-125,108,0.5353751187084521,0.4646248812915479,away,ARI,over,12,0.5283018867924528,-112,0.5044173060022736,COL,ARI,2022 REG,8,4,11,7,11,19,0,1,-3,3,1,1,1,1,0,0,0,0,0,0.5044173060022736,0.49558269399772636
86964,0.5555555555555556,0.4807692307692307,-125,108,0.5353751187084521,0.4646248812915479,home,COL,under,12,0.5169082125603864,-107,0.49558269399772636,COL,ARI,2022 REG,8,4,11,7,11,19,0,1,-3,3,1,1,1,1,0,0,0,0,0,0.5044173060022736,0.49558269399772636
86965,0.6551724137931035,0.3802281368821293,-190,163,0.6319789495576061,0.36802105044239386,away,OAK,over,8,0.5238095238095238,-110,0.4988662131519274,TEX,OAK,2022 REG,10,10,5,3,13,15,1,0,7,-7,1,1,1,0,0,0,0,0,0,0.4988662131519274,0.5011337868480725
86965,0.6551724137931035,0.3802281368821293,-190,163,0.6319789495576061,0.36802105044239386,home,TEX,under,8,0.5238095238095238,-110,0.5011337868480725,TEX,OAK,2022 REG,10,10,5,3,13,15,1,0,7,-7,1,1,1,0,0,0,0,0,0,0.4988662131519274,0.5011337868480725
86966,0.7014925373134329,0.3389830508474576,-235,195,0.6730992142751963,0.32690078572480374,away,OAK,over,9,0.5215311004784688,-109,0.50027251771145,TOR,OAK,2022 REG,10,5,9,7,12,19,0,1,-2,2,1,1,1,1,1,0,0,0,0,0.50027251771145,0.49972748228855
86966,0.7014925373134329,0.3389830508474576,-235,195,0.6730992142751963,0.32690078572480374,home,TOR,under,9,0.5192307692307692,-108,0.49972748228855,TOR,OAK,2022 REG,10,5,9,7,12,19,0,1,-2,2,1,1,1,1,1,0,0,0,0,0.50027251771145,0.49972748228855
86967,0.6183206106870228,0.4166666666666667,-162,140,0.5966872559874133,0.40331274401258665,away,LAA,over,8,0.5348837209302326,-115,0.5097020142727117,HOU,LAA,2022 REG,12,9,3,1,10,15,1,0,8,-8,1,0,0,0,0,0,0,0,0,0.5097020142727117,0.49029798572728833
86967,0.6183206106870228,0.4166666666666667,-162,140,0.5966872559874133,0.40331274401258665,home,HOU,under,8,0.5121951219512195,-105,0.49029798572728833,HOU,LAA,2022 REG,12,9,3,1,10,15,1,0,8,-8,1,0,0,0,0,0,0,0,0,0.5097020142727117,0.49029798572728833
86968,0.6031746031746031,0.4347826086956522,-152,130,0.5802797769671475,0.4197202230328525,away,WSH,over,7.5,0.5,100,0.4772727272727273,NYM,WSH,2022 REG,11,9,8,2,11,19,1,0,7,-7,1,1,0,0,0,0,0,0,0,0.4772727272727273,0.5227272727272727
86968,0.6031746031746031,0.4347826086956522,-152,130,0.5802797769671475,0.4197202230328525,home,NYM,under,7.5,0.5454545454545454,-120,0.5227272727272727,NYM,WSH,2022 REG,11,9,8,2,11,19,1,0,7,-7,1,1,0,0,0,0,0,0,0,0.4772727272727273,0.5227272727272727
86969,0.5,0.5412844036697247,100,-118,0.47935779816513757,0.5206422018348624,away,STL,over,9,0.5192307692307692,-108,0.49688292476754015,WSH,STL,2022 REG,5,0,7,5,5,12,0,1,-5,5,0,0,0,0,0,0,0,0,0,0.49688292476754015,0.5031170752324599
86969,0.5,0.5412844036697247,100,-118,0.47935779816513757,0.5206422018348624,home,WSH,under,9,0.5238095238095238,-110,0.5031170752324599,WSH,STL,2022 REG,5,0,7,5,5,12,0,1,-5,5,0,0,0,0,0,0,0,0,0,0.49688292476754015,0.5031170752324599
86970,0.5652173913043479,0.4716981132075471,-130,112,0.5443521061454507,0.4556478938545493,away,SD,over,7.5,0.5073891625615764,-103,0.4826927225525911,MIL,SD,2022 REG,8,4,9,6,10,17,0,1,-2,2,1,1,1,1,0,0,0,0,0,0.4826927225525911,0.5173072774474089
86970,0.5652173913043479,0.4716981132075471,-130,112,0.5443521061454507,0.4556478938545493,home,MIL,under,7.5,0.5412844036697247,-118,0.5173072774474089,MIL,SD,2022 REG,8,4,9,6,10,17,0,1,-2,2,1,1,1,1,0,0,0,0,0,0.4826927225525911,0.5173072774474089
86971,0.4444444444444444,0.5918367346938775,125,-145,0.42831947593852354,0.5716805240614764,away,CWS,over,8,0.5169082125603864,-107,0.49239402434819424,DET,CWS,2022 REG,5,3,5,4,7,10,0,1,-1,1,1,1,1,0,0,0,0,0,0,0.49239402434819424,0.5076059756518058
86971,0.4444444444444444,0.5918367346938775,125,-145,0.42831947593852354,0.5716805240614764,home,DET,under,8,0.5305164319248826,-113,0.5076059756518058,DET,CWS,2022 REG,5,3,5,4,7,10,0,1,-1,1,1,1,1,0,0,0,0,0,0,0.49239402434819424,0.5076059756518058
86972,0.5,0.5348837209302326,100,-115,0.4825581395348837,0.5174418604651163,away,MIA,over,10.5,0.5305164319248826,-113,0.5066009958897986,COL,MIA,2022 REG,17,13,13,12,25,30,1,0,1,-1,1,1,1,1,1,1,1,1,1,0.5066009958897986,0.49339900411020143
86972,0.5,0.5348837209302326,100,-115,0.4825581395348837,0.5174418604651163,home,COL,under,10.5,0.5145631067961165,-106,0.49339900411020143,COL,MIA,2022 REG,17,13,13,12,25,30,1,0,1,-1,1,1,1,1,1,1,1,1,1,0.5066009958897986,0.49339900411020143
86973,0.6503496503496503,0.3846153846153846,-186,160,0.6276101520856765,0.3723898479143235,away,COL,over,8.5,0.5391705069124424,-117,0.5127649394825569,PHI,COL,2022 REG,9,8,5,2,10,14,1,0,6,-6,1,1,0,0,0,0,0,0,0,0.5127649394825569,0.48723506051744314
86973,0.6503496503496503,0.3846153846153846,-186,160,0.6276101520856765,0.3723898479143235,home,PHI,under,8.5,0.5098039215686274,-104,0.48723506051744314,PHI,COL,2022 REG,9,8,5,2,10,14,1,0,6,-6,1,1,0,0,0,0,0,0,0,0.5127649394825569,0.48723506051744314
86974,0.5652173913043479,0.4716981132075471,-130,112,0.5443521061454507,0.4556478938545493,away,MIA,over,9,0.5348837209302326,-115,0.5097020142727117,CIN,MIA,2022 REG,16,11,7,2,13,23,1,0,9,-9,1,1,0,0,0,0,0,0,0,0.5097020142727117,0.49029798572728833
86974,0.5652173913043479,0.4716981132075471,-130,112,0.5443521061454507,0.4556478938545493,home,CIN,under,9,0.5121951219512195,-105,0.49029798572728833,CIN,MIA,2022 REG,16,11,7,2,13,23,1,0,9,-9,1,1,0,0,0,0,0,0,0,0.5097020142727117,0.49029798572728833
86975,0.7142857142857143,0.31746031746031744,-250,215,0.6916099773242631,0.3083900226757369,away,CHC,over,9,0.5,100,0.4762443438914027,NYY,CHC,2022 REG,6,2,9,1,3,15,1,0,1,-1,1,0,0,0,0,0,0,0,0,0.4762443438914027,0.5237556561085973
86975,0.7142857142857143,0.31746031746031744,-250,215,0.6916099773242631,0.3083900226757369,home,NYY,under,9,0.5475113122171946,-121,0.5237556561085973,NYY,CHC,2022 REG,6,2,9,1,3,15,1,0,1,-1,1,0,0,0,0,0,0,0,0,0.4762443438914027,0.5237556561085973
86976,0.7333333333333333,0.3125,-275,220,0.6997222222222221,0.30027777777777787,away,OAK,over,9,0.5238095238095238,-110,0.5012646084074657,ATL,OAK,2022 REG,9,3,5,2,5,14,1,0,1,-1,1,1,0,0,0,0,0,0,0,0.5012646084074657,0.4987353915925343
86976,0.7333333333333333,0.3125,-275,220,0.6997222222222221,0.30027777777777787,home,ATL,under,9,0.5192307692307692,-108,0.4987353915925343,ATL,OAK,2022 REG,9,3,5,2,5,14,1,0,1,-1,1,1,0,0,0,0,0,0,0,0.5012646084074657,0.4987353915925343
86977,0.5121951219512195,0.5348837209302326,-105,-115,0.48808156828023186,0.5119184317197681,away,COL,over,8.5,0.5305164319248826,-113,0.5066009958897986,DET,COL,2022 REG,6,2,3,3,5,9,0,1,-1,1,1,1,0,0,0,0,0,0,0,0.5066009958897986,0.49339900411020143
86977,0.5121951219512195,0.5348837209302326,-105,-115,0.48808156828023186,0.5119184317197681,home,DET,under,8.5,0.5145631067961165,-106,0.49339900411020143,DET,COL,2022 REG,6,2,3,3,5,9,0,1,-1,1,1,1,0,0,0,0,0,0,0,0.5066009958897986,0.49339900411020143
86978,0.38167938931297707,0.6598639455782314,162,-194,0.36582315462167614,0.6341768453783239,away,STL,over,8.5,0.5238095238095238,-110,0.5012646084074657,CHC,STL,2022 REG,9,7,9,1,8,18,1,0,6,-6,1,0,0,0,0,0,0,0,0,0.5012646084074657,0.4987353915925343
86978,0.38167938931297707,0.6598639455782314,162,-194,0.36582315462167614,0.6341768453783239,home,CHC,under,8.5,0.5192307692307692,-108,0.4987353915925343,CHC,STL,2022 REG,9,7,9,1,8,18,1,0,6,-6,1,0,0,0,0,0,0,0,0,0.5012646084074657,0.4987353915925343
86979,0.696969696969697,0.3389830508474576,-230,195,0.6719117212183469,0.32808827878165314,away,COL,over,7.5,0.5121951219512195,-105,0.48808156828023186,SD,COL,2022 REG,19,13,12,5,18,31,1,0,8,-8,1,1,1,1,1,0,0,0,0,0.48808156828023186,0.5119184317197681
86979,0.696969696969697,0.3389830508474576,-230,195,0.6719117212183469,0.32808827878165314,home,SD,under,7.5,0.5348837209302326,-115,0.5119184317197681,SD,COL,2022 REG,19,13,12,5,18,31,1,0,8,-8,1,1,1,1,1,0,0,0,0,0.48808156828023186,0.5119184317197681
86980,0.45454545454545453,0.5867768595041323,120,-142,0.43576258452291505,0.564237415477085,away,NYM,over,7,0.5215311004784688,-109,0.4978845547971712,PHI,NYM,2022 REG,6,1,8,6,7,14,0,1,-5,5,1,0,0,0,0,0,0,0,0,0.4978845547971712,0.5021154452028288
86980,0.45454545454545453,0.5867768595041323,120,-142,0.43576258452291505,0.564237415477085,home,PHI,under,7,0.5238095238095238,-110,0.5021154452028288,PHI,NYM,2022 REG,6,1,8,6,7,14,0,1,-5,5,1,0,0,0,0,0,0,0,0,0.4978845547971712,0.5021154452028288
86981,0.6610169491525424,0.3802281368821293,-195,163,0.6337532482143695,0.3662467517856305,away,CLE,over,8,0.5145631067961165,-106,0.4913668392989033,NYY,CLE,2022 REG,9,5,4,4,9,13,1,0,1,-1,1,1,1,1,0,0,0,0,0,0.4913668392989033,0.5086331607010968
86981,0.6610169491525424,0.3802281368821293,-195,163,0.6337532482143695,0.3662467517856305,home,NYY,under,8,0.5305164319248826,-113,0.5086331607010968,NYY,CLE,2022 REG,9,5,4,4,9,13,1,0,1,-1,1,1,1,1,0,0,0,0,0,0.4913668392989033,0.5086331607010968
86982,0.6000000000000001,0.4347826086956522,-150,130,0.5791304347826086,0.4208695652173914,away,ARI,over,7.5,0.504950495049505,-102,0.48054649490447493,CHC,ARI,2022 REG,10,6,11,7,13,21,0,1,-1,1,1,1,1,1,1,1,0,0,0,0.48054649490447493,0.5194535050955251
86982,0.6000000000000001,0.4347826086956522,-150,130,0.5791304347826086,0.4208695652173914,home,CHC,under,7.5,0.5433789954337899,-119,0.5194535050955251,CHC,ARI,2022 REG,10,6,11,7,13,21,0,1,-1,1,1,1,1,1,1,1,0,0,0,0.48054649490447493,0.5194535050955251
86983,0.48780487804878053,0.5555555555555556,105,-125,0.4666534470222751,0.5333465529777248,away,TOR,over,8,0.5073891625615764,-103,0.4837652908580103,TB,TOR,2022 REG,6,3,4,2,5,10,1,0,1,-1,1,1,0,0,0,0,0,0,0,0.4837652908580103,0.5162347091419897
86983,0.48780487804878053,0.5555555555555556,105,-125,0.4666534470222751,0.5333465529777248,home,TB,under,8,0.5391705069124424,-117,0.5162347091419897,TB,TOR,2022 REG,6,3,4,2,5,10,1,0,1,-1,1,1,0,0,0,0,0,0,0,0.4837652908580103,0.5162347091419897
86984,0.45454545454545453,0.5850622406639003,120,-141,0.4365419567230205,0.5634580432769796,away,MIL,over,9,0.5,100,0.4772727272727273,PIT,MIL,2022 REG,11,8,12,7,15,23,1,0,1,-1,1,1,1,1,1,1,1,0,0,0.4772727272727273,0.5227272727272727
86984,0.45454545454545453,0.5850622406639003,120,-141,0.4365419567230205,0.5634580432769796,home,PIT,under,9,0.5454545454545454,-120,0.5227272727272727,PIT,MIL,2022 REG,11,8,12,7,15,23,1,0,1,-1,1,1,1,1,1,1,1,0,0,0.4772727272727273,0.5227272727272727
86985,0.6491228070175439,0.4,-185,150,0.6172360726377346,0.3827639273622654,away,CHC,over,8.5,0.5327102803738317,-114,0.508788710910954,ATL,CHC,2022 REG,11,5,3,1,6,14,1,0,4,-4,1,0,0,0,0,0,0,0,0,0.508788710910954,0.491211289089046
86985,0.6491228070175439,0.4,-185,150,0.6172360726377346,0.3827639273622654,home,ATL,under,8.5,0.5121951219512195,-105,0.491211289089046,ATL,CHC,2022 REG,11,5,3,1,6,14,1,0,4,-4,1,0,0,0,0,0,0,0,0,0.508788710910954,0.491211289089046
86986,0.6551724137931035,0.3846153846153846,-190,160,0.6291045458703008,0.37089545412969915,away,CIN,over,6.5,0.5348837209302326,-115,0.5097020142727117,CHC,CIN,2022 REG,12,8,7,1,9,19,1,0,7,-7,1,0,0,0,0,0,0,0,0,0.5097020142727117,0.49029798572728833
86986,0.6551724137931035,0.3846153846153846,-190,160,0.6291045458703008,0.37089545412969915,home,CHC,under,6.5,0.5121951219512195,-105,0.49029798572728833,CHC,CIN,2022 REG,12,8,7,1,9,19,1,0,7,-7,1,0,0,0,0,0,0,0,0,0.5097020142727117,0.49029798572728833
86987,0.4484304932735426,0.5884773662551441,123,-143,0.43187988361942303,0.5681201163805769,away,ATL,over,9,0.5098039215686274,-104,0.48375889301574193,PHI,ATL,2022 REG,10,7,5,2,9,15,1,0,5,-5,1,1,0,0,0,0,0,0,0,0.48375889301574193,0.5162411069842581
86987,0.4484304932735426,0.5884773662551441,123,-143,0.43187988361942303,0.5681201163805769,home,PHI,under,9,0.5412844036697247,-118,0.5162411069842581,PHI,ATL,2022 REG,10,7,5,2,9,15,1,0,5,-5,1,1,0,0,0,0,0,0,0,0.48375889301574193,0.5162411069842581
86988,0.7530864197530864,0.28169014084507044,-305,255,0.7268966642408942,0.27310333575910584,away,WSH,over,8.5,0.5238095238095238,-110,0.5012646084074657,NYM,WSH,2022 REG,6,1,11,7,8,17,0,1,-6,6,1,0,0,0,0,0,0,0,0,0.5012646084074657,0.4987353915925343
86988,0.7530864197530864,0.28169014084507044,-305,255,0.7268966642408942,0.27310333575910584,home,NYM,under,8.5,0.5192307692307692,-108,0.4987353915925343,NYM,WSH,2022 REG,6,1,11,7,8,17,0,1,-6,6,1,0,0,0,0,0,0,0,0,0.5012646084074657,0.4987353915925343
86989,0.4464285714285714,0.5934959349593496,124,-146,0.42860513107682097,0.571394868923179,away,NYY,over,7,0.5327102803738317,-114,0.508788710910954,TB,NYY,2022 REG,7,3,4,1,4,11,1,0,2,-2,1,0,0,0,0,0,0,0,0,0.508788710910954,0.491211289089046
86989,0.4464285714285714,0.5934959349593496,124,-146,0.42860513107682097,0.571394868923179,home,TB,under,7,0.5121951219512195,-105,0.491211289089046,TB,NYY,2022 REG,7,3,4,1,4,11,1,0,2,-2,1,0,0,0,0,0,0,0,0,0.508788710910954,0.491211289089046
86990,0.609375,0.43103448275862066,-156,132,0.5847504714439656,0.41524952855603436,away,STL,over,8,0.5238095238095238,-110,0.4988662131519274,MIL,STL,2022 REG,9,5,5,1,6,14,1,0,4,-4,1,0,0,0,0,0,0,0,0,0.4988662131519274,0.5011337868480725
86990,0.609375,0.43103448275862066,-156,132,0.5847504714439656,0.41524952855603436,home,MIL,under,8,0.5238095238095238,-110,0.5011337868480725,MIL,STL,2022 REG,9,5,5,1,6,14,1,0,4,-4,1,0,0,0,0,0,0,0,0,0.4988662131519274,0.5011337868480725
86991,0.5391705069124424,0.5073891625615764,-117,-103,0.5140669063204599,0.4859330936795401,away,CIN,over,11,0.5073891625615764,-103,0.4837652908580103,COL,CIN,2022 REG,14,10,12,4,14,26,1,0,6,-6,1,1,1,1,0,0,0,0,0,0.4837652908580103,0.5162347091419897
86991,0.5391705069124424,0.5073891625615764,-117,-103,0.5140669063204599,0.4859330936795401,home,COL,under,11,0.5391705069124424,-117,0.5162347091419897,COL,CIN,2022 REG,14,10,12,4,14,26,1,0,6,-6,1,1,1,1,0,0,0,0,0,0.4837652908580103,0.5162347091419897
86992,0.43859649122807015,0.6000000000000001,128,-150,0.4216682056017235,0.5783317943982764,away,NYM,over,8.5,0.5024875621890548,-101,0.4794401874631478,MIA,NYM,2022 REG,6,3,5,2,5,11,1,0,1,-1,1,1,0,0,0,0,0,0,0,0.4794401874631478,0.5205598125368522
86992,0.43859649122807015,0.6000000000000001,128,-150,0.4216682056017235,0.5783317943982764,home,MIA,under,8.5,0.5433789954337899,-119,0.5205598125368522,MIA,NYM,2022 REG,6,3,5,2,5,11,1,0,1,-1,1,1,0,0,0,0,0,0,0,0.4794401874631478,0.5205598125368522
86993,0.7333333333333333,0.3076923076923077,-275,225,0.7032478632478633,0.29675213675213674,away,DET,over,9,0.5283018867924528,-112,0.5044173060022736,TOR,DET,2022 REG,4,5,10,3,8,14,1,0,2,-2,1,1,1,0,0,0,0,0,0,0.5044173060022736,0.49558269399772636
86993,0.7333333333333333,0.3076923076923077,-275,225,0.7032478632478633,0.29675213675213674,home,TOR,under,9,0.5169082125603864,-107,0.49558269399772636,TOR,DET,2022 REG,4,5,10,3,8,14,1,0,2,-2,1,1,1,0,0,0,0,0,0,0.5044173060022736,0.49558269399772636
86994,0.4291845493562232,0.607843137254902,133,-155,0.41329283836432396,0.586707161635676,away,BOS,over,8.5,0.5412844036697247,-118,0.5149381613977361,PIT,BOS,2022 REG,10,8,5,2,10,15,1,0,6,-6,1,1,0,0,0,0,0,0,0,0.5149381613977361,0.48506183860226393
86994,0.4291845493562232,0.607843137254902,133,-155,0.41329283836432396,0.586707161635676,home,PIT,under,8.5,0.5073891625615764,-103,0.48506183860226393,PIT,BOS,2022 REG,10,8,5,2,10,15,1,0,6,-6,1,1,0,0,0,0,0,0,0,0.5149381613977361,0.48506183860226393
86995,0.7727272727272727,0.26666666666666666,-340,275,0.7422865013774105,0.2577134986225895,away,COL,over,8.5,0.5169082125603864,-107,0.49353874091423283,NYM,COL,2022 REG,10,7,11,6,13,21,1,0,1,-1,1,1,1,1,1,1,0,0,0,0.49353874091423283,0.5064612590857671
86995,0.7727272727272727,0.26666666666666666,-340,275,0.7422865013774105,0.2577134986225895,home,NYM,under,8.5,0.5283018867924528,-112,0.5064612590857671,NYM,COL,2022 REG,10,7,11,6,13,21,1,0,1,-1,1,1,1,1,1,1,0,0,0,0.49353874091423283,0.5064612590857671
86996,0.6610169491525424,0.37037037037037035,-195,170,0.6402693989594307,0.3597306010405693,away,KC,over,9,0.5192307692307692,-108,0.49455035168025013,CWS,KC,2022 REG,11,7,8,1,8,19,1,0,6,-6,1,0,0,0,0,0,0,0,0,0.49455035168025013,0.5054496483197499
86996,0.6610169491525424,0.37037037037037035,-195,170,0.6402693989594307,0.3597306010405693,home,CWS,under,9,0.5283018867924528,-112,0.5054496483197499,CWS,KC,2022 REG,11,7,8,1,8,19,1,0,6,-6,1,0,0,0,0,0,0,0,0,0.49455035168025013,0.5054496483197499
86997,0.6875,0.3508771929824561,-220,185,0.6611156798245614,0.33888432017543857,away,MIA,over,8,0.5238095238095238,-110,0.5000596729920038,ATL,MIA,2022 REG,11,6,7,3,9,18,1,0,3,-3,1,1,1,0,0,0,0,0,0,0.5000596729920038,0.4999403270079962
86997,0.6875,0.3508771929824561,-220,185,0.6611156798245614,0.33888432017543857,home,ATL,under,8,0.5215311004784688,-109,0.4999403270079962,ATL,MIA,2022 REG,11,6,7,3,9,18,1,0,3,-3,1,1,1,0,0,0,0,0,0,0.5000596729920038,0.4999403270079962
86998,0.35714285714285715,0.6825396825396826,180,-215,0.34297052154195007,0.6570294784580499,away,STL,over,9.5,0.5348837209302326,-115,0.5097020142727117,CIN,STL,2022 REG,7,4,14,13,17,21,0,1,-9,9,1,1,1,1,0,0,0,0,0,0.5097020142727117,0.49029798572728833
86998,0.35714285714285715,0.6825396825396826,180,-215,0.34297052154195007,0.6570294784580499,home,CIN,under,9.5,0.5121951219512195,-105,0.49029798572728833,CIN,STL,2022 REG,7,4,14,13,17,21,0,1,-9,9,1,1,1,1,0,0,0,0,0,0.5097020142727117,0.49029798572728833
86999,0.5412844036697247,0.5,-118,100,0.5189377998484975,0.4810622001515025,away,DET,over,8,0.5391705069124424,-117,0.5140669063204599,PIT,DET,2022 REG,4,1,9,3,4,13,0,1,-2,2,1,0,0,0,0,0,0,0,0,0.5140669063204599,0.4859330936795401
86999,0.5412844036697247,0.5,-118,100,0.5189377998484975,0.4810622001515025,home,PIT,under,8,0.5073891625615764,-103,0.4859330936795401,PIT,DET,2022 REG,4,1,9,3,4,13,0,1,-2,2,1,0,0,0,0,0,0,0,0,0.5140669063204599,0.4859330936795401
87000,0.48780487804878053,0.5594713656387665,105,-127,0.46474329576217216,0.5352567042378278,away,CHC,over,8.5,0.5454545454545454,-120,0.5206611570247933,CIN,CHC,2022 REG,7,2,13,15,17,20,0,1,-13,13,1,1,0,0,0,0,0,0,0,0.5206611570247933,0.4793388429752067
87000,0.48780487804878053,0.5594713656387665,105,-127,0.46474329576217216,0.5352567042378278,home,CIN,under,8.5,0.5,100,0.4793388429752067,CIN,CHC,2022 REG,7,2,13,15,17,20,0,1,-13,13,1,1,0,0,0,0,0,0,0,0.5206611570247933,0.4793388429752067
87001,0.5535714285714286,0.4854368932038835,-124,106,0.5319775361600951,0.46802246383990487,away,PHI,over,7,0.5305164319248826,-113,0.5053568787472517,MIA,PHI,2022 REG,4,1,8,2,3,12,0,1,-1,1,1,0,0,0,0,0,0,0,0,0.5053568787472517,0.49464312125274834
87001,0.5535714285714286,0.4854368932038835,-124,106,0.5319775361600951,0.46802246383990487,home,MIA,under,7,0.5169082125603864,-107,0.49464312125274834,MIA,PHI,2022 REG,4,1,8,2,3,12,0,1,-1,1,1,0,0,0,0,0,0,0,0,0.5053568787472517,0.49464312125274834
87002,0.7222222222222222,0.31746031746031744,-260,215,0.693562610229277,0.306437389770723,away,DET,over,8,0.5098039215686274,-104,0.48483656587239576,CWS,DET,2022 REG,4,1,5,2,3,9,0,1,-1,1,1,0,0,0,0,0,0,0,0,0.48483656587239576,0.5151634341276042
87002,0.7222222222222222,0.31746031746031744,-260,215,0.693562610229277,0.306437389770723,home,CWS,under,8,0.5391705069124424,-117,0.5151634341276042,CWS,DET,2022 REG,4,1,5,2,3,9,0,1,-1,1,1,0,0,0,0,0,0,0,0,0.48483656587239576,0.5151634341276042
87003,0.5098039215686274,0.5283018867924528,-104,-112,0.4903774310316062,0.5096225689683938,away,NYY,over,8,0.5238095238095238,-110,0.4988662131519274,SEA,NYY,2022 REG,6,4,13,9,13,19,0,1,-5,5,1,1,1,1,0,0,0,0,0,0.4988662131519274,0.5011337868480725
87003,0.5098039215686274,0.5283018867924528,-104,-112,0.4903774310316062,0.5096225689683938,home,SEA,under,8,0.5238095238095238,-110,0.5011337868480725,SEA,NYY,2022 REG,6,4,13,9,13,19,0,1,-5,5,1,1,1,1,0,0,0,0,0,0.4988662131519274,0.5011337868480725
87004,0.7468354430379747,0.29850746268656714,-295,235,0.7129717539525574,0.2870282460474426,away,OAK,over,8,0.5121951219512195,-105,0.48808156828023186,CWS,OAK,2022 REG,8,4,6,1,5,14,1,0,3,-3,1,0,0,0,0,0,0,0,0,0.48808156828023186,0.5119184317197681
87004,0.7468354430379747,0.29850746268656714,-295,235,0.7129717539525574,0.2870282460474426,home,CWS,under,8,0.5348837209302326,-115,0.5119184317197681,CWS,OAK,2022 REG,8,4,6,1,5,14,1,0,3,-3,1,0,0,0,0,0,0,0,0,0.48808156828023186,0.5119184317197681
87005,0.6153846153846154,0.42016806722689076,-160,138,0.5935060414698423,0.4064939585301577,away,NYM,over,8,0.5391705069124424,-117,0.5140669063204599,ATL,NYM,2022 REG,15,13,7,1,14,22,1,0,12,-12,1,0,0,0,0,0,0,0,0,0.5140669063204599,0.4859330936795401
87005,0.6153846153846154,0.42016806722689076,-160,138,0.5935060414698423,0.4064939585301577,home,ATL,under,8,0.5073891625615764,-103,0.4859330936795401,ATL,NYM,2022 REG,15,13,7,1,14,22,1,0,12,-12,1,0,0,0,0,0,0,0,0,0.5140669063204599,0.4859330936795401
87006,0.37037037037037035,0.6721311475409836,170,-205,0.35462906744023925,0.6453709325597607,away,NYY,over,8,0.5454545454545454,-120,0.5206611570247933,MIN,NYY,2022 REG,9,7,14,10,17,23,0,1,-3,3,1,1,1,1,1,1,1,0,0,0.5206611570247933,0.4793388429752067
87006,0.37037037037037035,0.6721311475409836,170,-205,0.35462906744023925,0.6453709325597607,home,MIN,under,8,0.5,100,0.4793388429752067,MIN,NYY,2022 REG,9,7,14,10,17,23,0,1,-3,3,1,1,1,1,1,1,1,0,0,0.5206611570247933,0.4793388429752067
87007,0.49504950495049505,0.5454545454545454,102,-120,0.47499799484898986,0.5250020051510101,away,CLE,over,7.5,0.5169082125603864,-107,0.49239402434819424,OAK,CLE,2022 REG,6,3,9,7,10,15,0,1,-4,4,1,1,1,0,0,0,0,0,0,0.49239402434819424,0.5076059756518058
87007,0.49504950495049505,0.5454545454545454,102,-120,0.47499799484898986,0.5250020051510101,home,OAK,under,7.5,0.5305164319248826,-113,0.5076059756518058,OAK,CLE,2022 REG,6,3,9,7,10,15,0,1,-4,4,1,1,1,0,0,0,0,0,0,0.49239402434819424,0.5076059756518058
87008,0.48780487804878053,0.5495495495495495,105,-122,0.4695832060495952,0.5304167939504048,away,TB,over,8.5,0.5215311004784688,-109,0.49907282342437215,BOS,TB,2022 REG,8,5,6,1,6,14,1,0,4,-4,1,0,0,0,0,0,0,0,0,0.49907282342437215,0.5009271765756278
87008,0.48780487804878053,0.5495495495495495,105,-122,0.4695832060495952,0.5304167939504048,home,BOS,under,8.5,0.5215311004784688,-109,0.5009271765756278,BOS,TB,2022 REG,8,5,6,1,6,14,1,0,4,-4,1,0,0,0,0,0,0,0,0,0.49907282342437215,0.5009271765756278
87009,0.5594713656387665,0.47619047619047616,-127,110,0.5395195862893665,0.46048041371063353,away,DET,over,7.5,0.504950495049505,-102,0.4826715732667395,PIT,DET,2022 REG,6,3,11,5,8,17,0,1,-2,2,1,1,1,0,0,0,0,0,0,0.4826715732667395,0.5173284267332605
87009,0.5594713656387665,0.47619047619047616,-127,110,0.5395195862893665,0.46048041371063353,home,PIT,under,7.5,0.5391705069124424,-117,0.5173284267332605,PIT,DET,2022 REG,6,3,11,5,8,17,0,1,-2,2,1,1,1,0,0,0,0,0,0,0.4826715732667395,0.5173284267332605
87010,0.5652173913043479,0.47619047619047616,-130,110,0.5418129444594474,0.4581870555405526,away,BAL,over,7.5,0.5215311004784688,-109,0.49907282342437215,OAK,BAL,2022 REG,11,6,7,4,10,18,1,0,2,-2,1,1,1,1,0,0,0,0,0,0.49907282342437215,0.5009271765756278
87010,0.5652173913043479,0.47619047619047616,-130,110,0.5418129444594474,0.4581870555405526,home,OAK,under,7.5,0.5215311004784688,-109,0.5009271765756278,OAK,BAL,2022 REG,11,6,7,4,10,18,1,0,2,-2,1,1,1,1,0,0,0,0,0,0.49907282342437215,0.5009271765756278
87011,0.4484304932735426,0.5884773662551441,123,-143,0.43187988361942303,0.5681201163805769,away,STL,over,10,0.5283018867924528,-112,0.5031902949311281,CIN,STL,2022 REG,7,9,10,5,14,17,1,0,4,-4,1,1,1,1,1,0,0,0,0,0.5031902949311281,0.4968097050688719
87011,0.4484304932735426,0.5884773662551441,123,-143,0.43187988361942303,0.5681201163805769,home,CIN,under,10,0.5192307692307692,-108,0.4968097050688719,CIN,STL,2022 REG,7,9,10,5,14,17,1,0,4,-4,1,1,1,1,1,0,0,0,0,0.5031902949311281,0.4968097050688719
87012,0.4716981132075471,0.5652173913043479,112,-130,0.4542851393811816,0.5457148606188185,away,ATL,over,7.5,0.5,100,0.4772727272727273,MIA,ATL,2022 REG,10,3,9,5,8,19,0,1,-2,2,1,1,1,0,0,0,0,0,0,0.4772727272727273,0.5227272727272727
87012,0.4716981132075471,0.5652173913043479,112,-130,0.4542851393811816,0.5457148606188185,home,MIA,under,7.5,0.5454545454545454,-120,0.5227272727272727,MIA,ATL,2022 REG,10,3,9,5,8,19,0,1,-2,2,1,1,1,0,0,0,0,0,0,0.4772727272727273,0.5227272727272727
87013,0.5412844036697247,0.5,-118,100,0.5189377998484975,0.4810622001515025,away,NYM,over,6.5,0.5454545454545454,-120,0.5206611570247933,MIL,NYM,2022 REG,4,2,10,7,9,14,0,1,-5,5,1,1,0,0,0,0,0,0,0,0.5206611570247933,0.4793388429752067
87013,0.5412844036697247,0.5,-118,100,0.5189377998484975,0.4810622001515025,home,MIL,under,6.5,0.5,100,0.4793388429752067,MIL,NYM,2022 REG,4,2,10,7,9,14,0,1,-5,5,1,1,0,0,0,0,0,0,0,0.5206611570247933,0.4793388429752067
87014,0.5073891625615764,0.5348837209302326,-103,-115,0.4859403596076043,0.5140596403923957,away,PHI,over,11.5,0.49504950495049505,102,0.47499799484898986,COL,PHI,2022 REG,11,6,12,9,15,23,0,1,-3,3,1,1,1,1,1,1,0,0,0,0.47499799484898986,0.5250020051510101
87014,0.5073891625615764,0.5348837209302326,-103,-115,0.4859403596076043,0.5140596403923957,home,COL,under,11.5,0.5454545454545454,-120,0.5250020051510101,COL,PHI,2022 REG,11,6,12,9,15,23,0,1,-3,3,1,1,1,1,1,1,0,0,0,0.47499799484898986,0.5250020051510101
87015,0.7802197802197802,0.2631578947368421,-355,280,0.7463756601986793,0.2536243398013207,away,COL,over,7,0.5121951219512195,-105,0.48919479393107135,NYM,COL,2022 REG,3,0,7,1,1,10,0,1,-1,1,0,0,0,0,0,0,0,0,0,0.48919479393107135,0.5108052060689287
87015,0.7802197802197802,0.2631578947368421,-355,280,0.7463756601986793,0.2536243398013207,home,NYM,under,7,0.5327102803738317,-114,0.5108052060689287,NYM,COL,2022 REG,3,0,7,1,1,10,0,1,-1,1,0,0,0,0,0,0,0,0,0,0.48919479393107135,0.5108052060689287
87016,0.49504950495049505,0.5454545454545454,102,-120,0.47499799484898986,0.5250020051510101,away,NYM,over,7.5,0.5,100,0.4772727272727273,ATL,NYM,2022 REG,11,4,8,2,6,19,1,0,2,-2,1,1,0,0,0,0,0,0,0,0.4772727272727273,0.5227272727272727
87016,0.49504950495049505,0.5454545454545454,102,-120,0.47499799484898986,0.5250020051510101,home,ATL,under,7.5,0.5454545454545454,-120,0.5227272727272727,ATL,NYM,2022 REG,11,4,8,2,6,19,1,0,2,-2,1,1,0,0,0,0,0,0,0,0.4772727272727273,0.5227272727272727
87017,0.4,0.6389891696750902,150,-177,0.3844043321299639,0.6155956678700361,away,SD,over,8,0.5024875621890548,-101,0.48049269377245407,DET,SD,2022 REG,11,4,6,6,10,17,0,1,-2,2,1,1,1,1,0,0,0,0,0,0.48049269377245407,0.5195073062275459
87017,0.4,0.6389891696750902,150,-177,0.3844043321299639,0.6155956678700361,home,DET,under,8,0.5412844036697247,-118,0.5195073062275459,DET,SD,2022 REG,11,4,6,6,10,17,0,1,-2,2,1,1,1,1,0,0,0,0,0,0.48049269377245407,0.5195073062275459
87018,0.5348837209302326,0.5121951219512195,-115,-105,0.5097020142727117,0.49029798572728833,away,CIN,over,7,0.5121951219512195,-105,0.48808156828023186,PIT,CIN,2022 REG,7,4,6,1,5,13,1,0,3,-3,1,0,0,0,0,0,0,0,0,0.48808156828023186,0.5119184317197681
87018,0.5348837209302326,0.5121951219512195,-115,-105,0.5097020142727117,0.49029798572728833,home,PIT,under,7,0.5348837209302326,-115,0.5119184317197681,PIT,CIN,2022 REG,7,4,6,1,5,13,1,0,3,-3,1,0,0,0,0,0,0,0,0,0.48808156828023186,0.5119184317197681
87019,0.4166666666666667,0.6254681647940076,140,-167,0.3991104868913858,0.6008895131086143,away,SD,over,9,0.5412844036697247,-118,0.5189377998484975,ARI,SD,2022 REG,5,2,10,5,7,15,0,1,-3,3,1,1,0,0,0,0,0,0,0,0.5189377998484975,0.4810622001515025
87019,0.4166666666666667,0.6254681647940076,140,-167,0.3991104868913858,0.6008895131086143,home,ARI,under,9,0.5,100,0.4810622001515025,ARI,SD,2022 REG,5,2,10,5,7,15,0,1,-3,3,1,1,0,0,0,0,0,0,0,0.5189377998484975,0.4810622001515025
87020,0.5555555555555556,0.4854368932038835,-125,106,0.5327819729114227,0.4672180270885773,away,TEX,over,7,0.5327102803738317,-114,0.5062779990911175,SEA,TEX,2022 REG,13,10,12,9,19,25,1,0,1,-1,1,1,1,1,1,1,1,1,1,0.5062779990911175,0.4937220009088825
87020,0.5555555555555556,0.4854368932038835,-125,106,0.5327819729114227,0.4672180270885773,home,SEA,under,7,0.5169082125603864,-107,0.4937220009088825,SEA,TEX,2022 REG,13,10,12,9,19,25,1,0,1,-1,1,1,1,1,1,1,1,1,1,0.5062779990911175,0.4937220009088825
87021,0.4,0.6363636363636364,150,-175,0.3854545454545455,0.6145454545454545,away,SF,over,8,0.5327102803738317,-114,0.5075272610403079,PIT,SF,2022 REG,8,5,10,7,12,18,0,1,-2,2,1,1,1,1,1,0,0,0,0,0.5075272610403079,0.4924727389596921
87021,0.4,0.6363636363636364,150,-175,0.3854545454545455,0.6145454545454545,home,PIT,under,8,0.5145631067961165,-106,0.4924727389596921,PIT,SF,2022 REG,8,5,10,7,12,18,0,1,-2,2,1,1,1,1,1,0,0,0,0,0.5075272610403079,0.4924727389596921
87022,0.47619047619047616,0.5555555555555556,110,-125,0.46107331821617537,0.5389266817838246,away,ATL,over,8,0.5238095238095238,-110,0.4988662131519274,PHI,ATL,2022 REG,3,3,14,6,9,17,0,1,-3,3,1,1,1,0,0,0,0,0,0,0.4988662131519274,0.5011337868480725
87022,0.47619047619047616,0.5555555555555556,110,-125,0.46107331821617537,0.5389266817838246,home,PHI,under,8,0.5238095238095238,-110,0.5011337868480725,PHI,ATL,2022 REG,3,3,14,6,9,17,0,1,-3,3,1,1,1,0,0,0,0,0,0,0.4988662131519274,0.5011337868480725
87023,0.5867768595041323,0.45454545454545453,-142,120,0.5625298818386723,0.43747011816132775,away,PIT,over,8.5,0.5145631067961165,-106,0.4913668392989033,CHC,PIT,2022 REG,4,3,9,4,7,13,0,1,-1,1,1,1,1,0,0,0,0,0,0,0.4913668392989033,0.5086331607010968
87023,0.5867768595041323,0.45454545454545453,-142,120,0.5625298818386723,0.43747011816132775,home,CHC,under,8.5,0.5305164319248826,-113,0.5086331607010968,CHC,PIT,2022 REG,4,3,9,4,7,13,0,1,-1,1,1,1,1,0,0,0,0,0,0,0.4913668392989033,0.5086331607010968
87024,0.6721311475409836,0.37037037037037035,-205,170,0.6435645535349916,0.35643544646500835,away,COL,over,8.5,0.5238095238095238,-110,0.4988662131519274,MIN,COL,2022 REG,10,6,12,3,9,22,1,0,3,-3,1,1,1,0,0,0,0,0,0,0.4988662131519274,0.5011337868480725
87024,0.6721311475409836,0.37037037037037035,-205,170,0.6435645535349916,0.35643544646500835,home,MIN,under,8.5,0.5238095238095238,-110,0.5011337868480725,MIN,COL,2022 REG,10,6,12,3,9,22,1,0,3,-3,1,1,1,0,0,0,0,0,0,0.4988662131519274,0.5011337868480725
87025,0.6254681647940076,0.4081632653061224,-167,145,0.6044327759298813,0.3955672240701187,away,BAL,over,10,0.5215311004784688,-109,0.4978845547971712,BOS,BAL,2022 REG,4,0,14,10,10,18,0,1,-10,10,0,0,0,0,0,0,0,0,0,0.4978845547971712,0.5021154452028288
87025,0.6254681647940076,0.4081632653061224,-167,145,0.6044327759298813,0.3955672240701187,home,BOS,under,10,0.5238095238095238,-110,0.5021154452028288,BOS,BAL,2022 REG,4,0,14,10,10,18,0,1,-10,10,0,0,0,0,0,0,0,0,0,0.4978845547971712,0.5021154452028288
87026,0.48780487804878053,0.5555555555555556,105,-125,0.4666534470222751,0.5333465529777248,away,HOU,over,8.5,0.5121951219512195,-105,0.48808156828023186,SEA,HOU,2022 REG,7,2,10,5,7,17,0,1,-3,3,1,1,0,0,0,0,0,0,0,0.48808156828023186,0.5119184317197681
87026,0.48780487804878053,0.5555555555555556,105,-125,0.4666534470222751,0.5333465529777248,home,SEA,under,8.5,0.5348837209302326,-115,0.5119184317197681,SEA,HOU,2022 REG,7,2,10,5,7,17,0,1,-3,3,1,1,0,0,0,0,0,0,0,0.48808156828023186,0.5119184317197681
87027,0.38167938931297707,0.6610169491525424,162,-195,0.3653830769215574,0.6346169230784426,away,HOU,over,9.5,0.5238095238095238,-110,0.5012646084074657,LAA,HOU,2022 REG,6,1,11,9,10,17,0,1,-8,8,1,0,0,0,0,0,0,0,0,0.5012646084074657,0.4987353915925343
87027,0.38167938931297707,0.6610169491525424,162,-195,0.3653830769215574,0.6346169230784426,home,LAA,under,9.5,0.5192307692307692,-108,0.4987353915925343,LAA,HOU,2022 REG,6,1,11,9,10,17,0,1,-8,8,1,0,0,0,0,0,0,0,0,0.5012646084074657,0.4987353915925343
87028,0.5833333333333333,0.4587155963302753,-140,118,0.5588047910295616,0.4411952089704384,away,PIT,over,9.5,0.49751243781094534,101,0.47511256217505476,CIN,PIT,2022 REG,1,0,3,1,1,4,0,1,-1,1,0,0,0,0,0,0,0,0,0,0.47511256217505476,0.5248874378249453
87028,0.5833333333333333,0.4587155963302753,-140,118,0.5588047910295616,0.4411952089704384,home,CIN,under,9.5,0.5475113122171946,-121,0.5248874378249453,CIN,PIT,2022 REG,1,0,3,1,1,4,0,1,-1,1,0,0,0,0,0,0,0,0,0,0.47511256217505476,0.5248874378249453
87029,0.47619047619047616,0.5652173913043479,110,-130,0.4564724440500838,0.5435275559499162,away,NYM,over,9,0.5391705069124424,-117,0.5140669063204599,PHI,NYM,2022 REG,11,4,3,1,5,14,1,0,3,-3,1,0,0,0,0,0,0,0,0,0.5140669063204599,0.4859330936795401
87029,0.47619047619047616,0.5652173913043479,110,-130,0.4564724440500838,0.5435275559499162,home,PHI,under,9,0.5073891625615764,-103,0.4859330936795401,PHI,NYM,2022 REG,11,4,3,1,5,14,1,0,3,-3,1,0,0,0,0,0,0,0,0,0.5140669063204599,0.4859330936795401
87030,0.5145631067961165,0.5327102803738317,-106,-114,0.49023796582517226,0.5097620341748277,away,MIN,over,9,0.5412844036697247,-118,0.5149381613977361,ARI,MIN,2022 REG,4,1,14,11,12,18,0,1,-10,10,1,0,0,0,0,0,0,0,0,0.5149381613977361,0.48506183860226393
87030,0.5145631067961165,0.5327102803738317,-106,-114,0.49023796582517226,0.5097620341748277,home,ARI,under,9,0.5073891625615764,-103,0.48506183860226393,ARI,MIN,2022 REG,4,1,14,11,12,18,0,1,-10,10,1,0,0,0,0,0,0,0,0,0.5149381613977361,0.48506183860226393
87031,0.5652173913043479,0.47619047619047616,-130,110,0.5418129444594474,0.4581870555405526,away,TOR,over,9.5,0.5024875621890548,-101,0.4794401874631478,NYY,TOR,2022 REG,7,4,5,0,4,12,1,0,4,-4,0,0,0,0,0,0,0,0,0,0.4794401874631478,0.5205598125368522
87031,0.5652173913043479,0.47619047619047616,-130,110,0.5418129444594474,0.4581870555405526,home,NYY,under,9.5,0.5433789954337899,-119,0.5205598125368522,NYY,TOR,2022 REG,7,4,5,0,4,12,1,0,4,-4,0,0,0,0,0,0,0,0,0,0.4794401874631478,0.5205598125368522
87032,0.6153846153846154,0.42372881355932196,-160,136,0.591314812957577,0.40868518704242296,away,BAL,over,8,0.5283018867924528,-112,0.5044173060022736,STL,BAL,2022 REG,7,3,11,5,8,18,0,1,-2,2,1,1,1,0,0,0,0,0,0,0.5044173060022736,0.49558269399772636
87032,0.6153846153846154,0.42372881355932196,-160,136,0.591314812957577,0.40868518704242296,home,STL,under,8,0.5169082125603864,-107,0.49558269399772636,STL,BAL,2022 REG,7,3,11,5,8,18,0,1,-2,2,1,1,1,0,0,0,0,0,0,0.5044173060022736,0.49558269399772636
87033,0.48780487804878053,0.5555555555555556,105,-125,0.4666534470222751,0.5333465529777248,away,SF,over,8,0.5238095238095238,-110,0.4988662131519274,MIA,SF,2022 REG,5,1,9,5,6,14,0,1,-4,4,1,0,0,0,0,0,0,0,0,0.4988662131519274,0.5011337868480725
87033,0.48780487804878053,0.5555555555555556,105,-125,0.4666534470222751,0.5333465529777248,home,MIA,under,8,0.5238095238095238,-110,0.5011337868480725,MIA,SF,2022 REG,5,1,9,5,6,14,0,1,-4,4,1,0,0,0,0,0,0,0,0,0.4988662131519274,0.5011337868480725
87034,0.5348837209302326,0.5121951219512195,-115,-105,0.5097020142727117,0.49029798572728833,away,CLE,over,7.5,0.5391705069124424,-117,0.5140669063204599,CIN,CLE,2022 REG,5,5,11,10,15,16,0,1,-5,5,1,1,1,1,1,0,0,0,0,0.5140669063204599,0.4859330936795401
87034,0.5348837209302326,0.5121951219512195,-115,-105,0.5097020142727117,0.49029798572728833,home,CIN,under,7.5,0.5073891625615764,-103,0.4859330936795401,CIN,CLE,2022 REG,5,5,11,10,15,16,0,1,-5,5,1,1,1,1,1,0,0,0,0,0.5140669063204599,0.4859330936795401
87035,0.5,0.5391705069124424,100,-117,0.4804147465437788,0.5195852534562212,away,TB,over,7.5,0.49751243781094534,101,0.4740985137509976,BOS,TB,2022 REG,5,6,2,0,6,7,1,0,6,-6,0,0,0,0,0,0,0,0,0,0.4740985137509976,0.5259014862490023
87035,0.5,0.5391705069124424,100,-117,0.4804147465437788,0.5195852534562212,home,BOS,under,7.5,0.5495495495495495,-122,0.5259014862490023,BOS,TB,2022 REG,5,6,2,0,6,7,1,0,6,-6,0,0,0,0,0,0,0,0,0,0.4740985137509976,0.5259014862490023
87036,0.7402597402597403,0.30303030303030304,-285,230,0.7082138640580199,0.2917861359419801,away,CIN,over,7.5,0.5,100,0.4772727272727273,MIL,CIN,2022 REG,5,2,7,4,6,12,0,1,-2,2,1,1,0,0,0,0,0,0,0,0.4772727272727273,0.5227272727272727
87036,0.7402597402597403,0.30303030303030304,-285,230,0.7082138640580199,0.2917861359419801,home,MIL,under,7.5,0.5454545454545454,-120,0.5227272727272727,MIL,CIN,2022 REG,5,2,7,4,6,12,0,1,-2,2,1,1,0,0,0,0,0,0,0,0.4772727272727273,0.5227272727272727
87037,0.576271186440678,0.4716981132075471,-136,112,0.5486278612196669,0.4513721387803331,away,WSH,over,11,0.5073891625615764,-103,0.4837652908580103,COL,WSH,2022 REG,10,9,15,7,16,25,1,0,2,-2,1,1,1,1,1,1,1,0,0,0.4837652908580103,0.5162347091419897
87037,0.576271186440678,0.4716981132075471,-136,112,0.5486278612196669,0.4513721387803331,home,COL,under,11,0.5391705069124424,-117,0.5162347091419897,COL,WSH,2022 REG,10,9,15,7,16,25,1,0,2,-2,1,1,1,1,1,1,1,0,0,0.4837652908580103,0.5162347091419897
87038,0.4587155963302753,0.5726495726495727,118,-134,0.44432790413768447,0.5556720958623156,away,MIA,over,8,0.5238095238095238,-110,0.5012646084074657,WSH,MIA,2022 REG,6,5,8,3,8,14,1,0,2,-2,1,1,1,0,0,0,0,0,0,0.5012646084074657,0.4987353915925343
87038,0.4587155963302753,0.5726495726495727,118,-134,0.44432790413768447,0.5556720958623156,home,WSH,under,8,0.5192307692307692,-108,0.4987353915925343,WSH,MIA,2022 REG,6,5,8,3,8,14,1,0,2,-2,1,1,1,0,0,0,0,0,0,0.5012646084074657,0.4987353915925343
87039,0.6666666666666666,0.373134328358209,-200,168,0.6401326699834162,0.3598673300165838,away,CLE,over,9,0.5305164319248826,-113,0.5066009958897986,NYY,CLE,2022 REG,7,4,9,1,5,16,1,0,3,-3,1,0,0,0,0,0,0,0,0,0.5066009958897986,0.49339900411020143
87039,0.6666666666666666,0.373134328358209,-200,168,0.6401326699834162,0.3598673300165838,home,NYY,under,9,0.5145631067961165,-106,0.49339900411020143,NYY,CLE,2022 REG,7,4,9,1,5,16,1,0,3,-3,1,0,0,0,0,0,0,0,0,0.5066009958897986,0.49339900411020143
87040,0.4347826086956522,0.6031746031746031,130,-152,0.418279473099889,0.581720526900111,away,CWS,over,8.5,0.5098039215686274,-104,0.48592421718142587,DET,CWS,2022 REG,7,2,10,5,7,17,0,1,-3,3,1,1,0,0,0,0,0,0,0,0.48592421718142587,0.5140757828185741
87040,0.4347826086956522,0.6031746031746031,130,-152,0.418279473099889,0.581720526900111,home,DET,under,8.5,0.5370370370370371,-116,0.5140757828185741,DET,CWS,2022 REG,7,2,10,5,7,17,0,1,-3,3,1,1,0,0,0,0,0,0,0,0.48592421718142587,0.5140757828185741
87041,0.5833333333333333,0.4587155963302753,-140,118,0.5588047910295616,0.4411952089704384,away,CHC,over,9,0.5121951219512195,-105,0.48808156828023186,MIL,CHC,2022 REG,5,3,11,8,11,16,0,1,-5,5,1,1,1,0,0,0,0,0,0,0.48808156828023186,0.5119184317197681
87041,0.5833333333333333,0.4587155963302753,-140,118,0.5588047910295616,0.4411952089704384,home,MIL,under,9,0.5348837209302326,-115,0.5119184317197681,MIL,CHC,2022 REG,5,3,11,8,11,16,0,1,-5,5,1,1,1,0,0,0,0,0,0,0.48808156828023186,0.5119184317197681
87042,0.5,0.5348837209302326,100,-115,0.4825581395348837,0.5174418604651163,away,CIN,over,8,0.5121951219512195,-105,0.48808156828023186,PIT,CIN,2022 REG,13,5,7,4,9,20,1,0,1,-1,1,1,1,1,0,0,0,0,0,0.48808156828023186,0.5119184317197681
87042,0.5,0.5348837209302326,100,-115,0.4825581395348837,0.5174418604651163,home,PIT,under,8,0.5348837209302326,-115,0.5119184317197681,PIT,CIN,2022 REG,13,5,7,4,9,20,1,0,1,-1,1,1,1,1,0,0,0,0,0,0.48808156828023186,0.5119184317197681
87043,0.48780487804878053,0.5475113122171946,105,-121,0.470577468162939,0.529422531837061,away,LAD,over,8.5,0.5121951219512195,-105,0.48808156828023186,CWS,LAD,2022 REG,7,4,5,0,4,12,1,0,4,-4,0,0,0,0,0,0,0,0,0,0.48808156828023186,0.5119184317197681
87043,0.48780487804878053,0.5475113122171946,105,-121,0.470577468162939,0.529422531837061,home,CWS,under,8.5,0.5348837209302326,-115,0.5119184317197681,CWS,LAD,2022 REG,7,4,5,0,4,12,1,0,4,-4,0,0,0,0,0,0,0,0,0,0.48808156828023186,0.5119184317197681
87044,0.5652173913043479,0.4716981132075471,-130,112,0.5443521061454507,0.4556478938545493,away,TOR,over,8.5,0.5370370370370371,-116,0.5118817074154765,HOU,TOR,2022 REG,11,8,10,7,15,21,1,0,1,-1,1,1,1,1,1,1,1,0,0,0.5118817074154765,0.48811829258452355
87044,0.5652173913043479,0.4716981132075471,-130,112,0.5443521061454507,0.4556478938545493,home,HOU,under,8.5,0.5098039215686274,-104,0.48811829258452355,HOU,TOR,2022 REG,11,8,10,7,15,21,1,0,1,-1,1,1,1,1,1,1,1,0,0,0.5118817074154765,0.48811829258452355
87045,0.5689655172413793,0.4716981132075471,-132,112,0.5458293137100936,0.4541706862899064,away,TEX,over,8.5,0.5121951219512195,-105,0.48808156828023186,LAA,TEX,2022 REG,8,2,5,5,7,13,0,1,-3,3,1,1,0,0,0,0,0,0,0,0.48808156828023186,0.5119184317197681
87045,0.5689655172413793,0.4716981132075471,-132,112,0.5458293137100936,0.4541706862899064,home,LAA,under,8.5,0.5348837209302326,-115,0.5119184317197681,LAA,TEX,2022 REG,8,2,5,5,7,13,0,1,-3,3,1,1,0,0,0,0,0,0,0,0.48808156828023186,0.5119184317197681
87046,0.6774193548387096,0.35714285714285715,-210,180,0.6540062434963579,0.34599375650364206,away,CIN,over,9,0.5169082125603864,-107,0.49586088023391106,BOS,CIN,2022 REG,8,7,7,1,8,15,1,0,6,-6,1,0,0,0,0,0,0,0,0,0.49586088023391106,0.5041391197660889
87046,0.6774193548387096,0.35714285714285715,-210,180,0.6540062434963579,0.34599375650364206,home,BOS,under,9,0.5238095238095238,-110,0.5041391197660889,BOS,CIN,2022 REG,8,7,7,1,8,15,1,0,6,-6,1,0,0,0,0,0,0,0,0,0.49586088023391106,0.5041391197660889
87047,0.607843137254902,0.4347826086956522,-155,130,0.5819333701084867,0.41806662989151333,away,LAA,over,7,0.5515695067264574,-123,0.5258558814517258,ATL,LAA,2022 REG,8,8,5,1,9,13,1,0,7,-7,1,0,0,0,0,0,0,0,0,0.5258558814517258,0.4741441185482742
87047,0.607843137254902,0.4347826086956522,-155,130,0.5819333701084867,0.41806662989151333,home,ATL,under,7,0.49504950495049505,102,0.4741441185482742,ATL,LAA,2022 REG,8,8,5,1,9,13,1,0,7,-7,1,0,0,0,0,0,0,0,0,0.5258558814517258,0.4741441185482742
87048,0.6153846153846154,0.4166666666666667,-160,140,0.5956607495069033,0.4043392504930967,away,CIN,over,8,0.5238095238095238,-110,0.4988662131519274,STL,CIN,2022 REG,12,6,11,7,13,23,0,1,-1,1,1,1,1,1,1,1,0,0,0,0.4988662131519274,0.5011337868480725
87048,0.6153846153846154,0.4166666666666667,-160,140,0.5956607495069033,0.4043392504930967,home,STL,under,8,0.5238095238095238,-110,0.5011337868480725,STL,CIN,2022 REG,12,6,11,7,13,23,0,1,-1,1,1,1,1,1,1,1,0,0,0,0.4988662131519274,0.5011337868480725
87049,0.45454545454545453,0.5833333333333333,120,-140,0.43732782369146006,0.5626721763085399,away,TOR,over,8.5,0.5238095238095238,-110,0.4988662131519274,MIL,TOR,2022 REG,8,4,13,9,13,21,0,1,-5,5,1,1,1,1,0,0,0,0,0,0.4988662131519274,0.5011337868480725
87049,0.45454545454545453,0.5833333333333333,120,-140,0.43732782369146006,0.5626721763085399,home,MIL,under,8.5,0.5238095238095238,-110,0.5011337868480725,MIL,TOR,2022 REG,8,4,13,9,13,21,0,1,-5,5,1,1,1,1,0,0,0,0,0,0.4988662131519274,0.5011337868480725
87050,0.45454545454545453,0.5884773662551441,120,-143,0.43498962690881876,0.5650103730911813,away,HOU,over,9,0.5238095238095238,-110,0.4988662131519274,BOS,HOU,2022 REG,5,5,2,1,6,7,1,0,4,-4,1,0,0,0,0,0,0,0,0,0.4988662131519274,0.5011337868480725
87050,0.45454545454545453,0.5884773662551441,120,-143,0.43498962690881876,0.5650103730911813,home,BOS,under,9,0.5238095238095238,-110,0.5011337868480725,BOS,HOU,2022 REG,5,5,2,1,6,7,1,0,4,-4,1,0,0,0,0,0,0,0,0,0.4988662131519274,0.5011337868480725
87051,0.49504950495049505,0.5454545454545454,102,-120,0.47499799484898986,0.5250020051510101,away,NYM,over,9,0.5348837209302326,-115,0.5109810284308424,WSH,NYM,2022 REG,6,1,12,5,6,18,0,1,-4,4,1,0,0,0,0,0,0,0,0,0.5109810284308424,0.48901897156915763
87051,0.49504950495049505,0.5454545454545454,102,-120,0.47499799484898986,0.5250020051510101,home,WSH,under,9,0.5098039215686274,-104,0.48901897156915763,WSH,NYM,2022 REG,6,1,12,5,6,18,0,1,-4,4,1,0,0,0,0,0,0,0,0,0.5109810284308424,0.48901897156915763
87052,0.6363636363636364,0.4,-175,150,0.6132231404958678,0.3867768595041322,away,BOS,over,8.5,0.5283018867924528,-112,0.5044173060022736,NYY,BOS,2022 REG,9,6,9,5,11,18,1,0,1,-1,1,1,1,1,1,0,0,0,0,0.5044173060022736,0.49558269399772636
87052,0.6363636363636364,0.4,-175,150,0.6132231404958678,0.3867768595041322,home,NYY,under,8.5,0.5169082125603864,-107,0.49558269399772636,NYY,BOS,2022 REG,9,6,9,5,11,18,1,0,1,-1,1,1,1,1,1,0,0,0,0,0.5044173060022736,0.49558269399772636
87053,0.40322580645161293,0.6254681647940076,148,-167,0.3916556567557982,0.6083443432442017,away,BAL,over,8.5,0.5238095238095238,-110,0.4988662131519274,WSH,BAL,2022 REG,8,3,11,4,7,19,0,1,-1,1,1,1,1,0,0,0,0,0,0,0.4988662131519274,0.5011337868480725
87053,0.40322580645161293,0.6254681647940076,148,-167,0.3916556567557982,0.6083443432442017,home,WSH,under,8.5,0.5238095238095238,-110,0.5011337868480725,WSH,BAL,2022 REG,8,3,11,4,7,19,0,1,-1,1,1,1,1,0,0,0,0,0,0,0.4988662131519274,0.5011337868480725
87054,0.6226415094339623,0.41152263374485604,-165,143,0.6013694957565848,0.3986305042434152,away,CLE,over,7.5,0.5121951219512195,-105,0.48919479393107135,SD,CLE,2022 REG,6,0,13,7,7,19,0,1,-7,7,0,0,0,0,0,0,0,0,0,0.48919479393107135,0.5108052060689287
87054,0.6226415094339623,0.41152263374485604,-165,143,0.6013694957565848,0.3986305042434152,home,SD,under,7.5,0.5327102803738317,-114,0.5108052060689287,SD,CLE,2022 REG,6,0,13,7,7,19,0,1,-7,7,0,0,0,0,0,0,0,0,0,0.48919479393107135,0.5108052060689287
87055,0.6551724137931035,0.3802281368821293,-190,163,0.6319789495576061,0.36802105044239386,away,CIN,over,8.5,0.5073891625615764,-103,0.4837652908580103,STL,CIN,2022 REG,7,5,12,4,9,19,1,0,1,-1,1,1,1,1,0,0,0,0,0,0.4837652908580103,0.5162347091419897
87055,0.6551724137931035,0.3802281368821293,-190,163,0.6319789495576061,0.36802105044239386,home,STL,under,8.5,0.5391705069124424,-117,0.5162347091419897,STL,CIN,2022 REG,7,5,12,4,9,19,1,0,1,-1,1,1,1,1,0,0,0,0,0,0.4837652908580103,0.5162347091419897
87056,0.6363636363636364,0.4081632653061224,-175,145,0.6080283353010626,0.3919716646989374,away,STL,over,8.5,0.5348837209302326,-115,0.5097020142727117,ATL,STL,2022 REG,5,3,7,0,3,12,1,0,3,-3,0,0,0,0,0,0,0,0,0,0.5097020142727117,0.49029798572728833
87056,0.6363636363636364,0.4081632653061224,-175,145,0.6080283353010626,0.3919716646989374,home,ATL,under,8.5,0.5121951219512195,-105,0.49029798572728833,ATL,STL,2022 REG,5,3,7,0,3,12,1,0,3,-3,0,0,0,0,0,0,0,0,0,0.5097020142727117,0.49029798572728833
87057,0.5305164319248826,0.5098039215686274,-113,-104,0.5091258218555558,0.49087417814444423,away,SEA,over,9,0.5121951219512195,-105,0.48919479393107135,BOS,SEA,2022 REG,8,7,5,3,10,13,1,0,4,-4,1,1,1,0,0,0,0,0,0,0.48919479393107135,0.5108052060689287
87057,0.5305164319248826,0.5098039215686274,-113,-104,0.5091258218555558,0.49087417814444423,home,BOS,under,9,0.5327102803738317,-114,0.5108052060689287,BOS,SEA,2022 REG,8,7,5,3,10,13,1,0,4,-4,1,1,1,0,0,0,0,0,0,0.48919479393107135,0.5108052060689287
87058,0.48780487804878053,0.5475113122171946,105,-121,0.470577468162939,0.529422531837061,away,CWS,over,8,0.504950495049505,-102,0.48054649490447493,KC,CWS,2022 REG,9,4,7,2,6,16,1,0,2,-2,1,1,0,0,0,0,0,0,0,0.48054649490447493,0.5194535050955251
87058,0.48780487804878053,0.5475113122171946,105,-121,0.470577468162939,0.529422531837061,home,KC,under,8,0.5433789954337899,-119,0.5194535050955251,KC,CWS,2022 REG,9,4,7,2,6,16,1,0,2,-2,1,1,0,0,0,0,0,0,0,0.48054649490447493,0.5194535050955251
87059,0.6363636363636364,0.3921568627450981,-175,155,0.6182142278398962,0.3817857721601038,away,CIN,over,7.5,0.5145631067961165,-106,0.4913668392989033,SD,CIN,2022 REG,7,4,6,1,5,13,1,0,3,-3,1,0,0,0,0,0,0,0,0,0.4913668392989033,0.5086331607010968
87059,0.6363636363636364,0.3921568627450981,-175,155,0.6182142278398962,0.3817857721601038,home,SD,under,7.5,0.5305164319248826,-113,0.5086331607010968,SD,CIN,2022 REG,7,4,6,1,5,13,1,0,3,-3,1,0,0,0,0,0,0,0,0,0.4913668392989033,0.5086331607010968
87060,0.46511627906976744,0.5726495726495727,115,-134,0.4475507666421673,0.5524492333578327,away,MIL,over,6.5,0.5192307692307692,-108,0.49571111079951763,SD,MIL,2022 REG,8,1,5,4,5,13,0,1,-3,3,1,0,0,0,0,0,0,0,0,0.49571111079951763,0.5042888892004824
87060,0.46511627906976744,0.5726495726495727,115,-134,0.4475507666421673,0.5524492333578327,home,SD,under,6.5,0.5260663507109005,-111,0.5042888892004824,SD,MIL,2022 REG,8,1,5,4,5,13,0,1,-3,3,1,0,0,0,0,0,0,0,0,0.49571111079951763,0.5042888892004824
87061,0.6503496503496503,0.3846153846153846,-186,160,0.6276101520856765,0.3723898479143235,away,OAK,over,7.5,0.5098039215686274,-104,0.4870219861770517,TB,OAK,2022 REG,8,2,5,4,6,13,0,1,-2,2,1,1,0,0,0,0,0,0,0,0.4870219861770517,0.5129780138229483
87061,0.6503496503496503,0.3846153846153846,-186,160,0.6276101520856765,0.3723898479143235,home,TB,under,7.5,0.5348837209302326,-115,0.5129780138229483,TB,OAK,2022 REG,8,2,5,4,6,13,0,1,-2,2,1,1,0,0,0,0,0,0,0,0.4870219861770517,0.5129780138229483
87062,0.5454545454545454,0.5,-120,100,0.5206611570247933,0.4793388429752067,away,OAK,over,7.5,0.5073891625615764,-103,0.4816299493915137,DET,OAK,2022 REG,6,3,5,5,8,11,0,1,-2,2,1,1,1,0,0,0,0,0,0,0.4816299493915137,0.5183700506084863
87062,0.5454545454545454,0.5,-120,100,0.5206611570247933,0.4793388429752067,home,DET,under,7.5,0.5433789954337899,-119,0.5183700506084863,DET,OAK,2022 REG,6,3,5,5,8,11,0,1,-2,2,1,1,1,0,0,0,0,0,0,0.4816299493915137,0.5183700506084863
87063,0.4347826086956522,0.6031746031746031,130,-152,0.418279473099889,0.581720526900111,away,TB,over,8.5,0.5348837209302326,-115,0.5097020142727117,KC,TB,2022 REG,14,4,5,2,6,19,1,0,2,-2,1,1,0,0,0,0,0,0,0,0.5097020142727117,0.49029798572728833
87063,0.4347826086956522,0.6031746031746031,130,-152,0.418279473099889,0.581720526900111,home,KC,under,8.5,0.5121951219512195,-105,0.49029798572728833,KC,TB,2022 REG,14,4,5,2,6,19,1,0,2,-2,1,1,0,0,0,0,0,0,0,0.5097020142727117,0.49029798572728833
87064,0.6254681647940076,0.41152263374485604,-167,143,0.6023315979176397,0.3976684020823603,away,ARI,over,9,0.5215311004784688,-109,0.4955416477869355,CLE,ARI,2022 REG,10,6,9,5,11,19,1,0,1,-1,1,1,1,1,1,0,0,0,0,0.4955416477869355,0.5044583522130646
87064,0.6254681647940076,0.41152263374485604,-167,143,0.6023315979176397,0.3976684020823603,home,CLE,under,9,0.5283018867924528,-112,0.5044583522130646,CLE,ARI,2022 REG,10,6,9,5,11,19,1,0,1,-1,1,1,1,1,1,0,0,0,0,0.4955416477869355,0.5044583522130646
87065,0.5815899581589958,0.45454545454545453,-139,120,0.5605739649961564,0.4394260350038436,away,MIA,over,8.5,0.5145631067961165,-106,0.4913668392989033,ATL,MIA,2022 REG,7,4,11,5,9,18,0,1,-1,1,1,1,1,1,0,0,0,0,0,0.4913668392989033,0.5086331607010968
87065,0.5815899581589958,0.45454545454545453,-139,120,0.5605739649961564,0.4394260350038436,home,ATL,under,8.5,0.5305164319248826,-113,0.5086331607010968,ATL,MIA,2022 REG,7,4,11,5,9,18,0,1,-1,1,1,1,1,1,0,0,0,0,0,0.4913668392989033,0.5086331607010968
87066,0.4166666666666667,0.6183206106870228,140,-162,0.40208863443596277,0.5979113655640372,away,SD,over,9,0.5215311004784688,-109,0.4978845547971712,ARI,SD,2022 REG,7,4,3,0,4,10,1,0,4,-4,0,0,0,0,0,0,0,0,0,0.4978845547971712,0.5021154452028288
87066,0.4166666666666667,0.6183206106870228,140,-162,0.40208863443596277,0.5979113655640372,home,ARI,under,9,0.5238095238095238,-110,0.5021154452028288,ARI,SD,2022 REG,7,4,3,0,4,10,1,0,4,-4,0,0,0,0,0,0,0,0,0,0.4978845547971712,0.5021154452028288
87067,0.7142857142857143,0.3333333333333333,-250,200,0.6802721088435374,0.3197278911564626,away,TB,over,7,0.5454545454545454,-120,0.5206611570247933,NYY,TB,2022 REG,7,0,7,4,4,14,0,1,-4,4,0,0,0,0,0,0,0,0,0,0.5206611570247933,0.4793388429752067
87067,0.7142857142857143,0.3333333333333333,-250,200,0.6802721088435374,0.3197278911564626,home,NYY,under,7,0.5,100,0.4793388429752067,NYY,TB,2022 REG,7,0,7,4,4,14,0,1,-4,4,0,0,0,0,0,0,0,0,0,0.5206611570247933,0.4793388429752067
87068,0.5967741935483871,0.4444444444444444,-148,125,0.5721759741010521,0.42782402589894786,away,CIN,over,8.5,0.5454545454545454,-120,0.5206611570247933,BOS,CIN,2022 REG,4,1,8,2,3,12,0,1,-1,1,1,0,0,0,0,0,0,0,0,0.5206611570247933,0.4793388429752067
87068,0.5967741935483871,0.4444444444444444,-148,125,0.5721759741010521,0.42782402589894786,home,BOS,under,8.5,0.5,100,0.4793388429752067,BOS,CIN,2022 REG,4,1,8,2,3,12,0,1,-1,1,1,0,0,0,0,0,0,0,0,0.5206611570247933,0.4793388429752067
87069,0.6389891696750902,0.4,-177,150,0.614075512518083,0.385924487481917,away,ARI,over,7.5,0.5,100,0.4772727272727273,STL,ARI,2022 REG,5,2,9,6,8,14,0,1,-4,4,1,1,0,0,0,0,0,0,0,0.4772727272727273,0.5227272727272727
87069,0.6389891696750902,0.4,-177,150,0.614075512518083,0.385924487481917,home,STL,under,7.5,0.5454545454545454,-120,0.5227272727272727,STL,ARI,2022 REG,5,2,9,6,8,14,0,1,-4,4,1,1,0,0,0,0,0,0,0,0.4772727272727273,0.5227272727272727
87070,0.43859649122807015,0.5967741935483871,128,-148,0.4230830329927819,0.5769169670072181,away,LAD,over,8,0.5073891625615764,-103,0.4837652908580103,SD,LAD,2022 REG,9,4,11,8,12,20,0,1,-4,4,1,1,1,1,0,0,0,0,0,0.4837652908580103,0.5162347091419897
87070,0.43859649122807015,0.5967741935483871,128,-148,0.4230830329927819,0.5769169670072181,home,SD,under,8,0.5391705069124424,-117,0.5162347091419897,SD,LAD,2022 REG,9,4,11,8,12,20,0,1,-4,4,1,1,1,1,0,0,0,0,0,0.4837652908580103,0.5162347091419897
87071,0.7142857142857143,0.3278688524590164,-250,205,0.6841753094680495,0.3158246905319505,away,KC,over,8.5,0.5454545454545454,-120,0.5206611570247933,NYY,KC,2022 REG,2,1,4,0,1,6,1,0,1,-1,0,0,0,0,0,0,0,0,0,0.5206611570247933,0.4793388429752067
87071,0.7142857142857143,0.3278688524590164,-250,205,0.6841753094680495,0.3158246905319505,home,NYY,under,8.5,0.5,100,0.4793388429752067,NYY,KC,2022 REG,2,1,4,0,1,6,1,0,1,-1,0,0,0,0,0,0,0,0,0,0.5206611570247933,0.4793388429752067
87072,0.5121951219512195,0.5348837209302326,-105,-115,0.48808156828023186,0.5119184317197681,away,MIL,over,8.5,0.5412844036697247,-118,0.5149381613977361,ARI,MIL,2022 REG,6,2,9,1,3,15,1,0,1,-1,1,0,0,0,0,0,0,0,0,0.5149381613977361,0.48506183860226393
87072,0.5121951219512195,0.5348837209302326,-105,-115,0.48808156828023186,0.5119184317197681,home,ARI,under,8.5,0.5073891625615764,-103,0.48506183860226393,ARI,MIL,2022 REG,6,2,9,1,3,15,1,0,1,-1,1,0,0,0,0,0,0,0,0,0.5149381613977361,0.48506183860226393
87073,0.6000000000000001,0.43859649122807015,-150,128,0.5768421052631579,0.42315789473684207,away,PIT,over,9.5,0.5215311004784688,-109,0.4978845547971712,WSH,PIT,2022 REG,10,3,7,2,5,17,1,0,1,-1,1,1,0,0,0,0,0,0,0,0.4978845547971712,0.5021154452028288
87073,0.6000000000000001,0.43859649122807015,-150,128,0.5768421052631579,0.42315789473684207,home,WSH,under,9.5,0.5238095238095238,-110,0.5021154452028288,WSH,PIT,2022 REG,10,3,7,2,5,17,1,0,1,-1,1,1,0,0,0,0,0,0,0,0.4978845547971712,0.5021154452028288
87074,0.6183206106870228,0.4166666666666667,-162,140,0.5966872559874133,0.40331274401258665,away,CIN,over,8,0.5169082125603864,-107,0.49353874091423283,CLE,CIN,2022 REG,5,4,9,5,9,14,0,1,-1,1,1,1,1,1,0,0,0,0,0,0.49353874091423283,0.5064612590857671
87074,0.6183206106870228,0.4166666666666667,-162,140,0.5966872559874133,0.40331274401258665,home,CLE,under,8,0.5283018867924528,-112,0.5064612590857671,CLE,CIN,2022 REG,5,4,9,5,9,14,0,1,-1,1,1,1,1,1,0,0,0,0,0,0.49353874091423283,0.5064612590857671
87075,0.5283018867924528,0.5121951219512195,-112,-105,0.5069072406637203,0.4930927593362797,away,BOS,over,9,0.5283018867924528,-112,0.5044173060022736,CWS,BOS,2022 REG,10,7,19,16,23,29,0,1,-9,9,1,1,1,1,1,1,1,0,0,0.5044173060022736,0.49558269399772636
87075,0.5283018867924528,0.5121951219512195,-112,-105,0.5069072406637203,0.4930927593362797,home,CWS,under,9,0.5169082125603864,-107,0.49558269399772636,CWS,BOS,2022 REG,10,7,19,16,23,29,0,1,-9,9,1,1,1,1,1,1,1,0,0,0.5044173060022736,0.49558269399772636
87076,0.4444444444444444,0.5967741935483871,125,-148,0.42612504978096366,0.5738749502190363,away,ATL,over,11,0.5098039215686274,-104,0.4870219861770517,COL,ATL,2022 REG,13,6,18,13,19,31,0,1,-7,7,1,1,1,1,1,1,0,0,0,0.4870219861770517,0.5129780138229483
87076,0.4444444444444444,0.5967741935483871,125,-148,0.42612504978096366,0.5738749502190363,home,COL,under,11,0.5348837209302326,-115,0.5129780138229483,COL,ATL,2022 REG,13,6,18,13,19,31,0,1,-7,7,1,1,1,1,1,1,0,0,0,0.4870219861770517,0.5129780138229483
87077,0.5555555555555556,0.4807692307692307,-125,108,0.5353751187084521,0.4646248812915479,away,CLE,over,8.5,0.5454545454545454,-120,0.5206611570247933,KC,CLE,2022 REG,10,4,9,3,7,19,1,0,1,-1,1,1,1,0,0,0,0,0,0,0.5206611570247933,0.4793388429752067
87077,0.5555555555555556,0.4807692307692307,-125,108,0.5353751187084521,0.4646248812915479,home,KC,under,8.5,0.5,100,0.4793388429752067,KC,CLE,2022 REG,10,4,9,3,7,19,1,0,1,-1,1,1,1,0,0,0,0,0,0,0.5206611570247933,0.4793388429752067
87078,0.6153846153846154,0.4166666666666667,-160,140,0.5956607495069033,0.4043392504930967,away,BAL,over,8.5,0.5370370370370371,-116,0.5118817074154765,CWS,BAL,2022 REG,9,0,10,4,4,19,0,1,-4,4,0,0,0,0,0,0,0,0,0,0.5118817074154765,0.48811829258452355
87078,0.6153846153846154,0.4166666666666667,-160,140,0.5956607495069033,0.4043392504930967,home,CWS,under,8.5,0.5098039215686274,-104,0.48811829258452355,CWS,BAL,2022 REG,9,0,10,4,4,19,0,1,-4,4,0,0,0,0,0,0,0,0,0,0.5118817074154765,0.48811829258452355
87079,0.6551724137931035,0.38759689922480617,-190,158,0.6271511397468869,0.37284886025311315,away,LAA,over,9,0.504950495049505,-102,0.47949844489399435,TOR,LAA,2022 REG,6,0,13,12,12,19,0,1,-12,12,0,0,0,0,0,0,0,0,0,0.47949844489399435,0.5205015551060057
87079,0.6551724137931035,0.38759689922480617,-190,158,0.6271511397468869,0.37284886025311315,home,TOR,under,9,0.5454545454545454,-120,0.5205015551060057,TOR,LAA,2022 REG,6,0,13,12,12,19,0,1,-12,12,0,0,0,0,0,0,0,0,0,0.47949844489399435,0.5205015551060057
87080,0.42016806722689076,0.6183206106870228,138,-162,0.4039963538176834,0.5960036461823166,away,HOU,over,7.5,0.5370370370370371,-116,0.5118817074154765,SEA,HOU,2022 REG,3,0,8,4,4,11,0,1,-4,4,0,0,0,0,0,0,0,0,0,0.5118817074154765,0.48811829258452355
87080,0.42016806722689076,0.6183206106870228,138,-162,0.4039963538176834,0.5960036461823166,home,SEA,under,7.5,0.5098039215686274,-104,0.48811829258452355,SEA,HOU,2022 REG,3,0,8,4,4,11,0,1,-4,4,0,0,0,0,0,0,0,0,0,0.5118817074154765,0.48811829258452355
87081,0.3333333333333333,0.7142857142857143,200,-250,0.31746031746031744,0.6825396825396826,away,SF,over,7.5,0.49751243781094534,101,0.4740985137509976,OAK,SF,2022 REG,10,3,11,7,10,21,0,1,-4,4,1,1,1,0,0,0,0,0,0,0.4740985137509976,0.5259014862490023
87081,0.3333333333333333,0.7142857142857143,200,-250,0.31746031746031744,0.6825396825396826,home,OAK,under,7.5,0.5495495495495495,-122,0.5259014862490023,OAK,SF,2022 REG,10,3,11,7,10,21,0,1,-4,4,1,1,1,0,0,0,0,0,0,0.4740985137509976,0.5259014862490023
87082,0.7142857142857143,0.3278688524590164,-250,205,0.6841753094680495,0.3158246905319505,away,PIT,over,8.5,0.5454545454545454,-120,0.5206611570247933,PHI,PIT,2022 REG,4,0,9,5,5,13,0,1,-5,5,0,0,0,0,0,0,0,0,0,0.5206611570247933,0.4793388429752067
87082,0.7142857142857143,0.3278688524590164,-250,205,0.6841753094680495,0.3158246905319505,home,PHI,under,8.5,0.5,100,0.4793388429752067,PHI,PIT,2022 REG,4,0,9,5,5,13,0,1,-5,5,0,0,0,0,0,0,0,0,0,0.5206611570247933,0.4793388429752067
87083,0.6491228070175439,0.4065040650406504,-185,146,0.6130141356815231,0.3869858643184769,away,CHC,over,8,0.504950495049505,-102,0.47949844489399435,SD,CHC,2022 REG,12,5,9,7,12,21,0,1,-2,2,1,1,1,1,1,0,0,0,0,0.47949844489399435,0.5205015551060057
87083,0.6491228070175439,0.4065040650406504,-185,146,0.6130141356815231,0.3869858643184769,home,SD,under,8,0.5454545454545454,-120,0.5205015551060057,SD,CHC,2022 REG,12,5,9,7,12,21,0,1,-2,2,1,1,1,1,1,0,0,0,0,0.47949844489399435,0.5205015551060057
87084,0.6183206106870228,0.4166666666666667,-162,140,0.5966872559874133,0.40331274401258665,away,TEX,over,8.5,0.5121951219512195,-105,0.48808156828023186,LAA,TEX,2022 REG,11,4,5,1,5,16,1,0,3,-3,1,0,0,0,0,0,0,0,0,0.48808156828023186,0.5119184317197681
87084,0.6183206106870228,0.4166666666666667,-162,140,0.5966872559874133,0.40331274401258665,home,LAA,under,8.5,0.5348837209302326,-115,0.5119184317197681,LAA,TEX,2022 REG,11,4,5,1,5,16,1,0,3,-3,1,0,0,0,0,0,0,0,0,0.48808156828023186,0.5119184317197681
87085,0.6226415094339623,0.41152263374485604,-165,143,0.6013694957565848,0.3986305042434152,away,DET,over,8,0.5283018867924528,-112,0.5044173060022736,HOU,DET,2022 REG,8,3,9,2,5,17,1,0,1,-1,1,1,0,0,0,0,0,0,0,0.5044173060022736,0.49558269399772636
87085,0.6226415094339623,0.41152263374485604,-165,143,0.6013694957565848,0.3986305042434152,home,HOU,under,8,0.5169082125603864,-107,0.49558269399772636,HOU,DET,2022 REG,8,3,9,2,5,17,1,0,1,-1,1,1,0,0,0,0,0,0,0,0.5044173060022736,0.49558269399772636
87086,0.6428571428571428,0.3921568627450981,-180,155,0.6203481392557023,0.3796518607442977,away,CIN,over,8.5,0.5260663507109005,-111,0.5022370601254724,ATL,CIN,2022 REG,8,7,6,6,13,14,1,0,1,-1,1,1,1,1,1,1,0,0,0,0.5022370601254724,0.4977629398745276
87086,0.6428571428571428,0.3921568627450981,-180,155,0.6203481392557023,0.3796518607442977,home,ATL,under,8.5,0.5192307692307692,-108,0.4977629398745276,ATL,CIN,2022 REG,8,7,6,6,13,14,1,0,1,-1,1,1,1,1,1,1,0,0,0,0.5022370601254724,0.4977629398745276
87087,0.35211267605633806,0.6923076923076923,184,-225,0.33647170128027104,0.663528298719729,away,MIL,over,8,0.504950495049505,-102,0.4826715732667395,CIN,MIL,2022 REG,4,2,13,10,12,17,0,1,-8,8,1,1,0,0,0,0,0,0,0,0.4826715732667395,0.5173284267332605
87087,0.35211267605633806,0.6923076923076923,184,-225,0.33647170128027104,0.663528298719729,home,CIN,under,8,0.5391705069124424,-117,0.5173284267332605,CIN,MIL,2022 REG,4,2,13,10,12,17,0,1,-8,8,1,1,0,0,0,0,0,0,0,0.4826715732667395,0.5173284267332605
87088,0.5708154506437768,0.4694835680751174,-133,113,0.5478121481132493,0.4521878518867507,away,ATL,over,9,0.5260663507109005,-111,0.5010269332605688,NYM,ATL,2022 REG,13,8,12,5,13,25,1,0,3,-3,1,1,1,1,1,0,0,0,0,0.5010269332605688,0.4989730667394312
87088,0.5708154506437768,0.4694835680751174,-133,113,0.5478121481132493,0.4521878518867507,home,NYM,under,9,0.5215311004784688,-109,0.4989730667394312,NYM,ATL,2022 REG,13,8,12,5,13,25,1,0,3,-3,1,1,1,1,1,0,0,0,0,0.5010269332605688,0.4989730667394312
87089,0.7701149425287357,0.27027027027027023,-335,270,0.7390136866950185,0.26098631330498145,away,COL,over,8.5,0.5260663507109005,-111,0.5022370601254724,ATL,COL,2022 REG,5,3,6,2,5,11,1,0,1,-1,1,1,0,0,0,0,0,0,0,0.5022370601254724,0.4977629398745276
87089,0.7701149425287357,0.27027027027027023,-335,270,0.7390136866950185,0.26098631330498145,home,ATL,under,8.5,0.5192307692307692,-108,0.4977629398745276,ATL,COL,2022 REG,5,3,6,2,5,11,1,0,1,-1,1,1,0,0,0,0,0,0,0,0.5022370601254724,0.4977629398745276
87090,0.7402597402597403,0.29850746268656714,-285,235,0.7115619406761102,0.2884380593238898,away,LAA,over,7,0.5238095238095238,-110,0.4988662131519274,TB,LAA,2022 REG,5,4,7,3,7,12,1,0,1,-1,1,1,1,0,0,0,0,0,0,0.4988662131519274,0.5011337868480725
87090,0.7402597402597403,0.29850746268656714,-285,235,0.7115619406761102,0.2884380593238898,home,TB,under,7,0.5238095238095238,-110,0.5011337868480725,TB,LAA,2022 REG,5,4,7,3,7,12,1,0,1,-1,1,1,1,0,0,0,0,0,0,0.4988662131519274,0.5011337868480725
87091,0.5238095238095238,0.5238095238095238,-110,-110,0.4988662131519274,0.5011337868480725,away,CIN,over,8,0.5169082125603864,-107,0.49239402434819424,PIT,CIN,2022 REG,7,2,10,8,10,17,0,1,-6,6,1,1,0,0,0,0,0,0,0,0.49239402434819424,0.5076059756518058
87091,0.5238095238095238,0.5238095238095238,-110,-110,0.4988662131519274,0.5011337868480725,home,PIT,under,8,0.5305164319248826,-113,0.5076059756518058,PIT,CIN,2022 REG,7,2,10,8,10,17,0,1,-6,6,1,1,0,0,0,0,0,0,0,0.49239402434819424,0.5076059756518058
87092,0.5073891625615764,0.5305164319248826,-103,-113,0.4881562747186933,0.5118437252813067,away,ARI,over,8,0.5098039215686274,-104,0.48592421718142587,CWS,ARI,2022 REG,7,5,11,10,15,18,0,1,-5,5,1,1,1,1,1,0,0,0,0,0.48592421718142587,0.5140757828185741
87092,0.5073891625615764,0.5305164319248826,-103,-113,0.4881562747186933,0.5118437252813067,home,CWS,under,8,0.5370370370370371,-116,0.5140757828185741,CWS,ARI,2022 REG,7,5,11,10,15,18,0,1,-5,5,1,1,1,1,1,0,0,0,0,0.48592421718142587,0.5140757828185741
87093,0.5412844036697247,0.5073891625615764,-118,-103,0.5149381613977361,0.48506183860226393,away,SEA,over,8.5,0.5433789954337899,-119,0.5198077604720502,CWS,SEA,2022 REG,6,3,7,2,5,13,1,0,1,-1,1,1,0,0,0,0,0,0,0,0.5198077604720502,0.48019223952794976
87093,0.5412844036697247,0.5073891625615764,-118,-103,0.5149381613977361,0.48506183860226393,home,CWS,under,8.5,0.5,100,0.48019223952794976,CWS,SEA,2022 REG,6,3,7,2,5,13,1,0,1,-1,1,1,0,0,0,0,0,0,0,0.5198077604720502,0.48019223952794976
87094,0.6254681647940076,0.4166666666666667,-167,140,0.5991141690863948,0.4008858309136052,away,OAK,over,7,0.5495495495495495,-122,0.5263803278714742,SEA,OAK,2022 REG,8,7,12,6,13,20,1,0,1,-1,1,1,1,1,1,1,0,0,0,0.5263803278714742,0.47361967212852585
87094,0.6254681647940076,0.4166666666666667,-167,140,0.5991141690863948,0.4008858309136052,home,SEA,under,7,0.4926108374384236,103,0.47361967212852585,SEA,OAK,2022 REG,8,7,12,6,13,20,1,0,1,-1,1,1,1,1,1,1,0,0,0,0.5263803278714742,0.47361967212852585
87095,0.4166666666666667,0.6183206106870228,140,-162,0.40208863443596277,0.5979113655640372,away,TEX,over,8.5,0.5391705069124424,-117,0.5153817639191344,DET,TEX,2022 REG,8,1,4,3,4,12,0,1,-2,2,1,0,0,0,0,0,0,0,0,0.5153817639191344,0.4846182360808656
87095,0.4166666666666667,0.6183206106870228,140,-162,0.40208863443596277,0.5979113655640372,home,DET,under,8.5,0.504950495049505,-102,0.4846182360808656,DET,TEX,2022 REG,8,1,4,3,4,12,0,1,-2,2,1,0,0,0,0,0,0,0,0,0.5153817639191344,0.4846182360808656
87096,0.5145631067961165,0.5238095238095238,-106,-110,0.4948179667757384,0.5051820332242616,away,CHC,over,7.5,0.5238095238095238,-110,0.4988662131519274,PIT,CHC,2022 REG,7,6,5,0,6,12,1,0,6,-6,0,0,0,0,0,0,0,0,0,0.4988662131519274,0.5011337868480725
87096,0.5145631067961165,0.5238095238095238,-106,-110,0.4948179667757384,0.5051820332242616,home,PIT,under,7.5,0.5238095238095238,-110,0.5011337868480725,PIT,CHC,2022 REG,7,6,5,0,6,12,1,0,6,-6,0,0,0,0,0,0,0,0,0,0.4988662131519274,0.5011337868480725
87097,0.613899613899614,0.425531914893617,-159,135,0.589692613597978,0.410307386402022,away,STL,over,8,0.5238095238095238,-110,0.4988662131519274,SD,STL,2022 REG,6,4,8,5,9,14,0,1,-1,1,1,1,1,1,0,0,0,0,0,0.4988662131519274,0.5011337868480725
87097,0.613899613899614,0.425531914893617,-159,135,0.589692613597978,0.410307386402022,home,SD,under,8,0.5238095238095238,-110,0.5011337868480725,SD,STL,2022 REG,6,4,8,5,9,14,0,1,-1,1,1,1,1,1,0,0,0,0,0,0.4988662131519274,0.5011337868480725
87098,0.5815899581589958,0.4587155963302753,-139,118,0.5581486524100054,0.44185134758999456,away,BOS,over,8.5,0.5121951219512195,-105,0.48919479393107135,TB,BOS,2022 REG,6,3,11,4,7,17,0,1,-1,1,1,1,1,0,0,0,0,0,0,0.48919479393107135,0.5108052060689287
87098,0.5815899581589958,0.4587155963302753,-139,118,0.5581486524100054,0.44185134758999456,home,TB,under,8.5,0.5327102803738317,-114,0.5108052060689287,TB,BOS,2022 REG,6,3,11,4,7,17,0,1,-1,1,1,1,1,0,0,0,0,0,0,0.48919479393107135,0.5108052060689287
87099,0.607843137254902,0.4291845493562232,-155,133,0.5853361120599043,0.4146638879400957,away,BAL,over,8,0.5121951219512195,-105,0.48919479393107135,TEX,BAL,2022 REG,6,3,9,6,9,15,0,1,-3,3,1,1,1,0,0,0,0,0,0,0.48919479393107135,0.5108052060689287
87099,0.607843137254902,0.4291845493562232,-155,133,0.5853361120599043,0.4146638879400957,home,TEX,under,8,0.5327102803738317,-114,0.5108052060689287,TEX,BAL,2022 REG,6,3,9,6,9,15,0,1,-3,3,1,1,1,0,0,0,0,0,0,0.48919479393107135,0.5108052060689287
87100,0.38759689922480617,0.6551724137931035,158,-190,0.37101964611708926,0.6289803538829107,away,TOR,over,8,0.5121951219512195,-105,0.48808156828023186,MIN,TOR,2022 REG,11,2,10,3,5,21,0,1,-1,1,1,1,0,0,0,0,0,0,0,0.48808156828023186,0.5119184317197681
87100,0.38759689922480617,0.6551724137931035,158,-190,0.37101964611708926,0.6289803538829107,home,MIN,under,8,0.5348837209302326,-115,0.5119184317197681,MIN,TOR,2022 REG,11,2,10,3,5,21,0,1,-1,1,1,1,0,0,0,0,0,0,0,0.48808156828023186,0.5119184317197681
87101,0.5073891625615764,0.5327102803738317,-103,-114,0.487043139791394,0.512956860208606,away,HOU,over,9.5,0.49751243781094534,101,0.476135829221149,TEX,HOU,2022 REG,3,1,6,5,6,9,0,1,-4,4,1,0,0,0,0,0,0,0,0,0.476135829221149,0.523864170778851
87101,0.5073891625615764,0.5327102803738317,-103,-114,0.487043139791394,0.512956860208606,home,TEX,under,9.5,0.5454545454545454,-120,0.523864170778851,TEX,HOU,2022 REG,3,1,6,5,6,9,0,1,-4,4,1,0,0,0,0,0,0,0,0,0.476135829221149,0.523864170778851
87102,0.576271186440678,0.46511627906976744,-136,115,0.552420782587201,0.44757921741279905,away,SEA,over,9,0.5454545454545454,-120,0.5166307047184789,MIN,SEA,2022 REG,10,4,2,0,4,12,1,0,4,-4,0,0,0,0,0,0,0,0,0,0.5166307047184789,0.48336929528152106
87102,0.576271186440678,0.46511627906976744,-136,115,0.552420782587201,0.44757921741279905,home,MIN,under,9,0.5073891625615764,-103,0.48336929528152106,MIN,SEA,2022 REG,10,4,2,0,4,12,1,0,4,-4,0,0,0,0,0,0,0,0,0,0.5166307047184789,0.48336929528152106
87103,0.7058823529411764,0.3389830508474576,-240,195,0.6742126561491995,0.32578734385080055,away,ARI,over,9,0.49504950495049505,102,0.4739797934813417,LAD,ARI,2022 REG,9,5,5,4,9,14,1,0,1,-1,1,1,1,1,0,0,0,0,0,0.4739797934813417,0.5260202065186583
87103,0.7058823529411764,0.3389830508474576,-240,195,0.6742126561491995,0.32578734385080055,home,LAD,under,9,0.5475113122171946,-121,0.5260202065186583,LAD,ARI,2022 REG,9,5,5,4,9,14,1,0,1,-1,1,1,1,1,0,0,0,0,0,0.4739797934813417,0.5260202065186583
87104,0.3921568627450981,0.6428571428571428,155,-180,0.37842588015598405,0.6215741198440159,away,NYM,over,8.5,0.5073891625615764,-103,0.4826927225525911,WSH,NYM,2022 REG,10,8,10,3,11,20,1,0,5,-5,1,1,1,0,0,0,0,0,0,0.4826927225525911,0.5173072774474089
87104,0.3921568627450981,0.6428571428571428,155,-180,0.37842588015598405,0.6215741198440159,home,WSH,under,8.5,0.5412844036697247,-118,0.5173072774474089,WSH,NYM,2022 REG,10,8,10,3,11,20,1,0,5,-5,1,1,1,0,0,0,0,0,0,0.4826927225525911,0.5173072774474089
87105,0.5967741935483871,0.43859649122807015,-148,128,0.5756658816656627,0.4243341183343373,away,NYY,over,8.5,0.5121951219512195,-105,0.48808156828023186,TOR,NYY,2022 REG,5,0,8,4,4,13,0,1,-4,4,0,0,0,0,0,0,0,0,0,0.48808156828023186,0.5119184317197681
87105,0.5967741935483871,0.43859649122807015,-148,128,0.5756658816656627,0.4243341183343373,home,TOR,under,8.5,0.5348837209302326,-115,0.5119184317197681,TOR,NYY,2022 REG,5,0,8,4,4,13,0,1,-4,4,0,0,0,0,0,0,0,0,0,0.48808156828023186,0.5119184317197681
87106,0.7101449275362319,0.3333333333333333,-245,200,0.6792690611216132,0.3207309388783868,away,CLE,over,6.5,0.5454545454545454,-120,0.5206611570247933,TB,CLE,2022 REG,8,3,9,5,8,17,0,1,-2,2,1,1,1,0,0,0,0,0,0,0.5206611570247933,0.4793388429752067
87106,0.7101449275362319,0.3333333333333333,-245,200,0.6792690611216132,0.3207309388783868,home,TB,under,6.5,0.5,100,0.4793388429752067,TB,CLE,2022 REG,8,3,9,5,8,17,0,1,-2,2,1,1,1,0,0,0,0,0,0,0.5206611570247933,0.4793388429752067
87107,0.6428571428571428,0.3846153846153846,-180,160,0.6251962323390895,0.3748037676609105,away,CIN,over,8.5,0.5169082125603864,-107,0.49239402434819424,ATL,CIN,2022 REG,4,3,10,6,9,14,0,1,-3,3,1,1,1,0,0,0,0,0,0,0.49239402434819424,0.5076059756518058
87107,0.6428571428571428,0.3846153846153846,-180,160,0.6251962323390895,0.3748037676609105,home,ATL,under,8.5,0.5305164319248826,-113,0.5076059756518058,ATL,CIN,2022 REG,4,3,10,6,9,14,0,1,-3,3,1,1,1,0,0,0,0,0,0,0.49239402434819424,0.5076059756518058
87108,0.5689655172413793,0.4672897196261683,-132,114,0.5483375376443265,0.45166246235567353,away,MIN,over,8.5,0.5391705069124424,-117,0.5153817639191344,CLE,MIN,2022 REG,12,7,7,6,13,19,1,0,1,-1,1,1,1,1,1,1,0,0,0,0.5153817639191344,0.4846182360808656
87108,0.5689655172413793,0.4672897196261683,-132,114,0.5483375376443265,0.45166246235567353,home,CLE,under,8.5,0.504950495049505,-102,0.4846182360808656,CLE,MIN,2022 REG,12,7,7,6,13,19,1,0,1,-1,1,1,1,1,1,1,0,0,0,0.5153817639191344,0.4846182360808656
87109,0.6666666666666666,0.37037037037037035,-200,170,0.6419753086419753,0.3580246913580247,away,BAL,over,6.5,0.5348837209302326,-115,0.5097020142727117,TB,BAL,2022 REG,11,8,9,2,10,20,1,0,6,-6,1,1,0,0,0,0,0,0,0,0.5097020142727117,0.49029798572728833
87109,0.6666666666666666,0.37037037037037035,-200,170,0.6419753086419753,0.3580246913580247,home,TB,under,6.5,0.5121951219512195,-105,0.49029798572728833,TB,BAL,2022 REG,11,8,9,2,10,20,1,0,6,-6,1,1,0,0,0,0,0,0,0,0.5097020142727117,0.49029798572728833
87110,0.4807692307692307,0.5652173913043479,108,-130,0.45866027784924107,0.541339722150759,away,MIN,over,7.5,0.5348837209302326,-115,0.5109810284308424,KC,MIN,2022 REG,10,5,7,2,7,17,1,0,3,-3,1,1,0,0,0,0,0,0,0,0.5109810284308424,0.48901897156915763
87110,0.4807692307692307,0.5652173913043479,108,-130,0.45866027784924107,0.541339722150759,home,KC,under,7.5,0.5098039215686274,-104,0.48901897156915763,KC,MIN,2022 REG,10,5,7,2,7,17,1,0,3,-3,1,1,0,0,0,0,0,0,0,0.5109810284308424,0.48901897156915763
87111,0.4484304932735426,0.5850622406639003,123,-141,0.43341133007289556,0.5665886699271044,away,ATL,over,9,0.5,100,0.4772727272727273,TEX,ATL,2022 REG,6,3,9,6,9,15,0,1,-3,3,1,1,1,0,0,0,0,0,0,0.4772727272727273,0.5227272727272727
87111,0.4484304932735426,0.5850622406639003,123,-141,0.43341133007289556,0.5665886699271044,home,TEX,under,9,0.5454545454545454,-120,0.5227272727272727,TEX,ATL,2022 REG,6,3,9,6,9,15,0,1,-3,3,1,1,1,0,0,0,0,0,0,0.4772727272727273,0.5227272727272727
87112,0.576271186440678,0.4587155963302753,-136,118,0.5561093116235184,0.4438906883764816,away,CIN,over,8.5,0.5215311004784688,-109,0.49907282342437215,WSH,CIN,2022 REG,8,2,12,6,8,20,0,1,-4,4,1,1,0,0,0,0,0,0,0,0.49907282342437215,0.5009271765756278
87112,0.576271186440678,0.4587155963302753,-136,118,0.5561093116235184,0.4438906883764816,home,WSH,under,8.5,0.5215311004784688,-109,0.5009271765756278,WSH,CIN,2022 REG,8,2,12,6,8,20,0,1,-4,4,1,1,0,0,0,0,0,0,0,0.49907282342437215,0.5009271765756278
87114,0.6551724137931035,0.3846153846153846,-190,160,0.6291045458703008,0.37089545412969915,away,KC,over,7.5,0.5348837209302326,-115,0.5097020142727117,TB,KC,2022 REG,12,7,6,1,8,18,1,0,6,-6,1,0,0,0,0,0,0,0,0,0.5097020142727117,0.49029798572728833
87114,0.6551724137931035,0.3846153846153846,-190,160,0.6291045458703008,0.37089545412969915,home,TB,under,7.5,0.5121951219512195,-105,0.49029798572728833,TB,KC,2022 REG,12,7,6,1,8,18,1,0,6,-6,1,0,0,0,0,0,0,0,0,0.5097020142727117,0.49029798572728833
87115,0.5967741935483871,0.4444444444444444,-148,125,0.5721759741010521,0.42782402589894786,away,LAA,over,7.5,0.5121951219512195,-105,0.48808156828023186,SEA,LAA,2022 REG,11,8,4,1,9,15,1,0,7,-7,1,0,0,0,0,0,0,0,0,0.48808156828023186,0.5119184317197681
87115,0.5967741935483871,0.4444444444444444,-148,125,0.5721759741010521,0.42782402589894786,home,SEA,under,7.5,0.5348837209302326,-115,0.5119184317197681,SEA,LAA,2022 REG,11,8,4,1,9,15,1,0,7,-7,1,0,0,0,0,0,0,0,0,0.48808156828023186,0.5119184317197681
87116,0.3472222222222222,0.6923076923076923,188,-225,0.3334965574548908,0.6665034425451092,away,SEA,over,6.5,0.5391705069124424,-117,0.5153817639191344,OAK,SEA,2022 REG,12,5,9,3,8,21,1,0,2,-2,1,1,1,0,0,0,0,0,0,0.5153817639191344,0.4846182360808656
87116,0.3472222222222222,0.6923076923076923,188,-225,0.3334965574548908,0.6665034425451092,home,OAK,under,6.5,0.504950495049505,-102,0.4846182360808656,OAK,SEA,2022 REG,12,5,9,3,8,21,1,0,2,-2,1,1,1,0,0,0,0,0,0,0.5153817639191344,0.4846182360808656
87117,0.5192307692307692,0.5169082125603864,-108,-107,0.5004662979161306,0.4995337020838694,away,WSH,over,8.5,0.5121951219512195,-105,0.48808156828023186,TEX,WSH,2022 REG,6,3,6,2,5,12,1,0,1,-1,1,1,0,0,0,0,0,0,0,0.48808156828023186,0.5119184317197681
87117,0.5192307692307692,0.5169082125603864,-108,-107,0.5004662979161306,0.4995337020838694,home,TEX,under,8.5,0.5348837209302326,-115,0.5119184317197681,TEX,WSH,2022 REG,6,3,6,2,5,12,1,0,1,-1,1,1,0,0,0,0,0,0,0,0.48808156828023186,0.5119184317197681
87118,0.6551724137931035,0.3846153846153846,-190,160,0.6291045458703008,0.37089545412969915,away,NYY,over,7.5,0.5121951219512195,-105,0.48808156828023186,NYM,NYY,2022 REG,9,3,7,2,5,16,1,0,1,-1,1,1,0,0,0,0,0,0,0,0.48808156828023186,0.5119184317197681
87118,0.6551724137931035,0.3846153846153846,-190,160,0.6291045458703008,0.37089545412969915,home,NYM,under,7.5,0.5348837209302326,-115,0.5119184317197681,NYM,NYY,2022 REG,9,3,7,2,5,16,1,0,1,-1,1,1,0,0,0,0,0,0,0,0.48808156828023186,0.5119184317197681
87119,0.6254681647940076,0.4166666666666667,-167,140,0.5991141690863948,0.4008858309136052,away,PHI,over,7.5,0.5169082125603864,-107,0.49353874091423283,ATL,PHI,2022 REG,14,6,10,5,11,24,1,0,1,-1,1,1,1,1,1,0,0,0,0,0.49353874091423283,0.5064612590857671
87119,0.6254681647940076,0.4166666666666667,-167,140,0.5991141690863948,0.4008858309136052,home,ATL,under,7.5,0.5283018867924528,-112,0.5064612590857671,ATL,PHI,2022 REG,14,6,10,5,11,24,1,0,1,-1,1,1,1,1,1,0,0,0,0,0.49353874091423283,0.5064612590857671
87120,0.4291845493562232,0.607843137254902,133,-155,0.41329283836432396,0.586707161635676,away,BOS,over,9.5,0.5,100,0.4772727272727273,CHC,BOS,2022 REG,8,3,5,1,4,13,1,0,2,-2,1,0,0,0,0,0,0,0,0,0.4772727272727273,0.5227272727272727
87120,0.4291845493562232,0.607843137254902,133,-155,0.41329283836432396,0.586707161635676,home,CHC,under,9.5,0.5454545454545454,-120,0.5227272727272727,CHC,BOS,2022 REG,8,3,5,1,4,13,1,0,2,-2,1,0,0,0,0,0,0,0,0,0.4772727272727273,0.5227272727272727
87121,0.5884773662551441,0.4484304932735426,-143,123,0.5667579262855877,0.43324207371441226,away,CHC,over,7.5,0.5370370370370371,-116,0.5118817074154765,MIL,CHC,2022 REG,13,11,3,1,12,16,1,0,10,-10,1,0,0,0,0,0,0,0,0,0.5118817074154765,0.48811829258452355
87121,0.5884773662551441,0.4484304932735426,-143,123,0.5667579262855877,0.43324207371441226,home,MIL,under,7.5,0.5098039215686274,-104,0.48811829258452355,MIL,CHC,2022 REG,13,11,3,1,12,16,1,0,10,-10,1,0,0,0,0,0,0,0,0,0.5118817074154765,0.48811829258452355
87122,0.40322580645161293,0.6363636363636364,148,-175,0.387262321445464,0.612737678554536,away,CWS,over,7.5,0.5348837209302326,-115,0.5109810284308424,OAK,CWS,2022 REG,6,3,7,5,8,13,0,1,-2,2,1,1,1,0,0,0,0,0,0,0.5109810284308424,0.48901897156915763
87122,0.40322580645161293,0.6363636363636364,148,-175,0.387262321445464,0.612737678554536,home,OAK,under,7.5,0.5098039215686274,-104,0.48901897156915763,OAK,CWS,2022 REG,6,3,7,5,8,13,0,1,-2,2,1,1,1,0,0,0,0,0,0,0.5109810284308424,0.48901897156915763
87123,0.7101449275362319,0.3278688524590164,-245,205,0.6831496344961281,0.3168503655038719,away,PIT,over,8,0.5238095238095238,-110,0.4988662131519274,MIL,PIT,2022 REG,8,4,5,2,6,13,1,0,2,-2,1,1,0,0,0,0,0,0,0,0.4988662131519274,0.5011337868480725
87123,0.7101449275362319,0.3278688524590164,-245,205,0.6831496344961281,0.3168503655038719,home,MIL,under,8,0.5238095238095238,-110,0.5011337868480725,MIL,PIT,2022 REG,8,4,5,2,6,13,1,0,2,-2,1,1,0,0,0,0,0,0,0,0.4988662131519274,0.5011337868480725
87124,0.41152263374485604,0.6323529411764706,143,-172,0.39346684159616196,0.606533158403838,away,TOR,over,8.5,0.5238095238095238,-110,0.4988662131519274,BAL,TOR,2022 REG,12,6,9,5,11,21,1,0,1,-1,1,1,1,1,1,0,0,0,0,0.4988662131519274,0.5011337868480725
87124,0.41152263374485604,0.6323529411764706,143,-172,0.39346684159616196,0.606533158403838,home,BAL,under,8.5,0.5238095238095238,-110,0.5011337868480725,BAL,TOR,2022 REG,12,6,9,5,11,21,1,0,1,-1,1,1,1,1,1,0,0,0,0,0.4988662131519274,0.5011337868480725
87125,0.5,0.5327102803738317,100,-114,0.48364485981308414,0.5163551401869159,away,PHI,over,8,0.5145631067961165,-106,0.4913668392989033,ATL,PHI,2022 REG,8,4,9,3,7,17,1,0,1,-1,1,1,1,0,0,0,0,0,0,0.4913668392989033,0.5086331607010968
87125,0.5,0.5327102803738317,100,-114,0.48364485981308414,0.5163551401869159,home,ATL,under,8,0.5305164319248826,-113,0.5086331607010968,ATL,PHI,2022 REG,8,4,9,3,7,17,1,0,1,-1,1,1,1,0,0,0,0,0,0,0.4913668392989033,0.5086331607010968
87126,0.4081632653061224,0.6254681647940076,145,-167,0.39443615097953877,0.6055638490204612,away,PHI,over,9.5,0.5305164319248826,-113,0.5053568787472517,WSH,PHI,2022 REG,12,9,6,3,12,18,1,0,6,-6,1,1,1,0,0,0,0,0,0,0.5053568787472517,0.49464312125274834
87126,0.4081632653061224,0.6254681647940076,145,-167,0.39443615097953877,0.6055638490204612,home,WSH,under,9.5,0.5169082125603864,-107,0.49464312125274834,WSH,PHI,2022 REG,12,9,6,3,12,18,1,0,6,-6,1,1,1,0,0,0,0,0,0,0.5053568787472517,0.49464312125274834
87127,0.5327102803738317,0.5,-114,100,0.5152851777447812,0.4847148222552188,away,MIA,over,7.5,0.5,100,0.4772727272727273,ARI,MIA,2022 REG,4,3,15,11,14,19,0,1,-8,8,1,1,1,0,0,0,0,0,0,0.4772727272727273,0.5227272727272727
87127,0.5327102803738317,0.5,-114,100,0.5152851777447812,0.4847148222552188,home,ARI,under,7.5,0.5454545454545454,-120,0.5227272727272727,ARI,MIA,2022 REG,4,3,15,11,14,19,0,1,-8,8,1,1,1,0,0,0,0,0,0,0.4772727272727273,0.5227272727272727
87128,0.607843137254902,0.4347826086956522,-155,130,0.5819333701084867,0.41806662989151333,away,MIL,over,9,0.5238095238095238,-110,0.5000596729920038,MIN,MIL,2022 REG,6,3,7,6,9,13,0,1,-3,3,1,1,1,0,0,0,0,0,0,0.5000596729920038,0.4999403270079962
87128,0.607843137254902,0.4347826086956522,-155,130,0.5819333701084867,0.41806662989151333,home,MIN,under,9,0.5215311004784688,-109,0.4999403270079962,MIN,MIL,2022 REG,6,3,7,6,9,13,0,1,-3,3,1,1,1,0,0,0,0,0,0,0.5000596729920038,0.4999403270079962
87129,0.4716981132075471,0.5652173913043479,112,-130,0.4542851393811816,0.5457148606188185,away,LAA,over,8.5,0.5238095238095238,-110,0.5012646084074657,HOU,LAA,2022 REG,1,0,6,6,6,7,0,1,-6,6,0,0,0,0,0,0,0,0,0,0.5012646084074657,0.4987353915925343
87129,0.4716981132075471,0.5652173913043479,112,-130,0.4542851393811816,0.5457148606188185,home,HOU,under,8.5,0.5192307692307692,-108,0.4987353915925343,HOU,LAA,2022 REG,1,0,6,6,6,7,0,1,-6,6,0,0,0,0,0,0,0,0,0,0.5012646084074657,0.4987353915925343
87130,0.4587155963302753,0.5833333333333333,118,-140,0.4394270964845833,0.5605729035154168,away,NYM,over,7,0.5215311004784688,-109,0.4978845547971712,MIA,NYM,2022 REG,10,3,19,9,12,29,0,1,-6,6,1,1,1,0,0,0,0,0,0,0.4978845547971712,0.5021154452028288
87130,0.4587155963302753,0.5833333333333333,118,-140,0.4394270964845833,0.5605729035154168,home,MIA,under,7,0.5238095238095238,-110,0.5021154452028288,MIA,NYM,2022 REG,10,3,19,9,12,29,0,1,-6,6,1,1,1,0,0,0,0,0,0,0.4978845547971712,0.5021154452028288
87131,0.4065040650406504,0.6363636363636364,146,-175,0.389078170160859,0.610921829839141,away,CLE,over,7,0.5454545454545454,-120,0.5206611570247933,DET,CLE,2022 REG,10,5,6,3,8,16,1,0,2,-2,1,1,1,0,0,0,0,0,0,0.5206611570247933,0.4793388429752067
87131,0.4065040650406504,0.6363636363636364,146,-175,0.389078170160859,0.610921829839141,home,DET,under,7,0.5,100,0.4793388429752067,DET,CLE,2022 REG,10,5,6,3,8,16,1,0,2,-2,1,1,1,0,0,0,0,0,0,0.5206611570247933,0.4793388429752067
87132,0.4444444444444444,0.5918367346938775,125,-145,0.42831947593852354,0.5716805240614764,away,TOR,over,6.5,0.5348837209302326,-115,0.5097020142727117,CLE,TOR,2022 REG,11,8,4,2,10,15,1,0,6,-6,1,1,0,0,0,0,0,0,0,0.5097020142727117,0.49029798572728833
87132,0.4444444444444444,0.5918367346938775,125,-145,0.42831947593852354,0.5716805240614764,home,CLE,under,6.5,0.5121951219512195,-105,0.49029798572728833,CLE,TOR,2022 REG,11,8,4,2,10,15,1,0,6,-6,1,1,0,0,0,0,0,0,0,0.5097020142727117,0.49029798572728833
87133,0.6254681647940076,0.4166666666666667,-167,140,0.5991141690863948,0.4008858309136052,away,PIT,over,8.5,0.5327102803738317,-114,0.5050407492760537,BAL,PIT,2022 REG,11,6,6,3,9,17,1,0,3,-3,1,1,1,0,0,0,0,0,0,0.5050407492760537,0.4949592507239463
87133,0.6254681647940076,0.4166666666666667,-167,140,0.5991141690863948,0.4008858309136052,home,BAL,under,8.5,0.5192307692307692,-108,0.4949592507239463,BAL,PIT,2022 REG,11,6,6,3,9,17,1,0,3,-3,1,1,1,0,0,0,0,0,0,0.5050407492760537,0.4949592507239463
87134,0.6551724137931035,0.3802281368821293,-190,163,0.6319789495576061,0.36802105044239386,away,COL,over,8.5,0.5145631067961165,-106,0.49023796582517226,SD,COL,2022 REG,3,2,8,1,3,11,1,0,1,-1,1,0,0,0,0,0,0,0,0,0.49023796582517226,0.5097620341748277
87134,0.6551724137931035,0.3802281368821293,-190,163,0.6319789495576061,0.36802105044239386,home,SD,under,8.5,0.5327102803738317,-114,0.5097620341748277,SD,COL,2022 REG,3,2,8,1,3,11,1,0,1,-1,1,0,0,0,0,0,0,0,0,0.49023796582517226,0.5097620341748277
87135,0.47619047619047616,0.5633187772925764,110,-129,0.45737654596045113,0.5426234540395489,away,MIN,over,8,0.5121951219512195,-105,0.48808156828023186,CLE,MIN,2022 REG,5,1,14,11,12,19,0,1,-10,10,1,0,0,0,0,0,0,0,0,0.48808156828023186,0.5119184317197681
87135,0.47619047619047616,0.5633187772925764,110,-129,0.45737654596045113,0.5426234540395489,home,CLE,under,8,0.5348837209302326,-115,0.5119184317197681,CLE,MIN,2022 REG,5,1,14,11,12,19,0,1,-10,10,1,0,0,0,0,0,0,0,0,0.48808156828023186,0.5119184317197681
87136,0.4484304932735426,0.5884773662551441,123,-143,0.43187988361942303,0.5681201163805769,away,SD,over,12.5,0.5145631067961165,-106,0.4913668392989033,COL,SD,2022 REG,10,8,10,3,11,20,1,0,5,-5,1,1,1,0,0,0,0,0,0,0.4913668392989033,0.5086331607010968
87136,0.4484304932735426,0.5884773662551441,123,-143,0.43187988361942303,0.5681201163805769,home,COL,under,12.5,0.5305164319248826,-113,0.5086331607010968,COL,SD,2022 REG,10,8,10,3,11,20,1,0,5,-5,1,1,1,0,0,0,0,0,0,0.4913668392989033,0.5086331607010968
87137,0.5780590717299579,0.4587155963302753,-137,118,0.5568011412478822,0.44319885875211784,away,SEA,over,8.5,0.5169082125603864,-107,0.49353874091423283,HOU,SEA,2022 REG,8,3,10,6,9,18,0,1,-3,3,1,1,1,0,0,0,0,0,0,0.49353874091423283,0.5064612590857671
87137,0.5780590717299579,0.4587155963302753,-137,118,0.5568011412478822,0.44319885875211784,home,HOU,under,8.5,0.5283018867924528,-112,0.5064612590857671,HOU,SEA,2022 REG,8,3,10,6,9,18,0,1,-3,3,1,1,1,0,0,0,0,0,0,0.49353874091423283,0.5064612590857671
87138,0.5073891625615764,0.5305164319248826,-103,-113,0.4881562747186933,0.5118437252813067,away,TOR,over,9,0.5215311004784688,-109,0.4978845547971712,CWS,TOR,2022 REG,13,5,13,9,14,26,0,1,-4,4,1,1,1,1,1,0,0,0,0,0.4978845547971712,0.5021154452028288
87138,0.5073891625615764,0.5305164319248826,-103,-113,0.4881562747186933,0.5118437252813067,home,CWS,under,9,0.5238095238095238,-110,0.5021154452028288,CWS,TOR,2022 REG,13,5,13,9,14,26,0,1,-4,4,1,1,1,1,1,0,0,0,0,0.4978845547971712,0.5021154452028288
87139,0.7142857142857143,0.3333333333333333,-250,200,0.6802721088435374,0.3197278911564626,away,WSH,over,7.5,0.5121951219512195,-105,0.48808156828023186,SF,WSH,2022 REG,11,9,11,3,12,22,1,0,6,-6,1,1,1,0,0,0,0,0,0,0.48808156828023186,0.5119184317197681
87139,0.7142857142857143,0.3333333333333333,-250,200,0.6802721088435374,0.3197278911564626,home,SF,under,7.5,0.5348837209302326,-115,0.5119184317197681,SF,WSH,2022 REG,11,9,11,3,12,22,1,0,6,-6,1,1,1,0,0,0,0,0,0,0.48808156828023186,0.5119184317197681
87140,0.5348837209302326,0.5,-115,100,0.5162249864791779,0.4837750135208221,away,NYM,over,7.5,0.5192307692307692,-108,0.49571111079951763,SD,NYM,2022 REG,7,5,16,11,16,23,0,1,-6,6,1,1,1,1,1,0,0,0,0,0.49571111079951763,0.5042888892004824
87140,0.5348837209302326,0.5,-115,100,0.5162249864791779,0.4837750135208221,home,SD,under,7.5,0.5260663507109005,-111,0.5042888892004824,SD,NYM,2022 REG,7,5,16,11,16,23,0,1,-6,6,1,1,1,1,1,0,0,0,0,0.49571111079951763,0.5042888892004824
87141,0.4424778761061947,0.5967741935483871,126,-148,0.4251097036926629,0.5748902963073371,away,CLE,over,7.5,0.5,100,0.4772727272727273,MIN,CLE,2022 REG,5,1,10,4,5,15,0,1,-3,3,1,0,0,0,0,0,0,0,0,0.4772727272727273,0.5227272727272727
87141,0.4424778761061947,0.5967741935483871,126,-148,0.4251097036926629,0.5748902963073371,home,MIN,under,7.5,0.5454545454545454,-120,0.5227272727272727,MIN,CLE,2022 REG,5,1,10,4,5,15,0,1,-3,3,1,0,0,0,0,0,0,0,0,0.4772727272727273,0.5227272727272727
87142,0.5121951219512195,0.5238095238095238,-105,-110,0.4937537180249852,0.5062462819750149,away,OAK,over,8.5,0.5192307692307692,-108,0.49340049170764233,WSH,OAK,2022 REG,9,5,5,1,6,14,1,0,4,-4,1,0,0,0,0,0,0,0,0,0.49340049170764233,0.5065995082923577
87142,0.5121951219512195,0.5238095238095238,-105,-110,0.4937537180249852,0.5062462819750149,home,WSH,under,8.5,0.5305164319248826,-113,0.5065995082923577,WSH,OAK,2022 REG,9,5,5,1,6,14,1,0,4,-4,1,0,0,0,0,0,0,0,0,0.49340049170764233,0.5065995082923577
87143,0.4464285714285714,0.5918367346938775,124,-145,0.42934584548104954,0.5706541545189505,away,LAD,over,8.5,0.5121951219512195,-105,0.48808156828023186,SD,LAD,2022 REG,10,2,7,5,7,17,0,1,-3,3,1,1,0,0,0,0,0,0,0,0.48808156828023186,0.5119184317197681
87143,0.4464285714285714,0.5918367346938775,124,-145,0.42934584548104954,0.5706541545189505,home,SD,under,8.5,0.5348837209302326,-115,0.5119184317197681,SD,LAD,2022 REG,10,2,7,5,7,17,0,1,-3,3,1,1,0,0,0,0,0,0,0,0.48808156828023186,0.5119184317197681
87144,0.37735849056603776,0.6610169491525424,165,-195,0.36287719255902645,0.6371228074409736,away,NYY,over,7.5,0.5327102803738317,-114,0.5075272610403079,LAA,NYY,2022 REG,6,3,3,2,5,9,1,0,1,-1,1,1,0,0,0,0,0,0,0,0.5075272610403079,0.4924727389596921
87144,0.37735849056603776,0.6610169491525424,165,-195,0.36287719255902645,0.6371228074409736,home,LAA,under,7.5,0.5145631067961165,-106,0.4924727389596921,LAA,NYY,2022 REG,6,3,3,2,5,9,1,0,1,-1,1,1,0,0,0,0,0,0,0,0.5075272610403079,0.4924727389596921
87145,0.7142857142857143,0.3278688524590164,-250,205,0.6841753094680495,0.3158246905319505,away,COL,over,7,0.5348837209302326,-115,0.5097020142727117,SF,COL,2022 REG,9,6,7,4,10,16,1,0,2,-2,1,1,1,1,0,0,0,0,0,0.5097020142727117,0.49029798572728833
87145,0.7142857142857143,0.3278688524590164,-250,205,0.6841753094680495,0.3158246905319505,home,SF,under,7,0.5121951219512195,-105,0.49029798572728833,SF,COL,2022 REG,9,6,7,4,10,16,1,0,2,-2,1,1,1,1,0,0,0,0,0,0.5097020142727117,0.49029798572728833
87146,0.6610169491525424,0.3846153846153846,-195,160,0.6308532031025568,0.36914679689744323,away,TEX,over,8,0.5391705069124424,-117,0.5140669063204599,PHI,TEX,2022 REG,6,1,7,2,3,13,0,1,-1,1,1,0,0,0,0,0,0,0,0,0.5140669063204599,0.4859330936795401
87146,0.6610169491525424,0.3846153846153846,-195,160,0.6308532031025568,0.36914679689744323,home,PHI,under,8,0.5073891625615764,-103,0.4859330936795401,PHI,TEX,2022 REG,6,1,7,2,3,13,0,1,-1,1,1,0,0,0,0,0,0,0,0,0.5140669063204599,0.4859330936795401
87147,0.5652173913043479,0.4716981132075471,-130,112,0.5443521061454507,0.4556478938545493,away,CWS,over,8,0.5412844036697247,-118,0.5149381613977361,SF,CWS,2022 REG,7,4,17,13,17,24,0,1,-9,9,1,1,1,1,0,0,0,0,0,0.5149381613977361,0.48506183860226393
87147,0.5652173913043479,0.4716981132075471,-130,112,0.5443521061454507,0.4556478938545493,home,SF,under,8,0.5073891625615764,-103,0.48506183860226393,SF,CWS,2022 REG,7,4,17,13,17,24,0,1,-9,9,1,1,1,1,0,0,0,0,0,0.5149381613977361,0.48506183860226393
87148,0.6774193548387096,0.37037037037037035,-210,170,0.6450456700196554,0.3549543299803446,away,DET,over,7.5,0.5412844036697247,-118,0.5175913212324037,TB,DET,2022 REG,7,2,6,3,5,13,0,1,-1,1,1,1,0,0,0,0,0,0,0,0.5175913212324037,0.4824086787675963
87148,0.6774193548387096,0.37037037037037035,-210,170,0.6450456700196554,0.3549543299803446,home,TB,under,7.5,0.5024875621890548,-101,0.4824086787675963,TB,DET,2022 REG,7,2,6,3,5,13,0,1,-1,1,1,1,0,0,0,0,0,0,0,0.5175913212324037,0.4824086787675963
87149,0.5918367346938775,0.4484304932735426,-145,123,0.5680051099784656,0.43199489002153435,away,MIA,over,9,0.5,100,0.47935779816513757,STL,MIA,2022 REG,11,5,6,3,8,17,1,0,2,-2,1,1,1,0,0,0,0,0,0,0.47935779816513757,0.5206422018348624
87149,0.5918367346938775,0.4484304932735426,-145,123,0.5680051099784656,0.43199489002153435,home,STL,under,9,0.5412844036697247,-118,0.5206422018348624,STL,MIA,2022 REG,11,5,6,3,8,17,1,0,2,-2,1,1,1,0,0,0,0,0,0,0.47935779816513757,0.5206422018348624
87150,0.6551724137931035,0.3921568627450981,-190,155,0.6241635774404887,0.37583642255951133,away,DET,over,8.5,0.5454545454545454,-120,0.5220180091279142,CWS,DET,2022 REG,7,4,5,2,6,12,1,0,2,-2,1,1,0,0,0,0,0,0,0,0.5220180091279142,0.4779819908720858
87150,0.6551724137931035,0.3921568627450981,-190,155,0.6241635774404887,0.37583642255951133,home,CWS,under,8.5,0.49751243781094534,101,0.4779819908720858,CWS,DET,2022 REG,7,4,5,2,6,12,1,0,2,-2,1,1,0,0,0,0,0,0,0,0.5220180091279142,0.4779819908720858
87151,0.6183206106870228,0.4166666666666667,-162,140,0.5966872559874133,0.40331274401258665,away,HOU,over,8.5,0.5098039215686274,-104,0.48592421718142587,NYY,HOU,2022 REG,0,0,8,3,3,8,0,1,-3,3,0,0,0,0,0,0,0,0,0,0.48592421718142587,0.5140757828185741
87151,0.6183206106870228,0.4166666666666667,-162,140,0.5966872559874133,0.40331274401258665,home,NYY,under,8.5,0.5370370370370371,-116,0.5140757828185741,NYY,HOU,2022 REG,0,0,8,3,3,8,0,1,-3,3,0,0,0,0,0,0,0,0,0,0.48592421718142587,0.5140757828185741
87152,0.4347826086956522,0.6062992125984252,130,-154,0.4169209472634447,0.5830790527365552,away,NYM,over,7.5,0.5391705069124424,-117,0.5140669063204599,ATL,NYM,2022 REG,7,7,14,9,16,21,0,1,-2,2,1,1,1,1,1,1,1,0,0,0.5140669063204599,0.4859330936795401
87152,0.4347826086956522,0.6062992125984252,130,-154,0.4169209472634447,0.5830790527365552,home,ATL,under,7.5,0.5073891625615764,-103,0.4859330936795401,ATL,NYM,2022 REG,7,7,14,9,16,21,0,1,-2,2,1,1,1,1,1,1,1,0,0,0.5140669063204599,0.4859330936795401
87153,0.696969696969697,0.3389830508474576,-230,195,0.6719117212183469,0.32808827878165314,away,KC,over,6.5,0.5348837209302326,-115,0.5097020142727117,CLE,KC,2022 REG,10,7,12,5,12,22,1,0,2,-2,1,1,1,1,1,0,0,0,0,0.5097020142727117,0.49029798572728833
87153,0.696969696969697,0.3389830508474576,-230,195,0.6719117212183469,0.32808827878165314,home,CLE,under,6.5,0.5121951219512195,-105,0.49029798572728833,CLE,KC,2022 REG,10,7,12,5,12,22,1,0,2,-2,1,1,1,1,1,0,0,0,0,0.5097020142727117,0.49029798572728833
87154,0.4166666666666667,0.6183206106870228,140,-162,0.40208863443596277,0.5979113655640372,away,PHI,over,11.5,0.5,100,0.4772727272727273,COL,PHI,2022 REG,9,4,5,1,5,14,1,0,3,-3,1,0,0,0,0,0,0,0,0,0.4772727272727273,0.5227272727272727
87154,0.4166666666666667,0.6183206106870228,140,-162,0.40208863443596277,0.5979113655640372,home,COL,under,11.5,0.5454545454545454,-120,0.5227272727272727,COL,PHI,2022 REG,9,4,5,1,5,14,1,0,3,-3,1,0,0,0,0,0,0,0,0,0.4772727272727273,0.5227272727272727
87155,0.6453900709219857,0.3921568627450981,-182,155,0.6211576527396834,0.3788423472603166,away,NYM,over,9,0.49504950495049505,102,0.4739797934813417,LAD,NYM,2022 REG,9,4,8,5,9,17,0,1,-1,1,1,1,1,1,0,0,0,0,0,0.4739797934813417,0.5260202065186583
87155,0.6453900709219857,0.3921568627450981,-182,155,0.6211576527396834,0.3788423472603166,home,LAD,under,9,0.5475113122171946,-121,0.5260202065186583,LAD,NYM,2022 REG,9,4,8,5,9,17,0,1,-1,1,1,1,1,1,0,0,0,0,0,0.4739797934813417,0.5260202065186583
87156,0.5555555555555556,0.47619047619047616,-125,110,0.5379188712522047,0.4620811287477953,away,DET,over,8.5,0.5192307692307692,-108,0.49455035168025013,KC,DET,2022 REG,7,2,9,4,6,16,0,1,-2,2,1,1,0,0,0,0,0,0,0,0.49455035168025013,0.5054496483197499
87156,0.5555555555555556,0.47619047619047616,-125,110,0.5379188712522047,0.4620811287477953,home,KC,under,8.5,0.5283018867924528,-112,0.5054496483197499,KC,DET,2022 REG,7,2,9,4,6,16,0,1,-2,2,1,1,0,0,0,0,0,0,0,0.49455035168025013,0.5054496483197499
87157,0.48780487804878053,0.5412844036697247,105,-118,0.4736149845275584,0.5263850154724417,away,CLE,over,7.5,0.5,100,0.4772727272727273,KC,CLE,2022 REG,4,3,7,1,4,11,1,0,2,-2,1,0,0,0,0,0,0,0,0,0.4772727272727273,0.5227272727272727
87157,0.48780487804878053,0.5412844036697247,105,-118,0.4736149845275584,0.5263850154724417,home,KC,under,7.5,0.5454545454545454,-120,0.5227272727272727,KC,CLE,2022 REG,4,3,7,1,4,11,1,0,2,-2,1,0,0,0,0,0,0,0,0,0.4772727272727273,0.5227272727272727
87158,0.3448275862068966,0.6923076923076923,190,-225,0.3320223177535901,0.6679776822464099,away,SEA,over,7.5,0.4926108374384236,103,0.46986095270450623,OAK,SEA,2022 REG,6,2,4,1,3,10,1,0,1,-1,1,0,0,0,0,0,0,0,0,0.46986095270450623,0.5301390472954938
87158,0.3448275862068966,0.6923076923076923,190,-225,0.3320223177535901,0.6679776822464099,home,OAK,under,7.5,0.5535714285714286,-124,0.5301390472954938,OAK,SEA,2022 REG,6,2,4,1,3,10,1,0,1,-1,1,0,0,0,0,0,0,0,0,0.46986095270450623,0.5301390472954938
87159,0.5726495726495727,0.46511627906976744,-134,115,0.5510229738017454,0.44897702619825464,away,MIN,over,7.5,0.49504950495049505,102,0.4739797934813417,SD,MIN,2022 REG,8,4,9,7,11,17,0,1,-3,3,1,1,1,1,0,0,0,0,0,0.4739797934813417,0.5260202065186583
87159,0.5726495726495727,0.46511627906976744,-134,115,0.5510229738017454,0.44897702619825464,home,SD,under,7.5,0.5475113122171946,-121,0.5260202065186583,SD,MIN,2022 REG,8,4,9,7,11,17,0,1,-3,3,1,1,1,1,0,0,0,0,0,0.4739797934813417,0.5260202065186583
87160,0.6666666666666666,0.37735849056603776,-200,165,0.6373165618448637,0.36268343815513626,away,COL,over,7.5,0.5192307692307692,-108,0.49455035168025013,PHI,COL,2022 REG,4,7,5,1,8,9,1,0,6,-6,1,0,0,0,0,0,0,0,0,0.49455035168025013,0.5054496483197499
87160,0.6666666666666666,0.37735849056603776,-200,165,0.6373165618448637,0.36268343815513626,home,PHI,under,7.5,0.5283018867924528,-112,0.5054496483197499,PHI,COL,2022 REG,4,7,5,1,8,9,1,0,6,-6,1,0,0,0,0,0,0,0,0,0.49455035168025013,0.5054496483197499
87161,0.6875,0.37735849056603776,-220,165,0.6429097877358492,0.35709021226415083,away,SEA,over,7,0.5283018867924528,-112,0.5031902949311281,OAK,SEA,2022 REG,5,1,2,2,3,7,0,1,-1,1,1,0,0,0,0,0,0,0,0,0.5031902949311281,0.4968097050688719
87161,0.6875,0.37735849056603776,-220,165,0.6429097877358492,0.35709021226415083,home,OAK,under,7,0.5192307692307692,-108,0.4968097050688719,OAK,SEA,2022 REG,5,1,2,2,3,7,0,1,-1,1,1,0,0,0,0,0,0,0,0,0.5031902949311281,0.4968097050688719
87162,0.49019607843137253,0.5454545454545454,104,-120,0.4727202824088637,0.5272797175911363,away,CLE,over,8,0.5145631067961165,-106,0.4913668392989033,SEA,CLE,2022 REG,4,3,6,1,4,10,1,0,2,-2,1,0,0,0,0,0,0,0,0,0.4913668392989033,0.5086331607010968
87162,0.49019607843137253,0.5454545454545454,104,-120,0.4727202824088637,0.5272797175911363,home,SEA,under,8,0.5305164319248826,-113,0.5086331607010968,SEA,CLE,2022 REG,4,3,6,1,4,10,1,0,2,-2,1,0,0,0,0,0,0,0,0,0.4913668392989033,0.5086331607010968
87163,0.6062992125984252,0.4347826086956522,-154,130,0.581391336695717,0.41860866330428304,away,TOR,over,9.5,0.5121951219512195,-105,0.48808156828023186,BOS,TOR,2022 REG,3,2,8,1,3,11,1,0,1,-1,1,0,0,0,0,0,0,0,0,0.48808156828023186,0.5119184317197681
87163,0.6062992125984252,0.4347826086956522,-154,130,0.581391336695717,0.41860866330428304,home,BOS,under,9.5,0.5348837209302326,-115,0.5119184317197681,BOS,TOR,2022 REG,3,2,8,1,3,11,1,0,1,-1,1,0,0,0,0,0,0,0,0,0.48808156828023186,0.5119184317197681
87164,0.4444444444444444,0.5884773662551441,125,-143,0.4298125285779606,0.5701874714220394,away,MIA,over,7,0.5454545454545454,-120,0.5206611570247933,OAK,MIA,2022 REG,8,3,8,5,8,16,0,1,-2,2,1,1,1,0,0,0,0,0,0,0.5206611570247933,0.4793388429752067
87164,0.4444444444444444,0.5884773662551441,125,-143,0.4298125285779606,0.5701874714220394,home,OAK,under,7,0.5,100,0.4793388429752067,OAK,MIA,2022 REG,8,3,8,5,8,16,0,1,-2,2,1,1,1,0,0,0,0,0,0,0.5206611570247933,0.4793388429752067
87165,0.5652173913043479,0.47619047619047616,-130,110,0.5418129444594474,0.4581870555405526,away,TB,over,9,0.5169082125603864,-107,0.49239402434819424,BOS,TB,2022 REG,11,4,11,8,12,22,0,1,-4,4,1,1,1,1,0,0,0,0,0,0.49239402434819424,0.5076059756518058
87165,0.5652173913043479,0.47619047619047616,-130,110,0.5418129444594474,0.4581870555405526,home,BOS,under,9,0.5305164319248826,-113,0.5076059756518058,BOS,TB,2022 REG,11,4,11,8,12,22,0,1,-4,4,1,1,1,1,0,0,0,0,0,0.49239402434819424,0.5076059756518058
87166,0.5121951219512195,0.5283018867924528,-105,-112,0.49145275161909474,0.5085472483809053,away,MIL,over,10,0.5169082125603864,-107,0.49239402434819424,BOS,MIL,2022 REG,10,4,14,9,13,24,0,1,-5,5,1,1,1,1,0,0,0,0,0,0.49239402434819424,0.5076059756518058
87166,0.5121951219512195,0.5283018867924528,-105,-112,0.49145275161909474,0.5085472483809053,home,BOS,under,10,0.5305164319248826,-113,0.5076059756518058,BOS,MIL,2022 REG,10,4,14,9,13,24,0,1,-5,5,1,1,1,1,0,0,0,0,0,0.49239402434819424,0.5076059756518058
87167,0.48780487804878053,0.5535714285714286,105,-124,0.4676213138438005,0.5323786861561994,away,NYY,over,7,0.5370370370370371,-116,0.5118817074154765,SEA,NYY,2022 REG,5,4,4,3,7,9,1,0,1,-1,1,1,1,0,0,0,0,0,0,0.5118817074154765,0.48811829258452355
87167,0.48780487804878053,0.5535714285714286,105,-124,0.4676213138438005,0.5323786861561994,home,SEA,under,7,0.5098039215686274,-104,0.48811829258452355,SEA,NYY,2022 REG,5,4,4,3,7,9,1,0,1,-1,1,1,1,0,0,0,0,0,0,0.5118817074154765,0.48811829258452355
87168,0.6254681647940076,0.4081632653061224,-167,145,0.6044327759298813,0.3955672240701187,away,ARI,over,8.5,0.5121951219512195,-105,0.48808156828023186,CWS,ARI,2022 REG,6,2,6,7,9,12,0,1,-5,5,1,1,0,0,0,0,0,0,0,0.48808156828023186,0.5119184317197681
87168,0.6254681647940076,0.4081632653061224,-167,145,0.6044327759298813,0.3955672240701187,home,CWS,under,8.5,0.5348837209302326,-115,0.5119184317197681,CWS,ARI,2022 REG,6,2,6,7,9,12,0,1,-5,5,1,1,0,0,0,0,0,0,0,0.48808156828023186,0.5119184317197681
87169,0.6666666666666666,0.37037037037037035,-200,170,0.6419753086419753,0.3580246913580247,away,BAL,over,8,0.5098039215686274,-104,0.48592421718142587,TOR,BAL,2022 REG,6,4,9,5,9,15,0,1,-1,1,1,1,1,1,0,0,0,0,0,0.48592421718142587,0.5140757828185741
87169,0.6666666666666666,0.37037037037037035,-200,170,0.6419753086419753,0.3580246913580247,home,TOR,under,8,0.5370370370370371,-116,0.5140757828185741,TOR,BAL,2022 REG,6,4,9,5,9,15,0,1,-1,1,1,1,1,1,0,0,0,0,0,0.48592421718142587,0.5140757828185741
87170,0.33557046979865773,0.7014925373134329,198,-235,0.3231332190899025,0.6768667809100974,away,TOR,over,8.5,0.5475113122171946,-121,0.5214983313199976,KC,TOR,2022 REG,6,0,12,7,7,18,0,1,-7,7,0,0,0,0,0,0,0,0,0,0.5214983313199976,0.47850166868000243
87170,0.33557046979865773,0.7014925373134329,198,-235,0.3231332190899025,0.6768667809100974,home,KC,under,8.5,0.5,100,0.47850166868000243,KC,TOR,2022 REG,6,0,12,7,7,18,0,1,-7,7,0,0,0,0,0,0,0,0,0,0.5214983313199976,0.47850166868000243
87171,0.425531914893617,0.6183206106870228,135,-162,0.406871265710366,0.593128734289634,away,STL,over,9.5,0.5305164319248826,-113,0.5066009958897986,CIN,STL,2022 REG,7,6,3,3,9,10,1,0,3,-3,1,1,1,0,0,0,0,0,0,0.5066009958897986,0.49339900411020143
87171,0.425531914893617,0.6183206106870228,135,-162,0.406871265710366,0.593128734289634,home,CIN,under,9.5,0.5145631067961165,-106,0.49339900411020143,CIN,STL,2022 REG,7,6,3,3,9,10,1,0,3,-3,1,1,1,0,0,0,0,0,0,0.5066009958897986,0.49339900411020143
87172,0.46511627906976744,0.576271186440678,115,-136,0.44586629511142073,0.5541337048885793,away,LAD,over,7.5,0.5,100,0.4783105022831051,NYM,LAD,2022 REG,6,5,6,3,8,12,1,0,2,-2,1,1,1,0,0,0,0,0,0,0.4783105022831051,0.5216894977168949
87172,0.46511627906976744,0.576271186440678,115,-136,0.44586629511142073,0.5541337048885793,home,NYM,under,7.5,0.5433789954337899,-119,0.5216894977168949,NYM,LAD,2022 REG,6,5,6,3,8,12,1,0,2,-2,1,1,1,0,0,0,0,0,0,0.4783105022831051,0.5216894977168949
87173,0.6774193548387096,0.3623188405797102,-210,176,0.6504999321359091,0.34950006786409094,away,SEA,over,7.5,0.5327102803738317,-114,0.508788710910954,HOU,SEA,2022 REG,10,7,5,2,9,15,1,0,5,-5,1,1,0,0,0,0,0,0,0,0.508788710910954,0.491211289089046
87173,0.6774193548387096,0.3623188405797102,-210,176,0.6504999321359091,0.34950006786409094,home,HOU,under,7.5,0.5121951219512195,-105,0.491211289089046,HOU,SEA,2022 REG,10,7,5,2,9,15,1,0,5,-5,1,1,0,0,0,0,0,0,0,0.508788710910954,0.491211289089046
87174,0.8076923076923077,0.22727272727272727,-420,340,0.7794513179128564,0.22054868208714362,away,CHC,over,7,0.5073891625615764,-103,0.4859403596076043,NYM,CHC,2022 REG,4,1,9,4,5,13,0,1,-3,3,1,0,0,0,0,0,0,0,0,0.4859403596076043,0.5140596403923957
87174,0.8076923076923077,0.22727272727272727,-420,340,0.7794513179128564,0.22054868208714362,home,NYM,under,7,0.5348837209302326,-115,0.5140596403923957,NYM,CHC,2022 REG,4,1,9,4,5,13,0,1,-3,3,1,0,0,0,0,0,0,0,0,0.4859403596076043,0.5140596403923957
87175,0.4484304932735426,0.5918367346938775,123,-145,0.43037344037335423,0.5696265596266458,away,SF,over,7.5,0.5454545454545454,-120,0.5206611570247933,CHC,SF,2022 REG,5,4,3,2,6,8,1,0,2,-2,1,1,0,0,0,0,0,0,0,0.5206611570247933,0.4793388429752067
87175,0.4484304932735426,0.5918367346938775,123,-145,0.43037344037335423,0.5696265596266458,home,CHC,under,7.5,0.5,100,0.4793388429752067,CHC,SF,2022 REG,5,4,3,2,6,8,1,0,2,-2,1,1,0,0,0,0,0,0,0,0.5206611570247933,0.4793388429752067
87176,0.3125,0.726027397260274,220,-265,0.3004601883561644,0.6995398116438356,away,PHI,over,7.5,0.5098039215686274,-104,0.48483656587239576,WSH,PHI,2022 REG,3,1,11,8,9,14,0,1,-7,7,1,0,0,0,0,0,0,0,0,0.48483656587239576,0.5151634341276042
87176,0.3125,0.726027397260274,220,-265,0.3004601883561644,0.6995398116438356,home,WSH,under,7.5,0.5391705069124424,-117,0.5151634341276042,WSH,PHI,2022 REG,3,1,11,8,9,14,0,1,-7,7,1,0,0,0,0,0,0,0,0,0.48483656587239576,0.5151634341276042
87177,0.6183206106870228,0.4166666666666667,-162,140,0.5966872559874133,0.40331274401258665,away,HOU,over,7.5,0.5,100,0.47935779816513757,ATL,HOU,2022 REG,7,5,7,4,9,14,1,0,1,-1,1,1,1,1,0,0,0,0,0,0.47935779816513757,0.5206422018348624
87177,0.6183206106870228,0.4166666666666667,-162,140,0.5966872559874133,0.40331274401258665,home,ATL,under,7.5,0.5412844036697247,-118,0.5206422018348624,ATL,HOU,2022 REG,7,5,7,4,9,14,1,0,1,-1,1,1,1,1,0,0,0,0,0,0.47935779816513757,0.5206422018348624
87178,0.6721311475409836,0.36764705882352944,-205,172,0.6453949760500813,0.35460502394991866,away,CWS,over,8.5,0.5238095238095238,-110,0.4988662131519274,NYY,CWS,2022 REG,3,0,13,5,5,16,0,1,-5,5,0,0,0,0,0,0,0,0,0,0.4988662131519274,0.5011337868480725
87178,0.6721311475409836,0.36764705882352944,-205,172,0.6453949760500813,0.35460502394991866,home,NYY,under,8.5,0.5238095238095238,-110,0.5011337868480725,NYY,CWS,2022 REG,3,0,13,5,5,16,0,1,-5,5,0,0,0,0,0,0,0,0,0,0.4988662131519274,0.5011337868480725
87179,0.5884773662551441,0.45454545454545453,-143,120,0.5631594099815408,0.4368405900184592,away,SEA,over,8,0.5348837209302326,-115,0.5097020142727117,HOU,SEA,2022 REG,7,3,4,2,5,11,1,0,1,-1,1,1,0,0,0,0,0,0,0,0.5097020142727117,0.49029798572728833
87179,0.5884773662551441,0.45454545454545453,-143,120,0.5631594099815408,0.4368405900184592,home,HOU,under,8,0.5121951219512195,-105,0.49029798572728833,HOU,SEA,2022 REG,7,3,4,2,5,11,1,0,1,-1,1,1,0,0,0,0,0,0,0,0.5097020142727117,0.49029798572728833
87180,0.6031746031746031,0.4347826086956522,-152,130,0.5802797769671475,0.4197202230328525,away,SEA,over,9,0.5495495495495495,-122,0.5250401592387142,LAA,SEA,2022 REG,7,3,10,4,7,17,0,1,-1,1,1,1,1,0,0,0,0,0,0,0.5250401592387142,0.47495984076128583
87180,0.6031746031746031,0.4347826086956522,-152,130,0.5802797769671475,0.4197202230328525,home,LAA,under,9,0.49504950495049505,102,0.47495984076128583,LAA,SEA,2022 REG,7,3,10,4,7,17,0,1,-1,1,1,1,1,0,0,0,0,0,0,0.5250401592387142,0.47495984076128583
87181,0.425531914893617,0.6153846153846154,135,-160,0.4081206254135181,0.5918793745864819,away,SF,over,10.5,0.5348837209302326,-115,0.5097020142727117,COL,SF,2022 REG,8,5,8,3,8,16,1,0,2,-2,1,1,1,0,0,0,0,0,0,0.5097020142727117,0.49029798572728833
87181,0.425531914893617,0.6153846153846154,135,-160,0.4081206254135181,0.5918793745864819,home,COL,under,10.5,0.5121951219512195,-105,0.49029798572728833,COL,SF,2022 REG,8,5,8,3,8,16,1,0,2,-2,1,1,1,0,0,0,0,0,0,0.5097020142727117,0.49029798572728833
87182,0.7142857142857143,0.3278688524590164,-250,205,0.6841753094680495,0.3158246905319505,away,TEX,over,9.5,0.5283018867924528,-112,0.5031902949311281,TOR,TEX,2022 REG,10,6,11,12,18,21,0,1,-6,6,1,1,1,1,1,1,0,0,0,0.5031902949311281,0.4968097050688719
87182,0.7142857142857143,0.3278688524590164,-250,205,0.6841753094680495,0.3158246905319505,home,TOR,under,9.5,0.5192307692307692,-108,0.4968097050688719,TOR,TEX,2022 REG,10,6,11,12,18,21,0,1,-6,6,1,1,1,1,1,1,0,0,0,0.5031902949311281,0.4968097050688719
87183,0.6363636363636364,0.4081632653061224,-175,145,0.6080283353010626,0.3919716646989374,away,ARI,over,7.5,0.5098039215686274,-104,0.48483656587239576,STL,ARI,2022 REG,15,8,6,3,11,21,1,0,5,-5,1,1,1,0,0,0,0,0,0,0.48483656587239576,0.5151634341276042
87183,0.6363636363636364,0.4081632653061224,-175,145,0.6080283353010626,0.3919716646989374,home,STL,under,7.5,0.5391705069124424,-117,0.5151634341276042,STL,ARI,2022 REG,15,8,6,3,11,21,1,0,5,-5,1,1,1,0,0,0,0,0,0,0.48483656587239576,0.5151634341276042
87184,0.6296296296296295,0.4081632653061224,-170,145,0.6058341031886005,0.39416589681139946,away,PIT,over,7.5,0.5073891625615764,-103,0.4837652908580103,MIA,PIT,2022 REG,5,1,11,5,6,16,0,1,-4,4,1,0,0,0,0,0,0,0,0,0.4837652908580103,0.5162347091419897
87184,0.6296296296296295,0.4081632653061224,-170,145,0.6058341031886005,0.39416589681139946,home,MIA,under,7.5,0.5391705069124424,-117,0.5162347091419897,MIA,PIT,2022 REG,5,1,11,5,6,16,0,1,-4,4,1,0,0,0,0,0,0,0,0,0.4837652908580103,0.5162347091419897
87185,0.4,0.6402877697841727,150,-178,0.383884892086331,0.6161151079136691,away,ATL,over,8.5,0.5454545454545454,-120,0.5220180091279142,PHI,ATL,2022 REG,12,6,8,4,10,20,1,0,2,-2,1,1,1,1,0,0,0,0,0,0.5220180091279142,0.4779819908720858
87185,0.4,0.6402877697841727,150,-178,0.383884892086331,0.6161151079136691,home,PHI,under,8.5,0.49751243781094534,101,0.4779819908720858,PHI,ATL,2022 REG,12,6,8,4,10,20,1,0,2,-2,1,1,1,1,0,0,0,0,0,0.5220180091279142,0.4779819908720858
87186,0.4444444444444444,0.5918367346938775,125,-145,0.42831947593852354,0.5716805240614764,away,MIA,over,7,0.5495495495495495,-122,0.5250401592387142,WSH,MIA,2022 REG,5,1,4,2,3,9,0,1,-1,1,1,0,0,0,0,0,0,0,0,0.5250401592387142,0.47495984076128583
87186,0.4444444444444444,0.5918367346938775,125,-145,0.42831947593852354,0.5716805240614764,home,WSH,under,7,0.49504950495049505,102,0.47495984076128583,WSH,MIA,2022 REG,5,1,4,2,3,9,0,1,-1,1,1,0,0,0,0,0,0,0,0,0.5250401592387142,0.47495984076128583
87187,0.45454545454545453,0.5833333333333333,120,-140,0.43732782369146006,0.5626721763085399,away,SD,over,7,0.5454545454545454,-120,0.5206611570247933,DET,SD,2022 REG,9,4,5,3,7,14,1,0,1,-1,1,1,1,0,0,0,0,0,0,0.5206611570247933,0.4793388429752067
87187,0.45454545454545453,0.5833333333333333,120,-140,0.43732782369146006,0.5626721763085399,home,DET,under,7,0.5,100,0.4793388429752067,DET,SD,2022 REG,9,4,5,3,7,14,1,0,1,-1,1,1,1,0,0,0,0,0,0,0.5206611570247933,0.4793388429752067
87188,0.4608294930875576,0.5815899581589958,117,-139,0.44128135887255604,0.558718641127444,away,MIL,over,7,0.5305164319248826,-113,0.5053568787472517,MIA,MIL,2022 REG,11,9,8,3,12,19,1,0,6,-6,1,1,1,0,0,0,0,0,0,0.5053568787472517,0.49464312125274834
87188,0.4608294930875576,0.5815899581589958,117,-139,0.44128135887255604,0.558718641127444,home,MIA,under,7,0.5169082125603864,-107,0.49464312125274834,MIA,MIL,2022 REG,11,9,8,3,12,19,1,0,6,-6,1,1,1,0,0,0,0,0,0,0.5053568787472517,0.49464312125274834
87189,0.5348837209302326,0.504950495049505,-115,-102,0.5135770472666521,0.4864229527333479,away,BOS,over,8.5,0.5348837209302326,-115,0.5097020142727117,CHC,BOS,2022 REG,9,2,10,4,6,19,0,1,-2,2,1,1,0,0,0,0,0,0,0,0.5097020142727117,0.49029798572728833
87189,0.5348837209302326,0.504950495049505,-115,-102,0.5135770472666521,0.4864229527333479,home,CHC,under,8.5,0.5121951219512195,-105,0.49029798572728833,CHC,BOS,2022 REG,9,2,10,4,6,19,0,1,-2,2,1,1,0,0,0,0,0,0,0,0.5097020142727117,0.49029798572728833
87190,0.7142857142857143,0.3225806451612903,-250,210,0.6879526003949967,0.3120473996050033,away,CHC,over,8,0.5169082125603864,-107,0.49239402434819424,STL,CHC,2022 REG,9,8,7,0,8,16,1,0,8,-8,0,0,0,0,0,0,0,0,0,0.49239402434819424,0.5076059756518058
87190,0.7142857142857143,0.3225806451612903,-250,210,0.6879526003949967,0.3120473996050033,home,STL,under,8,0.5305164319248826,-113,0.5076059756518058,STL,CHC,2022 REG,9,8,7,0,8,16,1,0,8,-8,0,0,0,0,0,0,0,0,0,0.49239402434819424,0.5076059756518058
87191,0.6153846153846154,0.4166666666666667,-160,140,0.5956607495069033,0.4043392504930967,away,PIT,over,8,0.5283018867924528,-112,0.5044173060022736,DET,PIT,2022 REG,3,3,5,2,5,8,1,0,1,-1,1,1,0,0,0,0,0,0,0,0.5044173060022736,0.49558269399772636
87191,0.6153846153846154,0.4166666666666667,-160,140,0.5956607495069033,0.4043392504930967,home,DET,under,8,0.5169082125603864,-107,0.49558269399772636,DET,PIT,2022 REG,3,3,5,2,5,8,1,0,1,-1,1,1,0,0,0,0,0,0,0,0.5044173060022736,0.49558269399772636
87192,0.5535714285714286,0.4807692307692307,-124,108,0.5345614207221351,0.4654385792778649,away,COL,over,9,0.5454545454545454,-120,0.5193043049216726,CIN,COL,2022 REG,11,3,6,2,5,17,1,0,1,-1,1,1,0,0,0,0,0,0,0,0.5193043049216726,0.48069569507832743
87192,0.5535714285714286,0.4807692307692307,-124,108,0.5345614207221351,0.4654385792778649,home,CIN,under,9,0.5024875621890548,-101,0.48069569507832743,CIN,COL,2022 REG,11,3,6,2,5,17,1,0,1,-1,1,1,0,0,0,0,0,0,0,0.5193043049216726,0.48069569507832743
87193,0.7142857142857143,0.3278688524590164,-250,205,0.6841753094680495,0.3158246905319505,away,PHI,over,8.5,0.5305164319248826,-113,0.5066009958897986,ATL,PHI,2022 REG,14,13,4,1,14,18,1,0,12,-12,1,0,0,0,0,0,0,0,0,0.5066009958897986,0.49339900411020143
87193,0.7142857142857143,0.3278688524590164,-250,205,0.6841753094680495,0.3158246905319505,home,ATL,under,8.5,0.5145631067961165,-106,0.49339900411020143,ATL,PHI,2022 REG,14,13,4,1,14,18,1,0,12,-12,1,0,0,0,0,0,0,0,0,0.5066009958897986,0.49339900411020143
87194,0.6108949416342413,0.4291845493562232,-157,133,0.5864105833248914,0.4135894166751086,away,MIL,over,8,0.5238095238095238,-110,0.5000596729920038,NYM,MIL,2022 REG,8,4,3,0,4,11,1,0,4,-4,0,0,0,0,0,0,0,0,0,0.5000596729920038,0.4999403270079962
87194,0.6108949416342413,0.4291845493562232,-157,133,0.5864105833248914,0.4135894166751086,home,NYM,under,8,0.5215311004784688,-109,0.4999403270079962,NYM,MIL,2022 REG,8,4,3,0,4,11,1,0,4,-4,0,0,0,0,0,0,0,0,0,0.5000596729920038,0.4999403270079962
87195,0.7142857142857143,0.3225806451612903,-250,210,0.6879526003949967,0.3120473996050033,away,CIN,over,8,0.5260663507109005,-111,0.5022370601254724,TOR,CIN,2022 REG,7,3,7,1,4,14,1,0,2,-2,1,0,0,0,0,0,0,0,0,0.5022370601254724,0.4977629398745276
87195,0.7142857142857143,0.3225806451612903,-250,210,0.6879526003949967,0.3120473996050033,home,TOR,under,8,0.5192307692307692,-108,0.4977629398745276,TOR,CIN,2022 REG,7,3,7,1,4,14,1,0,2,-2,1,0,0,0,0,0,0,0,0,0.5022370601254724,0.4977629398745276
87196,0.49019607843137253,0.5454545454545454,104,-120,0.4727202824088637,0.5272797175911363,away,SEA,over,9.5,0.504950495049505,-102,0.47949844489399435,WSH,SEA,2022 REG,6,1,7,2,3,13,0,1,-1,1,1,0,0,0,0,0,0,0,0,0.47949844489399435,0.5205015551060057
87196,0.49019607843137253,0.5454545454545454,104,-120,0.4727202824088637,0.5272797175911363,home,WSH,under,9.5,0.5454545454545454,-120,0.5205015551060057,WSH,SEA,2022 REG,6,1,7,2,3,13,0,1,-1,1,1,0,0,0,0,0,0,0,0,0.47949844489399435,0.5205015551060057
87197,0.6183206106870228,0.42016806722689076,-162,138,0.5945222678547557,0.4054777321452443,away,SF,over,7.5,0.5121951219512195,-105,0.48808156828023186,SD,SF,2022 REG,9,6,5,3,9,14,1,0,3,-3,1,1,1,0,0,0,0,0,0,0.48808156828023186,0.5119184317197681
87197,0.6183206106870228,0.42016806722689076,-162,138,0.5945222678547557,0.4054777321452443,home,SD,under,7.5,0.5348837209302326,-115,0.5119184317197681,SD,SF,2022 REG,9,6,5,3,9,14,1,0,3,-3,1,1,1,0,0,0,0,0,0,0.48808156828023186,0.5119184317197681
87198,0.42016806722689076,0.6183206106870228,138,-162,0.4039963538176834,0.5960036461823166,away,LAA,over,7.5,0.5327102803738317,-114,0.508788710910954,TEX,LAA,2022 REG,12,6,7,5,11,19,1,0,1,-1,1,1,1,1,1,0,0,0,0,0.508788710910954,0.491211289089046
87198,0.42016806722689076,0.6183206106870228,138,-162,0.4039963538176834,0.5960036461823166,home,TEX,under,7.5,0.5121951219512195,-105,0.491211289089046,TEX,LAA,2022 REG,12,6,7,5,11,19,1,0,1,-1,1,1,1,1,1,0,0,0,0,0.508788710910954,0.491211289089046
87199,0.6363636363636364,0.4,-175,150,0.6132231404958678,0.3867768595041322,away,CLE,over,7,0.5169082125603864,-107,0.49353874091423283,SEA,CLE,2022 REG,3,3,6,4,7,9,0,1,-1,1,1,1,1,0,0,0,0,0,0,0.49353874091423283,0.5064612590857671
87199,0.6363636363636364,0.4,-175,150,0.6132231404958678,0.3867768595041322,home,SEA,under,7,0.5283018867924528,-112,0.5064612590857671,SEA,CLE,2022 REG,3,3,6,4,7,9,0,1,-1,1,1,1,1,0,0,0,0,0,0,0.49353874091423283,0.5064612590857671
87200,0.5145631067961165,0.5238095238095238,-106,-110,0.4948179667757384,0.5051820332242616,away,TEX,over,9.5,0.5238095238095238,-110,0.5012646084074657,BAL,TEX,2022 REG,4,2,6,1,3,10,1,0,1,-1,1,0,0,0,0,0,0,0,0,0.5012646084074657,0.4987353915925343
87200,0.5145631067961165,0.5238095238095238,-106,-110,0.4948179667757384,0.5051820332242616,home,BAL,under,9.5,0.5192307692307692,-108,0.4987353915925343,BAL,TEX,2022 REG,4,2,6,1,3,10,1,0,1,-1,1,0,0,0,0,0,0,0,0,0.5012646084074657,0.4987353915925343
87201,0.425531914893617,0.6108949416342413,135,-157,0.41003112488176247,0.5899688751182375,away,MIN,over,7.5,0.5121951219512195,-105,0.48808156828023186,OAK,MIN,2022 REG,12,4,14,14,18,26,0,1,-10,10,1,1,1,1,0,0,0,0,0,0.48808156828023186,0.5119184317197681
87201,0.425531914893617,0.6108949416342413,135,-157,0.41003112488176247,0.5899688751182375,home,OAK,under,7.5,0.5348837209302326,-115,0.5119184317197681,OAK,MIN,2022 REG,12,4,14,14,18,26,0,1,-10,10,1,1,1,1,0,0,0,0,0,0.48808156828023186,0.5119184317197681
87202,0.4444444444444444,0.5967741935483871,125,-148,0.42612504978096366,0.5738749502190363,away,SF,over,11,0.5454545454545454,-120,0.5206611570247933,COL,SF,2022 REG,11,6,9,7,13,20,0,1,-1,1,1,1,1,1,1,1,0,0,0,0.5206611570247933,0.4793388429752067
87202,0.4444444444444444,0.5967741935483871,125,-148,0.42612504978096366,0.5738749502190363,home,COL,under,11,0.5,100,0.4793388429752067,COL,SF,2022 REG,11,6,9,7,13,20,0,1,-1,1,1,1,1,1,1,1,0,0,0,0.5206611570247933,0.4793388429752067
87203,0.7468354430379747,0.29411764705882354,-295,240,0.7162502238517583,0.2837497761482417,away,DET,over,8.5,0.5215311004784688,-109,0.49907282342437215,NYY,DET,2022 REG,4,3,1,0,3,5,1,0,3,-3,0,0,0,0,0,0,0,0,0,0.49907282342437215,0.5009271765756278
87203,0.7468354430379747,0.29411764705882354,-295,240,0.7162502238517583,0.2837497761482417,home,NYY,under,8.5,0.5215311004784688,-109,0.5009271765756278,NYY,DET,2022 REG,4,3,1,0,3,5,1,0,3,-3,0,0,0,0,0,0,0,0,0,0.49907282342437215,0.5009271765756278
87204,0.6551724137931035,0.3921568627450981,-190,155,0.6241635774404887,0.37583642255951133,away,DET,over,6.5,0.5412844036697247,-118,0.5149381613977361,TB,DET,2022 REG,11,6,5,1,7,16,1,0,5,-5,1,0,0,0,0,0,0,0,0,0.5149381613977361,0.48506183860226393
87204,0.6551724137931035,0.3921568627450981,-190,155,0.6241635774404887,0.37583642255951133,home,TB,under,6.5,0.5073891625615764,-103,0.48506183860226393,TB,DET,2022 REG,11,6,5,1,7,16,1,0,5,-5,1,0,0,0,0,0,0,0,0,0.5149381613977361,0.48506183860226393
87205,0.47619047619047616,0.5652173913043479,110,-130,0.4564724440500838,0.5435275559499162,away,SF,over,9.5,0.5283018867924528,-112,0.5044173060022736,WSH,SF,2022 REG,6,1,12,7,8,18,0,1,-6,6,1,0,0,0,0,0,0,0,0,0.5044173060022736,0.49558269399772636
87205,0.47619047619047616,0.5652173913043479,110,-130,0.4564724440500838,0.5435275559499162,home,WSH,under,9.5,0.5169082125603864,-107,0.49558269399772636,WSH,SF,2022 REG,6,1,12,7,8,18,0,1,-6,6,1,0,0,0,0,0,0,0,0,0.5044173060022736,0.49558269399772636
87206,0.49019607843137253,0.5475113122171946,104,-121,0.47171206340756505,0.5282879365924349,away,CLE,over,9,0.49751243781094534,101,0.47511256217505476,BAL,CLE,2022 REG,4,2,6,3,5,10,0,1,-1,1,1,1,0,0,0,0,0,0,0,0.47511256217505476,0.5248874378249453
87206,0.49019607843137253,0.5475113122171946,104,-121,0.47171206340756505,0.5282879365924349,home,BAL,under,9,0.5475113122171946,-121,0.5248874378249453,BAL,CLE,2022 REG,4,2,6,3,5,10,0,1,-1,1,1,1,0,0,0,0,0,0,0,0.47511256217505476,0.5248874378249453
87207,0.4716981132075471,0.5689655172413793,112,-132,0.45251715544861953,0.5474828445513804,away,NYM,over,7.5,0.5412844036697247,-118,0.5162581740877563,CHC,NYM,2022 REG,8,0,12,8,8,20,0,1,-8,8,0,0,0,0,0,0,0,0,0,0.5162581740877563,0.4837418259122437
87207,0.4716981132075471,0.5689655172413793,112,-132,0.45251715544861953,0.5474828445513804,home,CHC,under,7.5,0.504950495049505,-102,0.4837418259122437,CHC,NYM,2022 REG,8,0,12,8,8,20,0,1,-8,8,0,0,0,0,0,0,0,0,0,0.5162581740877563,0.4837418259122437
87208,0.5833333333333333,0.45454545454545453,-140,120,0.5612373737373737,0.4387626262626263,away,MIN,over,7,0.5433789954337899,-119,0.5198077604720502,NYY,MIN,2022 REG,9,5,11,4,9,20,1,0,1,-1,1,1,1,1,0,0,0,0,0,0.5198077604720502,0.48019223952794976
87208,0.5833333333333333,0.45454545454545453,-140,120,0.5612373737373737,0.4387626262626263,home,NYY,under,7,0.5,100,0.48019223952794976,NYY,MIN,2022 REG,9,5,11,4,9,20,1,0,1,-1,1,1,1,1,0,0,0,0,0,0.5198077604720502,0.48019223952794976
87209,0.5121951219512195,0.5348837209302326,-105,-115,0.48808156828023186,0.5119184317197681,away,LAA,over,9,0.5121951219512195,-105,0.48808156828023186,BAL,LAA,2022 REG,8,4,6,1,5,14,1,0,3,-3,1,0,0,0,0,0,0,0,0,0.48808156828023186,0.5119184317197681
87209,0.5121951219512195,0.5348837209302326,-105,-115,0.48808156828023186,0.5119184317197681,home,BAL,under,9,0.5348837209302326,-115,0.5119184317197681,BAL,LAA,2022 REG,8,4,6,1,5,14,1,0,3,-3,1,0,0,0,0,0,0,0,0,0.48808156828023186,0.5119184317197681
87210,0.782608695652174,0.2597402597402597,-360,285,0.7494660349102693,0.2505339650897307,away,DET,over,8,0.5238095238095238,-110,0.5012646084074657,NYY,DET,2022 REG,15,13,3,0,13,18,1,0,13,-13,0,0,0,0,0,0,0,0,0,0.5012646084074657,0.4987353915925343
87210,0.782608695652174,0.2597402597402597,-360,285,0.7494660349102693,0.2505339650897307,home,NYY,under,8,0.5192307692307692,-108,0.4987353915925343,NYY,DET,2022 REG,15,13,3,0,13,18,1,0,13,-13,0,0,0,0,0,0,0,0,0,0.5012646084074657,0.4987353915925343
87211,0.33783783783783783,0.7101449275362319,196,-245,0.32162744413038186,0.6783725558696181,away,LAD,over,11.5,0.5348837209302326,-115,0.5097020142727117,COL,LAD,2022 REG,7,4,10,5,9,17,0,1,-1,1,1,1,1,1,0,0,0,0,0,0.5097020142727117,0.49029798572728833
87211,0.33783783783783783,0.7101449275362319,196,-245,0.32162744413038186,0.6783725558696181,home,COL,under,11.5,0.5121951219512195,-105,0.49029798572728833,COL,LAD,2022 REG,7,4,10,5,9,17,0,1,-1,1,1,1,1,1,0,0,0,0,0,0.5097020142727117,0.49029798572728833
87212,0.5475113122171946,0.49504950495049505,-121,102,0.5242087833606768,0.4757912166393232,away,OAK,over,7.5,0.5238095238095238,-110,0.4988662131519274,DET,OAK,2022 REG,7,0,11,9,9,18,0,1,-9,9,0,0,0,0,0,0,0,0,0,0.4988662131519274,0.5011337868480725
87212,0.5475113122171946,0.49504950495049505,-121,102,0.5242087833606768,0.4757912166393232,home,DET,under,7.5,0.5238095238095238,-110,0.5011337868480725,DET,OAK,2022 REG,7,0,11,9,9,18,0,1,-9,9,0,0,0,0,0,0,0,0,0,0.4988662131519274,0.5011337868480725
87213,0.37037037037037035,0.6666666666666666,170,-200,0.35665294924554186,0.6433470507544581,away,SD,over,9.5,0.5121951219512195,-105,0.48808156828023186,KC,SD,2022 REG,18,15,10,7,22,28,1,0,8,-8,1,1,1,1,1,1,1,0,0,0.48808156828023186,0.5119184317197681
87213,0.37037037037037035,0.6666666666666666,170,-200,0.35665294924554186,0.6433470507544581,home,KC,under,9.5,0.5348837209302326,-115,0.5119184317197681,KC,SD,2022 REG,18,15,10,7,22,28,1,0,8,-8,1,1,1,1,1,1,1,0,0,0.48808156828023186,0.5119184317197681
87214,0.45454545454545453,0.5884773662551441,120,-143,0.43498962690881876,0.5650103730911813,away,HOU,over,7.5,0.5121951219512195,-105,0.48808156828023186,TEX,HOU,2022 REG,6,3,11,5,8,17,0,1,-2,2,1,1,1,0,0,0,0,0,0,0.48808156828023186,0.5119184317197681
87214,0.45454545454545453,0.5884773662551441,120,-143,0.43498962690881876,0.5650103730911813,home,TEX,under,7.5,0.5348837209302326,-115,0.5119184317197681,TEX,HOU,2022 REG,6,3,11,5,8,17,0,1,-2,2,1,1,1,0,0,0,0,0,0,0.48808156828023186,0.5119184317197681
87215,0.7014925373134329,0.3389830508474576,-235,195,0.6730992142751963,0.32690078572480374,away,CIN,over,9,0.5,100,0.4772727272727273,MIL,CIN,2022 REG,6,5,1,1,6,7,1,0,4,-4,1,0,0,0,0,0,0,0,0,0.4772727272727273,0.5227272727272727
87215,0.7014925373134329,0.3389830508474576,-235,195,0.6730992142751963,0.32690078572480374,home,MIL,under,9,0.5454545454545454,-120,0.5227272727272727,MIL,CIN,2022 REG,6,5,1,1,6,7,1,0,4,-4,1,0,0,0,0,0,0,0,0,0.4772727272727273,0.5227272727272727
87216,0.7101449275362319,0.3225806451612903,-245,210,0.6869050280843684,0.3130949719156316,away,CWS,over,7.5,0.5348837209302326,-115,0.5097020142727117,HOU,CWS,2022 REG,3,0,12,7,7,15,0,1,-7,7,0,0,0,0,0,0,0,0,0,0.5097020142727117,0.49029798572728833
87216,0.7101449275362319,0.3225806451612903,-245,210,0.6869050280843684,0.3130949719156316,home,HOU,under,7.5,0.5121951219512195,-105,0.49029798572728833,HOU,CWS,2022 REG,3,0,12,7,7,15,0,1,-7,7,0,0,0,0,0,0,0,0,0,0.5097020142727117,0.49029798572728833
87217,0.6923076923076923,0.3508771929824561,-225,185,0.6624104640298972,0.33758953597010277,away,PIT,over,6.5,0.5145631067961165,-106,0.4913668392989033,TB,PIT,2022 REG,10,4,6,2,6,16,1,0,2,-2,1,1,0,0,0,0,0,0,0,0.4913668392989033,0.5086331607010968
87217,0.6923076923076923,0.3508771929824561,-225,185,0.6624104640298972,0.33758953597010277,home,TB,under,6.5,0.5305164319248826,-113,0.5086331607010968,TB,PIT,2022 REG,10,4,6,2,6,16,1,0,2,-2,1,1,0,0,0,0,0,0,0,0.4913668392989033,0.5086331607010968
87218,0.6503496503496503,0.3846153846153846,-186,160,0.6276101520856765,0.3723898479143235,away,BAL,over,8.5,0.5327102803738317,-114,0.508788710910954,LAA,BAL,2022 REG,8,3,8,5,8,16,0,1,-2,2,1,1,1,0,0,0,0,0,0,0.508788710910954,0.491211289089046
87218,0.6503496503496503,0.3846153846153846,-186,160,0.6276101520856765,0.3723898479143235,home,LAA,under,8.5,0.5121951219512195,-105,0.491211289089046,LAA,BAL,2022 REG,8,3,8,5,8,16,0,1,-2,2,1,1,1,0,0,0,0,0,0,0.508788710910954,0.491211289089046
87219,0.43859649122807015,0.6000000000000001,128,-150,0.4216682056017235,0.5783317943982764,away,ARI,over,11,0.5454545454545454,-120,0.5206611570247933,COL,ARI,2022 REG,3,0,11,6,6,14,0,1,-6,6,0,0,0,0,0,0,0,0,0,0.5206611570247933,0.4793388429752067
87219,0.43859649122807015,0.6000000000000001,128,-150,0.4216682056017235,0.5783317943982764,home,COL,under,11,0.5,100,0.4793388429752067,COL,ARI,2022 REG,3,0,11,6,6,14,0,1,-6,6,0,0,0,0,0,0,0,0,0,0.5206611570247933,0.4793388429752067
87220,0.5780590717299579,0.4629629629629629,-137,116,0.5543459124348938,0.44565408756510616,away,HOU,over,8,0.5348837209302326,-115,0.5097020142727117,NYY,HOU,2022 REG,6,7,11,6,13,17,1,0,1,-1,1,1,1,1,1,1,0,0,0,0.5097020142727117,0.49029798572728833
87220,0.5780590717299579,0.4629629629629629,-137,116,0.5543459124348938,0.44565408756510616,home,NYY,under,8,0.5121951219512195,-105,0.49029798572728833,NYY,HOU,2022 REG,6,7,11,6,13,17,1,0,1,-1,1,1,1,1,1,1,0,0,0,0.5097020142727117,0.49029798572728833
87221,0.3225806451612903,0.7183098591549296,210,-255,0.30939015989799357,0.6906098401020064,away,ATL,over,9.5,0.5024875621890548,-101,0.4773637496764618,WSH,ATL,2022 REG,6,0,6,8,8,12,0,1,-8,8,0,0,0,0,0,0,0,0,0,0.4773637496764618,0.5226362503235382
87221,0.3225806451612903,0.7183098591549296,210,-255,0.30939015989799357,0.6906098401020064,home,WSH,under,9.5,0.5475113122171946,-121,0.5226362503235382,WSH,ATL,2022 REG,6,0,6,8,8,12,0,1,-8,8,0,0,0,0,0,0,0,0,0,0.4773637496764618,0.5226362503235382
87222,0.5121951219512195,0.5348837209302326,-105,-115,0.48808156828023186,0.5119184317197681,away,CWS,over,8,0.5024875621890548,-101,0.48049269377245407,MIN,CWS,2022 REG,9,6,9,4,10,18,1,0,2,-2,1,1,1,1,0,0,0,0,0,0.48049269377245407,0.5195073062275459
87222,0.5121951219512195,0.5348837209302326,-105,-115,0.48808156828023186,0.5119184317197681,home,MIN,under,8,0.5412844036697247,-118,0.5195073062275459,MIN,CWS,2022 REG,9,6,9,4,10,18,1,0,2,-2,1,1,1,1,0,0,0,0,0,0.48049269377245407,0.5195073062275459
87223,0.6428571428571428,0.3921568627450981,-180,155,0.6203481392557023,0.3796518607442977,away,STL,over,9.5,0.5,100,0.4772727272727273,ATL,STL,2022 REG,10,6,9,3,9,19,1,0,3,-3,1,1,1,0,0,0,0,0,0,0.4772727272727273,0.5227272727272727
87223,0.6428571428571428,0.3921568627450981,-180,155,0.6203481392557023,0.3796518607442977,home,ATL,under,9.5,0.5454545454545454,-120,0.5227272727272727,ATL,STL,2022 REG,10,6,9,3,9,19,1,0,3,-3,1,1,1,0,0,0,0,0,0,0.4772727272727273,0.5227272727272727
87224,0.6296296296296295,0.41152263374485604,-170,143,0.6037189452827312,0.3962810547172688,away,TB,over,8.5,0.5348837209302326,-115,0.5109810284308424,TOR,TB,2022 REG,6,3,6,2,5,12,1,0,1,-1,1,1,0,0,0,0,0,0,0,0.5109810284308424,0.48901897156915763
87224,0.6296296296296295,0.41152263374485604,-170,143,0.6037189452827312,0.3962810547172688,home,TOR,under,8.5,0.5098039215686274,-104,0.48901897156915763,TOR,TB,2022 REG,6,3,6,2,5,12,1,0,1,-1,1,1,0,0,0,0,0,0,0,0.5109810284308424,0.48901897156915763
87225,0.7701149425287357,0.27027027027027023,-335,270,0.7390136866950185,0.26098631330498145,away,DET,over,8,0.5215311004784688,-109,0.4978845547971712,LAD,DET,2022 REG,4,1,10,5,6,14,0,1,-4,4,1,0,0,0,0,0,0,0,0,0.4978845547971712,0.5021154452028288
87225,0.7701149425287357,0.27027027027027023,-335,270,0.7390136866950185,0.26098631330498145,home,LAD,under,8,0.5238095238095238,-110,0.5021154452028288,LAD,DET,2022 REG,4,1,10,5,6,14,0,1,-4,4,1,0,0,0,0,0,0,0,0,0.4978845547971712,0.5021154452028288
87226,0.37037037037037035,0.6666666666666666,170,-200,0.35665294924554186,0.6433470507544581,away,MIL,over,8.5,0.5121951219512195,-105,0.48919479393107135,CIN,MIL,2022 REG,6,4,9,5,9,15,0,1,-1,1,1,1,1,1,0,0,0,0,0,0.48919479393107135,0.5108052060689287
87226,0.37037037037037035,0.6666666666666666,170,-200,0.35665294924554186,0.6433470507544581,home,CIN,under,8.5,0.5327102803738317,-114,0.5108052060689287,CIN,MIL,2022 REG,6,4,9,5,9,15,0,1,-1,1,1,1,1,1,0,0,0,0,0,0.48919479393107135,0.5108052060689287
87227,0.425531914893617,0.6108949416342413,135,-157,0.41003112488176247,0.5899688751182375,away,ATL,over,12,0.5283018867924528,-112,0.5031902949311281,COL,ATL,2022 REG,12,7,11,8,15,23,0,1,-1,1,1,1,1,1,1,1,1,0,0,0.5031902949311281,0.4968097050688719
87227,0.425531914893617,0.6108949416342413,135,-157,0.41003112488176247,0.5899688751182375,home,COL,under,12,0.5192307692307692,-108,0.4968097050688719,COL,ATL,2022 REG,12,7,11,8,15,23,0,1,-1,1,1,1,1,1,1,1,1,0,0,0.5031902949311281,0.4968097050688719
87228,0.3921568627450981,0.6610169491525424,155,-195,0.3713043874911215,0.6286956125088785,away,MIA,over,7.5,0.5348837209302326,-115,0.5059387610766736,WSH,MIA,2022 REG,7,1,6,3,4,13,0,1,-2,2,1,0,0,0,0,0,0,0,0,0.5059387610766736,0.49406123892332643
87228,0.3921568627450981,0.6610169491525424,155,-195,0.3713043874911215,0.6286956125088785,home,WSH,under,7.5,0.5192307692307692,-108,0.49406123892332643,WSH,MIA,2022 REG,7,1,6,3,4,13,0,1,-2,2,1,0,0,0,0,0,0,0,0,0.5059387610766736,0.49406123892332643
87229,0.613899613899614,0.42016806722689076,-159,138,0.5929854776095975,0.4070145223904025,away,BOS,over,8.5,0.5121951219512195,-105,0.48919479393107135,NYY,BOS,2022 REG,8,7,9,5,12,17,1,0,2,-2,1,1,1,1,1,0,0,0,0,0.48919479393107135,0.5108052060689287
87229,0.613899613899614,0.42016806722689076,-159,138,0.5929854776095975,0.4070145223904025,home,NYY,under,8.5,0.5327102803738317,-114,0.5108052060689287,NYY,BOS,2022 REG,8,7,9,5,12,17,1,0,2,-2,1,1,1,1,1,0,0,0,0,0.48919479393107135,0.5108052060689287
87230,0.6666666666666666,0.37037037037037035,-200,170,0.6419753086419753,0.3580246913580247,away,KC,over,7.5,0.5,100,0.4772727272727273,MIN,KC,2022 REG,8,4,5,0,4,13,1,0,4,-4,0,0,0,0,0,0,0,0,0,0.4772727272727273,0.5227272727272727
87230,0.6666666666666666,0.37037037037037035,-200,170,0.6419753086419753,0.3580246913580247,home,MIN,under,7.5,0.5454545454545454,-120,0.5227272727272727,MIN,KC,2022 REG,8,4,5,0,4,13,1,0,4,-4,0,0,0,0,0,0,0,0,0,0.4772727272727273,0.5227272727272727
87231,0.5555555555555556,0.48309178743961345,-125,107,0.5340848094471283,0.46591519055287167,away,COL,over,8.5,0.5145631067961165,-106,0.4913668392989033,PIT,COL,2022 REG,9,2,7,1,3,16,1,0,1,-1,1,0,0,0,0,0,0,0,0,0.4913668392989033,0.5086331607010968
87231,0.5555555555555556,0.48309178743961345,-125,107,0.5340848094471283,0.46591519055287167,home,PIT,under,8.5,0.5305164319248826,-113,0.5086331607010968,PIT,COL,2022 REG,9,2,7,1,3,16,1,0,1,-1,1,0,0,0,0,0,0,0,0,0.4913668392989033,0.5086331607010968
87232,0.6774193548387096,0.36363636363636365,-210,175,0.6496074165168858,0.3503925834831142,away,WSH,over,7.5,0.5305164319248826,-113,0.5053568787472517,MIA,WSH,2022 REG,9,2,7,1,3,16,1,0,1,-1,1,0,0,0,0,0,0,0,0,0.5053568787472517,0.49464312125274834
87232,0.6774193548387096,0.36363636363636365,-210,175,0.6496074165168858,0.3503925834831142,home,MIA,under,7.5,0.5169082125603864,-107,0.49464312125274834,MIA,WSH,2022 REG,9,2,7,1,3,16,1,0,1,-1,1,0,0,0,0,0,0,0,0,0.5053568787472517,0.49464312125274834
87233,0.5555555555555556,0.4807692307692307,-125,108,0.5353751187084521,0.4646248812915479,away,BOS,over,9,0.5121951219512195,-105,0.48919479393107135,LAA,BOS,2022 REG,3,0,6,1,1,9,0,1,-1,1,0,0,0,0,0,0,0,0,0,0.48919479393107135,0.5108052060689287
87233,0.5555555555555556,0.4807692307692307,-125,108,0.5353751187084521,0.4646248812915479,home,LAA,under,9,0.5327102803738317,-114,0.5108052060689287,LAA,BOS,2022 REG,3,0,6,1,1,9,0,1,-1,1,0,0,0,0,0,0,0,0,0,0.48919479393107135,0.5108052060689287
87234,0.5726495726495727,0.46511627906976744,-134,115,0.5510229738017454,0.44897702619825464,away,NYY,over,6.5,0.5391705069124424,-117,0.5140669063204599,TB,NYY,2022 REG,2,4,9,2,6,11,1,0,2,-2,1,1,0,0,0,0,0,0,0,0.5140669063204599,0.4859330936795401
87234,0.5726495726495727,0.46511627906976744,-134,115,0.5510229738017454,0.44897702619825464,home,TB,under,6.5,0.5073891625615764,-103,0.4859330936795401,TB,NYY,2022 REG,2,4,9,2,6,11,1,0,2,-2,1,1,0,0,0,0,0,0,0,0.5140669063204599,0.4859330936795401
87235,0.6503496503496503,0.3846153846153846,-186,160,0.6276101520856765,0.3723898479143235,away,BAL,over,8,0.5391705069124424,-117,0.5140669063204599,HOU,BAL,2022 REG,4,1,6,3,4,10,0,1,-2,2,1,0,0,0,0,0,0,0,0,0.5140669063204599,0.4859330936795401
87235,0.6503496503496503,0.3846153846153846,-186,160,0.6276101520856765,0.3723898479143235,home,HOU,under,8,0.5073891625615764,-103,0.4859330936795401,HOU,BAL,2022 REG,4,1,6,3,4,10,0,1,-2,2,1,0,0,0,0,0,0,0,0,0.5140669063204599,0.4859330936795401
87236,0.5884773662551441,0.4484304932735426,-143,123,0.5667579262855877,0.43324207371441226,away,ATL,over,6.5,0.5327102803738317,-114,0.508788710910954,MIL,ATL,2022 REG,10,7,10,6,13,20,1,0,1,-1,1,1,1,1,1,1,0,0,0,0.508788710910954,0.491211289089046
87236,0.5884773662551441,0.4484304932735426,-143,123,0.5667579262855877,0.43324207371441226,home,MIL,under,6.5,0.5121951219512195,-105,0.491211289089046,MIL,ATL,2022 REG,10,7,10,6,13,20,1,0,1,-1,1,1,1,1,1,1,0,0,0,0.508788710910954,0.491211289089046
87237,0.43859649122807015,0.6000000000000001,128,-150,0.4216682056017235,0.5783317943982764,away,PHI,over,8,0.5098039215686274,-104,0.4870219861770517,MIA,PHI,2022 REG,13,11,8,3,14,21,1,0,8,-8,1,1,1,0,0,0,0,0,0,0.4870219861770517,0.5129780138229483
87237,0.43859649122807015,0.6000000000000001,128,-150,0.4216682056017235,0.5783317943982764,home,MIA,under,8,0.5348837209302326,-115,0.5129780138229483,MIA,PHI,2022 REG,13,11,8,3,14,21,1,0,8,-8,1,1,1,0,0,0,0,0,0,0.4870219861770517,0.5129780138229483
87238,0.5412844036697247,0.5,-118,100,0.5189377998484975,0.4810622001515025,away,PHI,over,7.5,0.5073891625615764,-103,0.4837652908580103,MIA,PHI,2022 REG,11,7,8,1,8,19,1,0,6,-6,1,0,0,0,0,0,0,0,0,0.4837652908580103,0.5162347091419897
87238,0.5412844036697247,0.5,-118,100,0.5189377998484975,0.4810622001515025,home,MIA,under,7.5,0.5391705069124424,-117,0.5162347091419897,MIA,PHI,2022 REG,11,7,8,1,8,19,1,0,6,-6,1,0,0,0,0,0,0,0,0,0.4837652908580103,0.5162347091419897
87239,0.5098039215686274,0.5348837209302326,-104,-115,0.4870219861770517,0.5129780138229483,away,CIN,over,8.5,0.5121951219512195,-105,0.48919479393107135,WSH,CIN,2022 REG,6,3,5,2,5,11,1,0,1,-1,1,1,0,0,0,0,0,0,0,0.48919479393107135,0.5108052060689287
87239,0.5098039215686274,0.5348837209302326,-104,-115,0.4870219861770517,0.5129780138229483,home,WSH,under,8.5,0.5327102803738317,-114,0.5108052060689287,WSH,CIN,2022 REG,6,3,5,2,5,11,1,0,1,-1,1,1,0,0,0,0,0,0,0,0.48919479393107135,0.5108052060689287
87240,0.48780487804878053,0.5555555555555556,105,-125,0.4666534470222751,0.5333465529777248,away,STL,over,9,0.5348837209302326,-115,0.5097020142727117,MIL,STL,2022 REG,4,2,11,6,8,15,0,1,-4,4,1,1,0,0,0,0,0,0,0,0.5097020142727117,0.49029798572728833
87240,0.48780487804878053,0.5555555555555556,105,-125,0.4666534470222751,0.5333465529777248,home,MIL,under,9,0.5121951219512195,-105,0.49029798572728833,MIL,STL,2022 REG,4,2,11,6,8,15,0,1,-4,4,1,1,0,0,0,0,0,0,0,0.5097020142727117,0.49029798572728833
87241,0.5555555555555556,0.48780487804878053,-125,105,0.5314664257753688,0.46853357422463116,away,ATL,over,7.5,0.49504950495049505,102,0.4739797934813417,PHI,ATL,2022 REG,8,3,8,5,8,16,0,1,-2,2,1,1,1,0,0,0,0,0,0,0.4739797934813417,0.5260202065186583
87241,0.5555555555555556,0.48780487804878053,-125,105,0.5314664257753688,0.46853357422463116,home,PHI,under,7.5,0.5475113122171946,-121,0.5260202065186583,PHI,ATL,2022 REG,8,3,8,5,8,16,0,1,-2,2,1,1,1,0,0,0,0,0,0,0.4739797934813417,0.5260202065186583
87242,0.607843137254902,0.4347826086956522,-155,130,0.5819333701084867,0.41806662989151333,away,SD,over,9,0.5,100,0.4772727272727273,LAD,SD,2022 REG,10,8,6,3,11,16,1,0,5,-5,1,1,1,0,0,0,0,0,0,0.4772727272727273,0.5227272727272727
87242,0.607843137254902,0.4347826086956522,-155,130,0.5819333701084867,0.41806662989151333,home,LAD,under,9,0.5454545454545454,-120,0.5227272727272727,LAD,SD,2022 REG,10,8,6,3,11,16,1,0,5,-5,1,1,1,0,0,0,0,0,0,0.4772727272727273,0.5227272727272727
87243,0.5918367346938775,0.4484304932735426,-145,123,0.5680051099784656,0.43199489002153435,away,SF,over,7,0.504950495049505,-102,0.48054649490447493,SD,SF,2022 REG,8,2,2,1,3,10,1,0,1,-1,1,0,0,0,0,0,0,0,0,0.48054649490447493,0.5194535050955251
87243,0.5918367346938775,0.4484304932735426,-145,123,0.5680051099784656,0.43199489002153435,home,SD,under,7,0.5433789954337899,-119,0.5194535050955251,SD,SF,2022 REG,8,2,2,1,3,10,1,0,1,-1,1,0,0,0,0,0,0,0,0,0.48054649490447493,0.5194535050955251
87244,0.5798319327731092,0.4587155963302753,-138,118,0.557480844469466,0.442519155530534,away,DET,over,8.5,0.5073891625615764,-103,0.4837652908580103,MIN,DET,2022 REG,12,5,5,3,8,17,1,0,2,-2,1,1,1,0,0,0,0,0,0,0.4837652908580103,0.5162347091419897
87244,0.5798319327731092,0.4587155963302753,-138,118,0.557480844469466,0.442519155530534,home,MIN,under,8.5,0.5391705069124424,-117,0.5162347091419897,MIN,DET,2022 REG,12,5,5,3,8,17,1,0,2,-2,1,1,1,0,0,0,0,0,0,0.4837652908580103,0.5162347091419897
87245,0.5535714285714286,0.48309178743961345,-124,107,0.5332757197081732,0.4667242802918268,away,LAA,over,7.5,0.5215311004784688,-109,0.49907282342437215,NYY,LAA,2022 REG,13,6,7,1,7,20,1,0,5,-5,1,0,0,0,0,0,0,0,0,0.49907282342437215,0.5009271765756278
87245,0.5535714285714286,0.48309178743961345,-124,107,0.5332757197081732,0.4667242802918268,home,NYY,under,7.5,0.5215311004784688,-109,0.5009271765756278,NYY,LAA,2022 REG,13,6,7,1,7,20,1,0,5,-5,1,0,0,0,0,0,0,0,0,0.49907282342437215,0.5009271765756278
87246,0.5555555555555556,0.4807692307692307,-125,108,0.5353751187084521,0.4646248812915479,away,LAA,over,7.5,0.5215311004784688,-109,0.49907282342437215,CWS,LAA,2022 REG,7,3,2,0,3,9,1,0,3,-3,0,0,0,0,0,0,0,0,0,0.49907282342437215,0.5009271765756278
87246,0.5555555555555556,0.4807692307692307,-125,108,0.5353751187084521,0.4646248812915479,home,CWS,under,7.5,0.5215311004784688,-109,0.5009271765756278,CWS,LAA,2022 REG,7,3,2,0,3,9,1,0,3,-3,0,0,0,0,0,0,0,0,0,0.49907282342437215,0.5009271765756278
87247,0.5192307692307692,0.5305164319248826,-108,-113,0.49340049170764233,0.5065995082923577,away,NYM,over,8,0.5327102803738317,-114,0.508788710910954,MIL,NYM,2022 REG,11,5,4,7,12,15,0,1,-2,2,1,1,1,1,1,0,0,0,0,0.508788710910954,0.491211289089046
87247,0.5192307692307692,0.5305164319248826,-108,-113,0.49340049170764233,0.5065995082923577,home,MIL,under,8,0.5121951219512195,-105,0.491211289089046,MIL,NYM,2022 REG,11,5,4,7,12,15,0,1,-2,2,1,1,1,1,1,0,0,0,0,0.508788710910954,0.491211289089046
87248,0.5833333333333333,0.46511627906976744,-140,115,0.5550710594315246,0.44492894056847543,away,SD,over,8,0.5121951219512195,-105,0.48808156828023186,SF,SD,2022 REG,4,1,17,10,11,21,0,1,-9,9,1,0,0,0,0,0,0,0,0,0.48808156828023186,0.5119184317197681
87248,0.5833333333333333,0.46511627906976744,-140,115,0.5550710594315246,0.44492894056847543,home,SF,under,8,0.5348837209302326,-115,0.5119184317197681,SF,SD,2022 REG,4,1,17,10,11,21,0,1,-9,9,1,0,0,0,0,0,0,0,0,0.48808156828023186,0.5119184317197681
87249,0.6254681647940076,0.41152263374485604,-167,143,0.6023315979176397,0.3976684020823603,away,BOS,over,7.5,0.5192307692307692,-108,0.49455035168025013,CWS,BOS,2022 REG,6,3,19,16,19,25,0,1,-13,13,1,1,1,0,0,0,0,0,0,0.49455035168025013,0.5054496483197499
87249,0.6254681647940076,0.41152263374485604,-167,143,0.6023315979176397,0.3976684020823603,home,CWS,under,7.5,0.5283018867924528,-112,0.5054496483197499,CWS,BOS,2022 REG,6,3,19,16,19,25,0,1,-13,13,1,1,1,0,0,0,0,0,0,0.49455035168025013,0.5054496483197499
87250,0.47619047619047616,0.5594713656387665,110,-127,0.4592086467479796,0.5407913532520203,away,SF,over,8,0.5073891625615764,-103,0.4837652908580103,CLE,SF,2022 REG,6,1,11,8,9,17,0,1,-7,7,1,0,0,0,0,0,0,0,0,0.4837652908580103,0.5162347091419897
87250,0.47619047619047616,0.5594713656387665,110,-127,0.4592086467479796,0.5407913532520203,home,CLE,under,8,0.5391705069124424,-117,0.5162347091419897,CLE,SF,2022 REG,6,1,11,8,9,17,0,1,-7,7,1,0,0,0,0,0,0,0,0,0.4837652908580103,0.5162347091419897
87251,0.7777777777777779,0.2597402597402597,-350,285,0.7485970819304154,0.2514029180695846,away,PIT,over,7.5,0.5238095238095238,-110,0.4988662131519274,MIL,PIT,2022 REG,11,7,10,5,12,21,1,0,2,-2,1,1,1,1,1,0,0,0,0,0.4988662131519274,0.5011337868480725
87251,0.7777777777777779,0.2597402597402597,-350,285,0.7485970819304154,0.2514029180695846,home,MIL,under,7.5,0.5238095238095238,-110,0.5011337868480725,MIL,PIT,2022 REG,11,7,10,5,12,21,1,0,2,-2,1,1,1,1,1,0,0,0,0,0.4988662131519274,0.5011337868480725
87252,0.504950495049505,0.5370370370370371,-102,-116,0.4837488699364985,0.5162511300635015,away,WSH,over,8.5,0.5145631067961165,-106,0.49023796582517226,PIT,WSH,2022 REG,7,5,8,3,8,15,1,0,2,-2,1,1,1,0,0,0,0,0,0,0.49023796582517226,0.5097620341748277
87252,0.504950495049505,0.5370370370370371,-102,-116,0.4837488699364985,0.5162511300635015,home,PIT,under,8.5,0.5327102803738317,-114,0.5097620341748277,PIT,WSH,2022 REG,7,5,8,3,8,15,1,0,2,-2,1,1,1,0,0,0,0,0,0,0.49023796582517226,0.5097620341748277
87253,0.7101449275362319,0.3278688524590164,-245,205,0.6831496344961281,0.3168503655038719,away,PIT,over,9,0.5169082125603864,-107,0.49239402434819424,ATL,PIT,2022 REG,8,10,6,4,14,14,1,0,6,-6,1,1,1,1,0,0,0,0,0,0.49239402434819424,0.5076059756518058
87253,0.7101449275362319,0.3278688524590164,-245,205,0.6831496344961281,0.3168503655038719,home,ATL,under,9,0.5305164319248826,-113,0.5076059756518058,ATL,PIT,2022 REG,8,10,6,4,14,14,1,0,6,-6,1,1,1,1,0,0,0,0,0,0.49239402434819424,0.5076059756518058
87254,0.5495495495495495,0.4854368932038835,-122,106,0.5303227656940593,0.46967723430594066,away,BOS,over,7.5,0.5073891625615764,-103,0.4826927225525911,OAK,BOS,2022 REG,7,2,7,5,7,14,0,1,-3,3,1,1,0,0,0,0,0,0,0,0.4826927225525911,0.5173072774474089
87254,0.5495495495495495,0.4854368932038835,-122,106,0.5303227656940593,0.46967723430594066,home,OAK,under,7.5,0.5412844036697247,-118,0.5173072774474089,OAK,BOS,2022 REG,7,2,7,5,7,14,0,1,-3,3,1,1,0,0,0,0,0,0,0,0.4826927225525911,0.5173072774474089
87255,0.42016806722689076,0.6226415094339623,138,-165,0.40218085014249866,0.5978191498575014,away,ATL,over,9.5,0.5238095238095238,-110,0.4988662131519274,BOS,ATL,2022 REG,11,7,13,9,16,24,0,1,-2,2,1,1,1,1,1,1,1,0,0,0.4988662131519274,0.5011337868480725
87255,0.42016806722689076,0.6226415094339623,138,-165,0.40218085014249866,0.5978191498575014,home,BOS,under,9.5,0.5238095238095238,-110,0.5011337868480725,BOS,ATL,2022 REG,11,7,13,9,16,24,0,1,-2,2,1,1,1,1,1,1,1,0,0,0.4988662131519274,0.5011337868480725
87256,0.5850622406639003,0.4587155963302753,-141,118,0.559449481260669,0.44055051873933104,away,KC,over,8,0.5238095238095238,-110,0.5012646084074657,TEX,KC,2022 REG,10,6,7,4,10,17,1,0,2,-2,1,1,1,1,0,0,0,0,0,0.5012646084074657,0.4987353915925343
87256,0.5850622406639003,0.4587155963302753,-141,118,0.559449481260669,0.44055051873933104,home,TEX,under,8,0.5192307692307692,-108,0.4987353915925343,TEX,KC,2022 REG,10,6,7,4,10,17,1,0,2,-2,1,1,1,1,0,0,0,0,0,0.5012646084074657,0.4987353915925343
87257,0.45454545454545453,0.5850622406639003,120,-141,0.4365419567230205,0.5634580432769796,away,NYY,over,7.5,0.5,100,0.4772727272727273,HOU,NYY,2022 REG,3,2,5,1,3,8,1,0,1,-1,1,0,0,0,0,0,0,0,0,0.4772727272727273,0.5227272727272727
87257,0.45454545454545453,0.5850622406639003,120,-141,0.4365419567230205,0.5634580432769796,home,HOU,under,7.5,0.5454545454545454,-120,0.5227272727272727,HOU,NYY,2022 REG,3,2,5,1,3,8,1,0,1,-1,1,0,0,0,0,0,0,0,0,0.4772727272727273,0.5227272727272727
87258,0.613899613899614,0.425531914893617,-159,135,0.589692613597978,0.410307386402022,away,KC,over,7,0.5391705069124424,-117,0.5127649394825569,OAK,KC,2022 REG,5,1,11,5,6,16,0,1,-4,4,1,0,0,0,0,0,0,0,0,0.5127649394825569,0.48723506051744314
87258,0.613899613899614,0.425531914893617,-159,135,0.589692613597978,0.410307386402022,home,OAK,under,7,0.5098039215686274,-104,0.48723506051744314,OAK,KC,2022 REG,5,1,11,5,6,16,0,1,-4,4,1,0,0,0,0,0,0,0,0,0.5127649394825569,0.48723506051744314
87259,0.5652173913043479,0.47619047619047616,-130,110,0.5418129444594474,0.4581870555405526,away,LAA,over,8.5,0.5327102803738317,-114,0.508788710910954,KC,LAA,2022 REG,7,0,9,4,4,16,0,1,-4,4,0,0,0,0,0,0,0,0,0,0.508788710910954,0.491211289089046
87259,0.5652173913043479,0.47619047619047616,-130,110,0.5418129444594474,0.4581870555405526,home,KC,under,8.5,0.5121951219512195,-105,0.491211289089046,KC,LAA,2022 REG,7,0,9,4,4,16,0,1,-4,4,0,0,0,0,0,0,0,0,0,0.508788710910954,0.491211289089046
87260,0.6875,0.35714285714285715,-220,180,0.6568080357142857,0.3431919642857143,away,CIN,over,7.5,0.5348837209302326,-115,0.5097020142727117,MIL,CIN,2022 REG,12,10,9,5,15,21,1,0,5,-5,1,1,1,1,1,0,0,0,0,0.5097020142727117,0.49029798572728833
87260,0.6875,0.35714285714285715,-220,180,0.6568080357142857,0.3431919642857143,home,MIL,under,7.5,0.5121951219512195,-105,0.49029798572728833,MIL,CIN,2022 REG,12,10,9,5,15,21,1,0,5,-5,1,1,1,1,1,0,0,0,0,0.5097020142727117,0.49029798572728833
87261,0.5238095238095238,0.5145631067961165,-110,-106,0.5037095744446646,0.4962904255553354,away,TB,over,10,0.5145631067961165,-106,0.4913668392989033,KC,TB,2022 REG,13,6,8,3,9,21,1,0,3,-3,1,1,1,0,0,0,0,0,0,0.4913668392989033,0.5086331607010968
87261,0.5238095238095238,0.5145631067961165,-110,-106,0.5037095744446646,0.4962904255553354,home,KC,under,10,0.5305164319248826,-113,0.5086331607010968,KC,TB,2022 REG,13,6,8,3,9,21,1,0,3,-3,1,1,1,0,0,0,0,0,0,0.4913668392989033,0.5086331607010968
87262,0.37037037037037035,0.6666666666666666,170,-200,0.35665294924554186,0.6433470507544581,away,ATL,over,9,0.5121951219512195,-105,0.48808156828023186,PIT,ATL,2022 REG,5,1,4,2,3,9,0,1,-1,1,1,0,0,0,0,0,0,0,0,0.48808156828023186,0.5119184317197681
87262,0.37037037037037035,0.6666666666666666,170,-200,0.35665294924554186,0.6433470507544581,home,PIT,under,9,0.5348837209302326,-115,0.5119184317197681,PIT,ATL,2022 REG,5,1,4,2,3,9,0,1,-1,1,1,0,0,0,0,0,0,0,0,0.48808156828023186,0.5119184317197681
87263,0.3076923076923077,0.7333333333333333,225,-275,0.29506903353057207,0.7049309664694279,away,ATL,over,7.5,0.5348837209302326,-115,0.5109810284308424,PIT,ATL,2022 REG,3,1,10,6,7,13,0,1,-5,5,1,0,0,0,0,0,0,0,0,0.5109810284308424,0.48901897156915763
87263,0.3076923076923077,0.7333333333333333,225,-275,0.29506903353057207,0.7049309664694279,home,PIT,under,7.5,0.5098039215686274,-104,0.48901897156915763,PIT,ATL,2022 REG,3,1,10,6,7,13,0,1,-5,5,1,0,0,0,0,0,0,0,0,0.5109810284308424,0.48901897156915763
87264,0.5454545454545454,0.49504950495049505,-120,102,0.5233614270517961,0.4766385729482039,away,CHC,over,9,0.5121951219512195,-105,0.48808156828023186,CIN,CHC,2022 REG,7,2,9,7,9,16,0,1,-5,5,1,1,0,0,0,0,0,0,0,0.48808156828023186,0.5119184317197681
87264,0.5454545454545454,0.49504950495049505,-120,102,0.5233614270517961,0.4766385729482039,home,CIN,under,9,0.5348837209302326,-115,0.5119184317197681,CIN,CHC,2022 REG,7,2,9,7,9,16,0,1,-5,5,1,1,0,0,0,0,0,0,0,0.48808156828023186,0.5119184317197681
87265,0.45454545454545453,0.5815899581589958,120,-139,0.43812026695252254,0.5618797330474774,away,HOU,over,8.5,0.5145631067961165,-106,0.4925063625223866,TEX,HOU,2022 REG,11,6,8,2,8,19,1,0,4,-4,1,1,0,0,0,0,0,0,0,0.4925063625223866,0.5074936374776133
87265,0.45454545454545453,0.5815899581589958,120,-139,0.43812026695252254,0.5618797330474774,home,TEX,under,8.5,0.5283018867924528,-112,0.5074936374776133,TEX,HOU,2022 REG,11,6,8,2,8,19,1,0,4,-4,1,1,0,0,0,0,0,0,0,0.4925063625223866,0.5074936374776133
87266,0.4504504504504505,0.5884773662551441,122,-143,0.4329153978803628,0.5670846021196372,away,CWS,over,8.5,0.5192307692307692,-108,0.49688292476754015,DET,CWS,2022 REG,2,1,13,10,11,15,0,1,-9,9,1,0,0,0,0,0,0,0,0,0.49688292476754015,0.5031170752324599
87266,0.4504504504504505,0.5884773662551441,122,-143,0.4329153978803628,0.5670846021196372,home,DET,under,8.5,0.5238095238095238,-110,0.5031170752324599,DET,CWS,2022 REG,2,1,13,10,11,15,0,1,-9,9,1,0,0,0,0,0,0,0,0,0.49688292476754015,0.5031170752324599
87267,0.6031746031746031,0.4347826086956522,-152,130,0.5802797769671475,0.4197202230328525,away,BAL,over,8.5,0.5348837209302326,-115,0.5097020142727117,BOS,BAL,2022 REG,9,5,9,3,8,18,1,0,2,-2,1,1,1,0,0,0,0,0,0,0.5097020142727117,0.49029798572728833
87267,0.6031746031746031,0.4347826086956522,-152,130,0.5802797769671475,0.4197202230328525,home,BOS,under,8.5,0.5121951219512195,-105,0.49029798572728833,BOS,BAL,2022 REG,9,5,9,3,8,18,1,0,2,-2,1,1,1,0,0,0,0,0,0,0.5097020142727117,0.49029798572728833
87268,0.5,0.5454545454545454,100,-120,0.4772727272727273,0.5227272727272727,away,CLE,over,7,0.4926108374384236,103,0.46986095270450623,SEA,CLE,2022 REG,8,3,9,2,5,17,1,0,1,-1,1,1,0,0,0,0,0,0,0,0.46986095270450623,0.5301390472954938
87268,0.5,0.5454545454545454,100,-120,0.4772727272727273,0.5227272727272727,home,SEA,under,7,0.5535714285714286,-124,0.5301390472954938,SEA,CLE,2022 REG,8,3,9,2,5,17,1,0,1,-1,1,1,0,0,0,0,0,0,0,0.46986095270450623,0.5301390472954938
87269,0.5726495726495727,0.46511627906976744,-134,115,0.5510229738017454,0.44897702619825464,away,CHC,over,8,0.5327102803738317,-114,0.508788710910954,PIT,CHC,2022 REG,6,3,10,8,11,16,0,1,-5,5,1,1,1,0,0,0,0,0,0,0.508788710910954,0.491211289089046
87269,0.5726495726495727,0.46511627906976744,-134,115,0.5510229738017454,0.44897702619825464,home,PIT,under,8,0.5121951219512195,-105,0.491211289089046,PIT,CHC,2022 REG,6,3,10,8,11,16,0,1,-5,5,1,1,1,0,0,0,0,0,0,0.508788710910954,0.491211289089046
87270,0.5215311004784688,0.5238095238095238,-109,-110,0.4978845547971712,0.5021154452028288,away,HOU,over,9.5,0.5370370370370371,-116,0.5118817074154765,LAA,HOU,2022 REG,7,1,7,4,5,14,0,1,-3,3,1,0,0,0,0,0,0,0,0,0.5118817074154765,0.48811829258452355
87270,0.5215311004784688,0.5238095238095238,-109,-110,0.4978845547971712,0.5021154452028288,home,LAA,under,9.5,0.5098039215686274,-104,0.48811829258452355,LAA,HOU,2022 REG,7,1,7,4,5,14,0,1,-3,3,1,0,0,0,0,0,0,0,0,0.5118817074154765,0.48811829258452355
87271,0.576271186440678,0.4629629629629629,-136,116,0.553661676614851,0.446338323385149,away,LAA,over,7,0.5454545454545454,-120,0.5193043049216726,MIN,LAA,2022 REG,11,8,7,4,12,18,1,0,4,-4,1,1,1,1,0,0,0,0,0,0.5193043049216726,0.48069569507832743
87271,0.576271186440678,0.4629629629629629,-136,116,0.553661676614851,0.446338323385149,home,MIN,under,7,0.5024875621890548,-101,0.48069569507832743,MIN,LAA,2022 REG,11,8,7,4,12,18,1,0,4,-4,1,1,1,1,0,0,0,0,0,0.5193043049216726,0.48069569507832743
87272,0.574468085106383,0.4672897196261683,-135,114,0.550479558983428,0.44952044101657196,away,LAA,over,7.5,0.5391705069124424,-117,0.5127649394825569,OAK,LAA,2022 REG,7,4,6,5,9,13,0,1,-1,1,1,1,1,1,0,0,0,0,0,0.5127649394825569,0.48723506051744314
87272,0.574468085106383,0.4672897196261683,-135,114,0.550479558983428,0.44952044101657196,home,OAK,under,7.5,0.5098039215686274,-104,0.48723506051744314,OAK,LAA,2022 REG,7,4,6,5,9,13,0,1,-1,1,1,1,1,1,0,0,0,0,0,0.5127649394825569,0.48723506051744314
87273,0.45454545454545453,0.5833333333333333,120,-140,0.43732782369146006,0.5626721763085399,away,STL,over,8.5,0.5412844036697247,-118,0.5149381613977361,CIN,STL,2022 REG,8,4,7,1,5,15,1,0,3,-3,1,0,0,0,0,0,0,0,0,0.5149381613977361,0.48506183860226393
87273,0.45454545454545453,0.5833333333333333,120,-140,0.43732782369146006,0.5626721763085399,home,CIN,under,8.5,0.5073891625615764,-103,0.48506183860226393,CIN,STL,2022 REG,8,4,7,1,5,15,1,0,3,-3,1,0,0,0,0,0,0,0,0,0.5149381613977361,0.48506183860226393
87274,0.6666666666666666,0.37037037037037035,-200,170,0.6419753086419753,0.3580246913580247,away,ARI,over,9,0.5215311004784688,-109,0.49907282342437215,LAD,ARI,2022 REG,10,12,11,3,15,21,1,0,9,-9,1,1,1,0,0,0,0,0,0,0.49907282342437215,0.5009271765756278
87274,0.6666666666666666,0.37037037037037035,-200,170,0.6419753086419753,0.3580246913580247,home,LAD,under,9,0.5215311004784688,-109,0.5009271765756278,LAD,ARI,2022 REG,10,12,11,3,15,21,1,0,9,-9,1,1,1,0,0,0,0,0,0,0.49907282342437215,0.5009271765756278
87275,0.35714285714285715,0.6825396825396826,180,-215,0.34297052154195007,0.6570294784580499,away,HOU,over,9,0.5283018867924528,-112,0.5044173060022736,KC,HOU,2022 REG,7,4,12,7,11,19,0,1,-3,3,1,1,1,1,0,0,0,0,0,0.5044173060022736,0.49558269399772636
87275,0.35714285714285715,0.6825396825396826,180,-215,0.34297052154195007,0.6570294784580499,home,KC,under,9,0.5169082125603864,-107,0.49558269399772636,KC,HOU,2022 REG,7,4,12,7,11,19,0,1,-3,3,1,1,1,1,0,0,0,0,0,0.5044173060022736,0.49558269399772636
87276,0.6031746031746031,0.43103448275862066,-152,132,0.582540551341865,0.417459448658135,away,CIN,over,7.5,0.5283018867924528,-112,0.5031902949311281,CHC,CIN,2022 REG,9,9,4,3,12,13,1,0,6,-6,1,1,1,0,0,0,0,0,0,0.5031902949311281,0.4968097050688719
87276,0.6031746031746031,0.43103448275862066,-152,132,0.582540551341865,0.417459448658135,home,CHC,under,7.5,0.5192307692307692,-108,0.4968097050688719,CHC,CIN,2022 REG,9,9,4,3,12,13,1,0,6,-6,1,1,1,0,0,0,0,0,0,0.5031902949311281,0.4968097050688719
87277,0.5192307692307692,0.5238095238095238,-108,-110,0.49688292476754015,0.5031170752324599,away,MIL,over,6.5,0.5121951219512195,-105,0.48808156828023186,SF,MIL,2022 REG,4,2,13,3,5,17,0,1,-1,1,1,1,0,0,0,0,0,0,0,0.48808156828023186,0.5119184317197681
87277,0.5192307692307692,0.5238095238095238,-108,-110,0.49688292476754015,0.5031170752324599,home,SF,under,6.5,0.5348837209302326,-115,0.5119184317197681,SF,MIL,2022 REG,4,2,13,3,5,17,0,1,-1,1,1,1,0,0,0,0,0,0,0,0.48808156828023186,0.5119184317197681
87278,0.6254681647940076,0.4132231404958678,-167,142,0.6012679850808645,0.39873201491913546,away,ARI,over,7.5,0.5192307692307692,-108,0.49688292476754015,STL,ARI,2022 REG,2,0,5,2,2,7,0,1,-2,2,0,0,0,0,0,0,0,0,0,0.49688292476754015,0.5031170752324599
87278,0.6254681647940076,0.4132231404958678,-167,142,0.6012679850808645,0.39873201491913546,home,STL,under,7.5,0.5238095238095238,-110,0.5031170752324599,STL,ARI,2022 REG,2,0,5,2,2,7,0,1,-2,2,0,0,0,0,0,0,0,0,0,0.49688292476754015,0.5031170752324599
87279,0.4854368932038835,0.5535714285714286,106,-124,0.4665008146721786,0.5334991853278215,away,MIA,over,8.5,0.5121951219512195,-105,0.48808156828023186,ARI,MIA,2022 REG,7,4,9,3,7,16,1,0,1,-1,1,1,1,0,0,0,0,0,0,0.48808156828023186,0.5119184317197681
87279,0.4854368932038835,0.5535714285714286,106,-124,0.4665008146721786,0.5334991853278215,home,ARI,under,8.5,0.5348837209302326,-115,0.5119184317197681,ARI,MIA,2022 REG,7,4,9,3,7,16,1,0,1,-1,1,1,1,0,0,0,0,0,0,0.48808156828023186,0.5119184317197681
87280,0.4,0.6389891696750902,150,-177,0.3844043321299639,0.6155956678700361,away,ATL,over,8.5,0.5348837209302326,-115,0.5097020142727117,CIN,ATL,2022 REG,7,4,9,3,7,16,1,0,1,-1,1,1,1,0,0,0,0,0,0,0.5097020142727117,0.49029798572728833
87280,0.4,0.6389891696750902,150,-177,0.3844043321299639,0.6155956678700361,home,CIN,under,8.5,0.5121951219512195,-105,0.49029798572728833,CIN,ATL,2022 REG,7,4,9,3,7,16,1,0,1,-1,1,1,1,0,0,0,0,0,0,0.5097020142727117,0.49029798572728833
87281,0.5454545454545454,0.49504950495049505,-120,102,0.5233614270517961,0.4766385729482039,away,TB,over,9,0.5192307692307692,-108,0.49455035168025013,MIN,TB,2022 REG,13,9,6,4,13,19,1,0,5,-5,1,1,1,1,0,0,0,0,0,0.49455035168025013,0.5054496483197499
87281,0.5454545454545454,0.49504950495049505,-120,102,0.5233614270517961,0.4766385729482039,home,MIN,under,9,0.5283018867924528,-112,0.5054496483197499,MIN,TB,2022 REG,13,9,6,4,13,19,1,0,5,-5,1,1,1,1,0,0,0,0,0,0.49455035168025013,0.5054496483197499
87282,0.4,0.6428571428571428,150,-180,0.38285714285714295,0.617142857142857,away,ATL,over,11,0.5215311004784688,-109,0.50027251771145,COL,ATL,2022 REG,3,1,8,3,4,11,0,1,-2,2,1,0,0,0,0,0,0,0,0,0.50027251771145,0.49972748228855
87282,0.4,0.6428571428571428,150,-180,0.38285714285714295,0.617142857142857,home,COL,under,11,0.5192307692307692,-108,0.49972748228855,COL,ATL,2022 REG,3,1,8,3,4,11,0,1,-2,2,1,0,0,0,0,0,0,0,0,0.50027251771145,0.49972748228855
87283,0.5850622406639003,0.45454545454545453,-141,120,0.5618892737571823,0.43811072624281766,away,KC,over,8.5,0.5348837209302326,-115,0.5097020142727117,CWS,KC,2022 REG,12,4,4,1,5,16,1,0,3,-3,1,0,0,0,0,0,0,0,0,0.5097020142727117,0.49029798572728833
87283,0.5850622406639003,0.45454545454545453,-141,120,0.5618892737571823,0.43811072624281766,home,CWS,under,8.5,0.5121951219512195,-105,0.49029798572728833,CWS,KC,2022 REG,12,4,4,1,5,16,1,0,3,-3,1,0,0,0,0,0,0,0,0,0.5097020142727117,0.49029798572728833
87284,0.4807692307692307,0.5594713656387665,108,-127,0.46142279018846283,0.5385772098115371,away,MIN,over,9,0.5121951219512195,-105,0.48808156828023186,ARI,MIN,2022 REG,8,7,5,1,8,13,1,0,6,-6,1,0,0,0,0,0,0,0,0,0.48808156828023186,0.5119184317197681
87284,0.4807692307692307,0.5594713656387665,108,-127,0.46142279018846283,0.5385772098115371,home,ARI,under,9,0.5348837209302326,-115,0.5119184317197681,ARI,MIN,2022 REG,8,7,5,1,8,13,1,0,6,-6,1,0,0,0,0,0,0,0,0,0.48808156828023186,0.5119184317197681
87285,0.6428571428571428,0.39370078740157477,-180,154,0.6193556162622529,0.3806443837377471,away,CWS,over,9,0.5121951219512195,-105,0.48808156828023186,NYY,CWS,2022 REG,8,1,8,3,4,16,0,1,-2,2,1,0,0,0,0,0,0,0,0,0.48808156828023186,0.5119184317197681
87285,0.6428571428571428,0.39370078740157477,-180,154,0.6193556162622529,0.3806443837377471,home,NYY,under,9,0.5348837209302326,-115,0.5119184317197681,NYY,CWS,2022 REG,8,1,8,3,4,16,0,1,-2,2,1,0,0,0,0,0,0,0,0,0.48808156828023186,0.5119184317197681
87286,0.4,0.6428571428571428,150,-180,0.38285714285714295,0.617142857142857,away,SD,over,10.5,0.5391705069124424,-117,0.5127649394825569,COL,SD,2022 REG,18,10,11,6,16,29,1,0,4,-4,1,1,1,1,1,1,0,0,0,0.5127649394825569,0.48723506051744314
87286,0.4,0.6428571428571428,150,-180,0.38285714285714295,0.617142857142857,home,COL,under,10.5,0.5098039215686274,-104,0.48723506051744314,COL,SD,2022 REG,18,10,11,6,16,29,1,0,4,-4,1,1,1,1,1,1,0,0,0,0.5127649394825569,0.48723506051744314
87287,0.4484304932735426,0.5850622406639003,123,-141,0.43341133007289556,0.5665886699271044,away,CWS,over,6.5,0.5454545454545454,-120,0.5206611570247933,CHC,CWS,2022 REG,6,1,7,3,4,13,0,1,-2,2,1,0,0,0,0,0,0,0,0,0.5206611570247933,0.4793388429752067
87287,0.4484304932735426,0.5850622406639003,123,-141,0.43341133007289556,0.5665886699271044,home,CHC,under,6.5,0.5,100,0.4793388429752067,CHC,CWS,2022 REG,6,1,7,3,4,13,0,1,-2,2,1,0,0,0,0,0,0,0,0,0.5206611570247933,0.4793388429752067
87288,0.5495495495495495,0.48780487804878053,-122,105,0.529021440689206,0.470978559310794,away,ATL,over,7.5,0.5,100,0.4772727272727273,MIA,ATL,2022 REG,13,12,15,9,21,28,1,0,3,-3,1,1,1,1,1,1,1,1,1,0.4772727272727273,0.5227272727272727
87288,0.5495495495495495,0.48780487804878053,-122,105,0.529021440689206,0.470978559310794,home,MIA,under,7.5,0.5454545454545454,-120,0.5227272727272727,MIA,ATL,2022 REG,13,12,15,9,21,28,1,0,3,-3,1,1,1,1,1,1,1,1,1,0.4772727272727273,0.5227272727272727
87289,0.5327102803738317,0.5073891625615764,-114,-103,0.511348894884876,0.488651105115124,away,STL,over,8.5,0.5475113122171946,-121,0.5214983313199976,CHC,STL,2022 REG,13,6,5,1,7,18,1,0,5,-5,1,0,0,0,0,0,0,0,0,0.5214983313199976,0.47850166868000243
87289,0.5327102803738317,0.5073891625615764,-114,-103,0.511348894884876,0.488651105115124,home,CHC,under,8.5,0.5,100,0.47850166868000243,CHC,STL,2022 REG,13,6,5,1,7,18,1,0,5,-5,1,0,0,0,0,0,0,0,0,0.5214983313199976,0.47850166868000243
87290,0.4098360655737705,0.6323529411764706,144,-172,0.39254548903678643,0.6074545109632136,away,MIA,over,7,0.5192307692307692,-108,0.49688292476754015,PIT,MIA,2022 REG,6,5,11,6,11,17,0,1,-1,1,1,1,1,1,1,0,0,0,0,0.49688292476754015,0.5031170752324599
87290,0.4098360655737705,0.6323529411764706,144,-172,0.39254548903678643,0.6074545109632136,home,PIT,under,7,0.5238095238095238,-110,0.5031170752324599,PIT,MIA,2022 REG,6,5,11,6,11,17,0,1,-1,1,1,1,1,1,1,0,0,0,0,0.49688292476754015,0.5031170752324599
87291,0.607843137254902,0.425531914893617,-155,135,0.5875563408509002,0.41244365914909975,away,SF,over,9.5,0.5238095238095238,-110,0.4988662131519274,ATL,SF,2022 REG,10,7,14,6,13,24,1,0,1,-1,1,1,1,1,1,1,0,0,0,0.4988662131519274,0.5011337868480725
87291,0.607843137254902,0.425531914893617,-155,135,0.5875563408509002,0.41244365914909975,home,ATL,under,9.5,0.5238095238095238,-110,0.5011337868480725,ATL,SF,2022 REG,10,7,14,6,13,24,1,0,1,-1,1,1,1,1,1,1,0,0,0,0.4988662131519274,0.5011337868480725
87292,0.75,0.2857142857142857,-300,250,0.7232142857142858,0.2767857142857142,away,CHC,over,8,0.5238095238095238,-110,0.4988662131519274,NYM,CHC,2022 REG,8,2,7,5,7,15,0,1,-3,3,1,1,0,0,0,0,0,0,0,0.4988662131519274,0.5011337868480725
87292,0.75,0.2857142857142857,-300,250,0.7232142857142858,0.2767857142857142,home,NYM,under,8,0.5238095238095238,-110,0.5011337868480725,NYM,CHC,2022 REG,8,2,7,5,7,15,0,1,-3,3,1,1,0,0,0,0,0,0,0,0.4988662131519274,0.5011337868480725
87293,0.36363636363636365,0.6721311475409836,175,-205,0.3506299959355101,0.6493700040644899,away,NYY,over,8,0.5192307692307692,-108,0.49688292476754015,BAL,NYY,2022 REG,11,9,10,6,15,21,1,0,3,-3,1,1,1,1,1,1,0,0,0,0.49688292476754015,0.5031170752324599
87293,0.36363636363636365,0.6721311475409836,175,-205,0.3506299959355101,0.6493700040644899,home,BAL,under,8,0.5238095238095238,-110,0.5031170752324599,BAL,NYY,2022 REG,11,9,10,6,15,21,1,0,3,-3,1,1,1,1,1,1,0,0,0,0.49688292476754015,0.5031170752324599
87294,0.5555555555555556,0.48309178743961345,-125,107,0.5340848094471283,0.46591519055287167,away,MIN,over,9,0.49504950495049505,102,0.47297076509898783,CLE,MIN,2022 REG,10,7,11,6,13,21,1,0,1,-1,1,1,1,1,1,1,0,0,0,0.47297076509898783,0.5270292349010122
87294,0.5555555555555556,0.48309178743961345,-125,107,0.5340848094471283,0.46591519055287167,home,CLE,under,9,0.5495495495495495,-122,0.5270292349010122,CLE,MIN,2022 REG,10,7,11,6,13,21,1,0,1,-1,1,1,1,1,1,1,0,0,0,0.47297076509898783,0.5270292349010122
87295,0.5495495495495495,0.48780487804878053,-122,105,0.529021440689206,0.470978559310794,away,SD,over,8.5,0.5073891625615764,-103,0.4826927225525911,MIL,SD,2022 REG,9,5,9,4,9,18,1,0,1,-1,1,1,1,1,0,0,0,0,0,0.4826927225525911,0.5173072774474089
87295,0.5495495495495495,0.48780487804878053,-122,105,0.529021440689206,0.470978559310794,home,MIL,under,8.5,0.5412844036697247,-118,0.5173072774474089,MIL,SD,2022 REG,9,5,9,4,9,18,1,0,1,-1,1,1,1,1,0,0,0,0,0,0.4826927225525911,0.5173072774474089
87296,0.5555555555555556,0.48780487804878053,-125,105,0.5314664257753688,0.46853357422463116,away,TEX,over,9,0.5238095238095238,-110,0.4988662131519274,CLE,TEX,2022 REG,9,6,8,3,9,17,1,0,3,-3,1,1,1,0,0,0,0,0,0,0.4988662131519274,0.5011337868480725
87296,0.5555555555555556,0.48780487804878053,-125,105,0.5314664257753688,0.46853357422463116,home,CLE,under,9,0.5238095238095238,-110,0.5011337868480725,CLE,TEX,2022 REG,9,6,8,3,9,17,1,0,3,-3,1,1,1,0,0,0,0,0,0,0.4988662131519274,0.5011337868480725
87297,0.3968253968253968,0.6428571428571428,152,-180,0.3810783572688335,0.6189216427311666,away,LAA,over,3,0.5708154506437768,-133,0.5332187163346002,OAK,LAA,2022 REG,7,1,9,9,10,16,0,1,-8,8,1,0,0,0,0,0,0,0,0,0.5332187163346002,0.46678128366539984
87297,0.3968253968253968,0.6428571428571428,152,-180,0.3810783572688335,0.6189216427311666,home,OAK,under,3,0.49504950495049505,102,0.46678128366539984,OAK,LAA,2022 REG,7,1,9,9,10,16,0,1,-8,8,1,0,0,0,0,0,0,0,0,0.5332187163346002,0.46678128366539984
87298,0.4807692307692307,0.5594713656387665,108,-127,0.46142279018846283,0.5385772098115371,away,LAA,over,8.5,0.5327102803738317,-114,0.5075272610403079,BOS,LAA,2022 REG,9,4,3,0,4,12,1,0,4,-4,0,0,0,0,0,0,0,0,0,0.5075272610403079,0.4924727389596921
87298,0.4807692307692307,0.5594713656387665,108,-127,0.46142279018846283,0.5385772098115371,home,BOS,under,8.5,0.5145631067961165,-106,0.4924727389596921,BOS,LAA,2022 REG,9,4,3,0,4,12,1,0,4,-4,0,0,0,0,0,0,0,0,0,0.5075272610403079,0.4924727389596921
87299,0.5850622406639003,0.4587155963302753,-141,118,0.559449481260669,0.44055051873933104,away,SEA,over,9,0.5238095238095238,-110,0.4988662131519274,LAA,SEA,2022 REG,6,2,6,1,3,12,1,0,1,-1,1,0,0,0,0,0,0,0,0,0.4988662131519274,0.5011337868480725
87299,0.5850622406639003,0.4587155963302753,-141,118,0.559449481260669,0.44055051873933104,home,LAA,under,9,0.5238095238095238,-110,0.5011337868480725,LAA,SEA,2022 REG,6,2,6,1,3,12,1,0,1,-1,1,0,0,0,0,0,0,0,0,0.4988662131519274,0.5011337868480725
87300,0.6666666666666666,0.37037037037037035,-200,170,0.6419753086419753,0.3580246913580247,away,WSH,over,8,0.5283018867924528,-112,0.5019750255927206,CHC,WSH,2022 REG,11,6,8,3,9,19,1,0,3,-3,1,1,1,0,0,0,0,0,0,0.5019750255927206,0.49802497440727944
87300,0.6666666666666666,0.37037037037037035,-200,170,0.6419753086419753,0.3580246913580247,home,CHC,under,8,0.5215311004784688,-109,0.49802497440727944,CHC,WSH,2022 REG,11,6,8,3,9,19,1,0,3,-3,1,1,1,0,0,0,0,0,0,0.5019750255927206,0.49802497440727944
87301,0.41152263374485604,0.6363636363636364,143,-175,0.3918163497495917,0.6081836502504083,away,TB,over,8,0.5305164319248826,-113,0.5053568787472517,BAL,TB,2022 REG,10,6,14,7,13,24,0,1,-1,1,1,1,1,1,1,1,0,0,0,0.5053568787472517,0.49464312125274834
87301,0.41152263374485604,0.6363636363636364,143,-175,0.3918163497495917,0.6081836502504083,home,BAL,under,8,0.5169082125603864,-107,0.49464312125274834,BAL,TB,2022 REG,10,6,14,7,13,24,0,1,-1,1,1,1,1,1,1,1,0,0,0,0.5053568787472517,0.49464312125274834
87302,0.5967741935483871,0.4444444444444444,-148,125,0.5721759741010521,0.42782402589894786,away,SD,over,7,0.5073891625615764,-103,0.4859403596076043,SF,SD,2022 REG,6,1,6,2,3,12,0,1,-1,1,1,0,0,0,0,0,0,0,0,0.4859403596076043,0.5140596403923957
87302,0.5967741935483871,0.4444444444444444,-148,125,0.5721759741010521,0.42782402589894786,home,SF,under,7,0.5348837209302326,-115,0.5140596403923957,SF,SD,2022 REG,6,1,6,2,3,12,0,1,-1,1,1,0,0,0,0,0,0,0,0,0.4859403596076043,0.5140596403923957
87303,0.6000000000000001,0.43859649122807015,-150,128,0.5768421052631579,0.42315789473684207,away,CLE,over,7,0.5454545454545454,-120,0.5206611570247933,TOR,CLE,2022 REG,8,2,13,7,9,21,0,1,-5,5,1,1,0,0,0,0,0,0,0,0.5206611570247933,0.4793388429752067
87303,0.6000000000000001,0.43859649122807015,-150,128,0.5768421052631579,0.42315789473684207,home,TOR,under,7,0.5,100,0.4793388429752067,TOR,CLE,2022 REG,8,2,13,7,9,21,0,1,-5,5,1,1,0,0,0,0,0,0,0,0.5206611570247933,0.4793388429752067
87304,0.6610169491525424,0.37735849056603776,-195,165,0.6356501330673793,0.3643498669326207,away,CIN,over,8.5,0.5238095238095238,-110,0.4988662131519274,SD,CIN,2022 REG,6,6,5,0,6,11,1,0,6,-6,0,0,0,0,0,0,0,0,0,0.4988662131519274,0.5011337868480725
87304,0.6610169491525424,0.37735849056603776,-195,165,0.6356501330673793,0.3643498669326207,home,SD,under,8.5,0.5238095238095238,-110,0.5011337868480725,SD,CIN,2022 REG,6,6,5,0,6,11,1,0,6,-6,0,0,0,0,0,0,0,0,0,0.4988662131519274,0.5011337868480725
87305,0.4166666666666667,0.6153846153846154,140,-160,0.40331196581196577,0.5966880341880343,away,BOS,over,7,0.5495495495495495,-122,0.5236866555946829,OAK,BOS,2022 REG,6,2,10,7,9,16,0,1,-5,5,1,1,0,0,0,0,0,0,0,0.5236866555946829,0.47631334440531714
87305,0.4166666666666667,0.6153846153846154,140,-160,0.40331196581196577,0.5966880341880343,home,OAK,under,7,0.49751243781094534,101,0.47631334440531714,OAK,BOS,2022 REG,6,2,10,7,9,16,0,1,-5,5,1,1,0,0,0,0,0,0,0,0.5236866555946829,0.47631334440531714
87306,0.5495495495495495,0.48780487804878053,-122,105,0.529021440689206,0.470978559310794,away,SEA,over,9,0.5073891625615764,-103,0.4837652908580103,TEX,SEA,2022 REG,5,3,4,2,5,9,1,0,1,-1,1,1,0,0,0,0,0,0,0,0.4837652908580103,0.5162347091419897
87306,0.5495495495495495,0.48780487804878053,-122,105,0.529021440689206,0.470978559310794,home,TEX,under,9,0.5391705069124424,-117,0.5162347091419897,TEX,SEA,2022 REG,5,3,4,2,5,9,1,0,1,-1,1,1,0,0,0,0,0,0,0,0.4837652908580103,0.5162347091419897
87307,0.5098039215686274,0.5283018867924528,-104,-112,0.4903774310316062,0.5096225689683938,away,BOS,over,9,0.5475113122171946,-121,0.5228602997583487,CLE,BOS,2022 REG,8,3,15,8,11,23,0,1,-5,5,1,1,1,0,0,0,0,0,0,0.5228602997583487,0.4771397002416513
87307,0.5098039215686274,0.5283018867924528,-104,-112,0.4903774310316062,0.5096225689683938,home,CLE,under,9,0.49751243781094534,101,0.4771397002416513,CLE,BOS,2022 REG,8,3,15,8,11,23,0,1,-5,5,1,1,1,0,0,0,0,0,0,0.5228602997583487,0.4771397002416513
87308,0.5,0.5412844036697247,100,-118,0.47935779816513757,0.5206422018348624,away,STL,over,8,0.5169082125603864,-107,0.49353874091423283,MIA,STL,2022 REG,8,1,8,5,6,16,0,1,-4,4,1,0,0,0,0,0,0,0,0,0.49353874091423283,0.5064612590857671
87308,0.5,0.5412844036697247,100,-118,0.47935779816513757,0.5206422018348624,home,MIA,under,8,0.5283018867924528,-112,0.5064612590857671,MIA,STL,2022 REG,8,1,8,5,6,16,0,1,-4,4,1,0,0,0,0,0,0,0,0,0.49353874091423283,0.5064612590857671
87309,0.6000000000000001,0.4347826086956522,-150,130,0.5791304347826086,0.4208695652173914,away,SF,over,7.5,0.5,100,0.4772727272727273,SD,SF,2022 REG,14,6,4,2,8,18,1,0,4,-4,1,1,0,0,0,0,0,0,0,0.4772727272727273,0.5227272727272727
87309,0.6000000000000001,0.4347826086956522,-150,130,0.5791304347826086,0.4208695652173914,home,SD,under,7.5,0.5454545454545454,-120,0.5227272727272727,SD,SF,2022 REG,14,6,4,2,8,18,1,0,4,-4,1,1,0,0,0,0,0,0,0,0.4772727272727273,0.5227272727272727
87310,0.5145631067961165,0.5215311004784688,-106,-109,0.4959903593635629,0.5040096406364372,away,SD,over,8.5,0.5098039215686274,-104,0.48483656587239576,CIN,SD,2022 REG,8,5,11,7,12,19,0,1,-2,2,1,1,1,1,1,0,0,0,0,0.48483656587239576,0.5151634341276042
87310,0.5145631067961165,0.5215311004784688,-106,-109,0.4959903593635629,0.5040096406364372,home,CIN,under,8.5,0.5391705069124424,-117,0.5151634341276042,CIN,SD,2022 REG,8,5,11,7,12,19,0,1,-2,2,1,1,1,1,1,0,0,0,0,0.48483656587239576,0.5151634341276042
87311,0.6226415094339623,0.41152263374485604,-165,143,0.6013694957565848,0.3986305042434152,away,KC,over,9,0.5,100,0.4772727272727273,MIN,KC,2022 REG,11,3,11,7,10,22,0,1,-4,4,1,1,1,0,0,0,0,0,0,0.4772727272727273,0.5227272727272727
87311,0.6226415094339623,0.41152263374485604,-165,143,0.6013694957565848,0.3986305042434152,home,MIN,under,9,0.5454545454545454,-120,0.5227272727272727,MIN,KC,2022 REG,11,3,11,7,10,22,0,1,-4,4,1,1,1,0,0,0,0,0,0,0.4772727272727273,0.5227272727272727
87312,0.10526315789473684,0.9545454545454545,850,-2100,0.09896751447997985,0.9010324855200201,away,SF,over,7.5,0.5348837209302326,-115,0.5097020142727117,OAK,SF,2022 REG,9,4,9,6,10,18,0,1,-2,2,1,1,1,1,0,0,0,0,0,0.5097020142727117,0.49029798572728833
87312,0.10526315789473684,0.9545454545454545,850,-2100,0.09896751447997985,0.9010324855200201,home,OAK,under,7.5,0.5121951219512195,-105,0.49029798572728833,OAK,SF,2022 REG,9,4,9,6,10,18,0,1,-2,2,1,1,1,1,0,0,0,0,0,0.5097020142727117,0.49029798572728833
87313,0.6124031007751938,0.4273504273504274,-158,134,0.5880579168843095,0.41194208311569047,away,TOR,over,7.5,0.5,100,0.4772727272727273,NYY,TOR,2022 REG,5,6,7,5,11,12,1,0,1,-1,1,1,1,1,1,0,0,0,0,0.4772727272727273,0.5227272727272727
87313,0.6124031007751938,0.4273504273504274,-158,134,0.5880579168843095,0.41194208311569047,home,NYY,under,7.5,0.5454545454545454,-120,0.5227272727272727,NYY,TOR,2022 REG,5,6,7,5,11,12,1,0,1,-1,1,1,1,1,1,0,0,0,0,0.4772727272727273,0.5227272727272727
87314,0.36363636363636365,0.6666666666666666,175,-200,0.3526170798898072,0.6473829201101928,away,NYY,over,8.5,0.5145631067961165,-106,0.4913668392989033,BAL,NYY,2022 REG,9,5,4,0,5,13,1,0,5,-5,0,0,0,0,0,0,0,0,0,0.4913668392989033,0.5086331607010968
87314,0.36363636363636365,0.6666666666666666,175,-200,0.3526170798898072,0.6473829201101928,home,BAL,under,8.5,0.5305164319248826,-113,0.5086331607010968,BAL,NYY,2022 REG,9,5,4,0,5,13,1,0,5,-5,0,0,0,0,0,0,0,0,0,0.4913668392989033,0.5086331607010968
87315,0.7333333333333333,0.3076923076923077,-275,225,0.7032478632478633,0.29675213675213674,away,OAK,over,7,0.5238095238095238,-110,0.5000596729920038,SEA,OAK,2022 REG,5,3,12,10,13,17,0,1,-7,7,1,1,1,0,0,0,0,0,0,0.5000596729920038,0.4999403270079962
87315,0.7333333333333333,0.3076923076923077,-275,225,0.7032478632478633,0.29675213675213674,home,SEA,under,7,0.5215311004784688,-109,0.4999403270079962,SEA,OAK,2022 REG,5,3,12,10,13,17,0,1,-7,7,1,1,1,0,0,0,0,0,0,0.5000596729920038,0.4999403270079962
87316,0.6363636363636364,0.4081632653061224,-175,145,0.6080283353010626,0.3919716646989374,away,WSH,over,8.5,0.5238095238095238,-110,0.5012646084074657,LAA,WSH,2022 REG,7,3,10,7,10,17,0,1,-4,4,1,1,1,0,0,0,0,0,0,0.5012646084074657,0.4987353915925343
87316,0.6363636363636364,0.4081632653061224,-175,145,0.6080283353010626,0.3919716646989374,home,LAA,under,8.5,0.5192307692307692,-108,0.4987353915925343,LAA,WSH,2022 REG,7,3,10,7,10,17,0,1,-4,4,1,1,1,0,0,0,0,0,0,0.5012646084074657,0.4987353915925343
87317,0.6124031007751938,0.4273504273504274,-158,134,0.5880579168843095,0.41194208311569047,away,WSH,over,9,0.5121951219512195,-105,0.48808156828023186,BAL,WSH,2022 REG,11,7,3,0,7,14,1,0,7,-7,0,0,0,0,0,0,0,0,0,0.48808156828023186,0.5119184317197681
87317,0.6124031007751938,0.4273504273504274,-158,134,0.5880579168843095,0.41194208311569047,home,BAL,under,9,0.5348837209302326,-115,0.5119184317197681,BAL,WSH,2022 REG,11,7,3,0,7,14,1,0,7,-7,0,0,0,0,0,0,0,0,0,0.48808156828023186,0.5119184317197681
87318,0.6296296296296295,0.40322580645161293,-170,148,0.6089428735784769,0.3910571264215231,away,ARI,over,8,0.5192307692307692,-108,0.49571111079951763,NYM,ARI,2022 REG,5,2,9,3,5,14,0,1,-1,1,1,1,0,0,0,0,0,0,0,0.49571111079951763,0.5042888892004824
87318,0.6296296296296295,0.40322580645161293,-170,148,0.6089428735784769,0.3910571264215231,home,NYM,under,8,0.5260663507109005,-111,0.5042888892004824,NYM,ARI,2022 REG,5,2,9,3,5,14,0,1,-1,1,1,1,0,0,0,0,0,0,0,0.49571111079951763,0.5042888892004824
87319,0.26666666666666666,0.7752808988764045,275,-345,0.2554806491885143,0.7445193508114857,away,SD,over,9,0.5073891625615764,-103,0.4837652908580103,WSH,SD,2022 REG,10,4,8,3,7,18,1,0,1,-1,1,1,1,0,0,0,0,0,0,0.4837652908580103,0.5162347091419897
87319,0.26666666666666666,0.7752808988764045,275,-345,0.2554806491885143,0.7445193508114857,home,WSH,under,9,0.5391705069124424,-117,0.5162347091419897,WSH,SD,2022 REG,10,4,8,3,7,18,1,0,1,-1,1,1,1,0,0,0,0,0,0,0.4837652908580103,0.5162347091419897
87320,0.6875,0.35714285714285715,-220,180,0.6568080357142857,0.3431919642857143,away,MIA,over,7,0.5169082125603864,-107,0.49353874091423283,NYM,MIA,2022 REG,7,4,11,6,10,18,0,1,-2,2,1,1,1,1,0,0,0,0,0,0.49353874091423283,0.5064612590857671
87320,0.6875,0.35714285714285715,-220,180,0.6568080357142857,0.3431919642857143,home,NYM,under,7,0.5283018867924528,-112,0.5064612590857671,NYM,MIA,2022 REG,7,4,11,6,10,18,0,1,-2,2,1,1,1,1,0,0,0,0,0,0.49353874091423283,0.5064612590857671
87321,0.613899613899614,0.42016806722689076,-159,138,0.5929854776095975,0.4070145223904025,away,PIT,over,11,0.5169082125603864,-107,0.49239402434819424,COL,PIT,2022 REG,17,13,6,2,15,23,1,0,11,-11,1,1,0,0,0,0,0,0,0,0.49239402434819424,0.5076059756518058
87321,0.613899613899614,0.42016806722689076,-159,138,0.5929854776095975,0.4070145223904025,home,COL,under,11,0.5305164319248826,-113,0.5076059756518058,COL,PIT,2022 REG,17,13,6,2,15,23,1,0,11,-11,1,1,0,0,0,0,0,0,0,0.49239402434819424,0.5076059756518058
87322,0.4484304932735426,0.5918367346938775,123,-145,0.43037344037335423,0.5696265596266458,away,TEX,over,7,0.5412844036697247,-118,0.5149381613977361,OAK,TEX,2022 REG,12,8,16,11,19,28,0,1,-3,3,1,1,1,1,1,1,1,1,0,0.5149381613977361,0.48506183860226393
87322,0.4484304932735426,0.5918367346938775,123,-145,0.43037344037335423,0.5696265596266458,home,OAK,under,7,0.5073891625615764,-103,0.48506183860226393,OAK,TEX,2022 REG,12,8,16,11,19,28,0,1,-3,3,1,1,1,1,1,1,1,1,0,0.5149381613977361,0.48506183860226393
87323,0.7354497354497355,0.30303030303030304,-278,230,0.7071496013294954,0.29285039867050455,away,PIT,over,7.5,0.5121951219512195,-105,0.48808156828023186,MIL,PIT,2022 REG,9,3,5,4,7,14,0,1,-1,1,1,1,1,0,0,0,0,0,0,0.48808156828023186,0.5119184317197681
87323,0.7354497354497355,0.30303030303030304,-278,230,0.7071496013294954,0.29285039867050455,home,MIL,under,7.5,0.5348837209302326,-115,0.5119184317197681,MIL,PIT,2022 REG,9,3,5,4,7,14,0,1,-1,1,1,1,1,0,0,0,0,0,0,0.48808156828023186,0.5119184317197681
87324,0.6226415094339623,0.4166666666666667,-165,140,0.5981666073335706,0.40183339266642937,away,LAD,over,6.5,0.5454545454545454,-120,0.5206611570247933,NYM,LAD,2022 REG,8,2,3,1,3,11,1,0,1,-1,1,0,0,0,0,0,0,0,0,0.5206611570247933,0.4793388429752067
87324,0.6226415094339623,0.4166666666666667,-165,140,0.5981666073335706,0.40183339266642937,home,NYM,under,6.5,0.5,100,0.4793388429752067,NYM,LAD,2022 REG,8,2,3,1,3,11,1,0,1,-1,1,0,0,0,0,0,0,0,0,0.5206611570247933,0.4793388429752067
87325,0.5348837209302326,0.5098039215686274,-115,-104,0.5109810284308424,0.48901897156915763,away,SD,over,7,0.5391705069124424,-117,0.5153817639191344,ARI,SD,2022 REG,5,0,5,2,2,10,0,1,-2,2,0,0,0,0,0,0,0,0,0,0.5153817639191344,0.4846182360808656
87325,0.5348837209302326,0.5098039215686274,-115,-104,0.5109810284308424,0.48901897156915763,home,ARI,under,7,0.504950495049505,-102,0.4846182360808656,ARI,SD,2022 REG,5,0,5,2,2,10,0,1,-2,2,0,0,0,0,0,0,0,0,0,0.5153817639191344,0.4846182360808656
87326,0.5652173913043479,0.47619047619047616,-130,110,0.5418129444594474,0.4581870555405526,away,HOU,over,8.5,0.5145631067961165,-106,0.4913668392989033,ATL,HOU,2022 REG,12,6,7,2,8,19,1,0,4,-4,1,1,0,0,0,0,0,0,0,0.4913668392989033,0.5086331607010968
87326,0.5652173913043479,0.47619047619047616,-130,110,0.5418129444594474,0.4581870555405526,home,ATL,under,8.5,0.5305164319248826,-113,0.5086331607010968,ATL,HOU,2022 REG,12,6,7,2,8,19,1,0,4,-4,1,1,0,0,0,0,0,0,0,0.4913668392989033,0.5086331607010968
87327,0.6453900709219857,0.3921568627450981,-182,155,0.6211576527396834,0.3788423472603166,away,SF,over,9,0.5391705069124424,-117,0.5127649394825569,ATL,SF,2022 REG,12,10,14,12,22,26,0,1,-2,2,1,1,1,1,1,1,1,1,1,0.5127649394825569,0.48723506051744314
87327,0.6453900709219857,0.3921568627450981,-182,155,0.6211576527396834,0.3788423472603166,home,ATL,under,9,0.5098039215686274,-104,0.48723506051744314,ATL,SF,2022 REG,12,10,14,12,22,26,0,1,-2,2,1,1,1,1,1,1,1,1,1,0.5127649394825569,0.48723506051744314
87328,0.5348837209302326,0.5098039215686274,-115,-104,0.5109810284308424,0.48901897156915763,away,HOU,over,7,0.4926108374384236,103,0.46986095270450623,LAA,HOU,2022 REG,12,7,4,1,8,16,1,0,6,-6,1,0,0,0,0,0,0,0,0,0.46986095270450623,0.5301390472954938
87328,0.5348837209302326,0.5098039215686274,-115,-104,0.5109810284308424,0.48901897156915763,home,LAA,under,7,0.5535714285714286,-124,0.5301390472954938,LAA,HOU,2022 REG,12,7,4,1,8,16,1,0,6,-6,1,0,0,0,0,0,0,0,0,0.46986095270450623,0.5301390472954938
87329,0.6183206106870228,0.42016806722689076,-162,138,0.5945222678547557,0.4054777321452443,away,OAK,over,8,0.5370370370370371,-116,0.5118817074154765,CLE,OAK,2022 REG,7,3,5,2,5,12,1,0,1,-1,1,1,0,0,0,0,0,0,0,0.5118817074154765,0.48811829258452355
87329,0.6183206106870228,0.42016806722689076,-162,138,0.5945222678547557,0.4054777321452443,home,CLE,under,8,0.5098039215686274,-104,0.48811829258452355,CLE,OAK,2022 REG,7,3,5,2,5,12,1,0,1,-1,1,1,0,0,0,0,0,0,0,0.5118817074154765,0.48811829258452355
87330,0.425531914893617,0.6108949416342413,135,-157,0.41003112488176247,0.5899688751182375,away,PHI,over,7.5,0.5238095238095238,-110,0.4988662131519274,PIT,PHI,2022 REG,4,1,6,2,3,10,0,1,-1,1,1,0,0,0,0,0,0,0,0,0.4988662131519274,0.5011337868480725
87330,0.425531914893617,0.6108949416342413,135,-157,0.41003112488176247,0.5899688751182375,home,PIT,under,7.5,0.5238095238095238,-110,0.5011337868480725,PIT,PHI,2022 REG,4,1,6,2,3,10,0,1,-1,1,1,0,0,0,0,0,0,0,0,0.4988662131519274,0.5011337868480725
87331,0.5918367346938775,0.4464285714285714,-145,124,0.5691899208663057,0.4308100791336943,away,NYM,over,8.5,0.5238095238095238,-110,0.4988662131519274,PHI,NYM,2022 REG,6,0,3,2,2,9,0,1,-2,2,0,0,0,0,0,0,0,0,0,0.4988662131519274,0.5011337868480725
87331,0.5918367346938775,0.4464285714285714,-145,124,0.5691899208663057,0.4308100791336943,home,PHI,under,8.5,0.5238095238095238,-110,0.5011337868480725,PHI,NYM,2022 REG,6,0,3,2,2,9,0,1,-2,2,0,0,0,0,0,0,0,0,0,0.4988662131519274,0.5011337868480725
87332,0.46511627906976744,0.574468085106383,115,-135,0.44670494689481377,0.5532950531051862,away,NYY,over,6.5,0.5433789954337899,-119,0.5157926447422438,SEA,NYY,2022 REG,7,1,3,0,1,10,1,0,1,-1,0,0,0,0,0,0,0,0,0,0.5157926447422438,0.48420735525775616
87332,0.46511627906976744,0.574468085106383,115,-135,0.44670494689481377,0.5532950531051862,home,SEA,under,6.5,0.5073891625615764,-103,0.48420735525775616,SEA,NYY,2022 REG,7,1,3,0,1,10,1,0,1,-1,0,0,0,0,0,0,0,0,0,0.5157926447422438,0.48420735525775616
87333,0.4444444444444444,0.5967741935483871,125,-148,0.42612504978096366,0.5738749502190363,away,TB,over,8.5,0.5305164319248826,-113,0.5053568787472517,MIN,TB,2022 REG,11,6,13,5,11,24,1,0,1,-1,1,1,1,1,1,0,0,0,0,0.5053568787472517,0.49464312125274834
87333,0.4444444444444444,0.5967741935483871,125,-148,0.42612504978096366,0.5738749502190363,home,MIN,under,8.5,0.5169082125603864,-107,0.49464312125274834,MIN,TB,2022 REG,11,6,13,5,11,24,1,0,1,-1,1,1,1,1,1,0,0,0,0,0.5053568787472517,0.49464312125274834
87334,0.5121951219512195,0.5327102803738317,-105,-114,0.48919479393107135,0.5108052060689287,away,BAL,over,9.5,0.5121951219512195,-105,0.48808156828023186,KC,BAL,2022 REG,12,8,4,1,9,16,1,0,7,-7,1,0,0,0,0,0,0,0,0,0.48808156828023186,0.5119184317197681
87334,0.5121951219512195,0.5327102803738317,-105,-114,0.48919479393107135,0.5108052060689287,home,KC,under,9.5,0.5348837209302326,-115,0.5119184317197681,KC,BAL,2022 REG,12,8,4,1,9,16,1,0,7,-7,1,0,0,0,0,0,0,0,0,0.48808156828023186,0.5119184317197681
87335,0.5833333333333333,0.4587155963302753,-140,118,0.5588047910295616,0.4411952089704384,away,MIA,over,9.5,0.5283018867924528,-112,0.5044173060022736,CHC,MIA,2022 REG,2,0,8,3,3,10,0,1,-3,3,0,0,0,0,0,0,0,0,0,0.5044173060022736,0.49558269399772636
87335,0.5833333333333333,0.4587155963302753,-140,118,0.5588047910295616,0.4411952089704384,home,CHC,under,9.5,0.5169082125603864,-107,0.49558269399772636,CHC,MIA,2022 REG,2,0,8,3,3,10,0,1,-3,3,0,0,0,0,0,0,0,0,0,0.5044173060022736,0.49558269399772636
87336,0.40322580645161293,0.6296296296296295,148,-170,0.3899776467414345,0.6100223532585656,away,MIN,over,7,0.5192307692307692,-108,0.49688292476754015,BAL,MIN,2022 REG,7,2,10,7,9,17,0,1,-5,5,1,1,0,0,0,0,0,0,0,0.49688292476754015,0.5031170752324599
87336,0.40322580645161293,0.6296296296296295,148,-170,0.3899776467414345,0.6100223532585656,home,BAL,under,7,0.5238095238095238,-110,0.5031170752324599,BAL,MIN,2022 REG,7,2,10,7,9,17,0,1,-5,5,1,1,0,0,0,0,0,0,0,0.49688292476754015,0.5031170752324599
87337,0.6503496503496503,0.3846153846153846,-186,160,0.6276101520856765,0.3723898479143235,away,CLE,over,7.5,0.5,100,0.4772727272727273,CWS,CLE,2022 REG,9,4,7,1,5,16,1,0,3,-3,1,0,0,0,0,0,0,0,0,0.4772727272727273,0.5227272727272727
87337,0.6503496503496503,0.3846153846153846,-186,160,0.6276101520856765,0.3723898479143235,home,CWS,under,7.5,0.5454545454545454,-120,0.5227272727272727,CWS,CLE,2022 REG,9,4,7,1,5,16,1,0,3,-3,1,0,0,0,0,0,0,0,0,0.4772727272727273,0.5227272727272727
87338,0.3968253968253968,0.6453900709219857,152,-182,0.380073227084372,0.6199267729156279,away,LAD,over,8.5,0.5348837209302326,-115,0.5097020142727117,PIT,LAD,2022 REG,8,5,5,3,8,13,1,0,2,-2,1,1,1,0,0,0,0,0,0,0.5097020142727117,0.49029798572728833
87338,0.3968253968253968,0.6453900709219857,152,-182,0.380073227084372,0.6199267729156279,home,PIT,under,8.5,0.5121951219512195,-105,0.49029798572728833,PIT,LAD,2022 REG,8,5,5,3,8,13,1,0,2,-2,1,1,1,0,0,0,0,0,0,0.5097020142727117,0.49029798572728833
87339,0.5815899581589958,0.45454545454545453,-139,120,0.5605739649961564,0.4394260350038436,away,TB,over,7,0.5454545454545454,-120,0.5206611570247933,TOR,TB,2022 REG,5,2,13,6,8,18,0,1,-4,4,1,1,0,0,0,0,0,0,0,0.5206611570247933,0.4793388429752067
87339,0.5815899581589958,0.45454545454545453,-139,120,0.5605739649961564,0.4394260350038436,home,TOR,under,7,0.5,100,0.4793388429752067,TOR,TB,2022 REG,5,2,13,6,8,18,0,1,-4,4,1,1,0,0,0,0,0,0,0,0.5206611570247933,0.4793388429752067
87340,0.6825396825396826,0.37037037037037035,-215,170,0.6464264718232972,0.35357352817670284,away,OAK,over,9.5,0.49504950495049505,102,0.4739797934813417,PHI,OAK,2022 REG,3,1,9,4,5,12,0,1,-3,3,1,0,0,0,0,0,0,0,0,0.4739797934813417,0.5260202065186583
87340,0.6825396825396826,0.37037037037037035,-215,170,0.6464264718232972,0.35357352817670284,home,PHI,under,9.5,0.5475113122171946,-121,0.5260202065186583,PHI,OAK,2022 REG,3,1,9,4,5,12,0,1,-3,3,1,0,0,0,0,0,0,0,0,0.4739797934813417,0.5260202065186583
87341,0.5,0.5454545454545454,100,-120,0.4772727272727273,0.5227272727272727,away,TOR,over,8.5,0.504950495049505,-102,0.4837488699364985,HOU,TOR,2022 REG,8,2,8,3,5,16,0,1,-1,1,1,1,0,0,0,0,0,0,0,0.4837488699364985,0.5162511300635015
87341,0.5,0.5454545454545454,100,-120,0.4772727272727273,0.5227272727272727,home,HOU,under,8.5,0.5370370370370371,-116,0.5162511300635015,HOU,TOR,2022 REG,8,2,8,3,5,16,0,1,-1,1,1,1,0,0,0,0,0,0,0,0.4837488699364985,0.5162511300635015
87342,0.5073891625615764,0.5327102803738317,-103,-114,0.487043139791394,0.512956860208606,away,MIA,over,8.5,0.5348837209302326,-115,0.5122726437136835,CIN,MIA,2022 REG,2,1,11,2,3,13,0,1,-1,1,1,0,0,0,0,0,0,0,0,0.5122726437136835,0.48772735628631647
87342,0.5073891625615764,0.5327102803738317,-103,-114,0.487043139791394,0.512956860208606,home,CIN,under,8.5,0.5073891625615764,-103,0.48772735628631647,CIN,MIA,2022 REG,2,1,11,2,3,13,0,1,-1,1,1,0,0,0,0,0,0,0,0,0.5122726437136835,0.48772735628631647
87343,0.6610169491525424,0.37037037037037035,-195,170,0.6402693989594307,0.3597306010405693,away,BOS,over,6.5,0.5454545454545454,-120,0.5206611570247933,TB,BOS,2022 REG,5,4,5,1,5,10,1,0,3,-3,1,0,0,0,0,0,0,0,0,0.5206611570247933,0.4793388429752067
87343,0.6610169491525424,0.37037037037037035,-195,170,0.6402693989594307,0.3597306010405693,home,TB,under,6.5,0.5,100,0.4793388429752067,TB,BOS,2022 REG,5,4,5,1,5,10,1,0,3,-3,1,0,0,0,0,0,0,0,0,0.5206611570247933,0.4793388429752067
87344,0.5454545454545454,0.49504950495049505,-120,102,0.5233614270517961,0.4766385729482039,away,BAL,over,10,0.5283018867924528,-112,0.5044173060022736,BOS,BAL,2022 REG,8,4,8,3,7,16,1,0,1,-1,1,1,1,0,0,0,0,0,0,0.5044173060022736,0.49558269399772636
87344,0.5454545454545454,0.49504950495049505,-120,102,0.5233614270517961,0.4766385729482039,home,BOS,under,10,0.5169082125603864,-107,0.49558269399772636,BOS,BAL,2022 REG,8,4,8,3,7,16,1,0,1,-1,1,1,1,0,0,0,0,0,0,0.5044173060022736,0.49558269399772636
87345,0.6363636363636364,0.4,-175,150,0.6132231404958678,0.3867768595041322,away,STL,over,8,0.5121951219512195,-105,0.48808156828023186,MIL,STL,2022 REG,6,2,3,0,2,9,1,0,2,-2,0,0,0,0,0,0,0,0,0,0.48808156828023186,0.5119184317197681
87345,0.6363636363636364,0.4,-175,150,0.6132231404958678,0.3867768595041322,home,MIL,under,8,0.5348837209302326,-115,0.5119184317197681,MIL,STL,2022 REG,6,2,3,0,2,9,1,0,2,-2,0,0,0,0,0,0,0,0,0,0.48808156828023186,0.5119184317197681
87346,0.6666666666666666,0.37037037037037035,-200,170,0.6419753086419753,0.3580246913580247,away,PIT,over,8,0.5283018867924528,-112,0.5044173060022736,STL,PIT,2022 REG,7,4,15,9,13,22,0,1,-5,5,1,1,1,1,0,0,0,0,0,0.5044173060022736,0.49558269399772636
87346,0.6666666666666666,0.37037037037037035,-200,170,0.6419753086419753,0.3580246913580247,home,STL,under,8,0.5169082125603864,-107,0.49558269399772636,STL,PIT,2022 REG,7,4,15,9,13,22,0,1,-5,5,1,1,1,1,0,0,0,0,0,0.5044173060022736,0.49558269399772636
87347,0.7058823529411764,0.3333333333333333,-240,200,0.6782006920415226,0.32179930795847744,away,WSH,over,9.5,0.5145631067961165,-106,0.49023796582517226,ATL,WSH,2022 REG,4,2,15,11,13,19,0,1,-9,9,1,1,0,0,0,0,0,0,0,0.49023796582517226,0.5097620341748277
87347,0.7058823529411764,0.3333333333333333,-240,200,0.6782006920415226,0.32179930795847744,home,ATL,under,9.5,0.5327102803738317,-114,0.5097620341748277,ATL,WSH,2022 REG,4,2,15,11,13,19,0,1,-9,9,1,1,0,0,0,0,0,0,0,0.49023796582517226,0.5097620341748277
87348,0.47619047619047616,0.5633187772925764,110,-129,0.45737654596045113,0.5426234540395489,away,BOS,over,9,0.504950495049505,-102,0.47949844489399435,BAL,BOS,2022 REG,8,3,12,4,7,20,0,1,-1,1,1,1,1,0,0,0,0,0,0,0.47949844489399435,0.5205015551060057
87348,0.47619047619047616,0.5633187772925764,110,-129,0.45737654596045113,0.5426234540395489,home,BAL,under,9,0.5454545454545454,-120,0.5205015551060057,BAL,BOS,2022 REG,8,3,12,4,7,20,0,1,-1,1,1,1,1,0,0,0,0,0,0,0.47949844489399435,0.5205015551060057
87349,0.6254681647940076,0.4081632653061224,-167,145,0.6044327759298813,0.3955672240701187,away,STL,over,7.5,0.5238095238095238,-110,0.4988662131519274,LAD,STL,2022 REG,9,6,7,2,8,16,1,0,4,-4,1,1,0,0,0,0,0,0,0,0.4988662131519274,0.5011337868480725
87349,0.6254681647940076,0.4081632653061224,-167,145,0.6044327759298813,0.3955672240701187,home,LAD,under,7.5,0.5238095238095238,-110,0.5011337868480725,LAD,STL,2022 REG,9,6,7,2,8,16,1,0,4,-4,1,1,0,0,0,0,0,0,0,0.4988662131519274,0.5011337868480725
87350,0.7101449275362319,0.3333333333333333,-245,200,0.6792690611216132,0.3207309388783868,away,CIN,over,8,0.5348837209302326,-115,0.5109810284308424,TOR,CIN,2022 REG,4,2,6,3,5,10,0,1,-1,1,1,1,0,0,0,0,0,0,0,0.5109810284308424,0.48901897156915763
87350,0.7101449275362319,0.3333333333333333,-245,200,0.6792690611216132,0.3207309388783868,home,TOR,under,8,0.5098039215686274,-104,0.48901897156915763,TOR,CIN,2022 REG,4,2,6,3,5,10,0,1,-1,1,1,1,0,0,0,0,0,0,0,0.5109810284308424,0.48901897156915763
87351,0.4273504273504274,0.607843137254902,134,-155,0.412310442476355,0.5876895575236449,away,SD,over,7.5,0.5391705069124424,-117,0.5140669063204599,SF,SD,2022 REG,6,4,9,5,9,15,0,1,-1,1,1,1,1,1,0,0,0,0,0,0.5140669063204599,0.4859330936795401
87351,0.4273504273504274,0.607843137254902,134,-155,0.412310442476355,0.5876895575236449,home,SF,under,7.5,0.5073891625615764,-103,0.4859330936795401,SF,SD,2022 REG,6,4,9,5,9,15,0,1,-1,1,1,1,1,1,0,0,0,0,0,0.5140669063204599,0.4859330936795401
87352,0.6363636363636364,0.4081632653061224,-175,145,0.6080283353010626,0.3919716646989374,away,STL,over,8,0.5215311004784688,-109,0.4978845547971712,PHI,STL,2022 REG,9,4,4,0,4,13,1,0,4,-4,0,0,0,0,0,0,0,0,0,0.4978845547971712,0.5021154452028288
87352,0.6363636363636364,0.4081632653061224,-175,145,0.6080283353010626,0.3919716646989374,home,PHI,under,8,0.5238095238095238,-110,0.5021154452028288,PHI,STL,2022 REG,9,4,4,0,4,13,1,0,4,-4,0,0,0,0,0,0,0,0,0,0.4978845547971712,0.5021154452028288
87353,0.46511627906976744,0.576271186440678,115,-136,0.44586629511142073,0.5541337048885793,away,NYM,over,6.5,0.5454545454545454,-120,0.5206611570247933,ATL,NYM,2022 REG,6,3,6,2,5,12,1,0,1,-1,1,1,0,0,0,0,0,0,0,0.5206611570247933,0.4793388429752067
87353,0.46511627906976744,0.576271186440678,115,-136,0.44586629511142073,0.5541337048885793,home,ATL,under,6.5,0.5,100,0.4793388429752067,ATL,NYM,2022 REG,6,3,6,2,5,12,1,0,1,-1,1,1,0,0,0,0,0,0,0,0.5206611570247933,0.4793388429752067
87354,0.5726495726495727,0.4672897196261683,-134,114,0.5497783539959433,0.4502216460040567,away,KC,over,9,0.5192307692307692,-108,0.49688292476754015,DET,KC,2022 REG,7,4,6,3,7,13,1,0,1,-1,1,1,1,0,0,0,0,0,0,0.49688292476754015,0.5031170752324599
87354,0.5726495726495727,0.4672897196261683,-134,114,0.5497783539959433,0.4502216460040567,home,DET,under,9,0.5238095238095238,-110,0.5031170752324599,DET,KC,2022 REG,7,4,6,3,7,13,1,0,1,-1,1,1,1,0,0,0,0,0,0,0.49688292476754015,0.5031170752324599
87355,0.6108949416342413,0.425531914893617,-157,135,0.5886419592417365,0.41135804075826354,away,PIT,over,7.5,0.5348837209302326,-115,0.5097020142727117,CIN,PIT,2022 REG,8,4,12,10,14,20,0,1,-6,6,1,1,1,1,0,0,0,0,0,0.5097020142727117,0.49029798572728833
87355,0.6108949416342413,0.425531914893617,-157,135,0.5886419592417365,0.41135804075826354,home,CIN,under,7.5,0.5121951219512195,-105,0.49029798572728833,CIN,PIT,2022 REG,8,4,12,10,14,20,0,1,-6,6,1,1,1,1,0,0,0,0,0,0.5097020142727117,0.49029798572728833
87356,0.5495495495495495,0.48780487804878053,-122,105,0.529021440689206,0.470978559310794,away,BAL,over,9,0.5348837209302326,-115,0.5097020142727117,CHC,BAL,2022 REG,7,2,8,4,6,15,0,1,-2,2,1,1,0,0,0,0,0,0,0,0.5097020142727117,0.49029798572728833
87356,0.5495495495495495,0.48780487804878053,-122,105,0.529021440689206,0.470978559310794,home,CHC,under,9,0.5121951219512195,-105,0.49029798572728833,CHC,BAL,2022 REG,7,2,8,4,6,15,0,1,-2,2,1,1,0,0,0,0,0,0,0,0.5097020142727117,0.49029798572728833
87357,0.5238095238095238,0.5238095238095238,-110,-110,0.4988662131519274,0.5011337868480725,away,SEA,over,6.5,0.5454545454545454,-120,0.5206611570247933,LAA,SEA,2022 REG,8,2,9,6,8,17,0,1,-4,4,1,1,0,0,0,0,0,0,0,0.5206611570247933,0.4793388429752067
87357,0.5238095238095238,0.5238095238095238,-110,-110,0.4988662131519274,0.5011337868480725,home,LAA,under,6.5,0.5,100,0.4793388429752067,LAA,SEA,2022 REG,8,2,9,6,8,17,0,1,-4,4,1,1,0,0,0,0,0,0,0,0.5206611570247933,0.4793388429752067
87358,0.5726495726495727,0.4672897196261683,-134,114,0.5497783539959433,0.4502216460040567,away,SD,over,7.5,0.5327102803738317,-114,0.5100625279371946,LAD,SD,2022 REG,5,3,7,1,4,12,1,0,2,-2,1,0,0,0,0,0,0,0,0,0.5100625279371946,0.48993747206280536
87358,0.5726495726495727,0.4672897196261683,-134,114,0.5497783539959433,0.4502216460040567,home,LAD,under,7.5,0.5098039215686274,-104,0.48993747206280536,LAD,SD,2022 REG,5,3,7,1,4,12,1,0,2,-2,1,0,0,0,0,0,0,0,0,0.5100625279371946,0.48993747206280536
87359,0.3968253968253968,0.6389891696750902,152,-177,0.3826132672617115,0.6173867327382885,away,TOR,over,9,0.5283018867924528,-112,0.5044173060022736,BOS,TOR,2022 REG,15,5,13,6,11,28,0,1,-1,1,1,1,1,1,1,0,0,0,0,0.5044173060022736,0.49558269399772636
87359,0.3968253968253968,0.6389891696750902,152,-177,0.3826132672617115,0.6173867327382885,home,BOS,under,9,0.5169082125603864,-107,0.49558269399772636,BOS,TOR,2022 REG,15,5,13,6,11,28,0,1,-1,1,1,1,1,1,1,0,0,0,0,0.5044173060022736,0.49558269399772636
87360,0.4716981132075471,0.5689655172413793,112,-132,0.45251715544861953,0.5474828445513804,away,NYY,over,8,0.5238095238095238,-110,0.4988662131519274,TOR,NYY,2022 REG,4,2,5,1,3,9,1,0,1,-1,1,0,0,0,0,0,0,0,0,0.4988662131519274,0.5011337868480725
87360,0.4716981132075471,0.5689655172413793,112,-132,0.45251715544861953,0.5474828445513804,home,TOR,under,8,0.5238095238095238,-110,0.5011337868480725,TOR,NYY,2022 REG,4,2,5,1,3,9,1,0,1,-1,1,0,0,0,0,0,0,0,0,0.4988662131519274,0.5011337868480725
87361,0.5073891625615764,0.5305164319248826,-103,-113,0.4881562747186933,0.5118437252813067,away,HOU,over,7,0.5192307692307692,-108,0.49688292476754015,SEA,HOU,2022 REG,9,5,12,8,13,21,0,1,-3,3,1,1,1,1,1,0,0,0,0,0.49688292476754015,0.5031170752324599
87361,0.5073891625615764,0.5305164319248826,-103,-113,0.4881562747186933,0.5118437252813067,home,SEA,under,7,0.5238095238095238,-110,0.5031170752324599,SEA,HOU,2022 REG,9,5,12,8,13,21,0,1,-3,3,1,1,1,1,1,0,0,0,0,0.49688292476754015,0.5031170752324599
87362,0.3448275862068966,0.6923076923076923,190,-225,0.3320223177535901,0.6679776822464099,away,SD,over,10.5,0.5283018867924528,-112,0.5044173060022736,COL,SD,2022 REG,7,3,10,9,12,17,0,1,-6,6,1,1,1,0,0,0,0,0,0,0.5044173060022736,0.49558269399772636
87362,0.3448275862068966,0.6923076923076923,190,-225,0.3320223177535901,0.6679776822464099,home,COL,under,10.5,0.5169082125603864,-107,0.49558269399772636,COL,SD,2022 REG,7,3,10,9,12,17,0,1,-6,6,1,1,1,0,0,0,0,0,0,0.5044173060022736,0.49558269399772636
87363,0.4444444444444444,0.6000000000000001,125,-150,0.4246913580246913,0.5753086419753086,away,LAA,over,7.5,0.5412844036697247,-118,0.5189377998484975,DET,LAA,2022 REG,4,0,3,1,1,7,0,1,-1,1,0,0,0,0,0,0,0,0,0,0.5189377998484975,0.4810622001515025
87363,0.4444444444444444,0.6000000000000001,125,-150,0.4246913580246913,0.5753086419753086,home,DET,under,7.5,0.5,100,0.4810622001515025,DET,LAA,2022 REG,4,0,3,1,1,7,0,1,-1,1,0,0,0,0,0,0,0,0,0,0.5189377998484975,0.4810622001515025
87364,0.5454545454545454,0.49019607843137253,-120,104,0.526008750607681,0.47399124939231896,away,CWS,over,8,0.5283018867924528,-112,0.5031902949311281,CLE,CWS,2022 REG,11,11,5,1,12,16,1,0,10,-10,1,0,0,0,0,0,0,0,0,0.5031902949311281,0.4968097050688719
87364,0.5454545454545454,0.49019607843137253,-120,104,0.526008750607681,0.47399124939231896,home,CLE,under,8,0.5192307692307692,-108,0.4968097050688719,CLE,CWS,2022 REG,11,11,5,1,12,16,1,0,10,-10,1,0,0,0,0,0,0,0,0,0.5031902949311281,0.4968097050688719
87365,0.5475113122171946,0.49019607843137253,-121,104,0.5268660892829112,0.47313391071708877,away,CIN,over,9.5,0.49504950495049505,102,0.4739797934813417,CHC,CIN,2022 REG,10,3,12,5,8,22,0,1,-2,2,1,1,1,0,0,0,0,0,0,0.4739797934813417,0.5260202065186583
87365,0.5475113122171946,0.49019607843137253,-121,104,0.5268660892829112,0.47313391071708877,home,CHC,under,9.5,0.5475113122171946,-121,0.5260202065186583,CHC,CIN,2022 REG,10,3,12,5,8,22,0,1,-2,2,1,1,1,0,0,0,0,0,0,0.4739797934813417,0.5260202065186583
87366,0.5780590717299579,0.4587155963302753,-137,118,0.5568011412478822,0.44319885875211784,away,SF,over,7.5,0.5,100,0.4783105022831051,MIN,SF,2022 REG,9,3,4,2,5,13,1,0,1,-1,1,1,0,0,0,0,0,0,0,0.4783105022831051,0.5216894977168949
87366,0.5780590717299579,0.4587155963302753,-137,118,0.5568011412478822,0.44319885875211784,home,MIN,under,7.5,0.5433789954337899,-119,0.5216894977168949,MIN,SF,2022 REG,9,3,4,2,5,13,1,0,1,-1,1,1,0,0,0,0,0,0,0,0.4783105022831051,0.5216894977168949
87367,0.5726495726495727,0.4672897196261683,-134,114,0.5497783539959433,0.4502216460040567,away,PIT,over,7.5,0.5348837209302326,-115,0.5097020142727117,DET,PIT,2022 REG,8,2,11,7,9,19,0,1,-5,5,1,1,0,0,0,0,0,0,0,0.5097020142727117,0.49029798572728833
87367,0.5726495726495727,0.4672897196261683,-134,114,0.5497783539959433,0.4502216460040567,home,DET,under,7.5,0.5121951219512195,-105,0.49029798572728833,DET,PIT,2022 REG,8,2,11,7,9,19,0,1,-5,5,1,1,0,0,0,0,0,0,0,0.5097020142727117,0.49029798572728833
87368,0.6226415094339623,0.42372881355932196,-165,136,0.5937694215324834,0.40623057846751665,away,PIT,over,8.5,0.5348837209302326,-115,0.5097020142727117,ARI,PIT,2022 REG,11,6,7,4,10,18,1,0,2,-2,1,1,1,1,0,0,0,0,0,0.5097020142727117,0.49029798572728833
87368,0.6226415094339623,0.42372881355932196,-165,136,0.5937694215324834,0.40623057846751665,home,ARI,under,8.5,0.5121951219512195,-105,0.49029798572728833,ARI,PIT,2022 REG,11,6,7,4,10,18,1,0,2,-2,1,1,1,1,0,0,0,0,0,0.5097020142727117,0.49029798572728833
87369,0.5454545454545454,0.49504950495049505,-120,102,0.5233614270517961,0.4766385729482039,away,STL,over,10,0.5283018867924528,-112,0.5044173060022736,BOS,STL,2022 REG,5,2,14,11,13,19,0,1,-9,9,1,1,0,0,0,0,0,0,0,0.5044173060022736,0.49558269399772636
87369,0.5454545454545454,0.49504950495049505,-120,102,0.5233614270517961,0.4766385729482039,home,BOS,under,10,0.5169082125603864,-107,0.49558269399772636,BOS,STL,2022 REG,5,2,14,11,13,19,0,1,-9,9,1,1,0,0,0,0,0,0,0,0.5044173060022736,0.49558269399772636
87370,0.3846153846153846,0.6551724137931035,160,-190,0.3693123852275045,0.6306876147724956,away,PHI,over,7.5,0.5348837209302326,-115,0.5097020142727117,CHC,PHI,2022 REG,7,2,6,0,2,13,1,0,2,-2,0,0,0,0,0,0,0,0,0,0.5097020142727117,0.49029798572728833
87370,0.3846153846153846,0.6551724137931035,160,-190,0.3693123852275045,0.6306876147724956,home,CHC,under,7.5,0.5121951219512195,-105,0.49029798572728833,CHC,PHI,2022 REG,7,2,6,0,2,13,1,0,2,-2,0,0,0,0,0,0,0,0,0,0.5097020142727117,0.49029798572728833
87371,0.6402877697841727,0.3921568627450981,-178,155,0.6195138683805389,0.3804861316194611,away,OAK,over,8.5,0.5121951219512195,-105,0.48808156828023186,BAL,OAK,2022 REG,6,0,11,5,5,17,0,1,-5,5,0,0,0,0,0,0,0,0,0,0.48808156828023186,0.5119184317197681
87371,0.6402877697841727,0.3921568627450981,-178,155,0.6195138683805389,0.3804861316194611,home,BAL,under,8.5,0.5348837209302326,-115,0.5119184317197681,BAL,OAK,2022 REG,6,0,11,5,5,17,0,1,-5,5,0,0,0,0,0,0,0,0,0,0.48808156828023186,0.5119184317197681
87372,0.47619047619047616,0.5652173913043479,110,-130,0.4564724440500838,0.5435275559499162,away,MIN,over,8.5,0.5024875621890548,-101,0.4794401874631478,DET,MIN,2022 REG,6,3,10,2,5,16,1,0,1,-1,1,1,0,0,0,0,0,0,0,0.4794401874631478,0.5205598125368522
87372,0.47619047619047616,0.5652173913043479,110,-130,0.4564724440500838,0.5435275559499162,home,DET,under,8.5,0.5433789954337899,-119,0.5205598125368522,DET,MIN,2022 REG,6,3,10,2,5,16,1,0,1,-1,1,1,0,0,0,0,0,0,0,0.4794401874631478,0.5205598125368522
87373,0.607843137254902,0.4347826086956522,-155,130,0.5819333701084867,0.41806662989151333,away,CWS,over,8,0.5,100,0.4783105022831051,SF,CWS,2022 REG,3,0,6,1,1,9,0,1,-1,1,0,0,0,0,0,0,0,0,0,0.4783105022831051,0.5216894977168949
87373,0.607843137254902,0.4347826086956522,-155,130,0.5819333701084867,0.41806662989151333,home,SF,under,8,0.5433789954337899,-119,0.5216894977168949,SF,CWS,2022 REG,3,0,6,1,1,9,0,1,-1,1,0,0,0,0,0,0,0,0,0,0.4783105022831051,0.5216894977168949
87374,0.47619047619047616,0.5652173913043479,110,-130,0.4564724440500838,0.5435275559499162,away,NYM,over,9,0.5098039215686274,-104,0.48375889301574193,LAA,NYM,2022 REG,15,11,10,6,17,25,1,0,5,-5,1,1,1,1,1,1,0,0,0,0.48375889301574193,0.5162411069842581
87374,0.47619047619047616,0.5652173913043479,110,-130,0.4564724440500838,0.5435275559499162,home,LAA,under,9,0.5412844036697247,-118,0.5162411069842581,LAA,NYM,2022 REG,15,11,10,6,17,25,1,0,5,-5,1,1,1,1,1,1,0,0,0,0.48375889301574193,0.5162411069842581
87375,0.5652173913043479,0.47619047619047616,-130,110,0.5418129444594474,0.4581870555405526,away,COL,over,8,0.5283018867924528,-112,0.5031902949311281,MIA,COL,2022 REG,9,3,12,2,5,21,1,0,1,-1,1,1,0,0,0,0,0,0,0,0.5031902949311281,0.4968097050688719
87375,0.5652173913043479,0.47619047619047616,-130,110,0.5418129444594474,0.4581870555405526,home,MIA,under,8,0.5192307692307692,-108,0.4968097050688719,MIA,COL,2022 REG,9,3,12,2,5,21,1,0,1,-1,1,1,0,0,0,0,0,0,0,0.5031902949311281,0.4968097050688719
87376,0.696969696969697,0.3448275862068966,-230,190,0.6678382571799499,0.33216174282005007,away,PIT,over,6.5,0.5433789954337899,-119,0.5171177654451503,STL,PIT,2022 REG,8,13,7,3,16,15,1,0,10,-10,1,1,1,0,0,0,0,0,0,0.5171177654451503,0.4828822345548497
87376,0.696969696969697,0.3448275862068966,-230,190,0.6678382571799499,0.33216174282005007,home,STL,under,6.5,0.504950495049505,-102,0.4828822345548497,STL,PIT,2022 REG,8,13,7,3,16,15,1,0,10,-10,1,1,1,0,0,0,0,0,0,0.5171177654451503,0.4828822345548497
87377,0.5454545454545454,0.49504950495049505,-120,102,0.5233614270517961,0.4766385729482039,away,PHI,over,7,0.5348837209302326,-115,0.5109810284308424,NYM,PHI,2022 REG,10,3,0,0,3,10,1,0,3,-3,0,0,0,0,0,0,0,0,0,0.5109810284308424,0.48901897156915763
87377,0.5454545454545454,0.49504950495049505,-120,102,0.5233614270517961,0.4766385729482039,home,NYM,under,7,0.5098039215686274,-104,0.48901897156915763,NYM,PHI,2022 REG,10,3,0,0,3,10,1,0,3,-3,0,0,0,0,0,0,0,0,0,0.5109810284308424,0.48901897156915763
87378,0.7275204359673024,0.31746031746031744,-267,215,0.6947960186235027,0.3052039813764973,away,COL,over,8.5,0.5121951219512195,-105,0.48808156828023186,LAD,COL,2022 REG,10,6,8,4,10,18,1,0,2,-2,1,1,1,1,0,0,0,0,0,0.48808156828023186,0.5119184317197681
87378,0.7275204359673024,0.31746031746031744,-267,215,0.6947960186235027,0.3052039813764973,home,LAD,under,8.5,0.5348837209302326,-115,0.5119184317197681,LAD,COL,2022 REG,10,6,8,4,10,18,1,0,2,-2,1,1,1,1,0,0,0,0,0,0.48808156828023186,0.5119184317197681
87379,0.6923076923076923,0.3472222222222222,-225,188,0.6649408284023669,0.3350591715976331,away,LAA,over,9,0.5192307692307692,-108,0.49688292476754015,ATL,LAA,2022 REG,6,1,13,9,10,19,0,1,-8,8,1,0,0,0,0,0,0,0,0,0.49688292476754015,0.5031170752324599
87379,0.6923076923076923,0.3472222222222222,-225,188,0.6649408284023669,0.3350591715976331,home,ATL,under,9,0.5238095238095238,-110,0.5031170752324599,ATL,LAA,2022 REG,6,1,13,9,10,19,0,1,-8,8,1,0,0,0,0,0,0,0,0,0.49688292476754015,0.5031170752324599
87380,0.5594713656387665,0.47619047619047616,-127,110,0.5395195862893665,0.46048041371063353,away,COL,over,8,0.5370370370370371,-116,0.5118817074154765,PIT,COL,2022 REG,9,10,13,5,15,22,1,0,5,-5,1,1,1,1,1,0,0,0,0,0.5118817074154765,0.48811829258452355
87380,0.5594713656387665,0.47619047619047616,-127,110,0.5395195862893665,0.46048041371063353,home,PIT,under,8,0.5098039215686274,-104,0.48811829258452355,PIT,COL,2022 REG,9,10,13,5,15,22,1,0,5,-5,1,1,1,1,1,0,0,0,0,0.5118817074154765,0.48811829258452355
87381,0.6923076923076923,0.35714285714285715,-225,180,0.658072696534235,0.34192730346576505,away,ARI,over,8,0.5121951219512195,-105,0.48808156828023186,SF,ARI,2022 REG,14,13,8,0,13,22,1,0,13,-13,0,0,0,0,0,0,0,0,0,0.48808156828023186,0.5119184317197681
87381,0.6923076923076923,0.35714285714285715,-225,180,0.658072696534235,0.34192730346576505,home,SF,under,8,0.5348837209302326,-115,0.5119184317197681,SF,ARI,2022 REG,14,13,8,0,13,22,1,0,13,-13,0,0,0,0,0,0,0,0,0,0.48808156828023186,0.5119184317197681
87382,0.6774193548387096,0.36363636363636365,-210,175,0.6496074165168858,0.3503925834831142,away,WSH,over,9,0.5169082125603864,-107,0.49353874091423283,ATL,WSH,2022 REG,3,1,7,3,4,10,0,1,-2,2,1,0,0,0,0,0,0,0,0,0.49353874091423283,0.5064612590857671
87382,0.6774193548387096,0.36363636363636365,-210,175,0.6496074165168858,0.3503925834831142,home,ATL,under,9,0.5283018867924528,-112,0.5064612590857671,ATL,WSH,2022 REG,3,1,7,3,4,10,0,1,-2,2,1,0,0,0,0,0,0,0,0,0.49353874091423283,0.5064612590857671
87383,0.3448275862068966,0.6923076923076923,190,-225,0.3320223177535901,0.6679776822464099,away,NYM,over,9,0.5412844036697247,-118,0.5149381613977361,CIN,NYM,2022 REG,4,1,6,0,1,10,1,0,1,-1,0,0,0,0,0,0,0,0,0,0.5149381613977361,0.48506183860226393
87383,0.3448275862068966,0.6923076923076923,190,-225,0.3320223177535901,0.6679776822464099,home,CIN,under,9,0.5073891625615764,-103,0.48506183860226393,CIN,NYM,2022 REG,4,1,6,0,1,10,1,0,1,-1,0,0,0,0,0,0,0,0,0,0.5149381613977361,0.48506183860226393
87384,0.43103448275862066,0.609375,132,-156,0.41361660225921526,0.5863833977407847,away,TB,over,8.5,0.5370370370370371,-116,0.5118817074154765,BAL,TB,2022 REG,6,1,9,6,7,15,0,1,-5,5,1,0,0,0,0,0,0,0,0,0.5118817074154765,0.48811829258452355
87384,0.43103448275862066,0.609375,132,-156,0.41361660225921526,0.5863833977407847,home,BAL,under,8.5,0.5098039215686274,-104,0.48811829258452355,BAL,TB,2022 REG,6,1,9,6,7,15,0,1,-5,5,1,0,0,0,0,0,0,0,0,0.5118817074154765,0.48811829258452355
87385,0.6108949416342413,0.425531914893617,-157,135,0.5886419592417365,0.41135804075826354,away,CWS,over,7,0.5454545454545454,-120,0.5206611570247933,HOU,CWS,2022 REG,8,4,6,3,7,14,1,0,1,-1,1,1,1,0,0,0,0,0,0,0.5206611570247933,0.4793388429752067
87385,0.6108949416342413,0.425531914893617,-157,135,0.5886419592417365,0.41135804075826354,home,HOU,under,7,0.5,100,0.4793388429752067,HOU,CWS,2022 REG,8,4,6,3,7,14,1,0,1,-1,1,1,1,0,0,0,0,0,0,0.5206611570247933,0.4793388429752067
87386,0.5169082125603864,0.5215311004784688,-107,-109,0.49703861596542265,0.5029613840345774,away,SF,over,7,0.5121951219512195,-105,0.48808156828023186,MIA,SF,2022 REG,6,5,5,4,9,11,1,0,1,-1,1,1,1,1,0,0,0,0,0,0.48808156828023186,0.5119184317197681
87386,0.5169082125603864,0.5215311004784688,-107,-109,0.49703861596542265,0.5029613840345774,home,MIA,under,7,0.5348837209302326,-115,0.5119184317197681,MIA,SF,2022 REG,6,5,5,4,9,11,1,0,1,-1,1,1,1,1,0,0,0,0,0,0.48808156828023186,0.5119184317197681
87387,0.46511627906976744,0.574468085106383,115,-135,0.44670494689481377,0.5532950531051862,away,LAA,over,7.5,0.5,100,0.4772727272727273,SEA,LAA,2022 REG,4,1,10,4,5,14,0,1,-3,3,1,0,0,0,0,0,0,0,0,0.4772727272727273,0.5227272727272727
87387,0.46511627906976744,0.574468085106383,115,-135,0.44670494689481377,0.5532950531051862,home,SEA,under,7.5,0.5454545454545454,-120,0.5227272727272727,SEA,LAA,2022 REG,4,1,10,4,5,14,0,1,-3,3,1,0,0,0,0,0,0,0,0,0.4772727272727273,0.5227272727272727
87388,0.6923076923076923,0.3508771929824561,-225,185,0.6624104640298972,0.33758953597010277,away,TB,over,7.5,0.5370370370370371,-116,0.5118817074154765,NYY,TB,2022 REG,5,2,7,0,2,12,1,0,2,-2,0,0,0,0,0,0,0,0,0,0.5118817074154765,0.48811829258452355
87388,0.6923076923076923,0.3508771929824561,-225,185,0.6624104640298972,0.33758953597010277,home,NYY,under,7.5,0.5098039215686274,-104,0.48811829258452355,NYY,TB,2022 REG,5,2,7,0,2,12,1,0,2,-2,0,0,0,0,0,0,0,0,0,0.5118817074154765,0.48811829258452355
87389,0.6226415094339623,0.42016806722689076,-165,138,0.5959864900036198,0.4040135099963802,away,CLE,over,8.5,0.5391705069124424,-117,0.5127649394825569,TOR,CLE,2022 REG,3,0,14,8,8,17,0,1,-8,8,0,0,0,0,0,0,0,0,0,0.5127649394825569,0.48723506051744314
87389,0.6226415094339623,0.42016806722689076,-165,138,0.5959864900036198,0.4040135099963802,home,TOR,under,8.5,0.5098039215686274,-104,0.48723506051744314,TOR,CLE,2022 REG,3,0,14,8,8,17,0,1,-8,8,0,0,0,0,0,0,0,0,0,0.5127649394825569,0.48723506051744314
87390,0.4,0.6363636363636364,150,-175,0.3854545454545455,0.6145454545454545,away,LAA,over,6.5,0.5391705069124424,-117,0.5127649394825569,MIN,LAA,2022 REG,5,2,8,4,6,13,0,1,-2,2,1,1,0,0,0,0,0,0,0,0.5127649394825569,0.48723506051744314
87390,0.4,0.6363636363636364,150,-175,0.3854545454545455,0.6145454545454545,home,MIN,under,6.5,0.5098039215686274,-104,0.48723506051744314,MIN,LAA,2022 REG,5,2,8,4,6,13,0,1,-2,2,1,1,0,0,0,0,0,0,0,0.5127649394825569,0.48723506051744314
87391,0.5689655172413793,0.46511627906976744,-132,115,0.5495741503746924,0.45042584962530763,away,DET,over,8.5,0.5327102803738317,-114,0.508788710910954,KC,DET,2022 REG,6,2,17,10,12,23,0,1,-8,8,1,1,0,0,0,0,0,0,0,0.508788710910954,0.491211289089046
87391,0.5689655172413793,0.46511627906976744,-132,115,0.5495741503746924,0.45042584962530763,home,KC,under,8.5,0.5121951219512195,-105,0.491211289089046,KC,DET,2022 REG,6,2,17,10,12,23,0,1,-8,8,1,1,0,0,0,0,0,0,0,0.508788710910954,0.491211289089046
87392,0.425531914893617,0.6153846153846154,135,-160,0.4081206254135181,0.5918793745864819,away,LAD,over,8.5,0.5412844036697247,-118,0.5189377998484975,STL,LAD,2022 REG,13,7,10,6,13,23,1,0,1,-1,1,1,1,1,1,1,0,0,0,0.5189377998484975,0.4810622001515025
87392,0.425531914893617,0.6153846153846154,135,-160,0.4081206254135181,0.5918793745864819,home,STL,under,8.5,0.5,100,0.4810622001515025,STL,LAD,2022 REG,13,7,10,6,13,23,1,0,1,-1,1,1,1,1,1,1,0,0,0,0.5189377998484975,0.4810622001515025
87393,0.3921568627450981,0.6491228070175439,155,-185,0.37596875695582666,0.6240312430441733,away,TB,over,8,0.5433789954337899,-119,0.5171177654451503,DET,TB,2022 REG,6,2,12,6,8,18,0,1,-4,4,1,1,0,0,0,0,0,0,0,0.5171177654451503,0.4828822345548497
87393,0.3921568627450981,0.6491228070175439,155,-185,0.37596875695582666,0.6240312430441733,home,DET,under,8,0.504950495049505,-102,0.4828822345548497,DET,TB,2022 REG,6,2,12,6,8,18,0,1,-4,4,1,1,0,0,0,0,0,0,0,0.5171177654451503,0.4828822345548497
87394,0.6610169491525424,0.37735849056603776,-195,165,0.6356501330673793,0.3643498669326207,away,KC,over,9,0.5238095238095238,-110,0.4988662131519274,LAA,KC,2022 REG,7,2,12,6,8,19,0,1,-4,4,1,1,0,0,0,0,0,0,0,0.4988662131519274,0.5011337868480725
87394,0.6610169491525424,0.37735849056603776,-195,165,0.6356501330673793,0.3643498669326207,home,LAA,under,9,0.5238095238095238,-110,0.5011337868480725,LAA,KC,2022 REG,7,2,12,6,8,19,0,1,-4,4,1,1,0,0,0,0,0,0,0,0.4988662131519274,0.5011337868480725
87395,0.7222222222222222,0.31746031746031744,-260,215,0.693562610229277,0.306437389770723,away,COL,over,7.5,0.5121951219512195,-105,0.48808156828023186,SD,COL,2022 REG,14,9,5,0,9,19,1,0,9,-9,0,0,0,0,0,0,0,0,0,0.48808156828023186,0.5119184317197681
87395,0.7222222222222222,0.31746031746031744,-260,215,0.693562610229277,0.306437389770723,home,SD,under,7.5,0.5348837209302326,-115,0.5119184317197681,SD,COL,2022 REG,14,9,5,0,9,19,1,0,9,-9,0,0,0,0,0,0,0,0,0,0.48808156828023186,0.5119184317197681
87396,0.6226415094339623,0.4166666666666667,-165,140,0.5981666073335706,0.40183339266642937,away,OAK,over,8.5,0.5454545454545454,-120,0.5206611570247933,TEX,OAK,2022 REG,10,7,10,8,15,20,0,1,-1,1,1,1,1,1,1,1,1,0,0,0.5206611570247933,0.4793388429752067
87396,0.6226415094339623,0.4166666666666667,-165,140,0.5981666073335706,0.40183339266642937,home,TEX,under,8.5,0.5,100,0.4793388429752067,TEX,OAK,2022 REG,10,7,10,8,15,20,0,1,-1,1,1,1,1,1,1,1,1,0,0,0.5206611570247933,0.4793388429752067
87397,0.6254681647940076,0.4166666666666667,-167,140,0.5991141690863948,0.4008858309136052,away,OAK,over,8.5,0.5348837209302326,-115,0.5097020142727117,CLE,OAK,2022 REG,10,6,8,3,9,18,1,0,3,-3,1,1,1,0,0,0,0,0,0,0.5097020142727117,0.49029798572728833
87397,0.6254681647940076,0.4166666666666667,-167,140,0.5991141690863948,0.4008858309136052,home,CLE,under,8.5,0.5121951219512195,-105,0.49029798572728833,CLE,OAK,2022 REG,10,6,8,3,9,18,1,0,3,-3,1,1,1,0,0,0,0,0,0,0.5097020142727117,0.49029798572728833
87398,0.5192307692307692,0.5145631067961165,-108,-106,0.5016839489860401,0.4983160510139599,away,TOR,over,6.5,0.5412844036697247,-118,0.5149381613977361,TB,TOR,2022 REG,7,1,5,3,4,12,0,1,-2,2,1,0,0,0,0,0,0,0,0,0.5149381613977361,0.48506183860226393
87398,0.5192307692307692,0.5145631067961165,-108,-106,0.5016839489860401,0.4983160510139599,home,TB,under,6.5,0.5073891625615764,-103,0.48506183860226393,TB,TOR,2022 REG,7,1,5,3,4,12,0,1,-2,2,1,0,0,0,0,0,0,0,0,0.5149381613977361,0.48506183860226393
87399,0.6875,0.3508771929824561,-220,185,0.6611156798245614,0.33888432017543857,away,CWS,over,7.5,0.5238095238095238,-110,0.4988662131519274,SD,CWS,2022 REG,7,1,8,3,4,15,0,1,-2,2,1,0,0,0,0,0,0,0,0,0.4988662131519274,0.5011337868480725
87399,0.6875,0.3508771929824561,-220,185,0.6611156798245614,0.33888432017543857,home,SD,under,7.5,0.5238095238095238,-110,0.5011337868480725,SD,CWS,2022 REG,7,1,8,3,4,15,0,1,-2,2,1,0,0,0,0,0,0,0,0,0.4988662131519274,0.5011337868480725
87400,0.6000000000000001,0.4484304932735426,-150,123,0.5709417040358745,0.4290582959641255,away,BAL,over,7.5,0.5283018867924528,-112,0.5031902949311281,DET,BAL,2022 REG,6,4,8,2,6,14,1,0,2,-2,1,1,0,0,0,0,0,0,0,0.5031902949311281,0.4968097050688719
87400,0.6000000000000001,0.4484304932735426,-150,123,0.5709417040358745,0.4290582959641255,home,DET,under,7.5,0.5192307692307692,-108,0.4968097050688719,DET,BAL,2022 REG,6,4,8,2,6,14,1,0,2,-2,1,1,0,0,0,0,0,0,0,0.5031902949311281,0.4968097050688719
87401,0.5594713656387665,0.47619047619047616,-127,110,0.5395195862893665,0.46048041371063353,away,WSH,over,9.5,0.5348837209302326,-115,0.5109810284308424,CIN,WSH,2022 REG,6,5,12,8,13,18,0,1,-3,3,1,1,1,1,1,0,0,0,0,0.5109810284308424,0.48901897156915763
87401,0.5594713656387665,0.47619047619047616,-127,110,0.5395195862893665,0.46048041371063353,home,CIN,under,9.5,0.5098039215686274,-104,0.48901897156915763,CIN,WSH,2022 REG,6,5,12,8,13,18,0,1,-3,3,1,1,1,1,1,0,0,0,0,0.5109810284308424,0.48901897156915763
87402,0.6610169491525424,0.37735849056603776,-195,165,0.6356501330673793,0.3643498669326207,away,ARI,over,9.5,0.5145631067961165,-106,0.49023796582517226,PHI,ARI,2022 REG,7,1,12,13,14,19,0,1,-12,12,1,0,0,0,0,0,0,0,0,0.49023796582517226,0.5097620341748277
87402,0.6610169491525424,0.37735849056603776,-195,165,0.6356501330673793,0.3643498669326207,home,PHI,under,9.5,0.5327102803738317,-114,0.5097620341748277,PHI,ARI,2022 REG,7,1,12,13,14,19,0,1,-12,12,1,0,0,0,0,0,0,0,0,0.49023796582517226,0.5097620341748277
87403,0.574468085106383,0.46511627906976744,-135,115,0.5517281312179562,0.44827186878204384,away,TB,over,8.5,0.5098039215686274,-104,0.48592421718142587,NYY,TB,2022 REG,10,8,9,7,15,19,1,0,1,-1,1,1,1,1,1,1,1,0,0,0.48592421718142587,0.5140757828185741
87403,0.574468085106383,0.46511627906976744,-135,115,0.5517281312179562,0.44827186878204384,home,NYY,under,8.5,0.5370370370370371,-116,0.5140757828185741,NYY,TB,2022 REG,10,8,9,7,15,19,1,0,1,-1,1,1,1,1,1,1,1,0,0,0.48592421718142587,0.5140757828185741
87404,0.43859649122807015,0.6000000000000001,128,-150,0.4216682056017235,0.5783317943982764,away,NYY,over,9,0.5121951219512195,-105,0.48808156828023186,BAL,NYY,2022 REG,9,6,9,7,13,18,0,1,-1,1,1,1,1,1,1,1,0,0,0,0.48808156828023186,0.5119184317197681
87404,0.43859649122807015,0.6000000000000001,128,-150,0.4216682056017235,0.5783317943982764,home,BAL,under,9,0.5348837209302326,-115,0.5119184317197681,BAL,NYY,2022 REG,9,6,9,7,13,18,0,1,-1,1,1,1,1,1,1,1,0,0,0,0.48808156828023186,0.5119184317197681
87405,0.5121951219512195,0.5238095238095238,-105,-110,0.4937537180249852,0.5062462819750149,away,TOR,over,9,0.5024875621890548,-101,0.47839724939301687,SEA,TOR,2022 REG,10,8,10,3,11,20,1,0,5,-5,1,1,1,0,0,0,0,0,0,0.47839724939301687,0.5216027506069831
87405,0.5121951219512195,0.5238095238095238,-105,-110,0.4937537180249852,0.5062462819750149,home,SEA,under,9,0.5454545454545454,-120,0.5216027506069831,SEA,TOR,2022 REG,10,8,10,3,11,20,1,0,5,-5,1,1,1,0,0,0,0,0,0,0.47839724939301687,0.5216027506069831
87406,0.5884773662551441,0.4484304932735426,-143,123,0.5667579262855877,0.43324207371441226,away,PIT,over,8.5,0.5024875621890548,-101,0.48049269377245407,CHC,PIT,2022 REG,9,3,8,2,5,17,1,0,1,-1,1,1,0,0,0,0,0,0,0,0.48049269377245407,0.5195073062275459
87406,0.5884773662551441,0.4484304932735426,-143,123,0.5667579262855877,0.43324207371441226,home,CHC,under,8.5,0.5412844036697247,-118,0.5195073062275459,CHC,PIT,2022 REG,9,3,8,2,5,17,1,0,1,-1,1,1,0,0,0,0,0,0,0,0.48049269377245407,0.5195073062275459
87407,0.48780487804878053,0.5555555555555556,105,-125,0.4666534470222751,0.5333465529777248,away,TOR,over,9,0.5073891625615764,-103,0.4826927225525911,CWS,TOR,2022 REG,13,8,8,7,15,21,1,0,1,-1,1,1,1,1,1,1,1,0,0,0.4826927225525911,0.5173072774474089
87407,0.48780487804878053,0.5555555555555556,105,-125,0.4666534470222751,0.5333465529777248,home,CWS,under,9,0.5412844036697247,-118,0.5173072774474089,CWS,TOR,2022 REG,13,8,8,7,15,21,1,0,1,-1,1,1,1,1,1,1,1,0,0,0.4826927225525911,0.5173072774474089
87408,0.6226415094339623,0.4166666666666667,-165,140,0.5981666073335706,0.40183339266642937,away,MIA,over,6.5,0.5348837209302326,-115,0.5097020142727117,SD,MIA,2022 REG,8,3,5,2,5,13,1,0,1,-1,1,1,0,0,0,0,0,0,0,0.5097020142727117,0.49029798572728833
87408,0.6226415094339623,0.4166666666666667,-165,140,0.5981666073335706,0.40183339266642937,home,SD,under,6.5,0.5121951219512195,-105,0.49029798572728833,SD,MIA,2022 REG,8,3,5,2,5,13,1,0,1,-1,1,1,0,0,0,0,0,0,0,0.5097020142727117,0.49029798572728833
87409,0.6551724137931035,0.3846153846153846,-190,160,0.6291045458703008,0.37089545412969915,away,SEA,over,9,0.5348837209302326,-115,0.5097020142727117,NYY,SEA,2022 REG,10,7,7,2,9,17,1,0,5,-5,1,1,0,0,0,0,0,0,0,0.5097020142727117,0.49029798572728833
87409,0.6551724137931035,0.3846153846153846,-190,160,0.6291045458703008,0.37089545412969915,home,NYY,under,9,0.5121951219512195,-105,0.49029798572728833,NYY,SEA,2022 REG,10,7,7,2,9,17,1,0,5,-5,1,1,0,0,0,0,0,0,0,0.5097020142727117,0.49029798572728833
87410,0.574468085106383,0.46511627906976744,-135,115,0.5517281312179562,0.44827186878204384,away,STL,over,7.5,0.5283018867924528,-112,0.5044173060022736,MIA,STL,2022 REG,5,0,5,2,2,10,0,1,-2,2,0,0,0,0,0,0,0,0,0,0.5044173060022736,0.49558269399772636
87410,0.574468085106383,0.46511627906976744,-135,115,0.5517281312179562,0.44827186878204384,home,MIA,under,7.5,0.5169082125603864,-107,0.49558269399772636,MIA,STL,2022 REG,5,0,5,2,2,10,0,1,-2,2,0,0,0,0,0,0,0,0,0,0.5044173060022736,0.49558269399772636
87411,0.4608294930875576,0.576271186440678,117,-136,0.4437324057473569,0.5562675942526432,away,MIL,over,10.5,0.5305164319248826,-113,0.5066009958897986,CHC,MIL,2022 REG,6,1,3,3,4,9,0,1,-2,2,1,0,0,0,0,0,0,0,0,0.5066009958897986,0.49339900411020143
87411,0.4608294930875576,0.576271186440678,117,-136,0.4437324057473569,0.5562675942526432,home,CHC,under,10.5,0.5145631067961165,-106,0.49339900411020143,CHC,MIL,2022 REG,6,1,3,3,4,9,0,1,-2,2,1,0,0,0,0,0,0,0,0,0.5066009958897986,0.49339900411020143
87412,0.7402597402597403,0.30303030303030304,-285,230,0.7082138640580199,0.2917861359419801,away,KC,over,8.5,0.5121951219512195,-105,0.4903184724049234,NYY,KC,2022 REG,7,6,9,8,14,16,0,1,-2,2,1,1,1,1,1,1,0,0,0,0.4903184724049234,0.5096815275950766
87412,0.7402597402597403,0.30303030303030304,-285,230,0.7082138640580199,0.2917861359419801,home,NYY,under,8.5,0.5305164319248826,-113,0.5096815275950766,NYY,KC,2022 REG,7,6,9,8,14,16,0,1,-2,2,1,1,1,1,1,1,0,0,0,0.4903184724049234,0.5096815275950766
87413,0.6551724137931035,0.3802281368821293,-190,163,0.6319789495576061,0.36802105044239386,away,CHC,over,7.5,0.5412844036697247,-118,0.5149381613977361,MIL,CHC,2022 REG,12,7,5,0,7,17,1,0,7,-7,0,0,0,0,0,0,0,0,0,0.5149381613977361,0.48506183860226393
87413,0.6551724137931035,0.3802281368821293,-190,163,0.6319789495576061,0.36802105044239386,home,MIL,under,7.5,0.5073891625615764,-103,0.48506183860226393,MIL,CHC,2022 REG,12,7,5,0,7,17,1,0,7,-7,0,0,0,0,0,0,0,0,0,0.5149381613977361,0.48506183860226393
87414,0.5884773662551441,0.4484304932735426,-143,123,0.5667579262855877,0.43324207371441226,away,MIA,over,6.5,0.5305164319248826,-113,0.5066009958897986,NYM,MIA,2022 REG,6,2,8,6,8,14,0,1,-4,4,1,1,0,0,0,0,0,0,0,0.5066009958897986,0.49339900411020143
87414,0.5884773662551441,0.4484304932735426,-143,123,0.5667579262855877,0.43324207371441226,home,NYM,under,6.5,0.5145631067961165,-106,0.49339900411020143,NYM,MIA,2022 REG,6,2,8,6,8,14,0,1,-4,4,1,1,0,0,0,0,0,0,0,0.5066009958897986,0.49339900411020143
87415,0.6108949416342413,0.425531914893617,-157,135,0.5886419592417365,0.41135804075826354,away,CIN,over,8.5,0.5454545454545454,-120,0.5206611570247933,ARI,CIN,2022 REG,10,4,8,5,9,18,0,1,-1,1,1,1,1,1,0,0,0,0,0,0.5206611570247933,0.4793388429752067
87415,0.6108949416342413,0.425531914893617,-157,135,0.5886419592417365,0.41135804075826354,home,ARI,under,8.5,0.5,100,0.4793388429752067,ARI,CIN,2022 REG,10,4,8,5,9,18,0,1,-1,1,1,1,1,1,0,0,0,0,0,0.5206611570247933,0.4793388429752067
87416,0.48780487804878053,0.5555555555555556,105,-125,0.4666534470222751,0.5333465529777248,away,HOU,over,8,0.5283018867924528,-112,0.5044173060022736,LAA,HOU,2022 REG,2,5,8,6,11,10,0,1,-1,1,1,1,1,1,1,0,0,0,0,0.5044173060022736,0.49558269399772636
87416,0.48780487804878053,0.5555555555555556,105,-125,0.4666534470222751,0.5333465529777248,home,LAA,under,8,0.5169082125603864,-107,0.49558269399772636,LAA,HOU,2022 REG,2,5,8,6,11,10,0,1,-1,1,1,1,1,1,1,0,0,0,0,0.5044173060022736,0.49558269399772636
87417,0.47619047619047616,0.5652173913043479,110,-130,0.4564724440500838,0.5435275559499162,away,TOR,over,8.5,0.5348837209302326,-115,0.5097020142727117,BAL,TOR,2022 REG,10,4,11,8,12,21,0,1,-4,4,1,1,1,1,0,0,0,0,0,0.5097020142727117,0.49029798572728833
87417,0.47619047619047616,0.5652173913043479,110,-130,0.4564724440500838,0.5435275559499162,home,BAL,under,8.5,0.5121951219512195,-105,0.49029798572728833,BAL,TOR,2022 REG,10,4,11,8,12,21,0,1,-4,4,1,1,1,1,0,0,0,0,0,0.5097020142727117,0.49029798572728833
87418,0.6153846153846154,0.4166666666666667,-160,140,0.5956607495069033,0.4043392504930967,away,TEX,over,8,0.5305164319248826,-113,0.5053568787472517,CWS,TEX,2022 REG,15,9,15,11,20,30,0,1,-2,2,1,1,1,1,1,1,1,1,1,0.5053568787472517,0.49464312125274834
87418,0.6153846153846154,0.4166666666666667,-160,140,0.5956607495069033,0.4043392504930967,home,CWS,under,8,0.5169082125603864,-107,0.49464312125274834,CWS,TEX,2022 REG,15,9,15,11,20,30,0,1,-2,2,1,1,1,1,1,1,1,1,1,0.5053568787472517,0.49464312125274834
87419,0.7014925373134329,0.3389830508474576,-235,195,0.6730992142751963,0.32690078572480374,away,TEX,over,7.5,0.5169082125603864,-107,0.49353874091423283,LAA,TEX,2022 REG,5,0,10,2,2,15,0,1,-2,2,0,0,0,0,0,0,0,0,0,0.49353874091423283,0.5064612590857671
87419,0.7014925373134329,0.3389830508474576,-235,195,0.6730992142751963,0.32690078572480374,home,LAA,under,7.5,0.5283018867924528,-112,0.5064612590857671,LAA,TEX,2022 REG,5,0,10,2,2,15,0,1,-2,2,0,0,0,0,0,0,0,0,0,0.49353874091423283,0.5064612590857671
87420,0.4166666666666667,0.6254681647940076,140,-167,0.3991104868913858,0.6008895131086143,away,MIL,over,9.5,0.5098039215686274,-104,0.48483656587239576,BAL,MIL,2022 REG,7,4,9,5,9,16,0,1,-1,1,1,1,1,1,0,0,0,0,0,0.48483656587239576,0.5151634341276042
87420,0.4166666666666667,0.6254681647940076,140,-167,0.3991104868913858,0.6008895131086143,home,BAL,under,9.5,0.5391705069124424,-117,0.5151634341276042,BAL,MIL,2022 REG,7,4,9,5,9,16,0,1,-1,1,1,1,1,1,0,0,0,0,0,0.48483656587239576,0.5151634341276042
87421,0.4484304932735426,0.5884773662551441,123,-143,0.43187988361942303,0.5681201163805769,away,LAD,over,8,0.5145631067961165,-106,0.4891195935000339,SF,LAD,2022 REG,5,2,11,8,10,16,0,1,-6,6,1,1,0,0,0,0,0,0,0,0.4891195935000339,0.5108804064999661
87421,0.4484304932735426,0.5884773662551441,123,-143,0.43187988361942303,0.5681201163805769,home,SF,under,8,0.5348837209302326,-115,0.5108804064999661,SF,LAD,2022 REG,5,2,11,8,10,16,0,1,-6,6,1,1,0,0,0,0,0,0,0,0.4891195935000339,0.5108804064999661
87422,0.4166666666666667,0.6226415094339623,140,-165,0.4002882599580712,0.5997117400419287,away,LAD,over,8,0.5238095238095238,-110,0.5012646084074657,STL,LAD,2022 REG,9,6,12,7,13,21,0,1,-1,1,1,1,1,1,1,1,0,0,0,0.5012646084074657,0.4987353915925343
87422,0.4166666666666667,0.6226415094339623,140,-165,0.4002882599580712,0.5997117400419287,home,STL,under,8,0.5192307692307692,-108,0.4987353915925343,STL,LAD,2022 REG,9,6,12,7,13,21,0,1,-1,1,1,1,1,1,1,1,0,0,0,0.5012646084074657,0.4987353915925343
87423,0.6610169491525424,0.37735849056603776,-195,165,0.6356501330673793,0.3643498669326207,away,CIN,over,8.5,0.5121951219512195,-105,0.48808156828023186,TOR,CIN,2022 REG,9,2,8,1,3,17,1,0,1,-1,1,0,0,0,0,0,0,0,0,0.48808156828023186,0.5119184317197681
87423,0.6610169491525424,0.37735849056603776,-195,165,0.6356501330673793,0.3643498669326207,home,TOR,under,8.5,0.5348837209302326,-115,0.5119184317197681,TOR,CIN,2022 REG,9,2,8,1,3,17,1,0,1,-1,1,0,0,0,0,0,0,0,0,0.48808156828023186,0.5119184317197681
87424,0.4166666666666667,0.6376811594202898,140,-176,0.3940217391304348,0.6059782608695652,away,ATL,over,9.5,0.5121951219512195,-105,0.48808156828023186,WSH,ATL,2022 REG,8,4,12,8,12,20,0,1,-4,4,1,1,1,1,0,0,0,0,0,0.48808156828023186,0.5119184317197681
87424,0.4166666666666667,0.6376811594202898,140,-176,0.3940217391304348,0.6059782608695652,home,WSH,under,9.5,0.5348837209302326,-115,0.5119184317197681,WSH,ATL,2022 REG,8,4,12,8,12,20,0,1,-4,4,1,1,1,1,0,0,0,0,0,0.48808156828023186,0.5119184317197681
87425,0.5652173913043479,0.47619047619047616,-130,110,0.5418129444594474,0.4581870555405526,away,BAL,over,8,0.504950495049505,-102,0.4826715732667395,SEA,BAL,2022 REG,11,9,8,3,12,19,1,0,6,-6,1,1,1,0,0,0,0,0,0,0.4826715732667395,0.5173284267332605
87425,0.5652173913043479,0.47619047619047616,-130,110,0.5418129444594474,0.4581870555405526,home,SEA,under,8,0.5391705069124424,-117,0.5173284267332605,SEA,BAL,2022 REG,11,9,8,3,12,19,1,0,6,-6,1,1,1,0,0,0,0,0,0,0.4826715732667395,0.5173284267332605
87426,0.5348837209302326,0.5073891625615764,-115,-103,0.5122726437136835,0.48772735628631647,away,COL,over,7.5,0.5391705069124424,-117,0.5127649394825569,PIT,COL,2022 REG,5,1,7,2,3,12,0,1,-1,1,1,0,0,0,0,0,0,0,0,0.5127649394825569,0.48723506051744314
87426,0.5348837209302326,0.5073891625615764,-115,-103,0.5122726437136835,0.48772735628631647,home,PIT,under,7.5,0.5098039215686274,-104,0.48723506051744314,PIT,COL,2022 REG,5,1,7,2,3,12,0,1,-1,1,1,0,0,0,0,0,0,0,0,0.5127649394825569,0.48723506051744314
87427,0.6031746031746031,0.45454545454545453,-152,120,0.5683593302640922,0.43164066973590776,away,TEX,over,9,0.49019607843137253,104,0.45673767148954386,CLE,TEX,2022 REG,5,3,12,6,9,17,0,1,-3,3,1,1,1,0,0,0,0,0,0,0.45673767148954386,0.5432623285104561
87427,0.6031746031746031,0.45454545454545453,-152,120,0.5683593302640922,0.43164066973590776,home,CLE,under,9,0.5780590717299579,-137,0.5432623285104561,CLE,TEX,2022 REG,5,3,12,6,9,17,0,1,-3,3,1,1,1,0,0,0,0,0,0,0.45673767148954386,0.5432623285104561
87428,0.6551724137931035,0.3846153846153846,-190,160,0.6291045458703008,0.37089545412969915,away,WSH,over,9,0.5454545454545454,-120,0.5206611570247933,LAA,WSH,2022 REG,5,3,4,0,3,9,1,0,3,-3,0,0,0,0,0,0,0,0,0,0.5206611570247933,0.4793388429752067
87428,0.6551724137931035,0.3846153846153846,-190,160,0.6291045458703008,0.37089545412969915,home,LAA,under,9,0.5,100,0.4793388429752067,LAA,WSH,2022 REG,5,3,4,0,3,9,1,0,3,-3,0,0,0,0,0,0,0,0,0,0.5206611570247933,0.4793388429752067
87429,0.4291845493562232,0.607843137254902,133,-155,0.41329283836432396,0.586707161635676,away,LAD,over,8,0.5121951219512195,-105,0.48808156828023186,SF,LAD,2022 REG,7,5,13,9,14,20,0,1,-4,4,1,1,1,1,1,0,0,0,0,0.48808156828023186,0.5119184317197681
87429,0.4291845493562232,0.607843137254902,133,-155,0.41329283836432396,0.586707161635676,home,SF,under,8,0.5348837209302326,-115,0.5119184317197681,SF,LAD,2022 REG,7,5,13,9,14,20,0,1,-4,4,1,1,1,1,1,0,0,0,0,0.48808156828023186,0.5119184317197681
87430,0.613899613899614,0.425531914893617,-159,135,0.589692613597978,0.410307386402022,away,TEX,over,8.5,0.5145631067961165,-106,0.4913668392989033,SEA,TEX,2022 REG,8,4,6,3,7,14,1,0,1,-1,1,1,1,0,0,0,0,0,0,0.4913668392989033,0.5086331607010968
87430,0.613899613899614,0.425531914893617,-159,135,0.589692613597978,0.410307386402022,home,SEA,under,8.5,0.5305164319248826,-113,0.5086331607010968,SEA,TEX,2022 REG,8,4,6,3,7,14,1,0,1,-1,1,1,1,0,0,0,0,0,0,0.4913668392989033,0.5086331607010968
87431,0.5689655172413793,0.4716981132075471,-132,112,0.5458293137100936,0.4541706862899064,away,STL,over,7,0.5454545454545454,-120,0.5206611570247933,SF,STL,2022 REG,10,1,12,7,8,22,0,1,-6,6,1,0,0,0,0,0,0,0,0,0.5206611570247933,0.4793388429752067
87431,0.5689655172413793,0.4716981132075471,-132,112,0.5458293137100936,0.4541706862899064,home,SF,under,7,0.5,100,0.4793388429752067,SF,STL,2022 REG,10,1,12,7,8,22,0,1,-6,6,1,0,0,0,0,0,0,0,0,0.5206611570247933,0.4793388429752067
87432,0.7701149425287357,0.273972602739726,-335,265,0.7361624651380813,0.26383753486191874,away,PIT,over,8,0.5238095238095238,-110,0.4988662131519274,NYY,PIT,2022 REG,11,9,10,8,17,21,1,0,1,-1,1,1,1,1,1,1,1,1,0,0.4988662131519274,0.5011337868480725
87432,0.7701149425287357,0.273972602739726,-335,265,0.7361624651380813,0.26383753486191874,home,NYY,under,8,0.5238095238095238,-110,0.5011337868480725,NYY,PIT,2022 REG,11,9,10,8,17,21,1,0,1,-1,1,1,1,1,1,1,1,1,0,0.4988662131519274,0.5011337868480725
87433,0.75,0.29411764705882354,-300,240,0.7169117647058822,0.28308823529411775,away,CIN,over,8,0.5348837209302326,-115,0.5097020142727117,NYY,CIN,2022 REG,9,3,7,4,7,16,0,1,-1,1,1,1,1,0,0,0,0,0,0,0.5097020142727117,0.49029798572728833
87433,0.75,0.29411764705882354,-300,240,0.7169117647058822,0.28308823529411775,home,NYY,under,8,0.5121951219512195,-105,0.49029798572728833,NYY,CIN,2022 REG,9,3,7,4,7,16,0,1,-1,1,1,1,1,0,0,0,0,0,0,0.5097020142727117,0.49029798572728833
87434,0.7333333333333333,0.30303030303030304,-275,230,0.7066666666666666,0.29333333333333345,away,OAK,over,7,0.5454545454545454,-120,0.5166307047184789,LAA,OAK,2022 REG,13,4,3,2,6,16,1,0,2,-2,1,1,0,0,0,0,0,0,0,0.5166307047184789,0.48336929528152106
87434,0.7333333333333333,0.30303030303030304,-275,230,0.7066666666666666,0.29333333333333345,home,LAA,under,7,0.5073891625615764,-103,0.48336929528152106,LAA,OAK,2022 REG,13,4,3,2,6,16,1,0,2,-2,1,1,0,0,0,0,0,0,0,0.5166307047184789,0.48336929528152106
87435,0.607843137254902,0.4291845493562232,-155,133,0.5853361120599043,0.4146638879400957,away,SF,over,8,0.5391705069124424,-117,0.5127649394825569,ATL,SF,2022 REG,9,2,8,1,3,17,1,0,1,-1,1,0,0,0,0,0,0,0,0,0.5127649394825569,0.48723506051744314
87435,0.607843137254902,0.4291845493562232,-155,133,0.5853361120599043,0.4146638879400957,home,ATL,under,8,0.5098039215686274,-104,0.48723506051744314,ATL,SF,2022 REG,9,2,8,1,3,17,1,0,1,-1,1,0,0,0,0,0,0,0,0,0.5127649394825569,0.48723506051744314
87436,0.6296296296296295,0.4081632653061224,-170,145,0.6058341031886005,0.39416589681139946,away,MIA,over,7,0.5495495495495495,-122,0.5250401592387142,NYM,MIA,2022 REG,5,2,10,5,7,15,0,1,-3,3,1,1,0,0,0,0,0,0,0,0.5250401592387142,0.47495984076128583
87436,0.6296296296296295,0.4081632653061224,-170,145,0.6058341031886005,0.39416589681139946,home,NYM,under,7,0.49504950495049505,102,0.47495984076128583,NYM,MIA,2022 REG,5,2,10,5,7,15,0,1,-3,3,1,1,0,0,0,0,0,0,0,0.5250401592387142,0.47495984076128583
87437,0.43859649122807015,0.6031746031746031,128,-152,0.4202758357883012,0.5797241642116988,away,SEA,over,8.5,0.5475113122171946,-121,0.5242087833606768,BAL,SEA,2022 REG,10,9,8,2,11,18,1,0,7,-7,1,1,0,0,0,0,0,0,0,0.5242087833606768,0.4757912166393232
87437,0.43859649122807015,0.6031746031746031,128,-152,0.4202758357883012,0.5797241642116988,home,BAL,under,8.5,0.49504950495049505,102,0.4757912166393232,BAL,SEA,2022 REG,10,9,8,2,11,18,1,0,7,-7,1,1,0,0,0,0,0,0,0,0.5242087833606768,0.4757912166393232
87438,0.5495495495495495,0.48780487804878053,-122,105,0.529021440689206,0.470978559310794,away,COL,over,19.5,0.4629629629629629,116,0.43759273256627756,WSH,COL,2022 REG,8,2,10,3,5,18,0,1,-1,1,1,1,0,0,0,0,0,0,0,0.43759273256627756,0.5624072674337224
87438,0.5495495495495495,0.48780487804878053,-122,105,0.529021440689206,0.470978559310794,home,WSH,under,19.5,0.5918367346938775,-145,0.5624072674337224,WSH,COL,2022 REG,8,2,10,3,5,18,0,1,-1,1,1,1,0,0,0,0,0,0,0,0.43759273256627756,0.5624072674337224
87439,0.49504950495049505,0.5412844036697247,102,-118,0.47706242147513866,0.5229375785248613,away,NYY,over,7.5,0.5412844036697247,-118,0.5189377998484975,CWS,NYY,2022 REG,4,1,2,5,6,6,0,1,-4,4,1,0,0,0,0,0,0,0,0,0.5189377998484975,0.4810622001515025
87439,0.49504950495049505,0.5412844036697247,102,-118,0.47706242147513866,0.5229375785248613,home,CWS,under,7.5,0.5,100,0.4810622001515025,CWS,NYY,2022 REG,4,1,2,5,6,6,0,1,-4,4,1,0,0,0,0,0,0,0,0,0.5189377998484975,0.4810622001515025
87440,0.49019607843137253,0.5475113122171946,104,-121,0.47171206340756505,0.5282879365924349,away,TOR,over,9,0.5098039215686274,-104,0.48592421718142587,BOS,TOR,2022 REG,10,5,29,28,33,39,0,1,-23,23,1,1,1,1,1,0,0,0,0,0.48592421718142587,0.5140757828185741
87440,0.49019607843137253,0.5475113122171946,104,-121,0.47171206340756505,0.5282879365924349,home,BOS,under,9,0.5370370370370371,-116,0.5140757828185741,BOS,TOR,2022 REG,10,5,29,28,33,39,0,1,-23,23,1,1,1,1,1,0,0,0,0,0.48592421718142587,0.5140757828185741
87441,0.5535714285714286,0.4807692307692307,-124,108,0.5345614207221351,0.4654385792778649,away,HOU,over,8.5,0.5454545454545454,-120,0.5220180091279142,LAA,HOU,2022 REG,4,1,8,3,4,12,0,1,-2,2,1,0,0,0,0,0,0,0,0,0.5220180091279142,0.4779819908720858
87441,0.5535714285714286,0.4807692307692307,-124,108,0.5345614207221351,0.4654385792778649,home,LAA,under,8.5,0.49751243781094534,101,0.4779819908720858,LAA,HOU,2022 REG,4,1,8,3,4,12,0,1,-2,2,1,0,0,0,0,0,0,0,0,0.5220180091279142,0.4779819908720858
87442,0.6923076923076923,0.35714285714285715,-225,180,0.658072696534235,0.34192730346576505,away,WSH,over,7.5,0.5348837209302326,-115,0.5097020142727117,CHC,WSH,2022 REG,15,5,9,6,11,24,0,1,-1,1,1,1,1,1,1,0,0,0,0,0.5097020142727117,0.49029798572728833
87442,0.6923076923076923,0.35714285714285715,-225,180,0.658072696534235,0.34192730346576505,home,CHC,under,7.5,0.5121951219512195,-105,0.49029798572728833,CHC,WSH,2022 REG,15,5,9,6,11,24,0,1,-1,1,1,1,1,1,1,0,0,0,0,0.5097020142727117,0.49029798572728833
87443,0.5535714285714286,0.48309178743961345,-124,107,0.5332757197081732,0.4667242802918268,away,HOU,over,8.5,0.5412844036697247,-118,0.5149381613977361,BOS,HOU,2022 REG,8,6,7,3,9,15,1,0,3,-3,1,1,1,0,0,0,0,0,0,0.5149381613977361,0.48506183860226393
87443,0.5535714285714286,0.48309178743961345,-124,107,0.5332757197081732,0.4667242802918268,home,BOS,under,8.5,0.5073891625615764,-103,0.48506183860226393,BOS,HOU,2022 REG,8,6,7,3,9,15,1,0,3,-3,1,1,1,0,0,0,0,0,0,0.5149381613977361,0.48506183860226393
87444,0.6254681647940076,0.41152263374485604,-167,143,0.6023315979176397,0.3976684020823603,away,TB,over,7.5,0.5,100,0.4772727272727273,HOU,TB,2022 REG,10,3,6,1,4,16,1,0,2,-2,1,0,0,0,0,0,0,0,0,0.4772727272727273,0.5227272727272727
87444,0.6254681647940076,0.41152263374485604,-167,143,0.6023315979176397,0.3976684020823603,home,HOU,under,7.5,0.5454545454545454,-120,0.5227272727272727,HOU,TB,2022 REG,10,3,6,1,4,16,1,0,2,-2,1,0,0,0,0,0,0,0,0,0.4772727272727273,0.5227272727272727
87445,0.5780590717299579,0.4587155963302753,-137,118,0.5568011412478822,0.44319885875211784,away,CIN,over,6.5,0.5169082125603864,-107,0.49239402434819424,CHC,CIN,2022 REG,3,2,4,1,3,7,1,0,1,-1,1,0,0,0,0,0,0,0,0,0.49239402434819424,0.5076059756518058
87445,0.5780590717299579,0.4587155963302753,-137,118,0.5568011412478822,0.44319885875211784,home,CHC,under,6.5,0.5305164319248826,-113,0.5076059756518058,CHC,CIN,2022 REG,3,2,4,1,3,7,1,0,1,-1,1,0,0,0,0,0,0,0,0,0.49239402434819424,0.5076059756518058
87446,0.425531914893617,0.607843137254902,135,-155,0.4113297650431834,0.5886702349568166,away,TB,over,9,0.5348837209302326,-115,0.5097020142727117,BAL,TB,2022 REG,10,7,12,6,13,22,1,0,1,-1,1,1,1,1,1,1,0,0,0,0.5097020142727117,0.49029798572728833
87446,0.425531914893617,0.607843137254902,135,-155,0.4113297650431834,0.5886702349568166,home,BAL,under,9,0.5121951219512195,-105,0.49029798572728833,BAL,TB,2022 REG,10,7,12,6,13,22,1,0,1,-1,1,1,1,1,1,1,0,0,0,0.5097020142727117,0.49029798572728833
87447,0.4166666666666667,0.6226415094339623,140,-165,0.4002882599580712,0.5997117400419287,away,STL,over,10.5,0.5098039215686274,-104,0.4870219861770517,CIN,STL,2022 REG,6,3,13,6,9,19,0,1,-3,3,1,1,1,0,0,0,0,0,0,0.4870219861770517,0.5129780138229483
87447,0.4166666666666667,0.6226415094339623,140,-165,0.4002882599580712,0.5997117400419287,home,CIN,under,10.5,0.5348837209302326,-115,0.5129780138229483,CIN,STL,2022 REG,6,3,13,6,9,19,0,1,-3,3,1,1,1,0,0,0,0,0,0,0.4870219861770517,0.5129780138229483
87448,0.5121951219512195,0.5348837209302326,-105,-115,0.48808156828023186,0.5119184317197681,away,ARI,over,8,0.5121951219512195,-105,0.48808156828023186,CHC,ARI,2022 REG,4,1,6,3,4,10,0,1,-2,2,1,0,0,0,0,0,0,0,0,0.48808156828023186,0.5119184317197681
87448,0.5121951219512195,0.5348837209302326,-105,-115,0.48808156828023186,0.5119184317197681,home,CHC,under,8,0.5348837209302326,-115,0.5119184317197681,CHC,ARI,2022 REG,4,1,6,3,4,10,0,1,-2,2,1,0,0,0,0,0,0,0,0,0.48808156828023186,0.5119184317197681
87449,0.4081632653061224,0.6363636363636364,145,-175,0.3899890197266291,0.6100109802733709,away,SD,over,8.5,0.5169082125603864,-107,0.49353874091423283,CIN,SD,2022 REG,10,5,8,8,13,18,0,1,-3,3,1,1,1,1,1,0,0,0,0,0.49353874091423283,0.5064612590857671
87449,0.4081632653061224,0.6363636363636364,145,-175,0.3899890197266291,0.6100109802733709,home,CIN,under,8.5,0.5283018867924528,-112,0.5064612590857671,CIN,SD,2022 REG,10,5,8,8,13,18,0,1,-3,3,1,1,1,1,1,0,0,0,0,0.49353874091423283,0.5064612590857671
87450,0.7701149425287357,0.2777777777777778,-335,260,0.7332320429823401,0.2667679570176599,away,WSH,over,8.5,0.5121951219512195,-105,0.48808156828023186,LAD,WSH,2022 REG,8,1,8,4,5,16,0,1,-3,3,1,0,0,0,0,0,0,0,0,0.48808156828023186,0.5119184317197681
87450,0.7701149425287357,0.2777777777777778,-335,260,0.7332320429823401,0.2667679570176599,home,LAD,under,8.5,0.5348837209302326,-115,0.5119184317197681,LAD,WSH,2022 REG,8,1,8,4,5,16,0,1,-3,3,1,0,0,0,0,0,0,0,0,0.48808156828023186,0.5119184317197681
87451,0.5348837209302326,0.5073891625615764,-115,-103,0.5122726437136835,0.48772735628631647,away,TEX,over,10.5,0.5238095238095238,-110,0.4988662131519274,COL,TEX,2022 REG,12,7,9,6,13,21,1,0,1,-1,1,1,1,1,1,1,0,0,0,0.4988662131519274,0.5011337868480725
87451,0.5348837209302326,0.5073891625615764,-115,-103,0.5122726437136835,0.48772735628631647,home,COL,under,10.5,0.5238095238095238,-110,0.5011337868480725,COL,TEX,2022 REG,12,7,9,6,13,21,1,0,1,-1,1,1,1,1,1,1,0,0,0,0.4988662131519274,0.5011337868480725
87452,0.3448275862068966,0.696969696969697,190,-230,0.3304147299391057,0.6695852700608943,away,LAD,over,11,0.5391705069124424,-117,0.5101989271709614,COL,LAD,2022 REG,10,5,7,3,8,17,1,0,2,-2,1,1,1,0,0,0,0,0,0,0.5101989271709614,0.4898010728290386
87452,0.3448275862068966,0.696969696969697,190,-230,0.3304147299391057,0.6695852700608943,home,COL,under,11,0.5145631067961165,-106,0.4898010728290386,COL,LAD,2022 REG,10,5,7,3,8,17,1,0,2,-2,1,1,1,0,0,0,0,0,0,0.5101989271709614,0.4898010728290386
87453,0.49504950495049505,0.5495495495495495,102,-122,0.47297076509898783,0.5270292349010122,away,HOU,over,8.5,0.5121951219512195,-105,0.48808156828023186,CWS,HOU,2022 REG,9,4,7,2,6,16,1,0,2,-2,1,1,0,0,0,0,0,0,0,0.48808156828023186,0.5119184317197681
87453,0.49504950495049505,0.5495495495495495,102,-122,0.47297076509898783,0.5270292349010122,home,CWS,under,8.5,0.5348837209302326,-115,0.5119184317197681,CWS,HOU,2022 REG,9,4,7,2,6,16,1,0,2,-2,1,1,0,0,0,0,0,0,0,0.48808156828023186,0.5119184317197681
87454,0.36363636363636365,0.6666666666666666,175,-200,0.3526170798898072,0.6473829201101928,away,LAD,over,6.5,0.5327102803738317,-114,0.5075272610403079,MIA,LAD,2022 REG,5,2,6,1,3,11,1,0,1,-1,1,0,0,0,0,0,0,0,0,0.5075272610403079,0.4924727389596921
87454,0.36363636363636365,0.6666666666666666,175,-200,0.3526170798898072,0.6473829201101928,home,MIA,under,6.5,0.5145631067961165,-106,0.4924727389596921,MIA,LAD,2022 REG,5,2,6,1,3,11,1,0,1,-1,1,0,0,0,0,0,0,0,0,0.5075272610403079,0.4924727389596921
87455,0.38759689922480617,0.6503496503496503,158,-186,0.3728889342734665,0.6271110657265335,away,NYM,over,8.5,0.5370370370370371,-116,0.5118817074154765,WSH,NYM,2022 REG,8,2,8,4,6,16,0,1,-2,2,1,1,0,0,0,0,0,0,0,0.5118817074154765,0.48811829258452355
87455,0.38759689922480617,0.6503496503496503,158,-186,0.3728889342734665,0.6271110657265335,home,WSH,under,8.5,0.5098039215686274,-104,0.48811829258452355,WSH,NYM,2022 REG,8,2,8,4,6,16,0,1,-2,2,1,1,0,0,0,0,0,0,0,0.5118817074154765,0.48811829258452355
87456,0.607843137254902,0.4347826086956522,-155,130,0.5819333701084867,0.41806662989151333,away,TB,over,7.5,0.49504950495049505,102,0.4739797934813417,MIL,TB,2022 REG,7,4,5,3,7,12,1,0,1,-1,1,1,1,0,0,0,0,0,0,0.4739797934813417,0.5260202065186583
87456,0.607843137254902,0.4347826086956522,-155,130,0.5819333701084867,0.41806662989151333,home,MIL,under,7.5,0.5475113122171946,-121,0.5260202065186583,MIL,TB,2022 REG,7,4,5,3,7,12,1,0,1,-1,1,1,1,0,0,0,0,0,0,0.4739797934813417,0.5260202065186583
87457,0.6666666666666666,0.37037037037037035,-200,170,0.6419753086419753,0.3580246913580247,away,MIN,over,9,0.5145631067961165,-106,0.4913668392989033,LAD,MIN,2022 REG,10,8,8,5,13,18,1,0,3,-3,1,1,1,1,1,0,0,0,0,0.4913668392989033,0.5086331607010968
87457,0.6666666666666666,0.37037037037037035,-200,170,0.6419753086419753,0.3580246913580247,home,LAD,under,9,0.5305164319248826,-113,0.5086331607010968,LAD,MIN,2022 REG,10,8,8,5,13,18,1,0,3,-3,1,1,1,1,1,0,0,0,0,0.4913668392989033,0.5086331607010968
87458,0.41152263374485604,0.6296296296296295,143,-170,0.39458754593642575,0.6054124540635742,away,MIL,over,9,0.5348837209302326,-115,0.5097020142727117,BOS,MIL,2022 REG,7,1,8,4,5,15,0,1,-3,3,1,0,0,0,0,0,0,0,0,0.5097020142727117,0.49029798572728833
87458,0.41152263374485604,0.6296296296296295,143,-170,0.39458754593642575,0.6054124540635742,home,BOS,under,9,0.5121951219512195,-105,0.49029798572728833,BOS,MIL,2022 REG,7,1,8,4,5,15,0,1,-3,3,1,0,0,0,0,0,0,0,0,0.5097020142727117,0.49029798572728833
87459,0.6551724137931035,0.3846153846153846,-190,160,0.6291045458703008,0.37089545412969915,away,BAL,over,9,0.5098039215686274,-104,0.48592421718142587,LAA,BAL,2022 REG,7,7,9,6,13,16,1,0,1,-1,1,1,1,1,1,1,0,0,0,0.48592421718142587,0.5140757828185741
87459,0.6551724137931035,0.3846153846153846,-190,160,0.6291045458703008,0.37089545412969915,home,LAA,under,9,0.5370370370370371,-116,0.5140757828185741,LAA,BAL,2022 REG,7,7,9,6,13,16,1,0,1,-1,1,1,1,1,1,1,0,0,0,0.48592421718142587,0.5140757828185741
87460,0.425531914893617,0.6108949416342413,135,-157,0.41003112488176247,0.5899688751182375,away,STL,over,7,0.5348837209302326,-115,0.5097020142727117,PIT,STL,2022 REG,5,3,7,2,5,12,1,0,1,-1,1,1,0,0,0,0,0,0,0,0.5097020142727117,0.49029798572728833
87460,0.425531914893617,0.6108949416342413,135,-157,0.41003112488176247,0.5899688751182375,home,PIT,under,7,0.5121951219512195,-105,0.49029798572728833,PIT,STL,2022 REG,5,3,7,2,5,12,1,0,1,-1,1,1,0,0,0,0,0,0,0,0.5097020142727117,0.49029798572728833
87461,0.6254681647940076,0.4081632653061224,-167,145,0.6044327759298813,0.3955672240701187,away,CLE,over,8.5,0.5098039215686274,-104,0.48375889301574193,LAA,CLE,2022 REG,6,4,4,1,5,10,1,0,3,-3,1,0,0,0,0,0,0,0,0,0.48375889301574193,0.5162411069842581
87461,0.6254681647940076,0.4081632653061224,-167,145,0.6044327759298813,0.3955672240701187,home,LAA,under,8.5,0.5412844036697247,-118,0.5162411069842581,LAA,CLE,2022 REG,6,4,4,1,5,10,1,0,3,-3,1,0,0,0,0,0,0,0,0,0.48375889301574193,0.5162411069842581
87462,0.4081632653061224,0.6363636363636364,145,-175,0.3899890197266291,0.6100109802733709,away,HOU,over,8,0.5238095238095238,-110,0.4988662131519274,TEX,HOU,2022 REG,5,2,3,3,5,8,0,1,-1,1,1,1,0,0,0,0,0,0,0,0.4988662131519274,0.5011337868480725
87462,0.4081632653061224,0.6363636363636364,145,-175,0.3899890197266291,0.6100109802733709,home,TEX,under,8,0.5238095238095238,-110,0.5011337868480725,TEX,HOU,2022 REG,5,2,3,3,5,8,0,1,-1,1,1,1,0,0,0,0,0,0,0,0.4988662131519274,0.5011337868480725
87463,0.5833333333333333,0.45454545454545453,-140,120,0.5612373737373737,0.4387626262626263,away,MIN,over,7.5,0.5348837209302326,-115,0.5097020142727117,CWS,MIN,2022 REG,8,8,3,3,11,11,1,0,5,-5,1,1,1,0,0,0,0,0,0,0.5097020142727117,0.49029798572728833
87463,0.5833333333333333,0.45454545454545453,-140,120,0.5612373737373737,0.4387626262626263,home,CWS,under,7.5,0.5121951219512195,-105,0.49029798572728833,CWS,MIN,2022 REG,8,8,3,3,11,11,1,0,5,-5,1,1,1,0,0,0,0,0,0,0.5097020142727117,0.49029798572728833
87464,0.6254681647940076,0.4081632653061224,-167,145,0.6044327759298813,0.3955672240701187,away,SD,over,8.5,0.5348837209302326,-115,0.5097020142727117,LAD,SD,2022 REG,12,8,4,1,9,16,1,0,7,-7,1,0,0,0,0,0,0,0,0,0.5097020142727117,0.49029798572728833
87464,0.6254681647940076,0.4081632653061224,-167,145,0.6044327759298813,0.3955672240701187,home,LAD,under,8.5,0.5121951219512195,-105,0.49029798572728833,LAD,SD,2022 REG,12,8,4,1,9,16,1,0,7,-7,1,0,0,0,0,0,0,0,0,0.5097020142727117,0.49029798572728833
87465,0.6666666666666666,0.37037037037037035,-200,170,0.6419753086419753,0.3580246913580247,away,OAK,over,8,0.5454545454545454,-120,0.5166307047184789,CWS,OAK,2022 REG,6,3,9,7,10,15,0,1,-4,4,1,1,1,0,0,0,0,0,0,0.5166307047184789,0.48336929528152106
87465,0.6666666666666666,0.37037037037037035,-200,170,0.6419753086419753,0.3580246913580247,home,CWS,under,8,0.5073891625615764,-103,0.48336929528152106,CWS,OAK,2022 REG,6,3,9,7,10,15,0,1,-4,4,1,1,1,0,0,0,0,0,0,0.5166307047184789,0.48336929528152106
87466,0.6551724137931035,0.3846153846153846,-190,160,0.6291045458703008,0.37089545412969915,away,KC,over,8.5,0.5098039215686274,-104,0.48483656587239576,MIN,KC,2022 REG,11,4,8,2,6,19,1,0,2,-2,1,1,0,0,0,0,0,0,0,0.48483656587239576,0.5151634341276042
87466,0.6551724137931035,0.3846153846153846,-190,160,0.6291045458703008,0.37089545412969915,home,MIN,under,8.5,0.5391705069124424,-117,0.5151634341276042,MIN,KC,2022 REG,11,4,8,2,6,19,1,0,2,-2,1,1,0,0,0,0,0,0,0,0.48483656587239576,0.5151634341276042
87467,0.4166666666666667,0.6226415094339623,140,-165,0.4002882599580712,0.5997117400419287,away,PHI,over,8,0.5412844036697247,-118,0.5175913212324037,CIN,PHI,2022 REG,6,1,5,0,1,11,1,0,1,-1,0,0,0,0,0,0,0,0,0,0.5175913212324037,0.4824086787675963
87467,0.4166666666666667,0.6226415094339623,140,-165,0.4002882599580712,0.5997117400419287,home,CIN,under,8,0.5024875621890548,-101,0.4824086787675963,CIN,PHI,2022 REG,6,1,5,0,1,11,1,0,1,-1,0,0,0,0,0,0,0,0,0,0.5175913212324037,0.4824086787675963
87468,0.5495495495495495,0.49504950495049505,-122,102,0.5250401592387142,0.47495984076128583,away,PHI,over,7.5,0.5024875621890548,-101,0.47839724939301687,HOU,PHI,2022 REG,2,0,9,3,3,11,0,1,-3,3,0,0,0,0,0,0,0,0,0,0.47839724939301687,0.5216027506069831
87468,0.5495495495495495,0.49504950495049505,-122,102,0.5250401592387142,0.47495984076128583,home,HOU,under,7.5,0.5454545454545454,-120,0.5216027506069831,HOU,PHI,2022 REG,2,0,9,3,3,11,0,1,-3,3,0,0,0,0,0,0,0,0,0,0.47839724939301687,0.5216027506069831
87469,0.4854368932038835,0.5555555555555556,106,-125,0.465537646233282,0.534462353766718,away,HOU,over,9,0.5121951219512195,-105,0.48808156828023186,TEX,HOU,2022 REG,8,3,5,4,7,13,0,1,-1,1,1,1,1,0,0,0,0,0,0,0.48808156828023186,0.5119184317197681
87469,0.4854368932038835,0.5555555555555556,106,-125,0.465537646233282,0.534462353766718,home,TEX,under,9,0.5348837209302326,-115,0.5119184317197681,TEX,HOU,2022 REG,8,3,5,4,7,13,0,1,-1,1,1,1,1,0,0,0,0,0,0,0.48808156828023186,0.5119184317197681
87470,0.607843137254902,0.4291845493562232,-155,133,0.5853361120599043,0.4146638879400957,away,NYM,over,9,0.5454545454545454,-120,0.5220180091279142,PHI,NYM,2022 REG,8,5,7,4,9,15,1,0,1,-1,1,1,1,1,0,0,0,0,0,0.5220180091279142,0.4779819908720858
87470,0.607843137254902,0.4291845493562232,-155,133,0.5853361120599043,0.4146638879400957,home,PHI,under,9,0.49751243781094534,101,0.4779819908720858,PHI,NYM,2022 REG,8,5,7,4,9,15,1,0,1,-1,1,1,1,1,0,0,0,0,0,0.5220180091279142,0.4779819908720858
87471,0.7142857142857143,0.3225806451612903,-250,210,0.6879526003949967,0.3120473996050033,away,PHI,over,8,0.5121951219512195,-105,0.48919479393107135,ATL,PHI,2022 REG,10,5,4,2,7,14,1,0,3,-3,1,1,0,0,0,0,0,0,0,0.48919479393107135,0.5108052060689287
87471,0.7142857142857143,0.3225806451612903,-250,210,0.6879526003949967,0.3120473996050033,home,ATL,under,8,0.5327102803738317,-114,0.5108052060689287,ATL,PHI,2022 REG,10,5,4,2,7,14,1,0,3,-3,1,1,0,0,0,0,0,0,0,0.48919479393107135,0.5108052060689287
87472,0.5412844036697247,0.49504950495049505,-118,102,0.5216174256092387,0.47838257439076126,away,PHI,over,7.5,0.5169082125603864,-107,0.49239402434819424,SEA,PHI,2022 REG,4,0,17,9,9,21,0,1,-9,9,0,0,0,0,0,0,0,0,0,0.49239402434819424,0.5076059756518058
87472,0.5412844036697247,0.49504950495049505,-118,102,0.5216174256092387,0.47838257439076126,home,SEA,under,7.5,0.5305164319248826,-113,0.5076059756518058,SEA,PHI,2022 REG,4,0,17,9,9,21,0,1,-9,9,0,0,0,0,0,0,0,0,0,0.49239402434819424,0.5076059756518058
87473,0.5238095238095238,0.5145631067961165,-110,-106,0.5037095744446646,0.4962904255553354,away,SF,over,9,0.5098039215686274,-104,0.48483656587239576,MIN,SF,2022 REG,11,8,10,3,11,21,1,0,5,-5,1,1,1,0,0,0,0,0,0,0.48483656587239576,0.5151634341276042
87473,0.5238095238095238,0.5145631067961165,-110,-106,0.5037095744446646,0.4962904255553354,home,MIN,under,9,0.5391705069124424,-117,0.5151634341276042,MIN,SF,2022 REG,11,8,10,3,11,21,1,0,5,-5,1,1,1,0,0,0,0,0,0,0.48483656587239576,0.5151634341276042
87474,0.5454545454545454,0.49019607843137253,-120,104,0.526008750607681,0.47399124939231896,away,MIL,over,8,0.5327102803738317,-114,0.508788710910954,PHI,MIL,2022 REG,10,4,5,2,6,15,1,0,2,-2,1,1,0,0,0,0,0,0,0,0.508788710910954,0.491211289089046
87474,0.5454545454545454,0.49019607843137253,-120,104,0.526008750607681,0.47399124939231896,home,PHI,under,8,0.5121951219512195,-105,0.491211289089046,PHI,MIL,2022 REG,10,4,5,2,6,15,1,0,2,-2,1,1,0,0,0,0,0,0,0,0.508788710910954,0.491211289089046
87475,0.47619047619047616,0.5652173913043479,110,-130,0.4564724440500838,0.5435275559499162,away,CLE,over,8,0.5121951219512195,-105,0.48808156828023186,TEX,CLE,2022 REG,7,2,6,4,6,13,0,1,-2,2,1,1,0,0,0,0,0,0,0,0.48808156828023186,0.5119184317197681
87475,0.47619047619047616,0.5652173913043479,110,-130,0.4564724440500838,0.5435275559499162,home,TEX,under,8,0.5348837209302326,-115,0.5119184317197681,TEX,CLE,2022 REG,7,2,6,4,6,13,0,1,-2,2,1,1,0,0,0,0,0,0,0,0.48808156828023186,0.5119184317197681
87476,0.4807692307692307,0.5633187772925764,108,-129,0.45957307304720807,0.5404269269527919,away,NYM,over,8.5,0.5121951219512195,-105,0.48808156828023186,ARI,NYM,2022 REG,8,5,9,6,11,17,0,1,-1,1,1,1,1,1,1,0,0,0,0,0.48808156828023186,0.5119184317197681
87476,0.4807692307692307,0.5633187772925764,108,-129,0.45957307304720807,0.5404269269527919,home,ARI,under,8.5,0.5348837209302326,-115,0.5119184317197681,ARI,NYM,2022 REG,8,5,9,6,11,17,0,1,-1,1,1,1,1,1,1,0,0,0,0,0.48808156828023186,0.5119184317197681
87477,0.6153846153846154,0.4166666666666667,-160,140,0.5956607495069033,0.4043392504930967,away,CHC,over,7,0.49504950495049505,102,0.47297076509898783,SD,CHC,2022 REG,3,0,11,6,6,14,0,1,-6,6,0,0,0,0,0,0,0,0,0,0.47297076509898783,0.5270292349010122
87477,0.6153846153846154,0.4166666666666667,-160,140,0.5956607495069033,0.4043392504930967,home,SD,under,7,0.5495495495495495,-122,0.5270292349010122,SD,CHC,2022 REG,3,0,11,6,6,14,0,1,-6,6,0,0,0,0,0,0,0,0,0,0.47297076509898783,0.5270292349010122
87478,0.4166666666666667,0.613899613899614,140,-159,0.4039307164307164,0.5960692835692836,away,NYM,over,6.5,0.5391705069124424,-117,0.5127649394825569,STL,NYM,2022 REG,5,2,9,5,7,14,0,1,-3,3,1,1,0,0,0,0,0,0,0,0.5127649394825569,0.48723506051744314
87478,0.4166666666666667,0.613899613899614,140,-159,0.4039307164307164,0.5960692835692836,home,STL,under,6.5,0.5098039215686274,-104,0.48723506051744314,STL,NYM,2022 REG,5,2,9,5,7,14,0,1,-3,3,1,1,0,0,0,0,0,0,0,0.5127649394825569,0.48723506051744314
87479,0.7014925373134329,0.3401360544217687,-235,194,0.6722903908723213,0.32770960912767866,away,ARI,over,8.5,0.5073891625615764,-103,0.4837652908580103,SD,ARI,2022 REG,4,0,7,5,5,11,0,1,-5,5,0,0,0,0,0,0,0,0,0,0.4837652908580103,0.5162347091419897
87479,0.7014925373134329,0.3401360544217687,-235,194,0.6722903908723213,0.32770960912767866,home,SD,under,8.5,0.5391705069124424,-117,0.5162347091419897,SD,ARI,2022 REG,4,0,7,5,5,11,0,1,-5,5,0,0,0,0,0,0,0,0,0,0.4837652908580103,0.5162347091419897
87480,0.4672897196261683,0.5689655172413793,114,-132,0.4503480201553517,0.5496519798446483,away,SF,over,8.5,0.5145631067961165,-106,0.4913668392989033,ARI,SF,2022 REG,8,5,6,7,12,14,0,1,-2,2,1,1,1,1,1,0,0,0,0,0.4913668392989033,0.5086331607010968
87480,0.4672897196261683,0.5689655172413793,114,-132,0.4503480201553517,0.5496519798446483,home,ARI,under,8.5,0.5305164319248826,-113,0.5086331607010968,ARI,SF,2022 REG,8,5,6,7,12,14,0,1,-2,2,1,1,1,1,1,0,0,0,0,0.4913668392989033,0.5086331607010968
87481,0.4166666666666667,0.6226415094339623,140,-165,0.4002882599580712,0.5997117400419287,away,LAA,over,7,0.5098039215686274,-104,0.48483656587239576,MIA,LAA,2022 REG,3,2,9,5,7,12,0,1,-3,3,1,1,0,0,0,0,0,0,0,0.48483656587239576,0.5151634341276042
87481,0.4166666666666667,0.6226415094339623,140,-165,0.4002882599580712,0.5997117400419287,home,MIA,under,7,0.5391705069124424,-117,0.5151634341276042,MIA,LAA,2022 REG,3,2,9,5,7,12,0,1,-3,3,1,1,0,0,0,0,0,0,0,0.48483656587239576,0.5151634341276042
87482,0.4444444444444444,0.5967741935483871,125,-148,0.42612504978096366,0.5738749502190363,away,HOU,over,8,0.5192307692307692,-108,0.49455035168025013,SEA,HOU,2022 REG,5,1,6,2,3,11,0,1,-1,1,1,0,0,0,0,0,0,0,0,0.49455035168025013,0.5054496483197499
87482,0.4444444444444444,0.5967741935483871,125,-148,0.42612504978096366,0.5738749502190363,home,SEA,under,8,0.5283018867924528,-112,0.5054496483197499,SEA,HOU,2022 REG,5,1,6,2,3,11,0,1,-1,1,1,0,0,0,0,0,0,0,0,0.49455035168025013,0.5054496483197499
87483,0.6254681647940076,0.4166666666666667,-167,140,0.5991141690863948,0.4008858309136052,away,CIN,over,10,0.5305164319248826,-113,0.5066009958897986,ATL,CIN,2022 REG,8,2,3,1,3,11,1,0,1,-1,1,0,0,0,0,0,0,0,0,0.5066009958897986,0.49339900411020143
87483,0.6254681647940076,0.4166666666666667,-167,140,0.5991141690863948,0.4008858309136052,home,ATL,under,10,0.5145631067961165,-106,0.49339900411020143,ATL,CIN,2022 REG,8,2,3,1,3,11,1,0,1,-1,1,0,0,0,0,0,0,0,0,0.5066009958897986,0.49339900411020143
87484,0.6875,0.35714285714285715,-220,180,0.6568080357142857,0.3431919642857143,away,CIN,over,7.5,0.5348837209302326,-115,0.5097020142727117,STL,CIN,2022 REG,5,1,3,0,1,8,1,0,1,-1,0,0,0,0,0,0,0,0,0,0.5097020142727117,0.49029798572728833
87484,0.6875,0.35714285714285715,-220,180,0.6568080357142857,0.3431919642857143,home,STL,under,7.5,0.5121951219512195,-105,0.49029798572728833,STL,CIN,2022 REG,5,1,3,0,1,8,1,0,1,-1,0,0,0,0,0,0,0,0,0,0.5097020142727117,0.49029798572728833
87485,0.6875,0.3508771929824561,-220,185,0.6611156798245614,0.33888432017543857,away,KC,over,8,0.5098039215686274,-104,0.4870219861770517,LAA,KC,2022 REG,8,5,2,0,5,10,1,0,5,-5,0,0,0,0,0,0,0,0,0,0.4870219861770517,0.5129780138229483
87485,0.6875,0.3508771929824561,-220,185,0.6611156798245614,0.33888432017543857,home,LAA,under,8,0.5348837209302326,-115,0.5129780138229483,LAA,KC,2022 REG,8,5,2,0,5,10,1,0,5,-5,0,0,0,0,0,0,0,0,0,0.4870219861770517,0.5129780138229483
87486,0.29411764705882354,0.7409326424870467,240,-286,0.2838087383688617,0.7161912616311383,away,LAD,over,8,0.5145631067961165,-106,0.4913668392989033,MIA,LAD,2022 REG,8,6,16,10,16,24,0,1,-4,4,1,1,1,1,1,1,0,0,0,0.4913668392989033,0.5086331607010968
87486,0.29411764705882354,0.7409326424870467,240,-286,0.2838087383688617,0.7161912616311383,home,MIA,under,8,0.5305164319248826,-113,0.5086331607010968,MIA,LAD,2022 REG,8,6,16,10,16,24,0,1,-4,4,1,1,1,1,1,1,0,0,0,0.4913668392989033,0.5086331607010968
87487,0.7101449275362319,0.3278688524590164,-245,205,0.6831496344961281,0.3168503655038719,away,WSH,over,8,0.5,100,0.47935779816513757,STL,WSH,2022 REG,8,4,7,1,5,15,1,0,3,-3,1,0,0,0,0,0,0,0,0,0.47935779816513757,0.5206422018348624
87487,0.7101449275362319,0.3278688524590164,-245,205,0.6831496344961281,0.3168503655038719,home,STL,under,8,0.5412844036697247,-118,0.5206422018348624,STL,WSH,2022 REG,8,4,7,1,5,15,1,0,3,-3,1,0,0,0,0,0,0,0,0,0.47935779816513757,0.5206422018348624
87488,0.7142857142857143,0.3225806451612903,-250,210,0.6879526003949967,0.3120473996050033,away,PIT,over,8.5,0.5391705069124424,-117,0.5140669063204599,LAD,PIT,2022 REG,12,4,9,8,12,21,0,1,-4,4,1,1,1,1,0,0,0,0,0,0.5140669063204599,0.4859330936795401
87488,0.7142857142857143,0.3225806451612903,-250,210,0.6879526003949967,0.3120473996050033,home,LAD,under,8.5,0.5073891625615764,-103,0.4859330936795401,LAD,PIT,2022 REG,12,4,9,8,12,21,0,1,-4,4,1,1,1,1,0,0,0,0,0,0.5140669063204599,0.4859330936795401
87489,0.4166666666666667,0.613899613899614,140,-159,0.4039307164307164,0.5960692835692836,away,CWS,over,7.5,0.5238095238095238,-110,0.5012646084074657,OAK,CWS,2022 REG,14,10,4,3,13,18,1,0,7,-7,1,1,1,0,0,0,0,0,0,0.5012646084074657,0.4987353915925343
87489,0.4166666666666667,0.613899613899614,140,-159,0.4039307164307164,0.5960692835692836,home,OAK,under,7.5,0.5192307692307692,-108,0.4987353915925343,OAK,CWS,2022 REG,14,10,4,3,13,18,1,0,7,-7,1,1,1,0,0,0,0,0,0,0.5012646084074657,0.4987353915925343
87490,0.6000000000000001,0.4347826086956522,-150,130,0.5791304347826086,0.4208695652173914,away,NYM,over,8.5,0.5238095238095238,-110,0.5012646084074657,PHI,NYM,2022 REG,7,2,10,8,10,17,0,1,-6,6,1,1,0,0,0,0,0,0,0,0.5012646084074657,0.4987353915925343
87490,0.6000000000000001,0.4347826086956522,-150,130,0.5791304347826086,0.4208695652173914,home,PHI,under,8.5,0.5192307692307692,-108,0.4987353915925343,PHI,NYM,2022 REG,7,2,10,8,10,17,0,1,-6,6,1,1,0,0,0,0,0,0,0,0.5012646084074657,0.4987353915925343
87491,0.37878787878787884,0.6621621621621622,164,-196,0.36327649964013603,0.6367235003598639,away,LAD,over,8,0.5327102803738317,-114,0.508788710910954,ARI,LAD,2022 REG,2,3,5,1,4,7,1,0,2,-2,1,0,0,0,0,0,0,0,0,0.508788710910954,0.491211289089046
87491,0.37878787878787884,0.6621621621621622,164,-196,0.36327649964013603,0.6367235003598639,home,ARI,under,8,0.5121951219512195,-105,0.491211289089046,ARI,LAD,2022 REG,2,3,5,1,4,7,1,0,2,-2,1,0,0,0,0,0,0,0,0,0.508788710910954,0.491211289089046
87492,0.4,0.6363636363636364,150,-175,0.3854545454545455,0.6145454545454545,away,SF,over,8,0.5412844036697247,-118,0.5149381613977361,ARI,SF,2022 REG,11,5,10,6,11,21,0,1,-1,1,1,1,1,1,1,0,0,0,0,0.5149381613977361,0.48506183860226393
87492,0.4,0.6363636363636364,150,-175,0.3854545454545455,0.6145454545454545,home,ARI,under,8,0.5073891625615764,-103,0.48506183860226393,ARI,SF,2022 REG,11,5,10,6,11,21,0,1,-1,1,1,1,1,1,1,0,0,0,0,0.5149381613977361,0.48506183860226393
87493,0.3921568627450981,0.6453900709219857,155,-182,0.37743257503251615,0.6225674249674839,away,NYY,over,9,0.5495495495495495,-122,0.5250401592387142,BAL,NYY,2022 REG,8,0,13,6,6,21,0,1,-6,6,0,0,0,0,0,0,0,0,0,0.5250401592387142,0.47495984076128583
87493,0.3921568627450981,0.6453900709219857,155,-182,0.37743257503251615,0.6225674249674839,home,BAL,under,9,0.49504950495049505,102,0.47495984076128583,BAL,NYY,2022 REG,8,0,13,6,6,21,0,1,-6,6,0,0,0,0,0,0,0,0,0,0.5250401592387142,0.47495984076128583
87494,0.5348837209302326,0.5121951219512195,-115,-105,0.5097020142727117,0.49029798572728833,away,ATL,over,7,0.5238095238095238,-110,0.4988662131519274,NYM,ATL,2022 REG,9,3,7,0,3,16,1,0,3,-3,0,0,0,0,0,0,0,0,0,0.4988662131519274,0.5011337868480725
87494,0.5348837209302326,0.5121951219512195,-115,-105,0.5097020142727117,0.49029798572728833,home,NYM,under,7,0.5238095238095238,-110,0.5011337868480725,NYM,ATL,2022 REG,9,3,7,0,3,16,1,0,3,-3,0,0,0,0,0,0,0,0,0,0.4988662131519274,0.5011337868480725
87495,0.5689655172413793,0.4716981132075471,-132,112,0.5458293137100936,0.4541706862899064,away,SF,over,7.5,0.5121951219512195,-105,0.48919479393107135,NYM,SF,2022 REG,12,6,4,2,8,16,1,0,4,-4,1,1,0,0,0,0,0,0,0,0.48919479393107135,0.5108052060689287
87495,0.5689655172413793,0.4716981132075471,-132,112,0.5458293137100936,0.4541706862899064,home,NYM,under,7.5,0.5327102803738317,-114,0.5108052060689287,NYM,SF,2022 REG,12,6,4,2,8,16,1,0,4,-4,1,1,0,0,0,0,0,0,0,0.48919479393107135,0.5108052060689287
87496,0.6226415094339623,0.4166666666666667,-165,140,0.5981666073335706,0.40183339266642937,away,KC,over,11,0.49504950495049505,102,0.4739797934813417,COL,KC,2022 REG,10,10,5,4,14,15,1,0,6,-6,1,1,1,1,0,0,0,0,0,0.4739797934813417,0.5260202065186583
87496,0.6226415094339623,0.4166666666666667,-165,140,0.5981666073335706,0.40183339266642937,home,COL,under,11,0.5475113122171946,-121,0.5260202065186583,COL,KC,2022 REG,10,10,5,4,14,15,1,0,6,-6,1,1,1,1,0,0,0,0,0,0.4739797934813417,0.5260202065186583
87497,0.4,0.6363636363636364,150,-175,0.3854545454545455,0.6145454545454545,away,TOR,over,8.5,0.5121951219512195,-105,0.48808156828023186,BAL,TOR,2022 REG,8,3,14,7,10,22,0,1,-4,4,1,1,1,0,0,0,0,0,0,0.48808156828023186,0.5119184317197681
87497,0.4,0.6363636363636364,150,-175,0.3854545454545455,0.6145454545454545,home,BAL,under,8.5,0.5348837209302326,-115,0.5119184317197681,BAL,TOR,2022 REG,8,3,14,7,10,22,0,1,-4,4,1,1,1,0,0,0,0,0,0,0.48808156828023186,0.5119184317197681
87498,0.726027397260274,0.3125,-265,220,0.6980554513041847,0.30194454869581533,away,CIN,over,7,0.5454545454545454,-120,0.5206611570247933,MIL,CIN,2022 REG,6,6,6,3,9,12,1,0,3,-3,1,1,1,0,0,0,0,0,0,0.5206611570247933,0.4793388429752067
87498,0.726027397260274,0.3125,-265,220,0.6980554513041847,0.30194454869581533,home,MIL,under,7,0.5,100,0.4793388429752067,MIL,CIN,2022 REG,6,6,6,3,9,12,1,0,3,-3,1,1,1,0,0,0,0,0,0,0.5206611570247933,0.4793388429752067
87499,0.6031746031746031,0.4347826086956522,-152,130,0.5802797769671475,0.4197202230328525,away,OAK,over,9.5,0.5,100,0.4772727272727273,KC,OAK,2022 REG,8,3,6,1,4,14,1,0,2,-2,1,0,0,0,0,0,0,0,0,0.4772727272727273,0.5227272727272727
87499,0.6031746031746031,0.4347826086956522,-152,130,0.5802797769671475,0.4197202230328525,home,KC,under,9.5,0.5454545454545454,-120,0.5227272727272727,KC,OAK,2022 REG,8,3,6,1,4,14,1,0,2,-2,1,0,0,0,0,0,0,0,0,0.4772727272727273,0.5227272727272727
87500,0.4081632653061224,0.6296296296296295,145,-170,0.39273759390377466,0.6072624060962253,away,STL,over,8,0.5238095238095238,-110,0.4988662131519274,CHC,STL,2022 REG,1,0,4,1,1,5,0,1,-1,1,0,0,0,0,0,0,0,0,0,0.4988662131519274,0.5011337868480725
87500,0.4081632653061224,0.6296296296296295,145,-170,0.39273759390377466,0.6072624060962253,home,CHC,under,8,0.5238095238095238,-110,0.5011337868480725,CHC,STL,2022 REG,1,0,4,1,1,5,0,1,-1,1,0,0,0,0,0,0,0,0,0,0.4988662131519274,0.5011337868480725
87501,0.5412844036697247,0.5,-118,100,0.5189377998484975,0.4810622001515025,away,ARI,over,7.5,0.5433789954337899,-119,0.5198077604720502,PIT,ARI,2022 REG,10,6,10,8,14,20,0,1,-2,2,1,1,1,1,1,1,0,0,0,0.5198077604720502,0.48019223952794976
87501,0.5412844036697247,0.5,-118,100,0.5189377998484975,0.4810622001515025,home,PIT,under,7.5,0.5,100,0.48019223952794976,PIT,ARI,2022 REG,10,6,10,8,14,20,0,1,-2,2,1,1,1,1,1,1,0,0,0,0.5198077604720502,0.48019223952794976
87502,0.3846153846153846,0.6527777777777778,160,-188,0.37023339907955294,0.629766600920447,away,STL,over,7.5,0.5215311004784688,-109,0.49907282342437215,PIT,STL,2022 REG,10,5,11,7,12,21,0,1,-2,2,1,1,1,1,1,0,0,0,0,0.49907282342437215,0.5009271765756278
87502,0.3846153846153846,0.6527777777777778,160,-188,0.37023339907955294,0.629766600920447,home,PIT,under,7.5,0.5215311004784688,-109,0.5009271765756278,PIT,STL,2022 REG,10,5,11,7,12,21,0,1,-2,2,1,1,1,1,1,0,0,0,0,0.49907282342437215,0.5009271765756278
87503,0.4807692307692307,0.5555555555555556,108,-125,0.4633053911900066,0.5366946088099934,away,CHC,over,8,0.5412844036697247,-118,0.5189377998484975,PIT,CHC,2022 REG,8,6,6,2,8,14,1,0,4,-4,1,1,0,0,0,0,0,0,0,0.5189377998484975,0.4810622001515025
87503,0.4807692307692307,0.5555555555555556,108,-125,0.4633053911900066,0.5366946088099934,home,PIT,under,8,0.5,100,0.4810622001515025,PIT,CHC,2022 REG,8,6,6,2,8,14,1,0,4,-4,1,1,0,0,0,0,0,0,0,0.5189377998484975,0.4810622001515025
87504,0.7142857142857143,0.31746031746031744,-250,215,0.6916099773242631,0.3083900226757369,away,COL,over,8.5,0.5238095238095238,-110,0.5000596729920038,NYM,COL,2022 REG,7,3,5,0,3,12,1,0,3,-3,0,0,0,0,0,0,0,0,0,0.5000596729920038,0.4999403270079962
87504,0.7142857142857143,0.31746031746031744,-250,215,0.6916099773242631,0.3083900226757369,home,NYM,under,8.5,0.5215311004784688,-109,0.4999403270079962,NYM,COL,2022 REG,7,3,5,0,3,12,1,0,3,-3,0,0,0,0,0,0,0,0,0,0.5000596729920038,0.4999403270079962
87505,0.5967741935483871,0.4587155963302753,-148,118,0.563659318943379,0.43634068105662105,away,ARI,over,7.5,0.5454545454545454,-120,0.5140092723241282,CLE,ARI,2022 REG,6,3,9,6,9,15,0,1,-3,3,1,1,1,0,0,0,0,0,0,0.5140092723241282,0.4859907276758718
87505,0.5967741935483871,0.4587155963302753,-148,118,0.563659318943379,0.43634068105662105,home,CLE,under,7.5,0.5121951219512195,-105,0.4859907276758718,CLE,ARI,2022 REG,6,3,9,6,9,15,0,1,-3,3,1,1,1,0,0,0,0,0,0,0.5140092723241282,0.4859907276758718
87506,0.5555555555555556,0.4807692307692307,-125,108,0.5353751187084521,0.4646248812915479,away,TOR,over,8,0.5073891625615764,-103,0.4837652908580103,SEA,TOR,2022 REG,7,6,10,5,11,17,1,0,1,-1,1,1,1,1,1,0,0,0,0,0.4837652908580103,0.5162347091419897
87506,0.5555555555555556,0.4807692307692307,-125,108,0.5353751187084521,0.4646248812915479,home,SEA,under,8,0.5391705069124424,-117,0.5162347091419897,SEA,TOR,2022 REG,7,6,10,5,11,17,1,0,1,-1,1,1,1,1,1,0,0,0,0,0.4837652908580103,0.5162347091419897
87507,0.5,0.5454545454545454,100,-120,0.4772727272727273,0.5227272727272727,away,STL,over,8.5,0.5260663507109005,-111,0.5022370601254724,MIL,STL,2022 REG,6,2,9,6,8,15,0,1,-4,4,1,1,0,0,0,0,0,0,0,0.5022370601254724,0.4977629398745276
87507,0.5,0.5454545454545454,100,-120,0.4772727272727273,0.5227272727272727,home,MIL,under,8.5,0.5192307692307692,-108,0.4977629398745276,MIL,STL,2022 REG,6,2,9,6,8,15,0,1,-4,4,1,1,0,0,0,0,0,0,0,0.5022370601254724,0.4977629398745276
87508,0.5192307692307692,0.5169082125603864,-108,-107,0.5004662979161306,0.4995337020838694,away,TEX,over,7.5,0.5,100,0.4772727272727273,OAK,TEX,2022 REG,9,5,7,4,9,16,1,0,1,-1,1,1,1,1,0,0,0,0,0,0.4772727272727273,0.5227272727272727
87508,0.5192307692307692,0.5169082125603864,-108,-107,0.5004662979161306,0.4995337020838694,home,OAK,under,7.5,0.5454545454545454,-120,0.5227272727272727,OAK,TEX,2022 REG,9,5,7,4,9,16,1,0,1,-1,1,1,1,1,0,0,0,0,0,0.4772727272727273,0.5227272727272727
87509,0.5633187772925764,0.47619047619047616,-129,110,0.5410624729287608,0.45893752707123925,away,MIA,over,6.5,0.5327102803738317,-114,0.5075272610403079,SD,MIA,2022 REG,5,0,10,8,8,15,0,1,-8,8,0,0,0,0,0,0,0,0,0,0.5075272610403079,0.4924727389596921
87509,0.5633187772925764,0.47619047619047616,-129,110,0.5410624729287608,0.45893752707123925,home,SD,under,6.5,0.5145631067961165,-106,0.4924727389596921,SD,MIA,2022 REG,5,0,10,8,8,15,0,1,-8,8,0,0,0,0,0,0,0,0,0,0.5075272610403079,0.4924727389596921
87510,0.7674418604651163,0.27027027027027023,-330,270,0.7384999926914476,0.2615000073085524,away,MIA,over,7.5,0.5238095238095238,-110,0.4988662131519274,LAD,MIA,2022 REG,12,7,3,0,7,15,1,0,7,-7,0,0,0,0,0,0,0,0,0,0.4988662131519274,0.5011337868480725
87510,0.7674418604651163,0.27027027027027023,-330,270,0.7384999926914476,0.2615000073085524,home,LAD,under,7.5,0.5238095238095238,-110,0.5011337868480725,LAD,MIA,2022 REG,12,7,3,0,7,15,1,0,7,-7,0,0,0,0,0,0,0,0,0,0.4988662131519274,0.5011337868480725
87511,0.5215311004784688,0.5169082125603864,-109,-107,0.5014838032476784,0.4985161967523216,away,STL,over,8.5,0.5238095238095238,-110,0.4988662131519274,CIN,STL,2022 REG,3,0,10,5,5,13,0,1,-5,5,0,0,0,0,0,0,0,0,0,0.4988662131519274,0.5011337868480725
87511,0.5215311004784688,0.5169082125603864,-109,-107,0.5014838032476784,0.4985161967523216,home,CIN,under,8.5,0.5238095238095238,-110,0.5011337868480725,CIN,STL,2022 REG,3,0,10,5,5,13,0,1,-5,5,0,0,0,0,0,0,0,0,0,0.4988662131519274,0.5011337868480725
87512,0.5884773662551441,0.4504504504504505,-143,122,0.5655692272061728,0.43443077279382725,away,PHI,over,8,0.5024875621890548,-101,0.48049269377245407,SD,PHI,2022 REG,5,5,13,8,13,18,0,1,-3,3,1,1,1,1,1,0,0,0,0,0.48049269377245407,0.5195073062275459
87512,0.5884773662551441,0.4504504504504505,-143,122,0.5655692272061728,0.43443077279382725,home,SD,under,8,0.5412844036697247,-118,0.5195073062275459,SD,PHI,2022 REG,5,5,13,8,13,18,0,1,-3,3,1,1,1,1,1,0,0,0,0,0.48049269377245407,0.5195073062275459
87513,0.5850622406639003,0.4484304932735426,-141,123,0.5654669067005001,0.43453309329949985,away,PHI,over,8.5,0.5283018867924528,-112,0.5056562298022652,LAD,PHI,2022 REG,7,5,8,4,9,15,1,0,1,-1,1,1,1,1,0,0,0,0,0,0.5056562298022652,0.4943437701977348
87513,0.5850622406639003,0.4484304932735426,-141,123,0.5654669067005001,0.43453309329949985,home,LAD,under,8.5,0.5145631067961165,-106,0.4943437701977348,LAD,PHI,2022 REG,7,5,8,4,9,15,1,0,1,-1,1,1,1,1,0,0,0,0,0,0.5056562298022652,0.4943437701977348
87514,0.647887323943662,0.3921568627450981,-184,155,0.6219432029903809,0.37805679700961914,away,BOS,over,7,0.5238095238095238,-110,0.5000596729920038,TB,BOS,2022 REG,4,1,6,0,1,10,1,0,1,-1,0,0,0,0,0,0,0,0,0,0.5000596729920038,0.4999403270079962
87514,0.647887323943662,0.3921568627450981,-184,155,0.6219432029903809,0.37805679700961914,home,TB,under,7,0.5215311004784688,-109,0.4999403270079962,TB,BOS,2022 REG,4,1,6,0,1,10,1,0,1,-1,0,0,0,0,0,0,0,0,0,0.5000596729920038,0.4999403270079962
87515,0.6875,0.3508771929824561,-220,185,0.6611156798245614,0.33888432017543857,away,LAA,over,8.5,0.5,100,0.47935779816513757,HOU,LAA,2022 REG,6,4,5,3,7,11,1,0,1,-1,1,1,1,0,0,0,0,0,0,0.47935779816513757,0.5206422018348624
87515,0.6875,0.3508771929824561,-220,185,0.6611156798245614,0.33888432017543857,home,HOU,under,8.5,0.5412844036697247,-118,0.5206422018348624,HOU,LAA,2022 REG,6,4,5,3,7,11,1,0,1,-1,1,1,1,0,0,0,0,0,0,0.47935779816513757,0.5206422018348624
87516,0.48780487804878053,0.5555555555555556,105,-125,0.4666534470222751,0.5333465529777248,away,HOU,over,8,0.5192307692307692,-108,0.49688292476754015,SEA,HOU,2022 REG,10,7,4,2,9,14,1,0,5,-5,1,1,0,0,0,0,0,0,0,0.49688292476754015,0.5031170752324599
87516,0.48780487804878053,0.5555555555555556,105,-125,0.4666534470222751,0.5333465529777248,home,SEA,under,8,0.5238095238095238,-110,0.5031170752324599,SEA,HOU,2022 REG,10,7,4,2,9,14,1,0,5,-5,1,1,0,0,0,0,0,0,0,0.49688292476754015,0.5031170752324599
87517,0.3921568627450981,0.6503496503496503,155,-186,0.3754876419236281,0.6245123580763718,away,NYY,over,8,0.5169082125603864,-107,0.49353874091423283,MIL,NYY,2022 REG,12,8,16,12,20,28,0,1,-4,4,1,1,1,1,1,1,1,1,0,0.49353874091423283,0.5064612590857671
87517,0.3921568627450981,0.6503496503496503,155,-186,0.3754876419236281,0.6245123580763718,home,MIL,under,8,0.5283018867924528,-112,0.5064612590857671,MIL,NYY,2022 REG,12,8,16,12,20,28,0,1,-4,4,1,1,1,1,1,1,1,1,0,0.49353874091423283,0.5064612590857671
87518,0.7590361445783133,0.27027027027027023,-315,270,0.7367915164402318,0.2632084835597682,away,OAK,over,8,0.5215311004784688,-109,0.49907282342437215,HOU,OAK,2022 REG,9,5,3,2,7,12,1,0,3,-3,1,1,0,0,0,0,0,0,0,0.49907282342437215,0.5009271765756278
87518,0.7590361445783133,0.27027027027027023,-315,270,0.7367915164402318,0.2632084835597682,home,HOU,under,8,0.5215311004784688,-109,0.5009271765756278,HOU,OAK,2022 REG,9,5,3,2,7,12,1,0,3,-3,1,1,0,0,0,0,0,0,0,0.49907282342437215,0.5009271765756278
87519,0.5495495495495495,0.48780487804878053,-122,105,0.529021440689206,0.470978559310794,away,LAD,over,8,0.5370370370370371,-116,0.514488177212783,MIL,LAD,2022 REG,5,5,8,4,9,13,1,0,1,-1,1,1,1,1,0,0,0,0,0,0.514488177212783,0.48551182278721705
87519,0.5495495495495495,0.48780487804878053,-122,105,0.529021440689206,0.470978559310794,home,MIL,under,8,0.504950495049505,-102,0.48551182278721705,MIL,LAD,2022 REG,5,5,8,4,9,13,1,0,1,-1,1,1,1,1,0,0,0,0,0,0.514488177212783,0.48551182278721705
87520,0.36363636363636365,0.6774193548387096,175,-210,0.3487070114636097,0.6512929885363903,away,SF,over,8,0.5098039215686274,-104,0.48592421718142587,CIN,SF,2022 REG,9,5,6,1,6,15,1,0,4,-4,1,0,0,0,0,0,0,0,0,0.48592421718142587,0.5140757828185741
87520,0.36363636363636365,0.6774193548387096,175,-210,0.3487070114636097,0.6512929885363903,home,CIN,under,8,0.5370370370370371,-116,0.5140757828185741,CIN,SF,2022 REG,9,5,6,1,6,15,1,0,4,-4,1,0,0,0,0,0,0,0,0,0.48592421718142587,0.5140757828185741
87521,0.5454545454545454,0.49504950495049505,-120,102,0.5233614270517961,0.4766385729482039,away,MIN,over,8.5,0.5121951219512195,-105,0.48919479393107135,CWS,MIN,2022 REG,14,9,14,8,17,28,1,0,1,-1,1,1,1,1,1,1,1,1,0,0.48919479393107135,0.5108052060689287
87521,0.5454545454545454,0.49504950495049505,-120,102,0.5233614270517961,0.4766385729482039,home,CWS,under,8.5,0.5327102803738317,-114,0.5108052060689287,CWS,MIN,2022 REG,14,9,14,8,17,28,1,0,1,-1,1,1,1,1,1,1,1,1,0,0.48919479393107135,0.5108052060689287
87522,0.5238095238095238,0.5121951219512195,-110,-105,0.5049499474586583,0.4950500525413417,away,CLE,over,7.5,0.5283018867924528,-112,0.5031902949311281,MIN,CLE,2022 REG,14,6,15,7,13,29,0,1,-1,1,1,1,1,1,1,1,0,0,0,0.5031902949311281,0.4968097050688719
87522,0.5238095238095238,0.5121951219512195,-110,-105,0.5049499474586583,0.4950500525413417,home,MIN,under,7.5,0.5192307692307692,-108,0.4968097050688719,MIN,CLE,2022 REG,14,6,15,7,13,29,0,1,-1,1,1,1,1,1,1,1,0,0,0,0.5031902949311281,0.4968097050688719
87523,0.4,0.6428571428571428,150,-180,0.38285714285714295,0.617142857142857,away,MIL,over,8.5,0.5260663507109005,-111,0.5022370601254724,WSH,MIL,2022 REG,19,11,7,5,16,26,1,0,6,-6,1,1,1,1,1,0,0,0,0,0.5022370601254724,0.4977629398745276
87523,0.4,0.6428571428571428,150,-180,0.38285714285714295,0.617142857142857,home,WSH,under,8.5,0.5192307692307692,-108,0.4977629398745276,WSH,MIL,2022 REG,19,11,7,5,16,26,1,0,6,-6,1,1,1,1,1,0,0,0,0,0.5022370601254724,0.4977629398745276
87524,0.3846153846153846,0.6551724137931035,160,-190,0.3693123852275045,0.6306876147724956,away,STL,over,9,0.5073891625615764,-103,0.4837652908580103,ARI,STL,2022 REG,4,1,12,5,6,16,0,1,-4,4,1,0,0,0,0,0,0,0,0,0.4837652908580103,0.5162347091419897
87524,0.3846153846153846,0.6551724137931035,160,-190,0.3693123852275045,0.6306876147724956,home,ARI,under,9,0.5391705069124424,-117,0.5162347091419897,ARI,STL,2022 REG,4,1,12,5,6,16,0,1,-4,4,1,0,0,0,0,0,0,0,0,0.4837652908580103,0.5162347091419897
87525,0.5391705069124424,0.5,-117,100,0.5180509248444435,0.4819490751555565,away,MIN,over,10,0.5348837209302326,-115,0.5097020142727117,BOS,MIN,2022 REG,8,4,9,8,12,17,0,1,-4,4,1,1,1,1,0,0,0,0,0,0.5097020142727117,0.49029798572728833
87525,0.5391705069124424,0.5,-117,100,0.5180509248444435,0.4819490751555565,home,BOS,under,10,0.5121951219512195,-105,0.49029798572728833,BOS,MIN,2022 REG,8,4,9,8,12,17,0,1,-4,4,1,1,1,1,0,0,0,0,0,0.5097020142727117,0.49029798572728833
87526,0.5348837209302326,0.5073891625615764,-115,-103,0.5122726437136835,0.48772735628631647,away,PHI,over,7.5,0.5305164319248826,-113,0.5053568787472517,MIA,PHI,2022 REG,6,4,11,3,7,17,1,0,1,-1,1,1,1,0,0,0,0,0,0,0.5053568787472517,0.49464312125274834
87526,0.5348837209302326,0.5073891625615764,-115,-103,0.5122726437136835,0.48772735628631647,home,MIA,under,7.5,0.5169082125603864,-107,0.49464312125274834,MIA,PHI,2022 REG,6,4,11,3,7,17,1,0,1,-1,1,1,1,0,0,0,0,0,0,0.5053568787472517,0.49464312125274834
87527,0.6453900709219857,0.3968253968253968,-182,152,0.6181446271984977,0.3818553728015023,away,PIT,over,8.5,0.5238095238095238,-110,0.5012646084074657,STL,PIT,2022 REG,10,6,9,2,8,19,1,0,4,-4,1,1,0,0,0,0,0,0,0,0.5012646084074657,0.4987353915925343
87527,0.6453900709219857,0.3968253968253968,-182,152,0.6181446271984977,0.3818553728015023,home,STL,under,8.5,0.5192307692307692,-108,0.4987353915925343,STL,PIT,2022 REG,10,6,9,2,8,19,1,0,4,-4,1,1,0,0,0,0,0,0,0,0.5012646084074657,0.4987353915925343
87528,0.5967741935483871,0.4424778761061947,-148,126,0.5733495713351688,0.42665042866483116,away,DET,over,7.5,0.5192307692307692,-108,0.49571111079951763,SEA,DET,2022 REG,9,5,8,4,9,17,1,0,1,-1,1,1,1,1,0,0,0,0,0,0.49571111079951763,0.5042888892004824
87528,0.5967741935483871,0.4424778761061947,-148,126,0.5733495713351688,0.42665042866483116,home,SEA,under,7.5,0.5260663507109005,-111,0.5042888892004824,SEA,DET,2022 REG,9,5,8,4,9,17,1,0,1,-1,1,1,1,1,0,0,0,0,0,0.49571111079951763,0.5042888892004824
87529,0.6610169491525424,0.37878787878787884,-195,164,0.6347052832258232,0.3652947167741768,away,MIA,over,6.5,0.5515695067264574,-123,0.5258558814517258,NYM,MIA,2022 REG,7,5,7,4,9,14,1,0,1,-1,1,1,1,1,0,0,0,0,0,0.5258558814517258,0.4741441185482742
87529,0.6610169491525424,0.37878787878787884,-195,164,0.6347052832258232,0.3652947167741768,home,NYM,under,6.5,0.49504950495049505,102,0.4741441185482742,NYM,MIA,2022 REG,7,5,7,4,9,14,1,0,1,-1,1,1,1,1,0,0,0,0,0,0.5258558814517258,0.4741441185482742
87530,0.425531914893617,0.613899613899614,135,-159,0.40875254093905067,0.5912474590609493,away,SEA,over,7.5,0.5238095238095238,-110,0.4988662131519274,TEX,SEA,2022 REG,6,3,10,8,11,16,0,1,-5,5,1,1,1,0,0,0,0,0,0,0.4988662131519274,0.5011337868480725
87530,0.425531914893617,0.613899613899614,135,-159,0.40875254093905067,0.5912474590609493,home,TEX,under,7.5,0.5238095238095238,-110,0.5011337868480725,TEX,SEA,2022 REG,6,3,10,8,11,16,0,1,-5,5,1,1,1,0,0,0,0,0,0,0.4988662131519274,0.5011337868480725
87531,0.6254681647940076,0.4081632653061224,-167,145,0.6044327759298813,0.3955672240701187,away,PIT,over,7.5,0.5073891625615764,-103,0.4826927225525911,ARI,PIT,2022 REG,9,9,5,3,12,14,1,0,6,-6,1,1,1,0,0,0,0,0,0,0.4826927225525911,0.5173072774474089
87531,0.6254681647940076,0.4081632653061224,-167,145,0.6044327759298813,0.3955672240701187,home,ARI,under,7.5,0.5412844036697247,-118,0.5173072774474089,ARI,PIT,2022 REG,9,9,5,3,12,14,1,0,6,-6,1,1,1,0,0,0,0,0,0,0.4826927225525911,0.5173072774474089
87532,0.696969696969697,0.3389830508474576,-230,195,0.6719117212183469,0.32808827878165314,away,MIA,over,7,0.49019607843137253,104,0.4707129274603323,PHI,MIA,2022 REG,6,3,6,2,5,12,1,0,1,-1,1,1,0,0,0,0,0,0,0,0.4707129274603323,0.5292870725396677
87532,0.696969696969697,0.3389830508474576,-230,195,0.6719117212183469,0.32808827878165314,home,PHI,under,7,0.5495495495495495,-122,0.5292870725396677,PHI,MIA,2022 REG,6,3,6,2,5,12,1,0,1,-1,1,1,0,0,0,0,0,0,0,0.4707129274603323,0.5292870725396677
87533,0.5652173913043479,0.47619047619047616,-130,110,0.5418129444594474,0.4581870555405526,away,MIL,over,8,0.504950495049505,-102,0.4826715732667395,SF,MIL,2022 REG,4,2,5,1,3,9,1,0,1,-1,1,0,0,0,0,0,0,0,0,0.4826715732667395,0.5173284267332605
87533,0.5652173913043479,0.47619047619047616,-130,110,0.5418129444594474,0.4581870555405526,home,SF,under,8,0.5391705069124424,-117,0.5173284267332605,SF,MIL,2022 REG,4,2,5,1,3,9,1,0,1,-1,1,0,0,0,0,0,0,0,0,0.4826715732667395,0.5173284267332605
87534,0.46511627906976744,0.576271186440678,115,-136,0.44586629511142073,0.5541337048885793,away,MIL,over,7,0.5238095238095238,-110,0.4988662131519274,STL,MIL,2022 REG,4,0,13,8,8,17,0,1,-8,8,0,0,0,0,0,0,0,0,0,0.4988662131519274,0.5011337868480725
87534,0.46511627906976744,0.576271186440678,115,-136,0.44586629511142073,0.5541337048885793,home,STL,under,7,0.5238095238095238,-110,0.5011337868480725,STL,MIL,2022 REG,4,0,13,8,8,17,0,1,-8,8,0,0,0,0,0,0,0,0,0,0.4988662131519274,0.5011337868480725
87535,0.5652173913043479,0.47619047619047616,-130,110,0.5418129444594474,0.4581870555405526,away,BAL,over,9,0.5,100,0.4772727272727273,CIN,BAL,2022 REG,7,3,6,2,5,13,1,0,1,-1,1,1,0,0,0,0,0,0,0,0.4772727272727273,0.5227272727272727
87535,0.5652173913043479,0.47619047619047616,-130,110,0.5418129444594474,0.4581870555405526,home,CIN,under,9,0.5454545454545454,-120,0.5227272727272727,CIN,BAL,2022 REG,7,3,6,2,5,13,1,0,1,-1,1,1,0,0,0,0,0,0,0,0.4772727272727273,0.5227272727272727
87536,0.5348837209302326,0.5121951219512195,-115,-105,0.5097020142727117,0.49029798572728833,away,DET,over,6.5,0.5169082125603864,-107,0.49353874091423283,OAK,DET,2022 REG,4,0,12,6,6,16,0,1,-6,6,0,0,0,0,0,0,0,0,0,0.49353874091423283,0.5064612590857671
87536,0.5348837209302326,0.5121951219512195,-115,-105,0.5097020142727117,0.49029798572728833,home,OAK,under,6.5,0.5283018867924528,-112,0.5064612590857671,OAK,DET,2022 REG,4,0,12,6,6,16,0,1,-6,6,0,0,0,0,0,0,0,0,0,0.49353874091423283,0.5064612590857671
87537,0.5121951219512195,0.5283018867924528,-105,-112,0.49145275161909474,0.5085472483809053,away,SF,over,6.5,0.5238095238095238,-110,0.4988662131519274,NYM,SF,2022 REG,9,2,8,5,7,17,0,1,-3,3,1,1,0,0,0,0,0,0,0,0.4988662131519274,0.5011337868480725
87537,0.5121951219512195,0.5283018867924528,-105,-112,0.49145275161909474,0.5085472483809053,home,NYM,under,6.5,0.5238095238095238,-110,0.5011337868480725,NYM,SF,2022 REG,9,2,8,5,7,17,0,1,-3,3,1,1,0,0,0,0,0,0,0,0.4988662131519274,0.5011337868480725
87538,0.6108949416342413,0.425531914893617,-157,135,0.5886419592417365,0.41135804075826354,away,TOR,over,7.5,0.5260663507109005,-111,0.5010269332605688,LAA,TOR,2022 REG,10,3,7,6,9,17,0,1,-3,3,1,1,1,0,0,0,0,0,0,0.5010269332605688,0.4989730667394312
87538,0.6108949416342413,0.425531914893617,-157,135,0.5886419592417365,0.41135804075826354,home,LAA,under,7.5,0.5215311004784688,-109,0.4989730667394312,LAA,TOR,2022 REG,10,3,7,6,9,17,0,1,-3,3,1,1,1,0,0,0,0,0,0,0.5010269332605688,0.4989730667394312
87539,0.3846153846153846,0.6491228070175439,160,-185,0.37163915706425826,0.6283608429357417,away,ATL,over,6.5,0.5495495495495495,-122,0.5250401592387142,SF,ATL,2022 REG,10,3,10,2,5,20,1,0,1,-1,1,1,0,0,0,0,0,0,0,0.5250401592387142,0.47495984076128583
87539,0.3846153846153846,0.6491228070175439,160,-185,0.37163915706425826,0.6283608429357417,home,SF,under,6.5,0.49504950495049505,102,0.47495984076128583,SF,ATL,2022 REG,10,3,10,2,5,20,1,0,1,-1,1,1,0,0,0,0,0,0,0,0.5250401592387142,0.47495984076128583
87540,0.7014925373134329,0.3389830508474576,-235,195,0.6730992142751963,0.32690078572480374,away,SF,over,7.5,0.5348837209302326,-115,0.5097020142727117,LAD,SF,2022 REG,12,7,7,4,11,19,1,0,3,-3,1,1,1,1,0,0,0,0,0,0.5097020142727117,0.49029798572728833
87540,0.7014925373134329,0.3389830508474576,-235,195,0.6730992142751963,0.32690078572480374,home,LAD,under,7.5,0.5121951219512195,-105,0.49029798572728833,LAD,SF,2022 REG,12,7,7,4,11,19,1,0,3,-3,1,1,1,1,0,0,0,0,0,0.5097020142727117,0.49029798572728833
87541,0.5454545454545454,0.5,-120,100,0.5206611570247933,0.4793388429752067,away,TEX,over,8,0.5098039215686274,-104,0.48483656587239576,DET,TEX,2022 REG,5,0,12,7,7,17,0,1,-7,7,0,0,0,0,0,0,0,0,0,0.48483656587239576,0.5151634341276042
87541,0.5454545454545454,0.5,-120,100,0.5206611570247933,0.4793388429752067,home,DET,under,8,0.5391705069124424,-117,0.5151634341276042,DET,TEX,2022 REG,5,0,12,7,7,17,0,1,-7,7,0,0,0,0,0,0,0,0,0,0.48483656587239576,0.5151634341276042
87542,0.5726495726495727,0.46511627906976744,-134,115,0.5510229738017454,0.44897702619825464,away,TOR,over,8.5,0.5238095238095238,-110,0.4988662131519274,NYY,TOR,2022 REG,8,3,5,0,3,13,1,0,3,-3,0,0,0,0,0,0,0,0,0,0.4988662131519274,0.5011337868480725
87542,0.5726495726495727,0.46511627906976744,-134,115,0.5510229738017454,0.44897702619825464,home,NYY,under,8.5,0.5238095238095238,-110,0.5011337868480725,NYY,TOR,2022 REG,8,3,5,0,3,13,1,0,3,-3,0,0,0,0,0,0,0,0,0,0.4988662131519274,0.5011337868480725
87543,0.5652173913043479,0.47619047619047616,-130,110,0.5418129444594474,0.4581870555405526,away,COL,over,9,0.5098039215686274,-104,0.4870219861770517,ARI,COL,2022 REG,12,9,7,2,11,19,1,0,7,-7,1,1,0,0,0,0,0,0,0,0.4870219861770517,0.5129780138229483
87543,0.5652173913043479,0.47619047619047616,-130,110,0.5418129444594474,0.4581870555405526,home,ARI,under,9,0.5348837209302326,-115,0.5129780138229483,ARI,COL,2022 REG,12,9,7,2,11,19,1,0,7,-7,1,1,0,0,0,0,0,0,0,0.4870219861770517,0.5129780138229483
87544,0.40322580645161293,0.6376811594202898,148,-176,0.38673106214842634,0.6132689378515737,away,STL,over,11,0.5454545454545454,-120,0.5166307047184789,COL,STL,2022 REG,22,16,8,5,21,30,1,0,11,-11,1,1,1,1,1,0,0,0,0,0.5166307047184789,0.48336929528152106
87544,0.40322580645161293,0.6376811594202898,148,-176,0.38673106214842634,0.6132689378515737,home,COL,under,11,0.5073891625615764,-103,0.48336929528152106,COL,STL,2022 REG,22,16,8,5,21,30,1,0,11,-11,1,1,1,1,1,0,0,0,0,0.5166307047184789,0.48336929528152106
87545,0.6402877697841727,0.4,-178,150,0.6144920035194866,0.38550799648051337,away,WSH,over,8.5,0.5238095238095238,-110,0.5000596729920038,NYM,WSH,2022 REG,16,13,10,5,18,26,1,0,8,-8,1,1,1,1,1,0,0,0,0,0.5000596729920038,0.4999403270079962
87545,0.6402877697841727,0.4,-178,150,0.6144920035194866,0.38550799648051337,home,NYM,under,8.5,0.5215311004784688,-109,0.4999403270079962,NYM,WSH,2022 REG,16,13,10,5,18,26,1,0,8,-8,1,1,1,1,1,0,0,0,0,0.5000596729920038,0.4999403270079962
87546,0.6527777777777778,0.38759689922480617,-188,158,0.6264220858455355,0.3735779141544645,away,MIA,over,7,0.49504950495049505,102,0.47297076509898783,ATL,MIA,2022 REG,11,8,5,1,9,16,1,0,7,-7,1,0,0,0,0,0,0,0,0,0.47297076509898783,0.5270292349010122
87546,0.6527777777777778,0.38759689922480617,-188,158,0.6264220858455355,0.3735779141544645,home,ATL,under,7,0.5495495495495495,-122,0.5270292349010122,ATL,MIA,2022 REG,11,8,5,1,9,16,1,0,7,-7,1,0,0,0,0,0,0,0,0,0.47297076509898783,0.5270292349010122
87547,0.5901639344262295,0.45454545454545453,-144,120,0.5637780655249077,0.4362219344750923,away,CWS,over,8.5,0.5098039215686274,-104,0.4870219861770517,BOS,CWS,2022 REG,9,2,6,3,5,15,0,1,-1,1,1,1,0,0,0,0,0,0,0,0.4870219861770517,0.5129780138229483
87547,0.5901639344262295,0.45454545454545453,-144,120,0.5637780655249077,0.4362219344750923,home,BOS,under,8.5,0.5348837209302326,-115,0.5129780138229483,BOS,CWS,2022 REG,9,2,6,3,5,15,0,1,-1,1,1,1,0,0,0,0,0,0,0,0.4870219861770517,0.5129780138229483
87548,0.6153846153846154,0.425531914893617,-160,135,0.5902052121364724,0.40979478786352763,away,CLE,over,8.5,0.5145631067961165,-106,0.49023796582517226,MIN,CLE,2022 REG,12,10,15,11,21,27,0,1,-1,1,1,1,1,1,1,1,1,1,1,0.49023796582517226,0.5097620341748277
87548,0.6153846153846154,0.425531914893617,-160,135,0.5902052121364724,0.40979478786352763,home,MIN,under,8.5,0.5327102803738317,-114,0.5097620341748277,MIN,CLE,2022 REG,12,10,15,11,21,27,0,1,-1,1,1,1,1,1,1,1,1,1,1,0.49023796582517226,0.5097620341748277
87549,0.5348837209302326,0.5,-115,100,0.5162249864791779,0.4837750135208221,away,KC,over,8.5,0.5169082125603864,-107,0.49239402434819424,DET,KC,2022 REG,6,1,10,3,4,16,0,1,-2,2,1,0,0,0,0,0,0,0,0,0.49239402434819424,0.5076059756518058
87549,0.5348837209302326,0.5,-115,100,0.5162249864791779,0.4837750135208221,home,DET,under,8.5,0.5305164319248826,-113,0.5076059756518058,DET,KC,2022 REG,6,1,10,3,4,16,0,1,-2,2,1,0,0,0,0,0,0,0,0,0.49239402434819424,0.5076059756518058
87550,0.5555555555555556,0.4807692307692307,-125,108,0.5353751187084521,0.4646248812915479,away,CLE,over,9.5,0.5192307692307692,-108,0.49455035168025013,CIN,CLE,2022 REG,7,3,13,7,10,20,0,1,-4,4,1,1,1,0,0,0,0,0,0,0.49455035168025013,0.5054496483197499
87550,0.5555555555555556,0.4807692307692307,-125,108,0.5353751187084521,0.4646248812915479,home,CIN,under,9.5,0.5283018867924528,-112,0.5054496483197499,CIN,CLE,2022 REG,7,3,13,7,10,20,0,1,-4,4,1,1,1,0,0,0,0,0,0,0.49455035168025013,0.5054496483197499
87551,0.6875,0.3508771929824561,-220,185,0.6611156798245614,0.33888432017543857,away,PIT,over,8,0.5391705069124424,-117,0.5127649394825569,ATL,PIT,2022 REG,10,4,8,2,6,18,1,0,2,-2,1,1,0,0,0,0,0,0,0,0.5127649394825569,0.48723506051744314
87551,0.6875,0.3508771929824561,-220,185,0.6611156798245614,0.33888432017543857,home,ATL,under,8,0.5098039215686274,-104,0.48723506051744314,ATL,PIT,2022 REG,10,4,8,2,6,18,1,0,2,-2,1,1,0,0,0,0,0,0,0,0.5127649394825569,0.48723506051744314
87552,0.7468354430379747,0.29411764705882354,-295,240,0.7162502238517583,0.2837497761482417,away,OAK,over,8,0.5169082125603864,-107,0.49353874091423283,HOU,OAK,2022 REG,10,5,10,8,13,20,0,1,-3,3,1,1,1,1,1,0,0,0,0,0.49353874091423283,0.5064612590857671
87552,0.7468354430379747,0.29411764705882354,-295,240,0.7162502238517583,0.2837497761482417,home,HOU,under,8,0.5283018867924528,-112,0.5064612590857671,HOU,OAK,2022 REG,10,5,10,8,13,20,0,1,-3,3,1,1,1,1,1,0,0,0,0,0.49353874091423283,0.5064612590857671
87553,0.5833333333333333,0.4587155963302753,-140,118,0.5588047910295616,0.4411952089704384,away,WSH,over,9.5,0.5121951219512195,-105,0.48919479393107135,CIN,WSH,2022 REG,10,8,15,10,18,25,0,1,-2,2,1,1,1,1,1,1,1,1,0,0.48919479393107135,0.5108052060689287
87553,0.5833333333333333,0.4587155963302753,-140,118,0.5588047910295616,0.4411952089704384,home,CIN,under,9.5,0.5327102803738317,-114,0.5108052060689287,CIN,WSH,2022 REG,10,8,15,10,18,25,0,1,-2,2,1,1,1,1,1,1,1,1,0,0.48919479393107135,0.5108052060689287
87554,0.5348837209302326,0.5121951219512195,-115,-105,0.5097020142727117,0.49029798572728833,away,STL,over,10,0.5327102803738317,-114,0.5075272610403079,CHC,STL,2022 REG,8,3,16,8,11,24,0,1,-5,5,1,1,1,0,0,0,0,0,0,0.5075272610403079,0.4924727389596921
87554,0.5348837209302326,0.5121951219512195,-115,-105,0.5097020142727117,0.49029798572728833,home,CHC,under,10,0.5145631067961165,-106,0.4924727389596921,CHC,STL,2022 REG,8,3,16,8,11,24,0,1,-5,5,1,1,1,0,0,0,0,0,0,0.5075272610403079,0.4924727389596921
87555,0.7590361445783133,0.2857142857142857,-315,250,0.7250689505007983,0.27493104949920166,away,COL,over,8.5,0.5121951219512195,-105,0.48808156828023186,SD,COL,2022 REG,10,9,6,1,10,16,1,0,8,-8,1,0,0,0,0,0,0,0,0,0.48808156828023186,0.5119184317197681
87555,0.7590361445783133,0.2857142857142857,-315,250,0.7250689505007983,0.27493104949920166,home,SD,under,8.5,0.5348837209302326,-115,0.5119184317197681,SD,COL,2022 REG,10,9,6,1,10,16,1,0,8,-8,1,0,0,0,0,0,0,0,0,0.48808156828023186,0.5119184317197681
87556,0.5833333333333333,0.45454545454545453,-140,120,0.5612373737373737,0.4387626262626263,away,TEX,over,9,0.5238095238095238,-110,0.4988662131519274,CWS,TEX,2022 REG,11,8,6,3,11,17,1,0,5,-5,1,1,1,0,0,0,0,0,0,0.4988662131519274,0.5011337868480725
87556,0.5833333333333333,0.45454545454545453,-140,120,0.5612373737373737,0.4387626262626263,home,CWS,under,9,0.5238095238095238,-110,0.5011337868480725,CWS,TEX,2022 REG,11,8,6,3,11,17,1,0,5,-5,1,1,1,0,0,0,0,0,0,0.4988662131519274,0.5011337868480725
87557,0.6491228070175439,0.3921568627450981,-185,155,0.6223272319084604,0.3776727680915396,away,COL,over,8,0.5238095238095238,-110,0.4988662131519274,ARI,COL,2022 REG,10,2,8,3,5,18,0,1,-1,1,1,1,0,0,0,0,0,0,0,0.4988662131519274,0.5011337868480725
87557,0.6491228070175439,0.3921568627450981,-185,155,0.6223272319084604,0.3776727680915396,home,ARI,under,8,0.5238095238095238,-110,0.5011337868480725,ARI,COL,2022 REG,10,2,8,3,5,18,0,1,-1,1,1,1,0,0,0,0,0,0,0,0.4988662131519274,0.5011337868480725
87558,0.6503496503496503,0.3921568627450981,-186,155,0.6227055544208978,0.3772944455791022,away,WSH,over,9,0.5098039215686274,-104,0.4881300146960012,MIA,WSH,2022 REG,14,12,8,2,14,22,1,0,10,-10,1,1,0,0,0,0,0,0,0,0.4881300146960012,0.5118699853039987
87558,0.6503496503496503,0.3921568627450981,-186,155,0.6227055544208978,0.3772944455791022,home,MIA,under,9,0.5327102803738317,-114,0.5118699853039987,MIA,WSH,2022 REG,14,12,8,2,14,22,1,0,10,-10,1,1,0,0,0,0,0,0,0,0.4881300146960012,0.5118699853039987
87559,0.6774193548387096,0.36363636363636365,-210,175,0.6496074165168858,0.3503925834831142,away,DET,over,8.5,0.5098039215686274,-104,0.4870219861770517,CWS,DET,2022 REG,8,2,3,0,2,11,1,0,2,-2,0,0,0,0,0,0,0,0,0,0.4870219861770517,0.5129780138229483
87559,0.6774193548387096,0.36363636363636365,-210,175,0.6496074165168858,0.3503925834831142,home,CWS,under,8.5,0.5348837209302326,-115,0.5129780138229483,CWS,DET,2022 REG,8,2,3,0,2,11,1,0,2,-2,0,0,0,0,0,0,0,0,0,0.4870219861770517,0.5129780138229483
87560,0.6363636363636364,0.40322580645161293,-175,148,0.6111703545721141,0.3888296454278859,away,CLE,over,9.5,0.5024875621890548,-101,0.4794401874631478,CWS,CLE,2022 REG,8,5,8,4,9,16,1,0,1,-1,1,1,1,1,0,0,0,0,0,0.4794401874631478,0.5205598125368522
87560,0.6363636363636364,0.40322580645161293,-175,148,0.6111703545721141,0.3888296454278859,home,CWS,under,9.5,0.5433789954337899,-119,0.5205598125368522,CWS,CLE,2022 REG,8,5,8,4,9,16,1,0,1,-1,1,1,1,1,0,0,0,0,0,0.4794401874631478,0.5205598125368522
87561,0.5370370370370371,0.504950495049505,-116,-102,0.514488177212783,0.48551182278721705,away,BOS,over,8.5,0.5454545454545454,-120,0.5206611570247933,MIN,BOS,2022 REG,7,4,10,2,6,17,1,0,2,-2,1,1,0,0,0,0,0,0,0,0.5206611570247933,0.4793388429752067
87561,0.5370370370370371,0.504950495049505,-116,-102,0.514488177212783,0.48551182278721705,home,MIN,under,8.5,0.5,100,0.4793388429752067,MIN,BOS,2022 REG,7,4,10,2,6,17,1,0,2,-2,1,1,0,0,0,0,0,0,0,0.5206611570247933,0.4793388429752067
87562,0.5689655172413793,0.46511627906976744,-132,115,0.5495741503746924,0.45042584962530763,away,SEA,over,7,0.5391705069124424,-117,0.5140669063204599,NYM,SEA,2022 REG,9,7,16,8,15,25,0,1,-1,1,1,1,1,1,1,1,1,0,0,0.5140669063204599,0.4859330936795401
87562,0.5689655172413793,0.46511627906976744,-132,115,0.5495741503746924,0.45042584962530763,home,NYM,under,7,0.5073891625615764,-103,0.4859330936795401,NYM,SEA,2022 REG,9,7,16,8,15,25,0,1,-1,1,1,1,1,1,1,1,1,0,0,0.5140669063204599,0.4859330936795401
87563,0.4629629629629629,0.5780590717299579,116,-137,0.4439712802347588,0.5560287197652412,away,CWS,over,9.5,0.5121951219512195,-105,0.4858858974112951,KC,CWS,2022 REG,5,2,8,3,5,13,0,1,-1,1,1,1,0,0,0,0,0,0,0,0.4858858974112951,0.5141141025887048
87563,0.4629629629629629,0.5780590717299579,116,-137,0.4439712802347588,0.5560287197652412,home,KC,under,9.5,0.5391705069124424,-117,0.5141141025887048,KC,CWS,2022 REG,5,2,8,3,5,13,0,1,-1,1,1,1,0,0,0,0,0,0,0,0.4858858974112951,0.5141141025887048
87564,0.7101449275362319,0.3448275862068966,-245,190,0.6711064757476334,0.3288935242523666,away,MIA,over,7.5,0.5348837209302326,-115,0.5097020142727117,HOU,MIA,2022 REG,14,9,3,4,13,17,1,0,5,-5,1,1,1,1,0,0,0,0,0,0.5097020142727117,0.49029798572728833
87564,0.7101449275362319,0.3448275862068966,-245,190,0.6711064757476334,0.3288935242523666,home,HOU,under,7.5,0.5121951219512195,-105,0.49029798572728833,HOU,MIA,2022 REG,14,9,3,4,13,17,1,0,5,-5,1,1,1,1,0,0,0,0,0,0.5097020142727117,0.49029798572728833
87565,0.6923076923076923,0.3472222222222222,-225,188,0.6649408284023669,0.3350591715976331,away,ARI,over,10,0.5283018867924528,-112,0.5044173060022736,ATL,ARI,2022 REG,11,6,4,2,8,15,1,0,4,-4,1,1,0,0,0,0,0,0,0,0.5044173060022736,0.49558269399772636
87565,0.6923076923076923,0.3472222222222222,-225,188,0.6649408284023669,0.3350591715976331,home,ATL,under,10,0.5169082125603864,-107,0.49558269399772636,ATL,ARI,2022 REG,11,6,4,2,8,15,1,0,4,-4,1,1,0,0,0,0,0,0,0,0.5044173060022736,0.49558269399772636
87566,0.6226415094339623,0.4166666666666667,-165,140,0.5981666073335706,0.40183339266642937,away,COL,over,8,0.5283018867924528,-112,0.5031902949311281,PHI,COL,2022 REG,11,10,6,3,13,17,1,0,7,-7,1,1,1,0,0,0,0,0,0,0.5031902949311281,0.4968097050688719
87566,0.6226415094339623,0.4166666666666667,-165,140,0.5981666073335706,0.40183339266642937,home,PHI,under,8,0.5192307692307692,-108,0.4968097050688719,PHI,COL,2022 REG,11,10,6,3,13,17,1,0,7,-7,1,1,1,0,0,0,0,0,0,0.5031902949311281,0.4968097050688719
87567,0.5967741935483871,0.4484304932735426,-148,123,0.5697972030256225,0.43020279697437747,away,CIN,over,8.5,0.5348837209302326,-115,0.5097020142727117,STL,CIN,2022 REG,8,7,10,3,10,18,1,0,4,-4,1,1,1,0,0,0,0,0,0,0.5097020142727117,0.49029798572728833
87567,0.5967741935483871,0.4484304932735426,-148,123,0.5697972030256225,0.43020279697437747,home,STL,under,8.5,0.5121951219512195,-105,0.49029798572728833,STL,CIN,2022 REG,8,7,10,3,10,18,1,0,4,-4,1,1,1,0,0,0,0,0,0,0.5097020142727117,0.49029798572728833
87568,0.5575221238938054,0.4807692307692307,-126,108,0.5361738465152985,0.46382615348470146,away,ARI,over,8.5,0.5327102803738317,-114,0.508788710910954,PIT,ARI,2022 REG,5,2,4,1,3,9,1,0,1,-1,1,0,0,0,0,0,0,0,0,0.508788710910954,0.491211289089046
87568,0.5575221238938054,0.4807692307692307,-126,108,0.5361738465152985,0.46382615348470146,home,PIT,under,8.5,0.5121951219512195,-105,0.491211289089046,PIT,ARI,2022 REG,5,2,4,1,3,9,1,0,1,-1,1,0,0,0,0,0,0,0,0,0.508788710910954,0.491211289089046
87569,0.696969696969697,0.3448275862068966,-230,190,0.6678382571799499,0.33216174282005007,away,OAK,over,8.5,0.5348837209302326,-115,0.5084354177277668,TB,OAK,2022 REG,8,2,13,13,15,21,0,1,-11,11,1,1,0,0,0,0,0,0,0,0.5084354177277668,0.4915645822722332
87569,0.696969696969697,0.3448275862068966,-230,190,0.6678382571799499,0.33216174282005007,home,TB,under,8.5,0.5145631067961165,-106,0.4915645822722332,TB,OAK,2022 REG,8,2,13,13,15,21,0,1,-11,11,1,1,0,0,0,0,0,0,0,0.5084354177277668,0.4915645822722332
87570,0.613899613899614,0.42016806722689076,-159,138,0.5929854776095975,0.4070145223904025,away,CIN,over,7.5,0.5391705069124424,-117,0.5127649394825569,PIT,CIN,2022 REG,13,8,5,3,11,18,1,0,5,-5,1,1,1,0,0,0,0,0,0,0.5127649394825569,0.48723506051744314
87570,0.613899613899614,0.42016806722689076,-159,138,0.5929854776095975,0.4070145223904025,home,PIT,under,7.5,0.5098039215686274,-104,0.48723506051744314,PIT,CIN,2022 REG,13,8,5,3,11,18,1,0,5,-5,1,1,1,0,0,0,0,0,0,0.5127649394825569,0.48723506051744314
87571,0.6000000000000001,0.4444444444444444,-150,125,0.5733333333333334,0.42666666666666664,away,PHI,over,8,0.5098039215686274,-104,0.4870219861770517,LAD,PHI,2022 REG,12,7,12,9,16,24,0,1,-2,2,1,1,1,1,1,1,1,0,0,0.4870219861770517,0.5129780138229483
87571,0.6000000000000001,0.4444444444444444,-150,125,0.5733333333333334,0.42666666666666664,home,LAD,under,8,0.5348837209302326,-115,0.5129780138229483,LAD,PHI,2022 REG,12,7,12,9,16,24,0,1,-2,2,1,1,1,1,1,1,1,0,0,0.4870219861770517,0.5129780138229483
87572,0.5884773662551441,0.4444444444444444,-143,125,0.5691036258022998,0.4308963741977002,away,LAA,over,8.5,0.5391705069124424,-117,0.5140669063204599,TEX,LAA,2022 REG,10,7,5,2,9,15,1,0,5,-5,1,1,0,0,0,0,0,0,0,0.5140669063204599,0.4859330936795401
87572,0.5884773662551441,0.4444444444444444,-143,125,0.5691036258022998,0.4308963741977002,home,TEX,under,8.5,0.5073891625615764,-103,0.4859330936795401,TEX,LAA,2022 REG,10,7,5,2,9,15,1,0,5,-5,1,1,0,0,0,0,0,0,0,0.5140669063204599,0.4859330936795401
87573,0.5815899581589958,0.45454545454545453,-139,120,0.5605739649961564,0.4394260350038436,away,OAK,over,7.5,0.5305164319248826,-113,0.5066009958897986,DET,OAK,2022 REG,7,1,8,4,5,15,0,1,-3,3,1,0,0,0,0,0,0,0,0,0.5066009958897986,0.49339900411020143
87573,0.5815899581589958,0.45454545454545453,-139,120,0.5605739649961564,0.4394260350038436,home,DET,under,7.5,0.5145631067961165,-106,0.49339900411020143,DET,OAK,2022 REG,7,1,8,4,5,15,0,1,-3,3,1,0,0,0,0,0,0,0,0,0.5066009958897986,0.49339900411020143
87574,0.6453900709219857,0.3921568627450981,-182,155,0.6211576527396834,0.3788423472603166,away,OAK,over,7.5,0.5,100,0.47935779816513757,MIN,OAK,2022 REG,8,2,4,1,3,12,1,0,1,-1,1,0,0,0,0,0,0,0,0,0.47935779816513757,0.5206422018348624
87574,0.6453900709219857,0.3921568627450981,-182,155,0.6211576527396834,0.3788423472603166,home,MIN,under,7.5,0.5412844036697247,-118,0.5206422018348624,MIN,OAK,2022 REG,8,2,4,1,3,12,1,0,1,-1,1,0,0,0,0,0,0,0,0,0.47935779816513757,0.5206422018348624
87575,0.47619047619047616,0.5633187772925764,110,-129,0.45737654596045113,0.5426234540395489,away,TEX,over,7,0.5348837209302326,-115,0.5097020142727117,OAK,TEX,2022 REG,5,5,13,8,13,18,0,1,-3,3,1,1,1,1,1,0,0,0,0,0.5097020142727117,0.49029798572728833
87575,0.47619047619047616,0.5633187772925764,110,-129,0.45737654596045113,0.5426234540395489,home,OAK,under,7,0.5121951219512195,-105,0.49029798572728833,OAK,TEX,2022 REG,5,5,13,8,13,18,0,1,-3,3,1,1,1,1,1,0,0,0,0,0.5097020142727117,0.49029798572728833
87576,0.6721311475409836,0.36363636363636365,-205,175,0.6480906892086682,0.3519093107913318,away,SF,over,7.5,0.5391705069124424,-117,0.5140669063204599,MIL,SF,2022 REG,3,2,3,1,3,6,1,0,1,-1,1,0,0,0,0,0,0,0,0,0.5140669063204599,0.4859330936795401
87576,0.6721311475409836,0.36363636363636365,-205,175,0.6480906892086682,0.3519093107913318,home,MIL,under,7.5,0.5073891625615764,-103,0.4859330936795401,MIL,SF,2022 REG,3,2,3,1,3,6,1,0,1,-1,1,0,0,0,0,0,0,0,0,0.5140669063204599,0.4859330936795401
87577,0.6363636363636364,0.40322580645161293,-175,148,0.6111703545721141,0.3888296454278859,away,MIA,over,7.5,0.5454545454545454,-120,0.5206611570247933,MIL,MIA,2022 REG,10,2,5,4,6,15,0,1,-2,2,1,1,0,0,0,0,0,0,0,0.5206611570247933,0.4793388429752067
87577,0.6363636363636364,0.40322580645161293,-175,148,0.6111703545721141,0.3888296454278859,home,MIL,under,7.5,0.5,100,0.4793388429752067,MIL,MIA,2022 REG,10,2,5,4,6,15,0,1,-2,2,1,1,0,0,0,0,0,0,0,0.5206611570247933,0.4793388429752067
87578,0.5652173913043479,0.46511627906976744,-130,115,0.5480722732668045,0.4519277267331955,away,NYM,over,9,0.5121951219512195,-105,0.48808156828023186,NYY,NYM,2022 REG,8,4,9,2,6,17,1,0,2,-2,1,1,0,0,0,0,0,0,0,0.48808156828023186,0.5119184317197681
87578,0.5652173913043479,0.46511627906976744,-130,115,0.5480722732668045,0.4519277267331955,home,NYY,under,9,0.5348837209302326,-115,0.5119184317197681,NYY,NYM,2022 REG,8,4,9,2,6,17,1,0,2,-2,1,1,0,0,0,0,0,0,0,0.48808156828023186,0.5119184317197681
87579,0.5967741935483871,0.4424778761061947,-148,126,0.5733495713351688,0.42665042866483116,away,PIT,over,11.5,0.5283018867924528,-112,0.5044173060022736,COL,PIT,2022 REG,8,2,6,0,2,14,1,0,2,-2,0,0,0,0,0,0,0,0,0,0.5044173060022736,0.49558269399772636
87579,0.5967741935483871,0.4424778761061947,-148,126,0.5733495713351688,0.42665042866483116,home,COL,under,11.5,0.5169082125603864,-107,0.49558269399772636,COL,PIT,2022 REG,8,2,6,0,2,14,1,0,2,-2,0,0,0,0,0,0,0,0,0,0.5044173060022736,0.49558269399772636
87580,0.36764705882352944,0.6666666666666666,172,-200,0.35503171856978094,0.6449682814302191,away,STL,over,8,0.5370370370370371,-116,0.5118817074154765,PIT,STL,2022 REG,15,8,6,2,10,21,1,0,6,-6,1,1,0,0,0,0,0,0,0,0.5118817074154765,0.48811829258452355
87580,0.36764705882352944,0.6666666666666666,172,-200,0.35503171856978094,0.6449682814302191,home,PIT,under,8,0.5098039215686274,-104,0.48811829258452355,PIT,STL,2022 REG,15,8,6,2,10,21,1,0,6,-6,1,1,0,0,0,0,0,0,0,0.5118817074154765,0.48811829258452355
87581,0.5689655172413793,0.47619047619047616,-132,110,0.5432733140818753,0.4567266859181247,away,TEX,over,7,0.5192307692307692,-108,0.49571111079951763,OAK,TEX,2022 REG,5,1,7,4,5,12,0,1,-3,3,1,0,0,0,0,0,0,0,0,0.49571111079951763,0.5042888892004824
87581,0.5689655172413793,0.47619047619047616,-132,110,0.5432733140818753,0.4567266859181247,home,OAK,under,7,0.5260663507109005,-111,0.5042888892004824,OAK,TEX,2022 REG,5,1,7,4,5,12,0,1,-3,3,1,0,0,0,0,0,0,0,0,0.49571111079951763,0.5042888892004824
87582,0.5726495726495727,0.46511627906976744,-134,115,0.5510229738017454,0.44897702619825464,away,ATL,over,8.5,0.5283018867924528,-112,0.5044173060022736,LAD,ATL,2022 REG,8,5,3,1,6,11,1,0,4,-4,1,0,0,0,0,0,0,0,0,0.5044173060022736,0.49558269399772636
87582,0.5726495726495727,0.46511627906976744,-134,115,0.5510229738017454,0.44897702619825464,home,LAD,under,8.5,0.5169082125603864,-107,0.49558269399772636,LAD,ATL,2022 REG,8,5,3,1,6,11,1,0,4,-4,1,0,0,0,0,0,0,0,0,0.5044173060022736,0.49558269399772636
87583,0.5305164319248826,0.5098039215686274,-113,-104,0.5091258218555558,0.49087417814444423,away,SF,over,9,0.5305164319248826,-113,0.5053568787472517,CHC,SF,2022 REG,12,2,8,4,6,20,0,1,-2,2,1,1,0,0,0,0,0,0,0,0.5053568787472517,0.49464312125274834
87583,0.5305164319248826,0.5098039215686274,-113,-104,0.5091258218555558,0.49087417814444423,home,CHC,under,9,0.5169082125603864,-107,0.49464312125274834,CHC,SF,2022 REG,12,2,8,4,6,20,0,1,-2,2,1,1,0,0,0,0,0,0,0,0.5053568787472517,0.49464312125274834
87584,0.4444444444444444,0.5967741935483871,125,-148,0.42612504978096366,0.5738749502190363,away,BOS,over,8,0.5433789954337899,-119,0.5198077604720502,CHC,BOS,2022 REG,6,6,11,5,11,17,1,0,1,-1,1,1,1,1,1,0,0,0,0,0.5198077604720502,0.48019223952794976
87584,0.4444444444444444,0.5967741935483871,125,-148,0.42612504978096366,0.5738749502190363,home,CHC,under,8,0.5,100,0.48019223952794976,CHC,BOS,2022 REG,6,6,11,5,11,17,1,0,1,-1,1,1,1,1,1,0,0,0,0,0.5198077604720502,0.48019223952794976
87585,0.7777777777777779,0.25641025641025644,-350,290,0.7511870845204179,0.24881291547958206,away,OAK,over,7.5,0.5073891625615764,-103,0.4826927225525911,HOU,OAK,2022 REG,15,11,5,2,13,20,1,0,9,-9,1,1,0,0,0,0,0,0,0,0.4826927225525911,0.5173072774474089
87585,0.7777777777777779,0.25641025641025644,-350,290,0.7511870845204179,0.24881291547958206,home,HOU,under,7.5,0.5412844036697247,-118,0.5173072774474089,HOU,OAK,2022 REG,15,11,5,2,13,20,1,0,9,-9,1,1,0,0,0,0,0,0,0,0.4826927225525911,0.5173072774474089
87586,0.5454545454545454,0.49504950495049505,-120,102,0.5233614270517961,0.4766385729482039,away,CLE,over,8,0.5121951219512195,-105,0.48919479393107135,LAA,CLE,2022 REG,8,3,3,0,3,11,1,0,3,-3,0,0,0,0,0,0,0,0,0,0.48919479393107135,0.5108052060689287
87586,0.5454545454545454,0.49504950495049505,-120,102,0.5233614270517961,0.4766385729482039,home,LAA,under,8,0.5327102803738317,-114,0.5108052060689287,LAA,CLE,2022 REG,8,3,3,0,3,11,1,0,3,-3,0,0,0,0,0,0,0,0,0,0.48919479393107135,0.5108052060689287
87587,0.5815899581589958,0.45454545454545453,-139,120,0.5605739649961564,0.4394260350038436,away,CIN,over,8,0.5121951219512195,-105,0.48919479393107135,STL,CIN,2022 REG,6,2,4,0,2,10,1,0,2,-2,0,0,0,0,0,0,0,0,0,0.48919479393107135,0.5108052060689287
87587,0.5815899581589958,0.45454545454545453,-139,120,0.5605739649961564,0.4394260350038436,home,STL,under,8,0.5327102803738317,-114,0.5108052060689287,STL,CIN,2022 REG,6,2,4,0,2,10,1,0,2,-2,0,0,0,0,0,0,0,0,0,0.48919479393107135,0.5108052060689287
87588,0.6527777777777778,0.3921568627450981,-188,155,0.6234454429920115,0.37655455700798846,away,OAK,over,7.5,0.5098039215686274,-104,0.4870219861770517,TEX,OAK,2022 REG,4,5,4,2,7,8,1,0,3,-3,1,1,0,0,0,0,0,0,0,0.4870219861770517,0.5129780138229483
87588,0.6527777777777778,0.3921568627450981,-188,155,0.6234454429920115,0.37655455700798846,home,TEX,under,7.5,0.5348837209302326,-115,0.5129780138229483,TEX,OAK,2022 REG,4,5,4,2,7,8,1,0,3,-3,1,1,0,0,0,0,0,0,0,0.4870219861770517,0.5129780138229483
87589,0.5867768595041323,0.45454545454545453,-142,120,0.5625298818386723,0.43747011816132775,away,TOR,over,6.5,0.5348837209302326,-115,0.5097020142727117,TB,TOR,2022 REG,7,1,10,7,8,17,0,1,-6,6,1,0,0,0,0,0,0,0,0,0.5097020142727117,0.49029798572728833
87589,0.5867768595041323,0.45454545454545453,-142,120,0.5625298818386723,0.43747011816132775,home,TB,under,6.5,0.5121951219512195,-105,0.49029798572728833,TB,TOR,2022 REG,7,1,10,7,8,17,0,1,-6,6,1,0,0,0,0,0,0,0,0,0.5097020142727117,0.49029798572728833
87590,0.6153846153846154,0.42016806722689076,-160,138,0.5935060414698423,0.4064939585301577,away,TOR,over,8.5,0.5238095238095238,-110,0.5012646084074657,HOU,TOR,2022 REG,7,3,7,4,7,14,0,1,-1,1,1,1,1,0,0,0,0,0,0,0.5012646084074657,0.4987353915925343
87590,0.6153846153846154,0.42016806722689076,-160,138,0.5935060414698423,0.4064939585301577,home,HOU,under,8.5,0.5192307692307692,-108,0.4987353915925343,HOU,TOR,2022 REG,7,3,7,4,7,14,0,1,-1,1,1,1,1,0,0,0,0,0,0,0.5012646084074657,0.4987353915925343
87591,0.41152263374485604,0.6226415094339623,143,-165,0.39746331556427233,0.6025366844357276,away,ARI,over,10.5,0.5238095238095238,-110,0.4988662131519274,COL,ARI,2022 REG,6,6,15,12,18,21,0,1,-6,6,1,1,1,1,1,1,0,0,0,0.4988662131519274,0.5011337868480725
87591,0.41152263374485604,0.6226415094339623,143,-165,0.39746331556427233,0.6025366844357276,home,COL,under,10.5,0.5238095238095238,-110,0.5011337868480725,COL,ARI,2022 REG,6,6,15,12,18,21,0,1,-6,6,1,1,1,1,1,1,0,0,0,0.4988662131519274,0.5011337868480725
87592,0.5,0.5454545454545454,100,-120,0.4772727272727273,0.5227272727272727,away,LAA,over,9.5,0.5145631067961165,-106,0.4913668392989033,TEX,LAA,2022 REG,7,3,10,8,11,17,0,1,-5,5,1,1,1,0,0,0,0,0,0,0.4913668392989033,0.5086331607010968
87592,0.5,0.5454545454545454,100,-120,0.4772727272727273,0.5227272727272727,home,TEX,under,9.5,0.5305164319248826,-113,0.5086331607010968,TEX,LAA,2022 REG,7,3,10,8,11,17,0,1,-5,5,1,1,1,0,0,0,0,0,0,0.4913668392989033,0.5086331607010968
87593,0.36363636363636365,0.6774193548387096,175,-210,0.3487070114636097,0.6512929885363903,away,LAD,over,9,0.5192307692307692,-108,0.49688292476754015,WSH,LAD,2022 REG,7,1,12,10,11,19,0,1,-9,9,1,0,0,0,0,0,0,0,0,0.49688292476754015,0.5031170752324599
87593,0.36363636363636365,0.6774193548387096,175,-210,0.3487070114636097,0.6512929885363903,home,WSH,under,9,0.5238095238095238,-110,0.5031170752324599,WSH,LAD,2022 REG,7,1,12,10,11,19,0,1,-9,9,1,0,0,0,0,0,0,0,0,0.49688292476754015,0.5031170752324599
87594,0.6363636363636364,0.4,-175,150,0.6132231404958678,0.3867768595041322,away,CWS,over,7.5,0.5238095238095238,-110,0.4988662131519274,CLE,CWS,2022 REG,5,0,5,2,2,10,0,1,-2,2,0,0,0,0,0,0,0,0,0,0.4988662131519274,0.5011337868480725
87594,0.6363636363636364,0.4,-175,150,0.6132231404958678,0.3867768595041322,home,CLE,under,7.5,0.5238095238095238,-110,0.5011337868480725,CLE,CWS,2022 REG,5,0,5,2,2,10,0,1,-2,2,0,0,0,0,0,0,0,0,0,0.4988662131519274,0.5011337868480725
87595,0.2777777777777778,0.7590361445783133,260,-315,0.26755168823441916,0.7324483117655809,away,NYM,over,6.5,0.5454545454545454,-120,0.5206611570247933,OAK,NYM,2022 REG,8,4,19,13,17,27,0,1,-9,9,1,1,1,1,0,0,0,0,0,0.5206611570247933,0.4793388429752067
87595,0.2777777777777778,0.7590361445783133,260,-315,0.26755168823441916,0.7324483117655809,home,OAK,under,6.5,0.5,100,0.4793388429752067,OAK,NYM,2022 REG,8,4,19,13,17,27,0,1,-9,9,1,1,1,1,0,0,0,0,0,0.5206611570247933,0.4793388429752067
87596,0.5454545454545454,0.5,-120,100,0.5206611570247933,0.4793388429752067,away,TB,over,8.5,0.5454545454545454,-120,0.5220180091279142,BOS,TB,2022 REG,6,1,10,7,8,16,0,1,-6,6,1,0,0,0,0,0,0,0,0,0.5220180091279142,0.4779819908720858
87596,0.5454545454545454,0.5,-120,100,0.5206611570247933,0.4793388429752067,home,BOS,under,8.5,0.49751243781094534,101,0.4779819908720858,BOS,TB,2022 REG,6,1,10,7,8,16,0,1,-6,6,1,0,0,0,0,0,0,0,0,0.5220180091279142,0.4779819908720858
87597,0.5689655172413793,0.4672897196261683,-132,114,0.5483375376443265,0.45166246235567353,away,CWS,over,9,0.5121951219512195,-105,0.48808156828023186,MIN,CWS,2022 REG,10,6,9,3,9,19,1,0,3,-3,1,1,1,0,0,0,0,0,0,0.48808156828023186,0.5119184317197681
87597,0.5689655172413793,0.4672897196261683,-132,114,0.5483375376443265,0.45166246235567353,home,MIN,under,9,0.5348837209302326,-115,0.5119184317197681,MIN,CWS,2022 REG,10,6,9,3,9,19,1,0,3,-3,1,1,1,0,0,0,0,0,0,0.48808156828023186,0.5119184317197681
87598,0.6551724137931035,0.38759689922480617,-190,158,0.6271511397468869,0.37284886025311315,away,ARI,over,7.5,0.5283018867924528,-112,0.5044173060022736,CWS,ARI,2022 REG,7,2,3,3,5,10,0,1,-1,1,1,1,0,0,0,0,0,0,0,0.5044173060022736,0.49558269399772636
87598,0.6551724137931035,0.38759689922480617,-190,158,0.6271511397468869,0.37284886025311315,home,CWS,under,7.5,0.5169082125603864,-107,0.49558269399772636,CWS,ARI,2022 REG,7,2,3,3,5,10,0,1,-1,1,1,1,0,0,0,0,0,0,0,0.5044173060022736,0.49558269399772636
87599,0.46511627906976744,0.574468085106383,115,-135,0.44670494689481377,0.5532950531051862,away,HOU,over,8,0.5238095238095238,-110,0.4988662131519274,MIN,HOU,2022 REG,7,0,9,5,5,16,0,1,-5,5,0,0,0,0,0,0,0,0,0,0.4988662131519274,0.5011337868480725
87599,0.46511627906976744,0.574468085106383,115,-135,0.44670494689481377,0.5532950531051862,home,MIN,under,8,0.5238095238095238,-110,0.5011337868480725,MIN,HOU,2022 REG,7,0,9,5,5,16,0,1,-5,5,0,0,0,0,0,0,0,0,0,0.4988662131519274,0.5011337868480725
87600,0.7701149425287357,0.27027027027027023,-335,270,0.7390136866950185,0.26098631330498145,away,WSH,over,8,0.5215311004784688,-109,0.4978845547971712,SEA,WSH,2022 REG,5,1,10,3,4,15,0,1,-2,2,1,0,0,0,0,0,0,0,0,0.4978845547971712,0.5021154452028288
87600,0.7701149425287357,0.27027027027027023,-335,270,0.7390136866950185,0.26098631330498145,home,SEA,under,8,0.5238095238095238,-110,0.5021154452028288,SEA,WSH,2022 REG,5,1,10,3,4,15,0,1,-2,2,1,0,0,0,0,0,0,0,0,0.4978845547971712,0.5021154452028288
87601,0.40322580645161293,0.6254681647940076,148,-167,0.3916556567557982,0.6083443432442017,away,NYY,over,8,0.5327102803738317,-114,0.5062779990911175,LAA,NYY,2022 REG,9,4,6,3,7,15,1,0,1,-1,1,1,1,0,0,0,0,0,0,0.5062779990911175,0.4937220009088825
87601,0.40322580645161293,0.6254681647940076,148,-167,0.3916556567557982,0.6083443432442017,home,LAA,under,8,0.5169082125603864,-107,0.4937220009088825,LAA,NYY,2022 REG,9,4,6,3,7,15,1,0,1,-1,1,1,1,0,0,0,0,0,0,0.5062779990911175,0.4937220009088825
87602,0.4587155963302753,0.576271186440678,118,-136,0.44266661340781965,0.5573333865921803,away,MIN,over,8,0.5260663507109005,-111,0.5022370601254724,CWS,MIN,2022 REG,11,4,8,3,7,19,1,0,1,-1,1,1,1,0,0,0,0,0,0,0.5022370601254724,0.4977629398745276
87602,0.4587155963302753,0.576271186440678,118,-136,0.44266661340781965,0.5573333865921803,home,CWS,under,8,0.5192307692307692,-108,0.4977629398745276,CWS,MIN,2022 REG,11,4,8,3,7,19,1,0,1,-1,1,1,1,0,0,0,0,0,0,0.5022370601254724,0.4977629398745276
87603,0.7701149425287357,0.27027027027027023,-335,270,0.7390136866950185,0.26098631330498145,away,PIT,over,8.5,0.5073891625615764,-103,0.4837652908580103,LAD,PIT,2022 REG,4,3,11,5,8,15,0,1,-2,2,1,1,1,0,0,0,0,0,0,0.4837652908580103,0.5162347091419897
87603,0.7701149425287357,0.27027027027027023,-335,270,0.7390136866950185,0.26098631330498145,home,LAD,under,8.5,0.5391705069124424,-117,0.5162347091419897,LAD,PIT,2022 REG,4,3,11,5,8,15,0,1,-2,2,1,1,1,0,0,0,0,0,0,0.4837652908580103,0.5162347091419897
87604,0.5348837209302326,0.5121951219512195,-115,-105,0.5097020142727117,0.49029798572728833,away,STL,over,8,0.504950495049505,-102,0.4826715732667395,NYM,STL,2022 REG,8,3,6,1,4,14,1,0,2,-2,1,0,0,0,0,0,0,0,0,0.4826715732667395,0.5173284267332605
87604,0.5348837209302326,0.5121951219512195,-115,-105,0.5097020142727117,0.49029798572728833,home,NYM,under,8,0.5391705069124424,-117,0.5173284267332605,NYM,STL,2022 REG,8,3,6,1,4,14,1,0,2,-2,1,0,0,0,0,0,0,0,0,0.4826715732667395,0.5173284267332605
87605,0.7701149425287357,0.273972602739726,-335,265,0.7361624651380813,0.26383753486191874,away,COL,over,7.5,0.5348837209302326,-115,0.5097020142727117,LAD,COL,2022 REG,8,6,2,1,7,10,1,0,5,-5,1,0,0,0,0,0,0,0,0,0.5097020142727117,0.49029798572728833
87605,0.7701149425287357,0.273972602739726,-335,265,0.7361624651380813,0.26383753486191874,home,LAD,under,7.5,0.5121951219512195,-105,0.49029798572728833,LAD,COL,2022 REG,8,6,2,1,7,10,1,0,5,-5,1,0,0,0,0,0,0,0,0,0.5097020142727117,0.49029798572728833
87606,0.6108949416342413,0.425531914893617,-157,135,0.5886419592417365,0.41135804075826354,away,TEX,over,8,0.5121951219512195,-105,0.48808156828023186,SEA,TEX,2022 REG,9,4,8,2,6,17,1,0,2,-2,1,1,0,0,0,0,0,0,0,0.48808156828023186,0.5119184317197681
87606,0.6108949416342413,0.425531914893617,-157,135,0.5886419592417365,0.41135804075826354,home,SEA,under,8,0.5348837209302326,-115,0.5119184317197681,SEA,TEX,2022 REG,9,4,8,2,6,17,1,0,2,-2,1,1,0,0,0,0,0,0,0,0.48808156828023186,0.5119184317197681
87607,0.6240601503759399,0.4166666666666667,-166,140,0.5986441668079975,0.4013558331920025,away,BOS,over,8,0.5348837209302326,-115,0.5097020142727117,NYY,BOS,2022 REG,9,4,9,5,9,18,0,1,-1,1,1,1,1,1,0,0,0,0,0,0.5097020142727117,0.49029798572728833
87607,0.6240601503759399,0.4166666666666667,-166,140,0.5986441668079975,0.4013558331920025,home,NYY,under,8,0.5121951219512195,-105,0.49029798572728833,NYY,BOS,2022 REG,9,4,9,5,9,18,0,1,-1,1,1,1,1,1,0,0,0,0,0,0.5097020142727117,0.49029798572728833
87608,0.613899613899614,0.425531914893617,-159,135,0.589692613597978,0.410307386402022,away,LAA,over,8,0.5192307692307692,-108,0.49688292476754015,HOU,LAA,2022 REG,6,2,13,7,9,19,0,1,-5,5,1,1,0,0,0,0,0,0,0,0.49688292476754015,0.5031170752324599
87608,0.613899613899614,0.425531914893617,-159,135,0.589692613597978,0.410307386402022,home,HOU,under,8,0.5238095238095238,-110,0.5031170752324599,HOU,LAA,2022 REG,6,2,13,7,9,19,0,1,-5,5,1,1,0,0,0,0,0,0,0,0.49688292476754015,0.5031170752324599
87609,0.6000000000000001,0.4347826086956522,-150,130,0.5791304347826086,0.4208695652173914,away,CHC,over,7.5,0.5,100,0.4772727272727273,MIL,CHC,2022 REG,7,3,2,4,7,9,0,1,-1,1,1,1,1,0,0,0,0,0,0,0.4772727272727273,0.5227272727272727
87609,0.6000000000000001,0.4347826086956522,-150,130,0.5791304347826086,0.4208695652173914,home,MIL,under,7.5,0.5454545454545454,-120,0.5227272727272727,MIL,CHC,2022 REG,7,3,2,4,7,9,0,1,-1,1,1,1,1,0,0,0,0,0,0,0.4772727272727273,0.5227272727272727
87610,0.38759689922480617,0.6551724137931035,158,-190,0.37101964611708926,0.6289803538829107,away,TB,over,8.5,0.5121951219512195,-105,0.48919479393107135,DET,TB,2022 REG,3,0,9,7,7,12,0,1,-7,7,0,0,0,0,0,0,0,0,0,0.48919479393107135,0.5108052060689287
87610,0.38759689922480617,0.6551724137931035,158,-190,0.37101964611708926,0.6289803538829107,home,DET,under,8.5,0.5327102803738317,-114,0.5108052060689287,DET,TB,2022 REG,3,0,9,7,7,12,0,1,-7,7,0,0,0,0,0,0,0,0,0,0.48919479393107135,0.5108052060689287
87611,0.5689655172413793,0.4716981132075471,-132,112,0.5458293137100936,0.4541706862899064,away,KC,over,8,0.5121951219512195,-105,0.48919479393107135,CWS,KC,2022 REG,12,7,13,9,16,25,0,1,-2,2,1,1,1,1,1,1,1,0,0,0.48919479393107135,0.5108052060689287
87611,0.5689655172413793,0.4716981132075471,-132,112,0.5458293137100936,0.4541706862899064,home,CWS,under,8,0.5327102803738317,-114,0.5108052060689287,CWS,KC,2022 REG,12,7,13,9,16,25,0,1,-2,2,1,1,1,1,1,1,1,0,0,0.48919479393107135,0.5108052060689287
87612,0.6212121212121212,0.4166666666666667,-164,140,0.5976813590449954,0.4023186409550046,away,ARI,over,7,0.5391705069124424,-117,0.5140669063204599,SD,ARI,2022 REG,6,6,10,5,11,16,1,0,1,-1,1,1,1,1,1,0,0,0,0,0.5140669063204599,0.4859330936795401
87612,0.6212121212121212,0.4166666666666667,-164,140,0.5976813590449954,0.4023186409550046,home,SD,under,7,0.5073891625615764,-103,0.4859330936795401,SD,ARI,2022 REG,6,6,10,5,11,16,1,0,1,-1,1,1,1,1,1,0,0,0,0,0.5140669063204599,0.4859330936795401
87613,0.574468085106383,0.46511627906976744,-135,115,0.5517281312179562,0.44827186878204384,away,SEA,over,8,0.5348837209302326,-115,0.5097020142727117,TOR,SEA,2022 REG,6,3,6,0,3,12,1,0,3,-3,0,0,0,0,0,0,0,0,0,0.5097020142727117,0.49029798572728833
87613,0.574468085106383,0.46511627906976744,-135,115,0.5517281312179562,0.44827186878204384,home,TOR,under,8,0.5121951219512195,-105,0.49029798572728833,TOR,SEA,2022 REG,6,3,6,0,3,12,1,0,3,-3,0,0,0,0,0,0,0,0,0,0.5097020142727117,0.49029798572728833
87614,0.2898550724637681,0.7468354430379747,245,-295,0.27922014043427745,0.7207798595657225,away,LAD,over,9.5,0.5192307692307692,-108,0.49455035168025013,KC,LAD,2022 REG,10,3,16,13,16,26,0,1,-10,10,1,1,1,0,0,0,0,0,0,0.49455035168025013,0.5054496483197499
87614,0.2898550724637681,0.7468354430379747,245,-295,0.27922014043427745,0.7207798595657225,home,KC,under,9.5,0.5283018867924528,-112,0.5054496483197499,KC,LAD,2022 REG,10,3,16,13,16,26,0,1,-10,10,1,1,1,0,0,0,0,0,0,0.49455035168025013,0.5054496483197499
87615,0.6254681647940076,0.4132231404958678,-167,142,0.6012679850808645,0.39873201491913546,away,COL,over,8,0.5348837209302326,-115,0.5097020142727117,SF,COL,2022 REG,9,6,4,3,9,13,1,0,3,-3,1,1,1,0,0,0,0,0,0,0.5097020142727117,0.49029798572728833
87615,0.6254681647940076,0.4132231404958678,-167,142,0.6012679850808645,0.39873201491913546,home,SF,under,8,0.5121951219512195,-105,0.49029798572728833,SF,COL,2022 REG,9,6,4,3,9,13,1,0,3,-3,1,1,1,0,0,0,0,0,0,0.5097020142727117,0.49029798572728833
87616,0.6323529411764706,0.4098360655737705,-172,144,0.6056745986726416,0.3943254013273584,away,WSH,over,9.5,0.5098039215686274,-104,0.4870219861770517,PHI,WSH,2022 REG,13,11,3,0,11,16,1,0,11,-11,0,0,0,0,0,0,0,0,0,0.4870219861770517,0.5129780138229483
87616,0.6323529411764706,0.4098360655737705,-172,144,0.6056745986726416,0.3943254013273584,home,PHI,under,9.5,0.5348837209302326,-115,0.5129780138229483,PHI,WSH,2022 REG,13,11,3,0,11,16,1,0,11,-11,0,0,0,0,0,0,0,0,0,0.4870219861770517,0.5129780138229483
87617,0.4,0.6402877697841727,150,-178,0.383884892086331,0.6161151079136691,away,LAA,over,6.5,0.5454545454545454,-120,0.5153135634419057,OAK,LAA,2022 REG,6,1,10,5,6,16,0,1,-4,4,1,0,0,0,0,0,0,0,0,0.5153135634419057,0.4846864365580943
87617,0.4,0.6402877697841727,150,-178,0.383884892086331,0.6161151079136691,home,OAK,under,6.5,0.5098039215686274,-104,0.4846864365580943,OAK,LAA,2022 REG,6,1,10,5,6,16,0,1,-4,4,1,0,0,0,0,0,0,0,0,0.5153135634419057,0.4846864365580943
87618,0.6774193548387096,0.35714285714285715,-210,180,0.6540062434963579,0.34599375650364206,away,OAK,over,9.5,0.49504950495049505,102,0.47297076509898783,PHI,OAK,2022 REG,7,4,5,2,6,12,1,0,2,-2,1,1,0,0,0,0,0,0,0,0.47297076509898783,0.5270292349010122
87618,0.6774193548387096,0.35714285714285715,-210,180,0.6540062434963579,0.34599375650364206,home,PHI,under,9.5,0.5495495495495495,-122,0.5270292349010122,PHI,OAK,2022 REG,7,4,5,2,6,12,1,0,2,-2,1,1,0,0,0,0,0,0,0,0.47297076509898783,0.5270292349010122
87619,0.5121951219512195,0.5348837209302326,-105,-115,0.48808156828023186,0.5119184317197681,away,MIA,over,9.5,0.5391705069124424,-117,0.5140669063204599,WSH,MIA,2022 REG,7,3,7,5,8,14,0,1,-2,2,1,1,1,0,0,0,0,0,0,0.5140669063204599,0.4859330936795401
87619,0.5121951219512195,0.5348837209302326,-105,-115,0.48808156828023186,0.5119184317197681,home,WSH,under,9.5,0.5073891625615764,-103,0.4859330936795401,WSH,MIA,2022 REG,7,3,7,5,8,14,0,1,-2,2,1,1,1,0,0,0,0,0,0,0.5140669063204599,0.4859330936795401
87620,0.5121951219512195,0.5283018867924528,-105,-112,0.49145275161909474,0.5085472483809053,away,TEX,over,7.5,0.5348837209302326,-115,0.5097020142727117,OAK,TEX,2022 REG,10,4,18,11,15,28,0,1,-7,7,1,1,1,1,0,0,0,0,0,0.5097020142727117,0.49029798572728833
87620,0.5121951219512195,0.5283018867924528,-105,-112,0.49145275161909474,0.5085472483809053,home,OAK,under,7.5,0.5121951219512195,-105,0.49029798572728833,OAK,TEX,2022 REG,10,4,18,11,15,28,0,1,-7,7,1,1,1,1,0,0,0,0,0,0.5097020142727117,0.49029798572728833
87621,0.35714285714285715,0.6774193548387096,180,-210,0.3447992100065833,0.6552007899934167,away,LAD,over,9.5,0.5215311004784688,-109,0.4978845547971712,ARI,LAD,2022 REG,8,1,4,3,4,12,0,1,-2,2,1,0,0,0,0,0,0,0,0,0.4978845547971712,0.5021154452028288
87621,0.35714285714285715,0.6774193548387096,180,-210,0.3447992100065833,0.6552007899934167,home,ARI,under,9.5,0.5238095238095238,-110,0.5021154452028288,ARI,LAD,2022 REG,8,1,4,3,4,12,0,1,-2,2,1,0,0,0,0,0,0,0,0,0.4978845547971712,0.5021154452028288
87622,0.37735849056603776,0.6621621621621622,165,-196,0.36244503670633965,0.6375549632936603,away,TOR,over,7.5,0.5169082125603864,-107,0.49353874091423283,CLE,TOR,2022 REG,9,4,4,3,7,13,1,0,1,-1,1,1,1,0,0,0,0,0,0,0.49353874091423283,0.5064612590857671
87622,0.37735849056603776,0.6621621621621622,165,-196,0.36244503670633965,0.6375549632936603,home,CLE,under,7.5,0.5283018867924528,-112,0.5064612590857671,CLE,TOR,2022 REG,9,4,4,3,7,13,1,0,1,-1,1,1,1,0,0,0,0,0,0,0.49353874091423283,0.5064612590857671
87623,0.5454545454545454,0.49504950495049505,-120,102,0.5233614270517961,0.4766385729482039,away,BOS,over,7.5,0.49504950495049505,102,0.47297076509898783,ATL,BOS,2022 REG,8,5,7,3,8,15,1,0,2,-2,1,1,1,0,0,0,0,0,0,0.47297076509898783,0.5270292349010122
87623,0.5454545454545454,0.49504950495049505,-120,102,0.5233614270517961,0.4766385729482039,home,ATL,under,7.5,0.5495495495495495,-122,0.5270292349010122,ATL,BOS,2022 REG,8,5,7,3,8,15,1,0,2,-2,1,1,1,0,0,0,0,0,0,0.47297076509898783,0.5270292349010122
87624,0.5652173913043479,0.4716981132075471,-130,112,0.5443521061454507,0.4556478938545493,away,PHI,over,8,0.5073891625615764,-103,0.4837652908580103,TEX,PHI,2022 REG,11,7,6,0,7,17,1,0,7,-7,0,0,0,0,0,0,0,0,0,0.4837652908580103,0.5162347091419897
87624,0.5652173913043479,0.4716981132075471,-130,112,0.5443521061454507,0.4556478938545493,home,TEX,under,8,0.5391705069124424,-117,0.5162347091419897,TEX,PHI,2022 REG,11,7,6,0,7,17,1,0,7,-7,0,0,0,0,0,0,0,0,0,0.4837652908580103,0.5162347091419897
87625,0.4484304932735426,0.5850622406639003,123,-141,0.43341133007289556,0.5665886699271044,away,LAA,over,8,0.5238095238095238,-110,0.4988662131519274,TEX,LAA,2022 REG,8,7,9,4,11,17,1,0,3,-3,1,1,1,1,0,0,0,0,0,0.4988662131519274,0.5011337868480725
87625,0.4484304932735426,0.5850622406639003,123,-141,0.43341133007289556,0.5665886699271044,home,TEX,under,8,0.5238095238095238,-110,0.5011337868480725,TEX,LAA,2022 REG,8,7,9,4,11,17,1,0,3,-3,1,1,1,1,0,0,0,0,0,0.4988662131519274,0.5011337868480725
87626,0.6363636363636364,0.40322580645161293,-175,148,0.6111703545721141,0.3888296454278859,away,MIA,over,8.5,0.5098039215686274,-104,0.48483656587239576,NYM,MIA,2022 REG,12,10,2,0,10,14,1,0,10,-10,0,0,0,0,0,0,0,0,0,0.48483656587239576,0.5151634341276042
87626,0.6363636363636364,0.40322580645161293,-175,148,0.6111703545721141,0.3888296454278859,home,NYM,under,8.5,0.5391705069124424,-117,0.5151634341276042,NYM,MIA,2022 REG,12,10,2,0,10,14,1,0,10,-10,0,0,0,0,0,0,0,0,0,0.48483656587239576,0.5151634341276042
87627,0.3846153846153846,0.6551724137931035,160,-190,0.3693123852275045,0.6306876147724956,away,LAD,over,11.5,0.5327102803738317,-114,0.508788710910954,COL,LAD,2022 REG,11,4,3,0,4,14,1,0,4,-4,0,0,0,0,0,0,0,0,0,0.508788710910954,0.491211289089046
87627,0.3846153846153846,0.6551724137931035,160,-190,0.3693123852275045,0.6306876147724956,home,COL,under,11.5,0.5121951219512195,-105,0.491211289089046,COL,LAD,2022 REG,11,4,3,0,4,14,1,0,4,-4,0,0,0,0,0,0,0,0,0,0.508788710910954,0.491211289089046
87628,0.5633187772925764,0.47619047619047616,-129,110,0.5410624729287608,0.45893752707123925,away,SEA,over,8.5,0.5215311004784688,-109,0.4978845547971712,HOU,SEA,2022 REG,8,3,5,0,3,13,1,0,3,-3,0,0,0,0,0,0,0,0,0,0.4978845547971712,0.5021154452028288
87628,0.5633187772925764,0.47619047619047616,-129,110,0.5410624729287608,0.45893752707123925,home,HOU,under,8.5,0.5238095238095238,-110,0.5021154452028288,HOU,SEA,2022 REG,8,3,5,0,3,13,1,0,3,-3,0,0,0,0,0,0,0,0,0,0.4978845547971712,0.5021154452028288
87629,0.6428571428571428,0.3921568627450981,-180,155,0.6203481392557023,0.3796518607442977,away,DET,over,8.5,0.5169082125603864,-107,0.49239402434819424,HOU,DET,2022 REG,5,5,1,0,5,6,1,0,5,-5,0,0,0,0,0,0,0,0,0,0.49239402434819424,0.5076059756518058
87629,0.6428571428571428,0.3921568627450981,-180,155,0.6203481392557023,0.3796518607442977,home,HOU,under,8.5,0.5305164319248826,-113,0.5076059756518058,HOU,DET,2022 REG,5,5,1,0,5,6,1,0,5,-5,0,0,0,0,0,0,0,0,0,0.49239402434819424,0.5076059756518058
87630,0.4629629629629629,0.5726495726495727,116,-134,0.44647567795715937,0.5535243220428406,away,SF,over,11,0.5121951219512195,-105,0.48919479393107135,COL,SF,2022 REG,11,8,10,9,17,21,0,1,-1,1,1,1,1,1,1,1,1,1,0,0.48919479393107135,0.5108052060689287
87630,0.4629629629629629,0.5726495726495727,116,-134,0.44647567795715937,0.5535243220428406,home,COL,under,11,0.5327102803738317,-114,0.5108052060689287,COL,SF,2022 REG,11,8,10,9,17,21,0,1,-1,1,1,1,1,1,1,1,1,1,0,0.48919479393107135,0.5108052060689287
87631,0.5780590717299579,0.4587155963302753,-137,118,0.5568011412478822,0.44319885875211784,away,DET,over,8,0.5145631067961165,-106,0.4913668392989033,BOS,DET,2022 REG,9,6,5,2,8,14,1,0,4,-4,1,1,0,0,0,0,0,0,0,0.4913668392989033,0.5086331607010968
87631,0.5780590717299579,0.4587155963302753,-137,118,0.5568011412478822,0.44319885875211784,home,BOS,under,8,0.5305164319248826,-113,0.5086331607010968,BOS,DET,2022 REG,9,6,5,2,8,14,1,0,4,-4,1,1,0,0,0,0,0,0,0,0.4913668392989033,0.5086331607010968
87632,0.5967741935483871,0.4444444444444444,-148,125,0.5721759741010521,0.42782402589894786,away,KC,over,9.5,0.5098039215686274,-104,0.4870219861770517,CLE,KC,2022 REG,12,8,7,3,11,19,1,0,5,-5,1,1,1,0,0,0,0,0,0,0.4870219861770517,0.5129780138229483
87632,0.5967741935483871,0.4444444444444444,-148,125,0.5721759741010521,0.42782402589894786,home,CLE,under,9.5,0.5348837209302326,-115,0.5129780138229483,CLE,KC,2022 REG,12,8,7,3,11,19,1,0,5,-5,1,1,1,0,0,0,0,0,0,0.4870219861770517,0.5129780138229483
87633,0.4,0.6363636363636364,150,-175,0.3854545454545455,0.6145454545454545,away,CWS,over,8,0.5073891625615764,-103,0.4826927225525911,KC,CWS,2022 REG,9,0,5,3,3,14,0,1,-3,3,0,0,0,0,0,0,0,0,0,0.4826927225525911,0.5173072774474089
87633,0.4,0.6363636363636364,150,-175,0.3854545454545455,0.6145454545454545,home,KC,under,8,0.5412844036697247,-118,0.5173072774474089,KC,CWS,2022 REG,9,0,5,3,3,14,0,1,-3,3,0,0,0,0,0,0,0,0,0,0.4826927225525911,0.5173072774474089
87634,0.5283018867924528,0.5238095238095238,-112,-110,0.5007713302480123,0.49922866975198765,away,PIT,over,9,0.5475113122171946,-121,0.5135248656080966,CIN,PIT,2022 REG,8,2,7,4,6,15,0,1,-2,2,1,1,0,0,0,0,0,0,0,0.5135248656080966,0.4864751343919034
87634,0.5283018867924528,0.5238095238095238,-112,-110,0.5007713302480123,0.49922866975198765,home,CIN,under,9,0.5145631067961165,-106,0.4864751343919034,CIN,PIT,2022 REG,8,2,7,4,6,15,0,1,-2,2,1,1,0,0,0,0,0,0,0,0.5135248656080966,0.4864751343919034
87635,0.4587155963302753,0.5833333333333333,118,-140,0.4394270964845833,0.5605729035154168,away,STL,over,9.5,0.5238095238095238,-110,0.4988662131519274,WSH,STL,2022 REG,8,7,10,6,13,18,1,0,1,-1,1,1,1,1,1,1,0,0,0,0.4988662131519274,0.5011337868480725
87635,0.4587155963302753,0.5833333333333333,118,-140,0.4394270964845833,0.5605729035154168,home,WSH,under,9.5,0.5238095238095238,-110,0.5011337868480725,WSH,STL,2022 REG,8,7,10,6,13,18,1,0,1,-1,1,1,1,1,1,1,0,0,0,0.4988662131519274,0.5011337868480725
87636,0.576271186440678,0.46511627906976744,-136,115,0.552420782587201,0.44757921741279905,away,CIN,over,8,0.5169082125603864,-107,0.49239402434819424,CLE,CIN,2022 REG,3,2,8,4,6,11,0,1,-2,2,1,1,0,0,0,0,0,0,0,0.49239402434819424,0.5076059756518058
87636,0.576271186440678,0.46511627906976744,-136,115,0.552420782587201,0.44757921741279905,home,CLE,under,8,0.5305164319248826,-113,0.5076059756518058,CLE,CIN,2022 REG,3,2,8,4,6,11,0,1,-2,2,1,1,0,0,0,0,0,0,0,0.49239402434819424,0.5076059756518058
87637,0.47619047619047616,0.5652173913043479,110,-130,0.4564724440500838,0.5435275559499162,away,TOR,over,8.5,0.5121951219512195,-105,0.48919479393107135,DET,TOR,2022 REG,2,0,11,6,6,13,0,1,-6,6,0,0,0,0,0,0,0,0,0,0.48919479393107135,0.5108052060689287
87637,0.47619047619047616,0.5652173913043479,110,-130,0.4564724440500838,0.5435275559499162,home,DET,under,8.5,0.5327102803738317,-114,0.5108052060689287,DET,TOR,2022 REG,2,0,11,6,6,13,0,1,-6,6,0,0,0,0,0,0,0,0,0,0.48919479393107135,0.5108052060689287
87638,0.6226415094339623,0.4166666666666667,-165,140,0.5981666073335706,0.40183339266642937,away,CHC,over,8.5,0.5348837209302326,-115,0.5097020142727117,STL,CHC,2022 REG,11,6,7,0,6,18,1,0,6,-6,0,0,0,0,0,0,0,0,0,0.5097020142727117,0.49029798572728833
87638,0.6226415094339623,0.4166666666666667,-165,140,0.5981666073335706,0.40183339266642937,home,STL,under,8.5,0.5121951219512195,-105,0.49029798572728833,STL,CHC,2022 REG,11,6,7,0,6,18,1,0,6,-6,0,0,0,0,0,0,0,0,0,0.5097020142727117,0.49029798572728833
87639,0.5575221238938054,0.48780487804878053,-126,105,0.5322513175010363,0.46774868249896373,away,STL,over,7,0.5283018867924528,-112,0.5031902949311281,SF,STL,2022 REG,7,2,6,3,5,13,0,1,-1,1,1,1,0,0,0,0,0,0,0,0.5031902949311281,0.4968097050688719
87639,0.5575221238938054,0.48780487804878053,-126,105,0.5322513175010363,0.46774868249896373,home,SF,under,7,0.5192307692307692,-108,0.4968097050688719,SF,STL,2022 REG,7,2,6,3,5,13,0,1,-1,1,1,1,0,0,0,0,0,0,0,0.5031902949311281,0.4968097050688719
87640,0.3448275862068966,0.6923076923076923,190,-225,0.3320223177535901,0.6679776822464099,away,NYM,over,7,0.5348837209302326,-115,0.5097020142727117,OAK,NYM,2022 REG,6,2,13,9,11,19,0,1,-7,7,1,1,0,0,0,0,0,0,0,0.5097020142727117,0.49029798572728833
87640,0.3448275862068966,0.6923076923076923,190,-225,0.3320223177535901,0.6679776822464099,home,OAK,under,7,0.5121951219512195,-105,0.49029798572728833,OAK,NYM,2022 REG,6,2,13,9,11,19,0,1,-7,7,1,1,0,0,0,0,0,0,0,0.5097020142727117,0.49029798572728833
87641,0.5,0.5454545454545454,100,-120,0.4772727272727273,0.5227272727272727,away,MIL,over,8,0.5121951219512195,-105,0.48808156828023186,CHC,MIL,2022 REG,7,4,8,3,7,15,1,0,1,-1,1,1,1,0,0,0,0,0,0,0.48808156828023186,0.5119184317197681
87641,0.5,0.5454545454545454,100,-120,0.4772727272727273,0.5227272727272727,home,CHC,under,8,0.5348837209302326,-115,0.5119184317197681,CHC,MIL,2022 REG,7,4,8,3,7,15,1,0,1,-1,1,1,1,0,0,0,0,0,0,0.48808156828023186,0.5119184317197681
87642,0.4716981132075471,0.5652173913043479,112,-130,0.4542851393811816,0.5457148606188185,away,TB,over,6.5,0.5454545454545454,-120,0.5206611570247933,SEA,TB,2022 REG,5,3,7,4,7,12,0,1,-1,1,1,1,1,0,0,0,0,0,0,0.5206611570247933,0.4793388429752067
87642,0.4716981132075471,0.5652173913043479,112,-130,0.4542851393811816,0.5457148606188185,home,SEA,under,6.5,0.5,100,0.4793388429752067,SEA,TB,2022 REG,5,3,7,4,7,12,0,1,-1,1,1,1,1,0,0,0,0,0,0,0.5206611570247933,0.4793388429752067
87643,0.5780590717299579,0.45454545454545453,-137,120,0.5592117295369979,0.44078827046300206,away,DET,over,8.5,0.5121951219512195,-105,0.48919479393107135,LAA,DET,2022 REG,7,5,8,4,9,15,1,0,1,-1,1,1,1,1,0,0,0,0,0,0.48919479393107135,0.5108052060689287
87643,0.5780590717299579,0.45454545454545453,-137,120,0.5592117295369979,0.44078827046300206,home,LAA,under,8.5,0.5327102803738317,-114,0.5108052060689287,LAA,DET,2022 REG,7,5,8,4,9,15,1,0,1,-1,1,1,1,1,0,0,0,0,0,0.48919479393107135,0.5108052060689287
87644,0.5348837209302326,0.5098039215686274,-115,-104,0.5109810284308424,0.48901897156915763,away,BOS,over,8.5,0.5283018867924528,-112,0.5044173060022736,TEX,BOS,2022 REG,6,7,7,1,8,13,1,0,6,-6,1,0,0,0,0,0,0,0,0,0.5044173060022736,0.49558269399772636
87644,0.5348837209302326,0.5098039215686274,-115,-104,0.5109810284308424,0.48901897156915763,home,TEX,under,8.5,0.5169082125603864,-107,0.49558269399772636,TEX,BOS,2022 REG,6,7,7,1,8,13,1,0,6,-6,1,0,0,0,0,0,0,0,0,0.5044173060022736,0.49558269399772636
87645,0.43859649122807015,0.5967741935483871,128,-148,0.4230830329927819,0.5769169670072181,away,TB,over,8.5,0.5454545454545454,-120,0.5220180091279142,BAL,TB,2022 REG,5,1,8,0,1,13,1,0,1,-1,0,0,0,0,0,0,0,0,0,0.5220180091279142,0.4779819908720858
87645,0.43859649122807015,0.5967741935483871,128,-148,0.4230830329927819,0.5769169670072181,home,BAL,under,8.5,0.49751243781094534,101,0.4779819908720858,BAL,TB,2022 REG,5,1,8,0,1,13,1,0,1,-1,0,0,0,0,0,0,0,0,0,0.5220180091279142,0.4779819908720858
87646,0.5967741935483871,0.4444444444444444,-148,125,0.5721759741010521,0.42782402589894786,away,MIA,over,7.5,0.5121951219512195,-105,0.48808156828023186,SF,MIA,2022 REG,5,1,5,2,3,10,0,1,-1,1,1,0,0,0,0,0,0,0,0,0.48808156828023186,0.5119184317197681
87646,0.5967741935483871,0.4444444444444444,-148,125,0.5721759741010521,0.42782402589894786,home,SF,under,7.5,0.5348837209302326,-115,0.5119184317197681,SF,MIA,2022 REG,5,1,5,2,3,10,0,1,-1,1,1,0,0,0,0,0,0,0,0,0.48808156828023186,0.5119184317197681
87647,0.5633187772925764,0.47619047619047616,-129,110,0.5410624729287608,0.45893752707123925,away,MIA,over,8.5,0.5098039215686274,-104,0.4870219861770517,SF,MIA,2022 REG,6,3,11,2,5,17,1,0,1,-1,1,1,0,0,0,0,0,0,0,0.4870219861770517,0.5129780138229483
87647,0.5633187772925764,0.47619047619047616,-129,110,0.5410624729287608,0.45893752707123925,home,SF,under,8.5,0.5348837209302326,-115,0.5129780138229483,SF,MIA,2022 REG,6,3,11,2,5,17,1,0,1,-1,1,1,0,0,0,0,0,0,0,0.4870219861770517,0.5129780138229483
87648,0.4273504273504274,0.6124031007751938,134,-158,0.41036174011725596,0.5896382598827441,away,MIN,over,7.5,0.5305164319248826,-113,0.5053568787472517,BAL,MIN,2022 REG,4,1,7,2,3,11,0,1,-1,1,1,0,0,0,0,0,0,0,0,0.5053568787472517,0.49464312125274834
87648,0.4273504273504274,0.6124031007751938,134,-158,0.41036174011725596,0.5896382598827441,home,BAL,under,7.5,0.5169082125603864,-107,0.49464312125274834,BAL,MIN,2022 REG,4,1,7,2,3,11,0,1,-1,1,1,0,0,0,0,0,0,0,0,0.5053568787472517,0.49464312125274834
87649,0.6000000000000001,0.4347826086956522,-150,130,0.5791304347826086,0.4208695652173914,away,SD,over,8,0.5121951219512195,-105,0.48919479393107135,LAD,SD,2022 REG,8,7,10,2,9,18,1,0,5,-5,1,1,0,0,0,0,0,0,0,0.48919479393107135,0.5108052060689287
87649,0.6000000000000001,0.4347826086956522,-150,130,0.5791304347826086,0.4208695652173914,home,LAD,under,8,0.5327102803738317,-114,0.5108052060689287,LAD,SD,2022 REG,8,7,10,2,9,18,1,0,5,-5,1,1,0,0,0,0,0,0,0,0.48919479393107135,0.5108052060689287
87650,0.5901639344262295,0.45454545454545453,-144,120,0.5637780655249077,0.4362219344750923,away,CLE,over,6.5,0.5327102803738317,-114,0.5075272610403079,OAK,CLE,2022 REG,10,8,11,9,17,21,0,1,-1,1,1,1,1,1,1,1,1,1,0,0.5075272610403079,0.4924727389596921
87650,0.5901639344262295,0.45454545454545453,-144,120,0.5637780655249077,0.4362219344750923,home,OAK,under,6.5,0.5145631067961165,-106,0.4924727389596921,OAK,CLE,2022 REG,10,8,11,9,17,21,0,1,-1,1,1,1,1,1,1,1,1,1,0,0.5075272610403079,0.4924727389596921
87651,0.5348837209302326,0.5073891625615764,-115,-103,0.5122726437136835,0.48772735628631647,away,CHC,over,6.5,0.5535714285714286,-124,0.5266562689432208,MIA,CHC,2022 REG,6,3,4,4,7,10,0,1,-1,1,1,1,1,0,0,0,0,0,0,0.5266562689432208,0.4733437310567792
87651,0.5348837209302326,0.5073891625615764,-115,-103,0.5122726437136835,0.48772735628631647,home,MIA,under,6.5,0.49504950495049505,102,0.4733437310567792,MIA,CHC,2022 REG,6,3,4,4,7,10,0,1,-1,1,1,1,1,0,0,0,0,0,0,0.5266562689432208,0.4733437310567792
87652,0.4444444444444444,0.6000000000000001,125,-150,0.4246913580246913,0.5753086419753086,away,CLE,over,8.5,0.5412844036697247,-118,0.5136310900085983,DET,CLE,2022 REG,10,4,2,1,5,12,1,0,3,-3,1,0,0,0,0,0,0,0,0,0.5136310900085983,0.4863689099914017
87652,0.4444444444444444,0.6000000000000001,125,-150,0.4246913580246913,0.5753086419753086,home,DET,under,8.5,0.5098039215686274,-104,0.4863689099914017,DET,CLE,2022 REG,10,4,2,1,5,12,1,0,3,-3,1,0,0,0,0,0,0,0,0,0.5136310900085983,0.4863689099914017
87653,0.5475113122171946,0.49504950495049505,-121,102,0.5242087833606768,0.4757912166393232,away,LAA,over,9,0.5,100,0.4772727272727273,PHI,LAA,2022 REG,10,10,5,0,10,15,1,0,10,-10,0,0,0,0,0,0,0,0,0,0.4772727272727273,0.5227272727272727
87653,0.5475113122171946,0.49504950495049505,-121,102,0.5242087833606768,0.4757912166393232,home,PHI,under,9,0.5454545454545454,-120,0.5227272727272727,PHI,LAA,2022 REG,10,10,5,0,10,15,1,0,10,-10,0,0,0,0,0,0,0,0,0,0.4772727272727273,0.5227272727272727
87654,0.4347826086956522,0.607843137254902,130,-155,0.41624967567367205,0.583750324326328,away,LAD,over,9,0.5348837209302326,-115,0.5097020142727117,STL,LAD,2022 REG,5,0,8,4,4,13,0,1,-4,4,0,0,0,0,0,0,0,0,0,0.5097020142727117,0.49029798572728833
87654,0.4347826086956522,0.607843137254902,130,-155,0.41624967567367205,0.583750324326328,home,STL,under,9,0.5121951219512195,-105,0.49029798572728833,STL,LAD,2022 REG,5,0,8,4,4,13,0,1,-4,4,0,0,0,0,0,0,0,0,0,0.5097020142727117,0.49029798572728833
87655,0.6875,0.3508771929824561,-220,185,0.6611156798245614,0.33888432017543857,away,ARI,over,8.5,0.5073891625615764,-103,0.4826927225525911,NYM,ARI,2022 REG,12,10,3,3,13,15,1,0,7,-7,1,1,1,0,0,0,0,0,0,0.4826927225525911,0.5173072774474089
87655,0.6875,0.3508771929824561,-220,185,0.6611156798245614,0.33888432017543857,home,NYM,under,8.5,0.5412844036697247,-118,0.5173072774474089,NYM,ARI,2022 REG,12,10,3,3,13,15,1,0,7,-7,1,1,1,0,0,0,0,0,0,0.4826927225525911,0.5173072774474089
87656,0.5121951219512195,0.5348837209302326,-105,-115,0.48808156828023186,0.5119184317197681,away,CHC,over,8.5,0.5238095238095238,-110,0.5024811857109994,CIN,CHC,2022 REG,20,20,8,5,25,28,1,0,15,-15,1,1,1,1,1,0,0,0,0,0.5024811857109994,0.4975188142890006
87656,0.5121951219512195,0.5348837209302326,-105,-115,0.48808156828023186,0.5119184317197681,home,CIN,under,8.5,0.5169082125603864,-107,0.4975188142890006,CIN,CHC,2022 REG,20,20,8,5,25,28,1,0,15,-15,1,1,1,1,1,0,0,0,0,0.5024811857109994,0.4975188142890006
87657,0.635036496350365,0.40322580645161293,-174,148,0.6107385376367002,0.38926146236329984,away,KC,over,9.5,0.5098039215686274,-104,0.48483656587239576,LAA,KC,2022 REG,10,11,14,12,23,24,0,1,-1,1,1,1,1,1,1,1,1,1,1,0.48483656587239576,0.5151634341276042
87657,0.635036496350365,0.40322580645161293,-174,148,0.6107385376367002,0.38926146236329984,home,LAA,under,9.5,0.5391705069124424,-117,0.5151634341276042,LAA,KC,2022 REG,10,11,14,12,23,24,0,1,-1,1,1,1,1,1,1,1,1,1,1,0.48483656587239576,0.5151634341276042
87658,0.607843137254902,0.4291845493562232,-155,133,0.5853361120599043,0.4146638879400957,away,STL,over,9,0.5348837209302326,-115,0.5097020142727117,BOS,STL,2022 REG,9,6,7,4,10,16,1,0,2,-2,1,1,1,1,0,0,0,0,0,0.5097020142727117,0.49029798572728833
87658,0.607843137254902,0.4291845493562232,-155,133,0.5853361120599043,0.4146638879400957,home,BOS,under,9,0.5121951219512195,-105,0.49029798572728833,BOS,STL,2022 REG,9,6,7,4,10,16,1,0,2,-2,1,1,1,1,0,0,0,0,0,0.5097020142727117,0.49029798572728833
87659,0.42016806722689076,0.6183206106870228,138,-162,0.4039963538176834,0.5960036461823166,away,LAD,over,7.5,0.5,100,0.47935779816513757,SF,LAD,2022 REG,8,0,6,3,3,14,0,1,-3,3,0,0,0,0,0,0,0,0,0,0.47935779816513757,0.5206422018348624
87659,0.42016806722689076,0.6183206106870228,138,-162,0.4039963538176834,0.5960036461823166,home,SF,under,7.5,0.5412844036697247,-118,0.5206422018348624,SF,LAD,2022 REG,8,0,6,3,3,14,0,1,-3,3,0,0,0,0,0,0,0,0,0,0.47935779816513757,0.5206422018348624
87660,0.6428571428571428,0.3921568627450981,-180,155,0.6203481392557023,0.3796518607442977,away,CHC,over,7.5,0.5238095238095238,-110,0.4988662131519274,SF,CHC,2022 REG,9,4,4,0,4,13,1,0,4,-4,0,0,0,0,0,0,0,0,0,0.4988662131519274,0.5011337868480725
87660,0.6428571428571428,0.3921568627450981,-180,155,0.6203481392557023,0.3796518607442977,home,SF,under,7.5,0.5238095238095238,-110,0.5011337868480725,SF,CHC,2022 REG,9,4,4,0,4,13,1,0,4,-4,0,0,0,0,0,0,0,0,0,0.4988662131519274,0.5011337868480725
87661,0.4807692307692307,0.5555555555555556,108,-125,0.4633053911900066,0.5366946088099934,away,TB,over,8,0.5145631067961165,-106,0.4913668392989033,TEX,TB,2022 REG,10,3,6,4,7,16,0,1,-1,1,1,1,1,0,0,0,0,0,0,0.4913668392989033,0.5086331607010968
87661,0.4807692307692307,0.5555555555555556,108,-125,0.4633053911900066,0.5366946088099934,home,TEX,under,8,0.5305164319248826,-113,0.5086331607010968,TEX,TB,2022 REG,10,3,6,4,7,16,0,1,-1,1,1,1,1,0,0,0,0,0,0,0.4913668392989033,0.5086331607010968
87662,0.5652173913043479,0.47619047619047616,-130,110,0.5418129444594474,0.4581870555405526,away,KC,over,7.5,0.5192307692307692,-108,0.49455035168025013,BAL,KC,2022 REG,9,6,6,1,7,15,1,0,5,-5,1,0,0,0,0,0,0,0,0,0.49455035168025013,0.5054496483197499
87662,0.5652173913043479,0.47619047619047616,-130,110,0.5418129444594474,0.4581870555405526,home,BAL,under,7.5,0.5283018867924528,-112,0.5054496483197499,BAL,KC,2022 REG,9,6,6,1,7,15,1,0,5,-5,1,0,0,0,0,0,0,0,0,0.49455035168025013,0.5054496483197499
87663,0.6296296296296295,0.40322580645161293,-170,148,0.6089428735784769,0.3910571264215231,away,WSH,over,8.5,0.5169082125603864,-107,0.49353874091423283,MIA,WSH,2022 REG,11,5,7,1,6,18,1,0,4,-4,1,0,0,0,0,0,0,0,0,0.49353874091423283,0.5064612590857671
87663,0.6296296296296295,0.40322580645161293,-170,148,0.6089428735784769,0.3910571264215231,home,MIA,under,8.5,0.5283018867924528,-112,0.5064612590857671,MIA,WSH,2022 REG,11,5,7,1,6,18,1,0,4,-4,1,0,0,0,0,0,0,0,0,0.49353874091423283,0.5064612590857671
87664,0.5121951219512195,0.5305164319248826,-105,-113,0.4903184724049234,0.5096815275950766,away,PHI,over,8,0.5073891625615764,-103,0.4837652908580103,ATL,PHI,2022 REG,11,3,10,7,10,21,0,1,-4,4,1,1,1,0,0,0,0,0,0,0.4837652908580103,0.5162347091419897
87664,0.5121951219512195,0.5305164319248826,-105,-113,0.4903184724049234,0.5096815275950766,home,ATL,under,8,0.5391705069124424,-117,0.5162347091419897,ATL,PHI,2022 REG,11,3,10,7,10,21,0,1,-4,4,1,1,1,0,0,0,0,0,0,0.4837652908580103,0.5162347091419897
87665,0.5391705069124424,0.5,-117,100,0.5180509248444435,0.4819490751555565,away,CHC,over,8.5,0.5145631067961165,-106,0.4913668392989033,PIT,CHC,2022 REG,11,12,10,1,13,21,1,0,11,-11,1,0,0,0,0,0,0,0,0,0.4913668392989033,0.5086331607010968
87665,0.5391705069124424,0.5,-117,100,0.5180509248444435,0.4819490751555565,home,PIT,under,8.5,0.5305164319248826,-113,0.5086331607010968,PIT,CHC,2022 REG,11,12,10,1,13,21,1,0,11,-11,1,0,0,0,0,0,0,0,0,0.4913668392989033,0.5086331607010968
87666,0.6226415094339623,0.4166666666666667,-165,140,0.5981666073335706,0.40183339266642937,away,DET,over,7,0.49504950495049505,102,0.4739797934813417,OAK,DET,2022 REG,10,5,5,0,5,15,1,0,5,-5,0,0,0,0,0,0,0,0,0,0.4739797934813417,0.5260202065186583
87666,0.6226415094339623,0.4166666666666667,-165,140,0.5981666073335706,0.40183339266642937,home,OAK,under,7,0.5475113122171946,-121,0.5260202065186583,OAK,DET,2022 REG,10,5,5,0,5,15,1,0,5,-5,0,0,0,0,0,0,0,0,0,0.4739797934813417,0.5260202065186583
87667,0.5726495726495727,0.4716981132075471,-134,112,0.5472538892954956,0.45274611070450443,away,ARI,over,11,0.5327102803738317,-114,0.508788710910954,CHC,ARI,2022 REG,8,6,12,10,16,20,0,1,-4,4,1,1,1,1,1,1,0,0,0,0.508788710910954,0.491211289089046
87667,0.5726495726495727,0.4716981132075471,-134,112,0.5472538892954956,0.45274611070450443,home,CHC,under,11,0.5121951219512195,-105,0.491211289089046,CHC,ARI,2022 REG,8,6,12,10,16,20,0,1,-4,4,1,1,1,1,1,1,0,0,0,0.508788710910954,0.491211289089046
87668,0.75,0.2898550724637681,-300,245,0.720108695652174,0.27989130434782605,away,MIN,over,7.5,0.5348837209302326,-115,0.5097020142727117,HOU,MIN,2022 REG,12,4,6,2,6,18,1,0,2,-2,1,1,0,0,0,0,0,0,0,0.5097020142727117,0.49029798572728833
87668,0.75,0.2898550724637681,-300,245,0.720108695652174,0.27989130434782605,home,HOU,under,7.5,0.5121951219512195,-105,0.49029798572728833,HOU,MIN,2022 REG,12,4,6,2,6,18,1,0,2,-2,1,1,0,0,0,0,0,0,0,0.5097020142727117,0.49029798572728833
87669,0.6923076923076923,0.3472222222222222,-225,188,0.6649408284023669,0.3350591715976331,away,ARI,over,8.5,0.5391705069124424,-117,0.5140669063204599,CLE,ARI,2022 REG,9,7,9,4,11,18,1,0,3,-3,1,1,1,1,0,0,0,0,0,0.5140669063204599,0.4859330936795401
87669,0.6923076923076923,0.3472222222222222,-225,188,0.6649408284023669,0.3350591715976331,home,CLE,under,8.5,0.5073891625615764,-103,0.4859330936795401,CLE,ARI,2022 REG,9,7,9,4,11,18,1,0,3,-3,1,1,1,1,0,0,0,0,0,0.5140669063204599,0.4859330936795401
87670,0.574468085106383,0.46511627906976744,-135,115,0.5517281312179562,0.44827186878204384,away,MIN,over,7.5,0.5391705069124424,-117,0.5140669063204599,SD,MIN,2022 REG,9,10,5,1,11,14,1,0,9,-9,1,0,0,0,0,0,0,0,0,0.5140669063204599,0.4859330936795401
87670,0.574468085106383,0.46511627906976744,-135,115,0.5517281312179562,0.44827186878204384,home,SD,under,7.5,0.5073891625615764,-103,0.4859330936795401,SD,MIN,2022 REG,9,10,5,1,11,14,1,0,9,-9,1,0,0,0,0,0,0,0,0,0.5140669063204599,0.4859330936795401
87671,0.5967741935483871,0.4424778761061947,-148,126,0.5733495713351688,0.42665042866483116,away,TB,over,9.5,0.5098039215686274,-104,0.48483656587239576,TOR,TB,2022 REG,9,4,5,1,5,14,1,0,3,-3,1,0,0,0,0,0,0,0,0,0.48483656587239576,0.5151634341276042
87671,0.5967741935483871,0.4424778761061947,-148,126,0.5733495713351688,0.42665042866483116,home,TOR,under,9.5,0.5391705069124424,-117,0.5151634341276042,TOR,TB,2022 REG,9,4,5,1,5,14,1,0,3,-3,1,0,0,0,0,0,0,0,0,0.48483656587239576,0.5151634341276042
87672,0.5495495495495495,0.49019607843137253,-122,104,0.5277073575960698,0.4722926424039302,away,LAA,over,7,0.5098039215686274,-104,0.48592421718142587,CWS,LAA,2022 REG,3,1,13,5,6,16,0,1,-4,4,1,0,0,0,0,0,0,0,0,0.48592421718142587,0.5140757828185741
87672,0.5495495495495495,0.49019607843137253,-122,104,0.5277073575960698,0.4722926424039302,home,CWS,under,7,0.5370370370370371,-116,0.5140757828185741,CWS,LAA,2022 REG,3,1,13,5,6,16,0,1,-4,4,1,0,0,0,0,0,0,0,0,0.48592421718142587,0.5140757828185741
87673,0.5348837209302326,0.5,-115,100,0.5162249864791779,0.4837750135208221,away,HOU,over,9,0.5098039215686274,-104,0.4870219861770517,BOS,HOU,2022 REG,13,4,15,13,17,28,0,1,-9,9,1,1,1,1,0,0,0,0,0,0.4870219861770517,0.5129780138229483
87673,0.5348837209302326,0.5,-115,100,0.5162249864791779,0.4837750135208221,home,BOS,under,9,0.5348837209302326,-115,0.5129780138229483,BOS,HOU,2022 REG,13,4,15,13,17,28,0,1,-9,9,1,1,1,1,0,0,0,0,0,0.4870219861770517,0.5129780138229483
87674,0.5884773662551441,0.45454545454545453,-143,120,0.5631594099815408,0.4368405900184592,away,CHC,over,8,0.5238095238095238,-110,0.4988662131519274,SF,CHC,2022 REG,7,4,3,2,6,10,1,0,2,-2,1,1,0,0,0,0,0,0,0,0.4988662131519274,0.5011337868480725
87674,0.5884773662551441,0.45454545454545453,-143,120,0.5631594099815408,0.4368405900184592,home,SF,under,8,0.5238095238095238,-110,0.5011337868480725,SF,CHC,2022 REG,7,4,3,2,6,10,1,0,2,-2,1,1,0,0,0,0,0,0,0,0.4988662131519274,0.5011337868480725
87675,0.5594713656387665,0.47619047619047616,-127,110,0.5395195862893665,0.46048041371063353,away,TB,over,6,0.5454545454545454,-120,0.5206611570247933,CLE,TB,2022 REG,5,2,6,1,3,11,1,0,1,-1,1,0,0,0,0,0,0,0,0,0.5206611570247933,0.4793388429752067
87675,0.5594713656387665,0.47619047619047616,-127,110,0.5395195862893665,0.46048041371063353,home,CLE,under,6,0.5,100,0.4793388429752067,CLE,TB,2022 REG,5,2,6,1,3,11,1,0,1,-1,1,0,0,0,0,0,0,0,0,0.5206611570247933,0.4793388429752067
87676,0.5555555555555556,0.48780487804878053,-125,105,0.5314664257753688,0.46853357422463116,away,NYY,over,7.5,0.49504950495049505,102,0.47499799484898986,HOU,NYY,2022 REG,10,3,5,2,5,15,1,0,1,-1,1,1,0,0,0,0,0,0,0,0.47499799484898986,0.5250020051510101
87676,0.5555555555555556,0.48780487804878053,-125,105,0.5314664257753688,0.46853357422463116,home,HOU,under,7.5,0.5454545454545454,-120,0.5250020051510101,HOU,NYY,2022 REG,10,3,5,2,5,15,1,0,1,-1,1,1,0,0,0,0,0,0,0,0.47499799484898986,0.5250020051510101
87677,0.6226415094339623,0.4166666666666667,-165,140,0.5981666073335706,0.40183339266642937,away,ATL,over,7,0.5238095238095238,-110,0.4988662131519274,PHI,ATL,2022 REG,10,9,6,1,10,16,1,0,8,-8,1,0,0,0,0,0,0,0,0,0.4988662131519274,0.5011337868480725
87677,0.6226415094339623,0.4166666666666667,-165,140,0.5981666073335706,0.40183339266642937,home,PHI,under,7,0.5238095238095238,-110,0.5011337868480725,PHI,ATL,2022 REG,10,9,6,1,10,16,1,0,8,-8,1,0,0,0,0,0,0,0,0,0.4988662131519274,0.5011337868480725
87678,0.4629629629629629,0.5780590717299579,116,-137,0.4439712802347588,0.5560287197652412,away,CWS,over,8,0.5391705069124424,-117,0.5140669063204599,CLE,CWS,2022 REG,13,6,8,3,9,21,1,0,3,-3,1,1,1,0,0,0,0,0,0,0.5140669063204599,0.4859330936795401
87678,0.4629629629629629,0.5780590717299579,116,-137,0.4439712802347588,0.5560287197652412,home,CLE,under,8,0.5073891625615764,-103,0.4859330936795401,CLE,CWS,2022 REG,13,6,8,3,9,21,1,0,3,-3,1,1,1,0,0,0,0,0,0,0.5140669063204599,0.4859330936795401
87679,0.6183206106870228,0.42016806722689076,-162,138,0.5945222678547557,0.4054777321452443,away,WSH,over,9,0.5391705069124424,-117,0.5127649394825569,CIN,WSH,2022 REG,13,4,7,5,9,20,0,1,-1,1,1,1,1,1,0,0,0,0,0,0.5127649394825569,0.48723506051744314
87679,0.6183206106870228,0.42016806722689076,-162,138,0.5945222678547557,0.4054777321452443,home,CIN,under,9,0.5098039215686274,-104,0.48723506051744314,CIN,WSH,2022 REG,13,4,7,5,9,20,0,1,-1,1,1,1,1,1,0,0,0,0,0,0.5127649394825569,0.48723506051744314
87680,0.37037037037037035,0.6666666666666666,170,-200,0.35665294924554186,0.6433470507544581,away,HOU,over,7,0.5348837209302326,-115,0.5097020142727117,SEA,HOU,2022 REG,10,6,9,1,7,19,1,0,5,-5,1,0,0,0,0,0,0,0,0,0.5097020142727117,0.49029798572728833
87680,0.37037037037037035,0.6666666666666666,170,-200,0.35665294924554186,0.6433470507544581,home,SEA,under,7,0.5121951219512195,-105,0.49029798572728833,SEA,HOU,2022 REG,10,6,9,1,7,19,1,0,5,-5,1,0,0,0,0,0,0,0,0,0.5097020142727117,0.49029798572728833
87681,0.5121951219512195,0.5348837209302326,-105,-115,0.48808156828023186,0.5119184317197681,away,MIN,over,8,0.5348837209302326,-115,0.5097020142727117,LAA,MIN,2022 REG,8,5,10,3,8,18,1,0,2,-2,1,1,1,0,0,0,0,0,0,0.5097020142727117,0.49029798572728833
87681,0.5121951219512195,0.5348837209302326,-105,-115,0.48808156828023186,0.5119184317197681,home,LAA,under,8,0.5121951219512195,-105,0.49029798572728833,LAA,MIN,2022 REG,8,5,10,3,8,18,1,0,2,-2,1,1,1,0,0,0,0,0,0,0.5097020142727117,0.49029798572728833
87682,0.4166666666666667,0.6226415094339623,140,-165,0.4002882599580712,0.5997117400419287,away,PHI,over,8,0.5238095238095238,-110,0.5000596729920038,WSH,PHI,2022 REG,5,1,5,2,3,10,0,1,-1,1,1,0,0,0,0,0,0,0,0,0.5000596729920038,0.4999403270079962
87682,0.4166666666666667,0.6226415094339623,140,-165,0.4002882599580712,0.5997117400419287,home,WSH,under,8,0.5215311004784688,-109,0.4999403270079962,WSH,PHI,2022 REG,5,1,5,2,3,10,0,1,-1,1,1,0,0,0,0,0,0,0,0,0.5000596729920038,0.4999403270079962
87683,0.5652173913043479,0.47619047619047616,-130,110,0.5418129444594474,0.4581870555405526,away,LAA,over,9,0.5215311004784688,-109,0.4978845547971712,NYY,LAA,2022 REG,13,9,7,1,10,20,1,0,8,-8,1,0,0,0,0,0,0,0,0,0.4978845547971712,0.5021154452028288
87683,0.5652173913043479,0.47619047619047616,-130,110,0.5418129444594474,0.4581870555405526,home,NYY,under,9,0.5238095238095238,-110,0.5021154452028288,NYY,LAA,2022 REG,13,9,7,1,10,20,1,0,8,-8,1,0,0,0,0,0,0,0,0,0.4978845547971712,0.5021154452028288
87684,0.5555555555555556,0.48309178743961345,-125,107,0.5340848094471283,0.46591519055287167,away,SEA,over,8,0.5391705069124424,-117,0.5127649394825569,TEX,SEA,2022 REG,9,5,12,6,11,21,0,1,-1,1,1,1,1,1,1,0,0,0,0,0.5127649394825569,0.48723506051744314
87684,0.5555555555555556,0.48309178743961345,-125,107,0.5340848094471283,0.46591519055287167,home,TEX,under,8,0.5098039215686274,-104,0.48723506051744314,TEX,SEA,2022 REG,9,5,12,6,11,21,0,1,-1,1,1,1,1,1,1,0,0,0,0,0.5127649394825569,0.48723506051744314
87685,0.4,0.6491228070175439,150,-185,0.38035087719298244,0.6196491228070176,away,NYY,over,8.5,0.5192307692307692,-108,0.49688292476754015,CLE,NYY,2022 REG,7,1,7,6,7,14,0,1,-5,5,1,0,0,0,0,0,0,0,0,0.49688292476754015,0.5031170752324599
87685,0.4,0.6491228070175439,150,-185,0.38035087719298244,0.6196491228070176,home,CLE,under,8.5,0.5238095238095238,-110,0.5031170752324599,CLE,NYY,2022 REG,7,1,7,6,7,14,0,1,-5,5,1,0,0,0,0,0,0,0,0,0.49688292476754015,0.5031170752324599
87686,0.47619047619047616,0.5555555555555556,110,-125,0.46107331821617537,0.5389266817838246,away,CLE,over,8,0.5238095238095238,-110,0.5012646084074657,BAL,CLE,2022 REG,4,5,5,4,9,9,1,0,1,-1,1,1,1,1,0,0,0,0,0,0.5012646084074657,0.4987353915925343
87686,0.47619047619047616,0.5555555555555556,110,-125,0.46107331821617537,0.5389266817838246,home,BAL,under,8,0.5192307692307692,-108,0.4987353915925343,BAL,CLE,2022 REG,4,5,5,4,9,9,1,0,1,-1,1,1,1,1,0,0,0,0,0,0.5012646084074657,0.4987353915925343
87687,0.5412844036697247,0.5,-118,100,0.5189377998484975,0.4810622001515025,away,CLE,over,8.5,0.5283018867924528,-112,0.5031902949311281,TOR,CLE,2022 REG,6,2,6,1,3,12,1,0,1,-1,1,0,0,0,0,0,0,0,0,0.5031902949311281,0.4968097050688719
87687,0.5412844036697247,0.5,-118,100,0.5189377998484975,0.4810622001515025,home,TOR,under,8.5,0.5192307692307692,-108,0.4968097050688719,TOR,CLE,2022 REG,6,2,6,1,3,12,1,0,1,-1,1,0,0,0,0,0,0,0,0,0.5031902949311281,0.4968097050688719
87688,0.6226415094339623,0.4166666666666667,-165,140,0.5981666073335706,0.40183339266642937,away,WSH,over,7.5,0.5215311004784688,-109,0.49907282342437215,CHC,WSH,2022 REG,9,4,9,2,6,18,1,0,2,-2,1,1,0,0,0,0,0,0,0,0.49907282342437215,0.5009271765756278
87688,0.6226415094339623,0.4166666666666667,-165,140,0.5981666073335706,0.40183339266642937,home,CHC,under,7.5,0.5215311004784688,-109,0.5009271765756278,CHC,WSH,2022 REG,9,4,9,2,6,18,1,0,2,-2,1,1,0,0,0,0,0,0,0,0.49907282342437215,0.5009271765756278
87689,0.4672897196261683,0.5726495726495727,114,-134,0.44862649893656975,0.5513735010634302,away,ATL,over,9,0.5121951219512195,-105,0.48808156828023186,PHI,ATL,2022 REG,4,1,8,4,5,12,0,1,-3,3,1,0,0,0,0,0,0,0,0,0.48808156828023186,0.5119184317197681
87689,0.4672897196261683,0.5726495726495727,114,-134,0.44862649893656975,0.5513735010634302,home,PHI,under,9,0.5348837209302326,-115,0.5119184317197681,PHI,ATL,2022 REG,4,1,8,4,5,12,0,1,-3,3,1,0,0,0,0,0,0,0,0,0.48808156828023186,0.5119184317197681
87690,0.42016806722689076,0.6108949416342413,138,-157,0.4071163828314571,0.5928836171685429,away,CHC,over,9,0.504950495049505,-102,0.4826715732667395,WSH,CHC,2022 REG,6,2,5,3,5,11,0,1,-1,1,1,1,0,0,0,0,0,0,0,0.4826715732667395,0.5173284267332605
87690,0.42016806722689076,0.6108949416342413,138,-157,0.4071163828314571,0.5928836171685429,home,WSH,under,9,0.5391705069124424,-117,0.5173284267332605,WSH,CHC,2022 REG,6,2,5,3,5,11,0,1,-1,1,1,1,0,0,0,0,0,0,0,0.4826715732667395,0.5173284267332605
87691,0.31746031746031744,0.7142857142857143,215,-250,0.30738221214411693,0.692617787855883,away,NYY,over,7.5,0.5412844036697247,-118,0.5189377998484975,BAL,NYY,2022 REG,7,2,6,3,5,13,0,1,-1,1,1,1,0,0,0,0,0,0,0,0.5189377998484975,0.4810622001515025
87691,0.31746031746031744,0.7142857142857143,215,-250,0.30738221214411693,0.692617787855883,home,BAL,under,7.5,0.5,100,0.4810622001515025,BAL,NYY,2022 REG,7,2,6,3,5,13,0,1,-1,1,1,1,0,0,0,0,0,0,0,0.5189377998484975,0.4810622001515025
87692,0.49019607843137253,0.5475113122171946,104,-121,0.47171206340756505,0.5282879365924349,away,BOS,over,7.5,0.504950495049505,-102,0.4826715732667395,OAK,BOS,2022 REG,4,0,14,8,8,18,0,1,-8,8,0,0,0,0,0,0,0,0,0,0.4826715732667395,0.5173284267332605
87692,0.49019607843137253,0.5475113122171946,104,-121,0.47171206340756505,0.5282879365924349,home,OAK,under,7.5,0.5391705069124424,-117,0.5173284267332605,OAK,BOS,2022 REG,4,0,14,8,8,18,0,1,-8,8,0,0,0,0,0,0,0,0,0,0.4826715732667395,0.5173284267332605
87693,0.576271186440678,0.46511627906976744,-136,115,0.552420782587201,0.44757921741279905,away,ATL,over,8.5,0.5283018867924528,-112,0.5019750255927206,NYM,ATL,2022 REG,12,6,14,9,15,26,0,1,-3,3,1,1,1,1,1,1,0,0,0,0.5019750255927206,0.49802497440727944
87693,0.576271186440678,0.46511627906976744,-136,115,0.552420782587201,0.44757921741279905,home,NYM,under,8.5,0.5215311004784688,-109,0.49802497440727944,NYM,ATL,2022 REG,12,6,14,9,15,26,0,1,-3,3,1,1,1,1,1,1,0,0,0,0.5019750255927206,0.49802497440727944
87694,0.5145631067961165,0.5238095238095238,-106,-110,0.4948179667757384,0.5051820332242616,away,TOR,over,7.5,0.5391705069124424,-117,0.5140669063204599,LAA,TOR,2022 REG,7,3,11,4,7,18,0,1,-1,1,1,1,1,0,0,0,0,0,0,0.5140669063204599,0.4859330936795401
87694,0.5145631067961165,0.5238095238095238,-106,-110,0.4948179667757384,0.5051820332242616,home,LAA,under,7.5,0.5073891625615764,-103,0.4859330936795401,LAA,TOR,2022 REG,7,3,11,4,7,18,0,1,-1,1,1,1,1,0,0,0,0,0,0,0.5140669063204599,0.4859330936795401
87695,0.6825396825396826,0.35714285714285715,-215,180,0.6554547745023935,0.34454522549760647,away,BOS,over,7.5,0.5073891625615764,-103,0.48484779035144243,TOR,BOS,2022 REG,9,6,8,3,9,17,1,0,3,-3,1,1,1,0,0,0,0,0,0,0.48484779035144243,0.5151522096485576
87695,0.6825396825396826,0.35714285714285715,-215,180,0.6554547745023935,0.34454522549760647,home,TOR,under,7.5,0.5370370370370371,-116,0.5151522096485576,TOR,BOS,2022 REG,9,6,8,3,9,17,1,0,3,-3,1,1,1,0,0,0,0,0,0,0.48484779035144243,0.5151522096485576
87696,0.6031746031746031,0.4347826086956522,-152,130,0.5802797769671475,0.4197202230328525,away,DET,over,8.5,0.5098039215686274,-104,0.4870219861770517,BAL,DET,2022 REG,9,8,3,1,9,12,1,0,7,-7,1,0,0,0,0,0,0,0,0,0.4870219861770517,0.5129780138229483
87696,0.6031746031746031,0.4347826086956522,-152,130,0.5802797769671475,0.4197202230328525,home,BAL,under,8.5,0.5348837209302326,-115,0.5129780138229483,BAL,DET,2022 REG,9,8,3,1,9,12,1,0,7,-7,1,0,0,0,0,0,0,0,0,0.4870219861770517,0.5129780138229483
87697,0.6323529411764706,0.4098360655737705,-172,144,0.6056745986726416,0.3943254013273584,away,KC,over,7.5,0.5073891625615764,-103,0.4826927225525911,STL,KC,2022 REG,4,1,5,0,1,9,1,0,1,-1,0,0,0,0,0,0,0,0,0,0.4826927225525911,0.5173072774474089
87697,0.6323529411764706,0.4098360655737705,-172,144,0.6056745986726416,0.3943254013273584,home,STL,under,7.5,0.5412844036697247,-118,0.5173072774474089,STL,KC,2022 REG,4,1,5,0,1,9,1,0,1,-1,0,0,0,0,0,0,0,0,0,0.4826927225525911,0.5173072774474089
87698,0.7142857142857143,0.33783783783783783,-250,196,0.6770546056260343,0.32294539437396574,away,DET,over,8.5,0.5,100,0.47935779816513757,CLE,DET,2022 REG,10,4,5,0,4,15,1,0,4,-4,0,0,0,0,0,0,0,0,0,0.47935779816513757,0.5206422018348624
87698,0.7142857142857143,0.33783783783783783,-250,196,0.6770546056260343,0.32294539437396574,home,CLE,under,8.5,0.5412844036697247,-118,0.5206422018348624,CLE,DET,2022 REG,10,4,5,0,4,15,1,0,4,-4,0,0,0,0,0,0,0,0,0,0.47935779816513757,0.5206422018348624
87699,0.425531914893617,0.6183206106870228,135,-162,0.406871265710366,0.593128734289634,away,HOU,over,8,0.5433789954337899,-119,0.5198077604720502,BAL,HOU,2022 REG,8,3,9,6,9,17,0,1,-3,3,1,1,1,0,0,0,0,0,0,0.5198077604720502,0.48019223952794976
87699,0.425531914893617,0.6183206106870228,135,-162,0.406871265710366,0.593128734289634,home,BAL,under,8,0.5,100,0.48019223952794976,BAL,HOU,2022 REG,8,3,9,6,9,17,0,1,-3,3,1,1,1,0,0,0,0,0,0,0.5198077604720502,0.48019223952794976
87700,0.6666666666666666,0.37037037037037035,-200,170,0.6419753086419753,0.3580246913580247,away,BOS,over,8,0.5121951219512195,-105,0.48919479393107135,TOR,BOS,2022 REG,13,9,3,0,9,16,1,0,9,-9,0,0,0,0,0,0,0,0,0,0.48919479393107135,0.5108052060689287
87700,0.6666666666666666,0.37037037037037035,-200,170,0.6419753086419753,0.3580246913580247,home,TOR,under,8,0.5327102803738317,-114,0.5108052060689287,TOR,BOS,2022 REG,13,9,3,0,9,16,1,0,9,-9,0,0,0,0,0,0,0,0,0,0.48919479393107135,0.5108052060689287
87701,0.5918367346938775,0.4444444444444444,-145,125,0.5703642001018094,0.42963579989819056,away,ARI,over,8.5,0.5412844036697247,-118,0.5136310900085983,PHI,ARI,2022 REG,12,7,7,5,12,19,1,0,2,-2,1,1,1,1,1,0,0,0,0,0.5136310900085983,0.4863689099914017
87701,0.5918367346938775,0.4444444444444444,-145,125,0.5703642001018094,0.42963579989819056,home,PHI,under,8.5,0.5098039215686274,-104,0.4863689099914017,PHI,ARI,2022 REG,12,7,7,5,12,19,1,0,2,-2,1,1,1,1,1,0,0,0,0,0.5136310900085983,0.4863689099914017
87702,0.6453900709219857,0.3921568627450981,-182,155,0.6211576527396834,0.3788423472603166,away,CLE,over,7.5,0.5169082125603864,-107,0.49586088023391106,CWS,CLE,2022 REG,7,9,12,12,21,19,0,1,-3,3,1,1,1,1,1,1,1,1,1,0.49586088023391106,0.5041391197660889
87702,0.6453900709219857,0.3921568627450981,-182,155,0.6211576527396834,0.3788423472603166,home,CWS,under,7.5,0.5238095238095238,-110,0.5041391197660889,CWS,CLE,2022 REG,7,9,12,12,21,19,0,1,-3,3,1,1,1,1,1,1,1,1,1,0.49586088023391106,0.5041391197660889
87703,0.5575221238938054,0.4807692307692307,-126,108,0.5361738465152985,0.46382615348470146,away,SD,over,8,0.5305164319248826,-113,0.5066009958897986,PHI,SD,2022 REG,8,0,10,2,2,18,0,1,-2,2,0,0,0,0,0,0,0,0,0,0.5066009958897986,0.49339900411020143
87703,0.5575221238938054,0.4807692307692307,-126,108,0.5361738465152985,0.46382615348470146,home,PHI,under,8,0.5145631067961165,-106,0.49339900411020143,PHI,SD,2022 REG,8,0,10,2,2,18,0,1,-2,2,0,0,0,0,0,0,0,0,0,0.5066009958897986,0.49339900411020143
87704,0.37735849056603776,0.6666666666666666,165,-200,0.36074522368577194,0.639254776314228,away,PHI,over,8,0.5073891625615764,-103,0.4837652908580103,PIT,PHI,2022 REG,7,7,15,8,15,22,0,1,-1,1,1,1,1,1,1,1,1,0,0,0.4837652908580103,0.5162347091419897
87704,0.37735849056603776,0.6666666666666666,165,-200,0.36074522368577194,0.639254776314228,home,PIT,under,8,0.5391705069124424,-117,0.5162347091419897,PIT,PHI,2022 REG,7,7,15,8,15,22,0,1,-1,1,1,1,1,1,1,1,1,0,0,0.4837652908580103,0.5162347091419897
87705,0.7701149425287357,0.27027027027027023,-335,270,0.7390136866950185,0.26098631330498145,away,ARI,over,8.5,0.5348837209302326,-115,0.5097020142727117,LAD,ARI,2022 REG,3,1,7,6,7,10,0,1,-5,5,1,0,0,0,0,0,0,0,0,0.5097020142727117,0.49029798572728833
87705,0.7701149425287357,0.27027027027027023,-335,270,0.7390136866950185,0.26098631330498145,home,LAD,under,8.5,0.5121951219512195,-105,0.49029798572728833,LAD,ARI,2022 REG,3,1,7,6,7,10,0,1,-5,5,1,0,0,0,0,0,0,0,0,0.5097020142727117,0.49029798572728833
87706,0.6551724137931035,0.3802281368821293,-190,163,0.6319789495576061,0.36802105044239386,away,CHC,over,9,0.5,100,0.4772727272727273,STL,CHC,2022 REG,8,5,11,6,11,19,0,1,-1,1,1,1,1,1,1,0,0,0,0,0.4772727272727273,0.5227272727272727
87706,0.6551724137931035,0.3802281368821293,-190,163,0.6319789495576061,0.36802105044239386,home,STL,under,9,0.5454545454545454,-120,0.5227272727272727,STL,CHC,2022 REG,8,5,11,6,11,19,0,1,-1,1,1,1,1,1,1,0,0,0,0,0.4772727272727273,0.5227272727272727
87707,0.6666666666666666,0.37735849056603776,-200,165,0.6373165618448637,0.36268343815513626,away,LAA,over,8.5,0.5391705069124424,-117,0.5153817639191344,LAD,LAA,2022 REG,3,2,3,0,2,6,1,0,2,-2,0,0,0,0,0,0,0,0,0,0.5153817639191344,0.4846182360808656
87707,0.6666666666666666,0.37735849056603776,-200,165,0.6373165618448637,0.36268343815513626,home,LAD,under,8.5,0.504950495049505,-102,0.4846182360808656,LAD,LAA,2022 REG,3,2,3,0,2,6,1,0,2,-2,0,0,0,0,0,0,0,0,0,0.5153817639191344,0.4846182360808656
87708,0.3846153846153846,0.6503496503496503,160,-186,0.3711672942442173,0.6288327057557828,away,SF,over,8.5,0.5305164319248826,-113,0.5053568787472517,PIT,SF,2022 REG,8,4,4,3,7,12,1,0,1,-1,1,1,1,0,0,0,0,0,0,0.5053568787472517,0.49464312125274834
87708,0.3846153846153846,0.6503496503496503,160,-186,0.3711672942442173,0.6288327057557828,home,PIT,under,8.5,0.5169082125603864,-107,0.49464312125274834,PIT,SF,2022 REG,8,4,4,3,7,12,1,0,1,-1,1,1,1,0,0,0,0,0,0,0.5053568787472517,0.49464312125274834
87709,0.574468085106383,0.46511627906976744,-135,115,0.5517281312179562,0.44827186878204384,away,COL,over,8.5,0.5145631067961165,-106,0.4891195935000339,ARI,COL,2022 REG,8,6,12,5,11,20,1,0,1,-1,1,1,1,1,1,0,0,0,0,0.4891195935000339,0.5108804064999661
87709,0.574468085106383,0.46511627906976744,-135,115,0.5517281312179562,0.44827186878204384,home,ARI,under,8.5,0.5348837209302326,-115,0.5108804064999661,ARI,COL,2022 REG,8,6,12,5,11,20,1,0,1,-1,1,1,1,1,1,0,0,0,0,0.4891195935000339,0.5108804064999661
87710,0.7333333333333333,0.3076923076923077,-275,225,0.7032478632478633,0.29675213675213674,away,MIA,over,8,0.5215311004784688,-109,0.4978845547971712,LAD,MIA,2022 REG,6,2,5,1,3,11,1,0,1,-1,1,0,0,0,0,0,0,0,0,0.4978845547971712,0.5021154452028288
87710,0.7333333333333333,0.3076923076923077,-275,225,0.7032478632478633,0.29675213675213674,home,LAD,under,8,0.5238095238095238,-110,0.5021154452028288,LAD,MIA,2022 REG,6,2,5,1,3,11,1,0,1,-1,1,0,0,0,0,0,0,0,0,0.4978845547971712,0.5021154452028288
87711,0.5454545454545454,0.5,-120,100,0.5206611570247933,0.4793388429752067,away,CIN,over,7.5,0.5370370370370371,-116,0.5118817074154765,PIT,CIN,2022 REG,9,4,7,3,7,16,1,0,1,-1,1,1,1,0,0,0,0,0,0,0.5118817074154765,0.48811829258452355
87711,0.5454545454545454,0.5,-120,100,0.5206611570247933,0.4793388429752067,home,PIT,under,7.5,0.5098039215686274,-104,0.48811829258452355,PIT,CIN,2022 REG,9,4,7,3,7,16,1,0,1,-1,1,1,1,0,0,0,0,0,0,0.5118817074154765,0.48811829258452355
87712,0.41152263374485604,0.6254681647940076,143,-167,0.39630008290581753,0.6036999170941825,away,SD,over,8.5,0.5283018867924528,-112,0.5031902949311281,DET,SD,2022 REG,13,12,10,4,16,23,1,0,8,-8,1,1,1,1,0,0,0,0,0,0.5031902949311281,0.4968097050688719
87712,0.41152263374485604,0.6254681647940076,143,-167,0.39630008290581753,0.6036999170941825,home,DET,under,8.5,0.5192307692307692,-108,0.4968097050688719,DET,SD,2022 REG,13,12,10,4,16,23,1,0,8,-8,1,1,1,1,0,0,0,0,0,0.5031902949311281,0.4968097050688719
87713,0.6296296296296295,0.4081632653061224,-170,145,0.6058341031886005,0.39416589681139946,away,BAL,over,9,0.5073891625615764,-103,0.4837652908580103,CWS,BAL,2022 REG,1,1,5,4,5,6,0,1,-3,3,1,0,0,0,0,0,0,0,0,0.4837652908580103,0.5162347091419897
87713,0.6296296296296295,0.4081632653061224,-170,145,0.6058341031886005,0.39416589681139946,home,CWS,under,9,0.5391705069124424,-117,0.5162347091419897,CWS,BAL,2022 REG,1,1,5,4,5,6,0,1,-3,3,1,0,0,0,0,0,0,0,0,0.4837652908580103,0.5162347091419897
87714,0.726027397260274,0.3125,-265,220,0.6980554513041847,0.30194454869581533,away,KC,over,9,0.5121951219512195,-105,0.48808156828023186,HOU,KC,2022 REG,7,7,11,6,13,18,1,0,1,-1,1,1,1,1,1,1,0,0,0,0.48808156828023186,0.5119184317197681
87714,0.726027397260274,0.3125,-265,220,0.6980554513041847,0.30194454869581533,home,HOU,under,9,0.5348837209302326,-115,0.5119184317197681,HOU,KC,2022 REG,7,7,11,6,13,18,1,0,1,-1,1,1,1,1,1,1,0,0,0,0.48808156828023186,0.5119184317197681
87715,0.48780487804878053,0.5475113122171946,105,-121,0.470577468162939,0.529422531837061,away,NYY,over,8,0.5238095238095238,-110,0.5012646084074657,MIL,NYY,2022 REG,10,7,11,6,13,21,1,0,1,-1,1,1,1,1,1,1,0,0,0,0.5012646084074657,0.4987353915925343
87715,0.48780487804878053,0.5475113122171946,105,-121,0.470577468162939,0.529422531837061,home,MIL,under,8,0.5192307692307692,-108,0.4987353915925343,MIL,NYY,2022 REG,10,7,11,6,13,21,1,0,1,-1,1,1,1,1,1,1,0,0,0,0.5012646084074657,0.4987353915925343
87716,0.5652173913043479,0.47619047619047616,-130,110,0.5418129444594474,0.4581870555405526,away,ARI,over,7.5,0.5238095238095238,-110,0.4988662131519274,SF,ARI,2022 REG,9,4,8,3,7,17,1,0,1,-1,1,1,1,0,0,0,0,0,0,0.4988662131519274,0.5011337868480725
87716,0.5652173913043479,0.47619047619047616,-130,110,0.5418129444594474,0.4581870555405526,home,SF,under,7.5,0.5238095238095238,-110,0.5011337868480725,SF,ARI,2022 REG,9,4,8,3,7,17,1,0,1,-1,1,1,1,0,0,0,0,0,0,0.4988662131519274,0.5011337868480725
87717,0.48780487804878053,0.5475113122171946,105,-121,0.470577468162939,0.529422531837061,away,ATL,over,7.5,0.5327102803738317,-114,0.508788710910954,NYM,ATL,2022 REG,8,5,5,4,9,13,1,0,1,-1,1,1,1,1,0,0,0,0,0,0.508788710910954,0.491211289089046
87717,0.48780487804878053,0.5475113122171946,105,-121,0.470577468162939,0.529422531837061,home,NYM,under,7.5,0.5121951219512195,-105,0.491211289089046,NYM,ATL,2022 REG,8,5,5,4,9,13,1,0,1,-1,1,1,1,1,0,0,0,0,0,0.508788710910954,0.491211289089046
87718,0.696969696969697,0.3389830508474576,-230,195,0.6719117212183469,0.32808827878165314,away,CHC,over,9.5,0.5215311004784688,-109,0.4978845547971712,TOR,CHC,2022 REG,7,5,10,7,12,17,0,1,-2,2,1,1,1,1,1,0,0,0,0,0.4978845547971712,0.5021154452028288
87718,0.696969696969697,0.3389830508474576,-230,195,0.6719117212183469,0.32808827878165314,home,TOR,under,9.5,0.5238095238095238,-110,0.5021154452028288,TOR,CHC,2022 REG,7,5,10,7,12,17,0,1,-2,2,1,1,1,1,1,0,0,0,0,0.4978845547971712,0.5021154452028288
87719,0.607843137254902,0.4347826086956522,-155,130,0.5819333701084867,0.41806662989151333,away,BOS,over,8,0.5121951219512195,-105,0.48808156828023186,TOR,BOS,2022 REG,21,10,5,0,10,26,1,0,10,-10,0,0,0,0,0,0,0,0,0,0.48808156828023186,0.5119184317197681
87719,0.607843137254902,0.4347826086956522,-155,130,0.5819333701084867,0.41806662989151333,home,TOR,under,8,0.5348837209302326,-115,0.5119184317197681,TOR,BOS,2022 REG,21,10,5,0,10,26,1,0,10,-10,0,0,0,0,0,0,0,0,0,0.48808156828023186,0.5119184317197681
87720,0.425531914893617,0.6168582375478928,135,-161,0.407493552152549,0.592506447847451,away,BOS,over,9.5,0.5145631067961165,-106,0.4913668392989033,KC,BOS,2022 REG,11,13,10,5,18,21,1,0,8,-8,1,1,1,1,1,0,0,0,0,0.4913668392989033,0.5086331607010968
87720,0.425531914893617,0.6168582375478928,135,-161,0.407493552152549,0.592506447847451,home,KC,under,9.5,0.5305164319248826,-113,0.5086331607010968,KC,BOS,2022 REG,11,13,10,5,18,21,1,0,8,-8,1,1,1,1,1,0,0,0,0,0.4913668392989033,0.5086331607010968
87721,0.5967741935483871,0.43859649122807015,-148,128,0.5756658816656627,0.4243341183343373,away,STL,over,9.5,0.5238095238095238,-110,0.4988662131519274,ATL,STL,2022 REG,12,7,9,1,8,21,1,0,6,-6,1,0,0,0,0,0,0,0,0,0.4988662131519274,0.5011337868480725
87721,0.5967741935483871,0.43859649122807015,-148,128,0.5756658816656627,0.4243341183343373,home,ATL,under,9.5,0.5238095238095238,-110,0.5011337868480725,ATL,STL,2022 REG,12,7,9,1,8,21,1,0,6,-6,1,0,0,0,0,0,0,0,0,0.4988662131519274,0.5011337868480725
87722,0.5967741935483871,0.4444444444444444,-148,125,0.5721759741010521,0.42782402589894786,away,WSH,over,8.5,0.5145631067961165,-106,0.4913668392989033,MIA,WSH,2022 REG,10,7,9,4,11,19,1,0,3,-3,1,1,1,1,0,0,0,0,0,0.4913668392989033,0.5086331607010968
87722,0.5967741935483871,0.4444444444444444,-148,125,0.5721759741010521,0.42782402589894786,home,MIA,under,8.5,0.5305164319248826,-113,0.5086331607010968,MIA,WSH,2022 REG,10,7,9,4,11,19,1,0,3,-3,1,1,1,1,0,0,0,0,0,0.4913668392989033,0.5086331607010968
87723,0.574468085106383,0.4716981132075471,-135,112,0.547947077564338,0.452052922435662,away,TEX,over,6.5,0.5327102803738317,-114,0.5026015996406422,MIA,TEX,2022 REG,7,0,11,8,8,18,0,1,-8,8,0,0,0,0,0,0,0,0,0,0.5026015996406422,0.4973984003593578
87723,0.574468085106383,0.4716981132075471,-135,112,0.547947077564338,0.452052922435662,home,MIA,under,6.5,0.5238095238095238,-110,0.4973984003593578,MIA,TEX,2022 REG,7,0,11,8,8,18,0,1,-8,8,0,0,0,0,0,0,0,0,0,0.5026015996406422,0.4973984003593578
87724,0.5726495726495727,0.4716981132075471,-134,112,0.5472538892954956,0.45274611070450443,away,TEX,over,7.5,0.49019607843137253,104,0.46874141813588177,OAK,TEX,2022 REG,3,0,5,2,2,8,0,1,-2,2,0,0,0,0,0,0,0,0,0,0.46874141813588177,0.5312585818641182
87724,0.5726495726495727,0.4716981132075471,-134,112,0.5472538892954956,0.45274611070450443,home,OAK,under,7.5,0.5535714285714286,-124,0.5312585818641182,OAK,TEX,2022 REG,3,0,5,2,2,8,0,1,-2,2,0,0,0,0,0,0,0,0,0,0.46874141813588177,0.5312585818641182
87725,0.6226415094339623,0.4166666666666667,-165,140,0.5981666073335706,0.40183339266642937,away,TOR,over,8.5,0.5454545454545454,-120,0.5206611570247933,NYY,TOR,2022 REG,7,2,13,9,11,20,0,1,-7,7,1,1,0,0,0,0,0,0,0,0.5206611570247933,0.4793388429752067
87725,0.6226415094339623,0.4166666666666667,-165,140,0.5981666073335706,0.40183339266642937,home,NYY,under,8.5,0.5,100,0.4793388429752067,NYY,TOR,2022 REG,7,2,13,9,11,20,0,1,-7,7,1,1,0,0,0,0,0,0,0,0.5206611570247933,0.4793388429752067
87726,0.7101449275362319,0.3278688524590164,-245,205,0.6831496344961281,0.3168503655038719,away,OAK,over,9.5,0.5073891625615764,-103,0.4826927225525911,ATL,OAK,2022 REG,13,13,8,2,15,21,1,0,11,-11,1,1,0,0,0,0,0,0,0,0.4826927225525911,0.5173072774474089
87726,0.7101449275362319,0.3278688524590164,-245,205,0.6831496344961281,0.3168503655038719,home,ATL,under,9.5,0.5412844036697247,-118,0.5173072774474089,ATL,OAK,2022 REG,13,13,8,2,15,21,1,0,11,-11,1,1,0,0,0,0,0,0,0,0.4826927225525911,0.5173072774474089
87727,0.5073891625615764,0.5348837209302326,-103,-115,0.4859403596076043,0.5140596403923957,away,BOS,over,9,0.5454545454545454,-120,0.5206611570247933,KC,BOS,2022 REG,9,4,13,7,11,22,0,1,-3,3,1,1,1,1,0,0,0,0,0,0.5206611570247933,0.4793388429752067
87727,0.5073891625615764,0.5348837209302326,-103,-115,0.4859403596076043,0.5140596403923957,home,KC,under,9,0.5,100,0.4793388429752067,KC,BOS,2022 REG,9,4,13,7,11,22,0,1,-3,3,1,1,1,1,0,0,0,0,0,0.5206611570247933,0.4793388429752067
87728,0.5192307692307692,0.5238095238095238,-108,-110,0.49688292476754015,0.5031170752324599,away,SF,over,6.5,0.5454545454545454,-120,0.5206611570247933,SD,SF,2022 REG,3,1,7,3,4,10,0,1,-2,2,1,0,0,0,0,0,0,0,0,0.5206611570247933,0.4793388429752067
87728,0.5192307692307692,0.5238095238095238,-108,-110,0.49688292476754015,0.5031170752324599,home,SD,under,6.5,0.5,100,0.4793388429752067,SD,SF,2022 REG,3,1,7,3,4,10,0,1,-2,2,1,0,0,0,0,0,0,0,0,0.5206611570247933,0.4793388429752067
87729,0.504950495049505,0.5370370370370371,-102,-116,0.4837488699364985,0.5162511300635015,away,TOR,over,9,0.5412844036697247,-118,0.5162581740877563,BOS,TOR,2022 REG,8,2,9,3,5,17,0,1,-1,1,1,1,0,0,0,0,0,0,0,0.5162581740877563,0.4837418259122437
87729,0.504950495049505,0.5370370370370371,-102,-116,0.4837488699364985,0.5162511300635015,home,BOS,under,9,0.504950495049505,-102,0.4837418259122437,BOS,TOR,2022 REG,8,2,9,3,5,17,0,1,-1,1,1,1,0,0,0,0,0,0,0,0.5162581740877563,0.4837418259122437
87730,0.5689655172413793,0.4716981132075471,-132,112,0.5458293137100936,0.4541706862899064,away,NYM,over,7,0.5475113122171946,-121,0.5228602997583487,SF,NYM,2022 REG,19,13,18,12,25,37,1,0,1,-1,1,1,1,1,1,1,1,1,1,0.5228602997583487,0.4771397002416513
87730,0.5689655172413793,0.4716981132075471,-132,112,0.5458293137100936,0.4541706862899064,home,SF,under,7,0.49751243781094534,101,0.4771397002416513,SF,NYM,2022 REG,19,13,18,12,25,37,1,0,1,-1,1,1,1,1,1,1,1,1,1,0.5228602997583487,0.4771397002416513
87731,0.6666666666666666,0.37735849056603776,-200,165,0.6373165618448637,0.36268343815513626,away,TEX,over,7.5,0.5348837209302326,-115,0.5097020142727117,NYY,TEX,2022 REG,5,2,6,1,3,11,1,0,1,-1,1,0,0,0,0,0,0,0,0,0.5097020142727117,0.49029798572728833
87731,0.6666666666666666,0.37735849056603776,-200,165,0.6373165618448637,0.36268343815513626,home,NYY,under,7.5,0.5121951219512195,-105,0.49029798572728833,NYY,TEX,2022 REG,5,2,6,1,3,11,1,0,1,-1,1,0,0,0,0,0,0,0,0,0.5097020142727117,0.49029798572728833
87732,0.4444444444444444,0.5934959349593496,125,-146,0.42758205359831375,0.5724179464016863,away,TB,over,8,0.5370370370370371,-116,0.5118817074154765,CHC,TB,2022 REG,7,4,6,2,6,13,1,0,2,-2,1,1,0,0,0,0,0,0,0,0.5118817074154765,0.48811829258452355
87732,0.4444444444444444,0.5934959349593496,125,-146,0.42758205359831375,0.5724179464016863,home,CHC,under,8,0.5098039215686274,-104,0.48811829258452355,CHC,TB,2022 REG,7,4,6,2,6,13,1,0,2,-2,1,1,0,0,0,0,0,0,0,0.5118817074154765,0.48811829258452355
87733,0.5967741935483871,0.4444444444444444,-148,125,0.5721759741010521,0.42782402589894786,away,KC,over,8.5,0.5412844036697247,-118,0.5189377998484975,CWS,KC,2022 REG,5,0,6,6,6,11,0,1,-6,6,0,0,0,0,0,0,0,0,0,0.5189377998484975,0.4810622001515025
87733,0.5967741935483871,0.4444444444444444,-148,125,0.5721759741010521,0.42782402589894786,home,CWS,under,8.5,0.5,100,0.4810622001515025,CWS,KC,2022 REG,5,0,6,6,6,11,0,1,-6,6,0,0,0,0,0,0,0,0,0,0.5189377998484975,0.4810622001515025
87734,0.7701149425287357,0.2631578947368421,-335,280,0.7444910333701873,0.2555089666298127,away,KC,over,8,0.5073891625615764,-103,0.4837652908580103,HOU,KC,2022 REG,8,5,8,2,7,16,1,0,3,-3,1,1,0,0,0,0,0,0,0,0.4837652908580103,0.5162347091419897
87734,0.7701149425287357,0.2631578947368421,-335,280,0.7444910333701873,0.2555089666298127,home,HOU,under,8,0.5391705069124424,-117,0.5162347091419897,HOU,KC,2022 REG,8,5,8,2,7,16,1,0,3,-3,1,1,0,0,0,0,0,0,0,0.4837652908580103,0.5162347091419897
87735,0.6363636363636364,0.4,-175,150,0.6132231404958678,0.3867768595041322,away,SEA,over,7,0.5433789954337899,-119,0.5198077604720502,NYY,SEA,2022 REG,5,3,10,7,10,15,0,1,-4,4,1,1,1,0,0,0,0,0,0,0.5198077604720502,0.48019223952794976
87735,0.6363636363636364,0.4,-175,150,0.6132231404958678,0.3867768595041322,home,NYY,under,7,0.5,100,0.48019223952794976,NYY,SEA,2022 REG,5,3,10,7,10,15,0,1,-4,4,1,1,1,0,0,0,0,0,0,0.5198077604720502,0.48019223952794976
87736,0.5689655172413793,0.4716981132075471,-132,112,0.5458293137100936,0.4541706862899064,away,LAA,over,9,0.5391705069124424,-117,0.5140669063204599,BOS,LAA,2022 REG,8,5,8,10,15,16,0,1,-5,5,1,1,1,1,1,0,0,0,0,0.5140669063204599,0.4859330936795401
87736,0.5689655172413793,0.4716981132075471,-132,112,0.5458293137100936,0.4541706862899064,home,BOS,under,9,0.5073891625615764,-103,0.4859330936795401,BOS,LAA,2022 REG,8,5,8,10,15,16,0,1,-5,5,1,1,1,1,1,0,0,0,0,0.5140669063204599,0.4859330936795401
87737,0.7530864197530864,0.2857142857142857,-305,250,0.7238661353887691,0.2761338646112309,away,COL,over,8,0.5348837209302326,-115,0.5097020142727117,LAD,COL,2022 REG,8,5,8,3,8,16,1,0,2,-2,1,1,1,0,0,0,0,0,0,0.5097020142727117,0.49029798572728833
87737,0.7530864197530864,0.2857142857142857,-305,250,0.7238661353887691,0.2761338646112309,home,LAD,under,8,0.5121951219512195,-105,0.49029798572728833,LAD,COL,2022 REG,8,5,8,3,8,16,1,0,2,-2,1,1,1,0,0,0,0,0,0,0.5097020142727117,0.49029798572728833
87738,0.6774193548387096,0.35714285714285715,-210,180,0.6540062434963579,0.34599375650364206,away,LAA,over,7.5,0.5348837209302326,-115,0.5097020142727117,SEA,LAA,2022 REG,4,2,7,1,3,11,1,0,1,-1,1,0,0,0,0,0,0,0,0,0.5097020142727117,0.49029798572728833
87738,0.6774193548387096,0.35714285714285715,-210,180,0.6540062434963579,0.34599375650364206,home,SEA,under,7.5,0.5121951219512195,-105,0.49029798572728833,SEA,LAA,2022 REG,4,2,7,1,3,11,1,0,1,-1,1,0,0,0,0,0,0,0,0,0.5097020142727117,0.49029798572728833
87739,0.5145631067961165,0.5238095238095238,-106,-110,0.4948179667757384,0.5051820332242616,away,TOR,over,8.5,0.5121951219512195,-105,0.48919479393107135,SEA,TOR,2022 REG,9,5,12,2,7,21,1,0,3,-3,1,1,0,0,0,0,0,0,0,0.48919479393107135,0.5108052060689287
87739,0.5145631067961165,0.5238095238095238,-106,-110,0.4948179667757384,0.5051820332242616,home,SEA,under,8.5,0.5327102803738317,-114,0.5108052060689287,SEA,TOR,2022 REG,9,5,12,2,7,21,1,0,3,-3,1,1,0,0,0,0,0,0,0,0.48919479393107135,0.5108052060689287
87740,0.48780487804878053,0.5475113122171946,105,-121,0.470577468162939,0.529422531837061,away,MIN,over,7.5,0.5145631067961165,-106,0.49023796582517226,DET,MIN,2022 REG,9,5,2,0,5,11,1,0,5,-5,0,0,0,0,0,0,0,0,0,0.49023796582517226,0.5097620341748277
87740,0.48780487804878053,0.5475113122171946,105,-121,0.470577468162939,0.529422531837061,home,DET,under,7.5,0.5327102803738317,-114,0.5097620341748277,DET,MIN,2022 REG,9,5,2,0,5,11,1,0,5,-5,0,0,0,0,0,0,0,0,0,0.49023796582517226,0.5097620341748277
87741,0.7409326424870467,0.29850746268656714,-286,235,0.7117101811407941,0.2882898188592059,away,COL,over,8.5,0.5121951219512195,-105,0.48919479393107135,MIL,COL,2022 REG,12,9,7,4,13,19,1,0,5,-5,1,1,1,1,0,0,0,0,0,0.48919479393107135,0.5108052060689287
87741,0.7409326424870467,0.29850746268656714,-286,235,0.7117101811407941,0.2882898188592059,home,MIL,under,8.5,0.5327102803738317,-114,0.5108052060689287,MIL,COL,2022 REG,12,9,7,4,13,19,1,0,5,-5,1,1,1,1,0,0,0,0,0,0.48919479393107135,0.5108052060689287
87742,0.48309178743961345,0.5495495495495495,107,-122,0.46732302560909994,0.5326769743909001,away,SEA,over,7.5,0.5121951219512195,-105,0.4858858974112951,CLE,SEA,2022 REG,9,3,9,6,9,18,0,1,-3,3,1,1,1,0,0,0,0,0,0,0.4858858974112951,0.5141141025887048
87742,0.48309178743961345,0.5495495495495495,107,-122,0.46732302560909994,0.5326769743909001,home,CLE,under,7.5,0.5391705069124424,-117,0.5141141025887048,CLE,SEA,2022 REG,9,3,9,6,9,18,0,1,-3,3,1,1,1,0,0,0,0,0,0,0.4858858974112951,0.5141141025887048
87743,0.7333333333333333,0.3125,-275,220,0.6997222222222221,0.30027777777777787,away,PIT,over,7.5,0.5073891625615764,-103,0.4826927225525911,MIL,PIT,2022 REG,3,5,4,2,7,7,1,0,3,-3,1,1,0,0,0,0,0,0,0,0.4826927225525911,0.5173072774474089
87743,0.7333333333333333,0.3125,-275,220,0.6997222222222221,0.30027777777777787,home,MIL,under,7.5,0.5412844036697247,-118,0.5173072774474089,MIL,PIT,2022 REG,3,5,4,2,7,7,1,0,3,-3,1,1,0,0,0,0,0,0,0,0.4826927225525911,0.5173072774474089
87744,0.7409326424870467,0.29850746268656714,-286,235,0.7117101811407941,0.2882898188592059,away,PIT,over,7.5,0.5348837209302326,-115,0.5109810284308424,NYY,PIT,2022 REG,11,14,4,2,16,15,1,0,12,-12,1,1,0,0,0,0,0,0,0,0.5109810284308424,0.48901897156915763
87744,0.7409326424870467,0.29850746268656714,-286,235,0.7117101811407941,0.2882898188592059,home,NYY,under,7.5,0.5098039215686274,-104,0.48901897156915763,NYY,PIT,2022 REG,11,14,4,2,16,15,1,0,12,-12,1,1,0,0,0,0,0,0,0,0.5109810284308424,0.48901897156915763
87745,0.5391705069124424,0.5,-117,100,0.5180509248444435,0.4819490751555565,away,KC,over,7.5,0.5454545454545454,-120,0.5193043049216726,DET,KC,2022 REG,8,4,8,3,7,16,1,0,1,-1,1,1,1,0,0,0,0,0,0,0.5193043049216726,0.48069569507832743
87745,0.5391705069124424,0.5,-117,100,0.5180509248444435,0.4819490751555565,home,DET,under,7.5,0.5024875621890548,-101,0.48069569507832743,DET,KC,2022 REG,8,4,8,3,7,16,1,0,1,-1,1,1,1,0,0,0,0,0,0,0.5193043049216726,0.48069569507832743
87746,0.574468085106383,0.46511627906976744,-135,115,0.5517281312179562,0.44827186878204384,away,SEA,over,7.5,0.49504950495049505,102,0.4739797934813417,SD,SEA,2022 REG,8,2,11,6,8,19,0,1,-4,4,1,1,0,0,0,0,0,0,0,0.4739797934813417,0.5260202065186583
87746,0.574468085106383,0.46511627906976744,-135,115,0.5517281312179562,0.44827186878204384,home,SD,under,7.5,0.5475113122171946,-121,0.5260202065186583,SD,SEA,2022 REG,8,2,11,6,8,19,0,1,-4,4,1,1,0,0,0,0,0,0,0,0.4739797934813417,0.5260202065186583
87747,0.5535714285714286,0.49019607843137253,-124,104,0.5293429871948779,0.47065701280512207,away,ARI,over,12,0.5305164319248826,-113,0.5078572507605655,COL,ARI,2022 REG,6,5,5,3,8,11,1,0,2,-2,1,1,1,0,0,0,0,0,0,0.5078572507605655,0.49214274923943446
87747,0.5535714285714286,0.49019607843137253,-124,104,0.5293429871948779,0.47065701280512207,home,COL,under,12,0.5121951219512195,-105,0.49214274923943446,COL,ARI,2022 REG,6,5,5,3,8,11,1,0,2,-2,1,1,1,0,0,0,0,0,0,0.5078572507605655,0.49214274923943446
87748,0.38167938931297707,0.6598639455782314,162,-194,0.36582315462167614,0.6341768453783239,away,MIL,over,9,0.5305164319248826,-113,0.5066009958897986,CIN,MIL,2022 REG,14,14,15,11,25,29,1,0,3,-3,1,1,1,1,1,1,1,1,1,0.5066009958897986,0.49339900411020143
87748,0.38167938931297707,0.6598639455782314,162,-194,0.36582315462167614,0.6341768453783239,home,CIN,under,9,0.5145631067961165,-106,0.49339900411020143,CIN,MIL,2022 REG,14,14,15,11,25,29,1,0,3,-3,1,1,1,1,1,1,1,1,1,0.5066009958897986,0.49339900411020143
87749,0.3921568627450981,0.6428571428571428,155,-180,0.37842588015598405,0.6215741198440159,away,SEA,over,8.5,0.5238095238095238,-110,0.5012646084074657,LAA,SEA,2022 REG,10,7,10,11,18,20,0,1,-4,4,1,1,1,1,1,1,1,0,0,0.5012646084074657,0.4987353915925343
87749,0.3921568627450981,0.6428571428571428,155,-180,0.37842588015598405,0.6215741198440159,home,LAA,under,8.5,0.5192307692307692,-108,0.4987353915925343,LAA,SEA,2022 REG,10,7,10,11,18,20,0,1,-4,4,1,1,1,1,1,1,1,0,0,0.5012646084074657,0.4987353915925343
87750,0.3278688524590164,0.7101449275362319,205,-245,0.31540531803434485,0.6845946819656552,away,NYY,over,6.5,0.5433789954337899,-119,0.5184560714286826,OAK,NYY,2022 REG,5,2,9,3,5,14,0,1,-1,1,1,1,0,0,0,0,0,0,0,0.5184560714286826,0.48154392857131745
87750,0.3278688524590164,0.7101449275362319,205,-245,0.31540531803434485,0.6845946819656552,home,OAK,under,6.5,0.5024875621890548,-101,0.48154392857131745,OAK,NYY,2022 REG,5,2,9,3,5,14,0,1,-1,1,1,1,0,0,0,0,0,0,0,0.5184560714286826,0.48154392857131745
87751,0.5238095238095238,0.5192307692307692,-110,-108,0.5012646084074657,0.4987353915925343,away,ATL,over,9,0.5,100,0.47935779816513757,TEX,ATL,2022 REG,4,3,4,1,4,8,1,0,2,-2,1,0,0,0,0,0,0,0,0,0.47935779816513757,0.5206422018348624
87751,0.5238095238095238,0.5192307692307692,-110,-108,0.5012646084074657,0.4987353915925343,home,TEX,under,9,0.5412844036697247,-118,0.5206422018348624,TEX,ATL,2022 REG,4,3,4,1,4,8,1,0,2,-2,1,0,0,0,0,0,0,0,0,0.47935779816513757,0.5206422018348624
87752,0.35714285714285715,0.6774193548387096,180,-210,0.3447992100065833,0.6552007899934167,away,PHI,over,9.5,0.5238095238095238,-110,0.4988662131519274,WSH,PHI,2022 REG,5,1,11,10,11,16,0,1,-9,9,1,0,0,0,0,0,0,0,0,0.4988662131519274,0.5011337868480725
87752,0.35714285714285715,0.6774193548387096,180,-210,0.3447992100065833,0.6552007899934167,home,WSH,under,9.5,0.5238095238095238,-110,0.5011337868480725,WSH,PHI,2022 REG,5,1,11,10,11,16,0,1,-9,9,1,0,0,0,0,0,0,0,0,0.4988662131519274,0.5011337868480725
87753,0.6240601503759399,0.4166666666666667,-166,140,0.5986441668079975,0.4013558331920025,away,DET,over,7.5,0.5145631067961165,-106,0.49023796582517226,KC,DET,2022 REG,7,4,4,0,4,11,1,0,4,-4,0,0,0,0,0,0,0,0,0,0.49023796582517226,0.5097620341748277
87753,0.6240601503759399,0.4166666666666667,-166,140,0.5986441668079975,0.4013558331920025,home,KC,under,7.5,0.5327102803738317,-114,0.5097620341748277,KC,DET,2022 REG,7,4,4,0,4,11,1,0,4,-4,0,0,0,0,0,0,0,0,0,0.49023796582517226,0.5097620341748277
87754,0.5652173913043479,0.47619047619047616,-130,110,0.5418129444594474,0.4581870555405526,away,BAL,over,8,0.5238095238095238,-110,0.4988662131519274,OAK,BAL,2022 REG,7,2,8,1,3,15,1,0,1,-1,1,0,0,0,0,0,0,0,0,0.4988662131519274,0.5011337868480725
87754,0.5652173913043479,0.47619047619047616,-130,110,0.5418129444594474,0.4581870555405526,home,OAK,under,8,0.5238095238095238,-110,0.5011337868480725,OAK,BAL,2022 REG,7,2,8,1,3,15,1,0,1,-1,1,0,0,0,0,0,0,0,0,0.4988662131519274,0.5011337868480725
87755,0.5689655172413793,0.4672897196261683,-132,114,0.5483375376443265,0.45166246235567353,away,KC,over,8.5,0.5305164319248826,-113,0.5066009958897986,TEX,KC,2022 REG,6,2,8,8,10,14,0,1,-6,6,1,1,0,0,0,0,0,0,0,0.5066009958897986,0.49339900411020143
87755,0.5689655172413793,0.4672897196261683,-132,114,0.5483375376443265,0.45166246235567353,home,TEX,under,8.5,0.5145631067961165,-106,0.49339900411020143,TEX,KC,2022 REG,6,2,8,8,10,14,0,1,-6,6,1,1,0,0,0,0,0,0,0,0.5066009958897986,0.49339900411020143
87756,0.6402877697841727,0.4,-178,150,0.6144920035194866,0.38550799648051337,away,KC,over,7.5,0.5,100,0.4772727272727273,CLE,KC,2022 REG,8,1,12,7,8,20,0,1,-6,6,1,0,0,0,0,0,0,0,0,0.4772727272727273,0.5227272727272727
87756,0.6402877697841727,0.4,-178,150,0.6144920035194866,0.38550799648051337,home,CLE,under,7.5,0.5454545454545454,-120,0.5227272727272727,CLE,KC,2022 REG,8,1,12,7,8,20,0,1,-6,6,1,0,0,0,0,0,0,0,0,0.4772727272727273,0.5227272727272727
87757,0.696969696969697,0.3448275862068966,-230,190,0.6678382571799499,0.33216174282005007,away,ATL,over,8,0.5348837209302326,-115,0.5097020142727117,LAD,ATL,2022 REG,7,7,10,4,11,17,1,0,3,-3,1,1,1,1,0,0,0,0,0,0.5097020142727117,0.49029798572728833
87757,0.696969696969697,0.3448275862068966,-230,190,0.6678382571799499,0.33216174282005007,home,LAD,under,8,0.5121951219512195,-105,0.49029798572728833,LAD,ATL,2022 REG,7,7,10,4,11,17,1,0,3,-3,1,1,1,1,0,0,0,0,0,0.5097020142727117,0.49029798572728833
87758,0.6428571428571428,0.4,-180,150,0.6153061224489796,0.38469387755102036,away,SEA,over,8,0.5238095238095238,-110,0.4988662131519274,HOU,SEA,2022 REG,10,4,7,7,11,17,0,1,-3,3,1,1,1,1,0,0,0,0,0,0.4988662131519274,0.5011337868480725
87758,0.6428571428571428,0.4,-180,150,0.6153061224489796,0.38469387755102036,home,HOU,under,8,0.5238095238095238,-110,0.5011337868480725,HOU,SEA,2022 REG,10,4,7,7,11,17,0,1,-3,3,1,1,1,1,0,0,0,0,0,0.4988662131519274,0.5011337868480725
87759,0.5967741935483871,0.4424778761061947,-148,126,0.5733495713351688,0.42665042866483116,away,TEX,over,8,0.5169082125603864,-107,0.49353874091423283,CWS,TEX,2022 REG,8,6,11,8,14,19,0,1,-2,2,1,1,1,1,1,1,0,0,0,0.49353874091423283,0.5064612590857671
87759,0.5967741935483871,0.4424778761061947,-148,126,0.5733495713351688,0.42665042866483116,home,CWS,under,8,0.5283018867924528,-112,0.5064612590857671,CWS,TEX,2022 REG,8,6,11,8,14,19,0,1,-2,2,1,1,1,1,1,1,0,0,0,0.49353874091423283,0.5064612590857671
87760,0.2857142857142857,0.75,250,-300,0.2755102040816327,0.7244897959183674,away,NYM,over,9,0.5348837209302326,-115,0.5097020142727117,WSH,NYM,2022 REG,13,5,14,9,14,27,0,1,-4,4,1,1,1,1,1,0,0,0,0,0.5097020142727117,0.49029798572728833
87760,0.2857142857142857,0.75,250,-300,0.2755102040816327,0.7244897959183674,home,WSH,under,9,0.5121951219512195,-105,0.49029798572728833,WSH,NYM,2022 REG,13,5,14,9,14,27,0,1,-4,4,1,1,1,1,1,0,0,0,0,0.5097020142727117,0.49029798572728833
87761,0.6551724137931035,0.3846153846153846,-190,160,0.6291045458703008,0.37089545412969915,away,WSH,over,7,0.5535714285714286,-124,0.5293429871948779,MIA,WSH,2022 REG,7,4,9,5,9,16,0,1,-1,1,1,1,1,1,0,0,0,0,0,0.5293429871948779,0.47065701280512207
87761,0.6551724137931035,0.3846153846153846,-190,160,0.6291045458703008,0.37089545412969915,home,MIA,under,7,0.49019607843137253,104,0.47065701280512207,MIA,WSH,2022 REG,7,4,9,5,9,16,0,1,-1,1,1,1,1,1,0,0,0,0,0,0.5293429871948779,0.47065701280512207
87762,0.6363636363636364,0.4081632653061224,-175,145,0.6080283353010626,0.3919716646989374,away,TEX,over,8.5,0.5238095238095238,-110,0.5012646084074657,LAA,TEX,2022 REG,6,2,10,7,9,16,0,1,-5,5,1,1,0,0,0,0,0,0,0,0.5012646084074657,0.4987353915925343
87762,0.6363636363636364,0.4081632653061224,-175,145,0.6080283353010626,0.3919716646989374,home,LAA,under,8.5,0.5192307692307692,-108,0.4987353915925343,LAA,TEX,2022 REG,6,2,10,7,9,16,0,1,-5,5,1,1,0,0,0,0,0,0,0,0.5012646084074657,0.4987353915925343
87763,0.4291845493562232,0.607843137254902,133,-155,0.41329283836432396,0.586707161635676,away,LAD,over,7.5,0.49019607843137253,104,0.46776880686915284,SD,LAD,2022 REG,8,2,8,10,12,16,0,1,-8,8,1,1,0,0,0,0,0,0,0,0.46776880686915284,0.5322311931308472
87763,0.4291845493562232,0.607843137254902,133,-155,0.41329283836432396,0.586707161635676,home,SD,under,7.5,0.5555555555555556,-125,0.5322311931308472,SD,LAD,2022 REG,8,2,8,10,12,16,0,1,-8,8,1,1,0,0,0,0,0,0,0,0.46776880686915284,0.5322311931308472
87764,0.7142857142857143,0.3278688524590164,-250,205,0.6841753094680495,0.3158246905319505,away,MIN,over,8,0.5348837209302326,-115,0.5097020142727117,LAD,MIN,2022 REG,15,10,7,3,13,22,1,0,7,-7,1,1,1,0,0,0,0,0,0,0.5097020142727117,0.49029798572728833
87764,0.7142857142857143,0.3278688524590164,-250,205,0.6841753094680495,0.3158246905319505,home,LAD,under,8,0.5121951219512195,-105,0.49029798572728833,LAD,MIN,2022 REG,15,10,7,3,13,22,1,0,7,-7,1,1,1,0,0,0,0,0,0,0.5097020142727117,0.49029798572728833
87765,0.6226415094339623,0.4166666666666667,-165,140,0.5981666073335706,0.40183339266642937,away,WSH,over,9.5,0.5145631067961165,-106,0.4913668392989033,TEX,WSH,2022 REG,8,4,10,6,10,18,0,1,-2,2,1,1,1,1,0,0,0,0,0,0.4913668392989033,0.5086331607010968
87765,0.6226415094339623,0.4166666666666667,-165,140,0.5981666073335706,0.40183339266642937,home,TEX,under,9.5,0.5305164319248826,-113,0.5086331607010968,TEX,WSH,2022 REG,8,4,10,6,10,18,0,1,-2,2,1,1,1,1,0,0,0,0,0,0.4913668392989033,0.5086331607010968
87766,0.6666666666666666,0.37735849056603776,-200,165,0.6373165618448637,0.36268343815513626,away,COL,over,7.5,0.5192307692307692,-108,0.49688292476754015,SF,COL,2022 REG,10,7,4,1,8,14,1,0,6,-6,1,0,0,0,0,0,0,0,0,0.49688292476754015,0.5031170752324599
87766,0.6666666666666666,0.37735849056603776,-200,165,0.6373165618448637,0.36268343815513626,home,SF,under,7.5,0.5238095238095238,-110,0.5031170752324599,SF,COL,2022 REG,10,7,4,1,8,14,1,0,6,-6,1,0,0,0,0,0,0,0,0,0.49688292476754015,0.5031170752324599
87767,0.5884773662551441,0.4504504504504505,-143,122,0.5655692272061728,0.43443077279382725,away,SD,over,12,0.5145631067961165,-106,0.4913668392989033,CHC,SD,2022 REG,11,5,21,19,24,32,0,1,-14,14,1,1,1,1,1,0,0,0,0,0.4913668392989033,0.5086331607010968
87767,0.5884773662551441,0.4504504504504505,-143,122,0.5655692272061728,0.43443077279382725,home,CHC,under,12,0.5305164319248826,-113,0.5086331607010968,CHC,SD,2022 REG,11,5,21,19,24,32,0,1,-14,14,1,1,1,1,1,0,0,0,0,0.4913668392989033,0.5086331607010968
87768,0.7619047619047619,0.2857142857142857,-320,250,0.72562358276644,0.27437641723356,away,BAL,over,9.5,0.5,100,0.4772727272727273,TOR,BAL,2022 REG,13,7,6,6,13,19,1,0,1,-1,1,1,1,1,1,1,0,0,0,0.4772727272727273,0.5227272727272727
87768,0.7619047619047619,0.2857142857142857,-320,250,0.72562358276644,0.27437641723356,home,TOR,under,9.5,0.5454545454545454,-120,0.5227272727272727,TOR,BAL,2022 REG,13,7,6,6,13,19,1,0,1,-1,1,1,1,1,1,1,0,0,0,0.4772727272727273,0.5227272727272727
87769,0.35714285714285715,0.6875,180,-220,0.3411989795918367,0.6588010204081634,away,LAD,over,8.5,0.5327102803738317,-114,0.508788710910954,WSH,LAD,2022 REG,6,1,6,0,1,12,1,0,1,-1,0,0,0,0,0,0,0,0,0,0.508788710910954,0.491211289089046
87769,0.35714285714285715,0.6875,180,-220,0.3411989795918367,0.6588010204081634,home,WSH,under,8.5,0.5121951219512195,-105,0.491211289089046,WSH,LAD,2022 REG,6,1,6,0,1,12,1,0,1,-1,0,0,0,0,0,0,0,0,0,0.508788710910954,0.491211289089046
87770,0.4464285714285714,0.5918367346938775,124,-145,0.42934584548104954,0.5706541545189505,away,LAD,over,9,0.5454545454545454,-120,0.5206611570247933,MIN,LAD,2022 REG,5,2,9,7,9,14,0,1,-5,5,1,1,0,0,0,0,0,0,0,0.5206611570247933,0.4793388429752067
87770,0.4464285714285714,0.5918367346938775,124,-145,0.42934584548104954,0.5706541545189505,home,MIN,under,9,0.5,100,0.4793388429752067,MIN,LAD,2022 REG,5,2,9,7,9,14,0,1,-5,5,1,1,0,0,0,0,0,0,0,0.5206611570247933,0.4793388429752067
87771,0.5238095238095238,0.5145631067961165,-110,-106,0.5037095744446646,0.4962904255553354,away,LAD,over,8.5,0.5391705069124424,-117,0.5140669063204599,ATL,LAD,2022 REG,8,3,12,5,8,20,0,1,-2,2,1,1,1,0,0,0,0,0,0,0.5140669063204599,0.4859330936795401
87771,0.5238095238095238,0.5145631067961165,-110,-106,0.5037095744446646,0.4962904255553354,home,ATL,under,8.5,0.5073891625615764,-103,0.4859330936795401,ATL,LAD,2022 REG,8,3,12,5,8,20,0,1,-2,2,1,1,1,0,0,0,0,0,0,0.5140669063204599,0.4859330936795401
87772,0.6923076923076923,0.35211267605633806,-225,184,0.6615551295941329,0.3384448704058671,away,WSH,over,7,0.5495495495495495,-122,0.5250401592387142,MIA,WSH,2022 REG,16,8,5,2,10,21,1,0,6,-6,1,1,0,0,0,0,0,0,0,0.5250401592387142,0.47495984076128583
87772,0.6923076923076923,0.35211267605633806,-225,184,0.6615551295941329,0.3384448704058671,home,MIA,under,7,0.49504950495049505,102,0.47495984076128583,MIA,WSH,2022 REG,16,8,5,2,10,21,1,0,6,-6,1,1,0,0,0,0,0,0,0,0.5250401592387142,0.47495984076128583
87773,0.5726495726495727,0.46511627906976744,-134,115,0.5510229738017454,0.44897702619825464,away,ARI,over,8,0.5391705069124424,-117,0.5127649394825569,SF,ARI,2022 REG,6,4,13,3,7,19,1,0,1,-1,1,1,1,0,0,0,0,0,0,0.5127649394825569,0.48723506051744314
87773,0.5726495726495727,0.46511627906976744,-134,115,0.5510229738017454,0.44897702619825464,home,SF,under,8,0.5098039215686274,-104,0.48723506051744314,SF,ARI,2022 REG,6,4,13,3,7,19,1,0,1,-1,1,1,1,0,0,0,0,0,0,0.5127649394825569,0.48723506051744314
87774,0.5121951219512195,0.5238095238095238,-105,-110,0.4937537180249852,0.5062462819750149,away,MIN,over,7.5,0.5348837209302326,-115,0.5097020142727117,DET,MIN,2022 REG,6,5,3,2,7,9,1,0,3,-3,1,1,0,0,0,0,0,0,0,0.5097020142727117,0.49029798572728833
87774,0.5121951219512195,0.5238095238095238,-105,-110,0.4937537180249852,0.5062462819750149,home,DET,under,7.5,0.5121951219512195,-105,0.49029798572728833,DET,MIN,2022 REG,6,5,3,2,7,9,1,0,3,-3,1,1,0,0,0,0,0,0,0,0.5097020142727117,0.49029798572728833
87775,0.35714285714285715,0.6825396825396826,180,-215,0.34297052154195007,0.6570294784580499,away,NYY,over,7.5,0.5192307692307692,-108,0.49455035168025013,KC,NYY,2022 REG,7,0,8,3,3,15,0,1,-3,3,0,0,0,0,0,0,0,0,0,0.49455035168025013,0.5054496483197499
87775,0.35714285714285715,0.6825396825396826,180,-215,0.34297052154195007,0.6570294784580499,home,KC,under,7.5,0.5283018867924528,-112,0.5054496483197499,KC,NYY,2022 REG,7,0,8,3,3,15,0,1,-3,3,0,0,0,0,0,0,0,0,0,0.49455035168025013,0.5054496483197499
87776,0.35714285714285715,0.6774193548387096,180,-210,0.3447992100065833,0.6552007899934167,away,LAD,over,12,0.5238095238095238,-110,0.5000596729920038,COL,LAD,2022 REG,7,0,14,13,13,21,0,1,-13,13,0,0,0,0,0,0,0,0,0,0.5000596729920038,0.4999403270079962
87776,0.35714285714285715,0.6774193548387096,180,-210,0.3447992100065833,0.6552007899934167,home,COL,under,12,0.5215311004784688,-109,0.4999403270079962,COL,LAD,2022 REG,7,0,14,13,13,21,0,1,-13,13,0,0,0,0,0,0,0,0,0,0.5000596729920038,0.4999403270079962
87777,0.45454545454545453,0.5815899581589958,120,-139,0.43812026695252254,0.5618797330474774,away,STL,over,8.5,0.5145631067961165,-106,0.49023796582517226,CHC,STL,2022 REG,11,3,11,5,8,22,0,1,-2,2,1,1,1,0,0,0,0,0,0,0.49023796582517226,0.5097620341748277
87777,0.45454545454545453,0.5815899581589958,120,-139,0.43812026695252254,0.5618797330474774,home,CHC,under,8.5,0.5327102803738317,-114,0.5097620341748277,CHC,STL,2022 REG,11,3,11,5,8,22,0,1,-2,2,1,1,1,0,0,0,0,0,0,0.49023796582517226,0.5097620341748277
87778,0.43859649122807015,0.5967741935483871,128,-148,0.4230830329927819,0.5769169670072181,away,SF,over,9.5,0.49751243781094534,101,0.47511256217505476,CIN,SF,2022 REG,8,4,6,6,10,14,0,1,-2,2,1,1,1,1,0,0,0,0,0,0.47511256217505476,0.5248874378249453
87778,0.43859649122807015,0.5967741935483871,128,-148,0.4230830329927819,0.5769169670072181,home,CIN,under,9.5,0.5475113122171946,-121,0.5248874378249453,CIN,SF,2022 REG,8,4,6,6,10,14,0,1,-2,2,1,1,1,1,0,0,0,0,0,0.47511256217505476,0.5248874378249453
87779,0.5370370370370371,0.5,-116,100,0.5171467764060357,0.4828532235939643,away,TB,over,7.5,0.5,100,0.4772727272727273,TOR,TB,2022 REG,11,5,7,1,6,18,1,0,4,-4,1,0,0,0,0,0,0,0,0,0.4772727272727273,0.5227272727272727
87779,0.5370370370370371,0.5,-116,100,0.5171467764060357,0.4828532235939643,home,TOR,under,7.5,0.5454545454545454,-120,0.5227272727272727,TOR,TB,2022 REG,11,5,7,1,6,18,1,0,4,-4,1,0,0,0,0,0,0,0,0,0.4772727272727273,0.5227272727272727
87780,0.5798319327731092,0.45454545454545453,-138,120,0.5598988258404966,0.44010117415950345,away,BOS,over,7.5,0.5433789954337899,-119,0.5198077604720502,TB,BOS,2022 REG,13,8,6,4,12,19,1,0,4,-4,1,1,1,1,0,0,0,0,0,0.5198077604720502,0.48019223952794976
87780,0.5798319327731092,0.45454545454545453,-138,120,0.5598988258404966,0.44010117415950345,home,TB,under,7.5,0.5,100,0.48019223952794976,TB,BOS,2022 REG,13,8,6,4,12,19,1,0,4,-4,1,1,1,1,0,0,0,0,0,0.5198077604720502,0.48019223952794976
87781,0.38759689922480617,0.6551724137931035,158,-190,0.37101964611708926,0.6289803538829107,away,MIL,over,7.5,0.5412844036697247,-118,0.5149381613977361,BAL,MIL,2022 REG,5,2,7,4,6,12,0,1,-2,2,1,1,0,0,0,0,0,0,0,0.5149381613977361,0.48506183860226393
87781,0.38759689922480617,0.6551724137931035,158,-190,0.37101964611708926,0.6289803538829107,home,BAL,under,7.5,0.5073891625615764,-103,0.48506183860226393,BAL,MIL,2022 REG,5,2,7,4,6,12,0,1,-2,2,1,1,0,0,0,0,0,0,0,0.5149381613977361,0.48506183860226393
87782,0.45454545454545453,0.5884773662551441,120,-143,0.43498962690881876,0.5650103730911813,away,BOS,over,9,0.4926108374384236,103,0.4718421738975501,BAL,BOS,2022 REG,5,1,6,3,4,11,0,1,-2,2,1,0,0,0,0,0,0,0,0,0.4718421738975501,0.5281578261024499
87782,0.45454545454545453,0.5884773662551441,120,-143,0.43498962690881876,0.5650103730911813,home,BAL,under,9,0.5495495495495495,-122,0.5281578261024499,BAL,BOS,2022 REG,5,1,6,3,4,11,0,1,-2,2,1,0,0,0,0,0,0,0,0,0.4718421738975501,0.5281578261024499
87783,0.7142857142857143,0.3225806451612903,-250,210,0.6879526003949967,0.3120473996050033,away,PIT,over,7.5,0.5348837209302326,-115,0.5097020142727117,SF,PIT,2022 REG,5,2,5,0,2,10,1,0,2,-2,0,0,0,0,0,0,0,0,0,0.5097020142727117,0.49029798572728833
87783,0.7142857142857143,0.3225806451612903,-250,210,0.6879526003949967,0.3120473996050033,home,SF,under,7.5,0.5121951219512195,-105,0.49029798572728833,SF,PIT,2022 REG,5,2,5,0,2,10,1,0,2,-2,0,0,0,0,0,0,0,0,0,0.5097020142727117,0.49029798572728833
87784,0.574468085106383,0.46511627906976744,-135,115,0.5517281312179562,0.44827186878204384,away,NYM,over,7.5,0.4926108374384236,103,0.4708471211010438,ATL,NYM,2022 REG,5,1,9,4,5,14,0,1,-3,3,1,0,0,0,0,0,0,0,0,0.4708471211010438,0.5291528788989561
87784,0.574468085106383,0.46511627906976744,-135,115,0.5517281312179562,0.44827186878204384,home,ATL,under,7.5,0.5515695067264574,-123,0.5291528788989561,ATL,NYM,2022 REG,5,1,9,4,5,14,0,1,-3,3,1,0,0,0,0,0,0,0,0,0.4708471211010438,0.5291528788989561
87785,0.6721311475409836,0.36764705882352944,-205,172,0.6453949760500813,0.35460502394991866,away,CLE,over,8,0.5305164319248826,-113,0.5066009958897986,HOU,CLE,2022 REG,9,7,7,3,10,16,1,0,4,-4,1,1,1,0,0,0,0,0,0,0.5066009958897986,0.49339900411020143
87785,0.6721311475409836,0.36764705882352944,-205,172,0.6453949760500813,0.35460502394991866,home,HOU,under,8,0.5145631067961165,-106,0.49339900411020143,HOU,CLE,2022 REG,9,7,7,3,10,16,1,0,4,-4,1,1,1,0,0,0,0,0,0,0.5066009958897986,0.49339900411020143
87786,0.41152263374485604,0.6254681647940076,143,-167,0.39630008290581753,0.6036999170941825,away,MIN,over,8.5,0.5412844036697247,-118,0.5149381613977361,DET,MIN,2022 REG,13,7,10,5,12,23,1,0,2,-2,1,1,1,1,1,0,0,0,0,0.5149381613977361,0.48506183860226393
87786,0.41152263374485604,0.6254681647940076,143,-167,0.39630008290581753,0.6036999170941825,home,DET,under,8.5,0.5073891625615764,-103,0.48506183860226393,DET,MIN,2022 REG,13,7,10,5,12,23,1,0,2,-2,1,1,1,1,1,0,0,0,0,0.5149381613977361,0.48506183860226393
87787,0.6000000000000001,0.4444444444444444,-150,125,0.5733333333333334,0.42666666666666664,away,MIN,over,9,0.5098039215686274,-104,0.48592421718142587,BOS,MIN,2022 REG,11,3,9,8,11,20,0,1,-5,5,1,1,1,0,0,0,0,0,0,0.48592421718142587,0.5140757828185741
87787,0.6000000000000001,0.4444444444444444,-150,125,0.5733333333333334,0.42666666666666664,home,BOS,under,9,0.5370370370370371,-116,0.5140757828185741,BOS,MIN,2022 REG,11,3,9,8,11,20,0,1,-5,5,1,1,1,0,0,0,0,0,0,0.48592421718142587,0.5140757828185741
87788,0.37037037037037035,0.6666666666666666,170,-200,0.35665294924554186,0.6433470507544581,away,TB,over,8,0.5238095238095238,-110,0.4988662131519274,DET,TB,2022 REG,9,3,7,5,8,16,0,1,-2,2,1,1,1,0,0,0,0,0,0,0.4988662131519274,0.5011337868480725
87788,0.37037037037037035,0.6666666666666666,170,-200,0.35665294924554186,0.6433470507544581,home,DET,under,8,0.5238095238095238,-110,0.5011337868480725,DET,TB,2022 REG,9,3,7,5,8,16,0,1,-2,2,1,1,1,0,0,0,0,0,0,0.4988662131519274,0.5011337868480725
87789,0.4807692307692307,0.5575221238938054,108,-126,0.46235992564277106,0.5376400743572289,away,PHI,over,8,0.5327102803738317,-114,0.5075272610403079,PIT,PHI,2022 REG,7,2,11,4,6,18,0,1,-2,2,1,1,0,0,0,0,0,0,0,0.5075272610403079,0.4924727389596921
87789,0.4807692307692307,0.5575221238938054,108,-126,0.46235992564277106,0.5376400743572289,home,PIT,under,8,0.5145631067961165,-106,0.4924727389596921,PIT,PHI,2022 REG,7,2,11,4,6,18,0,1,-2,2,1,1,0,0,0,0,0,0,0,0.5075272610403079,0.4924727389596921
87790,0.4587155963302753,0.576271186440678,118,-136,0.44266661340781965,0.5573333865921803,away,SEA,over,7.5,0.5305164319248826,-113,0.5066009958897986,OAK,SEA,2022 REG,6,2,14,10,12,20,0,1,-8,8,1,1,0,0,0,0,0,0,0,0.5066009958897986,0.49339900411020143
87790,0.4587155963302753,0.576271186440678,118,-136,0.44266661340781965,0.5573333865921803,home,OAK,under,7.5,0.5145631067961165,-106,0.49339900411020143,OAK,SEA,2022 REG,6,2,14,10,12,20,0,1,-8,8,1,1,0,0,0,0,0,0,0,0.5066009958897986,0.49339900411020143
87791,0.4629629629629629,0.576271186440678,116,-136,0.4447990049057217,0.5552009950942782,away,MIL,over,9.5,0.5192307692307692,-108,0.49455035168025013,CIN,MIL,2022 REG,6,3,8,6,9,14,0,1,-3,3,1,1,1,0,0,0,0,0,0,0.49455035168025013,0.5054496483197499
87791,0.4629629629629629,0.576271186440678,116,-136,0.4447990049057217,0.5552009950942782,home,CIN,under,9.5,0.5283018867924528,-112,0.5054496483197499,CIN,MIL,2022 REG,6,3,8,6,9,14,0,1,-3,3,1,1,1,0,0,0,0,0,0,0.49455035168025013,0.5054496483197499
87792,0.4807692307692307,0.5633187772925764,108,-129,0.45957307304720807,0.5404269269527919,away,HOU,over,8.5,0.5454545454545454,-120,0.5206611570247933,SEA,HOU,2022 REG,13,11,5,1,12,18,1,0,10,-10,1,0,0,0,0,0,0,0,0,0.5206611570247933,0.4793388429752067
87792,0.4807692307692307,0.5633187772925764,108,-129,0.45957307304720807,0.5404269269527919,home,SEA,under,8.5,0.5,100,0.4793388429752067,SEA,HOU,2022 REG,13,11,5,1,12,18,1,0,10,-10,1,0,0,0,0,0,0,0,0,0.5206611570247933,0.4793388429752067
87793,0.4716981132075471,0.5652173913043479,112,-130,0.4542851393811816,0.5457148606188185,away,CLE,over,8,0.5305164319248826,-113,0.5078572507605655,TEX,CLE,2022 REG,6,4,11,10,14,17,0,1,-6,6,1,1,1,1,0,0,0,0,0,0.5078572507605655,0.49214274923943446
87793,0.4716981132075471,0.5652173913043479,112,-130,0.4542851393811816,0.5457148606188185,home,TEX,under,8,0.5121951219512195,-105,0.49214274923943446,TEX,CLE,2022 REG,6,4,11,10,14,17,0,1,-6,6,1,1,1,1,0,0,0,0,0,0.5078572507605655,0.49214274923943446
87794,0.47619047619047616,0.5652173913043479,110,-130,0.4564724440500838,0.5435275559499162,away,TOR,over,6.5,0.5495495495495495,-122,0.529021440689206,TB,TOR,2022 REG,7,5,6,2,7,13,1,0,3,-3,1,1,0,0,0,0,0,0,0,0.529021440689206,0.470978559310794
87794,0.47619047619047616,0.5652173913043479,110,-130,0.4564724440500838,0.5435275559499162,home,TB,under,6.5,0.48780487804878053,105,0.470978559310794,TB,TOR,2022 REG,7,5,6,2,7,13,1,0,3,-3,1,1,0,0,0,0,0,0,0,0.529021440689206,0.470978559310794
87795,0.574468085106383,0.4587155963302753,-135,118,0.5554051191746856,0.4445948808253144,away,ATL,over,8,0.504950495049505,-102,0.48160416005266615,SD,ATL,2022 REG,3,2,4,1,3,7,1,0,1,-1,1,0,0,0,0,0,0,0,0,0.48160416005266615,0.5183958399473338
87795,0.574468085106383,0.4587155963302753,-135,118,0.5554051191746856,0.4445948808253144,home,SD,under,8,0.5412844036697247,-118,0.5183958399473338,SD,ATL,2022 REG,3,2,4,1,3,7,1,0,1,-1,1,0,0,0,0,0,0,0,0,0.48160416005266615,0.5183958399473338
87796,0.574468085106383,0.4629629629629629,-135,116,0.5529651425984609,0.44703485740153914,away,KC,over,7.5,0.5348837209302326,-115,0.5097020142727117,DET,KC,2022 REG,6,2,10,1,3,16,1,0,1,-1,1,0,0,0,0,0,0,0,0,0.5097020142727117,0.49029798572728833
87796,0.574468085106383,0.4629629629629629,-135,116,0.5529651425984609,0.44703485740153914,home,DET,under,7.5,0.5121951219512195,-105,0.49029798572728833,DET,KC,2022 REG,6,2,10,1,3,16,1,0,1,-1,1,0,0,0,0,0,0,0,0,0.5097020142727117,0.49029798572728833
87797,0.5555555555555556,0.4807692307692307,-125,108,0.5353751187084521,0.4646248812915479,away,MIN,over,9.5,0.5348837209302326,-115,0.5097020142727117,BOS,MIN,2022 REG,11,8,4,1,9,15,1,0,7,-7,1,0,0,0,0,0,0,0,0,0.5097020142727117,0.49029798572728833
87797,0.5555555555555556,0.4807692307692307,-125,108,0.5353751187084521,0.4646248812915479,home,BOS,under,9.5,0.5121951219512195,-105,0.49029798572728833,BOS,MIN,2022 REG,11,8,4,1,9,15,1,0,7,-7,1,0,0,0,0,0,0,0,0,0.5097020142727117,0.49029798572728833
87798,0.7752808988764045,0.27027027027027023,-345,270,0.7399659475154994,0.2600340524845006,away,CIN,over,9,0.504950495049505,-102,0.48160416005266615,NYM,CIN,2022 REG,13,10,6,2,12,19,1,0,8,-8,1,1,0,0,0,0,0,0,0,0.48160416005266615,0.5183958399473338
87798,0.7752808988764045,0.27027027027027023,-345,270,0.7399659475154994,0.2600340524845006,home,NYM,under,9,0.5412844036697247,-118,0.5183958399473338,NYM,CIN,2022 REG,13,10,6,2,12,19,1,0,8,-8,1,1,0,0,0,0,0,0,0,0.48160416005266615,0.5183958399473338
87799,0.4807692307692307,0.5633187772925764,108,-129,0.45957307304720807,0.5404269269527919,away,HOU,over,8.5,0.504950495049505,-102,0.48160416005266615,MIN,HOU,2022 REG,10,3,15,11,14,25,0,1,-8,8,1,1,1,0,0,0,0,0,0,0.48160416005266615,0.5183958399473338
87799,0.4807692307692307,0.5633187772925764,108,-129,0.45957307304720807,0.5404269269527919,home,MIN,under,8.5,0.5412844036697247,-118,0.5183958399473338,MIN,HOU,2022 REG,10,3,15,11,14,25,0,1,-8,8,1,1,1,0,0,0,0,0,0,0.48160416005266615,0.5183958399473338
87800,0.7101449275362319,0.33783783783783783,-245,196,0.6760702100966752,0.32392978990332477,away,DET,over,8,0.5391705069124424,-117,0.5127649394825569,CWS,DET,2022 REG,6,1,11,4,5,17,0,1,-3,3,1,0,0,0,0,0,0,0,0,0.5127649394825569,0.48723506051744314
87800,0.7101449275362319,0.33783783783783783,-245,196,0.6760702100966752,0.32392978990332477,home,CWS,under,8,0.5098039215686274,-104,0.48723506051744314,CWS,DET,2022 REG,6,1,11,4,5,17,0,1,-3,3,1,0,0,0,0,0,0,0,0,0.5127649394825569,0.48723506051744314
87801,0.8076923076923077,0.23255813953488372,-420,330,0.7751823310857301,0.2248176689142699,away,KC,over,8.5,0.5454545454545454,-120,0.5206611570247933,TOR,KC,2022 REG,7,1,12,3,4,19,0,1,-2,2,1,0,0,0,0,0,0,0,0,0.5206611570247933,0.4793388429752067
87801,0.8076923076923077,0.23255813953488372,-420,330,0.7751823310857301,0.2248176689142699,home,TOR,under,8.5,0.5,100,0.4793388429752067,TOR,KC,2022 REG,7,1,12,3,4,19,0,1,-2,2,1,0,0,0,0,0,0,0,0,0.5206611570247933,0.4793388429752067
87802,0.6031746031746031,0.4347826086956522,-152,130,0.5802797769671475,0.4197202230328525,away,BAL,over,7,0.5495495495495495,-122,0.5250401592387142,TB,BAL,2022 REG,10,7,10,5,12,20,1,0,2,-2,1,1,1,1,1,0,0,0,0,0.5250401592387142,0.47495984076128583
87802,0.6031746031746031,0.4347826086956522,-152,130,0.5802797769671475,0.4197202230328525,home,TB,under,7,0.49504950495049505,102,0.47495984076128583,TB,BAL,2022 REG,10,7,10,5,12,20,1,0,2,-2,1,1,1,1,1,0,0,0,0,0.5250401592387142,0.47495984076128583
87803,0.7333333333333333,0.3125,-275,220,0.6997222222222221,0.30027777777777787,away,CLE,over,8,0.5192307692307692,-108,0.49571111079951763,LAD,CLE,2022 REG,11,7,2,1,8,13,1,0,6,-6,1,0,0,0,0,0,0,0,0,0.49571111079951763,0.5042888892004824
87803,0.7333333333333333,0.3125,-275,220,0.6997222222222221,0.30027777777777787,home,LAD,under,8,0.5260663507109005,-111,0.5042888892004824,LAD,CLE,2022 REG,11,7,2,1,8,13,1,0,6,-6,1,0,0,0,0,0,0,0,0,0.49571111079951763,0.5042888892004824
87804,0.49504950495049505,0.5454545454545454,102,-120,0.47499799484898986,0.5250020051510101,away,TOR,over,7.5,0.5215311004784688,-109,0.4978845547971712,TB,TOR,2022 REG,12,10,8,5,15,20,1,0,5,-5,1,1,1,1,1,0,0,0,0,0.4978845547971712,0.5021154452028288
87804,0.49504950495049505,0.5454545454545454,102,-120,0.47499799484898986,0.5250020051510101,home,TB,under,7.5,0.5238095238095238,-110,0.5021154452028288,TB,TOR,2022 REG,12,10,8,5,15,20,1,0,5,-5,1,1,1,1,1,0,0,0,0,0.4978845547971712,0.5021154452028288
87805,0.6721311475409836,0.37037037037037035,-205,170,0.6435645535349916,0.35643544646500835,away,PIT,over,7,0.5215311004784688,-109,0.4978845547971712,TB,PIT,2022 REG,7,4,8,3,7,15,1,0,1,-1,1,1,1,0,0,0,0,0,0,0.4978845547971712,0.5021154452028288
87805,0.6721311475409836,0.37037037037037035,-205,170,0.6435645535349916,0.35643544646500835,home,TB,under,7,0.5238095238095238,-110,0.5021154452028288,TB,PIT,2022 REG,7,4,8,3,7,15,1,0,1,-1,1,1,1,0,0,0,0,0,0,0.4978845547971712,0.5021154452028288
87806,0.5412844036697247,0.5,-118,100,0.5189377998484975,0.4810622001515025,away,CLE,over,8.5,0.5495495495495495,-122,0.5250401592387142,KC,CLE,2022 REG,7,3,22,17,20,29,0,1,-14,14,1,1,1,0,0,0,0,0,0,0.5250401592387142,0.47495984076128583
87806,0.5412844036697247,0.5,-118,100,0.5189377998484975,0.4810622001515025,home,KC,under,8.5,0.49504950495049505,102,0.47495984076128583,KC,CLE,2022 REG,7,3,22,17,20,29,0,1,-14,14,1,1,1,0,0,0,0,0,0,0.5250401592387142,0.47495984076128583
87807,0.5238095238095238,0.5192307692307692,-110,-108,0.5012646084074657,0.4987353915925343,away,NYY,over,8.5,0.5121951219512195,-105,0.48808156828023186,TOR,NYY,2022 REG,8,2,11,5,7,19,0,1,-3,3,1,1,0,0,0,0,0,0,0,0.48808156828023186,0.5119184317197681
87807,0.5238095238095238,0.5192307692307692,-110,-108,0.5012646084074657,0.4987353915925343,home,TOR,under,8.5,0.5348837209302326,-115,0.5119184317197681,TOR,NYY,2022 REG,8,2,11,5,7,19,0,1,-3,3,1,1,0,0,0,0,0,0,0,0.48808156828023186,0.5119184317197681
87808,0.647887323943662,0.3921568627450981,-184,155,0.6219432029903809,0.37805679700961914,away,SF,over,7.5,0.5169082125603864,-107,0.49239402434819424,SD,SF,2022 REG,8,7,5,4,11,13,1,0,3,-3,1,1,1,1,0,0,0,0,0,0.49239402434819424,0.5076059756518058
87808,0.647887323943662,0.3921568627450981,-184,155,0.6219432029903809,0.37805679700961914,home,SD,under,7.5,0.5305164319248826,-113,0.5076059756518058,SD,SF,2022 REG,8,7,5,4,11,13,1,0,3,-3,1,1,1,1,0,0,0,0,0,0.49239402434819424,0.5076059756518058
87809,0.6108949416342413,0.43103448275862066,-157,132,0.5852804683670066,0.41471953163299335,away,SD,over,7,0.5391705069124424,-117,0.5114756747601454,ATL,SD,2022 REG,12,6,16,11,17,28,0,1,-5,5,1,1,1,1,1,1,0,0,0,0.5114756747601454,0.48852432523985456
87809,0.6108949416342413,0.43103448275862066,-157,132,0.5852804683670066,0.41471953163299335,home,ATL,under,7,0.5121951219512195,-105,0.48852432523985456,ATL,SD,2022 REG,12,6,16,11,17,28,0,1,-5,5,1,1,1,1,1,1,0,0,0,0.5114756747601454,0.48852432523985456
87810,0.46511627906976744,0.574468085106383,115,-135,0.44670494689481377,0.5532950531051862,away,LAD,over,8.5,0.5454545454545454,-120,0.5206611570247933,NYM,LAD,2022 REG,10,3,7,4,7,17,0,1,-1,1,1,1,1,0,0,0,0,0,0,0.5206611570247933,0.4793388429752067
87810,0.46511627906976744,0.574468085106383,115,-135,0.44670494689481377,0.5532950531051862,home,NYM,under,8.5,0.5,100,0.4793388429752067,NYM,LAD,2022 REG,10,3,7,4,7,17,0,1,-1,1,1,1,1,0,0,0,0,0,0,0.5206611570247933,0.4793388429752067
87811,0.31746031746031744,0.7222222222222222,215,-260,0.3048626858150668,0.6951373141849332,away,NYM,over,7,0.504950495049505,-102,0.47949844489399435,CHC,NYM,2022 REG,10,3,7,4,7,17,0,1,-1,1,1,1,1,0,0,0,0,0,0,0.47949844489399435,0.5205015551060057
87811,0.31746031746031744,0.7222222222222222,215,-260,0.3048626858150668,0.6951373141849332,home,CHC,under,7,0.5454545454545454,-120,0.5205015551060057,CHC,NYM,2022 REG,10,3,7,4,7,17,0,1,-1,1,1,1,1,0,0,0,0,0,0,0.47949844489399435,0.5205015551060057
87812,0.5726495726495727,0.4672897196261683,-134,114,0.5497783539959433,0.4502216460040567,away,STL,over,8.5,0.5098039215686274,-104,0.4870219861770517,NYM,STL,2022 REG,5,3,11,4,7,16,0,1,-1,1,1,1,1,0,0,0,0,0,0,0.4870219861770517,0.5129780138229483
87812,0.5726495726495727,0.4672897196261683,-134,114,0.5497783539959433,0.4502216460040567,home,NYM,under,8.5,0.5348837209302326,-115,0.5129780138229483,NYM,STL,2022 REG,5,3,11,4,7,16,0,1,-1,1,1,1,1,0,0,0,0,0,0,0.4870219861770517,0.5129780138229483
87813,0.5283018867924528,0.5145631067961165,-112,-106,0.5056562298022652,0.4943437701977348,away,LAD,over,7.5,0.5370370370370371,-116,0.5118817074154765,SD,LAD,2022 REG,6,4,6,3,7,12,1,0,1,-1,1,1,1,0,0,0,0,0,0,0.5118817074154765,0.48811829258452355
87813,0.5283018867924528,0.5145631067961165,-112,-106,0.5056562298022652,0.4943437701977348,home,SD,under,7.5,0.5098039215686274,-104,0.48811829258452355,SD,LAD,2022 REG,6,4,6,3,7,12,1,0,1,-1,1,1,1,0,0,0,0,0,0,0.5118817074154765,0.48811829258452355
87814,0.5391705069124424,0.5,-117,100,0.5180509248444435,0.4819490751555565,away,TB,over,7.5,0.49504950495049505,102,0.47499799484898986,LAA,TB,2022 REG,6,2,5,4,6,11,0,1,-2,2,1,1,0,0,0,0,0,0,0,0.47499799484898986,0.5250020051510101
87814,0.5391705069124424,0.5,-117,100,0.5180509248444435,0.4819490751555565,home,LAA,under,7.5,0.5454545454545454,-120,0.5250020051510101,LAA,TB,2022 REG,6,2,5,4,6,11,0,1,-2,2,1,1,0,0,0,0,0,0,0,0.47499799484898986,0.5250020051510101
87815,0.5780590717299579,0.4587155963302753,-137,118,0.5568011412478822,0.44319885875211784,away,PIT,over,9,0.5283018867924528,-112,0.5044173060022736,CIN,PIT,2022 REG,9,3,10,6,9,19,0,1,-3,3,1,1,1,0,0,0,0,0,0,0.5044173060022736,0.49558269399772636
87815,0.5780590717299579,0.4587155963302753,-137,118,0.5568011412478822,0.44319885875211784,home,CIN,under,9,0.5169082125603864,-107,0.49558269399772636,CIN,PIT,2022 REG,9,3,10,6,9,19,0,1,-3,3,1,1,1,0,0,0,0,0,0,0.5044173060022736,0.49558269399772636
87816,0.3921568627450981,0.6428571428571428,155,-180,0.37842588015598405,0.6215741198440159,away,ATL,over,8,0.5121951219512195,-105,0.48919479393107135,MIA,ATL,2022 REG,5,2,10,6,8,15,0,1,-4,4,1,1,0,0,0,0,0,0,0,0.48919479393107135,0.5108052060689287
87816,0.3921568627450981,0.6428571428571428,155,-180,0.37842588015598405,0.6215741198440159,home,MIA,under,8,0.5327102803738317,-114,0.5108052060689287,MIA,ATL,2022 REG,5,2,10,6,8,15,0,1,-4,4,1,1,0,0,0,0,0,0,0,0.48919479393107135,0.5108052060689287
87817,0.5073891625615764,0.5348837209302326,-103,-115,0.4859403596076043,0.5140596403923957,away,BOS,over,9,0.504950495049505,-102,0.4826715732667395,CLE,BOS,2022 REG,12,3,12,6,9,24,0,1,-3,3,1,1,1,0,0,0,0,0,0,0.4826715732667395,0.5173284267332605
87817,0.5073891625615764,0.5348837209302326,-103,-115,0.4859403596076043,0.5140596403923957,home,CLE,under,9,0.5391705069124424,-117,0.5173284267332605,CLE,BOS,2022 REG,12,3,12,6,9,24,0,1,-3,3,1,1,1,0,0,0,0,0,0,0.4826715732667395,0.5173284267332605
87818,0.7142857142857143,0.3225806451612903,-250,210,0.6879526003949967,0.3120473996050033,away,WSH,over,9,0.5098039215686274,-104,0.48483656587239576,PHI,WSH,2022 REG,9,8,11,5,13,20,1,0,3,-3,1,1,1,1,1,0,0,0,0,0.48483656587239576,0.5151634341276042
87818,0.7142857142857143,0.3225806451612903,-250,210,0.6879526003949967,0.3120473996050033,home,PHI,under,9,0.5391705069124424,-117,0.5151634341276042,PHI,WSH,2022 REG,9,8,11,5,13,20,1,0,3,-3,1,1,1,1,1,0,0,0,0,0.48483656587239576,0.5151634341276042
87819,0.726027397260274,0.3125,-265,220,0.6980554513041847,0.30194454869581533,away,CHC,over,8.5,0.504950495049505,-102,0.48160416005266615,LAD,CHC,2022 REG,14,11,8,9,20,22,1,0,2,-2,1,1,1,1,1,1,1,1,1,0.48160416005266615,0.5183958399473338
87819,0.726027397260274,0.3125,-265,220,0.6980554513041847,0.30194454869581533,home,LAD,under,8.5,0.5412844036697247,-118,0.5183958399473338,LAD,CHC,2022 REG,14,11,8,9,20,22,1,0,2,-2,1,1,1,1,1,1,1,1,1,0.48160416005266615,0.5183958399473338
87820,0.4444444444444444,0.5918367346938775,125,-145,0.42831947593852354,0.5716805240614764,away,TOR,over,8,0.5169082125603864,-107,0.49239402434819424,CLE,TOR,2022 REG,11,6,9,5,11,20,1,0,1,-1,1,1,1,1,1,0,0,0,0,0.49239402434819424,0.5076059756518058
87820,0.4444444444444444,0.5918367346938775,125,-145,0.42831947593852354,0.5716805240614764,home,CLE,under,8,0.5305164319248826,-113,0.5076059756518058,CLE,TOR,2022 REG,11,6,9,5,11,20,1,0,1,-1,1,1,1,1,1,0,0,0,0,0.49239402434819424,0.5076059756518058
87821,0.42372881355932196,0.6183206106870228,136,-162,0.40591126091256574,0.5940887390874343,away,STL,over,12.5,0.5238095238095238,-110,0.5000596729920038,COL,STL,2022 REG,13,5,18,9,14,31,0,1,-4,4,1,1,1,1,1,0,0,0,0,0.5000596729920038,0.4999403270079962
87821,0.42372881355932196,0.6183206106870228,136,-162,0.40591126091256574,0.5940887390874343,home,COL,under,12.5,0.5215311004784688,-109,0.4999403270079962,COL,STL,2022 REG,13,5,18,9,14,31,0,1,-4,4,1,1,1,1,1,0,0,0,0,0.5000596729920038,0.4999403270079962
87822,0.36363636363636365,0.6721311475409836,175,-205,0.3506299959355101,0.6493700040644899,away,SEA,over,7,0.504950495049505,-102,0.48160416005266615,OAK,SEA,2022 REG,7,4,1,1,5,8,1,0,3,-3,1,0,0,0,0,0,0,0,0,0.48160416005266615,0.5183958399473338
87822,0.36363636363636365,0.6721311475409836,175,-205,0.3506299959355101,0.6493700040644899,home,OAK,under,7,0.5412844036697247,-118,0.5183958399473338,OAK,SEA,2022 REG,7,4,1,1,5,8,1,0,3,-3,1,0,0,0,0,0,0,0,0,0.48160416005266615,0.5183958399473338
87823,0.5726495726495727,0.47619047619047616,-134,110,0.5446813395531345,0.45531866044686553,away,KC,over,11,0.5098039215686274,-104,0.48483656587239576,COL,KC,2022 REG,9,7,9,8,15,18,0,1,-1,1,1,1,1,1,1,1,1,0,0,0.48483656587239576,0.5151634341276042
87823,0.5726495726495727,0.47619047619047616,-134,110,0.5446813395531345,0.45531866044686553,home,COL,under,11,0.5391705069124424,-117,0.5151634341276042,COL,KC,2022 REG,9,7,9,8,15,18,0,1,-1,1,1,1,1,1,1,1,1,0,0,0.48483656587239576,0.5151634341276042
87824,0.5238095238095238,0.5192307692307692,-110,-108,0.5012646084074657,0.4987353915925343,away,CWS,over,7,0.5454545454545454,-120,0.5206611570247933,SD,CWS,2022 REG,9,5,6,2,7,15,1,0,3,-3,1,1,0,0,0,0,0,0,0,0.5206611570247933,0.4793388429752067
87824,0.5238095238095238,0.5192307692307692,-110,-108,0.5012646084074657,0.4987353915925343,home,SD,under,7,0.5,100,0.4793388429752067,SD,CWS,2022 REG,9,5,6,2,7,15,1,0,3,-3,1,1,0,0,0,0,0,0,0,0.5206611570247933,0.4793388429752067
87825,0.7354497354497355,0.30303030303030304,-278,230,0.7071496013294954,0.29285039867050455,away,CLE,over,8,0.5192307692307692,-108,0.49688292476754015,LAD,CLE,2022 REG,8,1,6,2,3,14,0,1,-1,1,1,0,0,0,0,0,0,0,0,0.49688292476754015,0.5031170752324599
87825,0.7354497354497355,0.30303030303030304,-278,230,0.7071496013294954,0.29285039867050455,home,LAD,under,8,0.5238095238095238,-110,0.5031170752324599,LAD,CLE,2022 REG,8,1,6,2,3,14,0,1,-1,1,1,0,0,0,0,0,0,0,0,0.49688292476754015,0.5031170752324599
87826,0.6428571428571428,0.4,-180,150,0.6153061224489796,0.38469387755102036,away,WSH,over,9.5,0.5348837209302326,-115,0.5097020142727117,PHI,WSH,2022 REG,8,5,8,3,8,16,1,0,2,-2,1,1,1,0,0,0,0,0,0,0.5097020142727117,0.49029798572728833
87826,0.6428571428571428,0.4,-180,150,0.6153061224489796,0.38469387755102036,home,PHI,under,9.5,0.5121951219512195,-105,0.49029798572728833,PHI,WSH,2022 REG,8,5,8,3,8,16,1,0,2,-2,1,1,1,0,0,0,0,0,0,0.5097020142727117,0.49029798572728833
87827,0.7752808988764045,0.2597402597402597,-345,285,0.7481296635443839,0.2518703364556161,away,OAK,over,8.5,0.5024875621890548,-101,0.47839724939301687,NYY,OAK,2022 REG,6,5,9,3,8,15,1,0,2,-2,1,1,1,0,0,0,0,0,0,0.47839724939301687,0.5216027506069831
87827,0.7752808988764045,0.2597402597402597,-345,285,0.7481296635443839,0.2518703364556161,home,NYY,under,8.5,0.5454545454545454,-120,0.5216027506069831,NYY,OAK,2022 REG,6,5,9,3,8,15,1,0,2,-2,1,1,1,0,0,0,0,0,0,0.47839724939301687,0.5216027506069831
87828,0.6183206106870228,0.42016806722689076,-162,138,0.5945222678547557,0.4054777321452443,away,PIT,over,7.5,0.5145631067961165,-106,0.49023796582517226,MIA,PIT,2022 REG,9,3,6,2,5,15,1,0,1,-1,1,1,0,0,0,0,0,0,0,0.49023796582517226,0.5097620341748277
87828,0.6183206106870228,0.42016806722689076,-162,138,0.5945222678547557,0.4054777321452443,home,MIA,under,7.5,0.5327102803738317,-114,0.5097620341748277,MIA,PIT,2022 REG,9,3,6,2,5,15,1,0,1,-1,1,1,0,0,0,0,0,0,0,0.49023796582517226,0.5097620341748277
87829,0.48780487804878053,0.5495495495495495,105,-122,0.4695832060495952,0.5304167939504048,away,SEA,over,7.5,0.5238095238095238,-110,0.4988662131519274,TEX,SEA,2022 REG,8,5,4,3,8,12,1,0,2,-2,1,1,1,0,0,0,0,0,0,0.4988662131519274,0.5011337868480725
87829,0.48780487804878053,0.5495495495495495,105,-122,0.4695832060495952,0.5304167939504048,home,TEX,under,7.5,0.5238095238095238,-110,0.5011337868480725,TEX,SEA,2022 REG,8,5,4,3,8,12,1,0,2,-2,1,1,1,0,0,0,0,0,0,0.4988662131519274,0.5011337868480725
87830,0.726027397260274,0.3125,-265,220,0.6980554513041847,0.30194454869581533,away,DET,over,7.5,0.5348837209302326,-115,0.5097020142727117,LAD,DET,2022 REG,8,6,10,3,9,18,1,0,3,-3,1,1,1,0,0,0,0,0,0,0.5097020142727117,0.49029798572728833
87830,0.726027397260274,0.3125,-265,220,0.6980554513041847,0.30194454869581533,home,LAD,under,7.5,0.5121951219512195,-105,0.49029798572728833,LAD,DET,2022 REG,8,6,10,3,9,18,1,0,3,-3,1,1,1,0,0,0,0,0,0,0.5097020142727117,0.49029798572728833
87831,0.4484304932735426,0.5884773662551441,123,-143,0.43187988361942303,0.5681201163805769,away,MIL,over,7.5,0.5,100,0.4772727272727273,STL,MIL,2022 REG,6,2,4,3,5,10,0,1,-1,1,1,1,0,0,0,0,0,0,0,0.4772727272727273,0.5227272727272727
87831,0.4484304932735426,0.5884773662551441,123,-143,0.43187988361942303,0.5681201163805769,home,STL,under,7.5,0.5454545454545454,-120,0.5227272727272727,STL,MIL,2022 REG,6,2,4,3,5,10,0,1,-1,1,1,1,0,0,0,0,0,0,0,0.4772727272727273,0.5227272727272727
87832,0.5833333333333333,0.45454545454545453,-140,120,0.5612373737373737,0.4387626262626263,away,MIA,over,9.5,0.5169082125603864,-107,0.49239402434819424,LAA,MIA,2022 REG,7,6,3,2,8,10,1,0,4,-4,1,1,0,0,0,0,0,0,0,0.49239402434819424,0.5076059756518058
87832,0.5833333333333333,0.45454545454545453,-140,120,0.5612373737373737,0.4387626262626263,home,LAA,under,9.5,0.5305164319248826,-113,0.5076059756518058,LAA,MIA,2022 REG,7,6,3,2,8,10,1,0,4,-4,1,1,0,0,0,0,0,0,0,0.49239402434819424,0.5076059756518058
87833,0.5391705069124424,0.49504950495049505,-117,102,0.5207200857697526,0.4792799142302474,away,TB,over,9,0.5260663507109005,-111,0.5034588790373798,BOS,TB,2022 REG,16,9,9,8,17,25,1,0,1,-1,1,1,1,1,1,1,1,1,0,0.5034588790373798,0.49654112096262015
87833,0.5391705069124424,0.49504950495049505,-117,102,0.5207200857697526,0.4792799142302474,home,BOS,under,9,0.5169082125603864,-107,0.49654112096262015,BOS,TB,2022 REG,16,9,9,8,17,25,1,0,1,-1,1,1,1,1,1,1,1,1,0,0.5034588790373798,0.49654112096262015
87834,0.5555555555555556,0.4807692307692307,-125,108,0.5353751187084521,0.4646248812915479,away,SD,over,7.5,0.5215311004784688,-109,0.49907282342437215,MIL,SD,2022 REG,6,0,6,4,4,12,0,1,-4,4,0,0,0,0,0,0,0,0,0,0.49907282342437215,0.5009271765756278
87834,0.5555555555555556,0.4807692307692307,-125,108,0.5353751187084521,0.4646248812915479,home,MIL,under,7.5,0.5215311004784688,-109,0.5009271765756278,MIL,SD,2022 REG,6,0,6,4,4,12,0,1,-4,4,0,0,0,0,0,0,0,0,0,0.49907282342437215,0.5009271765756278
87835,0.647887323943662,0.39370078740157477,-184,154,0.6209429137763255,0.3790570862236745,away,BAL,over,7.5,0.5283018867924528,-112,0.5044173060022736,TB,BAL,2022 REG,8,2,7,1,3,15,1,0,1,-1,1,0,0,0,0,0,0,0,0,0.5044173060022736,0.49558269399772636
87835,0.647887323943662,0.39370078740157477,-184,154,0.6209429137763255,0.3790570862236745,home,TB,under,7.5,0.5169082125603864,-107,0.49558269399772636,TB,BAL,2022 REG,8,2,7,1,3,15,1,0,1,-1,1,0,0,0,0,0,0,0,0,0.5044173060022736,0.49558269399772636
87836,0.4854368932038835,0.5555555555555556,106,-125,0.465537646233282,0.534462353766718,away,HOU,over,7.5,0.49504950495049505,102,0.47297076509898783,SEA,HOU,2022 REG,13,6,5,0,6,18,1,0,6,-6,0,0,0,0,0,0,0,0,0,0.47297076509898783,0.5270292349010122
87836,0.4854368932038835,0.5555555555555556,106,-125,0.465537646233282,0.534462353766718,home,SEA,under,7.5,0.5495495495495495,-122,0.5270292349010122,SEA,HOU,2022 REG,13,6,5,0,6,18,1,0,6,-6,0,0,0,0,0,0,0,0,0,0.47297076509898783,0.5270292349010122
87837,0.3448275862068966,0.7014925373134329,190,-235,0.3288551298205761,0.6711448701794239,away,LAD,over,8,0.5145631067961165,-106,0.49023796582517226,PIT,LAD,2022 REG,4,1,15,11,12,19,0,1,-10,10,1,0,0,0,0,0,0,0,0,0.49023796582517226,0.5097620341748277
87837,0.3448275862068966,0.7014925373134329,190,-235,0.3288551298205761,0.6711448701794239,home,PIT,under,8,0.5327102803738317,-114,0.5097620341748277,PIT,LAD,2022 REG,4,1,15,11,12,19,0,1,-10,10,1,0,0,0,0,0,0,0,0,0.49023796582517226,0.5097620341748277
87838,0.576271186440678,0.4629629629629629,-136,116,0.553661676614851,0.446338323385149,away,TEX,over,8,0.5169082125603864,-107,0.49239402434819424,NYM,TEX,2022 REG,7,4,7,1,5,14,1,0,3,-3,1,0,0,0,0,0,0,0,0,0.49239402434819424,0.5076059756518058
87838,0.576271186440678,0.4629629629629629,-136,116,0.553661676614851,0.446338323385149,home,NYM,under,8,0.5305164319248826,-113,0.5076059756518058,NYM,TEX,2022 REG,7,4,7,1,5,14,1,0,3,-3,1,0,0,0,0,0,0,0,0,0.49239402434819424,0.5076059756518058
87839,0.45248868778280543,0.5884773662551441,121,-143,0.43395201174753417,0.5660479882524658,away,TB,over,8,0.5412844036697247,-118,0.5189377998484975,BAL,TB,2022 REG,11,8,10,6,14,21,1,0,2,-2,1,1,1,1,1,1,0,0,0,0.5189377998484975,0.4810622001515025
87839,0.45248868778280543,0.5884773662551441,121,-143,0.43395201174753417,0.5660479882524658,home,BAL,under,8,0.5,100,0.4810622001515025,BAL,TB,2022 REG,11,8,10,6,14,21,1,0,2,-2,1,1,1,1,1,1,0,0,0,0.5189377998484975,0.4810622001515025
87840,0.6153846153846154,0.425531914893617,-160,135,0.5902052121364724,0.40979478786352763,away,BOS,over,8.5,0.5121951219512195,-105,0.48808156828023186,CLE,BOS,2022 REG,7,2,10,4,6,17,0,1,-2,2,1,1,0,0,0,0,0,0,0,0.48808156828023186,0.5119184317197681
87840,0.6153846153846154,0.425531914893617,-160,135,0.5902052121364724,0.40979478786352763,home,CLE,under,8.5,0.5348837209302326,-115,0.5119184317197681,CLE,BOS,2022 REG,7,2,10,4,6,17,0,1,-2,2,1,1,0,0,0,0,0,0,0,0.48808156828023186,0.5119184317197681
87841,0.6226415094339623,0.4132231404958678,-165,142,0.6003106896663323,0.3996893103336677,away,OAK,over,8,0.5145631067961165,-106,0.49023796582517226,BAL,OAK,2022 REG,9,5,6,2,7,15,1,0,3,-3,1,1,0,0,0,0,0,0,0,0.49023796582517226,0.5097620341748277
87841,0.6226415094339623,0.4132231404958678,-165,142,0.6003106896663323,0.3996893103336677,home,BAL,under,8,0.5327102803738317,-114,0.5097620341748277,BAL,OAK,2022 REG,9,5,6,2,7,15,1,0,3,-3,1,1,0,0,0,0,0,0,0,0.49023796582517226,0.5097620341748277
87842,0.6153846153846154,0.425531914893617,-160,135,0.5902052121364724,0.40979478786352763,away,COL,over,9,0.5327102803738317,-114,0.5075272610403079,MIN,COL,2022 REG,3,0,5,1,1,8,0,1,-1,1,0,0,0,0,0,0,0,0,0,0.5075272610403079,0.4924727389596921
87842,0.6153846153846154,0.425531914893617,-160,135,0.5902052121364724,0.40979478786352763,home,MIN,under,9,0.5145631067961165,-106,0.4924727389596921,MIN,COL,2022 REG,3,0,5,1,1,8,0,1,-1,1,0,0,0,0,0,0,0,0,0,0.5075272610403079,0.4924727389596921
87843,0.6000000000000001,0.4444444444444444,-150,125,0.5733333333333334,0.42666666666666664,away,LAA,over,7,0.49504950495049505,102,0.47097973588023584,MIA,LAA,2022 REG,8,2,3,1,3,11,1,0,1,-1,1,0,0,0,0,0,0,0,0,0.47097973588023584,0.5290202641197641
87843,0.6000000000000001,0.4444444444444444,-150,125,0.5733333333333334,0.42666666666666664,home,MIA,under,7,0.5535714285714286,-124,0.5290202641197641,MIA,LAA,2022 REG,8,2,3,1,3,11,1,0,1,-1,1,0,0,0,0,0,0,0,0,0.47097973588023584,0.5290202641197641
87844,0.3333333333333333,0.7014925373134329,200,-235,0.32172470978441126,0.6782752902155887,away,HOU,over,8,0.5305164319248826,-113,0.5078572507605655,DET,HOU,2022 REG,6,3,12,6,9,18,0,1,-3,3,1,1,1,0,0,0,0,0,0,0.5078572507605655,0.49214274923943446
87844,0.3333333333333333,0.7014925373134329,200,-235,0.32172470978441126,0.6782752902155887,home,DET,under,8,0.5121951219512195,-105,0.49214274923943446,DET,HOU,2022 REG,6,3,12,6,9,18,0,1,-3,3,1,1,1,0,0,0,0,0,0,0.5078572507605655,0.49214274923943446
87845,0.6774193548387096,0.35714285714285715,-210,180,0.6540062434963579,0.34599375650364206,away,PIT,over,7.5,0.5238095238095238,-110,0.4988662131519274,SD,PIT,2022 REG,8,4,5,2,6,13,1,0,2,-2,1,1,0,0,0,0,0,0,0,0.4988662131519274,0.5011337868480725
87845,0.6774193548387096,0.35714285714285715,-210,180,0.6540062434963579,0.34599375650364206,home,SD,under,7.5,0.5238095238095238,-110,0.5011337868480725,SD,PIT,2022 REG,8,4,5,2,6,13,1,0,2,-2,1,1,0,0,0,0,0,0,0,0.4988662131519274,0.5011337868480725
87846,0.6363636363636364,0.4081632653061224,-175,145,0.6080283353010626,0.3919716646989374,away,BAL,over,7.5,0.5121951219512195,-105,0.48808156828023186,SEA,BAL,2022 REG,6,2,1,0,2,7,1,0,2,-2,0,0,0,0,0,0,0,0,0,0.48808156828023186,0.5119184317197681
87846,0.6363636363636364,0.4081632653061224,-175,145,0.6080283353010626,0.3919716646989374,home,SEA,under,7.5,0.5348837209302326,-115,0.5119184317197681,SEA,BAL,2022 REG,6,2,1,0,2,7,1,0,2,-2,0,0,0,0,0,0,0,0,0,0.48808156828023186,0.5119184317197681
87847,0.4166666666666667,0.6226415094339623,140,-165,0.4002882599580712,0.5997117400419287,away,MIL,over,8.5,0.5412844036697247,-118,0.5136310900085983,CIN,MIL,2022 REG,7,3,11,5,8,18,0,1,-2,2,1,1,1,0,0,0,0,0,0,0.5136310900085983,0.4863689099914017
87847,0.4166666666666667,0.6226415094339623,140,-165,0.4002882599580712,0.5997117400419287,home,CIN,under,8.5,0.5098039215686274,-104,0.4863689099914017,CIN,MIL,2022 REG,7,3,11,5,8,18,0,1,-2,2,1,1,1,0,0,0,0,0,0,0.5136310900085983,0.4863689099914017
87848,0.6363636363636364,0.4081632653061224,-175,145,0.6080283353010626,0.3919716646989374,away,OAK,over,7,0.5535714285714286,-124,0.5293429871948779,SEA,OAK,2022 REG,5,2,9,4,6,14,0,1,-2,2,1,1,0,0,0,0,0,0,0,0.5293429871948779,0.47065701280512207
87848,0.6363636363636364,0.4081632653061224,-175,145,0.6080283353010626,0.3919716646989374,home,SEA,under,7,0.49019607843137253,104,0.47065701280512207,SEA,OAK,2022 REG,5,2,9,4,6,14,0,1,-2,2,1,1,0,0,0,0,0,0,0,0.5293429871948779,0.47065701280512207
87849,0.5689655172413793,0.4672897196261683,-132,114,0.5483375376443265,0.45166246235567353,away,KC,over,7.5,0.5238095238095238,-110,0.4988662131519274,SEA,KC,2022 REG,8,4,8,1,5,16,1,0,3,-3,1,0,0,0,0,0,0,0,0,0.4988662131519274,0.5011337868480725
87849,0.5689655172413793,0.4672897196261683,-132,114,0.5483375376443265,0.45166246235567353,home,SEA,under,7.5,0.5238095238095238,-110,0.5011337868480725,SEA,KC,2022 REG,8,4,8,1,5,16,1,0,3,-3,1,0,0,0,0,0,0,0,0,0.4988662131519274,0.5011337868480725
87850,0.46511627906976744,0.576271186440678,115,-136,0.44586629511142073,0.5541337048885793,away,MIN,over,8,0.5121951219512195,-105,0.48808156828023186,LAA,MIN,2022 REG,4,0,9,4,4,13,0,1,-4,4,0,0,0,0,0,0,0,0,0,0.48808156828023186,0.5119184317197681
87850,0.46511627906976744,0.576271186440678,115,-136,0.44586629511142073,0.5541337048885793,home,LAA,under,8,0.5348837209302326,-115,0.5119184317197681,LAA,MIN,2022 REG,4,0,9,4,4,13,0,1,-4,4,0,0,0,0,0,0,0,0,0,0.48808156828023186,0.5119184317197681
87851,0.45454545454545453,0.5798319327731092,120,-138,0.4389193694006528,0.5610806305993472,away,CLE,over,7,0.5555555555555556,-125,0.5314664257753688,KC,CLE,2022 REG,7,5,12,6,11,19,0,1,-1,1,1,1,1,1,1,0,0,0,0,0.5314664257753688,0.46853357422463116
87851,0.45454545454545453,0.5798319327731092,120,-138,0.4389193694006528,0.5610806305993472,home,KC,under,7,0.48780487804878053,105,0.46853357422463116,KC,CLE,2022 REG,7,5,12,6,11,19,0,1,-1,1,1,1,1,1,1,0,0,0,0,0.5314664257753688,0.46853357422463116
87852,0.647887323943662,0.3921568627450981,-184,155,0.6219432029903809,0.37805679700961914,away,TEX,over,7.5,0.5370370370370371,-116,0.5105975442470474,HOU,TEX,2022 REG,7,7,7,5,12,14,1,0,2,-2,1,1,1,1,1,0,0,0,0,0.5105975442470474,0.4894024557529526
87852,0.647887323943662,0.3921568627450981,-184,155,0.6219432029903809,0.37805679700961914,home,HOU,under,7.5,0.5121951219512195,-105,0.4894024557529526,HOU,TEX,2022 REG,7,7,7,5,12,14,1,0,2,-2,1,1,1,1,1,0,0,0,0,0.5105975442470474,0.4894024557529526
87853,0.607843137254902,0.425531914893617,-155,135,0.5875563408509002,0.41244365914909975,away,MIA,over,6.5,0.5098039215686274,-104,0.48483656587239576,TB,MIA,2022 REG,10,4,5,0,4,15,1,0,4,-4,0,0,0,0,0,0,0,0,0,0.48483656587239576,0.5151634341276042
87853,0.607843137254902,0.425531914893617,-155,135,0.5875563408509002,0.41244365914909975,home,TB,under,6.5,0.5391705069124424,-117,0.5151634341276042,TB,MIA,2022 REG,10,4,5,0,4,15,1,0,4,-4,0,0,0,0,0,0,0,0,0,0.48483656587239576,0.5151634341276042
87854,0.5967741935483871,0.4424778761061947,-148,126,0.5733495713351688,0.42665042866483116,away,STL,over,6.5,0.5391705069124424,-117,0.5140669063204599,SF,STL,2022 REG,9,13,14,7,20,23,1,0,6,-6,1,1,1,1,1,1,1,0,0,0.5140669063204599,0.4859330936795401
87854,0.5967741935483871,0.4424778761061947,-148,126,0.5733495713351688,0.42665042866483116,home,SF,under,6.5,0.5073891625615764,-103,0.4859330936795401,SF,STL,2022 REG,9,13,14,7,20,23,1,0,6,-6,1,1,1,1,1,1,1,0,0,0.5140669063204599,0.4859330936795401
87855,0.6000000000000001,0.4347826086956522,-150,130,0.5791304347826086,0.4208695652173914,away,MIL,over,7,0.5348837209302326,-115,0.5097020142727117,LAD,MIL,2022 REG,11,10,4,1,11,15,1,0,9,-9,1,0,0,0,0,0,0,0,0,0.5097020142727117,0.49029798572728833
87855,0.6000000000000001,0.4347826086956522,-150,130,0.5791304347826086,0.4208695652173914,home,LAD,under,7,0.5121951219512195,-105,0.49029798572728833,LAD,MIL,2022 REG,11,10,4,1,11,15,1,0,9,-9,1,0,0,0,0,0,0,0,0,0.5097020142727117,0.49029798572728833
87856,0.49504950495049505,0.5412844036697247,102,-118,0.47706242147513866,0.5229375785248613,away,TB,over,8.5,0.5098039215686274,-104,0.4870219861770517,BAL,TB,2022 REG,8,5,8,1,6,16,1,0,4,-4,1,0,0,0,0,0,0,0,0,0.4870219861770517,0.5129780138229483
87856,0.49504950495049505,0.5412844036697247,102,-118,0.47706242147513866,0.5229375785248613,home,BAL,under,8.5,0.5348837209302326,-115,0.5129780138229483,BAL,TB,2022 REG,8,5,8,1,6,16,1,0,4,-4,1,0,0,0,0,0,0,0,0,0.4870219861770517,0.5129780138229483
87857,0.4672897196261683,0.5689655172413793,114,-132,0.4503480201553517,0.5496519798446483,away,LAD,over,8,0.5238095238095238,-110,0.5012646084074657,SF,LAD,2022 REG,5,2,5,0,2,10,1,0,2,-2,0,0,0,0,0,0,0,0,0,0.5012646084074657,0.4987353915925343
87857,0.4672897196261683,0.5689655172413793,114,-132,0.4503480201553517,0.5496519798446483,home,SF,under,8,0.5192307692307692,-108,0.4987353915925343,SF,LAD,2022 REG,5,2,5,0,2,10,1,0,2,-2,0,0,0,0,0,0,0,0,0,0.5012646084074657,0.4987353915925343
87858,0.5215311004784688,0.5192307692307692,-109,-108,0.50027251771145,0.49972748228855,away,SD,over,7.5,0.5238095238095238,-110,0.5000596729920038,SF,SD,2022 REG,10,7,11,8,15,21,0,1,-1,1,1,1,1,1,1,1,1,0,0,0.5000596729920038,0.4999403270079962
87858,0.5215311004784688,0.5192307692307692,-109,-108,0.50027251771145,0.49972748228855,home,SF,under,7.5,0.5215311004784688,-109,0.4999403270079962,SF,SD,2022 REG,10,7,11,8,15,21,0,1,-1,1,1,1,1,1,1,1,1,0,0,0.5000596729920038,0.4999403270079962
87859,0.5652173913043479,0.4716981132075471,-130,112,0.5443521061454507,0.4556478938545493,away,OAK,over,8,0.5391705069124424,-117,0.5140669063204599,TEX,OAK,2022 REG,9,1,11,5,6,20,0,1,-4,4,1,0,0,0,0,0,0,0,0,0.5140669063204599,0.4859330936795401
87859,0.5652173913043479,0.4716981132075471,-130,112,0.5443521061454507,0.4556478938545493,home,TEX,under,8,0.5073891625615764,-103,0.4859330936795401,TEX,OAK,2022 REG,9,1,11,5,6,20,0,1,-4,4,1,0,0,0,0,0,0,0,0,0.5140669063204599,0.4859330936795401
87860,0.5594713656387665,0.47619047619047616,-127,110,0.5395195862893665,0.46048041371063353,away,HOU,over,7.5,0.5098039215686274,-104,0.48483656587239576,LAA,HOU,2022 REG,4,2,7,1,3,11,1,0,1,-1,1,0,0,0,0,0,0,0,0,0.48483656587239576,0.5151634341276042
87860,0.5594713656387665,0.47619047619047616,-127,110,0.5395195862893665,0.46048041371063353,home,LAA,under,7.5,0.5391705069124424,-117,0.5151634341276042,LAA,HOU,2022 REG,4,2,7,1,3,11,1,0,1,-1,1,0,0,0,0,0,0,0,0,0.48483656587239576,0.5151634341276042
87861,0.6031746031746031,0.425531914893617,-152,135,0.5858595605302799,0.4141404394697201,away,MIN,over,7.5,0.5305164319248826,-113,0.5053568787472517,CLE,MIN,2022 REG,8,4,8,3,7,16,1,0,1,-1,1,1,1,0,0,0,0,0,0,0.5053568787472517,0.49464312125274834
87861,0.6031746031746031,0.425531914893617,-152,135,0.5858595605302799,0.4141404394697201,home,CLE,under,7.5,0.5169082125603864,-107,0.49464312125274834,CLE,MIN,2022 REG,8,4,8,3,7,16,1,0,1,-1,1,1,1,0,0,0,0,0,0,0.5053568787472517,0.49464312125274834
87862,0.3448275862068966,0.7014925373134329,190,-235,0.3288551298205761,0.6711448701794239,away,LAA,over,6.5,0.5454545454545454,-120,0.5206611570247933,OAK,LAA,2022 REG,4,3,6,2,5,10,1,0,1,-1,1,1,0,0,0,0,0,0,0,0.5206611570247933,0.4793388429752067
87862,0.3448275862068966,0.7014925373134329,190,-235,0.3288551298205761,0.6711448701794239,home,OAK,under,6.5,0.5,100,0.4793388429752067,OAK,LAA,2022 REG,4,3,6,2,5,10,1,0,1,-1,1,1,0,0,0,0,0,0,0,0.5206611570247933,0.4793388429752067
87863,0.5145631067961165,0.5238095238095238,-106,-110,0.4948179667757384,0.5051820332242616,away,STL,over,11.5,0.5348837209302326,-115,0.5109810284308424,COL,STL,2022 REG,9,8,12,6,14,21,1,0,2,-2,1,1,1,1,1,1,0,0,0,0.5109810284308424,0.48901897156915763
87863,0.5145631067961165,0.5238095238095238,-106,-110,0.4948179667757384,0.5051820332242616,home,COL,under,11.5,0.5098039215686274,-104,0.48901897156915763,COL,STL,2022 REG,9,8,12,6,14,21,1,0,2,-2,1,1,1,1,1,1,0,0,0,0.5109810284308424,0.48901897156915763
87864,0.6453900709219857,0.3921568627450981,-182,155,0.6211576527396834,0.3788423472603166,away,DET,over,9.5,0.49504950495049505,102,0.47297076509898783,BOS,DET,2022 REG,9,5,10,2,7,19,1,0,3,-3,1,1,0,0,0,0,0,0,0,0.47297076509898783,0.5270292349010122
87864,0.6453900709219857,0.3921568627450981,-182,155,0.6211576527396834,0.3788423472603166,home,BOS,under,9.5,0.5495495495495495,-122,0.5270292349010122,BOS,DET,2022 REG,9,5,10,2,7,19,1,0,3,-3,1,1,0,0,0,0,0,0,0,0.47297076509898783,0.5270292349010122
87865,0.7530864197530864,0.29411764705882354,-305,240,0.7175376780799196,0.28246232192008036,away,ARI,over,7.5,0.5098039215686274,-104,0.4870219861770517,LAD,ARI,2022 REG,9,5,7,2,7,16,1,0,3,-3,1,1,0,0,0,0,0,0,0,0.4870219861770517,0.5129780138229483
87865,0.7530864197530864,0.29411764705882354,-305,240,0.7175376780799196,0.28246232192008036,home,LAD,under,7.5,0.5348837209302326,-115,0.5129780138229483,LAD,ARI,2022 REG,9,5,7,2,7,16,1,0,3,-3,1,1,0,0,0,0,0,0,0,0.4870219861770517,0.5129780138229483
87866,0.6363636363636364,0.40322580645161293,-175,148,0.6111703545721141,0.3888296454278859,away,PIT,over,9.5,0.5215311004784688,-109,0.49907282342437215,CHC,PIT,2022 REG,23,21,3,0,21,26,1,0,21,-21,0,0,0,0,0,0,0,0,0,0.49907282342437215,0.5009271765756278
87866,0.6363636363636364,0.40322580645161293,-175,148,0.6111703545721141,0.3888296454278859,home,CHC,under,9.5,0.5215311004784688,-109,0.5009271765756278,CHC,PIT,2022 REG,23,21,3,0,21,26,1,0,21,-21,0,0,0,0,0,0,0,0,0,0.49907282342437215,0.5009271765756278
87867,0.5833333333333333,0.45454545454545453,-140,120,0.5612373737373737,0.4387626262626263,away,NYM,over,8,0.5305164319248826,-113,0.5066009958897986,HOU,NYM,2022 REG,7,5,8,3,8,15,1,0,2,-2,1,1,1,0,0,0,0,0,0,0.5066009958897986,0.49339900411020143
87867,0.5833333333333333,0.45454545454545453,-140,120,0.5612373737373737,0.4387626262626263,home,HOU,under,8,0.5145631067961165,-106,0.49339900411020143,HOU,NYM,2022 REG,7,5,8,3,8,15,1,0,2,-2,1,1,1,0,0,0,0,0,0,0.5066009958897986,0.49339900411020143
87868,0.7101449275362319,0.33783783783783783,-245,196,0.6760702100966752,0.32392978990332477,away,PHI,over,6,0.5192307692307692,-108,0.49455035168025013,NYM,PHI,2022 REG,4,1,3,0,1,7,1,0,1,-1,0,0,0,0,0,0,0,0,0,0.49455035168025013,0.5054496483197499
87868,0.7101449275362319,0.33783783783783783,-245,196,0.6760702100966752,0.32392978990332477,home,NYM,under,6,0.5283018867924528,-112,0.5054496483197499,NYM,PHI,2022 REG,4,1,3,0,1,7,1,0,1,-1,0,0,0,0,0,0,0,0,0,0.49455035168025013,0.5054496483197499
87869,0.7222222222222222,0.31746031746031744,-260,215,0.693562610229277,0.306437389770723,away,BAL,over,8.5,0.5121951219512195,-105,0.48808156828023186,TOR,BAL,2022 REG,8,2,13,10,12,21,0,1,-8,8,1,1,0,0,0,0,0,0,0,0.48808156828023186,0.5119184317197681
87869,0.7222222222222222,0.31746031746031744,-260,215,0.693562610229277,0.306437389770723,home,TOR,under,8.5,0.5348837209302326,-115,0.5119184317197681,TOR,BAL,2022 REG,8,2,13,10,12,21,0,1,-8,8,1,1,0,0,0,0,0,0,0,0.48808156828023186,0.5119184317197681
87870,0.5967741935483871,0.43859649122807015,-148,128,0.5756658816656627,0.4243341183343373,away,BAL,over,8,0.5348837209302326,-115,0.5109810284308424,CLE,BAL,2022 REG,9,5,1,1,6,10,1,0,4,-4,1,0,0,0,0,0,0,0,0,0.5109810284308424,0.48901897156915763
87870,0.5967741935483871,0.43859649122807015,-148,128,0.5756658816656627,0.4243341183343373,home,CLE,under,8,0.5098039215686274,-104,0.48901897156915763,CLE,BAL,2022 REG,9,5,1,1,6,10,1,0,4,-4,1,0,0,0,0,0,0,0,0,0.5109810284308424,0.48901897156915763
87871,0.574468085106383,0.46511627906976744,-135,115,0.5517281312179562,0.44827186878204384,away,CWS,over,9,0.5238095238095238,-110,0.4988662131519274,MIN,CWS,2022 REG,7,2,8,6,8,15,0,1,-4,4,1,1,0,0,0,0,0,0,0,0.4988662131519274,0.5011337868480725
87871,0.574468085106383,0.46511627906976744,-135,115,0.5517281312179562,0.44827186878204384,home,MIN,under,9,0.5238095238095238,-110,0.5011337868480725,MIN,CWS,2022 REG,7,2,8,6,8,15,0,1,-4,4,1,1,0,0,0,0,0,0,0,0.4988662131519274,0.5011337868480725
87872,0.5283018867924528,0.5145631067961165,-112,-106,0.5056562298022652,0.4943437701977348,away,SF,over,8.5,0.5215311004784688,-109,0.4978845547971712,PHI,SF,2022 REG,5,4,6,5,9,11,0,1,-1,1,1,1,1,1,0,0,0,0,0,0.4978845547971712,0.5021154452028288
87872,0.5283018867924528,0.5145631067961165,-112,-106,0.5056562298022652,0.4943437701977348,home,PHI,under,8.5,0.5238095238095238,-110,0.5021154452028288,PHI,SF,2022 REG,5,4,6,5,9,11,0,1,-1,1,1,1,1,1,0,0,0,0,0,0.4978845547971712,0.5021154452028288
87873,0.5780590717299579,0.46511627906976744,-137,115,0.5531011685250534,0.4468988314749466,away,CWS,over,8,0.5348837209302326,-115,0.5097020142727117,TOR,CWS,2022 REG,10,7,9,3,10,19,1,0,4,-4,1,1,1,0,0,0,0,0,0,0.5097020142727117,0.49029798572728833
87873,0.5780590717299579,0.46511627906976744,-137,115,0.5531011685250534,0.4468988314749466,home,TOR,under,8,0.5121951219512195,-105,0.49029798572728833,TOR,CWS,2022 REG,10,7,9,3,10,19,1,0,4,-4,1,1,1,0,0,0,0,0,0,0.5097020142727117,0.49029798572728833
87874,0.5652173913043479,0.47619047619047616,-130,110,0.5418129444594474,0.4581870555405526,away,PHI,over,8.5,0.5305164319248826,-113,0.5066009958897986,NYM,PHI,2022 REG,10,8,7,2,10,17,1,0,6,-6,1,1,0,0,0,0,0,0,0,0.5066009958897986,0.49339900411020143
87874,0.5652173913043479,0.47619047619047616,-130,110,0.5418129444594474,0.4581870555405526,home,NYM,under,8.5,0.5145631067961165,-106,0.49339900411020143,NYM,PHI,2022 REG,10,8,7,2,10,17,1,0,6,-6,1,1,0,0,0,0,0,0,0,0.5066009958897986,0.49339900411020143
87875,0.45454545454545453,0.5815899581589958,120,-139,0.43812026695252254,0.5618797330474774,away,TOR,over,6.5,0.5238095238095238,-110,0.4988662131519274,CLE,TOR,2022 REG,6,3,10,8,11,16,0,1,-5,5,1,1,1,0,0,0,0,0,0,0.4988662131519274,0.5011337868480725
87875,0.45454545454545453,0.5815899581589958,120,-139,0.43812026695252254,0.5618797330474774,home,CLE,under,6.5,0.5238095238095238,-110,0.5011337868480725,CLE,TOR,2022 REG,6,3,10,8,11,16,0,1,-5,5,1,1,1,0,0,0,0,0,0,0.4988662131519274,0.5011337868480725
87876,0.5305164319248826,0.5145631067961165,-113,-106,0.5066009958897986,0.49339900411020143,away,ATL,over,7,0.5454545454545454,-120,0.5206611570247933,MIA,ATL,2022 REG,8,4,6,3,7,14,1,0,1,-1,1,1,1,0,0,0,0,0,0,0.5206611570247933,0.4793388429752067
87876,0.5305164319248826,0.5145631067961165,-113,-106,0.5066009958897986,0.49339900411020143,home,MIA,under,7,0.5,100,0.4793388429752067,MIA,ATL,2022 REG,8,4,6,3,7,14,1,0,1,-1,1,1,1,0,0,0,0,0,0,0.5206611570247933,0.4793388429752067
87877,0.425531914893617,0.613899613899614,135,-159,0.40875254093905067,0.5912474590609493,away,CLE,over,9,0.5348837209302326,-115,0.5097020142727117,DET,CLE,2022 REG,13,11,11,4,15,24,1,0,7,-7,1,1,1,1,0,0,0,0,0,0.5097020142727117,0.49029798572728833
87877,0.425531914893617,0.613899613899614,135,-159,0.40875254093905067,0.5912474590609493,home,DET,under,9,0.5121951219512195,-105,0.49029798572728833,DET,CLE,2022 REG,13,11,11,4,15,24,1,0,7,-7,1,1,1,1,0,0,0,0,0,0.5097020142727117,0.49029798572728833
87878,0.35714285714285715,0.6825396825396826,180,-215,0.34297052154195007,0.6570294784580499,away,ATL,over,8.5,0.5454545454545454,-120,0.5206611570247933,WSH,ATL,2022 REG,6,2,10,8,10,16,0,1,-6,6,1,1,0,0,0,0,0,0,0,0.5206611570247933,0.4793388429752067
87878,0.35714285714285715,0.6825396825396826,180,-215,0.34297052154195007,0.6570294784580499,home,WSH,under,8.5,0.5,100,0.4793388429752067,WSH,ATL,2022 REG,6,2,10,8,10,16,0,1,-6,6,1,1,0,0,0,0,0,0,0,0.5206611570247933,0.4793388429752067
87879,0.6774193548387096,0.36363636363636365,-210,175,0.6496074165168858,0.3503925834831142,away,WSH,over,8,0.5145631067961165,-106,0.49023796582517226,PHI,WSH,2022 REG,4,2,8,3,5,12,0,1,-1,1,1,1,0,0,0,0,0,0,0,0.49023796582517226,0.5097620341748277
87879,0.6774193548387096,0.36363636363636365,-210,175,0.6496074165168858,0.3503925834831142,home,PHI,under,8,0.5327102803738317,-114,0.5097620341748277,PHI,WSH,2022 REG,4,2,8,3,5,12,0,1,-1,1,1,1,0,0,0,0,0,0,0,0.49023796582517226,0.5097620341748277
87880,0.6402877697841727,0.4,-178,150,0.6144920035194866,0.38550799648051337,away,TEX,over,8,0.5169082125603864,-107,0.49353874091423283,LAA,TEX,2022 REG,12,5,6,3,8,18,1,0,2,-2,1,1,1,0,0,0,0,0,0,0.49353874091423283,0.5064612590857671
87880,0.6402877697841727,0.4,-178,150,0.6144920035194866,0.38550799648051337,home,LAA,under,8,0.5283018867924528,-112,0.5064612590857671,LAA,TEX,2022 REG,12,5,6,3,8,18,1,0,2,-2,1,1,1,0,0,0,0,0,0,0.49353874091423283,0.5064612590857671
87881,0.5815899581589958,0.4587155963302753,-139,118,0.5581486524100054,0.44185134758999456,away,PHI,over,7.5,0.5348837209302326,-115,0.5097020142727117,ATL,PHI,2022 REG,6,1,5,3,4,11,0,1,-2,2,1,0,0,0,0,0,0,0,0,0.5097020142727117,0.49029798572728833
87881,0.5815899581589958,0.4587155963302753,-139,118,0.5581486524100054,0.44185134758999456,home,ATL,under,7.5,0.5121951219512195,-105,0.49029798572728833,ATL,PHI,2022 REG,6,1,5,3,4,11,0,1,-2,2,1,0,0,0,0,0,0,0,0,0.5097020142727117,0.49029798572728833
87882,0.7354497354497355,0.3076923076923077,-278,225,0.7037209312341587,0.2962790687658413,away,ARI,over,8,0.5238095238095238,-110,0.5012646084074657,LAD,ARI,2022 REG,9,5,9,3,8,18,1,0,2,-2,1,1,1,0,0,0,0,0,0,0.5012646084074657,0.4987353915925343
87882,0.7354497354497355,0.3076923076923077,-278,225,0.7037209312341587,0.2962790687658413,home,LAD,under,8,0.5192307692307692,-108,0.4987353915925343,LAD,ARI,2022 REG,9,5,9,3,8,18,1,0,2,-2,1,1,1,0,0,0,0,0,0,0.5012646084074657,0.4987353915925343
87883,0.5121951219512195,0.5305164319248826,-105,-113,0.4903184724049234,0.5096815275950766,away,PHI,over,7.5,0.5348837209302326,-115,0.5109810284308424,MIA,PHI,2022 REG,8,3,11,10,13,19,0,1,-7,7,1,1,1,0,0,0,0,0,0,0.5109810284308424,0.48901897156915763
87883,0.5121951219512195,0.5305164319248826,-105,-113,0.4903184724049234,0.5096815275950766,home,MIA,under,7.5,0.5098039215686274,-104,0.48901897156915763,MIA,PHI,2022 REG,8,3,11,10,13,19,0,1,-7,7,1,1,1,0,0,0,0,0,0,0.5109810284308424,0.48901897156915763
87884,0.4444444444444444,0.5967741935483871,125,-148,0.42612504978096366,0.5738749502190363,away,MIL,over,9,0.5283018867924528,-112,0.5031902949311281,CHC,MIL,2022 REG,12,8,7,7,15,19,1,0,1,-1,1,1,1,1,1,1,1,0,0,0.5031902949311281,0.4968097050688719
87884,0.4444444444444444,0.5967741935483871,125,-148,0.42612504978096366,0.5738749502190363,home,CHC,under,9,0.5192307692307692,-108,0.4968097050688719,CHC,MIL,2022 REG,12,8,7,7,15,19,1,0,1,-1,1,1,1,1,1,1,1,0,0,0.5031902949311281,0.4968097050688719
87885,0.41152263374485604,0.6254681647940076,143,-167,0.39630008290581753,0.6036999170941825,away,SD,over,7.5,0.49019607843137253,104,0.46874141813588177,PIT,SD,2022 REG,10,3,7,7,10,17,0,1,-4,4,1,1,1,0,0,0,0,0,0,0.46874141813588177,0.5312585818641182
87885,0.41152263374485604,0.6254681647940076,143,-167,0.39630008290581753,0.6036999170941825,home,PIT,under,7.5,0.5535714285714286,-124,0.5312585818641182,PIT,SD,2022 REG,10,3,7,7,10,17,0,1,-4,4,1,1,1,0,0,0,0,0,0,0.46874141813588177,0.5312585818641182
87886,0.6226415094339623,0.4166666666666667,-165,140,0.5981666073335706,0.40183339266642937,away,HOU,over,8.5,0.5145631067961165,-106,0.4913668392989033,ATL,HOU,2022 REG,7,4,10,5,9,17,0,1,-1,1,1,1,1,1,0,0,0,0,0,0.4913668392989033,0.5086331607010968
87886,0.6226415094339623,0.4166666666666667,-165,140,0.5981666073335706,0.40183339266642937,home,ATL,under,8.5,0.5305164319248826,-113,0.5086331607010968,ATL,HOU,2022 REG,7,4,10,5,9,17,0,1,-1,1,1,1,1,1,0,0,0,0,0,0.4913668392989033,0.5086331607010968
87887,0.5454545454545454,0.49504950495049505,-120,102,0.5233614270517961,0.4766385729482039,away,BOS,over,8.5,0.5121951219512195,-105,0.48919479393107135,TEX,BOS,2022 REG,4,1,10,7,8,14,0,1,-6,6,1,0,0,0,0,0,0,0,0,0.48919479393107135,0.5108052060689287
87887,0.5454545454545454,0.49504950495049505,-120,102,0.5233614270517961,0.4766385729482039,home,TEX,under,8.5,0.5327102803738317,-114,0.5108052060689287,TEX,BOS,2022 REG,4,1,10,7,8,14,0,1,-6,6,1,0,0,0,0,0,0,0,0,0.48919479393107135,0.5108052060689287
87888,0.5884773662551441,0.4484304932735426,-143,123,0.5667579262855877,0.43324207371441226,away,PHI,over,8.5,0.5121951219512195,-105,0.48808156828023186,ATL,PHI,2022 REG,13,8,11,4,12,24,1,0,4,-4,1,1,1,1,0,0,0,0,0,0.48808156828023186,0.5119184317197681
87888,0.5884773662551441,0.4484304932735426,-143,123,0.5667579262855877,0.43324207371441226,home,ATL,under,8.5,0.5348837209302326,-115,0.5119184317197681,ATL,PHI,2022 REG,13,8,11,4,12,24,1,0,4,-4,1,1,1,1,0,0,0,0,0,0.48808156828023186,0.5119184317197681
87889,0.37735849056603776,0.6610169491525424,165,-195,0.36287719255902645,0.6371228074409736,away,CWS,over,7.5,0.5169082125603864,-107,0.49239402434819424,OAK,CWS,2022 REG,3,2,20,10,12,23,0,1,-8,8,1,1,0,0,0,0,0,0,0,0.49239402434819424,0.5076059756518058
87889,0.37735849056603776,0.6610169491525424,165,-195,0.36287719255902645,0.6371228074409736,home,OAK,under,7.5,0.5305164319248826,-113,0.5076059756518058,OAK,CWS,2022 REG,3,2,20,10,12,23,0,1,-8,8,1,1,0,0,0,0,0,0,0,0.49239402434819424,0.5076059756518058
87890,0.41152263374485604,0.6226415094339623,143,-165,0.39746331556427233,0.6025366844357276,away,MIL,over,7.5,0.5327102803738317,-114,0.5075272610403079,CIN,MIL,2022 REG,4,1,4,5,6,8,0,1,-4,4,1,0,0,0,0,0,0,0,0,0.5075272610403079,0.4924727389596921
87890,0.41152263374485604,0.6226415094339623,143,-165,0.39746331556427233,0.6025366844357276,home,CIN,under,7.5,0.5145631067961165,-106,0.4924727389596921,CIN,MIL,2022 REG,4,1,4,5,6,8,0,1,-4,4,1,0,0,0,0,0,0,0,0,0.5075272610403079,0.4924727389596921
87891,0.6610169491525424,0.37735849056603776,-195,165,0.6356501330673793,0.3643498669326207,away,MIN,over,8,0.5412844036697247,-118,0.5149381613977361,TOR,MIN,2022 REG,10,6,16,8,14,26,0,1,-2,2,1,1,1,1,1,1,0,0,0,0.5149381613977361,0.48506183860226393
87891,0.6610169491525424,0.37735849056603776,-195,165,0.6356501330673793,0.3643498669326207,home,TOR,under,8,0.5073891625615764,-103,0.48506183860226393,TOR,MIN,2022 REG,10,6,16,8,14,26,0,1,-2,2,1,1,1,1,1,1,0,0,0,0.5149381613977361,0.48506183860226393
87892,0.4444444444444444,0.6000000000000001,125,-150,0.4246913580246913,0.5753086419753086,away,NYM,over,8,0.5073891625615764,-103,0.4837652908580103,PHI,NYM,2022 REG,11,3,6,2,5,17,1,0,1,-1,1,1,0,0,0,0,0,0,0,0.4837652908580103,0.5162347091419897
87892,0.4444444444444444,0.6000000000000001,125,-150,0.4246913580246913,0.5753086419753086,home,PHI,under,8,0.5391705069124424,-117,0.5162347091419897,PHI,NYM,2022 REG,11,3,6,2,5,17,1,0,1,-1,1,1,0,0,0,0,0,0,0,0.4837652908580103,0.5162347091419897
87893,0.6428571428571428,0.4,-180,150,0.6153061224489796,0.38469387755102036,away,TB,over,8.5,0.5327102803738317,-114,0.5075272610403079,NYY,TB,2022 REG,4,2,3,1,3,7,1,0,1,-1,1,0,0,0,0,0,0,0,0,0.5075272610403079,0.4924727389596921
87893,0.6428571428571428,0.4,-180,150,0.6153061224489796,0.38469387755102036,home,NYY,under,8.5,0.5145631067961165,-106,0.4924727389596921,NYY,TB,2022 REG,4,2,3,1,3,7,1,0,1,-1,1,0,0,0,0,0,0,0,0,0.5075272610403079,0.4924727389596921
87894,0.5815899581589958,0.4587155963302753,-139,118,0.5581486524100054,0.44185134758999456,away,MIA,over,7,0.5412844036697247,-118,0.5136310900085983,PHI,MIA,2022 REG,9,5,12,6,11,21,0,1,-1,1,1,1,1,1,1,0,0,0,0,0.5136310900085983,0.4863689099914017
87894,0.5815899581589958,0.4587155963302753,-139,118,0.5581486524100054,0.44185134758999456,home,PHI,under,7,0.5098039215686274,-104,0.4863689099914017,PHI,MIA,2022 REG,9,5,12,6,11,21,0,1,-1,1,1,1,1,1,1,0,0,0,0,0.5136310900085983,0.4863689099914017
87895,0.3076923076923077,0.7333333333333333,225,-275,0.29506903353057207,0.7049309664694279,away,MIL,over,8,0.5121951219512195,-105,0.48808156828023186,PIT,MIL,2022 REG,12,5,7,4,9,19,1,0,1,-1,1,1,1,1,0,0,0,0,0,0.48808156828023186,0.5119184317197681
87895,0.3076923076923077,0.7333333333333333,225,-275,0.29506903353057207,0.7049309664694279,home,PIT,under,8,0.5348837209302326,-115,0.5119184317197681,PIT,MIL,2022 REG,12,5,7,4,9,19,1,0,1,-1,1,1,1,1,0,0,0,0,0,0.48808156828023186,0.5119184317197681
87896,0.5726495726495727,0.4716981132075471,-134,112,0.5472538892954956,0.45274611070450443,away,BAL,over,7.5,0.5,100,0.4772727272727273,NYY,BAL,2022 REG,4,1,7,3,4,11,0,1,-2,2,1,0,0,0,0,0,0,0,0,0.4772727272727273,0.5227272727272727
87896,0.5726495726495727,0.4716981132075471,-134,112,0.5472538892954956,0.45274611070450443,home,NYY,under,7.5,0.5454545454545454,-120,0.5227272727272727,NYY,BAL,2022 REG,4,1,7,3,4,11,0,1,-2,2,1,0,0,0,0,0,0,0,0,0.4772727272727273,0.5227272727272727
87897,0.6721311475409836,0.36363636363636365,-205,175,0.6480906892086682,0.3519093107913318,away,SD,over,8,0.5305164319248826,-113,0.5053568787472517,LAD,SD,2022 REG,8,2,8,4,6,16,0,1,-2,2,1,1,0,0,0,0,0,0,0,0.5053568787472517,0.49464312125274834
87897,0.6721311475409836,0.36363636363636365,-205,175,0.6480906892086682,0.3519093107913318,home,LAD,under,8,0.5169082125603864,-107,0.49464312125274834,LAD,SD,2022 REG,8,2,8,4,6,16,0,1,-2,2,1,1,0,0,0,0,0,0,0,0.5053568787472517,0.49464312125274834
87898,0.42016806722689076,0.6183206106870228,138,-162,0.4039963538176834,0.5960036461823166,away,NYY,over,9,0.504950495049505,-102,0.4826715732667395,TOR,NYY,2022 REG,7,10,11,9,19,18,1,0,1,-1,1,1,1,1,1,1,1,1,1,0.4826715732667395,0.5173284267332605
87898,0.42016806722689076,0.6183206106870228,138,-162,0.4039963538176834,0.5960036461823166,home,TOR,under,9,0.5391705069124424,-117,0.5173284267332605,TOR,NYY,2022 REG,7,10,11,9,19,18,1,0,1,-1,1,1,1,1,1,1,1,1,1,0.4826715732667395,0.5173284267332605
87899,0.35714285714285715,0.6774193548387096,180,-210,0.3447992100065833,0.6552007899934167,away,LAD,over,9,0.5145631067961165,-106,0.49023796582517226,CIN,LAD,2022 REG,13,5,16,10,15,29,0,1,-5,5,1,1,1,1,1,0,0,0,0,0.49023796582517226,0.5097620341748277
87899,0.35714285714285715,0.6774193548387096,180,-210,0.3447992100065833,0.6552007899934167,home,CIN,under,9,0.5327102803738317,-114,0.5097620341748277,CIN,LAD,2022 REG,13,5,16,10,15,29,0,1,-5,5,1,1,1,1,1,0,0,0,0,0.49023796582517226,0.5097620341748277
87900,0.6108949416342413,0.425531914893617,-157,135,0.5886419592417365,0.41135804075826354,away,CIN,over,11,0.5260663507109005,-111,0.5010269332605688,COL,CIN,2022 REG,5,4,5,3,7,10,1,0,1,-1,1,1,1,0,0,0,0,0,0,0.5010269332605688,0.4989730667394312
87900,0.6108949416342413,0.425531914893617,-157,135,0.5886419592417365,0.41135804075826354,home,COL,under,11,0.5215311004784688,-109,0.4989730667394312,COL,CIN,2022 REG,5,4,5,3,7,10,1,0,1,-1,1,1,1,0,0,0,0,0,0,0.5010269332605688,0.4989730667394312
87901,0.47619047619047616,0.5633187772925764,110,-129,0.45737654596045113,0.5426234540395489,away,MIA,over,8.5,0.5192307692307692,-108,0.49455035168025013,WSH,MIA,2022 REG,5,4,8,7,11,13,0,1,-3,3,1,1,1,1,0,0,0,0,0,0.49455035168025013,0.5054496483197499
87901,0.47619047619047616,0.5633187772925764,110,-129,0.45737654596045113,0.5426234540395489,home,WSH,under,8.5,0.5283018867924528,-112,0.5054496483197499,WSH,MIA,2022 REG,5,4,8,7,11,13,0,1,-3,3,1,1,1,1,0,0,0,0,0,0.49455035168025013,0.5054496483197499
87902,0.6389891696750902,0.4,-177,150,0.614075512518083,0.385924487481917,away,CLE,over,7,0.5433789954337899,-119,0.5198077604720502,CWS,CLE,2022 REG,10,7,11,10,17,21,0,1,-3,3,1,1,1,1,1,1,1,0,0,0.5198077604720502,0.48019223952794976
87902,0.6389891696750902,0.4,-177,150,0.614075512518083,0.385924487481917,home,CWS,under,7,0.5,100,0.48019223952794976,CWS,CLE,2022 REG,10,7,11,10,17,21,0,1,-3,3,1,1,1,1,1,1,1,0,0,0.5198077604720502,0.48019223952794976
87903,0.6226415094339623,0.4098360655737705,-165,144,0.6024196231083928,0.3975803768916072,away,PIT,over,7.5,0.5283018867924528,-112,0.5044173060022736,CHC,PIT,2022 REG,7,2,8,4,6,15,0,1,-2,2,1,1,0,0,0,0,0,0,0,0.5044173060022736,0.49558269399772636
87903,0.6226415094339623,0.4098360655737705,-165,144,0.6024196231083928,0.3975803768916072,home,CHC,under,7.5,0.5169082125603864,-107,0.49558269399772636,CHC,PIT,2022 REG,7,2,8,4,6,15,0,1,-2,2,1,1,0,0,0,0,0,0,0,0.5044173060022736,0.49558269399772636
87904,0.8,0.24390243902439027,-400,310,0.7648780487804878,0.23512195121951218,away,WSH,over,7.5,0.5,100,0.4772727272727273,NYM,WSH,2022 REG,4,1,14,7,8,18,0,1,-6,6,1,0,0,0,0,0,0,0,0,0.4772727272727273,0.5227272727272727
87904,0.8,0.24390243902439027,-400,310,0.7648780487804878,0.23512195121951218,home,NYM,under,7.5,0.5454545454545454,-120,0.5227272727272727,NYM,WSH,2022 REG,4,1,14,7,8,18,0,1,-6,6,1,0,0,0,0,0,0,0,0,0.4772727272727273,0.5227272727272727
87905,0.48780487804878053,0.5535714285714286,105,-124,0.4676213138438005,0.5323786861561994,away,TB,over,8.5,0.5121951219512195,-105,0.48808156828023186,TEX,TB,2022 REG,6,1,9,3,4,15,0,1,-2,2,1,0,0,0,0,0,0,0,0,0.48808156828023186,0.5119184317197681
87905,0.48780487804878053,0.5535714285714286,105,-124,0.4676213138438005,0.5323786861561994,home,TEX,under,8.5,0.5348837209302326,-115,0.5119184317197681,TEX,TB,2022 REG,6,1,9,3,4,15,0,1,-2,2,1,0,0,0,0,0,0,0,0,0.48808156828023186,0.5119184317197681
87906,0.6226415094339623,0.41152263374485604,-165,143,0.6013694957565848,0.3986305042434152,away,CHC,over,8.5,0.5412844036697247,-118,0.5149381613977361,MIL,CHC,2022 REG,16,9,11,7,16,27,1,0,2,-2,1,1,1,1,1,1,1,0,0,0.5149381613977361,0.48506183860226393
87906,0.6226415094339623,0.41152263374485604,-165,143,0.6013694957565848,0.3986305042434152,home,MIL,under,8.5,0.5073891625615764,-103,0.48506183860226393,MIL,CHC,2022 REG,16,9,11,7,16,27,1,0,2,-2,1,1,1,1,1,1,1,0,0,0.5149381613977361,0.48506183860226393
87907,0.4807692307692307,0.5555555555555556,108,-125,0.4633053911900066,0.5366946088099934,away,BOS,over,8.5,0.5283018867924528,-112,0.5044173060022736,CIN,BOS,2022 REG,9,3,7,5,8,16,0,1,-2,2,1,1,1,0,0,0,0,0,0,0.5044173060022736,0.49558269399772636
87907,0.4807692307692307,0.5555555555555556,108,-125,0.4633053911900066,0.5366946088099934,home,CIN,under,8.5,0.5169082125603864,-107,0.49558269399772636,CIN,BOS,2022 REG,9,3,7,5,8,16,0,1,-2,2,1,1,1,0,0,0,0,0,0,0.5044173060022736,0.49558269399772636
87908,0.574468085106383,0.46511627906976744,-135,115,0.5517281312179562,0.44827186878204384,away,ATL,over,7,0.5348837209302326,-115,0.5097020142727117,NYM,ATL,2022 REG,8,2,9,9,11,17,0,1,-7,7,1,1,0,0,0,0,0,0,0,0.5097020142727117,0.49029798572728833
87908,0.574468085106383,0.46511627906976744,-135,115,0.5517281312179562,0.44827186878204384,home,NYM,under,7,0.5121951219512195,-105,0.49029798572728833,NYM,ATL,2022 REG,8,2,9,9,11,17,0,1,-7,7,1,1,0,0,0,0,0,0,0,0.5097020142727117,0.49029798572728833
87909,0.6721311475409836,0.36363636363636365,-205,175,0.6480906892086682,0.3519093107913318,away,BAL,over,8.5,0.5454545454545454,-120,0.5166307047184789,CWS,BAL,2022 REG,8,4,7,3,7,15,1,0,1,-1,1,1,1,0,0,0,0,0,0,0.5166307047184789,0.48336929528152106
87909,0.6721311475409836,0.36363636363636365,-205,175,0.6480906892086682,0.3519093107913318,home,CWS,under,8.5,0.5073891625615764,-103,0.48336929528152106,CWS,BAL,2022 REG,8,4,7,3,7,15,1,0,1,-1,1,1,1,0,0,0,0,0,0,0.5166307047184789,0.48336929528152106
87910,0.36764705882352944,0.6721311475409836,172,-205,0.3530227182483408,0.64697728175165925,away,HOU,over,6.5,0.5454545454545454,-120,0.5206611570247933,BAL,HOU,2022 REG,7,2,2,0,2,9,1,0,2,-2,0,0,0,0,0,0,0,0,0,0.5206611570247933,0.4793388429752067
87910,0.36764705882352944,0.6721311475409836,172,-205,0.3530227182483408,0.64697728175165925,home,BAL,under,6.5,0.5,100,0.4793388429752067,BAL,HOU,2022 REG,7,2,2,0,2,9,1,0,2,-2,0,0,0,0,0,0,0,0,0,0.5206611570247933,0.4793388429752067
87911,0.5145631067961165,0.5238095238095238,-106,-110,0.4948179667757384,0.5051820332242616,away,STL,over,8,0.5121951219512195,-105,0.48808156828023186,CHC,STL,2022 REG,11,5,15,14,19,26,0,1,-9,9,1,1,1,1,1,0,0,0,0,0.48808156828023186,0.5119184317197681
87911,0.5145631067961165,0.5238095238095238,-106,-110,0.4948179667757384,0.5051820332242616,home,CHC,under,8,0.5348837209302326,-115,0.5119184317197681,CHC,STL,2022 REG,11,5,15,14,19,26,0,1,-9,9,1,1,1,1,1,0,0,0,0,0.48808156828023186,0.5119184317197681
87912,0.5192307692307692,0.5238095238095238,-108,-110,0.49688292476754015,0.5031170752324599,away,TEX,over,9.5,0.49751243781094534,101,0.476135829221149,BAL,TEX,2022 REG,14,10,12,9,19,26,1,0,1,-1,1,1,1,1,1,1,1,1,1,0.476135829221149,0.523864170778851
87912,0.5192307692307692,0.5238095238095238,-108,-110,0.49688292476754015,0.5031170752324599,home,BAL,under,9.5,0.5454545454545454,-120,0.523864170778851,BAL,TEX,2022 REG,14,10,12,9,19,26,1,0,1,-1,1,1,1,1,1,1,1,1,1,0.476135829221149,0.523864170778851
87913,0.45454545454545453,0.5850622406639003,120,-141,0.4365419567230205,0.5634580432769796,away,STL,over,8.5,0.5412844036697247,-118,0.5189377998484975,PIT,STL,2022 REG,7,4,10,5,9,17,0,1,-1,1,1,1,1,1,0,0,0,0,0,0.5189377998484975,0.4810622001515025
87913,0.45454545454545453,0.5850622406639003,120,-141,0.4365419567230205,0.5634580432769796,home,PIT,under,8.5,0.5,100,0.4810622001515025,PIT,STL,2022 REG,7,4,10,5,9,17,0,1,-1,1,1,1,1,1,0,0,0,0,0,0.5189377998484975,0.4810622001515025
87914,0.5412844036697247,0.5,-118,100,0.5189377998484975,0.4810622001515025,away,KC,over,8.5,0.5348837209302326,-115,0.5097020142727117,ARI,KC,2022 REG,10,9,12,5,14,22,1,0,4,-4,1,1,1,1,1,0,0,0,0,0.5097020142727117,0.49029798572728833
87914,0.5412844036697247,0.5,-118,100,0.5189377998484975,0.4810622001515025,home,ARI,under,8.5,0.5121951219512195,-105,0.49029798572728833,ARI,KC,2022 REG,10,9,12,5,14,22,1,0,4,-4,1,1,1,1,1,0,0,0,0,0.5097020142727117,0.49029798572728833
87915,0.4587155963302753,0.5884773662551441,118,-143,0.43706744835531225,0.5629325516446877,away,CLE,over,11.5,0.5238095238095238,-110,0.4930654432315562,COL,CLE,2022 REG,11,2,8,4,6,19,0,1,-2,2,1,1,0,0,0,0,0,0,0,0.4930654432315562,0.5069345567684438
87915,0.4587155963302753,0.5884773662551441,118,-143,0.43706744835531225,0.5629325516446877,home,COL,under,11.5,0.5348837209302326,-115,0.5069345567684438,COL,CLE,2022 REG,11,2,8,4,6,19,0,1,-2,2,1,1,0,0,0,0,0,0,0,0.4930654432315562,0.5069345567684438
87916,0.3921568627450981,0.6402877697841727,155,-178,0.37943347743950173,0.6205665225604983,away,MIL,over,7.5,0.5192307692307692,-108,0.49688292476754015,CIN,MIL,2022 REG,14,10,7,5,15,21,1,0,5,-5,1,1,1,1,1,0,0,0,0,0.49688292476754015,0.5031170752324599
87916,0.3921568627450981,0.6402877697841727,155,-178,0.37943347743950173,0.6205665225604983,home,CIN,under,7.5,0.5238095238095238,-110,0.5031170752324599,CIN,MIL,2022 REG,14,10,7,5,15,21,1,0,5,-5,1,1,1,1,1,0,0,0,0,0.49688292476754015,0.5031170752324599
87917,0.7297297297297298,0.3125,-270,220,0.6989134404674946,0.3010865595325054,away,KC,over,8,0.5454545454545454,-120,0.5206611570247933,HOU,KC,2022 REG,13,9,9,7,16,22,1,0,2,-2,1,1,1,1,1,1,1,0,0,0.5206611570247933,0.4793388429752067
87917,0.7297297297297298,0.3125,-270,220,0.6989134404674946,0.3010865595325054,home,HOU,under,8,0.5,100,0.4793388429752067,HOU,KC,2022 REG,13,9,9,7,16,22,1,0,2,-2,1,1,1,1,1,1,1,0,0,0.5206611570247933,0.4793388429752067
87918,0.48780487804878053,0.5535714285714286,105,-124,0.4676213138438005,0.5323786861561994,away,TEX,over,8.5,0.5454545454545454,-120,0.5206611570247933,DET,TEX,2022 REG,19,14,10,7,21,29,1,0,7,-7,1,1,1,1,1,1,1,0,0,0.5206611570247933,0.4793388429752067
87918,0.48780487804878053,0.5535714285714286,105,-124,0.4676213138438005,0.5323786861561994,home,DET,under,8.5,0.5,100,0.4793388429752067,DET,TEX,2022 REG,19,14,10,7,21,29,1,0,7,-7,1,1,1,1,1,1,1,0,0,0.5206611570247933,0.4793388429752067
87919,0.6666666666666666,0.37037037037037035,-200,170,0.6419753086419753,0.3580246913580247,away,DET,over,8,0.5327102803738317,-114,0.508788710910954,HOU,DET,2022 REG,7,3,2,2,5,9,1,0,1,-1,1,1,0,0,0,0,0,0,0,0.508788710910954,0.491211289089046
87919,0.6666666666666666,0.37037037037037035,-200,170,0.6419753086419753,0.3580246913580247,home,HOU,under,8,0.5121951219512195,-105,0.491211289089046,HOU,DET,2022 REG,7,3,2,2,5,9,1,0,1,-1,1,1,0,0,0,0,0,0,0,0.508788710910954,0.491211289089046
87920,0.2857142857142857,0.7530864197530864,250,-305,0.27462836986646505,0.7253716301335349,away,ATL,over,7.5,0.5,100,0.4783105022831051,OAK,ATL,2022 REG,3,3,10,7,10,13,0,1,-4,4,1,1,1,0,0,0,0,0,0,0.4783105022831051,0.5216894977168949
87920,0.2857142857142857,0.7530864197530864,250,-305,0.27462836986646505,0.7253716301335349,home,OAK,under,7.5,0.5433789954337899,-119,0.5216894977168949,OAK,ATL,2022 REG,3,3,10,7,10,13,0,1,-4,4,1,1,1,0,0,0,0,0,0,0.4783105022831051,0.5216894977168949
87921,0.4081632653061224,0.6254681647940076,145,-167,0.39443615097953877,0.6055638490204612,away,NYM,over,9.5,0.5412844036697247,-118,0.5149381613977361,CIN,NYM,2022 REG,5,3,16,8,11,21,0,1,-5,5,1,1,1,0,0,0,0,0,0,0.5149381613977361,0.48506183860226393
87921,0.4081632653061224,0.6254681647940076,145,-167,0.39443615097953877,0.6055638490204612,home,CIN,under,9.5,0.5073891625615764,-103,0.48506183860226393,CIN,NYM,2022 REG,5,3,16,8,11,21,0,1,-5,5,1,1,1,0,0,0,0,0,0,0.5149381613977361,0.48506183860226393
87922,0.42016806722689076,0.6212121212121212,138,-164,0.4027814334289866,0.5972185665710135,away,BOS,over,8,0.5327102803738317,-114,0.508788710910954,PIT,BOS,2022 REG,6,3,12,8,11,18,0,1,-5,5,1,1,1,0,0,0,0,0,0,0.508788710910954,0.491211289089046
87922,0.42016806722689076,0.6212121212121212,138,-164,0.4027814334289866,0.5972185665710135,home,PIT,under,8,0.5121951219512195,-105,0.491211289089046,PIT,BOS,2022 REG,6,3,12,8,11,18,0,1,-5,5,1,1,1,0,0,0,0,0,0,0.508788710910954,0.491211289089046
87923,0.6428571428571428,0.3968253968253968,-180,152,0.6173469387755103,0.3826530612244897,away,BOS,over,7.5,0.5348837209302326,-115,0.5097020142727117,HOU,BOS,2022 REG,6,2,6,3,5,12,0,1,-1,1,1,1,0,0,0,0,0,0,0,0.5097020142727117,0.49029798572728833
87923,0.6428571428571428,0.3968253968253968,-180,152,0.6173469387755103,0.3826530612244897,home,HOU,under,7.5,0.5121951219512195,-105,0.49029798572728833,HOU,BOS,2022 REG,6,2,6,3,5,12,0,1,-1,1,1,1,0,0,0,0,0,0,0,0.5097020142727117,0.49029798572728833
87924,0.43103448275862066,0.6000000000000001,132,-150,0.4176575505350773,0.5823424494649228,away,STL,over,9,0.5454545454545454,-120,0.5206611570247933,ARI,STL,2022 REG,8,7,18,16,23,26,0,1,-9,9,1,1,1,1,1,1,1,0,0,0.5206611570247933,0.4793388429752067
87924,0.43103448275862066,0.6000000000000001,132,-150,0.4176575505350773,0.5823424494649228,home,ARI,under,9,0.5,100,0.4793388429752067,ARI,STL,2022 REG,8,7,18,16,23,26,0,1,-9,9,1,1,1,1,1,1,1,0,0,0.5206611570247933,0.4793388429752067
87925,0.3921568627450981,0.6491228070175439,155,-185,0.37596875695582666,0.6240312430441733,away,ATL,over,9,0.5238095238095238,-110,0.5000596729920038,CIN,ATL,2022 REG,1,1,7,4,5,8,0,1,-3,3,1,0,0,0,0,0,0,0,0,0.5000596729920038,0.4999403270079962
87925,0.3921568627450981,0.6491228070175439,155,-185,0.37596875695582666,0.6240312430441733,home,CIN,under,9,0.5215311004784688,-109,0.4999403270079962,CIN,ATL,2022 REG,1,1,7,4,5,8,0,1,-3,3,1,0,0,0,0,0,0,0,0,0.5000596729920038,0.4999403270079962
87926,0.613899613899614,0.425531914893617,-159,135,0.589692613597978,0.410307386402022,away,MIN,over,9,0.5283018867924528,-112,0.5031902949311281,TOR,MIN,2022 REG,16,12,6,3,15,22,1,0,9,-9,1,1,1,0,0,0,0,0,0,0.5031902949311281,0.4968097050688719
87926,0.613899613899614,0.425531914893617,-159,135,0.589692613597978,0.410307386402022,home,TOR,under,9,0.5192307692307692,-108,0.4968097050688719,TOR,MIN,2022 REG,16,12,6,3,15,22,1,0,9,-9,1,1,1,0,0,0,0,0,0,0.5031902949311281,0.4968097050688719
87927,0.4081632653061224,0.6363636363636364,145,-175,0.3899890197266291,0.6100109802733709,away,SF,over,11,0.5121951219512195,-105,0.48919479393107135,COL,SF,2022 REG,12,4,5,3,7,17,1,0,1,-1,1,1,1,0,0,0,0,0,0,0.48919479393107135,0.5108052060689287
87927,0.4081632653061224,0.6363636363636364,145,-175,0.3899890197266291,0.6100109802733709,home,COL,under,11,0.5327102803738317,-114,0.5108052060689287,COL,SF,2022 REG,12,4,5,3,7,17,1,0,1,-1,1,1,1,0,0,0,0,0,0,0.48919479393107135,0.5108052060689287
87928,0.4081632653061224,0.6226415094339623,145,-165,0.3955898878611898,0.6044101121388101,away,HOU,over,9,0.49504950495049505,102,0.4739797934813417,WSH,HOU,2022 REG,14,13,12,6,19,26,1,0,7,-7,1,1,1,1,1,1,0,0,0,0.4739797934813417,0.5260202065186583
87928,0.4081632653061224,0.6226415094339623,145,-165,0.3955898878611898,0.6044101121388101,home,WSH,under,9,0.5475113122171946,-121,0.5260202065186583,WSH,HOU,2022 REG,14,13,12,6,19,26,1,0,7,-7,1,1,1,1,1,1,0,0,0,0.4739797934813417,0.5260202065186583
87929,0.5884773662551441,0.4484304932735426,-143,123,0.5667579262855877,0.43324207371441226,away,PIT,over,7,0.5454545454545454,-120,0.5206611570247933,CHC,PIT,2022 REG,7,7,5,0,7,12,1,0,7,-7,0,0,0,0,0,0,0,0,0,0.5206611570247933,0.4793388429752067
87929,0.5884773662551441,0.4484304932735426,-143,123,0.5667579262855877,0.43324207371441226,home,CHC,under,7,0.5,100,0.4793388429752067,CHC,PIT,2022 REG,7,7,5,0,7,12,1,0,7,-7,0,0,0,0,0,0,0,0,0,0.5206611570247933,0.4793388429752067
87930,0.6000000000000001,0.4347826086956522,-150,130,0.5791304347826086,0.4208695652173914,away,ATL,over,8.5,0.5121951219512195,-105,0.48808156828023186,PHI,ATL,2022 REG,13,14,9,4,18,22,1,0,10,-10,1,1,1,1,0,0,0,0,0,0.48808156828023186,0.5119184317197681
87930,0.6000000000000001,0.4347826086956522,-150,130,0.5791304347826086,0.4208695652173914,home,PHI,under,8.5,0.5348837209302326,-115,0.5119184317197681,PHI,ATL,2022 REG,13,14,9,4,18,22,1,0,10,-10,1,1,1,1,0,0,0,0,0,0.48808156828023186,0.5119184317197681
87931,0.6666666666666666,0.36363636363636365,-200,175,0.6464646464646464,0.3535353535353536,away,KC,over,9,0.5238095238095238,-110,0.4988662131519274,SF,KC,2022 REG,7,2,4,3,5,11,0,1,-1,1,1,1,0,0,0,0,0,0,0,0.4988662131519274,0.5011337868480725
87931,0.6666666666666666,0.36363636363636365,-200,175,0.6464646464646464,0.3535353535353536,home,SF,under,9,0.5238095238095238,-110,0.5011337868480725,SF,KC,2022 REG,7,2,4,3,5,11,0,1,-1,1,1,1,0,0,0,0,0,0,0,0.4988662131519274,0.5011337868480725
87932,0.7368421052631579,0.29850746268656714,-280,235,0.7107950551949394,0.28920494480506065,away,OAK,over,7.5,0.5305164319248826,-113,0.5066009958897986,HOU,OAK,2022 REG,10,6,7,3,9,17,1,0,3,-3,1,1,1,0,0,0,0,0,0,0.5066009958897986,0.49339900411020143
87932,0.7368421052631579,0.29850746268656714,-280,235,0.7107950551949394,0.28920494480506065,home,HOU,under,7.5,0.5145631067961165,-106,0.49339900411020143,HOU,OAK,2022 REG,10,6,7,3,9,17,1,0,3,-3,1,1,1,0,0,0,0,0,0,0.5066009958897986,0.49339900411020143
87933,0.6254681647940076,0.41152263374485604,-167,143,0.6023315979176397,0.3976684020823603,away,MIA,over,7.5,0.5145631067961165,-106,0.4913668392989033,TB,MIA,2022 REG,6,5,9,4,9,15,1,0,1,-1,1,1,1,1,0,0,0,0,0,0.4913668392989033,0.5086331607010968
87933,0.6254681647940076,0.41152263374485604,-167,143,0.6023315979176397,0.3976684020823603,home,TB,under,7.5,0.5305164319248826,-113,0.5086331607010968,TB,MIA,2022 REG,6,5,9,4,9,15,1,0,1,-1,1,1,1,1,0,0,0,0,0,0.4913668392989033,0.5086331607010968
87934,0.3508771929824561,0.6825396825396826,185,-215,0.33915197350100396,0.660848026498996,away,SD,over,8.5,0.5283018867924528,-112,0.5031902949311281,KC,SD,2022 REG,7,3,11,4,7,18,0,1,-1,1,1,1,1,0,0,0,0,0,0,0.5031902949311281,0.4968097050688719
87934,0.3508771929824561,0.6825396825396826,185,-215,0.33915197350100396,0.660848026498996,home,KC,under,8.5,0.5192307692307692,-108,0.4968097050688719,KC,SD,2022 REG,7,3,11,4,7,18,0,1,-1,1,1,1,1,0,0,0,0,0,0,0.5031902949311281,0.4968097050688719
87935,0.5967741935483871,0.4444444444444444,-148,125,0.5721759741010521,0.42782402589894786,away,ARI,over,7.5,0.5,100,0.4772727272727273,MIA,ARI,2022 REG,10,7,9,8,15,19,0,1,-1,1,1,1,1,1,1,1,1,0,0,0.4772727272727273,0.5227272727272727
87935,0.5967741935483871,0.4444444444444444,-148,125,0.5721759741010521,0.42782402589894786,home,MIA,under,7.5,0.5454545454545454,-120,0.5227272727272727,MIA,ARI,2022 REG,10,7,9,8,15,19,0,1,-1,1,1,1,1,1,1,1,1,0,0,0.4772727272727273,0.5227272727272727
87936,0.6226415094339623,0.4132231404958678,-165,142,0.6003106896663323,0.3996893103336677,away,STL,over,8,0.5327102803738317,-114,0.508788710910954,LAD,STL,2022 REG,7,0,12,11,11,19,0,1,-11,11,0,0,0,0,0,0,0,0,0,0.508788710910954,0.491211289089046
87936,0.6226415094339623,0.4132231404958678,-165,142,0.6003106896663323,0.3996893103336677,home,LAD,under,8,0.5121951219512195,-105,0.491211289089046,LAD,STL,2022 REG,7,0,12,11,11,19,0,1,-11,11,0,0,0,0,0,0,0,0,0,0.508788710910954,0.491211289089046
87937,0.5555555555555556,0.4854368932038835,-125,106,0.5327819729114227,0.4672180270885773,away,CHC,over,9,0.5121951219512195,-105,0.48808156828023186,ARI,CHC,2022 REG,12,4,5,3,7,17,1,0,1,-1,1,1,1,0,0,0,0,0,0,0.48808156828023186,0.5119184317197681
87937,0.5555555555555556,0.4854368932038835,-125,106,0.5327819729114227,0.4672180270885773,home,ARI,under,9,0.5348837209302326,-115,0.5119184317197681,ARI,CHC,2022 REG,12,4,5,3,7,17,1,0,1,-1,1,1,1,0,0,0,0,0,0,0.48808156828023186,0.5119184317197681
87938,0.47619047619047616,0.5652173913043479,110,-130,0.4564724440500838,0.5435275559499162,away,PHI,over,8,0.5,100,0.47935779816513757,STL,PHI,2022 REG,6,0,5,2,2,11,0,1,-2,2,0,0,0,0,0,0,0,0,0,0.47935779816513757,0.5206422018348624
87938,0.47619047619047616,0.5652173913043479,110,-130,0.4564724440500838,0.5435275559499162,home,STL,under,8,0.5412844036697247,-118,0.5206422018348624,STL,PHI,2022 REG,6,0,5,2,2,11,0,1,-2,2,0,0,0,0,0,0,0,0,0,0.47935779816513757,0.5206422018348624
87939,0.4587155963302753,0.5833333333333333,118,-140,0.4394270964845833,0.5605729035154168,away,CLE,over,8,0.5098039215686274,-104,0.48483656587239576,KC,CLE,2022 REG,6,2,8,1,3,14,1,0,1,-1,1,0,0,0,0,0,0,0,0,0.48483656587239576,0.5151634341276042
87939,0.4587155963302753,0.5833333333333333,118,-140,0.4394270964845833,0.5605729035154168,home,KC,under,8,0.5391705069124424,-117,0.5151634341276042,KC,CLE,2022 REG,6,2,8,1,3,14,1,0,1,-1,1,0,0,0,0,0,0,0,0,0.48483656587239576,0.5151634341276042
87940,0.5555555555555556,0.4854368932038835,-125,106,0.5327819729114227,0.4672180270885773,away,NYM,over,8.5,0.5215311004784688,-109,0.49907282342437215,SF,NYM,2022 REG,8,9,5,3,12,13,1,0,6,-6,1,1,1,0,0,0,0,0,0,0.49907282342437215,0.5009271765756278
87940,0.5555555555555556,0.4854368932038835,-125,106,0.5327819729114227,0.4672180270885773,home,SF,under,8.5,0.5215311004784688,-109,0.5009271765756278,SF,NYM,2022 REG,8,9,5,3,12,13,1,0,6,-6,1,1,1,0,0,0,0,0,0,0.49907282342437215,0.5009271765756278
87941,0.6389891696750902,0.4,-177,150,0.614075512518083,0.385924487481917,away,CHC,over,8,0.5238095238095238,-110,0.5000596729920038,PHI,CHC,2022 REG,6,2,7,6,8,13,0,1,-4,4,1,1,0,0,0,0,0,0,0,0.5000596729920038,0.4999403270079962
87941,0.6389891696750902,0.4,-177,150,0.614075512518083,0.385924487481917,home,PHI,under,8,0.5215311004784688,-109,0.4999403270079962,PHI,CHC,2022 REG,6,2,7,6,8,13,0,1,-4,4,1,1,0,0,0,0,0,0,0,0.5000596729920038,0.4999403270079962
87942,0.46511627906976744,0.574468085106383,115,-135,0.44670494689481377,0.5532950531051862,away,SEA,over,7.5,0.5,100,0.4772727272727273,LAA,SEA,2022 REG,8,1,9,9,10,17,0,1,-8,8,1,0,0,0,0,0,0,0,0,0.4772727272727273,0.5227272727272727
87942,0.46511627906976744,0.574468085106383,115,-135,0.44670494689481377,0.5532950531051862,home,LAA,under,7.5,0.5454545454545454,-120,0.5227272727272727,LAA,SEA,2022 REG,8,1,9,9,10,17,0,1,-8,8,1,0,0,0,0,0,0,0,0,0.4772727272727273,0.5227272727272727
87943,0.6503496503496503,0.3846153846153846,-186,160,0.6276101520856765,0.3723898479143235,away,LAA,over,7.5,0.5192307692307692,-108,0.49455035168025013,TEX,LAA,2022 REG,6,5,8,3,8,14,1,0,2,-2,1,1,1,0,0,0,0,0,0,0.49455035168025013,0.5054496483197499
87943,0.6503496503496503,0.3846153846153846,-186,160,0.6276101520856765,0.3723898479143235,home,TEX,under,7.5,0.5283018867924528,-112,0.5054496483197499,TEX,LAA,2022 REG,6,5,8,3,8,14,1,0,2,-2,1,1,1,0,0,0,0,0,0,0.49455035168025013,0.5054496483197499
87944,0.5,0.5412844036697247,100,-118,0.47935779816513757,0.5206422018348624,away,SD,over,8,0.5412844036697247,-118,0.5149381613977361,STL,SD,2022 REG,8,5,6,2,7,14,1,0,3,-3,1,1,0,0,0,0,0,0,0,0.5149381613977361,0.48506183860226393
87944,0.5,0.5412844036697247,100,-118,0.47935779816513757,0.5206422018348624,home,STL,under,8,0.5073891625615764,-103,0.48506183860226393,STL,SD,2022 REG,8,5,6,2,7,14,1,0,3,-3,1,1,0,0,0,0,0,0,0,0.5149381613977361,0.48506183860226393
87945,0.5833333333333333,0.45454545454545453,-140,120,0.5612373737373737,0.4387626262626263,away,LAA,over,7.5,0.5,100,0.4772727272727273,SEA,LAA,2022 REG,7,1,8,7,8,15,0,1,-6,6,1,0,0,0,0,0,0,0,0,0.4772727272727273,0.5227272727272727
87945,0.5833333333333333,0.45454545454545453,-140,120,0.5612373737373737,0.4387626262626263,home,SEA,under,7.5,0.5454545454545454,-120,0.5227272727272727,SEA,LAA,2022 REG,7,1,8,7,8,15,0,1,-6,6,1,0,0,0,0,0,0,0,0,0.4772727272727273,0.5227272727272727
87946,0.7058823529411764,0.33783783783783783,-240,196,0.6750210418030487,0.32497895819695133,away,COL,over,8,0.5260663507109005,-111,0.5022370601254724,STL,COL,2022 REG,10,5,6,4,9,16,1,0,1,-1,1,1,1,1,0,0,0,0,0,0.5022370601254724,0.4977629398745276
87946,0.7058823529411764,0.33783783783783783,-240,196,0.6750210418030487,0.32497895819695133,home,STL,under,8,0.5192307692307692,-108,0.4977629398745276,STL,COL,2022 REG,10,5,6,4,9,16,1,0,1,-1,1,1,1,1,0,0,0,0,0,0.5022370601254724,0.4977629398745276
87947,0.425531914893617,0.6226415094339623,135,-165,0.40503258539251946,0.5949674146074806,away,ATL,over,8,0.5098039215686274,-104,0.48483656587239576,SF,ATL,2022 REG,4,1,10,5,6,14,0,1,-4,4,1,0,0,0,0,0,0,0,0,0.48483656587239576,0.5151634341276042
87947,0.425531914893617,0.6226415094339623,135,-165,0.40503258539251946,0.5949674146074806,home,SF,under,8,0.5391705069124424,-117,0.5151634341276042,SF,ATL,2022 REG,4,1,10,5,6,14,0,1,-4,4,1,0,0,0,0,0,0,0,0,0.48483656587239576,0.5151634341276042
87948,0.5867768595041323,0.45454545454545453,-142,120,0.5625298818386723,0.43747011816132775,away,PIT,over,9,0.5327102803738317,-114,0.508788710910954,CIN,PIT,2022 REG,5,1,12,6,7,17,0,1,-5,5,1,0,0,0,0,0,0,0,0,0.508788710910954,0.491211289089046
87948,0.5867768595041323,0.45454545454545453,-142,120,0.5625298818386723,0.43747011816132775,home,CIN,under,9,0.5121951219512195,-105,0.491211289089046,CIN,PIT,2022 REG,5,1,12,6,7,17,0,1,-5,5,1,0,0,0,0,0,0,0,0,0.508788710910954,0.491211289089046
87949,0.576271186440678,0.4587155963302753,-136,118,0.5561093116235184,0.4438906883764816,away,MIN,over,7.5,0.5,100,0.4772727272727273,CWS,MIN,2022 REG,13,13,1,0,13,14,1,0,13,-13,0,0,0,0,0,0,0,0,0,0.4772727272727273,0.5227272727272727
87949,0.576271186440678,0.4587155963302753,-136,118,0.5561093116235184,0.4438906883764816,home,CWS,under,7.5,0.5454545454545454,-120,0.5227272727272727,CWS,MIN,2022 REG,13,13,1,0,13,14,1,0,13,-13,0,0,0,0,0,0,0,0,0,0.4772727272727273,0.5227272727272727
87950,0.4424778761061947,0.5967741935483871,126,-148,0.4251097036926629,0.5748902963073371,away,LAA,over,7.5,0.504950495049505,-102,0.4826715732667395,OAK,LAA,2022 REG,6,2,7,1,3,13,1,0,1,-1,1,0,0,0,0,0,0,0,0,0.4826715732667395,0.5173284267332605
87950,0.4424778761061947,0.5967741935483871,126,-148,0.4251097036926629,0.5748902963073371,home,OAK,under,7.5,0.5391705069124424,-117,0.5173284267332605,OAK,LAA,2022 REG,6,2,7,1,3,13,1,0,1,-1,1,0,0,0,0,0,0,0,0,0.4826715732667395,0.5173284267332605
87951,0.6031746031746031,0.4444444444444444,-152,125,0.5744520030234317,0.4255479969765683,away,COL,over,8,0.5098039215686274,-104,0.4870219861770517,ARI,COL,2022 REG,8,4,5,0,4,13,1,0,4,-4,0,0,0,0,0,0,0,0,0,0.4870219861770517,0.5129780138229483
87951,0.6031746031746031,0.4444444444444444,-152,125,0.5744520030234317,0.4255479969765683,home,ARI,under,8,0.5348837209302326,-115,0.5129780138229483,ARI,COL,2022 REG,8,4,5,0,4,13,1,0,4,-4,0,0,0,0,0,0,0,0,0,0.4870219861770517,0.5129780138229483
87952,0.3508771929824561,0.6923076923076923,185,-225,0.3357246016525795,0.6642753983474206,away,LAD,over,8,0.5215311004784688,-109,0.4978845547971712,SF,LAD,2022 REG,5,3,8,5,8,13,0,1,-2,2,1,1,1,0,0,0,0,0,0,0.4978845547971712,0.5021154452028288
87952,0.3508771929824561,0.6923076923076923,185,-225,0.3357246016525795,0.6642753983474206,home,SF,under,8,0.5238095238095238,-110,0.5021154452028288,SF,LAD,2022 REG,5,3,8,5,8,13,0,1,-2,2,1,1,1,0,0,0,0,0,0,0.4978845547971712,0.5021154452028288
87953,0.6254681647940076,0.4081632653061224,-167,145,0.6044327759298813,0.3955672240701187,away,ARI,over,6,0.5454545454545454,-120,0.5206611570247933,HOU,ARI,2022 REG,7,2,9,5,7,16,0,1,-3,3,1,1,0,0,0,0,0,0,0,0.5206611570247933,0.4793388429752067
87953,0.6254681647940076,0.4081632653061224,-167,145,0.6044327759298813,0.3955672240701187,home,HOU,under,6,0.5,100,0.4793388429752067,HOU,ARI,2022 REG,7,2,9,5,7,16,0,1,-3,3,1,1,0,0,0,0,0,0,0,0.5206611570247933,0.4793388429752067
87954,0.607843137254902,0.43103448275862066,-155,132,0.5842116427368785,0.41578835726312147,away,CIN,over,8,0.5145631067961165,-106,0.49023796582517226,SF,CIN,2022 REG,5,3,14,10,13,19,0,1,-7,7,1,1,1,0,0,0,0,0,0,0.49023796582517226,0.5097620341748277
87954,0.607843137254902,0.43103448275862066,-155,132,0.5842116427368785,0.41578835726312147,home,SF,under,8,0.5327102803738317,-114,0.5097620341748277,SF,CIN,2022 REG,5,3,14,10,13,19,0,1,-7,7,1,1,1,0,0,0,0,0,0,0.49023796582517226,0.5097620341748277
87955,0.4081632653061224,0.6254681647940076,145,-167,0.39443615097953877,0.6055638490204612,away,SD,over,7,0.5327102803738317,-114,0.5075272610403079,PIT,SD,2022 REG,8,7,7,6,13,15,1,0,1,-1,1,1,1,1,1,1,0,0,0,0.5075272610403079,0.4924727389596921
87955,0.4081632653061224,0.6254681647940076,145,-167,0.39443615097953877,0.6055638490204612,home,PIT,under,7,0.5145631067961165,-106,0.4924727389596921,PIT,SD,2022 REG,8,7,7,6,13,15,1,0,1,-1,1,1,1,1,1,1,0,0,0,0.5075272610403079,0.4924727389596921
87956,0.4716981132075471,0.574468085106383,112,-135,0.44992160456890085,0.5500783954310992,away,MIA,over,7.5,0.5238095238095238,-110,0.5000596729920038,STL,MIA,2022 REG,7,3,7,4,7,14,0,1,-1,1,1,1,1,0,0,0,0,0,0,0.5000596729920038,0.4999403270079962
87956,0.4716981132075471,0.574468085106383,112,-135,0.44992160456890085,0.5500783954310992,home,STL,under,7.5,0.5215311004784688,-109,0.4999403270079962,STL,MIA,2022 REG,7,3,7,4,7,14,0,1,-1,1,1,1,1,0,0,0,0,0,0,0.5000596729920038,0.4999403270079962
87957,0.6000000000000001,0.43859649122807015,-150,128,0.5768421052631579,0.42315789473684207,away,MIL,over,8,0.5283018867924528,-112,0.5044173060022736,STL,MIL,2022 REG,7,6,6,3,9,13,1,0,3,-3,1,1,1,0,0,0,0,0,0,0.5044173060022736,0.49558269399772636
87957,0.6000000000000001,0.43859649122807015,-150,128,0.5768421052631579,0.42315789473684207,home,STL,under,8,0.5169082125603864,-107,0.49558269399772636,STL,MIL,2022 REG,7,6,6,3,9,13,1,0,3,-3,1,1,1,0,0,0,0,0,0,0.5044173060022736,0.49558269399772636
87958,0.37037037037037035,0.6721311475409836,170,-205,0.35462906744023925,0.6453709325597607,away,LAD,over,8.5,0.5238095238095238,-110,0.4988662131519274,SF,LAD,2022 REG,5,3,13,2,5,18,1,0,1,-1,1,1,0,0,0,0,0,0,0,0.4988662131519274,0.5011337868480725
87958,0.37037037037037035,0.6721311475409836,170,-205,0.35462906744023925,0.6453709325597607,home,SF,under,8.5,0.5238095238095238,-110,0.5011337868480725,SF,LAD,2022 REG,5,3,13,2,5,18,1,0,1,-1,1,1,0,0,0,0,0,0,0,0.4988662131519274,0.5011337868480725
87959,0.726027397260274,0.31746031746031744,-265,215,0.6944541249288857,0.3055458750711143,away,WSH,over,9,0.5145631067961165,-106,0.49023796582517226,LAD,WSH,2022 REG,6,3,14,8,11,20,0,1,-5,5,1,1,1,0,0,0,0,0,0,0.49023796582517226,0.5097620341748277
87959,0.726027397260274,0.31746031746031744,-265,215,0.6944541249288857,0.3055458750711143,home,LAD,under,9,0.5327102803738317,-114,0.5097620341748277,LAD,WSH,2022 REG,6,3,14,8,11,20,0,1,-5,5,1,1,1,0,0,0,0,0,0,0.49023796582517226,0.5097620341748277
87960,0.48309178743961345,0.5555555555555556,107,-125,0.4644215734322854,0.5355784265677146,away,ARI,over,9,0.5121951219512195,-105,0.48808156828023186,KC,ARI,2022 REG,5,3,13,7,10,18,0,1,-4,4,1,1,1,0,0,0,0,0,0,0.48808156828023186,0.5119184317197681
87960,0.48309178743961345,0.5555555555555556,107,-125,0.4644215734322854,0.5355784265677146,home,KC,under,9,0.5348837209302326,-115,0.5119184317197681,KC,ARI,2022 REG,5,3,13,7,10,18,0,1,-4,4,1,1,1,0,0,0,0,0,0,0.48808156828023186,0.5119184317197681
87961,0.5555555555555556,0.48309178743961345,-125,107,0.5340848094471283,0.46591519055287167,away,STL,over,10,0.5283018867924528,-112,0.5031902949311281,PHI,STL,2022 REG,12,6,9,7,13,21,0,1,-1,1,1,1,1,1,1,1,0,0,0,0.5031902949311281,0.4968097050688719
87961,0.5555555555555556,0.48309178743961345,-125,107,0.5340848094471283,0.46591519055287167,home,PHI,under,10,0.5192307692307692,-108,0.4968097050688719,PHI,STL,2022 REG,12,6,9,7,13,21,0,1,-1,1,1,1,1,1,1,1,0,0,0,0.5031902949311281,0.4968097050688719
87962,0.3921568627450981,0.6491228070175439,155,-185,0.37596875695582666,0.6240312430441733,away,NYY,over,9,0.5327102803738317,-114,0.5075272610403079,MIN,NYY,2022 REG,11,8,5,1,9,16,1,0,7,-7,1,0,0,0,0,0,0,0,0,0.5075272610403079,0.4924727389596921
87962,0.3921568627450981,0.6491228070175439,155,-185,0.37596875695582666,0.6240312430441733,home,MIN,under,9,0.5145631067961165,-106,0.4924727389596921,MIN,NYY,2022 REG,11,8,5,1,9,16,1,0,7,-7,1,0,0,0,0,0,0,0,0,0.5075272610403079,0.4924727389596921
87963,0.5121951219512195,0.5305164319248826,-105,-113,0.4903184724049234,0.5096815275950766,away,TB,over,8,0.5145631067961165,-106,0.49023796582517226,NYY,TB,2022 REG,15,10,7,3,13,22,1,0,7,-7,1,1,1,0,0,0,0,0,0,0.49023796582517226,0.5097620341748277
87963,0.5121951219512195,0.5305164319248826,-105,-113,0.4903184724049234,0.5096815275950766,home,NYY,under,8,0.5327102803738317,-114,0.5097620341748277,NYY,TB,2022 REG,15,10,7,3,13,22,1,0,7,-7,1,1,1,0,0,0,0,0,0,0.49023796582517226,0.5097620341748277
87964,0.5815899581589958,0.4629629629629629,-139,116,0.5556784266278149,0.44432157337218514,away,ARI,over,10,0.5098039215686274,-104,0.4870219861770517,CIN,ARI,2022 REG,9,4,7,5,9,16,0,1,-1,1,1,1,1,1,0,0,0,0,0,0.4870219861770517,0.5129780138229483
87964,0.5815899581589958,0.4629629629629629,-139,116,0.5556784266278149,0.44432157337218514,home,CIN,under,10,0.5348837209302326,-115,0.5129780138229483,CIN,ARI,2022 REG,9,4,7,5,9,16,0,1,-1,1,1,1,1,1,0,0,0,0,0,0.4870219861770517,0.5129780138229483
87965,0.38759689922480617,0.6503496503496503,158,-186,0.3728889342734665,0.6271110657265335,away,PHI,over,7,0.5454545454545454,-120,0.5206611570247933,PIT,PHI,2022 REG,9,2,18,8,10,27,0,1,-6,6,1,1,0,0,0,0,0,0,0,0.5206611570247933,0.4793388429752067
87965,0.38759689922480617,0.6503496503496503,158,-186,0.3728889342734665,0.6271110657265335,home,PIT,under,7,0.5,100,0.4793388429752067,PIT,PHI,2022 REG,9,2,18,8,10,27,0,1,-6,6,1,1,0,0,0,0,0,0,0,0.5206611570247933,0.4793388429752067
87966,0.47619047619047616,0.5652173913043479,110,-130,0.4564724440500838,0.5435275559499162,away,PHI,over,7.5,0.5145631067961165,-106,0.4925063625223866,MIA,PHI,2022 REG,7,5,8,3,8,15,1,0,2,-2,1,1,1,0,0,0,0,0,0,0.4925063625223866,0.5074936374776133
87966,0.47619047619047616,0.5652173913043479,110,-130,0.4564724440500838,0.5435275559499162,home,MIA,under,7.5,0.5283018867924528,-112,0.5074936374776133,MIA,PHI,2022 REG,7,5,8,3,8,15,1,0,2,-2,1,1,1,0,0,0,0,0,0,0.4925063625223866,0.5074936374776133
87967,0.6296296296296295,0.41152263374485604,-170,143,0.6037189452827312,0.3962810547172688,away,DET,over,8.5,0.5121951219512195,-105,0.48808156828023186,CLE,DET,2022 REG,13,10,5,0,10,18,1,0,10,-10,0,0,0,0,0,0,0,0,0,0.48808156828023186,0.5119184317197681
87967,0.6296296296296295,0.41152263374485604,-170,143,0.6037189452827312,0.3962810547172688,home,CLE,under,8.5,0.5348837209302326,-115,0.5119184317197681,CLE,DET,2022 REG,13,10,5,0,10,18,1,0,10,-10,0,0,0,0,0,0,0,0,0,0.48808156828023186,0.5119184317197681
87968,0.3802281368821293,0.6551724137931035,163,-190,0.36676785145428414,0.6332321485457159,away,LAA,over,6.5,0.5348837209302326,-115,0.5097020142727117,DET,LAA,2022 REG,7,4,7,0,4,14,1,0,4,-4,0,0,0,0,0,0,0,0,0,0.5097020142727117,0.49029798572728833
87968,0.3802281368821293,0.6551724137931035,163,-190,0.36676785145428414,0.6332321485457159,home,DET,under,6.5,0.5121951219512195,-105,0.49029798572728833,DET,LAA,2022 REG,7,4,7,0,4,14,1,0,4,-4,0,0,0,0,0,0,0,0,0,0.5097020142727117,0.49029798572728833
87969,0.48309178743961345,0.5555555555555556,107,-125,0.4644215734322854,0.5355784265677146,away,NYY,over,7,0.5,100,0.4772727272727273,TB,NYY,2022 REG,6,1,6,2,3,12,0,1,-1,1,1,0,0,0,0,0,0,0,0,0.4772727272727273,0.5227272727272727
87969,0.48309178743961345,0.5555555555555556,107,-125,0.4644215734322854,0.5355784265677146,home,TB,under,7,0.5454545454545454,-120,0.5227272727272727,TB,NYY,2022 REG,6,1,6,2,3,12,0,1,-1,1,1,0,0,0,0,0,0,0,0,0.4772727272727273,0.5227272727272727
87970,0.6000000000000001,0.4347826086956522,-150,130,0.5791304347826086,0.4208695652173914,away,TEX,over,7.5,0.49504950495049505,102,0.4739797934813417,TB,TEX,2022 REG,10,3,9,4,7,19,0,1,-1,1,1,1,1,0,0,0,0,0,0,0.4739797934813417,0.5260202065186583
87970,0.6000000000000001,0.4347826086956522,-150,130,0.5791304347826086,0.4208695652173914,home,TB,under,7.5,0.5475113122171946,-121,0.5260202065186583,TB,TEX,2022 REG,10,3,9,4,7,19,0,1,-1,1,1,1,1,0,0,0,0,0,0,0.4739797934813417,0.5260202065186583
87971,0.45454545454545453,0.5967741935483871,120,-148,0.43121834177552654,0.5687816582244735,away,NYM,over,7.5,0.49504950495049505,102,0.4739797934813417,MIA,NYM,2022 REG,7,3,14,9,12,21,0,1,-6,6,1,1,1,0,0,0,0,0,0,0.4739797934813417,0.5260202065186583
87971,0.45454545454545453,0.5967741935483871,120,-148,0.43121834177552654,0.5687816582244735,home,MIA,under,7.5,0.5475113122171946,-121,0.5260202065186583,MIA,NYM,2022 REG,7,3,14,9,12,21,0,1,-6,6,1,1,1,0,0,0,0,0,0,0.4739797934813417,0.5260202065186583
87972,0.4672897196261683,0.5689655172413793,114,-132,0.4503480201553517,0.5496519798446483,away,MIN,over,8,0.5391705069124424,-117,0.5140669063204599,DET,MIN,2022 REG,5,3,5,2,5,10,1,0,1,-1,1,1,0,0,0,0,0,0,0,0.5140669063204599,0.4859330936795401
87972,0.4672897196261683,0.5689655172413793,114,-132,0.4503480201553517,0.5496519798446483,home,DET,under,8,0.5073891625615764,-103,0.4859330936795401,DET,MIN,2022 REG,5,3,5,2,5,10,1,0,1,-1,1,1,0,0,0,0,0,0,0,0.5140669063204599,0.4859330936795401
87973,0.6666666666666666,0.36363636363636365,-200,175,0.6464646464646464,0.3535353535353536,away,COL,over,8.5,0.5121951219512195,-105,0.48919479393107135,CWS,COL,2022 REG,7,4,5,2,6,12,1,0,2,-2,1,1,0,0,0,0,0,0,0,0.48919479393107135,0.5108052060689287
87973,0.6666666666666666,0.36363636363636365,-200,175,0.6464646464646464,0.3535353535353536,home,CWS,under,8.5,0.5327102803738317,-114,0.5108052060689287,CWS,COL,2022 REG,7,4,5,2,6,12,1,0,2,-2,1,1,0,0,0,0,0,0,0,0.48919479393107135,0.5108052060689287
87974,0.5850622406639003,0.45454545454545453,-141,120,0.5618892737571823,0.43811072624281766,away,CWS,over,8.5,0.5475113122171946,-121,0.5242087833606768,LAA,CWS,2022 REG,9,4,6,3,7,15,1,0,1,-1,1,1,1,0,0,0,0,0,0,0.5242087833606768,0.4757912166393232
87974,0.5850622406639003,0.45454545454545453,-141,120,0.5618892737571823,0.43811072624281766,home,LAA,under,8.5,0.49504950495049505,102,0.4757912166393232,LAA,CWS,2022 REG,9,4,6,3,7,15,1,0,1,-1,1,1,1,0,0,0,0,0,0,0.5242087833606768,0.4757912166393232
87975,0.6428571428571428,0.3921568627450981,-180,155,0.6203481392557023,0.3796518607442977,away,WSH,over,7.5,0.5412844036697247,-118,0.5162581740877563,SF,WSH,2022 REG,6,5,12,11,16,18,0,1,-6,6,1,1,1,1,1,0,0,0,0,0.5162581740877563,0.4837418259122437
87975,0.6428571428571428,0.3921568627450981,-180,155,0.6203481392557023,0.3796518607442977,home,SF,under,7.5,0.504950495049505,-102,0.4837418259122437,SF,WSH,2022 REG,6,5,12,11,16,18,0,1,-6,6,1,1,1,1,1,0,0,0,0,0.5162581740877563,0.4837418259122437
87976,0.45454545454545453,0.5918367346938775,120,-145,0.433462641254849,0.566537358745151,away,PHI,over,7.5,0.5121951219512195,-105,0.48808156828023186,TEX,PHI,2022 REG,7,4,5,2,6,12,1,0,2,-2,1,1,0,0,0,0,0,0,0,0.48808156828023186,0.5119184317197681
87976,0.45454545454545453,0.5918367346938775,120,-145,0.433462641254849,0.566537358745151,home,TEX,under,7.5,0.5348837209302326,-115,0.5119184317197681,TEX,PHI,2022 REG,7,4,5,2,6,12,1,0,2,-2,1,1,0,0,0,0,0,0,0,0.48808156828023186,0.5119184317197681
87977,0.7142857142857143,0.3278688524590164,-250,205,0.6841753094680495,0.3158246905319505,away,SF,over,8,0.5412844036697247,-118,0.5136310900085983,LAD,SF,2022 REG,11,7,8,3,10,19,1,0,4,-4,1,1,1,0,0,0,0,0,0,0.5136310900085983,0.4863689099914017
87977,0.7142857142857143,0.3278688524590164,-250,205,0.6841753094680495,0.3158246905319505,home,LAD,under,8,0.5098039215686274,-104,0.4863689099914017,LAD,SF,2022 REG,11,7,8,3,10,19,1,0,4,-4,1,1,1,0,0,0,0,0,0,0.5136310900085983,0.4863689099914017
89013,0.35714285714285715,0.6825396825396826,180,-215,0.34297052154195007,0.6570294784580499,away,PHI,over,8.5,0.504950495049505,-102,0.48054649490447493,WSH,PHI,2022 REG,7,1,11,5,6,18,0,1,-4,4,1,0,0,0,0,0,0,0,0,0.48054649490447493,0.5194535050955251
89013,0.35714285714285715,0.6825396825396826,180,-215,0.34297052154195007,0.6570294784580499,home,WSH,under,8.5,0.5433789954337899,-119,0.5194535050955251,WSH,PHI,2022 REG,7,1,11,5,6,18,0,1,-4,4,1,0,0,0,0,0,0,0,0,0.48054649490447493,0.5194535050955251
89014,0.373134328358209,0.6666666666666666,168,-200,0.3582832108116136,0.6417167891883864,away,PHI,over,7.5,0.5348837209302326,-115,0.5097020142727117,WSH,PHI,2022 REG,14,13,7,4,17,21,1,0,9,-9,1,1,1,1,0,0,0,0,0,0.5097020142727117,0.49029798572728833
89014,0.373134328358209,0.6666666666666666,168,-200,0.3582832108116136,0.6417167891883864,home,WSH,under,7.5,0.5121951219512195,-105,0.49029798572728833,WSH,PHI,2022 REG,14,13,7,4,17,21,1,0,9,-9,1,1,1,1,0,0,0,0,0,0.5097020142727117,0.49029798572728833
89083,0.5238095238095238,0.5192307692307692,-110,-108,0.5012646084074657,0.4987353915925343,away,CLE,over,9,0.5348837209302326,-115,0.5097020142727117,ARI,CLE,2023 REG,9,3,16,12,15,25,0,1,-9,9,1,1,1,0,0,0,0,0,0,0.5097020142727117,0.49029798572728833
89083,0.5238095238095238,0.5192307692307692,-110,-108,0.5012646084074657,0.4987353915925343,home,ARI,under,9,0.5121951219512195,-105,0.49029798572728833,ARI,CLE,2023 REG,9,3,16,12,15,25,0,1,-9,9,1,1,1,0,0,0,0,0,0,0.5097020142727117,0.49029798572728833
89095,0.6336996336996338,0.4,-173,150,0.612344188168364,0.387655811831636,away,CHC,over,8.5,0.5121951219512195,-105,0.48808156828023186,HOU,CHC,2023 REG,13,7,13,6,13,26,1,0,1,-1,1,1,1,1,1,1,0,0,0,0.48808156828023186,0.5119184317197681
89095,0.6336996336996338,0.4,-173,150,0.612344188168364,0.387655811831636,home,HOU,under,8.5,0.5348837209302326,-115,0.5119184317197681,HOU,CHC,2023 REG,13,7,13,6,13,26,1,0,1,-1,1,1,1,1,1,1,0,0,0,0.48808156828023186,0.5119184317197681
89100,0.4444444444444444,0.5967741935483871,125,-148,0.42612504978096366,0.5738749502190363,away,KC,over,8.5,0.5475113122171946,-121,0.5214983313199976,OAK,KC,2023 REG,2,0,5,4,4,7,0,1,-4,4,0,0,0,0,0,0,0,0,0,0.5214983313199976,0.47850166868000243
89100,0.4444444444444444,0.5967741935483871,125,-148,0.42612504978096366,0.5738749502190363,home,OAK,under,8.5,0.5,100,0.47850166868000243,OAK,KC,2023 REG,2,0,5,4,4,7,0,1,-4,4,0,0,0,0,0,0,0,0,0,0.5214983313199976,0.47850166868000243
89104,0.4081632653061224,0.6363636363636364,145,-175,0.3899890197266291,0.6100109802733709,away,ATL,over,9,0.5348837209302326,-115,0.5097020142727117,MIA,ATL,2023 REG,13,9,11,6,15,24,1,0,3,-3,1,1,1,1,1,1,0,0,0,0.5097020142727117,0.49029798572728833
89104,0.4081632653061224,0.6363636363636364,145,-175,0.3899890197266291,0.6100109802733709,home,MIA,under,9,0.5121951219512195,-105,0.49029798572728833,MIA,ATL,2023 REG,13,9,11,6,15,24,1,0,3,-3,1,1,1,1,1,1,0,0,0,0.5097020142727117,0.49029798572728833
89110,0.574468085106383,0.46511627906976744,-135,115,0.5517281312179562,0.44827186878204384,away,BOS,over,8,0.5145631067961165,-106,0.4913668392989033,CLE,BOS,2023 REG,11,5,5,2,7,16,1,0,3,-3,1,1,0,0,0,0,0,0,0,0.4913668392989033,0.5086331607010968
89110,0.574468085106383,0.46511627906976744,-135,115,0.5517281312179562,0.44827186878204384,home,CLE,under,8,0.5305164319248826,-113,0.5086331607010968,CLE,BOS,2023 REG,11,5,5,2,7,16,1,0,3,-3,1,1,0,0,0,0,0,0,0,0.4913668392989033,0.5086331607010968
89113,0.5283018867924528,0.5098039215686274,-112,-104,0.5081705163375425,0.4918294836624575,away,CLE,over,8.5,0.5327102803738317,-114,0.508788710910954,PIT,CLE,2023 REG,5,1,13,10,11,18,0,1,-9,9,1,0,0,0,0,0,0,0,0,0.508788710910954,0.491211289089046
89113,0.5283018867924528,0.5098039215686274,-112,-104,0.5081705163375425,0.4918294836624575,home,PIT,under,8.5,0.5121951219512195,-105,0.491211289089046,PIT,CLE,2023 REG,5,1,13,10,11,18,0,1,-9,9,1,0,0,0,0,0,0,0,0,0.508788710910954,0.491211289089046
89117,0.6047430830039526,0.4291845493562232,-153,133,0.5842255820114353,0.41577441798856474,away,CWS,over,7.5,0.5348837209302326,-115,0.5109810284308424,SEA,CWS,2023 REG,5,5,6,1,6,11,1,0,4,-4,1,0,0,0,0,0,0,0,0,0.5109810284308424,0.48901897156915763
89117,0.6047430830039526,0.4291845493562232,-153,133,0.5842255820114353,0.41577441798856474,home,SEA,under,7.5,0.5098039215686274,-104,0.48901897156915763,SEA,CWS,2023 REG,5,5,6,1,6,11,1,0,4,-4,1,0,0,0,0,0,0,0,0,0.5109810284308424,0.48901897156915763
89128,0.5652173913043479,0.4716981132075471,-130,112,0.5443521061454507,0.4556478938545493,away,TB,over,7.5,0.49751243781094534,101,0.476135829221149,SEA,TB,2023 REG,10,7,7,6,13,17,1,0,1,-1,1,1,1,1,1,1,0,0,0,0.476135829221149,0.523864170778851
89128,0.5652173913043479,0.4716981132075471,-130,112,0.5443521061454507,0.4556478938545493,home,SEA,under,7.5,0.5454545454545454,-120,0.523864170778851,SEA,TB,2023 REG,10,7,7,6,13,17,1,0,1,-1,1,1,1,1,1,1,0,0,0,0.476135829221149,0.523864170778851
89139,0.6865203761755486,0.35714285714285715,-219,180,0.656544676812756,0.34345532318724403,away,WSH,over,8.5,0.5121951219512195,-105,0.48808156828023186,MIA,WSH,2023 REG,9,4,13,7,11,22,0,1,-3,3,1,1,1,1,0,0,0,0,0,0.48808156828023186,0.5119184317197681
89139,0.6865203761755486,0.35714285714285715,-219,180,0.656544676812756,0.34345532318724403,home,MIA,under,8.5,0.5348837209302326,-115,0.5119184317197681,MIA,WSH,2023 REG,9,4,13,7,11,22,0,1,-3,3,1,1,1,1,0,0,0,0,0,0.48808156828023186,0.5119184317197681
89140,0.646643109540636,0.3921568627450981,-183,155,0.6215533748116984,0.37844662518830163,away,SF,over,9,0.49504950495049505,102,0.47297076509898783,LAD,SF,2023 REG,9,7,3,2,9,12,1,0,5,-5,1,1,0,0,0,0,0,0,0,0.47297076509898783,0.5270292349010122
89140,0.646643109540636,0.3921568627450981,-183,155,0.6215533748116984,0.37844662518830163,home,LAD,under,9,0.5495495495495495,-122,0.5270292349010122,LAD,SF,2023 REG,9,7,3,2,9,12,1,0,5,-5,1,1,0,0,0,0,0,0,0,0.47297076509898783,0.5270292349010122
89141,0.6610169491525424,0.37878787878787884,-195,164,0.6347052832258232,0.3652947167741768,away,KC,over,8,0.5327102803738317,-114,0.5075272610403079,SEA,KC,2023 REG,16,7,10,5,12,26,1,0,2,-2,1,1,1,1,1,0,0,0,0,0.5075272610403079,0.4924727389596921
89141,0.6610169491525424,0.37878787878787884,-195,164,0.6347052832258232,0.3652947167741768,home,SEA,under,8,0.5145631067961165,-106,0.4924727389596921,SEA,KC,2023 REG,16,7,10,5,12,26,1,0,2,-2,1,1,1,1,1,0,0,0,0,0.5075272610403079,0.4924727389596921
89149,0.6363636363636364,0.4065040650406504,-175,146,0.6090841900154538,0.3909158099845462,away,OAK,over,8,0.5121951219512195,-105,0.48808156828023186,DET,OAK,2023 REG,6,0,2,1,1,8,0,1,-1,1,0,0,0,0,0,0,0,0,0,0.48808156828023186,0.5119184317197681
89149,0.6363636363636364,0.4065040650406504,-175,146,0.6090841900154538,0.3909158099845462,home,DET,under,8,0.5348837209302326,-115,0.5119184317197681,DET,OAK,2023 REG,6,0,2,1,1,8,0,1,-1,1,0,0,0,0,0,0,0,0,0,0.48808156828023186,0.5119184317197681
89153,0.4629629629629629,0.5798319327731092,116,-138,0.44315051123329985,0.5568494887667002,away,NYM,over,13,0.5192307692307692,-108,0.49455035168025013,COL,NYM,2023 REG,15,11,14,10,21,29,1,0,1,-1,1,1,1,1,1,1,1,1,1,0.49455035168025013,0.5054496483197499
89153,0.4629629629629629,0.5798319327731092,116,-138,0.44315051123329985,0.5568494887667002,home,COL,under,13,0.5283018867924528,-112,0.5054496483197499,COL,NYM,2023 REG,15,11,14,10,21,29,1,0,1,-1,1,1,1,1,1,1,1,1,1,0.49455035168025013,0.5054496483197499
89156,0.5192307692307692,0.5238095238095238,-108,-110,0.49688292476754015,0.5031170752324599,away,MIA,over,8.5,0.5283018867924528,-112,0.5044173060022736,STL,MIA,2023 REG,11,6,12,4,10,23,1,0,2,-2,1,1,1,1,0,0,0,0,0,0.5044173060022736,0.49558269399772636
89156,0.5192307692307692,0.5238095238095238,-108,-110,0.49688292476754015,0.5031170752324599,home,STL,under,8.5,0.5169082125603864,-107,0.49558269399772636,STL,MIA,2023 REG,11,6,12,4,10,23,1,0,2,-2,1,1,1,1,0,0,0,0,0,0.5044173060022736,0.49558269399772636
89157,0.4854368932038835,0.5535714285714286,106,-124,0.4665008146721786,0.5334991853278215,away,TB,over,9,0.5192307692307692,-108,0.49571111079951763,TEX,TB,2023 REG,6,3,5,2,5,11,1,0,1,-1,1,1,0,0,0,0,0,0,0,0.49571111079951763,0.5042888892004824
89157,0.4854368932038835,0.5535714285714286,106,-124,0.4665008146721786,0.5334991853278215,home,TEX,under,9,0.5260663507109005,-111,0.5042888892004824,TEX,TB,2023 REG,6,3,5,2,5,11,1,0,1,-1,1,1,0,0,0,0,0,0,0,0.49571111079951763,0.5042888892004824
89158,0.6453900709219857,0.3968253968253968,-182,152,0.6181446271984977,0.3818553728015023,away,SF,over,9,0.5348837209302326,-115,0.5097020142727117,LAD,SF,2023 REG,6,3,8,2,5,14,1,0,1,-1,1,1,0,0,0,0,0,0,0,0.5097020142727117,0.49029798572728833
89158,0.6453900709219857,0.3968253968253968,-182,152,0.6181446271984977,0.3818553728015023,home,LAD,under,9,0.5121951219512195,-105,0.49029798572728833,LAD,SF,2023 REG,6,3,8,2,5,14,1,0,1,-1,1,1,0,0,0,0,0,0,0,0.5097020142727117,0.49029798572728833
89159,0.5370370370370371,0.5,-116,100,0.5171467764060357,0.4828532235939643,away,TOR,over,7.5,0.5370370370370371,-116,0.5118817074154765,MIA,TOR,2023 REG,6,0,7,2,2,13,0,1,-2,2,0,0,0,0,0,0,0,0,0,0.5118817074154765,0.48811829258452355
89159,0.5370370370370371,0.5,-116,100,0.5171467764060357,0.4828532235939643,home,MIA,under,7.5,0.5098039215686274,-104,0.48811829258452355,MIA,TOR,2023 REG,6,0,7,2,2,13,0,1,-2,2,0,0,0,0,0,0,0,0,0,0.5118817074154765,0.48811829258452355
89160,0.6226415094339623,0.4166666666666667,-165,140,0.5981666073335706,0.40183339266642937,away,TOR,over,10.5,0.5305164319248826,-113,0.5066009958897986,BOS,TOR,2023 REG,6,3,14,7,10,20,0,1,-4,4,1,1,1,0,0,0,0,0,0,0.5066009958897986,0.49339900411020143
89160,0.6226415094339623,0.4166666666666667,-165,140,0.5981666073335706,0.40183339266642937,home,BOS,under,10.5,0.5145631067961165,-106,0.49339900411020143,BOS,TOR,2023 REG,6,3,14,7,10,20,0,1,-4,4,1,1,1,0,0,0,0,0,0,0.5066009958897986,0.49339900411020143
89164,0.49019607843137253,0.5515695067264574,104,-123,0.4697227523736127,0.5302772476263873,away,MIN,over,9,0.5215311004784688,-109,0.49670754937970685,PHI,MIN,2023 REG,9,1,11,8,9,20,0,1,-7,7,1,0,0,0,0,0,0,0,0,0.49670754937970685,0.5032924506202932
89164,0.49019607843137253,0.5515695067264574,104,-123,0.4697227523736127,0.5302772476263873,home,PHI,under,9,0.5260663507109005,-111,0.5032924506202932,PHI,MIN,2023 REG,9,1,11,8,9,20,0,1,-7,7,1,0,0,0,0,0,0,0,0,0.49670754937970685,0.5032924506202932
89165,0.4347826086956522,0.6047430830039526,130,-153,0.4175975253479979,0.5824024746520021,away,SEA,over,9,0.5024875621890548,-101,0.4794401874631478,NYM,SEA,2023 REG,10,6,6,3,9,16,1,0,3,-3,1,1,1,0,0,0,0,0,0,0.4794401874631478,0.5205598125368522
89165,0.4347826086956522,0.6047430830039526,130,-153,0.4175975253479979,0.5824024746520021,home,NYM,under,9,0.5433789954337899,-119,0.5205598125368522,NYM,SEA,2023 REG,10,6,6,3,9,16,1,0,3,-3,1,1,1,0,0,0,0,0,0,0.4794401874631478,0.5205598125368522
89166,0.5215311004784688,0.5215311004784688,-109,-109,0.49907282342437215,0.5009271765756278,away,CHC,over,9,0.5121951219512195,-105,0.48808156828023186,MIL,CHC,2023 REG,8,8,10,6,14,18,1,0,2,-2,1,1,1,1,1,1,0,0,0,0.48808156828023186,0.5119184317197681
89166,0.5215311004784688,0.5215311004784688,-109,-109,0.49907282342437215,0.5009271765756278,home,MIL,under,9,0.5348837209302326,-115,0.5119184317197681,MIL,CHC,2023 REG,8,8,10,6,14,18,1,0,2,-2,1,1,1,1,1,1,0,0,0,0.48808156828023186,0.5119184317197681
89169,0.6323529411764706,0.40485829959514175,-172,147,0.6088223036297157,0.3911776963702843,away,KC,over,9.5,0.5169082125603864,-107,0.49239402434819424,MIL,KC,2023 REG,6,9,8,6,15,14,1,0,3,-3,1,1,1,1,1,1,0,0,0,0.49239402434819424,0.5076059756518058
89169,0.6323529411764706,0.40485829959514175,-172,147,0.6088223036297157,0.3911776963702843,home,MIL,under,9.5,0.5305164319248826,-113,0.5076059756518058,MIL,KC,2023 REG,6,9,8,6,15,14,1,0,3,-3,1,1,1,1,1,1,0,0,0,0.49239402434819424,0.5076059756518058
89174,0.5454545454545454,0.5,-120,100,0.5206611570247933,0.4793388429752067,away,PIT,over,9.5,0.5,100,0.4772727272727273,LAA,PIT,2023 REG,10,7,10,5,12,20,1,0,2,-2,1,1,1,1,1,0,0,0,0,0.4772727272727273,0.5227272727272727
89174,0.5454545454545454,0.5,-120,100,0.5206611570247933,0.4793388429752067,home,LAA,under,9.5,0.5454545454545454,-120,0.5227272727272727,LAA,PIT,2023 REG,10,7,10,5,12,20,1,0,2,-2,1,1,1,1,1,0,0,0,0,0.4772727272727273,0.5227272727272727
89176,0.4098360655737705,0.6296296296296295,144,-170,0.3936616003264754,0.6063383996735245,away,TOR,over,7.5,0.5238095238095238,-110,0.4988662131519274,OAK,TOR,2023 REG,8,5,6,2,7,14,1,0,3,-3,1,1,0,0,0,0,0,0,0,0.4988662131519274,0.5011337868480725
89176,0.4098360655737705,0.6296296296296295,144,-170,0.3936616003264754,0.6063383996735245,home,OAK,under,7.5,0.5238095238095238,-110,0.5011337868480725,OAK,TOR,2023 REG,8,5,6,2,7,14,1,0,3,-3,1,1,0,0,0,0,0,0,0,0.4988662131519274,0.5011337868480725
89177,0.5850622406639003,0.45454545454545453,-141,120,0.5618892737571823,0.43811072624281766,away,ARI,over,7,0.5454545454545454,-120,0.5193043049216726,CHC,ARI,2023 REG,8,2,8,3,5,16,0,1,-1,1,1,1,0,0,0,0,0,0,0,0.5193043049216726,0.48069569507832743
89177,0.5850622406639003,0.45454545454545453,-141,120,0.5618892737571823,0.43811072624281766,home,CHC,under,7,0.5024875621890548,-101,0.48069569507832743,CHC,ARI,2023 REG,8,2,8,3,5,16,0,1,-1,1,1,1,0,0,0,0,0,0,0,0.5193043049216726,0.48069569507832743
89180,0.425531914893617,0.607843137254902,135,-155,0.4113297650431834,0.5886702349568166,away,LAD,over,7.5,0.5098039215686274,-104,0.48592421718142587,SF,LAD,2023 REG,7,1,9,9,10,16,0,1,-8,8,1,0,0,0,0,0,0,0,0,0.48592421718142587,0.5140757828185741
89180,0.425531914893617,0.607843137254902,135,-155,0.4113297650431834,0.5886702349568166,home,SF,under,7.5,0.5370370370370371,-116,0.5140757828185741,SF,LAD,2023 REG,7,1,9,9,10,16,0,1,-8,8,1,0,0,0,0,0,0,0,0,0.48592421718142587,0.5140757828185741
89182,0.5833333333333333,0.45454545454545453,-140,120,0.5612373737373737,0.4387626262626263,away,COL,over,8.5,0.5238095238095238,-110,0.4988662131519274,PIT,COL,2023 REG,6,3,8,4,7,14,0,1,-1,1,1,1,1,0,0,0,0,0,0,0.4988662131519274,0.5011337868480725
89182,0.5833333333333333,0.45454545454545453,-140,120,0.5612373737373737,0.4387626262626263,home,PIT,under,8.5,0.5238095238095238,-110,0.5011337868480725,PIT,COL,2023 REG,6,3,8,4,7,14,0,1,-1,1,1,1,1,0,0,0,0,0,0,0.4988662131519274,0.5011337868480725
89183,0.4347826086956522,0.6031746031746031,130,-152,0.418279473099889,0.581720526900111,away,CHC,over,10,0.5305164319248826,-113,0.5066009958897986,CIN,CHC,2023 REG,11,7,18,15,22,29,0,1,-8,8,1,1,1,1,1,1,1,0,0,0.5066009958897986,0.49339900411020143
89183,0.4347826086956522,0.6031746031746031,130,-152,0.418279473099889,0.581720526900111,home,CIN,under,10,0.5145631067961165,-106,0.49339900411020143,CIN,CHC,2023 REG,11,7,18,15,22,29,0,1,-8,8,1,1,1,1,1,1,1,0,0,0.5066009958897986,0.49339900411020143
89184,0.7214484679665738,0.3205128205128205,-259,212,0.6911755606792114,0.3088244393207886,away,WSH,over,9,0.5098039215686274,-104,0.48592421718142587,PHI,WSH,2023 REG,6,6,10,2,8,16,1,0,4,-4,1,1,0,0,0,0,0,0,0,0.48592421718142587,0.5140757828185741
89184,0.7214484679665738,0.3205128205128205,-259,212,0.6911755606792114,0.3088244393207886,home,PHI,under,9,0.5370370370370371,-116,0.5140757828185741,PHI,WSH,2023 REG,6,6,10,2,8,16,1,0,4,-4,1,1,0,0,0,0,0,0,0,0.48592421718142587,0.5140757828185741
89185,0.4608294930875576,0.5780590717299579,117,-137,0.44290849547579936,0.5570915045242006,away,LAD,over,9,0.5121951219512195,-105,0.48808156828023186,BAL,LAD,2023 REG,10,8,7,5,13,17,1,0,3,-3,1,1,1,1,1,0,0,0,0,0.48808156828023186,0.5119184317197681
89185,0.4608294930875576,0.5780590717299579,117,-137,0.44290849547579936,0.5570915045242006,home,BAL,under,9,0.5348837209302326,-115,0.5119184317197681,BAL,LAD,2023 REG,10,8,7,5,13,17,1,0,3,-3,1,1,1,1,1,0,0,0,0,0.48808156828023186,0.5119184317197681
89187,0.5238095238095238,0.5215311004784688,-110,-109,0.5000596729920038,0.4999403270079962,away,SD,over,7,0.5515695067264574,-123,0.5258558814517258,CHC,SD,2023 REG,7,6,5,0,6,12,1,0,6,-6,0,0,0,0,0,0,0,0,0,0.5258558814517258,0.4741441185482742
89187,0.5238095238095238,0.5215311004784688,-110,-109,0.5000596729920038,0.4999403270079962,home,CHC,under,7,0.49504950495049505,102,0.4741441185482742,CHC,SD,2023 REG,7,6,5,0,6,12,1,0,6,-6,0,0,0,0,0,0,0,0,0,0.5258558814517258,0.4741441185482742
89188,0.4566210045662101,0.5833333333333333,119,-140,0.4383770146577428,0.5616229853422572,away,SF,over,11,0.504950495049505,-102,0.48160416005266615,CIN,SF,2023 REG,14,10,11,11,21,25,0,1,-1,1,1,1,1,1,1,1,1,1,1,0.48160416005266615,0.5183958399473338
89188,0.4566210045662101,0.5833333333333333,119,-140,0.4383770146577428,0.5616229853422572,home,CIN,under,11,0.5412844036697247,-118,0.5183958399473338,CIN,SF,2023 REG,14,10,11,11,21,25,0,1,-1,1,1,1,1,1,1,1,1,1,1,0.48160416005266615,0.5183958399473338
89190,0.5,0.5391705069124424,100,-117,0.4804147465437788,0.5195852534562212,away,CIN,over,10.5,0.5238095238095238,-110,0.5000596729920038,WSH,CIN,2023 REG,8,2,7,3,5,15,0,1,-1,1,1,1,0,0,0,0,0,0,0,0.5000596729920038,0.4999403270079962
89190,0.5,0.5391705069124424,100,-117,0.4804147465437788,0.5195852534562212,home,WSH,under,10.5,0.5215311004784688,-109,0.4999403270079962,WSH,CIN,2023 REG,8,2,7,3,5,15,0,1,-1,1,1,1,0,0,0,0,0,0,0,0.5000596729920038,0.4999403270079962
89192,0.7530864197530864,0.29411764705882354,-305,240,0.7175376780799196,0.28246232192008036,away,DET,over,9,0.5145631067961165,-106,0.49023796582517226,TOR,DET,2023 REG,9,4,6,3,7,15,1,0,1,-1,1,1,1,0,0,0,0,0,0,0.49023796582517226,0.5097620341748277
89192,0.7530864197530864,0.29411764705882354,-305,240,0.7175376780799196,0.28246232192008036,home,TOR,under,9,0.5327102803738317,-114,0.5097620341748277,TOR,DET,2023 REG,9,4,6,3,7,15,1,0,1,-1,1,1,1,0,0,0,0,0,0,0.49023796582517226,0.5097620341748277
89193,0.5515695067264574,0.49019607843137253,-123,104,0.5285328835228112,0.47146711647718875,away,SD,over,9,0.5024875621890548,-101,0.47839724939301687,TOR,SD,2023 REG,6,0,8,2,2,14,0,1,-2,2,0,0,0,0,0,0,0,0,0,0.47839724939301687,0.5216027506069831
89193,0.5515695067264574,0.49019607843137253,-123,104,0.5285328835228112,0.47146711647718875,home,TOR,under,9,0.5454545454545454,-120,0.5216027506069831,TOR,SD,2023 REG,6,0,8,2,2,14,0,1,-2,2,0,0,0,0,0,0,0,0,0,0.47839724939301687,0.5216027506069831
89194,0.5726495726495727,0.46511627906976744,-134,115,0.5510229738017454,0.44897702619825464,away,BAL,over,8.5,0.5238095238095238,-110,0.4988662131519274,TOR,BAL,2023 REG,3,4,7,1,5,10,1,0,3,-3,1,0,0,0,0,0,0,0,0,0.4988662131519274,0.5011337868480725
89194,0.5726495726495727,0.46511627906976744,-134,115,0.5510229738017454,0.44897702619825464,home,TOR,under,8.5,0.5238095238095238,-110,0.5011337868480725,TOR,BAL,2023 REG,3,4,7,1,5,10,1,0,3,-3,1,0,0,0,0,0,0,0,0,0.4988662131519274,0.5011337868480725
89195,0.5,0.5454545454545454,100,-120,0.4772727272727273,0.5227272727272727,away,ATL,over,9,0.504950495049505,-102,0.48160416005266615,SD,ATL,2023 REG,6,1,4,0,1,10,1,0,1,-1,0,0,0,0,0,0,0,0,0,0.48160416005266615,0.5183958399473338
89195,0.5,0.5454545454545454,100,-120,0.4772727272727273,0.5227272727272727,home,SD,under,9,0.5412844036697247,-118,0.5183958399473338,SD,ATL,2023 REG,6,1,4,0,1,10,1,0,1,-1,0,0,0,0,0,0,0,0,0,0.48160416005266615,0.5183958399473338
89196,0.5594713656387665,0.47619047619047616,-127,110,0.5395195862893665,0.46048041371063353,away,CWS,over,12,0.5145631067961165,-106,0.49023796582517226,COL,CWS,2023 REG,13,14,4,1,15,17,1,0,13,-13,1,0,0,0,0,0,0,0,0,0.49023796582517226,0.5097620341748277
89196,0.5594713656387665,0.47619047619047616,-127,110,0.5395195862893665,0.46048041371063353,home,COL,under,12,0.5327102803738317,-114,0.5097620341748277,COL,CWS,2023 REG,13,14,4,1,15,17,1,0,13,-13,1,0,0,0,0,0,0,0,0,0.49023796582517226,0.5097620341748277
89198,0.3125,0.7267759562841529,220,-266,0.3002262636612022,0.6997737363387978,away,ATL,over,9,0.5145631067961165,-106,0.4913668392989033,DET,ATL,2023 REG,15,6,8,5,11,23,1,0,1,-1,1,1,1,1,1,0,0,0,0,0.4913668392989033,0.5086331607010968
89198,0.3125,0.7267759562841529,220,-266,0.3002262636612022,0.6997737363387978,home,DET,under,9,0.5305164319248826,-113,0.5086331607010968,DET,ATL,2023 REG,15,6,8,5,11,23,1,0,1,-1,1,1,1,1,1,0,0,0,0,0.4913668392989033,0.5086331607010968
89204,0.3278688524590164,0.7142857142857143,205,-250,0.3140476830345145,0.6859523169654855,away,LAD,over,9,0.5348837209302326,-115,0.5097020142727117,ARI,LAD,2023 REG,10,6,5,3,9,15,1,0,3,-3,1,1,1,0,0,0,0,0,0,0.5097020142727117,0.49029798572728833
89204,0.3278688524590164,0.7142857142857143,205,-250,0.3140476830345145,0.6859523169654855,home,ARI,under,9,0.5121951219512195,-105,0.49029798572728833,ARI,LAD,2023 REG,10,6,5,3,9,15,1,0,3,-3,1,1,1,0,0,0,0,0,0,0.5097020142727117,0.49029798572728833
89205,0.5215311004784688,0.5215311004784688,-109,-109,0.49907282342437215,0.5009271765756278,away,HOU,over,9,0.5,100,0.4772727272727273,TEX,HOU,2023 REG,8,1,20,14,15,28,0,1,-13,13,1,0,0,0,0,0,0,0,0,0.4772727272727273,0.5227272727272727
89205,0.5215311004784688,0.5215311004784688,-109,-109,0.49907282342437215,0.5009271765756278,home,TEX,under,9,0.5454545454545454,-120,0.5227272727272727,TEX,HOU,2023 REG,8,1,20,14,15,28,0,1,-13,13,1,0,0,0,0,0,0,0,0,0.4772727272727273,0.5227272727272727
89207,0.6987951807228916,0.3412969283276451,-232,193,0.67077900813336,0.32922099186664,away,ARI,over,10,0.5169082125603864,-107,0.49239402434819424,ATL,ARI,2023 REG,4,3,9,5,8,13,0,1,-2,2,1,1,1,0,0,0,0,0,0,0.49239402434819424,0.5076059756518058
89207,0.6987951807228916,0.3412969283276451,-232,193,0.67077900813336,0.32922099186664,home,ATL,under,10,0.5305164319248826,-113,0.5076059756518058,ATL,ARI,2023 REG,4,3,9,5,8,13,0,1,-2,2,1,1,1,0,0,0,0,0,0,0.49239402434819424,0.5076059756518058
89210,0.6825396825396826,0.35714285714285715,-215,180,0.6554547745023935,0.34454522549760647,away,COL,over,8,0.5370370370370371,-116,0.5118817074154765,CLE,COL,2023 REG,6,1,8,5,6,14,0,1,-4,4,1,0,0,0,0,0,0,0,0,0.5118817074154765,0.48811829258452355
89210,0.6825396825396826,0.35714285714285715,-215,180,0.6554547745023935,0.34454522549760647,home,CLE,under,8,0.5098039215686274,-104,0.48811829258452355,CLE,COL,2023 REG,6,1,8,5,6,14,0,1,-4,4,1,0,0,0,0,0,0,0,0,0.5118817074154765,0.48811829258452355
89212,0.5780590717299579,0.4608294930875576,-137,117,0.5555791840506346,0.44442081594936544,away,NYM,over,10,0.5121951219512195,-105,0.48808156828023186,ARI,NYM,2023 REG,4,0,17,9,9,21,0,1,-9,9,0,0,0,0,0,0,0,0,0,0.48808156828023186,0.5119184317197681
89212,0.5780590717299579,0.4608294930875576,-137,117,0.5555791840506346,0.44442081594936544,home,ARI,under,10,0.5348837209302326,-115,0.5119184317197681,ARI,NYM,2023 REG,4,0,17,9,9,21,0,1,-9,9,0,0,0,0,0,0,0,0,0,0.48808156828023186,0.5119184317197681
89213,0.5798319327731092,0.4608294930875576,-138,117,0.5562551396270082,0.44374486037299177,away,STL,over,8,0.5433789954337899,-119,0.5184560714286826,MIL,STL,2023 REG,7,3,8,2,5,15,1,0,1,-1,1,1,0,0,0,0,0,0,0,0.5184560714286826,0.48154392857131745
89213,0.5798319327731092,0.4608294930875576,-138,117,0.5562551396270082,0.44374486037299177,home,MIL,under,8,0.5024875621890548,-101,0.48154392857131745,MIL,STL,2023 REG,7,3,8,2,5,15,1,0,1,-1,1,1,0,0,0,0,0,0,0,0.5184560714286826,0.48154392857131745
89216,0.3968253968253968,0.6491228070175439,152,-185,0.37859198260200766,0.6214080173979923,away,ATL,over,9,0.504950495049505,-102,0.48054649490447493,CHC,ATL,2023 REG,4,0,11,8,8,15,0,1,-8,8,0,0,0,0,0,0,0,0,0,0.48054649490447493,0.5194535050955251
89216,0.3968253968253968,0.6491228070175439,152,-185,0.37859198260200766,0.6214080173979923,home,CHC,under,9,0.5433789954337899,-119,0.5194535050955251,CHC,ATL,2023 REG,4,0,11,8,8,15,0,1,-8,8,0,0,0,0,0,0,0,0,0,0.48054649490447493,0.5194535050955251
89217,0.6453900709219857,0.38759689922480617,-182,158,0.6241006079194462,0.3758993920805538,away,BOS,over,9.5,0.5370370370370371,-116,0.5118817074154765,ATL,BOS,2023 REG,12,9,8,3,12,20,1,0,6,-6,1,1,1,0,0,0,0,0,0,0.5118817074154765,0.48811829258452355
89217,0.6453900709219857,0.38759689922480617,-182,158,0.6241006079194462,0.3758993920805538,home,ATL,under,9.5,0.5098039215686274,-104,0.48811829258452355,ATL,BOS,2023 REG,12,9,8,3,12,20,1,0,6,-6,1,1,1,0,0,0,0,0,0,0.5118817074154765,0.48811829258452355
89218,0.425531914893617,0.607843137254902,135,-155,0.4113297650431834,0.5886702349568166,away,ATL,over,8,0.5348837209302326,-115,0.5097020142727117,TB,ATL,2023 REG,4,1,7,6,7,11,0,1,-5,5,1,0,0,0,0,0,0,0,0,0.5097020142727117,0.49029798572728833
89218,0.425531914893617,0.607843137254902,135,-155,0.4113297650431834,0.5886702349568166,home,TB,under,8,0.5121951219512195,-105,0.49029798572728833,TB,ATL,2023 REG,4,1,7,6,7,11,0,1,-5,5,1,0,0,0,0,0,0,0,0,0.5097020142727117,0.49029798572728833
89220,0.6031746031746031,0.4329004329004329,-152,131,0.5814150576055337,0.4185849423944663,away,LAA,over,10,0.5283018867924528,-112,0.5044173060022736,TEX,LAA,2023 REG,12,6,10,9,15,22,0,1,-3,3,1,1,1,1,1,1,0,0,0,0.5044173060022736,0.49558269399772636
89220,0.6031746031746031,0.4329004329004329,-152,131,0.5814150576055337,0.4185849423944663,home,TEX,under,10,0.5169082125603864,-107,0.49558269399772636,TEX,LAA,2023 REG,12,6,10,9,15,22,0,1,-3,3,1,1,1,1,1,1,0,0,0,0.5044173060022736,0.49558269399772636
89221,0.46511627906976744,0.574468085106383,115,-135,0.44670494689481377,0.5532950531051862,away,TOR,over,8,0.5412844036697247,-118,0.5149381613977361,BAL,TOR,2023 REG,10,7,5,0,7,15,1,0,7,-7,0,0,0,0,0,0,0,0,0,0.5149381613977361,0.48506183860226393
89221,0.46511627906976744,0.574468085106383,115,-135,0.44670494689481377,0.5532950531051862,home,BAL,under,8,0.5073891625615764,-103,0.48506183860226393,BAL,TOR,2023 REG,10,7,5,0,7,15,1,0,7,-7,0,0,0,0,0,0,0,0,0,0.5149381613977361,0.48506183860226393
89223,0.5,0.5391705069124424,100,-117,0.4804147465437788,0.5195852534562212,away,ATL,over,8.5,0.5121951219512195,-105,0.48919479393107135,LAD,ATL,2023 REG,6,3,14,6,9,20,0,1,-3,3,1,1,1,0,0,0,0,0,0,0.48919479393107135,0.5108052060689287
89223,0.5,0.5391705069124424,100,-117,0.4804147465437788,0.5195852534562212,home,LAD,under,8.5,0.5327102803738317,-114,0.5108052060689287,LAD,ATL,2023 REG,6,3,14,6,9,20,0,1,-3,3,1,1,1,0,0,0,0,0,0,0.48919479393107135,0.5108052060689287
89226,0.5073891625615764,0.5348837209302326,-103,-115,0.4859403596076043,0.5140596403923957,away,MIL,over,12,0.5238095238095238,-110,0.5012646084074657,COL,MIL,2023 REG,10,7,5,1,8,15,1,0,6,-6,1,0,0,0,0,0,0,0,0,0.5012646084074657,0.4987353915925343
89226,0.5073891625615764,0.5348837209302326,-103,-115,0.4859403596076043,0.5140596403923957,home,COL,under,12,0.5192307692307692,-108,0.4987353915925343,COL,MIL,2023 REG,10,7,5,1,8,15,1,0,6,-6,1,0,0,0,0,0,0,0,0,0.5012646084074657,0.4987353915925343
89227,0.4608294930875576,0.5780590717299579,117,-137,0.44290849547579936,0.5570915045242006,away,CHC,over,9,0.5454545454545454,-120,0.5206611570247933,NYM,CHC,2023 REG,6,2,8,3,5,14,0,1,-1,1,1,1,0,0,0,0,0,0,0,0.5206611570247933,0.4793388429752067
89227,0.4608294930875576,0.5780590717299579,117,-137,0.44290849547579936,0.5570915045242006,home,NYM,under,9,0.5,100,0.4793388429752067,NYM,CHC,2023 REG,6,2,8,3,5,14,0,1,-1,1,1,1,0,0,0,0,0,0,0,0.5206611570247933,0.4793388429752067
89228,0.6124031007751938,0.425531914893617,-158,135,0.5891715795516586,0.41082842044834145,away,DET,over,8.5,0.5475113122171946,-121,0.5228602997583487,MIA,DET,2023 REG,7,0,8,5,5,15,0,1,-5,5,0,0,0,0,0,0,0,0,0,0.5228602997583487,0.4771397002416513
89228,0.6124031007751938,0.425531914893617,-158,135,0.5891715795516586,0.41082842044834145,home,MIA,under,8.5,0.49751243781094534,101,0.4771397002416513,MIA,DET,2023 REG,7,0,8,5,5,15,0,1,-5,5,0,0,0,0,0,0,0,0,0,0.5228602997583487,0.4771397002416513
89230,0.7354497354497355,0.3076923076923077,-278,225,0.7037209312341587,0.2962790687658413,away,OAK,over,7.5,0.5327102803738317,-114,0.5075272610403079,TB,OAK,2023 REG,10,9,12,5,14,22,1,0,4,-4,1,1,1,1,1,0,0,0,0,0.5075272610403079,0.4924727389596921
89230,0.7354497354497355,0.3076923076923077,-278,225,0.7037209312341587,0.2962790687658413,home,TB,under,7.5,0.5145631067961165,-106,0.4924727389596921,TB,OAK,2023 REG,10,9,12,5,14,22,1,0,4,-4,1,1,1,1,1,0,0,0,0,0.5075272610403079,0.4924727389596921
89231,0.4444444444444444,0.5918367346938775,125,-145,0.42831947593852354,0.5716805240614764,away,BAL,over,9,0.5,100,0.4772727272727273,WSH,BAL,2023 REG,5,0,5,1,1,10,0,1,-1,1,0,0,0,0,0,0,0,0,0,0.4772727272727273,0.5227272727272727
89231,0.4444444444444444,0.5918367346938775,125,-145,0.42831947593852354,0.5716805240614764,home,WSH,under,9,0.5454545454545454,-120,0.5227272727272727,WSH,BAL,2023 REG,5,0,5,1,1,10,0,1,-1,1,0,0,0,0,0,0,0,0,0,0.4772727272727273,0.5227272727272727
89232,0.6363636363636364,0.4098360655737705,-175,144,0.6069638260398319,0.3930361739601681,away,CIN,over,7.5,0.5,100,0.4772727272727273,SF,CIN,2023 REG,4,1,11,4,5,15,0,1,-3,3,1,0,0,0,0,0,0,0,0,0.4772727272727273,0.5227272727272727
89232,0.6363636363636364,0.4098360655737705,-175,144,0.6069638260398319,0.3930361739601681,home,SF,under,7.5,0.5454545454545454,-120,0.5227272727272727,SF,CIN,2023 REG,4,1,11,4,5,15,0,1,-3,3,1,0,0,0,0,0,0,0,0,0.4772727272727273,0.5227272727272727
89233,0.5515695067264574,0.49019607843137253,-123,104,0.5285328835228112,0.47146711647718875,away,STL,over,9,0.5238095238095238,-110,0.4988662131519274,CHC,STL,2023 REG,6,2,10,7,9,16,0,1,-5,5,1,1,0,0,0,0,0,0,0,0.4988662131519274,0.5011337868480725
89233,0.5515695067264574,0.49019607843137253,-123,104,0.5285328835228112,0.47146711647718875,home,CHC,under,9,0.5238095238095238,-110,0.5011337868480725,CHC,STL,2023 REG,6,2,10,7,9,16,0,1,-5,5,1,1,0,0,0,0,0,0,0,0.4988662131519274,0.5011337868480725
89234,0.4854368932038835,0.5555555555555556,106,-125,0.465537646233282,0.534462353766718,away,BOS,over,8,0.5370370370370371,-116,0.5118817074154765,DET,BOS,2023 REG,9,1,7,4,5,16,0,1,-3,3,1,0,0,0,0,0,0,0,0,0.5118817074154765,0.48811829258452355
89234,0.4854368932038835,0.5555555555555556,106,-125,0.465537646233282,0.534462353766718,home,DET,under,8,0.5098039215686274,-104,0.48811829258452355,DET,BOS,2023 REG,9,1,7,4,5,16,0,1,-3,3,1,0,0,0,0,0,0,0,0,0.5118817074154765,0.48811829258452355
89235,0.7067448680351905,0.3367003367003367,-241,197,0.6760401925476184,0.3239598074523816,away,MIL,over,8,0.5412844036697247,-118,0.5162581740877563,LAD,MIL,2023 REG,10,7,3,1,8,13,1,0,6,-6,1,0,0,0,0,0,0,0,0,0.5162581740877563,0.4837418259122437
89235,0.7067448680351905,0.3367003367003367,-241,197,0.6760401925476184,0.3239598074523816,home,LAD,under,8,0.504950495049505,-102,0.4837418259122437,LAD,MIL,2023 REG,10,7,3,1,8,13,1,0,6,-6,1,0,0,0,0,0,0,0,0,0.5162581740877563,0.4837418259122437
89236,0.4366812227074236,0.6047430830039526,129,-153,0.41859200623957366,0.5814079937604264,away,BAL,over,8.5,0.5348837209302326,-115,0.5097020142727117,LAA,BAL,2023 REG,7,3,12,10,13,19,0,1,-7,7,1,1,1,0,0,0,0,0,0,0.5097020142727117,0.49029798572728833
89236,0.4366812227074236,0.6047430830039526,129,-153,0.41859200623957366,0.5814079937604264,home,LAA,under,8.5,0.5121951219512195,-105,0.49029798572728833,LAA,BAL,2023 REG,7,3,12,10,13,19,0,1,-7,7,1,1,1,0,0,0,0,0,0,0.5097020142727117,0.49029798572728833
89238,0.7014925373134329,0.3412969283276451,-235,193,0.6714760464905872,0.32852395350941277,away,PIT,over,8.5,0.5121951219512195,-105,0.48808156828023186,MIN,PIT,2023 REG,10,5,9,1,6,19,1,0,4,-4,1,0,0,0,0,0,0,0,0,0.48808156828023186,0.5119184317197681
89238,0.7014925373134329,0.3412969283276451,-235,193,0.6714760464905872,0.32852395350941277,home,MIN,under,8.5,0.5348837209302326,-115,0.5119184317197681,MIN,PIT,2023 REG,10,5,9,1,6,19,1,0,4,-4,1,0,0,0,0,0,0,0,0,0.48808156828023186,0.5119184317197681
89239,0.7311827956989247,0.3125,-272,220,0.69924268701584,0.30075731298416,away,COL,over,7.5,0.5283018867924528,-112,0.5031902949311281,MIA,COL,2023 REG,7,3,7,2,5,14,1,0,1,-1,1,1,0,0,0,0,0,0,0,0.5031902949311281,0.4968097050688719
89239,0.7311827956989247,0.3125,-272,220,0.69924268701584,0.30075731298416,home,MIA,under,7.5,0.5192307692307692,-108,0.4968097050688719,MIA,COL,2023 REG,7,3,7,2,5,14,1,0,1,-1,1,1,0,0,0,0,0,0,0,0.5031902949311281,0.4968097050688719
89240,0.5652173913043479,0.47619047619047616,-130,110,0.5418129444594474,0.4581870555405526,away,BOS,over,8.5,0.5412844036697247,-118,0.5175913212324037,HOU,BOS,2023 REG,8,7,10,3,10,18,1,0,4,-4,1,1,1,0,0,0,0,0,0,0.5175913212324037,0.4824086787675963
89240,0.5652173913043479,0.47619047619047616,-130,110,0.5418129444594474,0.4581870555405526,home,HOU,under,8.5,0.5024875621890548,-101,0.4824086787675963,HOU,BOS,2023 REG,8,7,10,3,10,18,1,0,4,-4,1,1,1,0,0,0,0,0,0,0.5175913212324037,0.4824086787675963
89242,0.6774193548387096,0.36363636363636365,-210,175,0.6496074165168858,0.3503925834831142,away,COL,over,8.5,0.5098039215686274,-104,0.48592421718142587,MIL,COL,2023 REG,9,3,6,7,10,15,0,1,-4,4,1,1,1,0,0,0,0,0,0,0.48592421718142587,0.5140757828185741
89242,0.6774193548387096,0.36363636363636365,-210,175,0.6496074165168858,0.3503925834831142,home,MIL,under,8.5,0.5370370370370371,-116,0.5140757828185741,MIL,COL,2023 REG,9,3,6,7,10,15,0,1,-4,4,1,1,1,0,0,0,0,0,0,0.48592421718142587,0.5140757828185741
89243,0.574468085106383,0.46511627906976744,-135,115,0.5517281312179562,0.44827186878204384,away,KC,over,9,0.5238095238095238,-110,0.4988662131519274,CWS,KC,2023 REG,5,2,1,0,2,6,1,0,2,-2,0,0,0,0,0,0,0,0,0,0.4988662131519274,0.5011337868480725
89243,0.574468085106383,0.46511627906976744,-135,115,0.5517281312179562,0.44827186878204384,home,CWS,under,9,0.5238095238095238,-110,0.5011337868480725,CWS,KC,2023 REG,5,2,1,0,2,6,1,0,2,-2,0,0,0,0,0,0,0,0,0,0.4988662131519274,0.5011337868480725
89246,0.6835443037974683,0.35714285714285715,-216,180,0.655732826699018,0.344267173300982,away,CWS,over,9,0.5348837209302326,-115,0.5097020142727117,BOS,CWS,2023 REG,7,3,7,2,5,14,1,0,1,-1,1,1,0,0,0,0,0,0,0,0.5097020142727117,0.49029798572728833
89246,0.6835443037974683,0.35714285714285715,-216,180,0.655732826699018,0.344267173300982,home,BOS,under,9,0.5121951219512195,-105,0.49029798572728833,BOS,CWS,2023 REG,7,3,7,2,5,14,1,0,1,-1,1,1,0,0,0,0,0,0,0,0.5097020142727117,0.49029798572728833
89247,0.5652173913043479,0.4739336492890995,-130,111,0.5430885422732689,0.45691145772673114,away,CIN,over,9.5,0.5024875621890548,-101,0.47839724939301687,MIL,CIN,2023 REG,9,5,13,8,13,22,0,1,-3,3,1,1,1,1,1,0,0,0,0,0.47839724939301687,0.5216027506069831
89247,0.5652173913043479,0.4739336492890995,-130,111,0.5430885422732689,0.45691145772673114,home,MIL,under,9.5,0.5454545454545454,-120,0.5216027506069831,MIL,CIN,2023 REG,9,5,13,8,13,22,0,1,-3,3,1,1,1,1,1,0,0,0,0,0.47839724939301687,0.5216027506069831
89248,0.5,0.5391705069124424,100,-117,0.4804147465437788,0.5195852534562212,away,SEA,over,8.5,0.5238095238095238,-110,0.4988662131519274,LAA,SEA,2023 REG,11,7,14,9,16,25,0,1,-2,2,1,1,1,1,1,1,1,0,0,0.4988662131519274,0.5011337868480725
89248,0.5,0.5391705069124424,100,-117,0.4804147465437788,0.5195852534562212,home,LAA,under,8.5,0.5238095238095238,-110,0.5011337868480725,LAA,SEA,2023 REG,11,7,14,9,16,25,0,1,-2,2,1,1,1,1,1,1,1,0,0,0.4988662131519274,0.5011337868480725
89249,0.6062992125984252,0.4347826086956522,-154,130,0.581391336695717,0.41860866330428304,away,CLE,over,8,0.5121951219512195,-105,0.48808156828023186,MIN,CLE,2023 REG,4,2,7,5,7,11,0,1,-3,3,1,1,0,0,0,0,0,0,0,0.48808156828023186,0.5119184317197681
89249,0.6062992125984252,0.4347826086956522,-154,130,0.581391336695717,0.41860866330428304,home,MIN,under,8,0.5348837209302326,-115,0.5119184317197681,MIN,CLE,2023 REG,4,2,7,5,7,11,0,1,-3,3,1,1,0,0,0,0,0,0,0,0.48808156828023186,0.5119184317197681
89251,0.35714285714285715,0.6875,180,-220,0.3411989795918367,0.6588010204081634,away,BAL,over,8.5,0.5215311004784688,-109,0.4978845547971712,OAK,BAL,2023 REG,12,4,16,9,13,28,0,1,-5,5,1,1,1,1,0,0,0,0,0,0.4978845547971712,0.5021154452028288
89251,0.35714285714285715,0.6875,180,-220,0.3411989795918367,0.6588010204081634,home,OAK,under,8.5,0.5238095238095238,-110,0.5021154452028288,OAK,BAL,2023 REG,12,4,16,9,13,28,0,1,-5,5,1,1,1,1,0,0,0,0,0,0.4978845547971712,0.5021154452028288
89252,0.4347826086956522,0.6031746031746031,130,-152,0.418279473099889,0.581720526900111,away,ARI,over,8,0.5145631067961165,-106,0.4913668392989033,TEX,ARI,2023 REG,10,6,9,4,10,19,1,0,2,-2,1,1,1,1,0,0,0,0,0,0.4913668392989033,0.5086331607010968
89252,0.4347826086956522,0.6031746031746031,130,-152,0.418279473099889,0.581720526900111,home,TEX,under,8,0.5305164319248826,-113,0.5086331607010968,TEX,ARI,2023 REG,10,6,9,4,10,19,1,0,2,-2,1,1,1,1,0,0,0,0,0,0.4913668392989033,0.5086331607010968
89253,0.5515695067264574,0.48780487804878053,-123,105,0.5298517967383217,0.4701482032616783,away,MIA,over,8,0.5145631067961165,-106,0.49023796582517226,CWS,MIA,2023 REG,11,2,4,1,3,15,1,0,1,-1,1,0,0,0,0,0,0,0,0,0.49023796582517226,0.5097620341748277
89253,0.5515695067264574,0.48780487804878053,-123,105,0.5298517967383217,0.4701482032616783,home,CWS,under,8,0.5327102803738317,-114,0.5097620341748277,CWS,MIA,2023 REG,11,2,4,1,3,15,1,0,1,-1,1,0,0,0,0,0,0,0,0,0.49023796582517226,0.5097620341748277
89254,0.6254681647940076,0.41152263374485604,-167,143,0.6023315979176397,0.3976684020823603,away,BOS,over,8,0.5121951219512195,-105,0.48808156828023186,TB,BOS,2023 REG,8,3,5,1,4,13,1,0,2,-2,1,0,0,0,0,0,0,0,0,0.48808156828023186,0.5119184317197681
89254,0.6254681647940076,0.41152263374485604,-167,143,0.6023315979176397,0.3976684020823603,home,TB,under,8,0.5348837209302326,-115,0.5119184317197681,TB,BOS,2023 REG,8,3,5,1,4,13,1,0,2,-2,1,0,0,0,0,0,0,0,0,0.48808156828023186,0.5119184317197681
89255,0.6721311475409836,0.36363636363636365,-205,175,0.6480906892086682,0.3519093107913318,away,MIA,over,8.5,0.5495495495495495,-122,0.5250401592387142,PHI,MIA,2023 REG,8,2,8,3,5,16,0,1,-1,1,1,1,0,0,0,0,0,0,0,0.5250401592387142,0.47495984076128583
89255,0.6721311475409836,0.36363636363636365,-205,175,0.6480906892086682,0.3519093107913318,home,PHI,under,8.5,0.49504950495049505,102,0.47495984076128583,PHI,MIA,2023 REG,8,2,8,3,5,16,0,1,-1,1,1,1,0,0,0,0,0,0,0,0.5250401592387142,0.47495984076128583
89256,0.6108949416342413,0.42372881355932196,-157,136,0.5897434647261112,0.41025653527388883,away,STL,over,9,0.5283018867924528,-112,0.5031902949311281,MIL,STL,2023 REG,11,6,6,1,7,17,1,0,5,-5,1,0,0,0,0,0,0,0,0,0.5031902949311281,0.4968097050688719
89256,0.6108949416342413,0.42372881355932196,-157,136,0.5897434647261112,0.41025653527388883,home,MIL,under,9,0.5192307692307692,-108,0.4968097050688719,MIL,STL,2023 REG,11,6,6,1,7,17,1,0,5,-5,1,0,0,0,0,0,0,0,0,0.5031902949311281,0.4968097050688719
89257,0.44052863436123346,0.5967741935483871,127,-148,0.42409567052439623,0.5759043294756038,away,PHI,over,9,0.5024875621890548,-101,0.4794401874631478,PIT,PHI,2023 REG,9,6,8,4,10,17,1,0,2,-2,1,1,1,1,0,0,0,0,0,0.4794401874631478,0.5205598125368522
89257,0.44052863436123346,0.5967741935483871,127,-148,0.42409567052439623,0.5759043294756038,home,PIT,under,9,0.5433789954337899,-119,0.5205598125368522,PIT,PHI,2023 REG,9,6,8,4,10,17,1,0,2,-2,1,1,1,1,0,0,0,0,0,0.4794401874631478,0.5205598125368522
89259,0.47619047619047616,0.5652173913043479,110,-130,0.4564724440500838,0.5435275559499162,away,MIN,over,8.5,0.5121951219512195,-105,0.48808156828023186,CLE,MIN,2023 REG,5,2,2,1,3,7,1,0,1,-1,1,0,0,0,0,0,0,0,0,0.48808156828023186,0.5119184317197681
89259,0.47619047619047616,0.5652173913043479,110,-130,0.4564724440500838,0.5435275559499162,home,CLE,under,8.5,0.5348837209302326,-115,0.5119184317197681,CLE,MIN,2023 REG,5,2,2,1,3,7,1,0,1,-1,1,0,0,0,0,0,0,0,0,0.48808156828023186,0.5119184317197681
89261,0.7590361445783133,0.2840909090909091,-315,252,0.7263011520342048,0.27369884796579524,away,KC,over,8,0.5348837209302326,-115,0.5097020142727117,TOR,KC,2023 REG,8,5,2,1,6,10,1,0,4,-4,1,0,0,0,0,0,0,0,0,0.5097020142727117,0.49029798572728833
89261,0.7590361445783133,0.2840909090909091,-315,252,0.7263011520342048,0.27369884796579524,home,TOR,under,8,0.5121951219512195,-105,0.49029798572728833,TOR,KC,2023 REG,8,5,2,1,6,10,1,0,4,-4,1,0,0,0,0,0,0,0,0,0.5097020142727117,0.49029798572728833
89263,0.5283018867924528,0.5121951219512195,-112,-105,0.5069072406637203,0.4930927593362797,away,ARI,over,8.5,0.5454545454545454,-120,0.5206611570247933,SD,ARI,2023 REG,7,4,9,6,10,16,0,1,-2,2,1,1,1,1,0,0,0,0,0,0.5206611570247933,0.4793388429752067
89263,0.5283018867924528,0.5121951219512195,-112,-105,0.5069072406637203,0.4930927593362797,home,SD,under,8.5,0.5,100,0.4793388429752067,SD,ARI,2023 REG,7,4,9,6,10,16,0,1,-2,2,1,1,1,1,0,0,0,0,0,0.5206611570247933,0.4793388429752067
89266,0.3333333333333333,0.7076023391812866,200,-242,0.31968810916179335,0.6803118908382066,away,ATL,over,12.5,0.5098039215686274,-104,0.48592421718142587,COL,ATL,2023 REG,9,4,18,14,18,27,0,1,-10,10,1,1,1,1,0,0,0,0,0,0.48592421718142587,0.5140757828185741
89266,0.3333333333333333,0.7076023391812866,200,-242,0.31968810916179335,0.6803118908382066,home,COL,under,12.5,0.5370370370370371,-116,0.5140757828185741,COL,ATL,2023 REG,9,4,18,14,18,27,0,1,-10,10,1,1,1,1,0,0,0,0,0,0.48592421718142587,0.5140757828185741
89267,0.5145631067961165,0.5238095238095238,-106,-110,0.4948179667757384,0.5051820332242616,away,LAD,over,8,0.5145631067961165,-106,0.49023796582517226,SD,LAD,2023 REG,9,2,6,5,7,15,0,1,-3,3,1,1,0,0,0,0,0,0,0,0.49023796582517226,0.5097620341748277
89267,0.5145631067961165,0.5238095238095238,-106,-110,0.4948179667757384,0.5051820332242616,home,SD,under,8,0.5327102803738317,-114,0.5097620341748277,SD,LAD,2023 REG,9,2,6,5,7,15,0,1,-3,3,1,1,0,0,0,0,0,0,0,0.49023796582517226,0.5097620341748277
89268,0.35460992907801414,0.6875,182,-220,0.3396773301141794,0.6603226698858207,away,SD,over,9,0.5,100,0.4772727272727273,DET,SD,2023 REG,8,3,3,1,4,11,1,0,2,-2,1,0,0,0,0,0,0,0,0,0.4772727272727273,0.5227272727272727
89268,0.35460992907801414,0.6875,182,-220,0.3396773301141794,0.6603226698858207,home,DET,under,9,0.5454545454545454,-120,0.5227272727272727,DET,SD,2023 REG,8,3,3,1,4,11,1,0,2,-2,1,0,0,0,0,0,0,0,0,0.4772727272727273,0.5227272727272727
89270,0.5652173913043479,0.47619047619047616,-130,110,0.5418129444594474,0.4581870555405526,away,BOS,over,8.5,0.5327102803738317,-114,0.508788710910954,MIL,BOS,2023 REG,9,5,8,4,9,17,1,0,1,-1,1,1,1,1,0,0,0,0,0,0.508788710910954,0.491211289089046
89270,0.5652173913043479,0.47619047619047616,-130,110,0.5418129444594474,0.4581870555405526,home,MIL,under,8.5,0.5121951219512195,-105,0.491211289089046,MIL,BOS,2023 REG,9,5,8,4,9,17,1,0,1,-1,1,1,1,1,0,0,0,0,0,0.508788710910954,0.491211289089046
89271,0.6666666666666666,0.36363636363636365,-200,175,0.6464646464646464,0.3535353535353536,away,COL,over,8.5,0.5348837209302326,-115,0.5097020142727117,NYM,COL,2023 REG,9,6,14,13,19,23,0,1,-7,7,1,1,1,1,1,1,0,0,0,0.5097020142727117,0.49029798572728833
89271,0.6666666666666666,0.36363636363636365,-200,175,0.6464646464646464,0.3535353535353536,home,NYM,under,8.5,0.5121951219512195,-105,0.49029798572728833,NYM,COL,2023 REG,9,6,14,13,19,23,0,1,-7,7,1,1,1,1,1,1,0,0,0,0.5097020142727117,0.49029798572728833
89272,0.609375,0.425531914893617,-156,135,0.5881035987367021,0.41189640126329785,away,BAL,over,9.5,0.5,100,0.47935779816513757,BOS,BAL,2023 REG,11,9,13,8,17,24,1,0,1,-1,1,1,1,1,1,1,1,1,0,0.47935779816513757,0.5206422018348624
89272,0.609375,0.425531914893617,-156,135,0.5881035987367021,0.41189640126329785,home,BOS,under,9.5,0.5412844036697247,-118,0.5206422018348624,BOS,BAL,2023 REG,11,9,13,8,17,24,1,0,1,-1,1,1,1,1,1,1,1,1,0,0.47935779816513757,0.5206422018348624
89273,0.5348837209302326,0.5098039215686274,-115,-104,0.5109810284308424,0.48901897156915763,away,BAL,over,7,0.5412844036697247,-118,0.5136310900085983,CLE,BAL,2023 REG,5,1,7,5,6,12,0,1,-4,4,1,0,0,0,0,0,0,0,0,0.5136310900085983,0.4863689099914017
89273,0.5348837209302326,0.5098039215686274,-115,-104,0.5109810284308424,0.48901897156915763,home,CLE,under,7,0.5098039215686274,-104,0.4863689099914017,CLE,BAL,2023 REG,5,1,7,5,6,12,0,1,-4,4,1,0,0,0,0,0,0,0,0,0.5136310900085983,0.4863689099914017
89275,0.6621621621621622,0.37735849056603776,-196,165,0.6359930813015974,0.3640069186984026,away,COL,over,9.5,0.5412844036697247,-118,0.5149381613977361,STL,COL,2023 REG,14,4,15,9,13,29,0,1,-5,5,1,1,1,1,0,0,0,0,0,0.5149381613977361,0.48506183860226393
89275,0.6621621621621622,0.37735849056603776,-196,165,0.6359930813015974,0.3640069186984026,home,STL,under,9.5,0.5073891625615764,-103,0.48506183860226393,STL,COL,2023 REG,14,4,15,9,13,29,0,1,-5,5,1,1,1,1,0,0,0,0,0,0.5149381613977361,0.48506183860226393
89276,0.46511627906976744,0.576271186440678,115,-136,0.44586629511142073,0.5541337048885793,away,SEA,over,8.5,0.5073891625615764,-103,0.4826927225525911,HOU,SEA,2023 REG,3,1,6,3,4,9,0,1,-2,2,1,0,0,0,0,0,0,0,0,0.4826927225525911,0.5173072774474089
89276,0.46511627906976744,0.576271186440678,115,-136,0.44586629511142073,0.5541337048885793,home,HOU,under,8.5,0.5412844036697247,-118,0.5173072774474089,HOU,SEA,2023 REG,3,1,6,3,4,9,0,1,-2,2,1,0,0,0,0,0,0,0,0,0.4826927225525911,0.5173072774474089
89277,0.4065040650406504,0.6296296296296295,146,-170,0.3918155712722439,0.608184428727756,away,SD,over,8.5,0.5327102803738317,-114,0.508788710910954,CHC,SD,2023 REG,9,5,6,2,7,15,1,0,3,-3,1,1,0,0,0,0,0,0,0,0.508788710910954,0.491211289089046
89277,0.4065040650406504,0.6296296296296295,146,-170,0.3918155712722439,0.608184428727756,home,CHC,under,8.5,0.5121951219512195,-105,0.491211289089046,CHC,SD,2023 REG,9,5,6,2,7,15,1,0,3,-3,1,1,0,0,0,0,0,0,0,0.508788710910954,0.491211289089046
89279,0.6825396825396826,0.35714285714285715,-215,180,0.6554547745023935,0.34454522549760647,away,WSH,over,8.5,0.5433789954337899,-119,0.5171177654451503,PHI,WSH,2023 REG,18,19,10,4,23,28,1,0,15,-15,1,1,1,1,0,0,0,0,0,0.5171177654451503,0.4828822345548497
89279,0.6825396825396826,0.35714285714285715,-215,180,0.6554547745023935,0.34454522549760647,home,PHI,under,8.5,0.504950495049505,-102,0.4828822345548497,PHI,WSH,2023 REG,18,19,10,4,23,28,1,0,15,-15,1,1,1,1,0,0,0,0,0,0.5171177654451503,0.4828822345548497
89280,0.5726495726495727,0.4716981132075471,-134,112,0.5472538892954956,0.45274611070450443,away,MIA,over,7.5,0.5348837209302326,-115,0.5097020142727117,SF,MIA,2023 REG,9,7,13,5,12,22,1,0,2,-2,1,1,1,1,1,0,0,0,0,0.5097020142727117,0.49029798572728833
89280,0.5726495726495727,0.4716981132075471,-134,112,0.5472538892954956,0.45274611070450443,home,SF,under,7.5,0.5121951219512195,-105,0.49029798572728833,SF,MIA,2023 REG,9,7,13,5,12,22,1,0,2,-2,1,1,1,1,1,0,0,0,0,0.5097020142727117,0.49029798572728833
89282,0.6183206106870228,0.42372881355932196,-162,136,0.5923205850079852,0.40767941499201477,away,CWS,over,10,0.5348837209302326,-115,0.5097020142727117,KC,CWS,2023 REG,16,12,3,1,13,19,1,0,11,-11,1,0,0,0,0,0,0,0,0,0.5097020142727117,0.49029798572728833
89282,0.6183206106870228,0.42372881355932196,-162,136,0.5923205850079852,0.40767941499201477,home,KC,under,10,0.5121951219512195,-105,0.49029798572728833,KC,CWS,2023 REG,16,12,3,1,13,19,1,0,11,-11,1,0,0,0,0,0,0,0,0,0.5097020142727117,0.49029798572728833
89283,0.5073891625615764,0.5370370370370371,-103,-116,0.48484779035144243,0.5151522096485576,away,ARI,over,8.5,0.5121951219512195,-105,0.48808156828023186,NYY,ARI,2023 REG,12,7,5,1,8,17,1,0,6,-6,1,0,0,0,0,0,0,0,0,0.48808156828023186,0.5119184317197681
89283,0.5073891625615764,0.5370370370370371,-103,-116,0.48484779035144243,0.5151522096485576,home,NYY,under,8.5,0.5348837209302326,-115,0.5119184317197681,NYY,ARI,2023 REG,12,7,5,1,8,17,1,0,6,-6,1,0,0,0,0,0,0,0,0,0.48808156828023186,0.5119184317197681
89285,0.5867768595041323,0.45248868778280543,-142,121,0.563736744980392,0.43626325501960805,away,PIT,over,8.5,0.5327102803738317,-114,0.508788710910954,SEA,PIT,2023 REG,7,6,7,3,9,14,1,0,3,-3,1,1,1,0,0,0,0,0,0,0.508788710910954,0.491211289089046
89285,0.5867768595041323,0.45248868778280543,-142,121,0.563736744980392,0.43626325501960805,home,SEA,under,8.5,0.5121951219512195,-105,0.491211289089046,SEA,PIT,2023 REG,7,6,7,3,9,14,1,0,3,-3,1,1,1,0,0,0,0,0,0,0.508788710910954,0.491211289089046
89288,0.574468085106383,0.46511627906976744,-135,115,0.5517281312179562,0.44827186878204384,away,CLE,over,7,0.5454545454545454,-120,0.5206611570247933,SEA,CLE,2023 REG,3,0,5,2,2,8,0,1,-2,2,0,0,0,0,0,0,0,0,0,0.5206611570247933,0.4793388429752067
89288,0.574468085106383,0.46511627906976744,-135,115,0.5517281312179562,0.44827186878204384,home,SEA,under,7,0.5,100,0.4793388429752067,SEA,CLE,2023 REG,3,0,5,2,2,8,0,1,-2,2,0,0,0,0,0,0,0,0,0,0.5206611570247933,0.4793388429752067
89291,0.5327102803738317,0.5121951219512195,-114,-105,0.508788710910954,0.491211289089046,away,DET,over,11.5,0.5327102803738317,-114,0.5075272610403079,COL,DET,2023 REG,6,2,9,4,6,15,0,1,-2,2,1,1,0,0,0,0,0,0,0,0.5075272610403079,0.4924727389596921
89291,0.5327102803738317,0.5121951219512195,-114,-105,0.508788710910954,0.491211289089046,home,COL,under,11.5,0.5145631067961165,-106,0.4924727389596921,COL,DET,2023 REG,6,2,9,4,6,15,0,1,-2,2,1,1,0,0,0,0,0,0,0,0.5075272610403079,0.4924727389596921
89292,0.30303030303030304,0.7361477572559366,230,-279,0.2911581635496243,0.7088418364503757,away,ATL,over,12,0.5348837209302326,-115,0.5097020142727117,COL,ATL,2023 REG,3,1,15,3,4,18,0,1,-2,2,1,0,0,0,0,0,0,0,0,0.5097020142727117,0.49029798572728833
89292,0.30303030303030304,0.7361477572559366,230,-279,0.2911581635496243,0.7088418364503757,home,COL,under,12,0.5121951219512195,-105,0.49029798572728833,COL,ATL,2023 REG,3,1,15,3,4,18,0,1,-2,2,1,0,0,0,0,0,0,0,0,0.5097020142727117,0.49029798572728833
89294,0.45454545454545453,0.5833333333333333,120,-140,0.43732782369146006,0.5626721763085399,away,PHI,over,7.5,0.49504950495049505,102,0.47297076509898783,MIA,PHI,2023 REG,9,3,11,4,7,20,0,1,-1,1,1,1,1,0,0,0,0,0,0,0.47297076509898783,0.5270292349010122
89294,0.45454545454545453,0.5833333333333333,120,-140,0.43732782369146006,0.5626721763085399,home,MIA,under,7.5,0.5495495495495495,-122,0.5270292349010122,MIA,PHI,2023 REG,9,3,11,4,7,20,0,1,-1,1,1,1,1,0,0,0,0,0,0,0.47297076509898783,0.5270292349010122
89295,0.4347826086956522,0.6031746031746031,130,-152,0.418279473099889,0.581720526900111,away,SD,over,9.5,0.5238095238095238,-110,0.4988662131519274,PIT,SD,2023 REG,16,9,11,4,13,27,1,0,5,-5,1,1,1,1,0,0,0,0,0,0.4988662131519274,0.5011337868480725
89295,0.4347826086956522,0.6031746031746031,130,-152,0.418279473099889,0.581720526900111,home,PIT,under,9.5,0.5238095238095238,-110,0.5011337868480725,PIT,SD,2023 REG,16,9,11,4,13,27,1,0,5,-5,1,1,1,1,0,0,0,0,0,0.4988662131519274,0.5011337868480725
89296,0.6721311475409836,0.37037037037037035,-205,170,0.6435645535349916,0.35643544646500835,away,BOS,over,8,0.5145631067961165,-106,0.49023796582517226,TOR,BOS,2023 REG,6,4,12,5,9,18,0,1,-1,1,1,1,1,1,0,0,0,0,0,0.49023796582517226,0.5097620341748277
89296,0.6721311475409836,0.37037037037037035,-205,170,0.6435645535349916,0.35643544646500835,home,TOR,under,8,0.5327102803738317,-114,0.5097620341748277,TOR,BOS,2023 REG,6,4,12,5,9,18,0,1,-1,1,1,1,1,1,0,0,0,0,0,0.49023796582517226,0.5097620341748277
89297,0.49504950495049505,0.5454545454545454,102,-120,0.47499799484898986,0.5250020051510101,away,NYM,over,8,0.5192307692307692,-108,0.49688292476754015,MIA,NYM,2023 REG,4,1,5,5,6,9,0,1,-4,4,1,0,0,0,0,0,0,0,0,0.49688292476754015,0.5031170752324599
89297,0.49504950495049505,0.5454545454545454,102,-120,0.47499799484898986,0.5250020051510101,home,MIA,under,8,0.5238095238095238,-110,0.5031170752324599,MIA,NYM,2023 REG,4,1,5,5,6,9,0,1,-4,4,1,0,0,0,0,0,0,0,0,0.49688292476754015,0.5031170752324599
89298,0.5652173913043479,0.47619047619047616,-130,110,0.5418129444594474,0.4581870555405526,away,STL,over,7,0.5535714285714286,-124,0.5293429871948779,CHC,STL,2023 REG,5,1,6,3,4,11,0,1,-2,2,1,0,0,0,0,0,0,0,0,0.5293429871948779,0.47065701280512207
89298,0.5652173913043479,0.47619047619047616,-130,110,0.5418129444594474,0.4581870555405526,home,CHC,under,7,0.49019607843137253,104,0.47065701280512207,CHC,STL,2023 REG,5,1,6,3,4,11,0,1,-2,2,1,0,0,0,0,0,0,0,0,0.5293429871948779,0.47065701280512207
89300,0.4716981132075471,0.574468085106383,112,-135,0.44992160456890085,0.5500783954310992,away,ATL,over,7.5,0.5348837209302326,-115,0.5097020142727117,NYM,ATL,2023 REG,3,0,5,4,4,8,0,1,-4,4,0,0,0,0,0,0,0,0,0,0.5097020142727117,0.49029798572728833
89300,0.4716981132075471,0.574468085106383,112,-135,0.44992160456890085,0.5500783954310992,home,NYM,under,7.5,0.5121951219512195,-105,0.49029798572728833,NYM,ATL,2023 REG,3,0,5,4,4,8,0,1,-4,4,0,0,0,0,0,0,0,0,0,0.5097020142727117,0.49029798572728833
89301,0.43103448275862066,0.607843137254902,132,-155,0.4142768879252058,0.5857231120747942,away,ATL,over,8.5,0.5260663507109005,-111,0.5010269332605688,TOR,ATL,2023 REG,6,3,2,0,3,8,1,0,3,-3,0,0,0,0,0,0,0,0,0,0.5010269332605688,0.4989730667394312
89301,0.43103448275862066,0.607843137254902,132,-155,0.4142768879252058,0.5857231120747942,home,TOR,under,8.5,0.5215311004784688,-109,0.4989730667394312,TOR,ATL,2023 REG,6,3,2,0,3,8,1,0,3,-3,0,0,0,0,0,0,0,0,0,0.5010269332605688,0.4989730667394312
89303,0.4347826086956522,0.6047430830039526,130,-153,0.4175975253479979,0.5824024746520021,away,ARI,over,9.5,0.5145631067961165,-106,0.4913668392989033,OAK,ARI,2023 REG,5,3,6,5,8,11,0,1,-2,2,1,1,1,0,0,0,0,0,0,0.4913668392989033,0.5086331607010968
89303,0.4347826086956522,0.6047430830039526,130,-153,0.4175975253479979,0.5824024746520021,home,OAK,under,9.5,0.5305164319248826,-113,0.5086331607010968,OAK,ARI,2023 REG,5,3,6,5,8,11,0,1,-2,2,1,1,1,0,0,0,0,0,0,0.4913668392989033,0.5086331607010968
89304,0.5798319327731092,0.4608294930875576,-138,117,0.5562551396270082,0.44374486037299177,away,LAA,over,9.5,0.49504950495049505,102,0.47297076509898783,PHI,LAA,2023 REG,7,6,11,4,10,18,1,0,2,-2,1,1,1,1,0,0,0,0,0,0.47297076509898783,0.5270292349010122
89304,0.5798319327731092,0.4608294930875576,-138,117,0.5562551396270082,0.44374486037299177,home,PHI,under,9.5,0.5495495495495495,-122,0.5270292349010122,PHI,LAA,2023 REG,7,6,11,4,10,18,1,0,2,-2,1,1,1,1,0,0,0,0,0,0.47297076509898783,0.5270292349010122
89305,0.48309178743961345,0.5555555555555556,107,-125,0.4644215734322854,0.5355784265677146,away,LAA,over,7.5,0.5238095238095238,-110,0.4988662131519274,STL,LAA,2023 REG,7,4,13,6,10,20,0,1,-2,2,1,1,1,1,0,0,0,0,0,0.4988662131519274,0.5011337868480725
89305,0.48309178743961345,0.5555555555555556,107,-125,0.4644215734322854,0.5355784265677146,home,STL,under,7.5,0.5238095238095238,-110,0.5011337868480725,STL,LAA,2023 REG,7,4,13,6,10,20,0,1,-2,2,1,1,1,1,0,0,0,0,0,0.4988662131519274,0.5011337868480725
89307,0.5283018867924528,0.5145631067961165,-112,-106,0.5056562298022652,0.4943437701977348,away,TB,over,9.5,0.5454545454545454,-120,0.5193043049216726,LAA,TB,2023 REG,9,6,15,9,15,24,0,1,-3,3,1,1,1,1,1,1,0,0,0,0.5193043049216726,0.48069569507832743
89307,0.5283018867924528,0.5145631067961165,-112,-106,0.5056562298022652,0.4943437701977348,home,LAA,under,9.5,0.5024875621890548,-101,0.48069569507832743,LAA,TB,2023 REG,9,6,15,9,15,24,0,1,-3,3,1,1,1,1,1,1,0,0,0,0.5193043049216726,0.48069569507832743
89308,0.6240601503759399,0.4166666666666667,-166,140,0.5986441668079975,0.4013558331920025,away,ARI,over,8.5,0.5495495495495495,-122,0.5236866555946829,SD,ARI,2023 REG,4,4,6,0,4,10,1,0,4,-4,0,0,0,0,0,0,0,0,0,0.5236866555946829,0.47631334440531714
89308,0.6240601503759399,0.4166666666666667,-166,140,0.5986441668079975,0.4013558331920025,home,SD,under,8.5,0.49751243781094534,101,0.47631334440531714,SD,ARI,2023 REG,4,4,6,0,4,10,1,0,4,-4,0,0,0,0,0,0,0,0,0,0.5236866555946829,0.47631334440531714
89309,0.48780487804878053,0.5555555555555556,105,-125,0.4666534470222751,0.5333465529777248,away,LAA,over,8,0.5121951219512195,-105,0.48808156828023186,OAK,LAA,2023 REG,5,2,6,1,3,11,1,0,1,-1,1,0,0,0,0,0,0,0,0,0.48808156828023186,0.5119184317197681
89309,0.48780487804878053,0.5555555555555556,105,-125,0.4666534470222751,0.5333465529777248,home,OAK,under,8,0.5348837209302326,-115,0.5119184317197681,OAK,LAA,2023 REG,5,2,6,1,3,11,1,0,1,-1,1,0,0,0,0,0,0,0,0,0.48808156828023186,0.5119184317197681
89310,0.7435897435897436,0.29850746268656714,-290,235,0.7122866927688971,0.2877133072311029,away,CIN,over,8,0.5073891625615764,-103,0.4826927225525911,ATL,CIN,2023 REG,9,5,6,4,9,15,1,0,1,-1,1,1,1,1,0,0,0,0,0,0.4826927225525911,0.5173072774474089
89310,0.7435897435897436,0.29850746268656714,-290,235,0.7122866927688971,0.2877133072311029,home,ATL,under,8,0.5412844036697247,-118,0.5173072774474089,ATL,CIN,2023 REG,9,5,6,4,9,15,1,0,1,-1,1,1,1,1,0,0,0,0,0,0.4826927225525911,0.5173072774474089
89312,0.6363636363636364,0.40322580645161293,-175,148,0.6111703545721141,0.3888296454278859,away,MIA,over,8.5,0.5121951219512195,-105,0.48808156828023186,STL,MIA,2023 REG,6,5,11,2,7,17,1,0,3,-3,1,1,0,0,0,0,0,0,0,0.48808156828023186,0.5119184317197681
89312,0.6363636363636364,0.40322580645161293,-175,148,0.6111703545721141,0.3888296454278859,home,STL,under,8.5,0.5348837209302326,-115,0.5119184317197681,STL,MIA,2023 REG,6,5,11,2,7,17,1,0,3,-3,1,1,0,0,0,0,0,0,0,0.48808156828023186,0.5119184317197681
89313,0.4166666666666667,0.6226415094339623,140,-165,0.4002882599580712,0.5997117400419287,away,ATL,over,9,0.5121951219512195,-105,0.48808156828023186,PHI,ATL,2023 REG,4,1,10,4,5,14,0,1,-3,3,1,0,0,0,0,0,0,0,0,0.48808156828023186,0.5119184317197681
89313,0.4166666666666667,0.6226415094339623,140,-165,0.4002882599580712,0.5997117400419287,home,PHI,under,9,0.5348837209302326,-115,0.5119184317197681,PHI,ATL,2023 REG,4,1,10,4,5,14,0,1,-3,3,1,0,0,0,0,0,0,0,0,0.48808156828023186,0.5119184317197681
89314,0.6721311475409836,0.36363636363636365,-205,175,0.6480906892086682,0.3519093107913318,away,COL,over,8,0.5238095238095238,-110,0.4988662131519274,SD,COL,2023 REG,4,3,4,1,4,8,1,0,2,-2,1,0,0,0,0,0,0,0,0,0.4988662131519274,0.5011337868480725
89314,0.6721311475409836,0.36363636363636365,-205,175,0.6480906892086682,0.3519093107913318,home,SD,under,8,0.5238095238095238,-110,0.5011337868480725,SD,COL,2023 REG,4,3,4,1,4,8,1,0,2,-2,1,0,0,0,0,0,0,0,0,0.4988662131519274,0.5011337868480725
89315,0.6774193548387096,0.36363636363636365,-210,175,0.6496074165168858,0.3503925834831142,away,CHC,over,8.5,0.5238095238095238,-110,0.4988662131519274,NYY,CHC,2023 REG,8,6,5,3,9,13,1,0,3,-3,1,1,1,0,0,0,0,0,0,0.4988662131519274,0.5011337868480725
89315,0.6774193548387096,0.36363636363636365,-210,175,0.6496074165168858,0.3503925834831142,home,NYY,under,8.5,0.5238095238095238,-110,0.5011337868480725,NYY,CHC,2023 REG,8,6,5,3,9,13,1,0,3,-3,1,1,1,0,0,0,0,0,0,0.4988662131519274,0.5011337868480725
89316,0.6376811594202898,0.4,-176,150,0.6136525939928585,0.38634740600714146,away,MIA,over,7.5,0.504950495049505,-102,0.48160416005266615,SD,MIA,2023 REG,3,0,8,3,3,11,0,1,-3,3,0,0,0,0,0,0,0,0,0,0.48160416005266615,0.5183958399473338
89316,0.6376811594202898,0.4,-176,150,0.6136525939928585,0.38634740600714146,home,SD,under,7.5,0.5412844036697247,-118,0.5183958399473338,SD,MIA,2023 REG,3,0,8,3,3,11,0,1,-3,3,0,0,0,0,0,0,0,0,0,0.48160416005266615,0.5183958399473338
89317,0.4694835680751174,0.5652173913043479,113,-130,0.4531920378500164,0.5468079621499836,away,LAD,over,10.5,0.5327102803738317,-114,0.508788710910954,PHI,LAD,2023 REG,13,7,5,3,10,18,1,0,4,-4,1,1,1,0,0,0,0,0,0,0.508788710910954,0.491211289089046
89317,0.4694835680751174,0.5652173913043479,113,-130,0.4531920378500164,0.5468079621499836,home,PHI,under,10.5,0.5121951219512195,-105,0.491211289089046,PHI,LAD,2023 REG,13,7,5,3,10,18,1,0,4,-4,1,1,1,0,0,0,0,0,0,0.508788710910954,0.491211289089046
89318,0.5454545454545454,0.5,-120,100,0.5206611570247933,0.4793388429752067,away,CLE,over,6.5,0.5348837209302326,-115,0.5097020142727117,SEA,CLE,2023 REG,7,3,4,0,3,11,1,0,3,-3,0,0,0,0,0,0,0,0,0,0.5097020142727117,0.49029798572728833
89318,0.5454545454545454,0.5,-120,100,0.5206611570247933,0.4793388429752067,home,SEA,under,6.5,0.5121951219512195,-105,0.49029798572728833,SEA,CLE,2023 REG,7,3,4,0,3,11,1,0,3,-3,0,0,0,0,0,0,0,0,0,0.5097020142727117,0.49029798572728833
89321,0.33783783783783783,0.7076023391812866,196,-242,0.32248642668272826,0.6775135733172717,away,ATL,over,13,0.5327102803738317,-114,0.5075272610403079,COL,ATL,2023 REG,5,3,12,7,10,17,0,1,-4,4,1,1,1,0,0,0,0,0,0,0.5075272610403079,0.4924727389596921
89321,0.33783783783783783,0.7076023391812866,196,-242,0.32248642668272826,0.6775135733172717,home,COL,under,13,0.5145631067961165,-106,0.4924727389596921,COL,ATL,2023 REG,5,3,12,7,10,17,0,1,-4,4,1,1,1,0,0,0,0,0,0,0.5075272610403079,0.4924727389596921
89323,0.47619047619047616,0.5652173913043479,110,-130,0.4564724440500838,0.5435275559499162,away,LAD,over,8.5,0.5283018867924528,-112,0.5031902949311281,CHC,LAD,2023 REG,5,4,11,9,13,16,0,1,-5,5,1,1,1,1,0,0,0,0,0,0.5031902949311281,0.4968097050688719
89323,0.47619047619047616,0.5652173913043479,110,-130,0.4564724440500838,0.5435275559499162,home,CHC,under,8.5,0.5192307692307692,-108,0.4968097050688719,CHC,LAD,2023 REG,5,4,11,9,13,16,0,1,-5,5,1,1,1,1,0,0,0,0,0,0.5031902949311281,0.4968097050688719
89325,0.5633187772925764,0.47619047619047616,-129,110,0.5410624729287608,0.45893752707123925,away,CIN,over,8,0.5192307692307692,-108,0.49455035168025013,CLE,CIN,2023 REG,11,4,8,3,7,19,1,0,1,-1,1,1,1,0,0,0,0,0,0,0.49455035168025013,0.5054496483197499
89325,0.5633187772925764,0.47619047619047616,-129,110,0.5410624729287608,0.45893752707123925,home,CLE,under,8,0.5283018867924528,-112,0.5054496483197499,CLE,CIN,2023 REG,11,4,8,3,7,19,1,0,1,-1,1,1,1,0,0,0,0,0,0,0.49455035168025013,0.5054496483197499
89327,0.6363636363636364,0.40322580645161293,-175,148,0.6111703545721141,0.3888296454278859,away,TEX,over,7.5,0.5348837209302326,-115,0.5097020142727117,SEA,TEX,2023 REG,4,1,4,2,3,8,0,1,-1,1,1,0,0,0,0,0,0,0,0,0.5097020142727117,0.49029798572728833
89327,0.6363636363636364,0.40322580645161293,-175,148,0.6111703545721141,0.3888296454278859,home,SEA,under,7.5,0.5121951219512195,-105,0.49029798572728833,SEA,TEX,2023 REG,4,1,4,2,3,8,0,1,-1,1,1,0,0,0,0,0,0,0,0,0.5097020142727117,0.49029798572728833
89328,0.5121951219512195,0.5305164319248826,-105,-113,0.4903184724049234,0.5096815275950766,away,MIA,over,8.5,0.5,100,0.4772727272727273,STL,MIA,2023 REG,11,6,12,4,10,23,1,0,2,-2,1,1,1,1,0,0,0,0,0,0.4772727272727273,0.5227272727272727
89328,0.5121951219512195,0.5305164319248826,-105,-113,0.4903184724049234,0.5096815275950766,home,STL,under,8.5,0.5454545454545454,-120,0.5227272727272727,STL,MIA,2023 REG,11,6,12,4,10,23,1,0,2,-2,1,1,1,1,0,0,0,0,0,0.4772727272727273,0.5227272727272727
89330,0.6363636363636364,0.40322580645161293,-175,148,0.6111703545721141,0.3888296454278859,away,NYY,over,7,0.5169082125603864,-107,0.49353874091423283,TOR,NYY,2023 REG,3,0,5,2,2,8,0,1,-2,2,0,0,0,0,0,0,0,0,0,0.49353874091423283,0.5064612590857671
89330,0.6363636363636364,0.40322580645161293,-175,148,0.6111703545721141,0.3888296454278859,home,TOR,under,7,0.5283018867924528,-112,0.5064612590857671,TOR,NYY,2023 REG,3,0,5,2,2,8,0,1,-2,2,0,0,0,0,0,0,0,0,0,0.49353874091423283,0.5064612590857671
89331,0.5689655172413793,0.4716981132075471,-132,112,0.5458293137100936,0.4541706862899064,away,TEX,over,8,0.5391705069124424,-117,0.5127649394825569,TOR,TEX,2023 REG,5,0,12,10,10,17,0,1,-10,10,0,0,0,0,0,0,0,0,0,0.5127649394825569,0.48723506051744314
89331,0.5689655172413793,0.4716981132075471,-132,112,0.5458293137100936,0.4541706862899064,home,TOR,under,8,0.5098039215686274,-104,0.48723506051744314,TOR,TEX,2023 REG,5,0,12,10,10,17,0,1,-10,10,0,0,0,0,0,0,0,0,0,0.5127649394825569,0.48723506051744314
89333,0.5073891625615764,0.5348837209302326,-103,-115,0.4859403596076043,0.5140596403923957,away,SEA,over,11,0.5121951219512195,-105,0.48808156828023186,CHC,SEA,2023 REG,5,2,10,5,7,15,0,1,-3,3,1,1,0,0,0,0,0,0,0,0.48808156828023186,0.5119184317197681
89333,0.5073891625615764,0.5348837209302326,-103,-115,0.4859403596076043,0.5140596403923957,home,CHC,under,11,0.5348837209302326,-115,0.5119184317197681,CHC,SEA,2023 REG,5,2,10,5,7,15,0,1,-3,3,1,1,0,0,0,0,0,0,0,0.48808156828023186,0.5119184317197681
89334,0.7142857142857143,0.31746031746031744,-250,215,0.6916099773242631,0.3083900226757369,away,CWS,over,8,0.5305164319248826,-113,0.5053568787472517,LAD,CWS,2023 REG,7,4,13,8,12,20,0,1,-4,4,1,1,1,1,0,0,0,0,0,0.5053568787472517,0.49464312125274834
89334,0.7142857142857143,0.31746031746031744,-250,215,0.6916099773242631,0.3083900226757369,home,LAD,under,8,0.5169082125603864,-107,0.49464312125274834,LAD,CWS,2023 REG,7,4,13,8,12,20,0,1,-4,4,1,1,1,1,0,0,0,0,0,0.5053568787472517,0.49464312125274834
89335,0.3448275862068966,0.6923076923076923,190,-225,0.3320223177535901,0.6679776822464099,away,NYM,over,8,0.5348837209302326,-115,0.5097020142727117,OAK,NYM,2023 REG,13,6,11,17,23,24,0,1,-11,11,1,1,1,1,1,1,0,0,0,0.5097020142727117,0.49029798572728833
89335,0.3448275862068966,0.6923076923076923,190,-225,0.3320223177535901,0.6679776822464099,home,OAK,under,8,0.5121951219512195,-105,0.49029798572728833,OAK,NYM,2023 REG,13,6,11,17,23,24,0,1,-11,11,1,1,1,1,1,1,0,0,0,0.5097020142727117,0.49029798572728833
89336,0.7530864197530864,0.29411764705882354,-305,240,0.7175376780799196,0.28246232192008036,away,COL,over,7.5,0.5121951219512195,-105,0.48808156828023186,SD,COL,2023 REG,5,2,2,0,2,7,1,0,2,-2,0,0,0,0,0,0,0,0,0,0.48808156828023186,0.5119184317197681
89336,0.7530864197530864,0.29411764705882354,-305,240,0.7175376780799196,0.28246232192008036,home,SD,under,7.5,0.5348837209302326,-115,0.5119184317197681,SD,COL,2023 REG,5,2,2,0,2,7,1,0,2,-2,0,0,0,0,0,0,0,0,0,0.48808156828023186,0.5119184317197681
89337,0.5670995670995671,0.4739336492890995,-131,111,0.5438296478488513,0.45617035215114865,away,TOR,over,8.5,0.5145631067961165,-106,0.4913668392989033,NYM,TOR,2023 REG,5,0,8,3,3,13,0,1,-3,3,0,0,0,0,0,0,0,0,0,0.4913668392989033,0.5086331607010968
89337,0.5670995670995671,0.4739336492890995,-131,111,0.5438296478488513,0.45617035215114865,home,NYM,under,8.5,0.5305164319248826,-113,0.5086331607010968,NYM,TOR,2023 REG,5,0,8,3,3,13,0,1,-3,3,0,0,0,0,0,0,0,0,0,0.4913668392989033,0.5086331607010968
89339,0.6923076923076923,0.3448275862068966,-225,190,0.6665986533360538,0.33340134666394616,away,DET,over,8,0.5348837209302326,-115,0.5097020142727117,STL,DET,2023 REG,12,4,9,5,9,21,0,1,-1,1,1,1,1,1,0,0,0,0,0,0.5097020142727117,0.49029798572728833
89339,0.6923076923076923,0.3448275862068966,-225,190,0.6665986533360538,0.33340134666394616,home,STL,under,8,0.5121951219512195,-105,0.49029798572728833,STL,DET,2023 REG,12,4,9,5,9,21,0,1,-1,1,1,1,1,1,0,0,0,0,0,0.5097020142727117,0.49029798572728833
89340,0.6491228070175439,0.390625,-185,156,0.6233215989535241,0.3766784010464759,away,CWS,over,8.5,0.5192307692307692,-108,0.49455035168025013,BAL,CWS,2023 REG,9,5,15,10,15,24,0,1,-5,5,1,1,1,1,1,0,0,0,0,0.49455035168025013,0.5054496483197499
89340,0.6491228070175439,0.390625,-185,156,0.6233215989535241,0.3766784010464759,home,BAL,under,8.5,0.5283018867924528,-112,0.5054496483197499,BAL,CWS,2023 REG,9,5,15,10,15,24,0,1,-5,5,1,1,1,1,1,0,0,0,0,0.49455035168025013,0.5054496483197499
89342,0.5260663507109005,0.5121951219512195,-111,-105,0.5059382774147141,0.4940617225852859,away,WSH,over,9,0.5391705069124424,-117,0.5140669063204599,KC,WSH,2023 REG,6,3,8,2,5,14,1,0,1,-1,1,1,0,0,0,0,0,0,0,0.5140669063204599,0.4859330936795401
89342,0.5260663507109005,0.5121951219512195,-111,-105,0.5059382774147141,0.4940617225852859,home,KC,under,9,0.5073891625615764,-103,0.4859330936795401,KC,WSH,2023 REG,6,3,8,2,5,14,1,0,1,-1,1,1,0,0,0,0,0,0,0,0.5140669063204599,0.4859330936795401
89343,0.7058823529411764,0.3333333333333333,-240,200,0.6782006920415226,0.32179930795847744,away,DET,over,9,0.5169082125603864,-107,0.49353874091423283,TEX,DET,2023 REG,14,10,5,2,12,19,1,0,8,-8,1,1,0,0,0,0,0,0,0,0.49353874091423283,0.5064612590857671
89343,0.7058823529411764,0.3333333333333333,-240,200,0.6782006920415226,0.32179930795847744,home,TEX,under,9,0.5283018867924528,-112,0.5064612590857671,TEX,DET,2023 REG,14,10,5,2,12,19,1,0,8,-8,1,1,0,0,0,0,0,0,0,0.49353874091423283,0.5064612590857671
89344,0.5495495495495495,0.48780487804878053,-122,105,0.529021440689206,0.470978559310794,away,MIL,over,9,0.5098039215686274,-104,0.48592421718142587,CHC,MIL,2023 REG,9,5,13,9,14,22,0,1,-4,4,1,1,1,1,1,0,0,0,0,0.48592421718142587,0.5140757828185741
89344,0.5495495495495495,0.48780487804878053,-122,105,0.529021440689206,0.470978559310794,home,CHC,under,9,0.5370370370370371,-116,0.5140757828185741,CHC,MIL,2023 REG,9,5,13,9,14,22,0,1,-4,4,1,1,1,1,1,0,0,0,0,0.48592421718142587,0.5140757828185741
89345,0.6923076923076923,0.3508771929824561,-225,185,0.6624104640298972,0.33758953597010277,away,PIT,over,8.5,0.5215311004784688,-109,0.49670754937970685,ARI,PIT,2023 REG,12,7,6,3,10,18,1,0,4,-4,1,1,1,0,0,0,0,0,0,0.49670754937970685,0.5032924506202932
89345,0.6923076923076923,0.3508771929824561,-225,185,0.6624104640298972,0.33758953597010277,home,ARI,under,8.5,0.5260663507109005,-111,0.5032924506202932,ARI,PIT,2023 REG,12,7,6,3,10,18,1,0,4,-4,1,1,1,0,0,0,0,0,0,0.49670754937970685,0.5032924506202932
89346,0.4444444444444444,0.5918367346938775,125,-145,0.42831947593852354,0.5716805240614764,away,SD,over,9.5,0.5,100,0.4772727272727273,ARI,SD,2023 REG,9,3,6,5,8,15,0,1,-2,2,1,1,1,0,0,0,0,0,0,0.4772727272727273,0.5227272727272727
89346,0.4444444444444444,0.5918367346938775,125,-145,0.42831947593852354,0.5716805240614764,home,ARI,under,9.5,0.5454545454545454,-120,0.5227272727272727,ARI,SD,2023 REG,9,3,6,5,8,15,0,1,-2,2,1,1,1,0,0,0,0,0,0,0.4772727272727273,0.5227272727272727
89348,0.4464285714285714,0.5901639344262295,124,-144,0.430092631314821,0.569907368685179,away,TEX,over,9,0.5121951219512195,-105,0.48808156828023186,NYY,TEX,2023 REG,4,1,8,0,1,12,1,0,1,-1,0,0,0,0,0,0,0,0,0,0.48808156828023186,0.5119184317197681
89348,0.4464285714285714,0.5901639344262295,124,-144,0.430092631314821,0.569907368685179,home,NYY,under,9,0.5348837209302326,-115,0.5119184317197681,NYY,TEX,2023 REG,4,1,8,0,1,12,1,0,1,-1,0,0,0,0,0,0,0,0,0,0.48808156828023186,0.5119184317197681
89349,0.47619047619047616,0.5652173913043479,110,-130,0.4564724440500838,0.5435275559499162,away,TB,over,8.5,0.5145631067961165,-106,0.4913668392989033,BAL,TB,2023 REG,2,1,13,7,8,15,0,1,-6,6,1,0,0,0,0,0,0,0,0,0.4913668392989033,0.5086331607010968
89349,0.47619047619047616,0.5652173913043479,110,-130,0.4564724440500838,0.5435275559499162,home,BAL,under,8.5,0.5305164319248826,-113,0.5086331607010968,BAL,TB,2023 REG,2,1,13,7,8,15,0,1,-6,6,1,0,0,0,0,0,0,0,0,0.4913668392989033,0.5086331607010968
89350,0.5,0.5433789954337899,100,-119,0.4783105022831051,0.5216894977168949,away,LAD,over,9.5,0.5348837209302326,-115,0.5097020142727117,BOS,LAD,2023 REG,7,4,14,7,11,21,0,1,-3,3,1,1,1,1,0,0,0,0,0,0.5097020142727117,0.49029798572728833
89350,0.5,0.5433789954337899,100,-119,0.4783105022831051,0.5216894977168949,home,BOS,under,9.5,0.5121951219512195,-105,0.49029798572728833,BOS,LAD,2023 REG,7,4,14,7,11,21,0,1,-3,3,1,1,1,1,0,0,0,0,0,0.5097020142727117,0.49029798572728833
89353,0.3968253968253968,0.6453900709219857,152,-182,0.380073227084372,0.6199267729156279,away,MIL,over,8.5,0.5121951219512195,-105,0.48808156828023186,PIT,MIL,2023 REG,8,3,7,7,10,15,0,1,-4,4,1,1,1,0,0,0,0,0,0,0.48808156828023186,0.5119184317197681
89353,0.3968253968253968,0.6453900709219857,152,-182,0.380073227084372,0.6199267729156279,home,PIT,under,8.5,0.5348837209302326,-115,0.5119184317197681,PIT,MIL,2023 REG,8,3,7,7,10,15,0,1,-4,4,1,1,1,0,0,0,0,0,0,0.48808156828023186,0.5119184317197681
89355,0.3861003861003861,0.6563573883161512,159,-191,0.36970742300519793,0.630292576994802,away,CHC,over,11.5,0.5348837209302326,-115,0.5097020142727117,COL,CHC,2023 REG,11,7,11,3,10,22,1,0,4,-4,1,1,1,0,0,0,0,0,0,0.5097020142727117,0.49029798572728833
89355,0.3861003861003861,0.6563573883161512,159,-191,0.36970742300519793,0.630292576994802,home,COL,under,11.5,0.5121951219512195,-105,0.49029798572728833,COL,CHC,2023 REG,11,7,11,3,10,22,1,0,4,-4,1,1,1,0,0,0,0,0,0,0.5097020142727117,0.49029798572728833
89359,0.5555555555555556,0.4807692307692307,-125,108,0.5353751187084521,0.4646248812915479,away,LAD,over,8.5,0.5454545454545454,-120,0.5220180091279142,SD,LAD,2023 REG,5,1,3,2,3,8,0,1,-1,1,1,0,0,0,0,0,0,0,0,0.5220180091279142,0.4779819908720858
89359,0.5555555555555556,0.4807692307692307,-125,108,0.5353751187084521,0.4646248812915479,home,SD,under,8.5,0.49751243781094534,101,0.4779819908720858,SD,LAD,2023 REG,5,1,3,2,3,8,0,1,-1,1,1,0,0,0,0,0,0,0,0,0.5220180091279142,0.4779819908720858
89361,0.6825396825396826,0.3508771929824561,-215,185,0.6597313389293339,0.3402686610706661,away,DET,over,8,0.5433789954337899,-119,0.5171177654451503,MIL,DET,2023 REG,8,6,7,2,8,15,1,0,4,-4,1,1,0,0,0,0,0,0,0,0.5171177654451503,0.4828822345548497
89361,0.6825396825396826,0.3508771929824561,-215,185,0.6597313389293339,0.3402686610706661,home,MIL,under,8,0.504950495049505,-102,0.4828822345548497,MIL,DET,2023 REG,8,6,7,2,8,15,1,0,4,-4,1,1,0,0,0,0,0,0,0,0.5171177654451503,0.4828822345548497
89362,0.6226415094339623,0.4166666666666667,-165,140,0.5981666073335706,0.40183339266642937,away,MIL,over,9.5,0.5260663507109005,-111,0.5022370601254724,TOR,MIL,2023 REG,7,2,7,4,6,14,0,1,-2,2,1,1,0,0,0,0,0,0,0,0.5022370601254724,0.4977629398745276
89362,0.6226415094339623,0.4166666666666667,-165,140,0.5981666073335706,0.40183339266642937,home,TOR,under,9.5,0.5192307692307692,-108,0.4977629398745276,TOR,MIL,2023 REG,7,2,7,4,6,14,0,1,-2,2,1,1,0,0,0,0,0,0,0,0.5022370601254724,0.4977629398745276
89363,0.4166666666666667,0.6212121212121212,140,-164,0.4008838383838384,0.5991161616161615,away,LAD,over,8,0.5238095238095238,-110,0.4988662131519274,SF,LAD,2023 REG,3,2,7,5,7,10,0,1,-3,3,1,1,0,0,0,0,0,0,0,0.4988662131519274,0.5011337868480725
89363,0.4166666666666667,0.6212121212121212,140,-164,0.4008838383838384,0.5991161616161615,home,SF,under,8,0.5238095238095238,-110,0.5011337868480725,SF,LAD,2023 REG,3,2,7,5,7,10,0,1,-3,3,1,1,0,0,0,0,0,0,0,0.4988662131519274,0.5011337868480725
89364,0.5,0.5348837209302326,100,-115,0.4825581395348837,0.5174418604651163,away,SEA,over,8.5,0.5169082125603864,-107,0.49353874091423283,PHI,SEA,2023 REG,12,6,8,5,11,20,1,0,1,-1,1,1,1,1,1,0,0,0,0,0.49353874091423283,0.5064612590857671
89364,0.5,0.5348837209302326,100,-115,0.4825581395348837,0.5174418604651163,home,PHI,under,8.5,0.5283018867924528,-112,0.5064612590857671,PHI,SEA,2023 REG,12,6,8,5,11,20,1,0,1,-1,1,1,1,1,1,0,0,0,0,0.49353874091423283,0.5064612590857671
89365,0.5454545454545454,0.5,-120,100,0.5206611570247933,0.4793388429752067,away,CLE,over,9,0.5348837209302326,-115,0.5097020142727117,BOS,CLE,2023 REG,16,8,14,7,15,30,1,0,1,-1,1,1,1,1,1,1,1,0,0,0.5097020142727117,0.49029798572728833
89365,0.5454545454545454,0.5,-120,100,0.5206611570247933,0.4793388429752067,home,BOS,under,9,0.5121951219512195,-105,0.49029798572728833,BOS,CLE,2023 REG,16,8,14,7,15,30,1,0,1,-1,1,1,1,1,1,1,1,0,0,0.5097020142727117,0.49029798572728833
89366,0.43103448275862066,0.6062992125984252,132,-154,0.41494237269092843,0.5850576273090715,away,LAD,over,7.5,0.5192307692307692,-108,0.49688292476754015,SF,LAD,2023 REG,10,5,13,10,15,23,0,1,-5,5,1,1,1,1,1,0,0,0,0,0.49688292476754015,0.5031170752324599
89366,0.43103448275862066,0.6062992125984252,132,-154,0.41494237269092843,0.5850576273090715,home,SF,under,7.5,0.5238095238095238,-110,0.5031170752324599,SF,LAD,2023 REG,10,5,13,10,15,23,0,1,-5,5,1,1,1,1,1,0,0,0,0,0.49688292476754015,0.5031170752324599
89368,0.6363636363636364,0.4081632653061224,-175,145,0.6080283353010626,0.3919716646989374,away,SF,over,9,0.5121951219512195,-105,0.48808156828023186,LAD,SF,2023 REG,5,1,8,5,6,13,0,1,-4,4,1,0,0,0,0,0,0,0,0,0.48808156828023186,0.5119184317197681
89368,0.6363636363636364,0.4081632653061224,-175,145,0.6080283353010626,0.3919716646989374,home,LAD,under,9,0.5348837209302326,-115,0.5119184317197681,LAD,SF,2023 REG,5,1,8,5,6,13,0,1,-4,4,1,0,0,0,0,0,0,0,0,0.48808156828023186,0.5119184317197681
89369,0.49751243781094534,0.5412844036697247,101,-118,0.47821052662653235,0.5217894733734676,away,TEX,over,10.5,0.5169082125603864,-107,0.49353874091423283,BOS,TEX,2023 REG,10,2,10,6,8,20,0,1,-4,4,1,1,0,0,0,0,0,0,0,0.49353874091423283,0.5064612590857671
89369,0.49751243781094534,0.5412844036697247,101,-118,0.47821052662653235,0.5217894733734676,home,BOS,under,10.5,0.5283018867924528,-112,0.5064612590857671,BOS,TEX,2023 REG,10,2,10,6,8,20,0,1,-4,4,1,1,0,0,0,0,0,0,0,0.49353874091423283,0.5064612590857671
89370,0.726027397260274,0.31746031746031744,-265,215,0.6944541249288857,0.3055458750711143,away,KC,over,9,0.5169082125603864,-107,0.49353874091423283,TB,KC,2023 REG,8,4,11,9,13,19,0,1,-5,5,1,1,1,1,0,0,0,0,0,0.49353874091423283,0.5064612590857671
89370,0.726027397260274,0.31746031746031744,-265,215,0.6944541249288857,0.3055458750711143,home,TB,under,9,0.5283018867924528,-112,0.5064612590857671,TB,KC,2023 REG,8,4,11,9,13,19,0,1,-5,5,1,1,1,1,0,0,0,0,0,0.49353874091423283,0.5064612590857671
89371,0.4464285714285714,0.5967741935483871,124,-148,0.42714162277814344,0.5728583772218565,away,TB,over,9.5,0.5121951219512195,-105,0.48808156828023186,CLE,TB,2023 REG,5,2,13,6,8,18,0,1,-4,4,1,1,0,0,0,0,0,0,0,0.48808156828023186,0.5119184317197681
89371,0.4464285714285714,0.5967741935483871,124,-148,0.42714162277814344,0.5728583772218565,home,CLE,under,9.5,0.5348837209302326,-115,0.5119184317197681,CLE,TB,2023 REG,5,2,13,6,8,18,0,1,-4,4,1,1,0,0,0,0,0,0,0,0.48808156828023186,0.5119184317197681
89372,0.4694835680751174,0.5708154506437768,113,-133,0.45056384097704505,0.549436159022955,away,HOU,over,8,0.5121951219512195,-105,0.48808156828023186,MIA,HOU,2023 REG,7,5,8,1,6,15,1,0,4,-4,1,0,0,0,0,0,0,0,0,0.48808156828023186,0.5119184317197681
89372,0.4694835680751174,0.5708154506437768,113,-133,0.45056384097704505,0.549436159022955,home,MIA,under,8,0.5348837209302326,-115,0.5119184317197681,MIA,HOU,2023 REG,7,5,8,1,6,15,1,0,4,-4,1,0,0,0,0,0,0,0,0,0.48808156828023186,0.5119184317197681
89373,0.4672897196261683,0.5726495726495727,114,-134,0.44862649893656975,0.5513735010634302,away,NYY,over,9.5,0.5121951219512195,-105,0.48808156828023186,KC,NYY,2023 REG,12,2,12,5,7,24,0,1,-3,3,1,1,0,0,0,0,0,0,0,0.48808156828023186,0.5119184317197681
89373,0.4672897196261683,0.5726495726495727,114,-134,0.44862649893656975,0.5513735010634302,home,KC,under,9.5,0.5348837209302326,-115,0.5119184317197681,KC,NYY,2023 REG,12,2,12,5,7,24,0,1,-3,3,1,1,0,0,0,0,0,0,0,0.48808156828023186,0.5119184317197681
89374,0.5348837209302326,0.5098039215686274,-115,-104,0.5109810284308424,0.48901897156915763,away,STL,over,11,0.5238095238095238,-110,0.4988662131519274,BOS,STL,2023 REG,9,6,14,8,14,23,0,1,-2,2,1,1,1,1,1,1,0,0,0,0.4988662131519274,0.5011337868480725
89374,0.5348837209302326,0.5098039215686274,-115,-104,0.5109810284308424,0.48901897156915763,home,BOS,under,11,0.5238095238095238,-110,0.5011337868480725,BOS,STL,2023 REG,9,6,14,8,14,23,0,1,-2,2,1,1,1,1,1,1,0,0,0,0.4988662131519274,0.5011337868480725
89376,0.6402877697841727,0.3968253968253968,-178,152,0.616524663106103,0.383475336893897,away,MIL,over,8.5,0.5348837209302326,-115,0.5097020142727117,NYM,MIL,2023 REG,3,1,7,2,3,10,0,1,-1,1,1,0,0,0,0,0,0,0,0,0.5097020142727117,0.49029798572728833
89376,0.6402877697841727,0.3968253968253968,-178,152,0.616524663106103,0.383475336893897,home,NYM,under,8.5,0.5121951219512195,-105,0.49029798572728833,NYM,MIL,2023 REG,3,1,7,2,3,10,0,1,-1,1,1,0,0,0,0,0,0,0,0,0.5097020142727117,0.49029798572728833
89378,0.43103448275862066,0.609375,132,-156,0.41361660225921526,0.5863833977407847,away,ARI,over,8,0.5121951219512195,-105,0.48808156828023186,NYM,ARI,2023 REG,11,7,6,1,8,17,1,0,6,-6,1,0,0,0,0,0,0,0,0,0.48808156828023186,0.5119184317197681
89378,0.43103448275862066,0.609375,132,-156,0.41361660225921526,0.5863833977407847,home,NYM,under,8,0.5348837209302326,-115,0.5119184317197681,NYM,ARI,2023 REG,11,7,6,1,8,17,1,0,6,-6,1,0,0,0,0,0,0,0,0,0.48808156828023186,0.5119184317197681
89379,0.4,0.6323529411764706,150,-172,0.38705882352941184,0.6129411764705881,away,TEX,over,9,0.5238095238095238,-110,0.4988662131519274,OAK,TEX,2023 REG,5,0,9,5,5,14,0,1,-5,5,0,0,0,0,0,0,0,0,0,0.4988662131519274,0.5011337868480725
89379,0.4,0.6323529411764706,150,-172,0.38705882352941184,0.6129411764705881,home,OAK,under,9,0.5238095238095238,-110,0.5011337868480725,OAK,TEX,2023 REG,5,0,9,5,5,14,0,1,-5,5,0,0,0,0,0,0,0,0,0,0.4988662131519274,0.5011337868480725
89380,0.4716981132075471,0.5689655172413793,112,-132,0.45251715544861953,0.5474828445513804,away,TOR,over,9,0.5454545454545454,-120,0.5206611570247933,DET,TOR,2023 REG,7,2,14,12,14,21,0,1,-10,10,1,1,0,0,0,0,0,0,0,0.5206611570247933,0.4793388429752067
89380,0.4716981132075471,0.5689655172413793,112,-132,0.45251715544861953,0.5474828445513804,home,DET,under,9,0.5,100,0.4793388429752067,DET,TOR,2023 REG,7,2,14,12,14,21,0,1,-10,10,1,1,0,0,0,0,0,0,0,0.5206611570247933,0.4793388429752067
89381,0.5535714285714286,0.48780487804878053,-124,105,0.53066668740667,0.46933331259333,away,HOU,over,7.5,0.5238095238095238,-110,0.4988662131519274,SEA,HOU,2023 REG,3,1,9,5,6,12,0,1,-4,4,1,0,0,0,0,0,0,0,0,0.4988662131519274,0.5011337868480725
89381,0.5535714285714286,0.48780487804878053,-124,105,0.53066668740667,0.46933331259333,home,SEA,under,7.5,0.5238095238095238,-110,0.5011337868480725,SEA,HOU,2023 REG,3,1,9,5,6,12,0,1,-4,4,1,0,0,0,0,0,0,0,0,0.4988662131519274,0.5011337868480725
89383,0.47619047619047616,0.5652173913043479,110,-130,0.4564724440500838,0.5435275559499162,away,MIN,over,8.5,0.5121951219512195,-105,0.48808156828023186,STL,MIN,2023 REG,7,2,7,3,5,14,0,1,-1,1,1,1,0,0,0,0,0,0,0,0.48808156828023186,0.5119184317197681
89383,0.47619047619047616,0.5652173913043479,110,-130,0.4564724440500838,0.5435275559499162,home,STL,under,8.5,0.5348837209302326,-115,0.5119184317197681,STL,MIN,2023 REG,7,2,7,3,5,14,0,1,-1,1,1,1,0,0,0,0,0,0,0,0.48808156828023186,0.5119184317197681
89385,0.49019607843137253,0.5475113122171946,104,-121,0.47171206340756505,0.5282879365924349,away,TEX,over,8.5,0.5260663507109005,-111,0.5010269332605688,MIN,TEX,2023 REG,8,7,10,6,13,18,1,0,1,-1,1,1,1,1,1,1,0,0,0,0.5010269332605688,0.4989730667394312
89385,0.49019607843137253,0.5475113122171946,104,-121,0.47171206340756505,0.5282879365924349,home,MIN,under,8.5,0.5215311004784688,-109,0.4989730667394312,MIN,TEX,2023 REG,8,7,10,6,13,18,1,0,1,-1,1,1,1,1,1,1,0,0,0,0.5010269332605688,0.4989730667394312
89386,0.6894409937888198,0.35460992907801414,-222,182,0.6590704817501952,0.3409295182498048,away,MIA,over,8.5,0.5348837209302326,-115,0.5097020142727117,ATL,MIA,2023 REG,9,6,8,3,9,17,1,0,3,-3,1,1,1,0,0,0,0,0,0,0.5097020142727117,0.49029798572728833
89386,0.6894409937888198,0.35460992907801414,-222,182,0.6590704817501952,0.3409295182498048,home,ATL,under,8.5,0.5121951219512195,-105,0.49029798572728833,ATL,MIA,2023 REG,9,6,8,3,9,17,1,0,3,-3,1,1,1,0,0,0,0,0,0,0.5097020142727117,0.49029798572728833
89387,0.4672897196261683,0.5726495726495727,114,-134,0.44862649893656975,0.5513735010634302,away,SD,over,9,0.5454545454545454,-120,0.5206611570247933,TOR,SD,2023 REG,6,1,9,9,10,15,0,1,-8,8,1,0,0,0,0,0,0,0,0,0.5206611570247933,0.4793388429752067
89387,0.4672897196261683,0.5726495726495727,114,-134,0.44862649893656975,0.5513735010634302,home,TOR,under,9,0.5,100,0.4793388429752067,TOR,SD,2023 REG,6,1,9,9,10,15,0,1,-8,8,1,0,0,0,0,0,0,0,0,0.5206611570247933,0.4793388429752067
89390,0.5475113122171946,0.49019607843137253,-121,104,0.5268660892829112,0.47313391071708877,away,TOR,over,9,0.5024875621890548,-101,0.48049269377245407,BAL,TOR,2023 REG,11,4,8,2,6,19,1,0,2,-2,1,1,0,0,0,0,0,0,0,0.48049269377245407,0.5195073062275459
89390,0.5475113122171946,0.49019607843137253,-121,104,0.5268660892829112,0.47313391071708877,home,BAL,under,9,0.5412844036697247,-118,0.5195073062275459,BAL,TOR,2023 REG,11,4,8,2,6,19,1,0,2,-2,1,1,0,0,0,0,0,0,0,0.48049269377245407,0.5195073062275459
89391,0.4,0.6402877697841727,150,-178,0.383884892086331,0.6161151079136691,away,TB,over,9,0.5454545454545454,-120,0.5206611570247933,WSH,TB,2023 REG,16,6,10,10,16,26,0,1,-4,4,1,1,1,1,1,1,0,0,0,0.5206611570247933,0.4793388429752067
89391,0.4,0.6402877697841727,150,-178,0.383884892086331,0.6161151079136691,home,WSH,under,9,0.5,100,0.4793388429752067,WSH,TB,2023 REG,16,6,10,10,16,26,0,1,-4,4,1,1,1,1,1,1,0,0,0,0.5206611570247933,0.4793388429752067
89392,0.5454545454545454,0.5,-120,100,0.5206611570247933,0.4793388429752067,away,STL,over,8,0.5145631067961165,-106,0.49023796582517226,CHC,STL,2023 REG,9,4,9,6,10,18,0,1,-2,2,1,1,1,1,0,0,0,0,0,0.49023796582517226,0.5097620341748277
89392,0.5454545454545454,0.5,-120,100,0.5206611570247933,0.4793388429752067,home,CHC,under,8,0.5327102803738317,-114,0.5097620341748277,CHC,STL,2023 REG,9,4,9,6,10,18,0,1,-2,2,1,1,1,1,0,0,0,0,0,0.49023796582517226,0.5097620341748277
89393,0.4,0.6389891696750902,150,-177,0.3844043321299639,0.6155956678700361,away,HOU,over,9,0.5145631067961165,-106,0.49023796582517226,NYY,HOU,2023 REG,8,3,9,7,10,17,0,1,-4,4,1,1,1,0,0,0,0,0,0,0.49023796582517226,0.5097620341748277
89393,0.4,0.6389891696750902,150,-177,0.3844043321299639,0.6155956678700361,home,NYY,under,9,0.5327102803738317,-114,0.5097620341748277,NYY,HOU,2023 REG,8,3,9,7,10,17,0,1,-4,4,1,1,1,0,0,0,0,0,0,0.49023796582517226,0.5097620341748277
89396,0.4854368932038835,0.5535714285714286,106,-124,0.4665008146721786,0.5334991853278215,away,MIA,over,7.5,0.5327102803738317,-114,0.508788710910954,NYM,MIA,2023 REG,12,11,9,2,13,21,1,0,9,-9,1,1,0,0,0,0,0,0,0,0.508788710910954,0.491211289089046
89396,0.4854368932038835,0.5535714285714286,106,-124,0.4665008146721786,0.5334991853278215,home,NYM,under,7.5,0.5121951219512195,-105,0.491211289089046,NYM,MIA,2023 REG,12,11,9,2,13,21,1,0,9,-9,1,1,0,0,0,0,0,0,0,0.508788710910954,0.491211289089046
89397,0.4854368932038835,0.5535714285714286,106,-124,0.4665008146721786,0.5334991853278215,away,TB,over,9,0.5238095238095238,-110,0.5000596729920038,TOR,TB,2023 REG,10,6,8,3,9,18,1,0,3,-3,1,1,1,0,0,0,0,0,0,0.5000596729920038,0.4999403270079962
89397,0.4854368932038835,0.5535714285714286,106,-124,0.4665008146721786,0.5334991853278215,home,TOR,under,9,0.5215311004784688,-109,0.4999403270079962,TOR,TB,2023 REG,10,6,8,3,9,18,1,0,3,-3,1,1,1,0,0,0,0,0,0,0.5000596729920038,0.4999403270079962
89398,0.5918367346938775,0.4484304932735426,-145,123,0.5680051099784656,0.43199489002153435,away,PHI,over,8,0.5238095238095238,-110,0.4988662131519274,TB,PHI,2023 REG,6,1,6,3,4,12,0,1,-2,2,1,0,0,0,0,0,0,0,0,0.4988662131519274,0.5011337868480725
89398,0.5918367346938775,0.4484304932735426,-145,123,0.5680051099784656,0.43199489002153435,home,TB,under,8,0.5238095238095238,-110,0.5011337868480725,TB,PHI,2023 REG,6,1,6,3,4,12,0,1,-2,2,1,0,0,0,0,0,0,0,0,0.4988662131519274,0.5011337868480725
89399,0.726027397260274,0.31545741324921134,-265,217,0.6959082882602367,0.30409171173976335,away,COL,over,8,0.5,100,0.4772727272727273,SF,COL,2023 REG,7,1,7,0,1,14,1,0,1,-1,0,0,0,0,0,0,0,0,0,0.4772727272727273,0.5227272727272727
89399,0.726027397260274,0.31545741324921134,-265,217,0.6959082882602367,0.30409171173976335,home,SF,under,8,0.5454545454545454,-120,0.5227272727272727,SF,COL,2023 REG,7,1,7,0,1,14,1,0,1,-1,0,0,0,0,0,0,0,0,0,0.4772727272727273,0.5227272727272727
89400,0.7354497354497355,0.29850746268656714,-278,235,0.7104759230637776,0.2895240769362224,away,KC,over,8,0.5260663507109005,-111,0.5022370601254724,ARI,KC,2023 REG,6,2,5,0,2,11,1,0,2,-2,0,0,0,0,0,0,0,0,0,0.5022370601254724,0.4977629398745276
89400,0.7354497354497355,0.29850746268656714,-278,235,0.7104759230637776,0.2895240769362224,home,ARI,under,8,0.5192307692307692,-108,0.4977629398745276,ARI,KC,2023 REG,6,2,5,0,2,11,1,0,2,-2,0,0,0,0,0,0,0,0,0,0.5022370601254724,0.4977629398745276
89401,0.6666666666666666,0.37593984962406013,-200,166,0.6382623224728488,0.36173767752715125,away,DET,over,9,0.5169082125603864,-107,0.49353874091423283,TEX,DET,2023 REG,8,2,10,7,9,18,0,1,-5,5,1,1,0,0,0,0,0,0,0,0.49353874091423283,0.5064612590857671
89401,0.6666666666666666,0.37593984962406013,-200,166,0.6382623224728488,0.36173767752715125,home,TEX,under,9,0.5283018867924528,-112,0.5064612590857671,TEX,DET,2023 REG,8,2,10,7,9,18,0,1,-5,5,1,1,0,0,0,0,0,0,0,0.49353874091423283,0.5064612590857671
89402,0.5121951219512195,0.5348837209302326,-105,-115,0.48808156828023186,0.5119184317197681,away,OAK,over,10,0.5391705069124424,-117,0.5140669063204599,KC,OAK,2023 REG,9,5,4,1,6,13,1,0,4,-4,1,0,0,0,0,0,0,0,0,0.5140669063204599,0.4859330936795401
89402,0.5121951219512195,0.5348837209302326,-105,-115,0.48808156828023186,0.5119184317197681,home,KC,under,10,0.5073891625615764,-103,0.4859330936795401,KC,OAK,2023 REG,9,5,4,1,6,13,1,0,4,-4,1,0,0,0,0,0,0,0,0,0.5140669063204599,0.4859330936795401
89403,0.5192307692307692,0.5215311004784688,-108,-109,0.49806595226635714,0.5019340477336429,away,SD,over,9,0.5260663507109005,-111,0.5022370601254724,STL,SD,2023 REG,10,5,11,4,9,21,1,0,1,-1,1,1,1,1,0,0,0,0,0,0.5022370601254724,0.4977629398745276
89403,0.5192307692307692,0.5215311004784688,-108,-109,0.49806595226635714,0.5019340477336429,home,STL,under,9,0.5192307692307692,-108,0.4977629398745276,STL,SD,2023 REG,10,5,11,4,9,21,1,0,1,-1,1,1,1,1,0,0,0,0,0,0.5022370601254724,0.4977629398745276
89404,0.3508771929824561,0.6923076923076923,185,-225,0.3357246016525795,0.6642753983474206,away,TEX,over,10.5,0.5098039215686274,-104,0.48592421718142587,WSH,TEX,2023 REG,13,7,8,2,9,21,1,0,5,-5,1,1,0,0,0,0,0,0,0,0.48592421718142587,0.5140757828185741
89404,0.3508771929824561,0.6923076923076923,185,-225,0.3357246016525795,0.6642753983474206,home,WSH,under,10.5,0.5370370370370371,-116,0.5140757828185741,WSH,TEX,2023 REG,13,7,8,2,9,21,1,0,5,-5,1,1,0,0,0,0,0,0,0,0.48592421718142587,0.5140757828185741
89405,0.41152263374485604,0.6296296296296295,143,-170,0.39458754593642575,0.6054124540635742,away,TOR,over,8,0.5169082125603864,-107,0.49353874091423283,CLE,TOR,2023 REG,6,0,8,1,1,14,0,1,-1,1,0,0,0,0,0,0,0,0,0,0.49353874091423283,0.5064612590857671
89405,0.41152263374485604,0.6296296296296295,143,-170,0.39458754593642575,0.6054124540635742,home,CLE,under,8,0.5283018867924528,-112,0.5064612590857671,CLE,TOR,2023 REG,6,0,8,1,1,14,0,1,-1,1,0,0,0,0,0,0,0,0,0,0.49353874091423283,0.5064612590857671
89406,0.5934959349593496,0.4464285714285714,-146,124,0.5698009027128599,0.4301990972871401,away,CWS,over,8.5,0.5433789954337899,-119,0.5184560714286826,CLE,CWS,2023 REG,7,3,10,5,8,17,0,1,-2,2,1,1,1,0,0,0,0,0,0,0.5184560714286826,0.48154392857131745
89406,0.5934959349593496,0.4464285714285714,-146,124,0.5698009027128599,0.4301990972871401,home,CLE,under,8.5,0.5024875621890548,-101,0.48154392857131745,CLE,CWS,2023 REG,7,3,10,5,8,17,0,1,-2,2,1,1,1,0,0,0,0,0,0,0.5184560714286826,0.48154392857131745
89407,0.6875,0.35211267605633806,-220,184,0.6602662852112676,0.3397337147887324,away,WSH,over,9,0.5348837209302326,-115,0.5097020142727117,NYM,WSH,2023 REG,6,2,5,1,3,11,1,0,1,-1,1,0,0,0,0,0,0,0,0,0.5097020142727117,0.49029798572728833
89407,0.6875,0.35211267605633806,-220,184,0.6602662852112676,0.3397337147887324,home,NYM,under,9,0.5121951219512195,-105,0.49029798572728833,NYM,WSH,2023 REG,6,2,5,1,3,11,1,0,1,-1,1,0,0,0,0,0,0,0,0,0.5097020142727117,0.49029798572728833
89408,0.6363636363636364,0.4081632653061224,-175,145,0.6080283353010626,0.3919716646989374,away,STL,over,9,0.5238095238095238,-110,0.4988662131519274,TB,STL,2023 REG,9,4,9,6,10,18,0,1,-2,2,1,1,1,1,0,0,0,0,0,0.4988662131519274,0.5011337868480725
89408,0.6363636363636364,0.4081632653061224,-175,145,0.6080283353010626,0.3919716646989374,home,TB,under,9,0.5238095238095238,-110,0.5011337868480725,TB,STL,2023 REG,9,4,9,6,10,18,0,1,-2,2,1,1,1,1,0,0,0,0,0,0.4988662131519274,0.5011337868480725
89409,0.5,0.5391705069124424,100,-117,0.4804147465437788,0.5195852534562212,away,LAA,over,9.5,0.49751243781094534,101,0.476135829221149,KC,LAA,2023 REG,8,2,9,5,7,17,0,1,-3,3,1,1,0,0,0,0,0,0,0,0.476135829221149,0.523864170778851
89409,0.5,0.5391705069124424,100,-117,0.4804147465437788,0.5195852534562212,home,KC,under,9.5,0.5454545454545454,-120,0.523864170778851,KC,LAA,2023 REG,8,2,9,5,7,17,0,1,-3,3,1,1,0,0,0,0,0,0,0,0.476135829221149,0.523864170778851
89411,0.5535714285714286,0.48309178743961345,-124,107,0.5332757197081732,0.4667242802918268,away,PHI,over,8,0.5238095238095238,-110,0.4988662131519274,ARI,PHI,2023 REG,8,3,5,4,7,13,0,1,-1,1,1,1,1,0,0,0,0,0,0,0.4988662131519274,0.5011337868480725
89411,0.5535714285714286,0.48309178743961345,-124,107,0.5332757197081732,0.4667242802918268,home,ARI,under,8,0.5238095238095238,-110,0.5011337868480725,ARI,PHI,2023 REG,8,3,5,4,7,13,0,1,-1,1,1,1,1,0,0,0,0,0,0,0.4988662131519274,0.5011337868480725
89412,0.5121951219512195,0.5238095238095238,-105,-110,0.4937537180249852,0.5062462819750149,away,MIL,over,10,0.5348837209302326,-115,0.5097020142727117,CIN,MIL,2023 REG,11,8,11,10,18,22,0,1,-2,2,1,1,1,1,1,1,1,1,0,0.5097020142727117,0.49029798572728833
89412,0.5121951219512195,0.5238095238095238,-105,-110,0.4937537180249852,0.5062462819750149,home,CIN,under,10,0.5121951219512195,-105,0.49029798572728833,CIN,MIL,2023 REG,11,8,11,10,18,22,0,1,-2,2,1,1,1,1,1,1,1,1,0,0.5097020142727117,0.49029798572728833
89413,0.4347826086956522,0.6062992125984252,130,-154,0.4169209472634447,0.5830790527365552,away,ATL,over,8.5,0.5348837209302326,-115,0.5097020142727117,PHI,ATL,2023 REG,11,2,10,4,6,21,0,1,-2,2,1,1,0,0,0,0,0,0,0,0.5097020142727117,0.49029798572728833
89413,0.4347826086956522,0.6062992125984252,130,-154,0.4169209472634447,0.5830790527365552,home,PHI,under,8.5,0.5121951219512195,-105,0.49029798572728833,PHI,ATL,2023 REG,11,2,10,4,6,21,0,1,-2,2,1,1,0,0,0,0,0,0,0,0.5097020142727117,0.49029798572728833
89414,0.3333333333333333,0.7101449275362319,200,-245,0.3188405797101449,0.6811594202898551,away,ATL,over,8.5,0.5098039215686274,-104,0.48592421718142587,NYM,ATL,2023 REG,5,0,7,6,6,12,0,1,-6,6,0,0,0,0,0,0,0,0,0,0.48592421718142587,0.5140757828185741
89414,0.3333333333333333,0.7101449275362319,200,-245,0.3188405797101449,0.6811594202898551,home,NYM,under,8.5,0.5370370370370371,-116,0.5140757828185741,NYM,ATL,2023 REG,5,0,7,6,6,12,0,1,-6,6,0,0,0,0,0,0,0,0,0,0.48592421718142587,0.5140757828185741
89415,0.5689655172413793,0.4694835680751174,-132,113,0.5470893135268209,0.4529106864731791,away,CWS,over,9.5,0.5121951219512195,-105,0.48808156828023186,WSH,CWS,2023 REG,14,13,6,3,16,20,1,0,10,-10,1,1,1,0,0,0,0,0,0,0.48808156828023186,0.5119184317197681
89415,0.5689655172413793,0.4694835680751174,-132,113,0.5470893135268209,0.4529106864731791,home,WSH,under,9.5,0.5348837209302326,-115,0.5119184317197681,WSH,CWS,2023 REG,14,13,6,3,16,20,1,0,10,-10,1,1,1,0,0,0,0,0,0,0.48808156828023186,0.5119184317197681
89416,0.5454545454545454,0.5,-120,100,0.5206611570247933,0.4793388429752067,away,CWS,over,9.5,0.5283018867924528,-112,0.5044173060022736,WSH,CWS,2023 REG,7,4,8,3,7,15,1,0,1,-1,1,1,1,0,0,0,0,0,0,0.5044173060022736,0.49558269399772636
89416,0.5454545454545454,0.5,-120,100,0.5206611570247933,0.4793388429752067,home,WSH,under,9.5,0.5169082125603864,-107,0.49558269399772636,WSH,CWS,2023 REG,7,4,8,3,7,15,1,0,1,-1,1,1,1,0,0,0,0,0,0,0.5044173060022736,0.49558269399772636
89417,0.5815899581589958,0.45454545454545453,-139,120,0.5605739649961564,0.4394260350038436,away,KC,over,8.5,0.5238095238095238,-110,0.4988662131519274,DET,KC,2023 REG,11,9,11,4,13,22,1,0,5,-5,1,1,1,1,0,0,0,0,0,0.4988662131519274,0.5011337868480725
89417,0.5815899581589958,0.45454545454545453,-139,120,0.5605739649961564,0.4394260350038436,home,DET,under,8.5,0.5238095238095238,-110,0.5011337868480725,DET,KC,2023 REG,11,9,11,4,13,22,1,0,5,-5,1,1,1,1,0,0,0,0,0,0.4988662131519274,0.5011337868480725
89419,0.6491228070175439,0.3861003861003861,-185,159,0.6262586290287122,0.3737413709712878,away,WSH,over,9,0.5,100,0.4772727272727273,PHI,WSH,2023 REG,8,7,0,0,7,8,1,0,7,-7,0,0,0,0,0,0,0,0,0,0.4772727272727273,0.5227272727272727
89419,0.6491228070175439,0.3861003861003861,-185,159,0.6262586290287122,0.3737413709712878,home,PHI,under,9,0.5454545454545454,-120,0.5227272727272727,PHI,WSH,2023 REG,8,7,0,0,7,8,1,0,7,-7,0,0,0,0,0,0,0,0,0,0.4772727272727273,0.5227272727272727
89420,0.45454545454545453,0.5833333333333333,120,-140,0.43732782369146006,0.5626721763085399,away,LAD,over,7.5,0.5,100,0.4772727272727273,CHC,LAD,2023 REG,6,3,8,7,10,14,0,1,-4,4,1,1,1,0,0,0,0,0,0,0.4772727272727273,0.5227272727272727
89420,0.45454545454545453,0.5833333333333333,120,-140,0.43732782369146006,0.5626721763085399,home,CHC,under,7.5,0.5454545454545454,-120,0.5227272727272727,CHC,LAD,2023 REG,6,3,8,7,10,14,0,1,-4,4,1,1,1,0,0,0,0,0,0,0.4772727272727273,0.5227272727272727
89421,0.6183206106870228,0.4184100418410042,-162,139,0.5956092911849603,0.4043907088150397,away,MIN,over,10,0.5348837209302326,-115,0.5097020142727117,ATL,MIN,2023 REG,6,3,4,0,3,10,1,0,3,-3,0,0,0,0,0,0,0,0,0,0.5097020142727117,0.49029798572728833
89421,0.6183206106870228,0.4184100418410042,-162,139,0.5956092911849603,0.4043907088150397,home,ATL,under,10,0.5121951219512195,-105,0.49029798572728833,ATL,MIN,2023 REG,6,3,4,0,3,10,1,0,3,-3,0,0,0,0,0,0,0,0,0,0.5097020142727117,0.49029798572728833
89422,0.5238095238095238,0.5121951219512195,-110,-105,0.5049499474586583,0.4950500525413417,away,PIT,over,13,0.5283018867924528,-112,0.5031902949311281,COL,PIT,2023 REG,10,3,9,5,8,19,0,1,-2,2,1,1,1,0,0,0,0,0,0,0.5031902949311281,0.4968097050688719
89422,0.5238095238095238,0.5121951219512195,-110,-105,0.5049499474586583,0.4950500525413417,home,COL,under,13,0.5192307692307692,-108,0.4968097050688719,COL,PIT,2023 REG,10,3,9,5,8,19,0,1,-2,2,1,1,1,0,0,0,0,0,0,0.5031902949311281,0.4968097050688719
89423,0.6453900709219857,0.3968253968253968,-182,152,0.6181446271984977,0.3818553728015023,away,NYY,over,8.5,0.5121951219512195,-105,0.48808156828023186,HOU,NYY,2023 REG,4,2,8,6,8,12,0,1,-4,4,1,1,0,0,0,0,0,0,0,0.48808156828023186,0.5119184317197681
89423,0.6453900709219857,0.3968253968253968,-182,152,0.6181446271984977,0.3818553728015023,home,HOU,under,8.5,0.5348837209302326,-115,0.5119184317197681,HOU,NYY,2023 REG,4,2,8,6,8,12,0,1,-4,4,1,1,0,0,0,0,0,0,0,0.48808156828023186,0.5119184317197681
89424,0.5670995670995671,0.4739336492890995,-131,111,0.5438296478488513,0.45617035215114865,away,SD,over,8,0.5238095238095238,-110,0.5012646084074657,LAD,SD,2023 REG,3,1,8,6,7,11,0,1,-5,5,1,0,0,0,0,0,0,0,0,0.5012646084074657,0.4987353915925343
89424,0.5670995670995671,0.4739336492890995,-131,111,0.5438296478488513,0.45617035215114865,home,LAD,under,8,0.5192307692307692,-108,0.4987353915925343,LAD,SD,2023 REG,3,1,8,6,7,11,0,1,-5,5,1,0,0,0,0,0,0,0,0,0.5012646084074657,0.4987353915925343
89425,0.5121951219512195,0.5238095238095238,-105,-110,0.4937537180249852,0.5062462819750149,away,CIN,over,7.5,0.5327102803738317,-114,0.5075272610403079,PIT,CIN,2023 REG,6,2,4,0,2,10,1,0,2,-2,0,0,0,0,0,0,0,0,0,0.5075272610403079,0.4924727389596921
89425,0.5121951219512195,0.5238095238095238,-105,-110,0.4937537180249852,0.5062462819750149,home,PIT,under,7.5,0.5145631067961165,-106,0.4924727389596921,PIT,CIN,2023 REG,6,2,4,0,2,10,1,0,2,-2,0,0,0,0,0,0,0,0,0,0.5075272610403079,0.4924727389596921
89426,0.5833333333333333,0.45454545454545453,-140,120,0.5612373737373737,0.4387626262626263,away,BAL,over,9,0.5,100,0.4772727272727273,BOS,BAL,2023 REG,14,9,10,5,14,24,1,0,4,-4,1,1,1,1,1,0,0,0,0,0.4772727272727273,0.5227272727272727
89426,0.5833333333333333,0.45454545454545453,-140,120,0.5612373737373737,0.4387626262626263,home,BOS,under,9,0.5454545454545454,-120,0.5227272727272727,BOS,BAL,2023 REG,14,9,10,5,14,24,1,0,4,-4,1,1,1,1,1,0,0,0,0,0.4772727272727273,0.5227272727272727
89427,0.6254681647940076,0.41152263374485604,-167,143,0.6023315979176397,0.3976684020823603,away,CIN,over,9.5,0.5305164319248826,-113,0.5066009958897986,BAL,CIN,2023 REG,10,7,16,11,18,26,0,1,-4,4,1,1,1,1,1,1,1,0,0,0.5066009958897986,0.49339900411020143
89427,0.6254681647940076,0.41152263374485604,-167,143,0.6023315979176397,0.3976684020823603,home,BAL,under,9.5,0.5145631067961165,-106,0.49339900411020143,BAL,CIN,2023 REG,10,7,16,11,18,26,0,1,-4,4,1,1,1,1,1,1,1,0,0,0.5066009958897986,0.49339900411020143
89428,0.6575342465753424,0.38314176245210724,-192,161,0.6307883776257865,0.36921162237421346,away,KC,over,8.5,0.5391705069124424,-117,0.5140669063204599,CWS,KC,2023 REG,6,5,7,1,6,13,1,0,4,-4,1,0,0,0,0,0,0,0,0,0.5140669063204599,0.4859330936795401
89428,0.6575342465753424,0.38314176245210724,-192,161,0.6307883776257865,0.36921162237421346,home,CWS,under,8.5,0.5073891625615764,-103,0.4859330936795401,CWS,KC,2023 REG,6,5,7,1,6,13,1,0,4,-4,1,0,0,0,0,0,0,0,0,0.5140669063204599,0.4859330936795401
89429,0.6551724137931035,0.38314176245210724,-190,161,0.6300700224600344,0.3699299775399656,away,MIA,over,7,0.49019607843137253,104,0.46874141813588177,SEA,MIA,2023 REG,4,1,6,4,5,10,0,1,-3,3,1,0,0,0,0,0,0,0,0,0.46874141813588177,0.5312585818641182
89429,0.6551724137931035,0.38314176245210724,-190,161,0.6300700224600344,0.3699299775399656,home,SEA,under,7,0.5535714285714286,-124,0.5312585818641182,SEA,MIA,2023 REG,4,1,6,4,5,10,0,1,-3,3,1,0,0,0,0,0,0,0,0,0.46874141813588177,0.5312585818641182
89430,0.5098039215686274,0.5348837209302326,-104,-115,0.4870219861770517,0.5129780138229483,away,ARI,over,11.5,0.504950495049505,-102,0.48160416005266615,CIN,ARI,2023 REG,13,7,10,3,10,23,1,0,4,-4,1,1,1,0,0,0,0,0,0,0.48160416005266615,0.5183958399473338
89430,0.5098039215686274,0.5348837209302326,-104,-115,0.4870219861770517,0.5129780138229483,home,CIN,under,11.5,0.5412844036697247,-118,0.5183958399473338,CIN,ARI,2023 REG,13,7,10,3,10,23,1,0,4,-4,1,1,1,0,0,0,0,0,0,0.48160416005266615,0.5183958399473338
89432,0.6363636363636364,0.40322580645161293,-175,148,0.6111703545721141,0.3888296454278859,away,MIA,over,9,0.5454545454545454,-120,0.5206611570247933,CHC,MIA,2023 REG,8,4,8,1,5,16,1,0,3,-3,1,0,0,0,0,0,0,0,0,0.5206611570247933,0.4793388429752067
89432,0.6363636363636364,0.40322580645161293,-175,148,0.6111703545721141,0.3888296454278859,home,CHC,under,9,0.5,100,0.4793388429752067,CHC,MIA,2023 REG,8,4,8,1,5,16,1,0,3,-3,1,0,0,0,0,0,0,0,0,0.5206611570247933,0.4793388429752067
89433,0.5652173913043479,0.47619047619047616,-130,110,0.5418129444594474,0.4581870555405526,away,CLE,over,8,0.5098039215686274,-104,0.48483656587239576,CHC,CLE,2023 REG,5,0,8,6,6,13,0,1,-6,6,0,0,0,0,0,0,0,0,0,0.48483656587239576,0.5151634341276042
89433,0.5652173913043479,0.47619047619047616,-130,110,0.5418129444594474,0.4581870555405526,home,CHC,under,8,0.5391705069124424,-117,0.5151634341276042,CHC,CLE,2023 REG,5,0,8,6,6,13,0,1,-6,6,0,0,0,0,0,0,0,0,0,0.48483656587239576,0.5151634341276042
89434,0.5850622406639003,0.45454545454545453,-141,120,0.5618892737571823,0.43811072624281766,away,SD,over,8.5,0.5145631067961165,-106,0.4913668392989033,MIL,SD,2023 REG,6,5,5,4,9,11,1,0,1,-1,1,1,1,1,0,0,0,0,0,0.4913668392989033,0.5086331607010968
89434,0.5850622406639003,0.45454545454545453,-141,120,0.5618892737571823,0.43811072624281766,home,MIL,under,8.5,0.5305164319248826,-113,0.5086331607010968,MIL,SD,2023 REG,6,5,5,4,9,11,1,0,1,-1,1,1,1,1,0,0,0,0,0,0.4913668392989033,0.5086331607010968
89435,0.607843137254902,0.4347826086956522,-155,130,0.5819333701084867,0.41806662989151333,away,STL,over,8.5,0.5238095238095238,-110,0.5000596729920038,MIL,STL,2023 REG,9,4,5,0,4,14,1,0,4,-4,0,0,0,0,0,0,0,0,0,0.5000596729920038,0.4999403270079962
89435,0.607843137254902,0.4347826086956522,-155,130,0.5819333701084867,0.41806662989151333,home,MIL,under,8.5,0.5215311004784688,-109,0.4999403270079962,MIL,STL,2023 REG,9,4,5,0,4,14,1,0,4,-4,0,0,0,0,0,0,0,0,0,0.5000596729920038,0.4999403270079962
89436,0.6453900709219857,0.39370078740157477,-182,154,0.6201612190961417,0.37983878090385825,away,HOU,over,8.5,0.5412844036697247,-118,0.5149381613977361,LAD,HOU,2023 REG,5,8,13,7,15,18,1,0,1,-1,1,1,1,1,1,1,1,0,0,0.5149381613977361,0.48506183860226393
89436,0.6453900709219857,0.39370078740157477,-182,154,0.6201612190961417,0.37983878090385825,home,LAD,under,8.5,0.5073891625615764,-103,0.48506183860226393,LAD,HOU,2023 REG,5,8,13,7,15,18,1,0,1,-1,1,1,1,1,1,1,1,0,0,0.5149381613977361,0.48506183860226393
89437,0.5192307692307692,0.5215311004784688,-108,-109,0.49806595226635714,0.5019340477336429,away,SEA,over,8.5,0.5121951219512195,-105,0.48919479393107135,BAL,SEA,2023 REG,3,1,17,13,14,20,0,1,-12,12,1,0,0,0,0,0,0,0,0,0.48919479393107135,0.5108052060689287
89437,0.5192307692307692,0.5215311004784688,-108,-109,0.49806595226635714,0.5019340477336429,home,BAL,under,8.5,0.5327102803738317,-114,0.5108052060689287,BAL,SEA,2023 REG,3,1,17,13,14,20,0,1,-12,12,1,0,0,0,0,0,0,0,0,0.48919479393107135,0.5108052060689287
89439,0.6363636363636364,0.4081632653061224,-175,145,0.6080283353010626,0.3919716646989374,away,DET,over,8,0.5,100,0.4772727272727273,CLE,DET,2023 REG,9,3,7,4,7,16,0,1,-1,1,1,1,1,0,0,0,0,0,0,0.4772727272727273,0.5227272727272727
89439,0.6363636363636364,0.4081632653061224,-175,145,0.6080283353010626,0.3919716646989374,home,CLE,under,8,0.5454545454545454,-120,0.5227272727272727,CLE,DET,2023 REG,9,3,7,4,7,16,0,1,-1,1,1,1,1,0,0,0,0,0,0,0.4772727272727273,0.5227272727272727
89440,0.5348837209302326,0.5121951219512195,-115,-105,0.5097020142727117,0.49029798572728833,away,LAA,over,9,0.5391705069124424,-117,0.5153817639191344,BOS,LAA,2023 REG,7,2,4,1,3,11,1,0,1,-1,1,0,0,0,0,0,0,0,0,0.5153817639191344,0.4846182360808656
89440,0.5348837209302326,0.5121951219512195,-115,-105,0.5097020142727117,0.49029798572728833,home,BOS,under,9,0.504950495049505,-102,0.4846182360808656,BOS,LAA,2023 REG,7,2,4,1,3,11,1,0,1,-1,1,0,0,0,0,0,0,0,0,0.5153817639191344,0.4846182360808656
89441,0.5967741935483871,0.4444444444444444,-148,125,0.5721759741010521,0.42782402589894786,away,SF,over,8.5,0.5098039215686274,-104,0.48483656587239576,ARI,SF,2023 REG,13,8,6,4,12,19,1,0,4,-4,1,1,1,1,0,0,0,0,0,0.48483656587239576,0.5151634341276042
89441,0.5967741935483871,0.4444444444444444,-148,125,0.5721759741010521,0.42782402589894786,home,ARI,under,8.5,0.5391705069124424,-117,0.5151634341276042,ARI,SF,2023 REG,13,8,6,4,12,19,1,0,4,-4,1,1,1,1,0,0,0,0,0,0.48483656587239576,0.5151634341276042
89442,0.3846153846153846,0.6551724137931035,160,-190,0.3693123852275045,0.6306876147724956,away,MIN,over,11.5,0.5215311004784688,-109,0.49670754937970685,COL,MIN,2023 REG,13,6,14,7,13,27,0,1,-1,1,1,1,1,1,1,1,0,0,0,0.49670754937970685,0.5032924506202932
89442,0.3846153846153846,0.6551724137931035,160,-190,0.3693123852275045,0.6306876147724956,home,COL,under,11.5,0.5260663507109005,-111,0.5032924506202932,COL,MIN,2023 REG,13,6,14,7,13,27,0,1,-1,1,1,1,1,1,1,1,0,0,0,0.49670754937970685,0.5032924506202932
89445,0.4184100418410042,0.6183206106870228,139,-162,0.40304156797990504,0.5969584320200949,away,STL,over,11,0.5,100,0.4772727272727273,CIN,STL,2023 REG,18,10,8,3,13,26,1,0,7,-7,1,1,1,0,0,0,0,0,0,0.4772727272727273,0.5227272727272727
89445,0.4184100418410042,0.6183206106870228,139,-162,0.40304156797990504,0.5969584320200949,home,CIN,under,11,0.5454545454545454,-120,0.5227272727272727,CIN,STL,2023 REG,18,10,8,3,13,26,1,0,7,-7,1,1,1,0,0,0,0,0,0,0.4772727272727273,0.5227272727272727
89446,0.6875,0.35460992907801414,-220,182,0.6585494237588654,0.3414505762411346,away,PHI,over,8.5,0.5215311004784688,-109,0.49670754937970685,ATL,PHI,2023 REG,13,9,4,3,12,17,1,0,6,-6,1,1,1,0,0,0,0,0,0,0.49670754937970685,0.5032924506202932
89446,0.6875,0.35460992907801414,-220,182,0.6585494237588654,0.3414505762411346,home,ATL,under,8.5,0.5260663507109005,-111,0.5032924506202932,ATL,PHI,2023 REG,13,9,4,3,12,17,1,0,6,-6,1,1,1,0,0,0,0,0,0,0.49670754937970685,0.5032924506202932
89447,0.6000000000000001,0.43859649122807015,-150,128,0.5768421052631579,0.42315789473684207,away,SF,over,8.5,0.5454545454545454,-120,0.5206611570247933,NYM,SF,2023 REG,4,4,5,1,5,9,1,0,3,-3,1,0,0,0,0,0,0,0,0,0.5206611570247933,0.4793388429752067
89447,0.6000000000000001,0.43859649122807015,-150,128,0.5768421052631579,0.42315789473684207,home,NYM,under,8.5,0.5,100,0.4793388429752067,NYM,SF,2023 REG,4,4,5,1,5,9,1,0,3,-3,1,0,0,0,0,0,0,0,0,0.5206611570247933,0.4793388429752067
89448,0.5391705069124424,0.5,-117,100,0.5180509248444435,0.4819490751555565,away,MIA,over,8.5,0.5121951219512195,-105,0.48808156828023186,BOS,MIA,2023 REG,4,0,7,2,2,11,0,1,-2,2,0,0,0,0,0,0,0,0,0,0.48808156828023186,0.5119184317197681
89448,0.5391705069124424,0.5,-117,100,0.5180509248444435,0.4819490751555565,home,BOS,under,8.5,0.5348837209302326,-115,0.5119184317197681,BOS,MIA,2023 REG,4,0,7,2,2,11,0,1,-2,2,0,0,0,0,0,0,0,0,0,0.48808156828023186,0.5119184317197681
89449,0.6825396825396826,0.35460992907801414,-215,182,0.6571835984196672,0.3428164015803328,away,COL,over,9.5,0.5,100,0.4772727272727273,CIN,COL,2023 REG,9,5,6,3,8,15,1,0,2,-2,1,1,1,0,0,0,0,0,0,0.4772727272727273,0.5227272727272727
89449,0.6825396825396826,0.35460992907801414,-215,182,0.6571835984196672,0.3428164015803328,home,CIN,under,9.5,0.5454545454545454,-120,0.5227272727272727,CIN,COL,2023 REG,9,5,6,3,8,15,1,0,2,-2,1,1,1,0,0,0,0,0,0,0.4772727272727273,0.5227272727272727
89450,0.4716981132075471,0.5652173913043479,112,-130,0.4542851393811816,0.5457148606188185,away,TOR,over,7.5,0.5098039215686274,-104,0.48483656587239576,SEA,TOR,2023 REG,9,9,14,8,17,23,1,0,1,-1,1,1,1,1,1,1,1,1,0,0.48483656587239576,0.5151634341276042
89450,0.4716981132075471,0.5652173913043479,112,-130,0.4542851393811816,0.5457148606188185,home,SEA,under,7.5,0.5391705069124424,-117,0.5151634341276042,SEA,TOR,2023 REG,9,9,14,8,17,23,1,0,1,-1,1,1,1,1,1,1,1,1,0,0.48483656587239576,0.5151634341276042
89451,0.3225806451612903,0.7183098591549296,210,-255,0.30939015989799357,0.6906098401020064,away,ATL,over,9,0.5121951219512195,-105,0.48808156828023186,WSH,ATL,2023 REG,5,1,11,7,8,16,0,1,-6,6,1,0,0,0,0,0,0,0,0,0.48808156828023186,0.5119184317197681
89451,0.3225806451612903,0.7183098591549296,210,-255,0.30939015989799357,0.6906098401020064,home,WSH,under,9,0.5348837209302326,-115,0.5119184317197681,WSH,ATL,2023 REG,5,1,11,7,8,16,0,1,-6,6,1,0,0,0,0,0,0,0,0,0.48808156828023186,0.5119184317197681
89452,0.43103448275862066,0.6047430830039526,132,-153,0.4156131182057874,0.5843868817942126,away,NYY,over,7.5,0.5073891625615764,-103,0.48057683780462784,OAK,NYY,2023 REG,0,0,11,11,11,11,0,1,-11,11,0,0,0,0,0,0,0,0,0,0.48057683780462784,0.5194231621953722
89452,0.43103448275862066,0.6047430830039526,132,-153,0.4156131182057874,0.5843868817942126,home,OAK,under,7.5,0.5454545454545454,-120,0.5194231621953722,OAK,NYY,2023 REG,0,0,11,11,11,11,0,1,-11,11,0,0,0,0,0,0,0,0,0,0.48057683780462784,0.5194231621953722
89453,0.46511627906976744,0.574468085106383,115,-135,0.44670494689481377,0.5532950531051862,away,SEA,over,8,0.5238095238095238,-110,0.4988662131519274,OAK,SEA,2023 REG,3,1,3,2,3,6,0,1,-1,1,1,0,0,0,0,0,0,0,0,0.4988662131519274,0.5011337868480725
89453,0.46511627906976744,0.574468085106383,115,-135,0.44670494689481377,0.5532950531051862,home,OAK,under,8,0.5238095238095238,-110,0.5011337868480725,OAK,SEA,2023 REG,3,1,3,2,3,6,0,1,-1,1,1,0,0,0,0,0,0,0,0,0.4988662131519274,0.5011337868480725
89454,0.6453900709219857,0.3921568627450981,-182,155,0.6211576527396834,0.3788423472603166,away,ARI,over,8,0.5370370370370371,-116,0.5118817074154765,SF,ARI,2023 REG,10,4,5,2,6,15,1,0,2,-2,1,1,0,0,0,0,0,0,0,0.5118817074154765,0.48811829258452355
89454,0.6453900709219857,0.3921568627450981,-182,155,0.6211576527396834,0.3788423472603166,home,SF,under,8,0.5098039215686274,-104,0.48811829258452355,SF,ARI,2023 REG,10,4,5,2,6,15,1,0,2,-2,1,1,0,0,0,0,0,0,0,0.5118817074154765,0.48811829258452355
89455,0.613899613899614,0.42016806722689076,-159,138,0.5929854776095975,0.4070145223904025,away,NYY,over,8,0.5433789954337899,-119,0.5198077604720502,TEX,NYY,2023 REG,5,2,3,0,2,8,1,0,2,-2,0,0,0,0,0,0,0,0,0,0.5198077604720502,0.48019223952794976
89455,0.613899613899614,0.42016806722689076,-159,138,0.5929854776095975,0.4070145223904025,home,TEX,under,8,0.5,100,0.48019223952794976,TEX,NYY,2023 REG,5,2,3,0,2,8,1,0,2,-2,0,0,0,0,0,0,0,0,0,0.5198077604720502,0.48019223952794976
89456,0.6894409937888198,0.35460992907801414,-222,182,0.6590704817501952,0.3409295182498048,away,COL,over,9,0.5098039215686274,-104,0.48483656587239576,BOS,COL,2023 REG,9,6,12,7,13,21,0,1,-1,1,1,1,1,1,1,1,0,0,0,0.48483656587239576,0.5151634341276042
89456,0.6894409937888198,0.35460992907801414,-222,182,0.6590704817501952,0.3409295182498048,home,BOS,under,9,0.5391705069124424,-117,0.5151634341276042,BOS,COL,2023 REG,9,6,12,7,13,21,0,1,-1,1,1,1,1,1,1,1,0,0,0,0.48483656587239576,0.5151634341276042
89458,0.6875,0.35714285714285715,-220,180,0.6568080357142857,0.3431919642857143,away,ARI,over,10,0.5391705069124424,-117,0.5089345153072766,STL,ARI,2023 REG,13,14,11,5,19,24,1,0,9,-9,1,1,1,1,1,0,0,0,0,0.5089345153072766,0.4910654846927234
89458,0.6875,0.35714285714285715,-220,180,0.6568080357142857,0.3431919642857143,home,STL,under,10,0.5169082125603864,-107,0.4910654846927234,STL,ARI,2023 REG,13,14,11,5,19,24,1,0,9,-9,1,1,1,1,1,0,0,0,0,0.5089345153072766,0.4910654846927234
89459,0.6389891696750902,0.4,-177,150,0.614075512518083,0.385924487481917,away,PIT,over,8.5,0.5121951219512195,-105,0.48808156828023186,BAL,PIT,2023 REG,5,2,3,0,2,8,1,0,2,-2,0,0,0,0,0,0,0,0,0,0.48808156828023186,0.5119184317197681
89459,0.6389891696750902,0.4,-177,150,0.614075512518083,0.385924487481917,home,BAL,under,8.5,0.5348837209302326,-115,0.5119184317197681,BAL,PIT,2023 REG,5,2,3,0,2,8,1,0,2,-2,0,0,0,0,0,0,0,0,0,0.48808156828023186,0.5119184317197681
89460,0.7237569060773481,0.31545741324921134,-262,217,0.6953752716476282,0.30462472835237175,away,WSH,over,7.5,0.5433789954337899,-119,0.5198077604720502,SEA,WSH,2023 REG,12,8,10,4,12,22,1,0,4,-4,1,1,1,1,0,0,0,0,0,0.5198077604720502,0.48019223952794976
89460,0.7237569060773481,0.31545741324921134,-262,217,0.6953752716476282,0.30462472835237175,home,SEA,under,7.5,0.5,100,0.48019223952794976,SEA,WSH,2023 REG,12,8,10,4,12,22,1,0,4,-4,1,1,1,1,0,0,0,0,0,0.5198077604720502,0.48019223952794976
89461,0.4566210045662101,0.5833333333333333,119,-140,0.4383770146577428,0.5616229853422572,away,ATL,over,9,0.5348837209302326,-115,0.5097020142727117,CLE,ATL,2023 REG,11,6,10,5,11,21,1,0,1,-1,1,1,1,1,1,0,0,0,0,0.5097020142727117,0.49029798572728833
89461,0.4566210045662101,0.5833333333333333,119,-140,0.4383770146577428,0.5616229853422572,home,CLE,under,9,0.5121951219512195,-105,0.49029798572728833,CLE,ATL,2023 REG,11,6,10,5,11,21,1,0,1,-1,1,1,1,1,1,0,0,0,0,0.5097020142727117,0.49029798572728833
89462,0.4081632653061224,0.6363636363636364,145,-175,0.3899890197266291,0.6100109802733709,away,HOU,over,8,0.5433789954337899,-119,0.5198077604720502,PIT,HOU,2023 REG,10,7,9,4,11,19,1,0,3,-3,1,1,1,1,0,0,0,0,0,0.5198077604720502,0.48019223952794976
89462,0.4081632653061224,0.6363636363636364,145,-175,0.3899890197266291,0.6100109802733709,home,PIT,under,8,0.5,100,0.48019223952794976,PIT,HOU,2023 REG,10,7,9,4,11,19,1,0,3,-3,1,1,1,1,0,0,0,0,0,0.5198077604720502,0.48019223952794976
89463,0.31545741324921134,0.7282608695652174,217,-268,0.3016661568408742,0.6983338431591257,away,ATL,over,9,0.5238095238095238,-110,0.4988662131519274,WSH,ATL,2023 REG,10,6,10,9,15,20,0,1,-3,3,1,1,1,1,1,1,0,0,0,0.4988662131519274,0.5011337868480725
89463,0.31545741324921134,0.7282608695652174,217,-268,0.3016661568408742,0.6983338431591257,home,WSH,under,9,0.5238095238095238,-110,0.5011337868480725,WSH,ATL,2023 REG,10,6,10,9,15,20,0,1,-3,3,1,1,1,1,1,1,0,0,0,0.4988662131519274,0.5011337868480725
89464,0.4366812227074236,0.6000000000000001,129,-150,0.42066322152514246,0.5793367784748575,away,CHC,over,12,0.5238095238095238,-110,0.4988662131519274,STL,CHC,2023 REG,12,7,7,5,12,19,1,0,2,-2,1,1,1,1,1,0,0,0,0,0.4988662131519274,0.5011337868480725
89464,0.4366812227074236,0.6000000000000001,129,-150,0.42066322152514246,0.5793367784748575,home,STL,under,12,0.5238095238095238,-110,0.5011337868480725,STL,CHC,2023 REG,12,7,7,5,12,19,1,0,2,-2,1,1,1,1,1,0,0,0,0,0.4988662131519274,0.5011337868480725
89465,0.7142857142857143,0.3278688524590164,-250,205,0.6841753094680495,0.3158246905319505,away,COL,over,8.5,0.5121951219512195,-105,0.48808156828023186,MIL,COL,2023 REG,13,12,1,1,13,14,1,0,11,-11,1,0,0,0,0,0,0,0,0,0.48808156828023186,0.5119184317197681
89465,0.7142857142857143,0.3278688524590164,-250,205,0.6841753094680495,0.3158246905319505,home,MIL,under,8.5,0.5348837209302326,-115,0.5119184317197681,MIL,COL,2023 REG,13,12,1,1,13,14,1,0,11,-11,1,0,0,0,0,0,0,0,0,0.48808156828023186,0.5119184317197681
89466,0.5454545454545454,0.49751243781094534,-120,101,0.5220180091279142,0.4779819908720858,away,PHI,over,7,0.5145631067961165,-106,0.4913668392989033,MIA,PHI,2023 REG,13,7,6,3,10,19,1,0,4,-4,1,1,1,0,0,0,0,0,0,0.4913668392989033,0.5086331607010968
89466,0.5454545454545454,0.49751243781094534,-120,101,0.5220180091279142,0.4779819908720858,home,MIA,under,7,0.5305164319248826,-113,0.5086331607010968,MIA,PHI,2023 REG,13,7,6,3,10,19,1,0,4,-4,1,1,1,0,0,0,0,0,0,0.4913668392989033,0.5086331607010968
89467,0.5689655172413793,0.47619047619047616,-132,110,0.5432733140818753,0.4567266859181247,away,STL,over,9.5,0.5412844036697247,-118,0.5149381613977361,PIT,STL,2023 REG,8,6,9,3,9,17,1,0,3,-3,1,1,1,0,0,0,0,0,0,0.5149381613977361,0.48506183860226393
89467,0.5689655172413793,0.47619047619047616,-132,110,0.5432733140818753,0.4567266859181247,home,PIT,under,9.5,0.5073891625615764,-103,0.48506183860226393,PIT,STL,2023 REG,8,6,9,3,9,17,1,0,3,-3,1,1,1,0,0,0,0,0,0,0.5149381613977361,0.48506183860226393
89468,0.6296296296296295,0.4098360655737705,-170,144,0.6047808585756369,0.3952191414243631,away,BOS,over,8.5,0.5121951219512195,-105,0.48919479393107135,BAL,BOS,2023 REG,2,1,5,6,7,7,0,1,-5,5,1,0,0,0,0,0,0,0,0,0.48919479393107135,0.5108052060689287
89468,0.6296296296296295,0.4098360655737705,-170,144,0.6047808585756369,0.3952191414243631,home,BAL,under,8.5,0.5327102803738317,-114,0.5108052060689287,BAL,BOS,2023 REG,2,1,5,6,7,7,0,1,-5,5,1,0,0,0,0,0,0,0,0,0.48919479393107135,0.5108052060689287
89470,0.3508771929824561,0.6923076923076923,185,-225,0.3357246016525795,0.6642753983474206,away,LAD,over,11.5,0.5348837209302326,-115,0.5097020142727117,COL,LAD,2023 REG,18,14,12,5,19,30,1,0,9,-9,1,1,1,1,1,0,0,0,0,0.5097020142727117,0.49029798572728833
89470,0.3508771929824561,0.6923076923076923,185,-225,0.3357246016525795,0.6642753983474206,home,COL,under,11.5,0.5121951219512195,-105,0.49029798572728833,COL,LAD,2023 REG,18,14,12,5,19,30,1,0,9,-9,1,1,1,1,1,0,0,0,0,0.5097020142727117,0.49029798572728833
89471,0.5,0.5454545454545454,100,-120,0.4772727272727273,0.5227272727272727,away,SF,over,9.5,0.5073891625615764,-103,0.4826927225525911,WSH,SF,2023 REG,11,6,6,1,7,17,1,0,5,-5,1,0,0,0,0,0,0,0,0,0.4826927225525911,0.5173072774474089
89471,0.5,0.5454545454545454,100,-120,0.4772727272727273,0.5227272727272727,home,WSH,under,9.5,0.5412844036697247,-118,0.5173072774474089,WSH,SF,2023 REG,11,6,6,1,7,17,1,0,5,-5,1,0,0,0,0,0,0,0,0,0.4826927225525911,0.5173072774474089
89472,0.5798319327731092,0.4629629629629629,-138,116,0.5550180856656387,0.4449819143343613,away,SEA,over,8,0.5348837209302326,-115,0.5097020142727117,TB,SEA,2023 REG,11,6,9,3,9,20,1,0,3,-3,1,1,1,0,0,0,0,0,0,0.5097020142727117,0.49029798572728833
89472,0.5798319327731092,0.4629629629629629,-138,116,0.5550180856656387,0.4449819143343613,home,TB,under,8,0.5121951219512195,-105,0.49029798572728833,TB,SEA,2023 REG,11,6,9,3,9,20,1,0,3,-3,1,1,1,0,0,0,0,0,0,0.5097020142727117,0.49029798572728833
89473,0.4291845493562232,0.607843137254902,133,-155,0.41329283836432396,0.586707161635676,away,SEA,over,7,0.5454545454545454,-120,0.5206611570247933,NYY,SEA,2023 REG,5,4,4,2,6,9,1,0,2,-2,1,1,0,0,0,0,0,0,0,0.5206611570247933,0.4793388429752067
89473,0.4291845493562232,0.607843137254902,133,-155,0.41329283836432396,0.586707161635676,home,NYY,under,7,0.5,100,0.4793388429752067,NYY,SEA,2023 REG,5,4,4,2,6,9,1,0,2,-2,1,1,0,0,0,0,0,0,0,0.5206611570247933,0.4793388429752067
89474,0.46511627906976744,0.574468085106383,115,-135,0.44670494689481377,0.5532950531051862,away,CHC,over,8.5,0.5145631067961165,-106,0.49023796582517226,ARI,CHC,2023 REG,8,6,7,4,10,15,1,0,2,-2,1,1,1,1,0,0,0,0,0,0.49023796582517226,0.5097620341748277
89474,0.46511627906976744,0.574468085106383,115,-135,0.44670494689481377,0.5532950531051862,home,ARI,under,8.5,0.5327102803738317,-114,0.5097620341748277,ARI,CHC,2023 REG,8,6,7,4,10,15,1,0,2,-2,1,1,1,1,0,0,0,0,0,0.49023796582517226,0.5097620341748277
89475,0.5833333333333333,0.45454545454545453,-140,120,0.5612373737373737,0.4387626262626263,away,CHC,over,7.5,0.5348837209302326,-115,0.5097020142727117,MIN,CHC,2023 REG,18,16,6,3,19,24,1,0,13,-13,1,1,1,0,0,0,0,0,0,0.5097020142727117,0.49029798572728833
89475,0.5833333333333333,0.45454545454545453,-140,120,0.5612373737373737,0.4387626262626263,home,MIN,under,7.5,0.5121951219512195,-105,0.49029798572728833,MIN,CHC,2023 REG,18,16,6,3,19,24,1,0,13,-13,1,1,1,0,0,0,0,0,0,0.5097020142727117,0.49029798572728833
89476,0.5348837209302326,0.5121951219512195,-115,-105,0.5097020142727117,0.49029798572728833,away,ATL,over,9.5,0.5073891625615764,-103,0.4837652908580103,TOR,ATL,2023 REG,13,6,10,5,11,23,1,0,1,-1,1,1,1,1,1,0,0,0,0,0.4837652908580103,0.5162347091419897
89476,0.5348837209302326,0.5121951219512195,-115,-105,0.5097020142727117,0.49029798572728833,home,TOR,under,9.5,0.5391705069124424,-117,0.5162347091419897,TOR,ATL,2023 REG,13,6,10,5,11,23,1,0,1,-1,1,1,1,1,1,0,0,0,0,0.4837652908580103,0.5162347091419897
89477,0.5780590717299579,0.4608294930875576,-137,117,0.5555791840506346,0.44442081594936544,away,TB,over,8.5,0.5348837209302326,-115,0.5097020142727117,TOR,TB,2023 REG,7,5,14,7,12,21,0,1,-2,2,1,1,1,1,1,0,0,0,0,0.5097020142727117,0.49029798572728833
89477,0.5780590717299579,0.4608294930875576,-137,117,0.5555791840506346,0.44442081594936544,home,TOR,under,8.5,0.5121951219512195,-105,0.49029798572728833,TOR,TB,2023 REG,7,5,14,7,12,21,0,1,-2,2,1,1,1,1,1,0,0,0,0,0.5097020142727117,0.49029798572728833
89478,0.4504504504504505,0.5918367346938775,122,-145,0.43140216885390636,0.5685978311460936,away,CLE,over,9,0.5391705069124424,-117,0.5153817639191344,CWS,CLE,2023 REG,4,0,7,5,5,11,0,1,-5,5,0,0,0,0,0,0,0,0,0,0.5153817639191344,0.4846182360808656
89478,0.4504504504504505,0.5918367346938775,122,-145,0.43140216885390636,0.5685978311460936,home,CWS,under,9,0.504950495049505,-102,0.4846182360808656,CWS,CLE,2023 REG,4,0,7,5,5,11,0,1,-5,5,0,0,0,0,0,0,0,0,0,0.5153817639191344,0.4846182360808656
89479,0.5689655172413793,0.4739336492890995,-132,111,0.5445573707671414,0.4554426292328586,away,CLE,over,8,0.5145631067961165,-106,0.4913668392989033,MIN,CLE,2023 REG,6,1,8,0,1,14,1,0,1,-1,0,0,0,0,0,0,0,0,0,0.4913668392989033,0.5086331607010968
89479,0.5689655172413793,0.4739336492890995,-132,111,0.5445573707671414,0.4554426292328586,home,MIN,under,8,0.5305164319248826,-113,0.5086331607010968,MIN,CLE,2023 REG,6,1,8,0,1,14,1,0,1,-1,0,0,0,0,0,0,0,0,0,0.4913668392989033,0.5086331607010968
89480,0.607843137254902,0.4347826086956522,-155,130,0.5819333701084867,0.41806662989151333,away,BOS,over,8,0.5238095238095238,-110,0.4988662131519274,PHI,BOS,2023 REG,8,3,8,5,8,16,0,1,-2,2,1,1,1,0,0,0,0,0,0,0.4988662131519274,0.5011337868480725
89480,0.607843137254902,0.4347826086956522,-155,130,0.5819333701084867,0.41806662989151333,home,PHI,under,8,0.5238095238095238,-110,0.5011337868480725,PHI,BOS,2023 REG,8,3,8,5,8,16,0,1,-2,2,1,1,1,0,0,0,0,0,0,0.4988662131519274,0.5011337868480725
89482,0.6721311475409836,0.37037037037037035,-205,170,0.6435645535349916,0.35643544646500835,away,KC,over,9.5,0.5238095238095238,-110,0.4988662131519274,BOS,KC,2023 REG,6,6,8,2,8,14,1,0,4,-4,1,1,0,0,0,0,0,0,0,0.4988662131519274,0.5011337868480725
89482,0.6721311475409836,0.37037037037037035,-205,170,0.6435645535349916,0.35643544646500835,home,BOS,under,9.5,0.5238095238095238,-110,0.5011337868480725,BOS,KC,2023 REG,6,6,8,2,8,14,1,0,4,-4,1,1,0,0,0,0,0,0,0,0.4988662131519274,0.5011337868480725
89485,0.37735849056603776,0.6610169491525424,165,-195,0.36287719255902645,0.6371228074409736,away,HOU,over,10.5,0.5327102803738317,-114,0.5075272610403079,KC,HOU,2023 REG,9,4,7,2,6,16,1,0,2,-2,1,1,0,0,0,0,0,0,0,0.5075272610403079,0.4924727389596921
89485,0.37735849056603776,0.6610169491525424,165,-195,0.36287719255902645,0.6371228074409736,home,KC,under,10.5,0.5145631067961165,-106,0.4924727389596921,KC,HOU,2023 REG,9,4,7,2,6,16,1,0,2,-2,1,1,0,0,0,0,0,0,0,0.5075272610403079,0.4924727389596921
89486,0.5169082125603864,0.5238095238095238,-107,-110,0.49586088023391106,0.5041391197660889,away,CHC,over,9,0.5192307692307692,-108,0.49688292476754015,SD,CHC,2023 REG,5,1,11,7,8,16,0,1,-6,6,1,0,0,0,0,0,0,0,0,0.49688292476754015,0.5031170752324599
89486,0.5169082125603864,0.5238095238095238,-107,-110,0.49586088023391106,0.5041391197660889,home,SD,under,9,0.5238095238095238,-110,0.5031170752324599,SD,CHC,2023 REG,5,1,11,7,8,16,0,1,-6,6,1,0,0,0,0,0,0,0,0,0.49688292476754015,0.5031170752324599
89488,0.48780487804878053,0.5535714285714286,105,-124,0.4676213138438005,0.5323786861561994,away,ATL,over,9.5,0.5238095238095238,-110,0.5000596729920038,MIL,ATL,2023 REG,6,4,6,6,10,12,0,1,-2,2,1,1,1,1,0,0,0,0,0,0.5000596729920038,0.4999403270079962
89488,0.48780487804878053,0.5535714285714286,105,-124,0.4676213138438005,0.5323786861561994,home,MIL,under,9.5,0.5215311004784688,-109,0.4999403270079962,MIL,ATL,2023 REG,6,4,6,6,10,12,0,1,-2,2,1,1,1,1,0,0,0,0,0,0.5000596729920038,0.4999403270079962
89489,0.7118155619596541,0.33112582781456956,-247,202,0.6812492124661865,0.3187507875338135,away,SF,over,9,0.5169082125603864,-107,0.49353874091423283,ATL,SF,2023 REG,10,4,2,0,4,12,1,0,4,-4,0,0,0,0,0,0,0,0,0,0.49353874091423283,0.5064612590857671
89489,0.7118155619596541,0.33112582781456956,-247,202,0.6812492124661865,0.3187507875338135,home,ATL,under,9,0.5283018867924528,-112,0.5064612590857671,ATL,SF,2023 REG,10,4,2,0,4,12,1,0,4,-4,0,0,0,0,0,0,0,0,0,0.49353874091423283,0.5064612590857671
89490,0.6389891696750902,0.39840637450199207,-177,151,0.6150938219518283,0.38490617804817173,away,SF,over,7.5,0.5454545454545454,-120,0.5206611570247933,ARI,SF,2023 REG,9,7,7,2,9,16,1,0,5,-5,1,1,0,0,0,0,0,0,0,0.5206611570247933,0.4793388429752067
89490,0.6389891696750902,0.39840637450199207,-177,151,0.6150938219518283,0.38490617804817173,home,ARI,under,7.5,0.5,100,0.4793388429752067,ARI,SF,2023 REG,9,7,7,2,9,16,1,0,5,-5,1,1,0,0,0,0,0,0,0,0.5206611570247933,0.4793388429752067
89491,0.4,0.6428571428571428,150,-180,0.38285714285714295,0.617142857142857,away,MIL,over,8.5,0.5260663507109005,-111,0.5022370601254724,STL,MIL,2023 REG,5,1,6,0,1,11,1,0,1,-1,0,0,0,0,0,0,0,0,0,0.5022370601254724,0.4977629398745276
89491,0.4,0.6428571428571428,150,-180,0.38285714285714295,0.617142857142857,home,STL,under,8.5,0.5192307692307692,-108,0.4977629398745276,STL,MIL,2023 REG,5,1,6,0,1,11,1,0,1,-1,0,0,0,0,0,0,0,0,0,0.5022370601254724,0.4977629398745276
89492,0.4065040650406504,0.6363636363636364,146,-175,0.389078170160859,0.610921829839141,away,HOU,over,8.5,0.5391705069124424,-117,0.5127649394825569,DET,HOU,2023 REG,5,4,25,17,21,30,0,1,-13,13,1,1,1,1,0,0,0,0,0,0.5127649394825569,0.48723506051744314
89492,0.4065040650406504,0.6363636363636364,146,-175,0.389078170160859,0.610921829839141,home,DET,under,8.5,0.5098039215686274,-104,0.48723506051744314,DET,HOU,2023 REG,5,4,25,17,21,30,0,1,-13,13,1,1,1,1,0,0,0,0,0,0.5127649394825569,0.48723506051744314
89493,0.5555555555555556,0.48309178743961345,-125,107,0.5340848094471283,0.46591519055287167,away,BOS,over,8.5,0.5475113122171946,-121,0.5214983313199976,ARI,BOS,2023 REG,9,4,8,2,6,17,1,0,2,-2,1,1,0,0,0,0,0,0,0,0.5214983313199976,0.47850166868000243
89493,0.5555555555555556,0.48309178743961345,-125,107,0.5340848094471283,0.46591519055287167,home,ARI,under,8.5,0.5,100,0.47850166868000243,ARI,BOS,2023 REG,9,4,8,2,6,17,1,0,2,-2,1,1,0,0,0,0,0,0,0,0.5214983313199976,0.47850166868000243
89495,0.37878787878787884,0.6655518394648829,164,-199,0.361992530964863,0.6380074690351369,away,ATL,over,10,0.5121951219512195,-105,0.48808156828023186,PIT,ATL,2023 REG,10,7,12,5,12,22,1,0,2,-2,1,1,1,1,1,0,0,0,0,0.48808156828023186,0.5119184317197681
89495,0.37878787878787884,0.6655518394648829,164,-199,0.361992530964863,0.6380074690351369,home,PIT,under,10,0.5348837209302326,-115,0.5119184317197681,PIT,ATL,2023 REG,10,7,12,5,12,22,1,0,2,-2,1,1,1,1,1,0,0,0,0,0.48808156828023186,0.5119184317197681
89496,0.6153846153846154,0.425531914893617,-160,135,0.5902052121364724,0.40979478786352763,away,MIL,over,8,0.5192307692307692,-108,0.49455035168025013,SEA,MIL,2023 REG,7,5,6,6,11,13,0,1,-1,1,1,1,1,1,1,0,0,0,0,0.49455035168025013,0.5054496483197499
89496,0.6153846153846154,0.425531914893617,-160,135,0.5902052121364724,0.40979478786352763,home,SEA,under,8,0.5283018867924528,-112,0.5054496483197499,SEA,MIL,2023 REG,7,5,6,6,11,13,0,1,-1,1,1,1,1,1,1,0,0,0,0,0.49455035168025013,0.5054496483197499
89497,0.6527777777777778,0.390625,-188,156,0.6244454089506174,0.3755545910493826,away,BAL,over,8.5,0.5391705069124424,-117,0.5140669063204599,HOU,BAL,2023 REG,10,7,16,8,15,26,0,1,-1,1,1,1,1,1,1,1,1,0,0,0.5140669063204599,0.4859330936795401
89497,0.6527777777777778,0.390625,-188,156,0.6244454089506174,0.3755545910493826,home,HOU,under,8.5,0.5073891625615764,-103,0.4859330936795401,HOU,BAL,2023 REG,10,7,16,8,15,26,0,1,-1,1,1,1,1,1,1,1,1,0,0,0.5140669063204599,0.4859330936795401
89498,0.425531914893617,0.607843137254902,135,-155,0.4113297650431834,0.5886702349568166,away,MIA,over,8.5,0.5145631067961165,-106,0.4913668392989033,WSH,MIA,2023 REG,12,5,11,6,11,23,0,1,-1,1,1,1,1,1,1,0,0,0,0,0.4913668392989033,0.5086331607010968
89498,0.425531914893617,0.607843137254902,135,-155,0.4113297650431834,0.5886702349568166,home,WSH,under,8.5,0.5305164319248826,-113,0.5086331607010968,WSH,MIA,2023 REG,12,5,11,6,11,23,0,1,-1,1,1,1,1,1,1,0,0,0,0,0.4913668392989033,0.5086331607010968
89499,0.5348837209302326,0.5121951219512195,-115,-105,0.5097020142727117,0.49029798572728833,away,STL,over,9,0.5260663507109005,-111,0.5010269332605688,MIA,STL,2023 REG,12,10,12,9,19,24,1,0,1,-1,1,1,1,1,1,1,1,1,1,0.5010269332605688,0.4989730667394312
89499,0.5348837209302326,0.5121951219512195,-115,-105,0.5097020142727117,0.49029798572728833,home,MIA,under,9,0.5215311004784688,-109,0.4989730667394312,MIA,STL,2023 REG,12,10,12,9,19,24,1,0,1,-1,1,1,1,1,1,1,1,1,1,0.5010269332605688,0.4989730667394312
89500,0.5169082125603864,0.5238095238095238,-107,-110,0.49586088023391106,0.5041391197660889,away,HOU,over,7.5,0.5348837209302326,-115,0.5097020142727117,MIA,HOU,2023 REG,9,5,12,12,17,21,0,1,-7,7,1,1,1,1,1,0,0,0,0,0.5097020142727117,0.49029798572728833
89500,0.5169082125603864,0.5238095238095238,-107,-110,0.49586088023391106,0.5041391197660889,home,MIA,under,7.5,0.5121951219512195,-105,0.49029798572728833,MIA,HOU,2023 REG,9,5,12,12,17,21,0,1,-7,7,1,1,1,1,1,0,0,0,0,0.5097020142727117,0.49029798572728833
89501,0.6742671009771988,0.36363636363636365,-207,175,0.6487100417752203,0.3512899582247797,away,MIL,over,8.5,0.5121951219512195,-105,0.48808156828023186,TB,MIL,2023 REG,10,8,6,4,12,16,1,0,4,-4,1,1,1,1,0,0,0,0,0,0.48808156828023186,0.5119184317197681
89501,0.6742671009771988,0.36363636363636365,-207,175,0.6487100417752203,0.3512899582247797,home,TB,under,8.5,0.5348837209302326,-115,0.5119184317197681,TB,MIL,2023 REG,10,8,6,4,12,16,1,0,4,-4,1,1,1,1,0,0,0,0,0,0.48808156828023186,0.5119184317197681
89502,0.46511627906976744,0.574468085106383,115,-135,0.44670494689481377,0.5532950531051862,away,LAD,over,8,0.5169082125603864,-107,0.49353874091423283,STL,LAD,2023 REG,12,10,6,5,15,18,1,0,5,-5,1,1,1,1,1,0,0,0,0,0.49353874091423283,0.5064612590857671
89502,0.46511627906976744,0.574468085106383,115,-135,0.44670494689481377,0.5532950531051862,home,STL,under,8,0.5283018867924528,-112,0.5064612590857671,STL,LAD,2023 REG,12,10,6,5,15,18,1,0,5,-5,1,1,1,1,1,0,0,0,0,0.49353874091423283,0.5064612590857671
89503,0.5815899581589958,0.45454545454545453,-139,120,0.5605739649961564,0.4394260350038436,away,SD,over,9,0.5192307692307692,-108,0.49571111079951763,ARI,SD,2023 REG,10,3,5,0,3,15,1,0,3,-3,0,0,0,0,0,0,0,0,0,0.49571111079951763,0.5042888892004824
89503,0.5815899581589958,0.45454545454545453,-139,120,0.5605739649961564,0.4394260350038436,home,ARI,under,9,0.5260663507109005,-111,0.5042888892004824,ARI,SD,2023 REG,10,3,5,0,3,15,1,0,3,-3,0,0,0,0,0,0,0,0,0,0.49571111079951763,0.5042888892004824
89504,0.6226415094339623,0.4166666666666667,-165,140,0.5981666073335706,0.40183339266642937,away,ARI,over,9.5,0.5192307692307692,-108,0.49455035168025013,TOR,ARI,2023 REG,12,7,4,5,12,16,1,0,2,-2,1,1,1,1,1,0,0,0,0,0.49455035168025013,0.5054496483197499
89504,0.6226415094339623,0.4166666666666667,-165,140,0.5981666073335706,0.40183339266642937,home,TOR,under,9.5,0.5283018867924528,-112,0.5054496483197499,TOR,ARI,2023 REG,12,7,4,5,12,16,1,0,2,-2,1,1,1,1,1,0,0,0,0,0.49455035168025013,0.5054496483197499
89505,0.5535714285714286,0.48780487804878053,-124,105,0.53066668740667,0.46933331259333,away,MIN,over,8.5,0.5348837209302326,-115,0.5097020142727117,TOR,MIN,2023 REG,8,2,7,3,5,15,0,1,-1,1,1,1,0,0,0,0,0,0,0,0.5097020142727117,0.49029798572728833
89505,0.5535714285714286,0.48780487804878053,-124,105,0.53066668740667,0.46933331259333,home,TOR,under,8.5,0.5121951219512195,-105,0.49029798572728833,TOR,MIN,2023 REG,8,2,7,3,5,15,0,1,-1,1,1,1,0,0,0,0,0,0,0,0.5097020142727117,0.49029798572728833
89506,0.47619047619047616,0.5652173913043479,110,-130,0.4564724440500838,0.5435275559499162,away,MIA,over,8,0.5238095238095238,-110,0.5000596729920038,PHI,MIA,2023 REG,20,15,9,3,18,29,1,0,12,-12,1,1,1,0,0,0,0,0,0,0.5000596729920038,0.4999403270079962
89506,0.47619047619047616,0.5652173913043479,110,-130,0.4564724440500838,0.5435275559499162,home,PHI,under,8,0.5215311004784688,-109,0.4999403270079962,PHI,MIA,2023 REG,20,15,9,3,18,29,1,0,12,-12,1,1,1,0,0,0,0,0,0,0.5000596729920038,0.4999403270079962
89507,0.5833333333333333,0.45454545454545453,-140,120,0.5612373737373737,0.4387626262626263,away,NYM,over,8.5,0.5327102803738317,-114,0.508788710910954,HOU,NYM,2023 REG,9,10,10,8,18,19,1,0,2,-2,1,1,1,1,1,1,1,1,0,0.508788710910954,0.491211289089046
89507,0.5833333333333333,0.45454545454545453,-140,120,0.5612373737373737,0.4387626262626263,home,HOU,under,8.5,0.5121951219512195,-105,0.491211289089046,HOU,NYM,2023 REG,9,10,10,8,18,19,1,0,2,-2,1,1,1,1,1,1,1,1,0,0.508788710910954,0.491211289089046
89508,0.5454545454545454,0.49504950495049505,-120,102,0.5233614270517961,0.4766385729482039,away,BOS,over,8.5,0.5192307692307692,-108,0.49688292476754015,MIN,BOS,2023 REG,9,5,10,4,9,19,1,0,1,-1,1,1,1,1,0,0,0,0,0,0.49688292476754015,0.5031170752324599
89508,0.5454545454545454,0.49504950495049505,-120,102,0.5233614270517961,0.4766385729482039,home,MIN,under,8.5,0.5238095238095238,-110,0.5031170752324599,MIN,BOS,2023 REG,9,5,10,4,9,19,1,0,1,-1,1,1,1,1,0,0,0,0,0,0.49688292476754015,0.5031170752324599
89509,0.43859649122807015,0.5967741935483871,128,-148,0.4230830329927819,0.5769169670072181,away,PHI,over,10,0.5145631067961165,-106,0.49023796582517226,CIN,PHI,2023 REG,6,3,13,8,11,19,0,1,-5,5,1,1,1,0,0,0,0,0,0,0.49023796582517226,0.5097620341748277
89509,0.43859649122807015,0.5967741935483871,128,-148,0.4230830329927819,0.5769169670072181,home,CIN,under,10,0.5327102803738317,-114,0.5097620341748277,CIN,PHI,2023 REG,6,3,13,8,11,19,0,1,-5,5,1,1,1,0,0,0,0,0,0,0.49023796582517226,0.5097620341748277
89510,0.5884773662551441,0.45454545454545453,-143,120,0.5631594099815408,0.4368405900184592,away,MIN,over,9,0.5,100,0.4772727272727273,TEX,MIN,2023 REG,13,6,11,5,11,24,1,0,1,-1,1,1,1,1,1,0,0,0,0,0.4772727272727273,0.5227272727272727
89510,0.5884773662551441,0.45454545454545453,-143,120,0.5631594099815408,0.4368405900184592,home,TEX,under,9,0.5454545454545454,-120,0.5227272727272727,TEX,MIN,2023 REG,13,6,11,5,11,24,1,0,1,-1,1,1,1,1,1,0,0,0,0,0.4772727272727273,0.5227272727272727
89511,0.5348837209302326,0.5121951219512195,-115,-105,0.5097020142727117,0.49029798572728833,away,CWS,over,8.5,0.5348837209302326,-115,0.5097020142727117,DET,CWS,2023 REG,11,7,4,3,10,15,1,0,4,-4,1,1,1,0,0,0,0,0,0,0.5097020142727117,0.49029798572728833
89511,0.5348837209302326,0.5121951219512195,-115,-105,0.5097020142727117,0.49029798572728833,home,DET,under,8.5,0.5121951219512195,-105,0.49029798572728833,DET,CWS,2023 REG,11,7,4,3,10,15,1,0,4,-4,1,1,1,0,0,0,0,0,0,0.5097020142727117,0.49029798572728833
89512,0.5,0.5454545454545454,100,-120,0.4772727272727273,0.5227272727272727,away,CHC,over,8.5,0.5454545454545454,-120,0.5206611570247933,PIT,CHC,2023 REG,2,3,8,8,11,10,0,1,-5,5,1,1,1,0,0,0,0,0,0,0.5206611570247933,0.4793388429752067
89512,0.5,0.5454545454545454,100,-120,0.4772727272727273,0.5227272727272727,home,PIT,under,8.5,0.5,100,0.4793388429752067,PIT,CHC,2023 REG,2,3,8,8,11,10,0,1,-5,5,1,1,1,0,0,0,0,0,0,0.5206611570247933,0.4793388429752067
89513,0.4166666666666667,0.6226415094339623,140,-165,0.4002882599580712,0.5997117400419287,away,LAD,over,9.5,0.5192307692307692,-108,0.49688292476754015,CHC,LAD,2023 REG,17,13,1,0,13,18,1,0,13,-13,0,0,0,0,0,0,0,0,0,0.49688292476754015,0.5031170752324599
89513,0.4166666666666667,0.6226415094339623,140,-165,0.4002882599580712,0.5997117400419287,home,CHC,under,9.5,0.5238095238095238,-110,0.5031170752324599,CHC,LAD,2023 REG,17,13,1,0,13,18,1,0,13,-13,0,0,0,0,0,0,0,0,0,0.49688292476754015,0.5031170752324599
89514,0.3508771929824561,0.6923076923076923,185,-225,0.3357246016525795,0.6642753983474206,away,LAD,over,9.5,0.5121951219512195,-105,0.48808156828023186,WSH,LAD,2023 REG,8,7,9,6,13,17,1,0,1,-1,1,1,1,1,1,1,0,0,0,0.48808156828023186,0.5119184317197681
89514,0.3508771929824561,0.6923076923076923,185,-225,0.3357246016525795,0.6642753983474206,home,WSH,under,9.5,0.5348837209302326,-115,0.5119184317197681,WSH,LAD,2023 REG,8,7,9,6,13,17,1,0,1,-1,1,1,1,1,1,1,0,0,0,0.48808156828023186,0.5119184317197681
89516,0.4484304932735426,0.5901639344262295,123,-144,0.43112357502252374,0.5688764249774763,away,SF,over,9,0.5145631067961165,-106,0.49023796582517226,DET,SF,2023 REG,10,7,9,6,13,19,1,0,1,-1,1,1,1,1,1,1,0,0,0,0.49023796582517226,0.5097620341748277
89516,0.4484304932735426,0.5901639344262295,123,-144,0.43112357502252374,0.5688764249774763,home,DET,under,9,0.5327102803738317,-114,0.5097620341748277,DET,SF,2023 REG,10,7,9,6,13,19,1,0,1,-1,1,1,1,1,1,1,0,0,0,0.49023796582517226,0.5097620341748277
89517,0.5652173913043479,0.4716981132075471,-130,112,0.5443521061454507,0.4556478938545493,away,PIT,over,9,0.5121951219512195,-105,0.48808156828023186,CHC,PIT,2023 REG,14,11,7,3,14,21,1,0,8,-8,1,1,1,0,0,0,0,0,0,0.48808156828023186,0.5119184317197681
89517,0.5652173913043479,0.4716981132075471,-130,112,0.5443521061454507,0.4556478938545493,home,CHC,under,9,0.5348837209302326,-115,0.5119184317197681,CHC,PIT,2023 REG,14,11,7,3,14,21,1,0,8,-8,1,1,1,0,0,0,0,0,0,0.48808156828023186,0.5119184317197681
89518,0.5475113122171946,0.49019607843137253,-121,104,0.5268660892829112,0.47313391071708877,away,BOS,over,7.5,0.5,100,0.4772727272727273,BAL,BOS,2023 REG,4,2,3,0,2,7,1,0,2,-2,0,0,0,0,0,0,0,0,0,0.4772727272727273,0.5227272727272727
89518,0.5475113122171946,0.49019607843137253,-121,104,0.5268660892829112,0.47313391071708877,home,BAL,under,7.5,0.5454545454545454,-120,0.5227272727272727,BAL,BOS,2023 REG,4,2,3,0,2,7,1,0,2,-2,0,0,0,0,0,0,0,0,0,0.4772727272727273,0.5227272727272727
89519,0.6415770609318996,0.3921568627450981,-179,155,0.6199341493255103,0.3800658506744897,away,LAA,over,8.5,0.5260663507109005,-111,0.5010269332605688,HOU,LAA,2023 REG,15,11,7,3,14,22,1,0,8,-8,1,1,1,0,0,0,0,0,0,0.5010269332605688,0.4989730667394312
89519,0.6415770609318996,0.3921568627450981,-179,155,0.6199341493255103,0.3800658506744897,home,HOU,under,8.5,0.5215311004784688,-109,0.4989730667394312,HOU,LAA,2023 REG,15,11,7,3,14,22,1,0,8,-8,1,1,1,0,0,0,0,0,0,0.5010269332605688,0.4989730667394312
89520,0.373134328358209,0.6610169491525424,168,-195,0.36039131436166,0.6396086856383401,away,CHC,over,8,0.5073891625615764,-103,0.4837652908580103,OAK,CHC,2023 REG,2,0,8,4,4,10,0,1,-4,4,0,0,0,0,0,0,0,0,0,0.4837652908580103,0.5162347091419897
89520,0.373134328358209,0.6610169491525424,168,-195,0.36039131436166,0.6396086856383401,home,OAK,under,8,0.5391705069124424,-117,0.5162347091419897,OAK,CHC,2023 REG,2,0,8,4,4,10,0,1,-4,4,0,0,0,0,0,0,0,0,0,0.4837652908580103,0.5162347091419897
89522,0.574468085106383,0.4672897196261683,-135,114,0.550479558983428,0.44952044101657196,away,CIN,over,9,0.5,100,0.4772727272727273,MIL,CIN,2023 REG,9,3,6,0,3,15,1,0,3,-3,0,0,0,0,0,0,0,0,0,0.4772727272727273,0.5227272727272727
89522,0.574468085106383,0.4672897196261683,-135,114,0.550479558983428,0.44952044101657196,home,MIL,under,9,0.5454545454545454,-120,0.5227272727272727,MIL,CIN,2023 REG,9,3,6,0,3,15,1,0,3,-3,0,0,0,0,0,0,0,0,0,0.4772727272727273,0.5227272727272727
89523,0.5633187772925764,0.47619047619047616,-129,110,0.5410624729287608,0.45893752707123925,away,BOS,over,8.5,0.5121951219512195,-105,0.48808156828023186,BAL,BOS,2023 REG,11,6,7,2,8,18,1,0,4,-4,1,1,0,0,0,0,0,0,0,0.48808156828023186,0.5119184317197681
89523,0.5633187772925764,0.47619047619047616,-129,110,0.5410624729287608,0.45893752707123925,home,BAL,under,8.5,0.5348837209302326,-115,0.5119184317197681,BAL,BOS,2023 REG,11,6,7,2,8,18,1,0,4,-4,1,1,0,0,0,0,0,0,0,0.48808156828023186,0.5119184317197681
89524,0.613899613899614,0.4184100418410042,-159,139,0.5940647287152191,0.4059352712847809,away,SEA,over,8,0.5305164319248826,-113,0.5053568787472517,TEX,SEA,2023 REG,15,12,8,3,15,23,1,0,9,-9,1,1,1,0,0,0,0,0,0,0.5053568787472517,0.49464312125274834
89524,0.613899613899614,0.4184100418410042,-159,139,0.5940647287152191,0.4059352712847809,home,TEX,under,8,0.5169082125603864,-107,0.49464312125274834,TEX,SEA,2023 REG,15,12,8,3,15,23,1,0,9,-9,1,1,1,0,0,0,0,0,0,0.5053568787472517,0.49464312125274834
89525,0.4347826086956522,0.6031746031746031,130,-152,0.418279473099889,0.581720526900111,away,CIN,over,7.5,0.5283018867924528,-112,0.5044173060022736,OAK,CIN,2023 REG,7,2,9,3,5,16,0,1,-1,1,1,1,0,0,0,0,0,0,0,0.5044173060022736,0.49558269399772636
89525,0.4347826086956522,0.6031746031746031,130,-152,0.418279473099889,0.581720526900111,home,OAK,under,7.5,0.5169082125603864,-107,0.49558269399772636,OAK,CIN,2023 REG,7,2,9,3,5,16,0,1,-1,1,1,1,0,0,0,0,0,0,0,0.5044173060022736,0.49558269399772636
89526,0.45454545454545453,0.5815899581589958,120,-139,0.43812026695252254,0.5618797330474774,away,ATL,over,7.5,0.5121951219512195,-105,0.48808156828023186,SD,ATL,2023 REG,4,1,8,8,9,12,0,1,-7,7,1,0,0,0,0,0,0,0,0,0.48808156828023186,0.5119184317197681
89526,0.45454545454545453,0.5815899581589958,120,-139,0.43812026695252254,0.5618797330474774,home,SD,under,7.5,0.5348837209302326,-115,0.5119184317197681,SD,ATL,2023 REG,4,1,8,8,9,12,0,1,-7,7,1,0,0,0,0,0,0,0,0,0.48808156828023186,0.5119184317197681
89527,0.4347826086956522,0.607843137254902,130,-155,0.41624967567367205,0.583750324326328,away,ARI,over,8.5,0.5098039215686274,-104,0.48483656587239576,MIN,ARI,2023 REG,6,5,11,3,8,17,1,0,2,-2,1,1,1,0,0,0,0,0,0,0.48483656587239576,0.5151634341276042
89527,0.4347826086956522,0.607843137254902,130,-155,0.41624967567367205,0.583750324326328,home,MIN,under,8.5,0.5391705069124424,-117,0.5151634341276042,MIN,ARI,2023 REG,6,5,11,3,8,17,1,0,2,-2,1,1,1,0,0,0,0,0,0,0.48483656587239576,0.5151634341276042
89528,0.5918367346938775,0.4484304932735426,-145,123,0.5680051099784656,0.43199489002153435,away,MIL,over,9,0.5348837209302326,-115,0.5097020142727117,PHI,MIL,2023 REG,7,3,10,5,8,17,0,1,-2,2,1,1,1,0,0,0,0,0,0,0.5097020142727117,0.49029798572728833
89528,0.5918367346938775,0.4484304932735426,-145,123,0.5680051099784656,0.43199489002153435,home,PHI,under,9,0.5121951219512195,-105,0.49029798572728833,PHI,MIL,2023 REG,7,3,10,5,8,17,0,1,-2,2,1,1,1,0,0,0,0,0,0,0.5097020142727117,0.49029798572728833
89529,0.6527777777777778,0.3921568627450981,-188,155,0.6234454429920115,0.37655455700798846,away,STL,over,11,0.5238095238095238,-110,0.4988662131519274,BAL,STL,2023 REG,9,2,9,5,7,18,0,1,-3,3,1,1,0,0,0,0,0,0,0,0.4988662131519274,0.5011337868480725
89529,0.6527777777777778,0.3921568627450981,-188,155,0.6234454429920115,0.37655455700798846,home,BAL,under,11,0.5238095238095238,-110,0.5011337868480725,BAL,STL,2023 REG,9,2,9,5,7,18,0,1,-3,3,1,1,0,0,0,0,0,0,0,0.4988662131519274,0.5011337868480725
89530,0.4347826086956522,0.6000000000000001,130,-150,0.4196597353497164,0.5803402646502835,away,ATL,over,7.5,0.5145631067961165,-106,0.4913668392989033,TEX,ATL,2023 REG,7,5,8,6,11,15,0,1,-1,1,1,1,1,1,1,0,0,0,0,0.4913668392989033,0.5086331607010968
89530,0.4347826086956522,0.6000000000000001,130,-150,0.4196597353497164,0.5803402646502835,home,TEX,under,7.5,0.5305164319248826,-113,0.5086331607010968,TEX,ATL,2023 REG,7,5,8,6,11,15,0,1,-1,1,1,1,1,1,1,0,0,0,0,0.4913668392989033,0.5086331607010968
89531,0.5433789954337899,0.5,-119,100,0.5198077604720502,0.48019223952794976,away,PHI,over,9,0.5454545454545454,-120,0.5206611570247933,SD,PHI,2023 REG,10,7,16,9,16,26,0,1,-2,2,1,1,1,1,1,1,1,0,0,0.5206611570247933,0.4793388429752067
89531,0.5433789954337899,0.5,-119,100,0.5198077604720502,0.48019223952794976,home,SD,under,9,0.5,100,0.4793388429752067,SD,PHI,2023 REG,10,7,16,9,16,26,0,1,-2,2,1,1,1,1,1,1,1,0,0,0.5206611570247933,0.4793388429752067
89532,0.5780590717299579,0.4587155963302753,-137,118,0.5568011412478822,0.44319885875211784,away,MIL,over,11,0.5283018867924528,-112,0.5044173060022736,CIN,MIL,2023 REG,7,3,9,4,7,16,0,1,-1,1,1,1,1,0,0,0,0,0,0,0.5044173060022736,0.49558269399772636
89532,0.5780590717299579,0.4587155963302753,-137,118,0.5568011412478822,0.44319885875211784,home,CIN,under,11,0.5169082125603864,-107,0.49558269399772636,CIN,MIL,2023 REG,7,3,9,4,7,16,0,1,-1,1,1,1,1,0,0,0,0,0,0,0.5044173060022736,0.49558269399772636
89533,0.574468085106383,0.46511627906976744,-135,115,0.5517281312179562,0.44827186878204384,away,CWS,over,8.5,0.5370370370370371,-116,0.5118817074154765,PIT,CWS,2023 REG,2,1,6,0,1,8,1,0,1,-1,0,0,0,0,0,0,0,0,0,0.5118817074154765,0.48811829258452355
89533,0.574468085106383,0.46511627906976744,-135,115,0.5517281312179562,0.44827186878204384,home,PIT,under,8.5,0.5098039215686274,-104,0.48811829258452355,PIT,CWS,2023 REG,2,1,6,0,1,8,1,0,1,-1,0,0,0,0,0,0,0,0,0,0.5118817074154765,0.48811829258452355
89534,0.6323529411764706,0.40322580645161293,-172,148,0.6098546154704766,0.3901453845295234,away,ARI,over,9,0.5433789954337899,-119,0.5184560714286826,LAD,ARI,2023 REG,11,7,6,0,7,17,1,0,7,-7,0,0,0,0,0,0,0,0,0,0.5184560714286826,0.48154392857131745
89534,0.6323529411764706,0.40322580645161293,-172,148,0.6098546154704766,0.3901453845295234,home,LAD,under,9,0.5024875621890548,-101,0.48154392857131745,LAD,ARI,2023 REG,11,7,6,0,7,17,1,0,7,-7,0,0,0,0,0,0,0,0,0,0.5184560714286826,0.48154392857131745
89535,0.4854368932038835,0.5555555555555556,106,-125,0.465537646233282,0.534462353766718,away,TOR,over,8.5,0.5215311004784688,-109,0.4978845547971712,CLE,TOR,2023 REG,5,1,5,3,4,10,0,1,-2,2,1,0,0,0,0,0,0,0,0,0.4978845547971712,0.5021154452028288
89535,0.4854368932038835,0.5555555555555556,106,-125,0.465537646233282,0.534462353766718,home,CLE,under,8.5,0.5238095238095238,-110,0.5021154452028288,CLE,TOR,2023 REG,5,1,5,3,4,10,0,1,-2,2,1,0,0,0,0,0,0,0,0,0.4978845547971712,0.5021154452028288
89536,0.5652173913043479,0.4739336492890995,-130,111,0.5430885422732689,0.45691145772673114,away,SEA,over,9.5,0.5098039215686274,-104,0.4870219861770517,BOS,SEA,2023 REG,16,12,5,3,15,21,1,0,9,-9,1,1,1,0,0,0,0,0,0,0.4870219861770517,0.5129780138229483
89536,0.5652173913043479,0.4739336492890995,-130,111,0.5430885422732689,0.45691145772673114,home,BOS,under,9.5,0.5348837209302326,-115,0.5129780138229483,BOS,SEA,2023 REG,16,12,5,3,15,21,1,0,9,-9,1,1,1,0,0,0,0,0,0,0.4870219861770517,0.5129780138229483
89537,0.5983935742971888,0.4366812227074236,-149,129,0.5774050411498505,0.4225949588501495,away,COL,over,9,0.5192307692307692,-108,0.49455035168025013,KC,COL,2023 REG,4,2,8,0,2,12,1,0,2,-2,0,0,0,0,0,0,0,0,0,0.49455035168025013,0.5054496483197499
89537,0.5983935742971888,0.4366812227074236,-149,129,0.5774050411498505,0.4225949588501495,home,KC,under,9,0.5283018867924528,-112,0.5054496483197499,KC,COL,2023 REG,4,2,8,0,2,12,1,0,2,-2,0,0,0,0,0,0,0,0,0,0.49455035168025013,0.5054496483197499
89538,0.5918367346938775,0.4444444444444444,-145,125,0.5703642001018094,0.42963579989819056,away,BAL,over,8.5,0.5283018867924528,-112,0.5031902949311281,TEX,BAL,2023 REG,7,2,8,7,9,15,0,1,-5,5,1,1,0,0,0,0,0,0,0,0.5031902949311281,0.4968097050688719
89538,0.5918367346938775,0.4444444444444444,-145,125,0.5703642001018094,0.42963579989819056,home,TEX,under,8.5,0.5192307692307692,-108,0.4968097050688719,TEX,BAL,2023 REG,7,2,8,7,9,15,0,1,-5,5,1,1,0,0,0,0,0,0,0,0.5031902949311281,0.4968097050688719
89539,0.5238095238095238,0.5098039215686274,-110,-104,0.5062024809923971,0.49379751900760294,away,NYM,over,8.5,0.5073891625615764,-103,0.4826927225525911,MIA,NYM,2023 REG,10,2,12,6,8,22,0,1,-4,4,1,1,0,0,0,0,0,0,0,0.4826927225525911,0.5173072774474089
89539,0.5238095238095238,0.5098039215686274,-110,-104,0.5062024809923971,0.49379751900760294,home,MIA,under,8.5,0.5412844036697247,-118,0.5173072774474089,MIA,NYM,2023 REG,10,2,12,6,8,22,0,1,-4,4,1,1,0,0,0,0,0,0,0,0.4826927225525911,0.5173072774474089
89540,0.607843137254902,0.43103448275862066,-155,132,0.5842116427368785,0.41578835726312147,away,ARI,over,8,0.5192307692307692,-108,0.49455035168025013,LAD,ARI,2023 REG,11,7,8,4,11,19,1,0,3,-3,1,1,1,1,0,0,0,0,0,0.49455035168025013,0.5054496483197499
89540,0.607843137254902,0.43103448275862066,-155,132,0.5842116427368785,0.41578835726312147,home,LAD,under,8,0.5283018867924528,-112,0.5054496483197499,LAD,ARI,2023 REG,11,7,8,4,11,19,1,0,3,-3,1,1,1,1,0,0,0,0,0,0.49455035168025013,0.5054496483197499
89541,0.43859649122807015,0.6031746031746031,128,-152,0.4202758357883012,0.5797241642116988,away,LAA,over,9,0.5391705069124424,-117,0.5127649394825569,KC,LAA,2023 REG,4,0,9,3,3,13,0,1,-3,3,0,0,0,0,0,0,0,0,0,0.5127649394825569,0.48723506051744314
89541,0.43859649122807015,0.6031746031746031,128,-152,0.4202758357883012,0.5797241642116988,home,KC,under,9,0.5098039215686274,-104,0.48723506051744314,KC,LAA,2023 REG,4,0,9,3,3,13,0,1,-3,3,0,0,0,0,0,0,0,0,0,0.5127649394825569,0.48723506051744314
89542,0.4,0.6363636363636364,150,-175,0.3854545454545455,0.6145454545454545,away,STL,over,13,0.5348837209302326,-115,0.5109810284308424,COL,STL,2023 REG,7,4,11,7,11,18,0,1,-3,3,1,1,1,1,0,0,0,0,0,0.5109810284308424,0.48901897156915763
89542,0.4,0.6363636363636364,150,-175,0.3854545454545455,0.6145454545454545,home,COL,under,13,0.5098039215686274,-104,0.48901897156915763,COL,STL,2023 REG,7,4,11,7,11,18,0,1,-3,3,1,1,1,1,0,0,0,0,0,0.5109810284308424,0.48901897156915763
89543,0.6610169491525424,0.3802281368821293,-195,163,0.6337532482143695,0.3662467517856305,away,WSH,over,9,0.5348837209302326,-115,0.5097020142727117,PHI,WSH,2023 REG,8,4,8,5,9,16,0,1,-1,1,1,1,1,1,0,0,0,0,0,0.5097020142727117,0.49029798572728833
89543,0.6610169491525424,0.3802281368821293,-195,163,0.6337532482143695,0.3662467517856305,home,PHI,under,9,0.5121951219512195,-105,0.49029798572728833,PHI,WSH,2023 REG,8,4,8,5,9,16,0,1,-1,1,1,1,1,1,0,0,0,0,0,0.5097020142727117,0.49029798572728833
89544,0.574468085106383,0.46511627906976744,-135,115,0.5517281312179562,0.44827186878204384,away,LAA,over,9.5,0.5348837209302326,-115,0.5097020142727117,TEX,LAA,2023 REG,9,3,8,7,10,17,0,1,-4,4,1,1,1,0,0,0,0,0,0,0.5097020142727117,0.49029798572728833
89544,0.574468085106383,0.46511627906976744,-135,115,0.5517281312179562,0.44827186878204384,home,TEX,under,9.5,0.5121951219512195,-105,0.49029798572728833,TEX,LAA,2023 REG,9,3,8,7,10,17,0,1,-4,4,1,1,1,0,0,0,0,0,0,0.5097020142727117,0.49029798572728833
89545,0.45454545454545453,0.5867768595041323,120,-142,0.43576258452291505,0.564237415477085,away,CLE,over,9,0.5238095238095238,-110,0.5000596729920038,KC,CLE,2023 REG,2,1,7,2,3,9,0,1,-1,1,1,0,0,0,0,0,0,0,0,0.5000596729920038,0.4999403270079962
89545,0.45454545454545453,0.5867768595041323,120,-142,0.43576258452291505,0.564237415477085,home,KC,under,9,0.5215311004784688,-109,0.4999403270079962,KC,CLE,2023 REG,2,1,7,2,3,9,0,1,-1,1,1,0,0,0,0,0,0,0,0,0.5000596729920038,0.4999403270079962
89546,0.43859649122807015,0.5967741935483871,128,-148,0.4230830329927819,0.5769169670072181,away,CIN,over,8,0.5327102803738317,-114,0.5075272610403079,OAK,CIN,2023 REG,9,5,12,4,9,21,1,0,1,-1,1,1,1,1,0,0,0,0,0,0.5075272610403079,0.4924727389596921
89546,0.43859649122807015,0.5967741935483871,128,-148,0.4230830329927819,0.5769169670072181,home,OAK,under,8,0.5145631067961165,-106,0.4924727389596921,OAK,CIN,2023 REG,9,5,12,4,9,21,1,0,1,-1,1,1,1,1,0,0,0,0,0,0.5075272610403079,0.4924727389596921
89547,0.4716981132075471,0.5652173913043479,112,-130,0.4542851393811816,0.5457148606188185,away,ARI,over,12,0.5121951219512195,-105,0.48808156828023186,COL,ARI,2023 REG,16,12,7,4,16,23,1,0,8,-8,1,1,1,1,0,0,0,0,0,0.48808156828023186,0.5119184317197681
89547,0.4716981132075471,0.5652173913043479,112,-130,0.4542851393811816,0.5457148606188185,home,COL,under,12,0.5348837209302326,-115,0.5119184317197681,COL,ARI,2023 REG,16,12,7,4,16,23,1,0,8,-8,1,1,1,1,0,0,0,0,0,0.48808156828023186,0.5119184317197681
89548,0.42372881355932196,0.6183206106870228,136,-162,0.40591126091256574,0.5940887390874343,away,NYM,over,9,0.5348837209302326,-115,0.5097020142727117,CIN,NYM,2023 REG,2,1,10,2,3,12,0,1,-1,1,1,0,0,0,0,0,0,0,0,0.5097020142727117,0.49029798572728833
89548,0.42372881355932196,0.6183206106870228,136,-162,0.40591126091256574,0.5940887390874343,home,CIN,under,9,0.5121951219512195,-105,0.49029798572728833,CIN,NYM,2023 REG,2,1,10,2,3,12,0,1,-1,1,1,0,0,0,0,0,0,0,0,0.5097020142727117,0.49029798572728833
89549,0.45454545454545453,0.5884773662551441,120,-143,0.43498962690881876,0.5650103730911813,away,ATL,over,8.5,0.5238095238095238,-110,0.4988662131519274,MIA,ATL,2023 REG,12,6,18,14,20,30,0,1,-8,8,1,1,1,1,1,1,0,0,0,0.4988662131519274,0.5011337868480725
89549,0.45454545454545453,0.5884773662551441,120,-143,0.43498962690881876,0.5650103730911813,home,MIA,under,8.5,0.5238095238095238,-110,0.5011337868480725,MIA,ATL,2023 REG,12,6,18,14,20,30,0,1,-8,8,1,1,1,1,1,1,0,0,0,0.4988662131519274,0.5011337868480725
89550,0.5918367346938775,0.4464285714285714,-145,124,0.5691899208663057,0.4308100791336943,away,WSH,over,9.5,0.5121951219512195,-105,0.48808156828023186,PIT,WSH,2023 REG,11,7,8,6,13,19,1,0,1,-1,1,1,1,1,1,1,0,0,0,0.48808156828023186,0.5119184317197681
89550,0.5918367346938775,0.4464285714285714,-145,124,0.5691899208663057,0.4308100791336943,home,PIT,under,9.5,0.5348837209302326,-115,0.5119184317197681,PIT,WSH,2023 REG,11,7,8,6,13,19,1,0,1,-1,1,1,1,1,1,1,0,0,0,0.48808156828023186,0.5119184317197681
89551,0.5454545454545454,0.5,-120,100,0.5206611570247933,0.4793388429752067,away,PHI,over,8.5,0.5305164319248826,-113,0.5053568787472517,NYM,PHI,2023 REG,2,1,12,9,10,14,0,1,-8,8,1,0,0,0,0,0,0,0,0,0.5053568787472517,0.49464312125274834
89551,0.5454545454545454,0.5,-120,100,0.5206611570247933,0.4793388429752067,home,NYM,under,8.5,0.5169082125603864,-107,0.49464312125274834,NYM,PHI,2023 REG,2,1,12,9,10,14,0,1,-8,8,1,0,0,0,0,0,0,0,0,0.5053568787472517,0.49464312125274834
89552,0.574468085106383,0.46511627906976744,-135,115,0.5517281312179562,0.44827186878204384,away,STL,over,9,0.5238095238095238,-110,0.4988662131519274,TEX,STL,2023 REG,4,0,4,1,1,8,0,1,-1,1,0,0,0,0,0,0,0,0,0,0.4988662131519274,0.5011337868480725
89552,0.574468085106383,0.46511627906976744,-135,115,0.5517281312179562,0.44827186878204384,home,TEX,under,9,0.5238095238095238,-110,0.5011337868480725,TEX,STL,2023 REG,4,0,4,1,1,8,0,1,-1,1,0,0,0,0,0,0,0,0,0,0.4988662131519274,0.5011337868480725
89554,0.5305164319248826,0.5121951219512195,-113,-105,0.5078572507605655,0.49214274923943446,away,SF,over,9,0.5,100,0.47935779816513757,STL,SF,2023 REG,7,3,17,11,14,24,0,1,-8,8,1,1,1,0,0,0,0,0,0,0.47935779816513757,0.5206422018348624
89554,0.5305164319248826,0.5121951219512195,-113,-105,0.5078572507605655,0.49214274923943446,home,STL,under,9,0.5412844036697247,-118,0.5206422018348624,STL,SF,2023 REG,7,3,17,11,14,24,0,1,-8,8,1,1,1,0,0,0,0,0,0,0.47935779816513757,0.5206422018348624
89555,0.4444444444444444,0.5884773662551441,125,-143,0.4298125285779606,0.5701874714220394,away,NYY,over,7.5,0.5238095238095238,-110,0.5024811857109994,BAL,NYY,2023 REG,6,3,9,5,8,15,0,1,-2,2,1,1,1,0,0,0,0,0,0,0.5024811857109994,0.4975188142890006
89555,0.4444444444444444,0.5884773662551441,125,-143,0.4298125285779606,0.5701874714220394,home,BAL,under,7.5,0.5169082125603864,-107,0.4975188142890006,BAL,NYY,2023 REG,6,3,9,5,8,15,0,1,-2,2,1,1,1,0,0,0,0,0,0,0.5024811857109994,0.4975188142890006
89556,0.6000000000000001,0.4347826086956522,-150,130,0.5791304347826086,0.4208695652173914,away,PIT,over,8.5,0.5433789954337899,-119,0.5198077604720502,BOS,PIT,2023 REG,5,1,9,4,5,14,0,1,-3,3,1,0,0,0,0,0,0,0,0,0.5198077604720502,0.48019223952794976
89556,0.6000000000000001,0.4347826086956522,-150,130,0.5791304347826086,0.4208695652173914,home,BOS,under,8.5,0.5,100,0.48019223952794976,BOS,PIT,2023 REG,5,1,9,4,5,14,0,1,-3,3,1,0,0,0,0,0,0,0,0,0.5198077604720502,0.48019223952794976
89557,0.5098039215686274,0.5260663507109005,-104,-111,0.4915171160927897,0.5084828839072103,away,DET,over,8.5,0.5391705069124424,-117,0.5140669063204599,WSH,DET,2023 REG,7,6,9,8,14,16,0,1,-2,2,1,1,1,1,1,1,0,0,0,0.5140669063204599,0.4859330936795401
89557,0.5098039215686274,0.5260663507109005,-104,-111,0.4915171160927897,0.5084828839072103,home,WSH,under,8.5,0.5073891625615764,-103,0.4859330936795401,WSH,DET,2023 REG,7,6,9,8,14,16,0,1,-2,2,1,1,1,1,1,1,0,0,0,0.5140669063204599,0.4859330936795401
89558,0.5454545454545454,0.5,-120,100,0.5206611570247933,0.4793388429752067,away,SF,over,8.5,0.5169082125603864,-107,0.49239402434819424,LAD,SF,2023 REG,9,3,8,7,10,17,0,1,-4,4,1,1,1,0,0,0,0,0,0,0.49239402434819424,0.5076059756518058
89558,0.5454545454545454,0.5,-120,100,0.5206611570247933,0.4793388429752067,home,LAD,under,8.5,0.5305164319248826,-113,0.5076059756518058,LAD,SF,2023 REG,9,3,8,7,10,17,0,1,-4,4,1,1,1,0,0,0,0,0,0,0.49239402434819424,0.5076059756518058
89559,0.504950495049505,0.5348837209302326,-102,-115,0.48483618797062755,0.5151638120293724,away,PIT,over,8.5,0.5121951219512195,-105,0.48808156828023186,MIL,PIT,2023 REG,6,5,6,0,5,12,1,0,5,-5,0,0,0,0,0,0,0,0,0,0.48808156828023186,0.5119184317197681
89559,0.504950495049505,0.5348837209302326,-102,-115,0.48483618797062755,0.5151638120293724,home,MIL,under,8.5,0.5348837209302326,-115,0.5119184317197681,MIL,PIT,2023 REG,6,5,6,0,5,12,1,0,5,-5,0,0,0,0,0,0,0,0,0,0.48808156828023186,0.5119184317197681
89560,0.5348837209302326,0.5098039215686274,-115,-104,0.5109810284308424,0.48901897156915763,away,CHC,over,9,0.5215311004784688,-109,0.4978845547971712,NYM,CHC,2023 REG,12,11,9,2,13,21,1,0,9,-9,1,1,0,0,0,0,0,0,0,0.4978845547971712,0.5021154452028288
89560,0.5348837209302326,0.5098039215686274,-115,-104,0.5109810284308424,0.48901897156915763,home,NYM,under,9,0.5238095238095238,-110,0.5021154452028288,NYM,CHC,2023 REG,12,11,9,2,13,21,1,0,9,-9,1,1,0,0,0,0,0,0,0,0.4978845547971712,0.5021154452028288
89561,0.6000000000000001,0.4347826086956522,-150,130,0.5791304347826086,0.4208695652173914,away,PIT,over,9.5,0.5121951219512195,-105,0.48808156828023186,BOS,PIT,2023 REG,10,6,9,7,13,19,0,1,-1,1,1,1,1,1,1,1,0,0,0,0.48808156828023186,0.5119184317197681
89561,0.6000000000000001,0.4347826086956522,-150,130,0.5791304347826086,0.4208695652173914,home,BOS,under,9.5,0.5348837209302326,-115,0.5119184317197681,BOS,PIT,2023 REG,10,6,9,7,13,19,0,1,-1,1,1,1,1,1,1,1,0,0,0,0.48808156828023186,0.5119184317197681
89562,0.41152263374485604,0.6254681647940076,143,-167,0.39630008290581753,0.6036999170941825,away,ATL,over,10,0.5121951219512195,-105,0.48808156828023186,PIT,ATL,2023 REG,9,6,14,8,14,23,0,1,-2,2,1,1,1,1,1,1,0,0,0,0.48808156828023186,0.5119184317197681
89562,0.41152263374485604,0.6254681647940076,143,-167,0.39630008290581753,0.6036999170941825,home,PIT,under,10,0.5348837209302326,-115,0.5119184317197681,PIT,ATL,2023 REG,9,6,14,8,14,23,0,1,-2,2,1,1,1,1,1,1,0,0,0,0.48808156828023186,0.5119184317197681
89563,0.7058823529411764,0.3278688524590164,-240,205,0.6820579726586873,0.3179420273413127,away,COL,over,8.5,0.5073891625615764,-103,0.4837652908580103,SD,COL,2023 REG,10,8,6,4,12,16,1,0,4,-4,1,1,1,1,0,0,0,0,0,0.4837652908580103,0.5162347091419897
89563,0.7058823529411764,0.3278688524590164,-240,205,0.6820579726586873,0.3179420273413127,home,SD,under,8.5,0.5391705069124424,-117,0.5162347091419897,SD,COL,2023 REG,10,8,6,4,12,16,1,0,4,-4,1,1,1,1,0,0,0,0,0,0.4837652908580103,0.5162347091419897
89565,0.6742671009771988,0.36764705882352944,-207,172,0.6460057619584667,0.3539942380415333,away,STL,over,9.5,0.504950495049505,-102,0.48054649490447493,TB,STL,2023 REG,4,2,11,5,7,15,0,1,-3,3,1,1,0,0,0,0,0,0,0,0.48054649490447493,0.5194535050955251
89565,0.6742671009771988,0.36764705882352944,-207,172,0.6460057619584667,0.3539942380415333,home,TB,under,9.5,0.5433789954337899,-119,0.5194535050955251,TB,STL,2023 REG,4,2,11,5,7,15,0,1,-3,3,1,1,0,0,0,0,0,0,0,0.48054649490447493,0.5194535050955251
89566,0.6363636363636364,0.4065040650406504,-175,146,0.6090841900154538,0.3909158099845462,away,ARI,over,7.5,0.4926108374384236,103,0.4718421738975501,LAD,ARI,2023 REG,12,8,4,2,10,16,1,0,6,-6,1,1,0,0,0,0,0,0,0,0.4718421738975501,0.5281578261024499
89566,0.6363636363636364,0.4065040650406504,-175,146,0.6090841900154538,0.3909158099845462,home,LAD,under,7.5,0.5495495495495495,-122,0.5281578261024499,LAD,ARI,2023 REG,12,8,4,2,10,16,1,0,6,-6,1,1,0,0,0,0,0,0,0,0.4718421738975501,0.5281578261024499
89567,0.5594713656387665,0.4807692307692307,-127,108,0.5369579042122659,0.46304209578773414,away,MIN,over,8.5,0.5412844036697247,-118,0.5189377998484975,TOR,MIN,2023 REG,9,4,12,9,13,21,0,1,-5,5,1,1,1,1,0,0,0,0,0,0.5189377998484975,0.4810622001515025
89567,0.5594713656387665,0.4807692307692307,-127,108,0.5369579042122659,0.46304209578773414,home,TOR,under,8.5,0.5,100,0.4810622001515025,TOR,MIN,2023 REG,9,4,12,9,13,21,0,1,-5,5,1,1,1,1,0,0,0,0,0,0.5189377998484975,0.4810622001515025
89568,0.5901639344262295,0.4444444444444444,-144,125,0.569739317387799,0.43026068261220096,away,LAA,over,9.5,0.5391705069124424,-117,0.5140669063204599,BAL,LAA,2023 REG,9,7,8,3,10,17,1,0,4,-4,1,1,1,0,0,0,0,0,0,0.5140669063204599,0.4859330936795401
89568,0.5901639344262295,0.4444444444444444,-144,125,0.569739317387799,0.43026068261220096,home,BAL,under,9.5,0.5073891625615764,-103,0.4859330936795401,BAL,LAA,2023 REG,9,7,8,3,10,17,1,0,4,-4,1,1,1,0,0,0,0,0,0,0.5140669063204599,0.4859330936795401
89569,0.5555555555555556,0.48780487804878053,-125,105,0.5314664257753688,0.46853357422463116,away,CIN,over,9,0.5391705069124424,-117,0.5140669063204599,ARI,CIN,2023 REG,8,5,4,2,7,12,1,0,3,-3,1,1,0,0,0,0,0,0,0,0.5140669063204599,0.4859330936795401
89569,0.5555555555555556,0.48780487804878053,-125,105,0.5314664257753688,0.46853357422463116,home,ARI,under,9,0.5073891625615764,-103,0.4859330936795401,ARI,CIN,2023 REG,8,5,4,2,7,12,1,0,3,-3,1,1,0,0,0,0,0,0,0,0.5140669063204599,0.4859330936795401
89570,0.6774193548387096,0.3623188405797102,-210,176,0.6504999321359091,0.34950006786409094,away,WSH,over,8.5,0.5169082125603864,-107,0.4946943078742622,NYM,WSH,2023 REG,5,0,11,5,5,16,0,1,-5,5,0,0,0,0,0,0,0,0,0,0.4946943078742622,0.5053056921257377
89570,0.6774193548387096,0.3623188405797102,-210,176,0.6504999321359091,0.34950006786409094,home,NYM,under,8.5,0.5260663507109005,-111,0.5053056921257377,NYM,WSH,2023 REG,5,0,11,5,5,16,0,1,-5,5,0,0,0,0,0,0,0,0,0,0.4946943078742622,0.5053056921257377
89571,0.5121951219512195,0.5238095238095238,-105,-110,0.4937537180249852,0.5062462819750149,away,NYM,over,8.5,0.5121951219512195,-105,0.48919479393107135,CHC,NYM,2023 REG,6,1,15,10,11,21,0,1,-9,9,1,0,0,0,0,0,0,0,0,0.48919479393107135,0.5108052060689287
89571,0.5121951219512195,0.5238095238095238,-105,-110,0.4937537180249852,0.5062462819750149,home,CHC,under,8.5,0.5327102803738317,-114,0.5108052060689287,CHC,NYM,2023 REG,6,1,15,10,11,21,0,1,-9,9,1,0,0,0,0,0,0,0,0,0.48919479393107135,0.5108052060689287
89572,0.48780487804878053,0.5555555555555556,105,-125,0.4666534470222751,0.5333465529777248,away,DET,over,8.5,0.5454545454545454,-120,0.5206611570247933,LAA,DET,2023 REG,6,4,6,5,9,12,0,1,-1,1,1,1,1,1,0,0,0,0,0,0.5206611570247933,0.4793388429752067
89572,0.48780487804878053,0.5555555555555556,105,-125,0.4666534470222751,0.5333465529777248,home,LAA,under,8.5,0.5,100,0.4793388429752067,LAA,DET,2023 REG,6,4,6,5,9,12,0,1,-1,1,1,1,1,1,0,0,0,0,0,0.5206611570247933,0.4793388429752067
89573,0.4081632653061224,0.6296296296296295,145,-170,0.39273759390377466,0.6072624060962253,away,LAA,over,7.5,0.5073891625615764,-103,0.4837652908580103,SEA,LAA,2023 REG,8,3,5,4,7,13,0,1,-1,1,1,1,1,0,0,0,0,0,0,0.4837652908580103,0.5162347091419897
89573,0.4081632653061224,0.6296296296296295,145,-170,0.39273759390377466,0.6072624060962253,home,SEA,under,7.5,0.5391705069124424,-117,0.5162347091419897,SEA,LAA,2023 REG,8,3,5,4,7,13,0,1,-1,1,1,1,1,0,0,0,0,0,0,0.4837652908580103,0.5162347091419897
89574,0.5475113122171946,0.48780487804878053,-121,105,0.5281752985421585,0.4718247014578415,away,ATL,over,8,0.5121951219512195,-105,0.48808156828023186,MIA,ATL,2023 REG,4,0,9,6,6,13,0,1,-6,6,0,0,0,0,0,0,0,0,0,0.48808156828023186,0.5119184317197681
89574,0.5475113122171946,0.48780487804878053,-121,105,0.5281752985421585,0.4718247014578415,home,MIA,under,8,0.5348837209302326,-115,0.5119184317197681,MIA,ATL,2023 REG,4,0,9,6,6,13,0,1,-6,6,0,0,0,0,0,0,0,0,0,0.48808156828023186,0.5119184317197681
89575,0.4166666666666667,0.6226415094339623,140,-165,0.4002882599580712,0.5997117400419287,away,TEX,over,8.5,0.5454545454545454,-120,0.5206611570247933,LAA,TEX,2023 REG,3,0,10,5,5,13,0,1,-5,5,0,0,0,0,0,0,0,0,0,0.5206611570247933,0.4793388429752067
89575,0.4166666666666667,0.6226415094339623,140,-165,0.4002882599580712,0.5997117400419287,home,LAA,under,8.5,0.5,100,0.4793388429752067,LAA,TEX,2023 REG,3,0,10,5,5,13,0,1,-5,5,0,0,0,0,0,0,0,0,0,0.5206611570247933,0.4793388429752067
89576,0.4504504504504505,0.5901639344262295,122,-144,0.43215568248798203,0.567844317512018,away,CWS,over,7,0.5391705069124424,-117,0.5140669063204599,MIN,CWS,2023 REG,4,3,8,4,7,12,0,1,-1,1,1,1,1,0,0,0,0,0,0,0.5140669063204599,0.4859330936795401
89576,0.4504504504504505,0.5901639344262295,122,-144,0.43215568248798203,0.567844317512018,home,MIN,under,7,0.5073891625615764,-103,0.4859330936795401,MIN,CWS,2023 REG,4,3,8,4,7,12,0,1,-1,1,1,1,1,0,0,0,0,0,0,0.5140669063204599,0.4859330936795401
89577,0.3968253968253968,0.6389891696750902,152,-177,0.3826132672617115,0.6173867327382885,away,ARI,over,7.5,0.5454545454545454,-120,0.5206611570247933,PIT,ARI,2023 REG,17,13,4,3,16,21,1,0,10,-10,1,1,1,0,0,0,0,0,0,0.5206611570247933,0.4793388429752067
89577,0.3968253968253968,0.6389891696750902,152,-177,0.3826132672617115,0.6173867327382885,home,PIT,under,7.5,0.5,100,0.4793388429752067,PIT,ARI,2023 REG,17,13,4,3,16,21,1,0,10,-10,1,1,1,0,0,0,0,0,0,0.5206611570247933,0.4793388429752067
89578,0.5901639344262295,0.45454545454545453,-144,120,0.5637780655249077,0.4362219344750923,away,MIA,over,8.5,0.5348837209302326,-115,0.5097020142727117,LAD,MIA,2023 REG,10,3,9,11,14,19,0,1,-8,8,1,1,1,0,0,0,0,0,0,0.5097020142727117,0.49029798572728833
89578,0.5901639344262295,0.45454545454545453,-144,120,0.5637780655249077,0.4362219344750923,home,LAD,under,8.5,0.5121951219512195,-105,0.49029798572728833,LAD,MIA,2023 REG,10,3,9,11,14,19,0,1,-8,8,1,1,1,0,0,0,0,0,0,0.5097020142727117,0.49029798572728833
89579,0.6183206106870228,0.4166666666666667,-162,140,0.5966872559874133,0.40331274401258665,away,CHC,over,8.5,0.5121951219512195,-105,0.48808156828023186,LAD,CHC,2023 REG,3,2,12,8,10,15,0,1,-6,6,1,1,0,0,0,0,0,0,0,0.48808156828023186,0.5119184317197681
89579,0.6183206106870228,0.4166666666666667,-162,140,0.5966872559874133,0.40331274401258665,home,LAD,under,8.5,0.5348837209302326,-115,0.5119184317197681,LAD,CHC,2023 REG,3,2,12,8,10,15,0,1,-6,6,1,1,0,0,0,0,0,0,0,0.48808156828023186,0.5119184317197681
89581,0.4291845493562232,0.609375,133,-156,0.4126353865423935,0.5873646134576065,away,TB,over,9.5,0.5121951219512195,-105,0.48808156828023186,ARI,TB,2023 REG,8,2,6,3,5,14,0,1,-1,1,1,1,0,0,0,0,0,0,0,0.48808156828023186,0.5119184317197681
89581,0.4291845493562232,0.609375,133,-156,0.4126353865423935,0.5873646134576065,home,ARI,under,9.5,0.5348837209302326,-115,0.5119184317197681,ARI,TB,2023 REG,8,2,6,3,5,14,0,1,-1,1,1,1,0,0,0,0,0,0,0,0.48808156828023186,0.5119184317197681
89582,0.5,0.5412844036697247,100,-118,0.47935779816513757,0.5206422018348624,away,LAD,over,9,0.5,100,0.4772727272727273,PHI,LAD,2023 REG,6,0,9,9,9,15,0,1,-9,9,0,0,0,0,0,0,0,0,0,0.4772727272727273,0.5227272727272727
89582,0.5,0.5412844036697247,100,-118,0.47935779816513757,0.5206422018348624,home,PHI,under,9,0.5454545454545454,-120,0.5227272727272727,PHI,LAD,2023 REG,6,0,9,9,9,15,0,1,-9,9,0,0,0,0,0,0,0,0,0,0.4772727272727273,0.5227272727272727
89583,0.6875,0.35714285714285715,-220,180,0.6568080357142857,0.3431919642857143,away,NYM,over,11,0.5305164319248826,-113,0.5066009958897986,ATL,NYM,2023 REG,9,3,5,2,5,14,1,0,1,-1,1,1,0,0,0,0,0,0,0,0.5066009958897986,0.49339900411020143
89583,0.6875,0.35714285714285715,-220,180,0.6568080357142857,0.3431919642857143,home,ATL,under,11,0.5145631067961165,-106,0.49339900411020143,ATL,NYM,2023 REG,9,3,5,2,5,14,1,0,1,-1,1,1,0,0,0,0,0,0,0,0.5066009958897986,0.49339900411020143
89584,0.7142857142857143,0.33112582781456956,-250,202,0.6818488984997972,0.31815110150020276,away,WSH,over,8,0.5,100,0.4772727272727273,BAL,WSH,2023 REG,9,5,6,1,6,15,1,0,4,-4,1,0,0,0,0,0,0,0,0,0.4772727272727273,0.5227272727272727
89584,0.7142857142857143,0.33112582781456956,-250,202,0.6818488984997972,0.31815110150020276,home,BAL,under,8,0.5454545454545454,-120,0.5227272727272727,BAL,WSH,2023 REG,9,5,6,1,6,15,1,0,4,-4,1,0,0,0,0,0,0,0,0,0.4772727272727273,0.5227272727272727
89585,0.6503496503496503,0.39370078740157477,-186,154,0.6217014635603921,0.37829853643960787,away,MIN,over,9,0.5391705069124424,-117,0.5127649394825569,TEX,MIN,2023 REG,9,7,13,9,16,22,0,1,-2,2,1,1,1,1,1,1,1,0,0,0.5127649394825569,0.48723506051744314
89585,0.6503496503496503,0.39370078740157477,-186,154,0.6217014635603921,0.37829853643960787,home,TEX,under,9,0.5098039215686274,-104,0.48723506051744314,TEX,MIN,2023 REG,9,7,13,9,16,22,0,1,-2,2,1,1,1,1,1,1,1,0,0,0.5127649394825569,0.48723506051744314
89586,0.30120481927710846,0.7361477572559366,232,-279,0.2899540432129382,0.7100459567870618,away,TB,over,8,0.5348837209302326,-115,0.5097020142727117,OAK,TB,2023 REG,7,3,13,6,9,20,0,1,-3,3,1,1,1,0,0,0,0,0,0,0.5097020142727117,0.49029798572728833
89586,0.30120481927710846,0.7361477572559366,232,-279,0.2899540432129382,0.7100459567870618,home,OAK,under,8,0.5121951219512195,-105,0.49029798572728833,OAK,TB,2023 REG,7,3,13,6,9,20,0,1,-3,3,1,1,1,0,0,0,0,0,0,0.5097020142727117,0.49029798572728833
89587,0.47619047619047616,0.5652173913043479,110,-130,0.4564724440500838,0.5435275559499162,away,CLE,over,9.5,0.5348837209302326,-115,0.5097020142727117,KC,CLE,2023 REG,6,6,9,4,10,15,1,0,2,-2,1,1,1,1,0,0,0,0,0,0.5097020142727117,0.49029798572728833
89587,0.47619047619047616,0.5652173913043479,110,-130,0.4564724440500838,0.5435275559499162,home,KC,under,9.5,0.5121951219512195,-105,0.49029798572728833,KC,CLE,2023 REG,6,6,9,4,10,15,1,0,2,-2,1,1,1,1,0,0,0,0,0,0.5097020142727117,0.49029798572728833
89588,0.4504504504504505,0.5918367346938775,122,-145,0.43140216885390636,0.5685978311460936,away,NYY,over,8.5,0.5391705069124424,-117,0.5140669063204599,LAA,NYY,2023 REG,6,7,8,3,10,14,1,0,4,-4,1,1,1,0,0,0,0,0,0,0.5140669063204599,0.4859330936795401
89588,0.4504504504504505,0.5918367346938775,122,-145,0.43140216885390636,0.5685978311460936,home,LAA,under,8.5,0.5073891625615764,-103,0.4859330936795401,LAA,NYY,2023 REG,6,7,8,3,10,14,1,0,4,-4,1,1,1,0,0,0,0,0,0,0.5140669063204599,0.4859330936795401
89589,0.425531914893617,0.6153846153846154,135,-160,0.4081206254135181,0.5918793745864819,away,CLE,over,9.5,0.5215311004784688,-109,0.4978845547971712,KC,CLE,2023 REG,13,7,10,6,13,23,1,0,1,-1,1,1,1,1,1,1,0,0,0,0.4978845547971712,0.5021154452028288
89589,0.425531914893617,0.6153846153846154,135,-160,0.4081206254135181,0.5918793745864819,home,KC,under,9.5,0.5238095238095238,-110,0.5021154452028288,KC,CLE,2023 REG,13,7,10,6,13,23,1,0,1,-1,1,1,1,1,1,1,0,0,0,0.4978845547971712,0.5021154452028288
89590,0.5535714285714286,0.48780487804878053,-124,105,0.53066668740667,0.46933331259333,away,MIN,over,7,0.5238095238095238,-110,0.5000596729920038,SEA,MIN,2023 REG,9,3,14,10,13,23,0,1,-7,7,1,1,1,0,0,0,0,0,0,0.5000596729920038,0.4999403270079962
89590,0.5535714285714286,0.48780487804878053,-124,105,0.53066668740667,0.46933331259333,home,SEA,under,7,0.5215311004784688,-109,0.4999403270079962,SEA,MIN,2023 REG,9,3,14,10,13,23,0,1,-7,7,1,1,1,0,0,0,0,0,0,0.5000596729920038,0.4999403270079962
89591,0.4608294930875576,0.5780590717299579,117,-137,0.44290849547579936,0.5570915045242006,away,TEX,over,9,0.5,100,0.4772727272727273,NYM,TEX,2023 REG,4,3,10,4,7,14,0,1,-1,1,1,1,1,0,0,0,0,0,0,0.4772727272727273,0.5227272727272727
89591,0.4608294930875576,0.5780590717299579,117,-137,0.44290849547579936,0.5570915045242006,home,NYM,under,9,0.5454545454545454,-120,0.5227272727272727,NYM,TEX,2023 REG,4,3,10,4,7,14,0,1,-1,1,1,1,1,0,0,0,0,0,0,0.4772727272727273,0.5227272727272727
89592,0.5726495726495727,0.4629629629629629,-134,116,0.5522560693500865,0.44774393064991347,away,NYY,over,9,0.5,100,0.4783105022831051,TOR,NYY,2023 REG,6,2,9,4,6,15,0,1,-2,2,1,1,0,0,0,0,0,0,0,0.4783105022831051,0.5216894977168949
89592,0.5726495726495727,0.4629629629629629,-134,116,0.5522560693500865,0.44774393064991347,home,TOR,under,9,0.5433789954337899,-119,0.5216894977168949,TOR,NYY,2023 REG,6,2,9,4,6,15,0,1,-2,2,1,1,0,0,0,0,0,0,0,0.4783105022831051,0.5216894977168949
89593,0.4854368932038835,0.5535714285714286,106,-124,0.4665008146721786,0.5334991853278215,away,LAA,over,8,0.5283018867924528,-112,0.5044173060022736,OAK,LAA,2023 REG,14,9,7,2,11,21,1,0,7,-7,1,1,0,0,0,0,0,0,0,0.5044173060022736,0.49558269399772636
89593,0.4854368932038835,0.5535714285714286,106,-124,0.4665008146721786,0.5334991853278215,home,OAK,under,8,0.5169082125603864,-107,0.49558269399772636,OAK,LAA,2023 REG,14,9,7,2,11,21,1,0,7,-7,1,1,0,0,0,0,0,0,0,0.5044173060022736,0.49558269399772636
89594,0.6363636363636364,0.40485829959514175,-175,147,0.6101314952989593,0.38986850470104073,away,PIT,over,7.5,0.5348837209302326,-115,0.5097020142727117,PHI,PIT,2023 REG,5,3,5,2,5,10,1,0,1,-1,1,1,0,0,0,0,0,0,0,0.5097020142727117,0.49029798572728833
89594,0.6363636363636364,0.40485829959514175,-175,147,0.6101314952989593,0.38986850470104073,home,PHI,under,7.5,0.5121951219512195,-105,0.49029798572728833,PHI,PIT,2023 REG,5,3,5,2,5,10,1,0,1,-1,1,1,0,0,0,0,0,0,0,0.5097020142727117,0.49029798572728833
89595,0.33112582781456956,0.7101449275362319,202,-245,0.31746001478450286,0.6825399852154972,away,SEA,over,9.5,0.5215311004784688,-109,0.4978845547971712,CWS,SEA,2023 REG,10,5,8,4,9,18,1,0,1,-1,1,1,1,1,0,0,0,0,0,0.4978845547971712,0.5021154452028288
89595,0.33112582781456956,0.7101449275362319,202,-245,0.31746001478450286,0.6825399852154972,home,CWS,under,9.5,0.5238095238095238,-110,0.5021154452028288,CWS,SEA,2023 REG,10,5,8,4,9,18,1,0,1,-1,1,1,1,1,0,0,0,0,0,0.4978845547971712,0.5021154452028288
89596,0.7590361445783133,0.2840909090909091,-315,252,0.7263011520342048,0.27369884796579524,away,OAK,over,9,0.5454545454545454,-120,0.5206611570247933,TOR,OAK,2023 REG,7,4,7,5,9,14,0,1,-1,1,1,1,1,1,0,0,0,0,0,0.5206611570247933,0.4793388429752067
89596,0.7590361445783133,0.2840909090909091,-315,252,0.7263011520342048,0.27369884796579524,home,TOR,under,9,0.5,100,0.4793388429752067,TOR,OAK,2023 REG,7,4,7,5,9,14,0,1,-1,1,1,1,1,1,0,0,0,0,0,0.5206611570247933,0.4793388429752067
89597,0.4716981132075471,0.5689655172413793,112,-132,0.45251715544861953,0.5474828445513804,away,PHI,over,8.5,0.5,100,0.4772727272727273,CHC,PHI,2023 REG,6,1,9,5,6,15,0,1,-4,4,1,0,0,0,0,0,0,0,0,0.4772727272727273,0.5227272727272727
89597,0.4716981132075471,0.5689655172413793,112,-132,0.45251715544861953,0.5474828445513804,home,CHC,under,8.5,0.5454545454545454,-120,0.5227272727272727,CHC,PHI,2023 REG,6,1,9,5,6,15,0,1,-4,4,1,0,0,0,0,0,0,0,0,0.4772727272727273,0.5227272727272727
89598,0.7354497354497355,0.30303030303030304,-278,230,0.7071496013294954,0.29285039867050455,away,KC,over,8.5,0.5348837209302326,-115,0.5097020142727117,TB,KC,2023 REG,7,3,4,1,4,11,1,0,2,-2,1,0,0,0,0,0,0,0,0,0.5097020142727117,0.49029798572728833
89598,0.7354497354497355,0.30303030303030304,-278,230,0.7071496013294954,0.29285039867050455,home,TB,under,8.5,0.5121951219512195,-105,0.49029798572728833,TB,KC,2023 REG,7,3,4,1,4,11,1,0,2,-2,1,0,0,0,0,0,0,0,0,0.5097020142727117,0.49029798572728833
89599,0.4807692307692307,0.5555555555555556,108,-125,0.4633053911900066,0.5366946088099934,away,LAD,over,9.5,0.5192307692307692,-108,0.49455035168025013,MIL,LAD,2023 REG,5,2,8,6,8,13,0,1,-4,4,1,1,0,0,0,0,0,0,0,0.49455035168025013,0.5054496483197499
89599,0.4807692307692307,0.5555555555555556,108,-125,0.4633053911900066,0.5366946088099934,home,MIL,under,9.5,0.5283018867924528,-112,0.5054496483197499,MIL,LAD,2023 REG,5,2,8,6,8,13,0,1,-4,4,1,1,0,0,0,0,0,0,0,0.49455035168025013,0.5054496483197499
89600,0.5348837209302326,0.5073891625615764,-115,-103,0.5122726437136835,0.48772735628631647,away,TEX,over,8.5,0.5121951219512195,-105,0.48808156828023186,SF,TEX,2023 REG,9,3,16,9,12,25,0,1,-6,6,1,1,1,0,0,0,0,0,0,0.48808156828023186,0.5119184317197681
89600,0.5348837209302326,0.5073891625615764,-115,-103,0.5122726437136835,0.48772735628631647,home,SF,under,8.5,0.5348837209302326,-115,0.5119184317197681,SF,TEX,2023 REG,9,3,16,9,12,25,0,1,-6,6,1,1,1,0,0,0,0,0,0,0.48808156828023186,0.5119184317197681
89601,0.5535714285714286,0.4854368932038835,-124,106,0.5319775361600951,0.46802246383990487,away,PHI,over,9,0.5391705069124424,-117,0.5140669063204599,TB,PHI,2023 REG,7,4,17,8,12,24,0,1,-4,4,1,1,1,1,0,0,0,0,0,0.5140669063204599,0.4859330936795401
89601,0.5535714285714286,0.4854368932038835,-124,106,0.5319775361600951,0.46802246383990487,home,TB,under,9,0.5073891625615764,-103,0.4859330936795401,TB,PHI,2023 REG,7,4,17,8,12,24,0,1,-4,4,1,1,1,1,0,0,0,0,0,0.5140669063204599,0.4859330936795401
89603,0.726027397260274,0.3076923076923077,-265,225,0.7015459676371667,0.2984540323628333,away,CIN,over,8.5,0.5454545454545454,-120,0.5206611570247933,SD,CIN,2023 REG,10,7,8,1,8,18,1,0,6,-6,1,0,0,0,0,0,0,0,0,0.5206611570247933,0.4793388429752067
89603,0.726027397260274,0.3076923076923077,-265,225,0.7015459676371667,0.2984540323628333,home,SD,under,8.5,0.5,100,0.4793388429752067,SD,CIN,2023 REG,10,7,8,1,8,18,1,0,6,-6,1,0,0,0,0,0,0,0,0,0.5206611570247933,0.4793388429752067
89604,0.574468085106383,0.4608294930875576,-135,117,0.5541907529524172,0.44580924704758285,away,NYM,over,8,0.5238095238095238,-110,0.5000596729920038,MIL,NYM,2023 REG,10,7,7,6,13,17,1,0,1,-1,1,1,1,1,1,1,0,0,0,0.5000596729920038,0.4999403270079962
89604,0.574468085106383,0.4608294930875576,-135,117,0.5541907529524172,0.44580924704758285,home,MIL,under,8,0.5215311004784688,-109,0.4999403270079962,MIL,NYM,2023 REG,10,7,7,6,13,17,1,0,1,-1,1,1,1,1,1,1,0,0,0,0.5000596729920038,0.4999403270079962
89605,0.7014925373134329,0.3389830508474576,-235,195,0.6730992142751963,0.32690078572480374,away,OAK,over,9,0.5121951219512195,-105,0.48808156828023186,SF,OAK,2023 REG,9,8,8,3,11,17,1,0,5,-5,1,1,1,0,0,0,0,0,0,0.48808156828023186,0.5119184317197681
89605,0.7014925373134329,0.3389830508474576,-235,195,0.6730992142751963,0.32690078572480374,home,SF,under,9,0.5348837209302326,-115,0.5119184317197681,SF,OAK,2023 REG,9,8,8,3,11,17,1,0,5,-5,1,1,1,0,0,0,0,0,0,0.48808156828023186,0.5119184317197681
89606,0.5454545454545454,0.5,-120,100,0.5206611570247933,0.4793388429752067,away,TB,over,7.5,0.5454545454545454,-120,0.5206611570247933,MIA,TB,2023 REG,10,2,15,11,13,25,0,1,-9,9,1,1,0,0,0,0,0,0,0,0.5206611570247933,0.4793388429752067
89606,0.5454545454545454,0.5,-120,100,0.5206611570247933,0.4793388429752067,home,MIA,under,7.5,0.5,100,0.4793388429752067,MIA,TB,2023 REG,10,2,15,11,13,25,0,1,-9,9,1,1,0,0,0,0,0,0,0,0.5206611570247933,0.4793388429752067
89607,0.5535714285714286,0.48780487804878053,-124,105,0.53066668740667,0.46933331259333,away,LAA,over,9.5,0.5391705069124424,-117,0.5127649394825569,TOR,LAA,2023 REG,10,6,6,1,7,16,1,0,5,-5,1,0,0,0,0,0,0,0,0,0.5127649394825569,0.48723506051744314
89607,0.5535714285714286,0.48780487804878053,-124,105,0.53066668740667,0.46933331259333,home,TOR,under,9.5,0.5098039215686274,-104,0.48723506051744314,TOR,LAA,2023 REG,10,6,6,1,7,16,1,0,5,-5,1,0,0,0,0,0,0,0,0,0.5127649394825569,0.48723506051744314
89608,0.5073891625615764,0.5348837209302326,-103,-115,0.4859403596076043,0.5140596403923957,away,BOS,over,9,0.5121951219512195,-105,0.48808156828023186,CHC,BOS,2023 REG,12,10,6,4,14,18,1,0,6,-6,1,1,1,1,0,0,0,0,0,0.48808156828023186,0.5119184317197681
89608,0.5073891625615764,0.5348837209302326,-103,-115,0.4859403596076043,0.5140596403923957,home,CHC,under,9,0.5348837209302326,-115,0.5119184317197681,CHC,BOS,2023 REG,12,10,6,4,14,18,1,0,6,-6,1,1,1,1,0,0,0,0,0,0.48808156828023186,0.5119184317197681
89609,0.4716981132075471,0.5689655172413793,112,-132,0.45251715544861953,0.5474828445513804,away,SEA,over,8,0.5121951219512195,-105,0.48808156828023186,CLE,SEA,2023 REG,9,7,9,6,13,18,1,0,1,-1,1,1,1,1,1,1,0,0,0,0.48808156828023186,0.5119184317197681
89609,0.4716981132075471,0.5689655172413793,112,-132,0.45251715544861953,0.5474828445513804,home,CLE,under,8,0.5348837209302326,-115,0.5119184317197681,CLE,SEA,2023 REG,9,7,9,6,13,18,1,0,1,-1,1,1,1,1,1,1,0,0,0,0.48808156828023186,0.5119184317197681
89610,0.46511627906976744,0.576271186440678,115,-136,0.44586629511142073,0.5541337048885793,away,PHI,over,8.5,0.5327102803738317,-114,0.508788710910954,CHC,PHI,2023 REG,10,5,11,8,13,21,0,1,-3,3,1,1,1,1,1,0,0,0,0,0.508788710910954,0.491211289089046
89610,0.46511627906976744,0.576271186440678,115,-136,0.44586629511142073,0.5541337048885793,home,CHC,under,8.5,0.5121951219512195,-105,0.491211289089046,CHC,PHI,2023 REG,10,5,11,8,13,21,0,1,-3,3,1,1,1,1,1,0,0,0,0,0.508788710910954,0.491211289089046
89611,0.6000000000000001,0.4347826086956522,-150,130,0.5791304347826086,0.4208695652173914,away,DET,over,8.5,0.5348837209302326,-115,0.5097020142727117,MIL,DET,2023 REG,5,2,8,4,6,13,0,1,-2,2,1,1,0,0,0,0,0,0,0,0.5097020142727117,0.49029798572728833
89611,0.6000000000000001,0.4347826086956522,-150,130,0.5791304347826086,0.4208695652173914,home,MIL,under,8.5,0.5121951219512195,-105,0.49029798572728833,MIL,DET,2023 REG,5,2,8,4,6,13,0,1,-2,2,1,1,0,0,0,0,0,0,0,0.5097020142727117,0.49029798572728833
89612,0.5884773662551441,0.45454545454545453,-143,120,0.5631594099815408,0.4368405900184592,away,PHI,over,9.5,0.5238095238095238,-110,0.4988662131519274,ATL,PHI,2023 REG,9,5,5,6,11,14,0,1,-1,1,1,1,1,1,1,0,0,0,0,0.4988662131519274,0.5011337868480725
89612,0.5884773662551441,0.45454545454545453,-143,120,0.5631594099815408,0.4368405900184592,home,ATL,under,9.5,0.5238095238095238,-110,0.5011337868480725,ATL,PHI,2023 REG,9,5,5,6,11,14,0,1,-1,1,1,1,1,1,1,0,0,0,0,0.4988662131519274,0.5011337868480725
89613,0.5652173913043479,0.47619047619047616,-130,110,0.5418129444594474,0.4581870555405526,away,CWS,over,8.5,0.5169082125603864,-107,0.49353874091423283,CLE,CWS,2023 REG,7,2,8,4,6,15,0,1,-2,2,1,1,0,0,0,0,0,0,0,0.49353874091423283,0.5064612590857671
89613,0.5652173913043479,0.47619047619047616,-130,110,0.5418129444594474,0.4581870555405526,home,CLE,under,8.5,0.5283018867924528,-112,0.5064612590857671,CLE,CWS,2023 REG,7,2,8,4,6,15,0,1,-2,2,1,1,0,0,0,0,0,0,0,0.49353874091423283,0.5064612590857671
89614,0.7014925373134329,0.3389830508474576,-235,195,0.6730992142751963,0.32690078572480374,away,CHC,over,8.5,0.5098039215686274,-104,0.4870219861770517,LAD,CHC,2023 REG,8,2,11,3,5,19,0,1,-1,1,1,1,0,0,0,0,0,0,0,0.4870219861770517,0.5129780138229483
89614,0.7014925373134329,0.3389830508474576,-235,195,0.6730992142751963,0.32690078572480374,home,LAD,under,8.5,0.5348837209302326,-115,0.5129780138229483,LAD,CHC,2023 REG,8,2,11,3,5,19,0,1,-1,1,1,1,0,0,0,0,0,0,0,0.4870219861770517,0.5129780138229483
89616,0.4166666666666667,0.6226415094339623,140,-165,0.4002882599580712,0.5997117400419287,away,MIL,over,11,0.5121951219512195,-105,0.48808156828023186,COL,MIL,2023 REG,9,3,8,2,5,17,1,0,1,-1,1,1,0,0,0,0,0,0,0,0.48808156828023186,0.5119184317197681
89616,0.4166666666666667,0.6226415094339623,140,-165,0.4002882599580712,0.5997117400419287,home,COL,under,11,0.5348837209302326,-115,0.5119184317197681,COL,MIL,2023 REG,9,3,8,2,5,17,1,0,1,-1,1,1,0,0,0,0,0,0,0,0.48808156828023186,0.5119184317197681
89617,0.5,0.5454545454545454,100,-120,0.4772727272727273,0.5227272727272727,away,NYY,over,9,0.5327102803738317,-114,0.5075272610403079,PIT,NYY,2023 REG,4,3,9,6,9,13,0,1,-3,3,1,1,1,0,0,0,0,0,0,0.5075272610403079,0.4924727389596921
89617,0.5,0.5454545454545454,100,-120,0.4772727272727273,0.5227272727272727,home,PIT,under,9,0.5145631067961165,-106,0.4924727389596921,PIT,NYY,2023 REG,4,3,9,6,9,13,0,1,-3,3,1,1,1,0,0,0,0,0,0,0.5075272610403079,0.4924727389596921
89618,0.7014925373134329,0.33783783783783783,-235,196,0.6739025726550789,0.3260974273449211,away,DET,over,6.5,0.5535714285714286,-124,0.5266562689432208,TB,DET,2023 REG,6,4,6,0,4,12,1,0,4,-4,0,0,0,0,0,0,0,0,0,0.5266562689432208,0.4733437310567792
89618,0.7014925373134329,0.33783783783783783,-235,196,0.6739025726550789,0.3260974273449211,home,TB,under,6.5,0.49504950495049505,102,0.4733437310567792,TB,DET,2023 REG,6,4,6,0,4,12,1,0,4,-4,0,0,0,0,0,0,0,0,0,0.5266562689432208,0.4733437310567792
89619,0.43859649122807015,0.601593625498008,128,-151,0.42096924704996574,0.5790307529500343,away,SEA,over,8,0.5215311004784688,-109,0.4978845547971712,KC,SEA,2023 REG,14,7,7,6,13,21,1,0,1,-1,1,1,1,1,1,1,0,0,0,0.4978845547971712,0.5021154452028288
89619,0.43859649122807015,0.601593625498008,128,-151,0.42096924704996574,0.5790307529500343,home,KC,under,8,0.5238095238095238,-110,0.5021154452028288,KC,SEA,2023 REG,14,7,7,6,13,21,1,0,1,-1,1,1,1,1,1,1,0,0,0,0.4978845547971712,0.5021154452028288
89620,0.49504950495049505,0.5454545454545454,102,-120,0.47499799484898986,0.5250020051510101,away,MIN,over,8,0.5098039215686274,-104,0.48592421718142587,CLE,MIN,2023 REG,7,3,11,8,11,18,0,1,-5,5,1,1,1,0,0,0,0,0,0,0.48592421718142587,0.5140757828185741
89620,0.49504950495049505,0.5454545454545454,102,-120,0.47499799484898986,0.5250020051510101,home,CLE,under,8,0.5370370370370371,-116,0.5140757828185741,CLE,MIN,2023 REG,7,3,11,8,11,18,0,1,-5,5,1,1,1,0,0,0,0,0,0,0.48592421718142587,0.5140757828185741
89621,0.5850622406639003,0.45454545454545453,-141,120,0.5618892737571823,0.43811072624281766,away,PHI,over,7.5,0.5238095238095238,-110,0.4988662131519274,TOR,PHI,2023 REG,5,4,11,9,13,16,0,1,-5,5,1,1,1,1,0,0,0,0,0,0.4988662131519274,0.5011337868480725
89621,0.5850622406639003,0.45454545454545453,-141,120,0.5618892737571823,0.43811072624281766,home,TOR,under,7.5,0.5238095238095238,-110,0.5011337868480725,TOR,PHI,2023 REG,5,4,11,9,13,16,0,1,-5,5,1,1,1,1,0,0,0,0,0,0.4988662131519274,0.5011337868480725
89622,0.6551724137931035,0.38167938931297707,-190,162,0.6310281289994645,0.3689718710005355,away,KC,over,8.5,0.5121951219512195,-105,0.48808156828023186,CLE,KC,2023 REG,6,3,2,0,3,8,1,0,3,-3,0,0,0,0,0,0,0,0,0,0.48808156828023186,0.5119184317197681
89622,0.6551724137931035,0.38167938931297707,-190,162,0.6310281289994645,0.3689718710005355,home,CLE,under,8.5,0.5348837209302326,-115,0.5119184317197681,CLE,KC,2023 REG,6,3,2,0,3,8,1,0,3,-3,0,0,0,0,0,0,0,0,0,0.48808156828023186,0.5119184317197681
89623,0.4444444444444444,0.5951417004048584,125,-147,0.4268506022891988,0.5731493977108012,away,SD,over,9,0.5121951219512195,-105,0.48808156828023186,STL,SD,2023 REG,9,6,12,5,11,21,1,0,1,-1,1,1,1,1,1,0,0,0,0,0.48808156828023186,0.5119184317197681
89623,0.4444444444444444,0.5951417004048584,125,-147,0.4268506022891988,0.5731493977108012,home,STL,under,9,0.5348837209302326,-115,0.5119184317197681,STL,SD,2023 REG,9,6,12,5,11,21,1,0,1,-1,1,1,1,1,1,0,0,0,0,0.48808156828023186,0.5119184317197681
89624,0.5535714285714286,0.48780487804878053,-124,105,0.53066668740667,0.46933331259333,away,MIN,over,7.5,0.5391705069124424,-117,0.5127649394825569,CWS,MIN,2023 REG,12,6,8,4,10,20,1,0,2,-2,1,1,1,1,0,0,0,0,0,0.5127649394825569,0.48723506051744314
89624,0.5535714285714286,0.48780487804878053,-124,105,0.53066668740667,0.46933331259333,home,CWS,under,7.5,0.5098039215686274,-104,0.48723506051744314,CWS,MIN,2023 REG,12,6,8,4,10,20,1,0,2,-2,1,1,1,1,0,0,0,0,0,0.5127649394825569,0.48723506051744314
89625,0.6153846153846154,0.4184100418410042,-160,139,0.5945879032457726,0.4054120967542274,away,PIT,over,8.5,0.5073891625615764,-103,0.4826927225525911,SF,PIT,2023 REG,5,1,6,2,3,11,0,1,-1,1,1,0,0,0,0,0,0,0,0,0.4826927225525911,0.5173072774474089
89625,0.6153846153846154,0.4184100418410042,-160,139,0.5945879032457726,0.4054120967542274,home,SF,under,8.5,0.5412844036697247,-118,0.5173072774474089,SF,PIT,2023 REG,5,1,6,2,3,11,0,1,-1,1,1,0,0,0,0,0,0,0,0,0.4826927225525911,0.5173072774474089
89626,0.5454545454545454,0.49504950495049505,-120,102,0.5233614270517961,0.4766385729482039,away,MIL,over,8,0.5098039215686274,-104,0.48592421718142587,STL,MIL,2023 REG,8,3,7,0,3,15,1,0,3,-3,0,0,0,0,0,0,0,0,0,0.48592421718142587,0.5140757828185741
89626,0.5454545454545454,0.49504950495049505,-120,102,0.5233614270517961,0.4766385729482039,home,STL,under,8,0.5370370370370371,-116,0.5140757828185741,STL,MIL,2023 REG,8,3,7,0,3,15,1,0,3,-3,0,0,0,0,0,0,0,0,0,0.48592421718142587,0.5140757828185741
89627,0.5850622406639003,0.45454545454545453,-141,120,0.5618892737571823,0.43811072624281766,away,MIA,over,8,0.5348837209302326,-115,0.5097020142727117,NYM,MIA,2023 REG,9,2,11,7,9,20,0,1,-5,5,1,1,0,0,0,0,0,0,0,0.5097020142727117,0.49029798572728833
89627,0.5850622406639003,0.45454545454545453,-141,120,0.5618892737571823,0.43811072624281766,home,NYM,under,8,0.5121951219512195,-105,0.49029798572728833,NYM,MIA,2023 REG,9,2,11,7,9,20,0,1,-5,5,1,1,0,0,0,0,0,0,0,0.5097020142727117,0.49029798572728833
89628,0.4329004329004329,0.607843137254902,131,-155,0.41526252374227923,0.5847374762577208,away,PHI,over,9.5,0.5098039215686274,-104,0.48483656587239576,WSH,PHI,2023 REG,9,3,16,12,15,25,0,1,-9,9,1,1,1,0,0,0,0,0,0,0.48483656587239576,0.5151634341276042
89628,0.4329004329004329,0.607843137254902,131,-155,0.41526252374227923,0.5847374762577208,home,WSH,under,9.5,0.5391705069124424,-117,0.5151634341276042,WSH,PHI,2023 REG,9,3,16,12,15,25,0,1,-9,9,1,1,1,0,0,0,0,0,0,0.48483656587239576,0.5151634341276042
89629,0.42194092827004215,0.613899613899614,137,-159,0.40681833663727585,0.5931816633627242,away,BOS,over,8.5,0.5454545454545454,-120,0.5206611570247933,OAK,BOS,2023 REG,1,0,10,7,7,11,0,1,-7,7,0,0,0,0,0,0,0,0,0,0.5206611570247933,0.4793388429752067
89629,0.42194092827004215,0.613899613899614,137,-159,0.40681833663727585,0.5931816633627242,home,OAK,under,8.5,0.5,100,0.4793388429752067,OAK,BOS,2023 REG,1,0,10,7,7,11,0,1,-7,7,0,0,0,0,0,0,0,0,0,0.5206611570247933,0.4793388429752067
89630,0.5192307692307692,0.5169082125603864,-108,-107,0.5004662979161306,0.4995337020838694,away,BAL,over,7.5,0.5370370370370371,-116,0.5118817074154765,DET,BAL,2023 REG,16,7,9,4,11,25,1,0,3,-3,1,1,1,1,0,0,0,0,0,0.5118817074154765,0.48811829258452355
89630,0.5192307692307692,0.5169082125603864,-108,-107,0.5004662979161306,0.4995337020838694,home,DET,under,7.5,0.5098039215686274,-104,0.48811829258452355,DET,BAL,2023 REG,16,7,9,4,11,25,1,0,3,-3,1,1,1,1,0,0,0,0,0,0.5118817074154765,0.48811829258452355
89631,0.5121951219512195,0.5305164319248826,-105,-113,0.4903184724049234,0.5096815275950766,away,NYY,over,9.5,0.5098039215686274,-104,0.48592421718142587,STL,NYY,2023 REG,7,2,10,6,8,17,0,1,-4,4,1,1,0,0,0,0,0,0,0,0.48592421718142587,0.5140757828185741
89631,0.5121951219512195,0.5305164319248826,-105,-113,0.4903184724049234,0.5096815275950766,home,STL,under,9.5,0.5370370370370371,-116,0.5140757828185741,STL,NYY,2023 REG,7,2,10,6,8,17,0,1,-4,4,1,1,0,0,0,0,0,0,0,0.48592421718142587,0.5140757828185741
89632,0.49751243781094534,0.5454545454545454,101,-120,0.476135829221149,0.523864170778851,away,ATL,over,10,0.5238095238095238,-110,0.4988662131519274,LAD,ATL,2023 REG,6,2,5,4,6,11,0,1,-2,2,1,1,0,0,0,0,0,0,0,0.4988662131519274,0.5011337868480725
89632,0.49751243781094534,0.5454545454545454,101,-120,0.476135829221149,0.523864170778851,home,LAD,under,10,0.5238095238095238,-110,0.5011337868480725,LAD,ATL,2023 REG,6,2,5,4,6,11,0,1,-2,2,1,1,0,0,0,0,0,0,0,0.4988662131519274,0.5011337868480725
89633,0.6226415094339623,0.4166666666666667,-165,140,0.5981666073335706,0.40183339266642937,away,CWS,over,7.5,0.5238095238095238,-110,0.4988662131519274,MIN,CWS,2023 REG,9,4,4,3,7,13,1,0,1,-1,1,1,1,0,0,0,0,0,0,0.4988662131519274,0.5011337868480725
89633,0.6226415094339623,0.4166666666666667,-165,140,0.5981666073335706,0.40183339266642937,home,MIN,under,7.5,0.5238095238095238,-110,0.5011337868480725,MIN,CWS,2023 REG,9,4,4,3,7,13,1,0,1,-1,1,1,1,0,0,0,0,0,0,0.4988662131519274,0.5011337868480725
89634,0.5652173913043479,0.47619047619047616,-130,110,0.5418129444594474,0.4581870555405526,away,SF,over,9,0.5215311004784688,-109,0.4978845547971712,PHI,SF,2023 REG,9,4,8,3,7,17,1,0,1,-1,1,1,1,0,0,0,0,0,0,0.4978845547971712,0.5021154452028288
89634,0.5652173913043479,0.47619047619047616,-130,110,0.5418129444594474,0.4581870555405526,home,PHI,under,9,0.5238095238095238,-110,0.5021154452028288,PHI,SF,2023 REG,9,4,8,3,7,17,1,0,1,-1,1,1,1,0,0,0,0,0,0,0.4978845547971712,0.5021154452028288
89635,0.4484304932735426,0.5901639344262295,123,-144,0.43112357502252374,0.5688764249774763,away,SEA,over,8.5,0.5454545454545454,-120,0.5193043049216726,CWS,SEA,2023 REG,10,3,9,6,9,19,0,1,-3,3,1,1,1,0,0,0,0,0,0,0.5193043049216726,0.48069569507832743
89635,0.4484304932735426,0.5901639344262295,123,-144,0.43112357502252374,0.5688764249774763,home,CWS,under,8.5,0.5024875621890548,-101,0.48069569507832743,CWS,SEA,2023 REG,10,3,9,6,9,19,0,1,-3,3,1,1,1,0,0,0,0,0,0,0.5193043049216726,0.48069569507832743
89636,0.4366812227074236,0.6000000000000001,129,-150,0.42066322152514246,0.5793367784748575,away,SEA,over,8,0.5391705069124424,-117,0.5140669063204599,NYM,SEA,2023 REG,13,7,10,8,15,23,0,1,-1,1,1,1,1,1,1,1,1,0,0,0.5140669063204599,0.4859330936795401
89636,0.4366812227074236,0.6000000000000001,129,-150,0.42066322152514246,0.5793367784748575,home,NYM,under,8,0.5073891625615764,-103,0.4859330936795401,NYM,SEA,2023 REG,13,7,10,8,15,23,0,1,-1,1,1,1,1,1,1,1,1,0,0,0.5140669063204599,0.4859330936795401
89637,0.5454545454545454,0.49751243781094534,-120,101,0.5220180091279142,0.4779819908720858,away,NYY,over,9.5,0.5121951219512195,-105,0.48808156828023186,BAL,NYY,2023 REG,5,3,12,8,11,17,0,1,-5,5,1,1,1,0,0,0,0,0,0,0.48808156828023186,0.5119184317197681
89637,0.5454545454545454,0.49751243781094534,-120,101,0.5220180091279142,0.4779819908720858,home,BAL,under,9.5,0.5348837209302326,-115,0.5119184317197681,BAL,NYY,2023 REG,5,3,12,8,11,17,0,1,-5,5,1,1,1,0,0,0,0,0,0,0.48808156828023186,0.5119184317197681
89638,0.6774193548387096,0.36363636363636365,-210,175,0.6496074165168858,0.3503925834831142,away,KC,over,9.5,0.5305164319248826,-113,0.5053568787472517,PHI,KC,2023 REG,12,8,7,4,12,19,1,0,4,-4,1,1,1,1,0,0,0,0,0,0.5053568787472517,0.49464312125274834
89638,0.6774193548387096,0.36363636363636365,-210,175,0.6496074165168858,0.3503925834831142,home,PHI,under,9.5,0.5169082125603864,-107,0.49464312125274834,PHI,KC,2023 REG,12,8,7,4,12,19,1,0,4,-4,1,1,1,1,0,0,0,0,0,0.5053568787472517,0.49464312125274834
89639,0.5,0.5391705069124424,100,-117,0.4804147465437788,0.5195852534562212,away,NYY,over,8,0.5169082125603864,-107,0.49239402434819424,DET,NYY,2023 REG,8,4,5,3,7,13,1,0,1,-1,1,1,1,0,0,0,0,0,0,0.49239402434819424,0.5076059756518058
89639,0.5,0.5391705069124424,100,-117,0.4804147465437788,0.5195852534562212,home,DET,under,8,0.5305164319248826,-113,0.5076059756518058,DET,NYY,2023 REG,8,4,5,3,7,13,1,0,1,-1,1,1,1,0,0,0,0,0,0,0.49239402434819424,0.5076059756518058
89640,0.6168582375478928,0.425531914893617,-161,135,0.5907095228234366,0.4092904771765634,away,SEA,over,8.5,0.5412844036697247,-118,0.5149381613977361,TB,SEA,2023 REG,7,7,6,5,12,13,1,0,2,-2,1,1,1,1,1,0,0,0,0,0.5149381613977361,0.48506183860226393
89640,0.6168582375478928,0.425531914893617,-161,135,0.5907095228234366,0.4092904771765634,home,TB,under,8.5,0.5073891625615764,-103,0.48506183860226393,TB,SEA,2023 REG,7,7,6,5,12,13,1,0,2,-2,1,1,1,1,1,0,0,0,0,0.5149381613977361,0.48506183860226393
89641,0.47619047619047616,0.5652173913043479,110,-130,0.4564724440500838,0.5435275559499162,away,MIN,over,9.5,0.504950495049505,-102,0.4826715732667395,CIN,MIN,2023 REG,4,0,11,7,7,15,0,1,-7,7,0,0,0,0,0,0,0,0,0,0.4826715732667395,0.5173284267332605
89641,0.47619047619047616,0.5652173913043479,110,-130,0.4564724440500838,0.5435275559499162,home,CIN,under,9.5,0.5391705069124424,-117,0.5173284267332605,CIN,MIN,2023 REG,4,0,11,7,7,15,0,1,-7,7,0,0,0,0,0,0,0,0,0,0.4826715732667395,0.5173284267332605
89642,0.5412844036697247,0.5,-118,100,0.5189377998484975,0.4810622001515025,away,SEA,over,8,0.5238095238095238,-110,0.5000596729920038,SF,SEA,2023 REG,5,0,13,6,6,18,0,1,-6,6,0,0,0,0,0,0,0,0,0,0.5000596729920038,0.4999403270079962
89642,0.5412844036697247,0.5,-118,100,0.5189377998484975,0.4810622001515025,home,SF,under,8,0.5215311004784688,-109,0.4999403270079962,SF,SEA,2023 REG,5,0,13,6,6,18,0,1,-6,6,0,0,0,0,0,0,0,0,0,0.5000596729920038,0.4999403270079962
89643,0.4629629629629629,0.576271186440678,116,-136,0.4447990049057217,0.5552009950942782,away,NYM,over,8.5,0.5348837209302326,-115,0.5097020142727117,LAD,NYM,2023 REG,5,3,11,5,8,16,0,1,-2,2,1,1,1,0,0,0,0,0,0,0.5097020142727117,0.49029798572728833
89643,0.4629629629629629,0.576271186440678,116,-136,0.4447990049057217,0.5552009950942782,home,LAD,under,8.5,0.5121951219512195,-105,0.49029798572728833,LAD,NYM,2023 REG,5,3,11,5,8,16,0,1,-2,2,1,1,1,0,0,0,0,0,0,0.5097020142727117,0.49029798572728833
89644,0.35714285714285715,0.6845425867507886,180,-217,0.3422551986094122,0.6577448013905878,away,HOU,over,12,0.5215311004784688,-109,0.49670754937970685,COL,HOU,2023 REG,7,4,8,3,7,15,1,0,1,-1,1,1,1,0,0,0,0,0,0,0.49670754937970685,0.5032924506202932
89644,0.35714285714285715,0.6845425867507886,180,-217,0.3422551986094122,0.6577448013905878,home,COL,under,12,0.5260663507109005,-111,0.5032924506202932,COL,HOU,2023 REG,7,4,8,3,7,15,1,0,1,-1,1,1,1,0,0,0,0,0,0,0.49670754937970685,0.5032924506202932
89645,0.4,0.6389891696750902,150,-177,0.3844043321299639,0.6155956678700361,away,MIL,over,8.5,0.5169082125603864,-107,0.49239402434819424,CWS,MIL,2023 REG,5,2,7,3,5,12,0,1,-1,1,1,1,0,0,0,0,0,0,0,0.49239402434819424,0.5076059756518058
89645,0.4,0.6389891696750902,150,-177,0.3844043321299639,0.6155956678700361,home,CWS,under,8.5,0.5305164319248826,-113,0.5076059756518058,CWS,MIL,2023 REG,5,2,7,3,5,12,0,1,-1,1,1,1,0,0,0,0,0,0,0,0.49239402434819424,0.5076059756518058
89646,0.5348837209302326,0.5098039215686274,-115,-104,0.5109810284308424,0.48901897156915763,away,SEA,over,7.5,0.5,100,0.4772727272727273,LAA,SEA,2023 REG,6,5,4,4,9,10,1,0,1,-1,1,1,1,1,0,0,0,0,0,0.4772727272727273,0.5227272727272727
89646,0.5348837209302326,0.5098039215686274,-115,-104,0.5109810284308424,0.48901897156915763,home,LAA,under,7.5,0.5454545454545454,-120,0.5227272727272727,LAA,SEA,2023 REG,6,5,4,4,9,10,1,0,1,-1,1,1,1,1,0,0,0,0,0,0.4772727272727273,0.5227272727272727
89647,0.4081632653061224,0.6323529411764706,145,-172,0.39162603817037017,0.6083739618296298,away,SEA,over,7.5,0.5238095238095238,-110,0.4976840657273969,OAK,SEA,2023 REG,5,0,9,5,5,14,0,1,-5,5,0,0,0,0,0,0,0,0,0,0.4976840657273969,0.5023159342726031
89647,0.4081632653061224,0.6323529411764706,145,-172,0.39162603817037017,0.6083739618296298,home,OAK,under,7.5,0.5260663507109005,-111,0.5023159342726031,OAK,SEA,2023 REG,5,0,9,5,5,14,0,1,-5,5,0,0,0,0,0,0,0,0,0,0.4976840657273969,0.5023159342726031
89648,0.4347826086956522,0.6047430830039526,130,-153,0.4175975253479979,0.5824024746520021,away,TEX,over,9,0.5121951219512195,-105,0.48919479393107135,OAK,TEX,2023 REG,7,3,11,11,14,18,0,1,-8,8,1,1,1,0,0,0,0,0,0,0.48919479393107135,0.5108052060689287
89648,0.4347826086956522,0.6047430830039526,130,-153,0.4175975253479979,0.5824024746520021,home,OAK,under,9,0.5327102803738317,-114,0.5108052060689287,OAK,TEX,2023 REG,7,3,11,11,14,18,0,1,-8,8,1,1,1,0,0,0,0,0,0,0.48919479393107135,0.5108052060689287
89649,0.6923076923076923,0.3472222222222222,-225,188,0.6649408284023669,0.3350591715976331,away,KC,over,9,0.5454545454545454,-120,0.5206611570247933,CLE,KC,2023 REG,11,6,6,1,7,17,1,0,5,-5,1,0,0,0,0,0,0,0,0,0.5206611570247933,0.4793388429752067
89649,0.6923076923076923,0.3472222222222222,-225,188,0.6649408284023669,0.3350591715976331,home,CLE,under,9,0.5,100,0.4793388429752067,CLE,KC,2023 REG,11,6,6,1,7,17,1,0,5,-5,1,0,0,0,0,0,0,0,0,0.5206611570247933,0.4793388429752067
89650,0.6363636363636364,0.4,-175,150,0.6132231404958678,0.3867768595041322,away,COL,over,10.5,0.5121951219512195,-105,0.48808156828023186,PHI,COL,2023 REG,7,4,9,3,7,16,1,0,1,-1,1,1,1,0,0,0,0,0,0,0.48808156828023186,0.5119184317197681
89650,0.6363636363636364,0.4,-175,150,0.6132231404958678,0.3867768595041322,home,PHI,under,10.5,0.5348837209302326,-115,0.5119184317197681,PHI,COL,2023 REG,7,4,9,3,7,16,1,0,1,-1,1,1,1,0,0,0,0,0,0,0.48808156828023186,0.5119184317197681
89651,0.5850622406639003,0.45454545454545453,-141,120,0.5618892737571823,0.43811072624281766,away,NYM,over,8.5,0.5305164319248826,-113,0.5053568787472517,NYY,NYM,2023 REG,6,3,4,1,4,10,1,0,2,-2,1,0,0,0,0,0,0,0,0,0.5053568787472517,0.49464312125274834
89651,0.5850622406639003,0.45454545454545453,-141,120,0.5618892737571823,0.43811072624281766,home,NYY,under,8.5,0.5169082125603864,-107,0.49464312125274834,NYY,NYM,2023 REG,6,3,4,1,4,10,1,0,2,-2,1,0,0,0,0,0,0,0,0,0.5053568787472517,0.49464312125274834
89652,0.4132231404958678,0.6226415094339623,142,-165,0.3984030372190785,0.6015969627809215,away,PHI,over,10.5,0.5454545454545454,-120,0.5206611570247933,COL,PHI,2023 REG,6,4,7,0,4,13,1,0,4,-4,0,0,0,0,0,0,0,0,0,0.5206611570247933,0.4793388429752067
89652,0.4132231404958678,0.6226415094339623,142,-165,0.3984030372190785,0.6015969627809215,home,COL,under,10.5,0.5,100,0.4793388429752067,COL,PHI,2023 REG,6,4,7,0,4,13,1,0,4,-4,0,0,0,0,0,0,0,0,0,0.5206611570247933,0.4793388429752067
89653,0.49019607843137253,0.5454545454545454,104,-120,0.4727202824088637,0.5272797175911363,away,SD,over,8,0.5215311004784688,-109,0.4978845547971712,SF,SD,2023 REG,8,4,8,2,6,16,1,0,2,-2,1,1,0,0,0,0,0,0,0,0.4978845547971712,0.5021154452028288
89653,0.49019607843137253,0.5454545454545454,104,-120,0.4727202824088637,0.5272797175911363,home,SF,under,8,0.5238095238095238,-110,0.5021154452028288,SF,SD,2023 REG,8,4,8,2,6,16,1,0,2,-2,1,1,0,0,0,0,0,0,0,0.4978845547971712,0.5021154452028288
89654,0.5594713656387665,0.47619047619047616,-127,110,0.5395195862893665,0.46048041371063353,away,WSH,over,9.5,0.5121951219512195,-105,0.48808156828023186,ARI,WSH,2023 REG,16,8,11,7,15,27,1,0,1,-1,1,1,1,1,1,1,1,0,0,0.48808156828023186,0.5119184317197681
89654,0.5594713656387665,0.47619047619047616,-127,110,0.5395195862893665,0.46048041371063353,home,ARI,under,9.5,0.5348837209302326,-115,0.5119184317197681,ARI,WSH,2023 REG,16,8,11,7,15,27,1,0,1,-1,1,1,1,1,1,1,1,0,0,0.48808156828023186,0.5119184317197681
89655,0.6598639455782314,0.38167938931297707,-194,162,0.6324509967044407,0.3675490032955593,away,ARI,over,10.5,0.5192307692307692,-108,0.49571111079951763,ATL,ARI,2023 REG,11,13,16,16,29,27,0,1,-3,3,1,1,1,1,1,1,1,1,1,0.49571111079951763,0.5042888892004824
89655,0.6598639455782314,0.38167938931297707,-194,162,0.6324509967044407,0.3675490032955593,home,ATL,under,10.5,0.5260663507109005,-111,0.5042888892004824,ATL,ARI,2023 REG,11,13,16,16,29,27,0,1,-3,3,1,1,1,1,1,1,1,1,1,0.49571111079951763,0.5042888892004824
89656,0.5934959349593496,0.4444444444444444,-146,125,0.5709784740123824,0.42902152598761756,away,CLE,over,7.5,0.5370370370370371,-116,0.5118817074154765,NYM,CLE,2023 REG,11,5,8,4,9,19,1,0,1,-1,1,1,1,1,0,0,0,0,0,0.5118817074154765,0.48811829258452355
89656,0.5934959349593496,0.4444444444444444,-146,125,0.5709784740123824,0.42902152598761756,home,NYM,under,7.5,0.5098039215686274,-104,0.48811829258452355,NYM,CLE,2023 REG,11,5,8,4,9,19,1,0,1,-1,1,1,1,1,0,0,0,0,0,0.5118817074154765,0.48811829258452355
89657,0.5780590717299579,0.4629629629629629,-137,116,0.5543459124348938,0.44565408756510616,away,STL,over,8,0.5305164319248826,-113,0.5066009958897986,CHC,STL,2023 REG,9,4,7,3,7,16,1,0,1,-1,1,1,1,0,0,0,0,0,0,0.5066009958897986,0.49339900411020143
89657,0.5780590717299579,0.4629629629629629,-137,116,0.5543459124348938,0.44565408756510616,home,CHC,under,8,0.5145631067961165,-106,0.49339900411020143,CHC,STL,2023 REG,9,4,7,3,7,16,1,0,1,-1,1,1,1,0,0,0,0,0,0,0.5066009958897986,0.49339900411020143
89658,0.49751243781094534,0.5433789954337899,101,-119,0.4771684411717736,0.5228315588282264,away,LAD,over,10,0.5098039215686274,-104,0.48483656587239576,TEX,LAD,2023 REG,9,8,8,4,12,17,1,0,4,-4,1,1,1,1,0,0,0,0,0,0.48483656587239576,0.5151634341276042
89658,0.49751243781094534,0.5433789954337899,101,-119,0.4771684411717736,0.5228315588282264,home,TEX,under,10,0.5391705069124424,-117,0.5151634341276042,TEX,LAD,2023 REG,9,8,8,4,12,17,1,0,4,-4,1,1,1,1,0,0,0,0,0,0.48483656587239576,0.5151634341276042
89659,0.6515679442508712,0.3861003861003861,-187,159,0.6270244676805398,0.37297553231946023,away,STL,over,8.5,0.5215311004784688,-109,0.4978845547971712,MIA,STL,2023 REG,19,15,9,2,17,28,1,0,13,-13,1,1,0,0,0,0,0,0,0,0.4978845547971712,0.5021154452028288
89659,0.6515679442508712,0.3861003861003861,-187,159,0.6270244676805398,0.37297553231946023,home,MIA,under,8.5,0.5238095238095238,-110,0.5021154452028288,MIA,STL,2023 REG,19,15,9,2,17,28,1,0,13,-13,1,1,0,0,0,0,0,0,0,0.4978845547971712,0.5021154452028288
89660,0.609375,0.4291845493562232,-156,133,0.5858777746110515,0.4141222253889485,away,CHC,over,9.5,0.5,100,0.4772727272727273,ATL,CHC,2023 REG,9,6,7,5,11,16,1,0,1,-1,1,1,1,1,1,0,0,0,0,0.4772727272727273,0.5227272727272727
89660,0.609375,0.4291845493562232,-156,133,0.5858777746110515,0.4141222253889485,home,ATL,under,9.5,0.5454545454545454,-120,0.5227272727272727,ATL,CHC,2023 REG,9,6,7,5,11,16,1,0,1,-1,1,1,1,1,1,0,0,0,0,0.4772727272727273,0.5227272727272727
89661,0.5934959349593496,0.4504504504504505,-146,122,0.5674139338624764,0.4325860661375236,away,BOS,over,8.5,0.5238095238095238,-110,0.4988662131519274,TOR,BOS,2023 REG,8,4,5,3,7,13,1,0,1,-1,1,1,1,0,0,0,0,0,0,0.4988662131519274,0.5011337868480725
89661,0.5934959349593496,0.4504504504504505,-146,122,0.5674139338624764,0.4325860661375236,home,TOR,under,8.5,0.5238095238095238,-110,0.5011337868480725,TOR,BOS,2023 REG,8,4,5,3,7,13,1,0,1,-1,1,1,1,0,0,0,0,0,0,0.4988662131519274,0.5011337868480725
89663,0.6415770609318996,0.39840637450199207,-179,151,0.615924605940263,0.384075394059737,away,LAA,over,9,0.5024875621890548,-101,0.4794401874631478,LAD,LAA,2023 REG,11,11,8,4,15,19,1,0,7,-7,1,1,1,1,0,0,0,0,0,0.4794401874631478,0.5205598125368522
89663,0.6415770609318996,0.39840637450199207,-179,151,0.615924605940263,0.384075394059737,home,LAD,under,9,0.5433789954337899,-119,0.5205598125368522,LAD,LAA,2023 REG,11,11,8,4,15,19,1,0,7,-7,1,1,1,1,0,0,0,0,0,0.4794401874631478,0.5205598125368522
89664,0.41493775933609955,0.6254681647940076,141,-167,0.39817181571364846,0.6018281842863515,away,TEX,over,9,0.5,100,0.4772727272727273,LAA,TEX,2023 REG,12,9,6,3,12,18,1,0,6,-6,1,1,1,0,0,0,0,0,0,0.4772727272727273,0.5227272727272727
89664,0.41493775933609955,0.6254681647940076,141,-167,0.39817181571364846,0.6018281842863515,home,LAA,under,9,0.5454545454545454,-120,0.5227272727272727,LAA,TEX,2023 REG,12,9,6,3,12,18,1,0,6,-6,1,1,1,0,0,0,0,0,0,0.4772727272727273,0.5227272727272727
89665,0.48780487804878053,0.5535714285714286,105,-124,0.4676213138438005,0.5323786861561994,away,HOU,over,10,0.5348837209302326,-115,0.5097020142727117,STL,HOU,2023 REG,4,0,18,14,14,22,0,1,-14,14,0,0,0,0,0,0,0,0,0,0.5097020142727117,0.49029798572728833
89665,0.48780487804878053,0.5535714285714286,105,-124,0.4676213138438005,0.5323786861561994,home,STL,under,10,0.5121951219512195,-105,0.49029798572728833,STL,HOU,2023 REG,4,0,18,14,14,22,0,1,-14,14,0,0,0,0,0,0,0,0,0,0.5097020142727117,0.49029798572728833
89666,0.5555555555555556,0.48780487804878053,-125,105,0.5314664257753688,0.46853357422463116,away,CLE,over,7.5,0.5327102803738317,-114,0.508788710910954,DET,CLE,2023 REG,9,5,5,2,7,14,1,0,3,-3,1,1,0,0,0,0,0,0,0,0.508788710910954,0.491211289089046
89666,0.5555555555555556,0.48780487804878053,-125,105,0.5314664257753688,0.46853357422463116,home,DET,under,7.5,0.5121951219512195,-105,0.491211289089046,DET,CLE,2023 REG,9,5,5,2,7,14,1,0,3,-3,1,1,0,0,0,0,0,0,0,0.508788710910954,0.491211289089046
89667,0.45454545454545453,0.5884773662551441,120,-143,0.43498962690881876,0.5650103730911813,away,LAD,over,7.5,0.5283018867924528,-112,0.5031902949311281,MIA,LAD,2023 REG,8,6,7,3,9,15,1,0,3,-3,1,1,1,0,0,0,0,0,0,0.5031902949311281,0.4968097050688719
89667,0.45454545454545453,0.5884773662551441,120,-143,0.43498962690881876,0.5650103730911813,home,MIA,under,7.5,0.5192307692307692,-108,0.4968097050688719,MIA,LAD,2023 REG,8,6,7,3,9,15,1,0,3,-3,1,1,1,0,0,0,0,0,0,0.5031902949311281,0.4968097050688719
89668,0.6153846153846154,0.42194092827004215,-160,137,0.5924150500586723,0.40758494994132766,away,CIN,over,7.5,0.5348837209302326,-115,0.5097020142727117,SF,CIN,2023 REG,7,6,1,1,7,8,1,0,5,-5,1,0,0,0,0,0,0,0,0,0.5097020142727117,0.49029798572728833
89668,0.6153846153846154,0.42194092827004215,-160,137,0.5924150500586723,0.40758494994132766,home,SF,under,7.5,0.5121951219512195,-105,0.49029798572728833,SF,CIN,2023 REG,7,6,1,1,7,8,1,0,5,-5,1,0,0,0,0,0,0,0,0,0.5097020142727117,0.49029798572728833
89669,0.5073891625615764,0.5348837209302326,-103,-115,0.4859403596076043,0.5140596403923957,away,CLE,over,8,0.5169082125603864,-107,0.49239402434819424,DET,CLE,2023 REG,8,8,8,0,8,16,1,0,8,-8,0,0,0,0,0,0,0,0,0,0.49239402434819424,0.5076059756518058
89669,0.5073891625615764,0.5348837209302326,-103,-115,0.4859403596076043,0.5140596403923957,home,DET,under,8,0.5305164319248826,-113,0.5076059756518058,DET,CLE,2023 REG,8,8,8,0,8,16,1,0,8,-8,0,0,0,0,0,0,0,0,0,0.49239402434819424,0.5076059756518058
89670,0.6000000000000001,0.4444444444444444,-150,125,0.5733333333333334,0.42666666666666664,away,SF,over,7.5,0.5,100,0.4772727272727273,HOU,SF,2023 REG,5,2,7,4,6,12,0,1,-2,2,1,1,0,0,0,0,0,0,0,0.4772727272727273,0.5227272727272727
89670,0.6000000000000001,0.4444444444444444,-150,125,0.5733333333333334,0.42666666666666664,home,HOU,under,7.5,0.5454545454545454,-120,0.5227272727272727,HOU,SF,2023 REG,5,2,7,4,6,12,0,1,-2,2,1,1,0,0,0,0,0,0,0,0.4772727272727273,0.5227272727272727
89671,0.7701149425287357,0.2777777777777778,-335,260,0.7332320429823401,0.2667679570176599,away,WSH,over,8.5,0.5121951219512195,-105,0.48919479393107135,LAA,WSH,2023 REG,5,2,1,0,2,6,1,0,2,-2,0,0,0,0,0,0,0,0,0,0.48919479393107135,0.5108052060689287
89671,0.7701149425287357,0.2777777777777778,-335,260,0.7332320429823401,0.2667679570176599,home,LAA,under,8.5,0.5327102803738317,-114,0.5108052060689287,LAA,WSH,2023 REG,5,2,1,0,2,6,1,0,2,-2,0,0,0,0,0,0,0,0,0,0.48919479393107135,0.5108052060689287
89672,0.5391705069124424,0.49751243781094534,-117,101,0.5193921450108923,0.48060785498910774,away,MIA,over,8,0.5348837209302326,-115,0.5097020142727117,CWS,MIA,2023 REG,7,5,10,6,11,17,0,1,-1,1,1,1,1,1,1,0,0,0,0,0.5097020142727117,0.49029798572728833
89672,0.5391705069124424,0.49751243781094534,-117,101,0.5193921450108923,0.48060785498910774,home,CWS,under,8,0.5121951219512195,-105,0.49029798572728833,CWS,MIA,2023 REG,7,5,10,6,11,17,0,1,-1,1,1,1,1,1,1,0,0,0,0,0.5097020142727117,0.49029798572728833
89673,0.4081632653061224,0.6363636363636364,145,-175,0.3899890197266291,0.6100109802733709,away,SD,over,12.5,0.5169082125603864,-107,0.49239402434819424,COL,SD,2023 REG,12,5,9,8,13,21,0,1,-3,3,1,1,1,1,1,0,0,0,0,0.49239402434819424,0.5076059756518058
89673,0.4081632653061224,0.6363636363636364,145,-175,0.3899890197266291,0.6100109802733709,home,COL,under,12.5,0.5305164319248826,-113,0.5076059756518058,COL,SD,2023 REG,12,5,9,8,13,21,0,1,-3,3,1,1,1,1,1,0,0,0,0,0.49239402434819424,0.5076059756518058
89674,0.4444444444444444,0.5918367346938775,125,-145,0.42831947593852354,0.5716805240614764,away,STL,over,8.5,0.5098039215686274,-104,0.48592421718142587,WSH,STL,2023 REG,8,3,14,9,12,22,0,1,-6,6,1,1,1,0,0,0,0,0,0,0.48592421718142587,0.5140757828185741
89674,0.4444444444444444,0.5918367346938775,125,-145,0.42831947593852354,0.5716805240614764,home,WSH,under,8.5,0.5370370370370371,-116,0.5140757828185741,WSH,STL,2023 REG,8,3,14,9,12,22,0,1,-6,6,1,1,1,0,0,0,0,0,0,0.48592421718142587,0.5140757828185741
89675,0.6168582375478928,0.425531914893617,-161,135,0.5907095228234366,0.4092904771765634,away,DET,over,8.5,0.5192307692307692,-108,0.49455035168025013,NYY,DET,2023 REG,6,3,14,10,13,20,0,1,-7,7,1,1,1,0,0,0,0,0,0,0.49455035168025013,0.5054496483197499
89675,0.6168582375478928,0.425531914893617,-161,135,0.5907095228234366,0.4092904771765634,home,NYY,under,8.5,0.5283018867924528,-112,0.5054496483197499,NYY,DET,2023 REG,6,3,14,10,13,20,0,1,-7,7,1,1,1,0,0,0,0,0,0,0.49455035168025013,0.5054496483197499
89676,0.6183206106870228,0.42194092827004215,-162,137,0.5934260713318911,0.40657392866810893,away,CIN,over,10.5,0.5305164319248826,-113,0.5066009958897986,BOS,CIN,2023 REG,10,4,8,5,9,18,0,1,-1,1,1,1,1,1,0,0,0,0,0,0.5066009958897986,0.49339900411020143
89676,0.6183206106870228,0.42194092827004215,-162,137,0.5934260713318911,0.40657392866810893,home,BOS,under,10.5,0.5145631067961165,-106,0.49339900411020143,BOS,CIN,2023 REG,10,4,8,5,9,18,0,1,-1,1,1,1,1,1,0,0,0,0,0,0.5066009958897986,0.49339900411020143
89677,0.5780590717299579,0.4608294930875576,-137,117,0.5555791840506346,0.44442081594936544,away,CLE,over,7.5,0.5391705069124424,-117,0.5127649394825569,SF,CLE,2023 REG,12,5,9,4,9,21,1,0,1,-1,1,1,1,1,0,0,0,0,0,0.5127649394825569,0.48723506051744314
89677,0.5780590717299579,0.4608294930875576,-137,117,0.5555791840506346,0.44442081594936544,home,SF,under,7.5,0.5098039215686274,-104,0.48723506051744314,SF,CLE,2023 REG,12,5,9,4,9,21,1,0,1,-1,1,1,1,1,0,0,0,0,0,0.5127649394825569,0.48723506051744314
89678,0.5,0.5454545454545454,100,-120,0.4772727272727273,0.5227272727272727,away,TB,over,7,0.5238095238095238,-110,0.4988662131519274,MIN,TB,2023 REG,6,4,13,7,11,19,0,1,-3,3,1,1,1,1,0,0,0,0,0,0.4988662131519274,0.5011337868480725
89678,0.5,0.5454545454545454,100,-120,0.4772727272727273,0.5227272727272727,home,MIN,under,7,0.5238095238095238,-110,0.5011337868480725,MIN,TB,2023 REG,6,4,13,7,11,19,0,1,-3,3,1,1,1,1,0,0,0,0,0,0.4988662131519274,0.5011337868480725
89679,0.6894409937888198,0.35211267605633806,-222,184,0.6607921903552016,0.33920780964479835,away,WSH,over,8.5,0.5412844036697247,-118,0.5162581740877563,NYY,WSH,2023 REG,12,5,9,6,11,21,0,1,-1,1,1,1,1,1,1,0,0,0,0,0.5162581740877563,0.4837418259122437
89679,0.6894409937888198,0.35211267605633806,-222,184,0.6607921903552016,0.33920780964479835,home,NYY,under,8.5,0.504950495049505,-102,0.4837418259122437,NYY,WSH,2023 REG,12,5,9,6,11,21,0,1,-1,1,1,1,1,1,1,0,0,0,0,0.5162581740877563,0.4837418259122437
89680,0.5454545454545454,0.49504950495049505,-120,102,0.5233614270517961,0.4766385729482039,away,SEA,over,8.5,0.5283018867924528,-112,0.5031902949311281,TEX,SEA,2023 REG,7,2,6,0,2,13,1,0,2,-2,0,0,0,0,0,0,0,0,0,0.5031902949311281,0.4968097050688719
89680,0.5454545454545454,0.49504950495049505,-120,102,0.5233614270517961,0.4766385729482039,home,TEX,under,8.5,0.5192307692307692,-108,0.4968097050688719,TEX,SEA,2023 REG,7,2,6,0,2,13,1,0,2,-2,0,0,0,0,0,0,0,0,0,0.5031902949311281,0.4968097050688719
89681,0.4166666666666667,0.6226415094339623,140,-165,0.4002882599580712,0.5997117400419287,away,MIN,over,7.5,0.5348837209302326,-115,0.5097020142727117,DET,MIN,2023 REG,8,3,8,2,5,16,1,0,1,-1,1,1,0,0,0,0,0,0,0,0.5097020142727117,0.49029798572728833
89681,0.4166666666666667,0.6226415094339623,140,-165,0.4002882599580712,0.5997117400419287,home,DET,under,7.5,0.5121951219512195,-105,0.49029798572728833,DET,MIN,2023 REG,8,3,8,2,5,16,1,0,1,-1,1,1,0,0,0,0,0,0,0,0.5097020142727117,0.49029798572728833
89682,0.5098039215686274,0.5348837209302326,-104,-115,0.4870219861770517,0.5129780138229483,away,BAL,over,10.5,0.5283018867924528,-112,0.5031902949311281,BOS,BAL,2023 REG,4,2,14,11,13,18,0,1,-9,9,1,1,0,0,0,0,0,0,0,0.5031902949311281,0.4968097050688719
89682,0.5098039215686274,0.5348837209302326,-104,-115,0.4870219861770517,0.5129780138229483,home,BOS,under,10.5,0.5192307692307692,-108,0.4968097050688719,BOS,BAL,2023 REG,4,2,14,11,13,18,0,1,-9,9,1,1,0,0,0,0,0,0,0,0.5031902949311281,0.4968097050688719
89683,0.5121951219512195,0.5327102803738317,-105,-114,0.48919479393107135,0.5108052060689287,away,NYM,over,9,0.5391705069124424,-117,0.5127649394825569,ARI,NYM,2023 REG,4,1,6,2,3,10,0,1,-1,1,1,0,0,0,0,0,0,0,0,0.5127649394825569,0.48723506051744314
89683,0.5121951219512195,0.5327102803738317,-105,-114,0.48919479393107135,0.5108052060689287,home,ARI,under,9,0.5098039215686274,-104,0.48723506051744314,ARI,NYM,2023 REG,4,1,6,2,3,10,0,1,-1,1,1,0,0,0,0,0,0,0,0,0.5127649394825569,0.48723506051744314
89685,0.5798319327731092,0.4587155963302753,-138,118,0.557480844469466,0.442519155530534,away,MIL,over,8,0.5327102803738317,-114,0.508788710910954,TB,MIL,2023 REG,7,4,10,6,10,17,0,1,-2,2,1,1,1,1,0,0,0,0,0,0.508788710910954,0.491211289089046
89685,0.5798319327731092,0.4587155963302753,-138,118,0.557480844469466,0.442519155530534,home,TB,under,8,0.5121951219512195,-105,0.491211289089046,TB,MIL,2023 REG,7,4,10,6,10,17,0,1,-2,2,1,1,1,1,0,0,0,0,0,0.508788710910954,0.491211289089046
89686,0.5495495495495495,0.48780487804878053,-122,105,0.529021440689206,0.470978559310794,away,TEX,over,6.5,0.5348837209302326,-115,0.5097020142727117,CHC,TEX,2023 REG,6,2,3,0,2,9,1,0,2,-2,0,0,0,0,0,0,0,0,0,0.5097020142727117,0.49029798572728833
89686,0.5495495495495495,0.48780487804878053,-122,105,0.529021440689206,0.470978559310794,home,CHC,under,6.5,0.5121951219512195,-105,0.49029798572728833,CHC,TEX,2023 REG,6,2,3,0,2,9,1,0,2,-2,0,0,0,0,0,0,0,0,0,0.5097020142727117,0.49029798572728833
89687,0.6551724137931035,0.3846153846153846,-190,160,0.6291045458703008,0.37089545412969915,away,NYY,over,8.5,0.5238095238095238,-110,0.4988662131519274,HOU,NYY,2023 REG,9,4,8,5,9,17,0,1,-1,1,1,1,1,1,0,0,0,0,0,0.4988662131519274,0.5011337868480725
89687,0.6551724137931035,0.3846153846153846,-190,160,0.6291045458703008,0.37089545412969915,home,HOU,under,8.5,0.5238095238095238,-110,0.5011337868480725,HOU,NYY,2023 REG,9,4,8,5,9,17,0,1,-1,1,1,1,1,1,0,0,0,0,0,0.4988662131519274,0.5011337868480725
89688,0.7333333333333333,0.3125,-275,220,0.6997222222222221,0.30027777777777787,away,OAK,over,8.5,0.5370370370370371,-116,0.5131785224377817,NYY,OAK,2023 REG,10,10,10,5,15,20,1,0,5,-5,1,1,1,1,1,0,0,0,0,0.5131785224377817,0.4868214775622183
89688,0.7333333333333333,0.3125,-275,220,0.6997222222222221,0.30027777777777787,home,NYY,under,8.5,0.5073891625615764,-103,0.4868214775622183,NYY,OAK,2023 REG,10,10,10,5,15,20,1,0,5,-5,1,1,1,1,1,0,0,0,0,0.5131785224377817,0.4868214775622183
89689,0.7101449275362319,0.3278688524590164,-245,205,0.6831496344961281,0.3168503655038719,away,WSH,over,7.5,0.5283018867924528,-112,0.5056562298022652,MIN,WSH,2023 REG,6,2,6,3,5,12,0,1,-1,1,1,1,0,0,0,0,0,0,0,0.5056562298022652,0.4943437701977348
89689,0.7101449275362319,0.3278688524590164,-245,205,0.6831496344961281,0.3168503655038719,home,MIN,under,7.5,0.5145631067961165,-106,0.4943437701977348,MIN,WSH,2023 REG,6,2,6,3,5,12,0,1,-1,1,1,1,0,0,0,0,0,0,0,0.5056562298022652,0.4943437701977348
89690,0.726027397260274,0.3125,-265,220,0.6980554513041847,0.30194454869581533,away,DET,over,7.5,0.5,100,0.4772727272727273,TB,DET,2023 REG,8,5,2,1,6,10,1,0,4,-4,1,0,0,0,0,0,0,0,0,0.4772727272727273,0.5227272727272727
89690,0.726027397260274,0.3125,-265,220,0.6980554513041847,0.30194454869581533,home,TB,under,7.5,0.5454545454545454,-120,0.5227272727272727,TB,DET,2023 REG,8,5,2,1,6,10,1,0,4,-4,1,0,0,0,0,0,0,0,0,0.4772727272727273,0.5227272727272727
89692,0.42372881355932196,0.613899613899614,136,-159,0.407784564636044,0.5922154353639559,away,TEX,over,9,0.5,100,0.4783105022831051,DET,TEX,2023 REG,11,3,11,2,5,22,1,0,1,-1,1,1,0,0,0,0,0,0,0,0.4783105022831051,0.5216894977168949
89692,0.42372881355932196,0.613899613899614,136,-159,0.407784564636044,0.5922154353639559,home,DET,under,9,0.5433789954337899,-119,0.5216894977168949,DET,TEX,2023 REG,11,3,11,2,5,22,1,0,1,-1,1,1,0,0,0,0,0,0,0,0.4783105022831051,0.5216894977168949
89693,0.5305164319248826,0.5121951219512195,-113,-105,0.5078572507605655,0.49214274923943446,away,SF,over,9,0.5327102803738317,-114,0.508788710910954,LAA,SF,2023 REG,12,7,5,5,12,17,1,0,2,-2,1,1,1,1,1,0,0,0,0,0.508788710910954,0.491211289089046
89693,0.5305164319248826,0.5121951219512195,-113,-105,0.5078572507605655,0.49214274923943446,home,LAA,under,9,0.5121951219512195,-105,0.491211289089046,LAA,SF,2023 REG,12,7,5,5,12,17,1,0,2,-2,1,1,1,1,1,0,0,0,0,0.508788710910954,0.491211289089046
89694,0.6254681647940076,0.41152263374485604,-167,143,0.6023315979176397,0.3976684020823603,away,COL,over,9.5,0.5,100,0.4772727272727273,WSH,COL,2023 REG,7,6,16,10,16,23,0,1,-4,4,1,1,1,1,1,1,0,0,0,0.4772727272727273,0.5227272727272727
89694,0.6254681647940076,0.41152263374485604,-167,143,0.6023315979176397,0.3976684020823603,home,WSH,under,9.5,0.5454545454545454,-120,0.5227272727272727,WSH,COL,2023 REG,7,6,16,10,16,23,0,1,-4,4,1,1,1,1,1,1,0,0,0,0.4772727272727273,0.5227272727272727
89695,0.49019607843137253,0.5454545454545454,104,-120,0.4727202824088637,0.5272797175911363,away,MIA,over,11,0.5121951219512195,-105,0.48808156828023186,COL,MIA,2023 REG,13,7,12,6,13,25,1,0,1,-1,1,1,1,1,1,1,0,0,0,0.48808156828023186,0.5119184317197681
89695,0.49019607843137253,0.5454545454545454,104,-120,0.4727202824088637,0.5272797175911363,home,COL,under,11,0.5348837209302326,-115,0.5119184317197681,COL,MIA,2023 REG,13,7,12,6,13,25,1,0,1,-1,1,1,1,1,1,1,0,0,0,0.48808156828023186,0.5119184317197681
89696,0.48309178743961345,0.5555555555555556,107,-125,0.4644215734322854,0.5355784265677146,away,MIL,over,8.5,0.5348837209302326,-115,0.5097020142727117,ARI,MIL,2023 REG,4,1,8,7,8,12,0,1,-6,6,1,0,0,0,0,0,0,0,0,0.5097020142727117,0.49029798572728833
89696,0.48309178743961345,0.5555555555555556,107,-125,0.4644215734322854,0.5355784265677146,home,ARI,under,8.5,0.5121951219512195,-105,0.49029798572728833,ARI,MIL,2023 REG,4,1,8,7,8,12,0,1,-6,6,1,0,0,0,0,0,0,0,0,0.5097020142727117,0.49029798572728833
89697,0.5121951219512195,0.5348837209302326,-105,-115,0.48808156828023186,0.5119184317197681,away,SF,over,7.5,0.5391705069124424,-117,0.5153817639191344,ARI,SF,2023 REG,14,7,3,1,8,17,1,0,6,-6,1,0,0,0,0,0,0,0,0,0.5153817639191344,0.4846182360808656
89697,0.5121951219512195,0.5348837209302326,-105,-115,0.48808156828023186,0.5119184317197681,home,ARI,under,7.5,0.504950495049505,-102,0.4846182360808656,ARI,SF,2023 REG,14,7,3,1,8,17,1,0,6,-6,1,0,0,0,0,0,0,0,0,0.5153817639191344,0.4846182360808656
89698,0.5850622406639003,0.45248868778280543,-141,121,0.5630926103278608,0.43690738967213916,away,CLE,over,8.5,0.5391705069124424,-117,0.5140669063204599,NYM,CLE,2023 REG,12,10,11,9,19,23,1,0,1,-1,1,1,1,1,1,1,1,1,1,0.5140669063204599,0.4859330936795401
89698,0.5850622406639003,0.45248868778280543,-141,121,0.5630926103278608,0.43690738967213916,home,NYM,under,8.5,0.5073891625615764,-103,0.4859330936795401,NYM,CLE,2023 REG,12,10,11,9,19,23,1,0,1,-1,1,1,1,1,1,1,1,1,1,0.5140669063204599,0.4859330936795401
89699,0.45248868778280543,0.5850622406639003,121,-141,0.43549731744492953,0.5645026825550705,away,PHI,over,11.5,0.5192307692307692,-108,0.49455035168025013,COL,PHI,2023 REG,8,4,11,7,11,19,0,1,-3,3,1,1,1,1,0,0,0,0,0,0.49455035168025013,0.5054496483197499
89699,0.45248868778280543,0.5850622406639003,121,-141,0.43549731744492953,0.5645026825550705,home,COL,under,11.5,0.5283018867924528,-112,0.5054496483197499,COL,PHI,2023 REG,8,4,11,7,11,19,0,1,-3,3,1,1,1,1,0,0,0,0,0,0.49455035168025013,0.5054496483197499
89700,0.3968253968253968,0.6453900709219857,152,-182,0.380073227084372,0.6199267729156279,away,MIN,over,8.5,0.5238095238095238,-110,0.4988662131519274,CWS,MIN,2023 REG,6,0,7,4,4,13,0,1,-4,4,0,0,0,0,0,0,0,0,0,0.4988662131519274,0.5011337868480725
89700,0.3968253968253968,0.6453900709219857,152,-182,0.380073227084372,0.6199267729156279,home,CWS,under,8.5,0.5238095238095238,-110,0.5011337868480725,CWS,MIN,2023 REG,6,0,7,4,4,13,0,1,-4,4,0,0,0,0,0,0,0,0,0,0.4988662131519274,0.5011337868480725
89701,0.5348837209302326,0.5,-115,-100,0.5162249864791779,0.4837750135208221,away,MIN,over,8,0.5121951219512195,-105,0.48808156828023186,TB,MIN,2023 REG,6,2,3,1,3,9,1,0,1,-1,1,0,0,0,0,0,0,0,0,0.48808156828023186,0.5119184317197681
89701,0.5348837209302326,0.5,-115,-100,0.5162249864791779,0.4837750135208221,home,TB,under,8,0.5348837209302326,-115,0.5119184317197681,TB,MIN,2023 REG,6,2,3,1,3,9,1,0,1,-1,1,0,0,0,0,0,0,0,0,0.48808156828023186,0.5119184317197681
89702,0.5238095238095238,0.5238095238095238,-110,-110,0.4988662131519274,0.5011337868480725,away,HOU,over,9,0.5215311004784688,-109,0.4978845547971712,MIL,HOU,2023 REG,5,4,4,0,4,9,1,0,4,-4,0,0,0,0,0,0,0,0,0,0.4978845547971712,0.5021154452028288
89702,0.5238095238095238,0.5238095238095238,-110,-110,0.4988662131519274,0.5011337868480725,home,MIL,under,9,0.5238095238095238,-110,0.5021154452028288,MIL,HOU,2023 REG,5,4,4,0,4,9,1,0,4,-4,0,0,0,0,0,0,0,0,0,0.4978845547971712,0.5021154452028288
89703,0.4587155963302753,0.5884773662551441,118,-143,0.43706744835531225,0.5629325516446877,away,SD,over,8.5,0.5238095238095238,-110,0.4988662131519274,OAK,SD,2023 REG,9,2,6,5,7,15,0,1,-3,3,1,1,0,0,0,0,0,0,0,0.4988662131519274,0.5011337868480725
89703,0.4587155963302753,0.5884773662551441,118,-143,0.43706744835531225,0.5629325516446877,home,OAK,under,8.5,0.5238095238095238,-110,0.5011337868480725,OAK,SD,2023 REG,9,2,6,5,7,15,0,1,-3,3,1,1,0,0,0,0,0,0,0,0.4988662131519274,0.5011337868480725
89704,0.42016806722689076,0.6197718631178707,138,-163,0.4033865838887557,0.5966134161112443,away,DET,over,8,0.5145631067961165,-106,0.49023796582517226,OAK,DET,2023 REG,9,8,5,2,10,14,1,0,6,-6,1,1,0,0,0,0,0,0,0,0.49023796582517226,0.5097620341748277
89704,0.42016806722689076,0.6197718631178707,138,-163,0.4033865838887557,0.5966134161112443,home,OAK,under,8,0.5327102803738317,-114,0.5097620341748277,OAK,DET,2023 REG,9,8,5,2,10,14,1,0,6,-6,1,1,0,0,0,0,0,0,0,0.49023796582517226,0.5097620341748277
89705,0.5884773662551441,0.4504504504504505,-143,122,0.5655692272061728,0.43443077279382725,away,MIA,over,8,0.5098039215686274,-104,0.48592421718142587,PHI,MIA,2023 REG,11,4,14,8,12,25,0,1,-4,4,1,1,1,1,0,0,0,0,0,0.48592421718142587,0.5140757828185741
89705,0.5884773662551441,0.4504504504504505,-143,122,0.5655692272061728,0.43443077279382725,home,PHI,under,8,0.5370370370370371,-116,0.5140757828185741,PHI,MIA,2023 REG,11,4,14,8,12,25,0,1,-4,4,1,1,1,1,0,0,0,0,0,0.48592421718142587,0.5140757828185741
89706,0.5555555555555556,0.48780487804878053,-125,105,0.5314664257753688,0.46853357422463116,away,LAD,over,9.5,0.5192307692307692,-108,0.49571111079951763,BAL,LAD,2023 REG,9,3,13,10,13,22,0,1,-7,7,1,1,1,0,0,0,0,0,0,0.49571111079951763,0.5042888892004824
89706,0.5555555555555556,0.48780487804878053,-125,105,0.5314664257753688,0.46853357422463116,home,BAL,under,9.5,0.5260663507109005,-111,0.5042888892004824,BAL,LAD,2023 REG,9,3,13,10,13,22,0,1,-7,7,1,1,1,0,0,0,0,0,0,0.49571111079951763,0.5042888892004824
89707,0.47619047619047616,0.5652173913043479,110,-130,0.4564724440500838,0.5435275559499162,away,CHC,over,9.5,0.5121951219512195,-105,0.48808156828023186,PIT,CHC,2023 REG,7,6,10,10,16,17,0,1,-4,4,1,1,1,1,1,1,0,0,0,0.48808156828023186,0.5119184317197681
89707,0.47619047619047616,0.5652173913043479,110,-130,0.4564724440500838,0.5435275559499162,home,PIT,under,9.5,0.5348837209302326,-115,0.5119184317197681,PIT,CHC,2023 REG,7,6,10,10,16,17,0,1,-4,4,1,1,1,1,1,1,0,0,0,0.48808156828023186,0.5119184317197681
89708,0.4098360655737705,0.6254681647940076,144,-167,0.39536711870173025,0.6046328812982698,away,LAD,over,8,0.5215311004784688,-109,0.49670754937970685,MIL,LAD,2023 REG,5,1,9,8,9,14,0,1,-7,7,1,0,0,0,0,0,0,0,0,0.49670754937970685,0.5032924506202932
89708,0.4098360655737705,0.6254681647940076,144,-167,0.39536711870173025,0.6046328812982698,home,MIL,under,8,0.5260663507109005,-111,0.5032924506202932,MIL,LAD,2023 REG,5,1,9,8,9,14,0,1,-7,7,1,0,0,0,0,0,0,0,0,0.49670754937970685,0.5032924506202932
89709,0.6389891696750902,0.4,-177,150,0.614075512518083,0.385924487481917,away,BOS,over,7.5,0.5024875621890548,-101,0.47839724939301687,TB,BOS,2023 REG,11,7,6,2,9,17,1,0,5,-5,1,1,0,0,0,0,0,0,0,0.47839724939301687,0.5216027506069831
89709,0.6389891696750902,0.4,-177,150,0.614075512518083,0.385924487481917,home,TB,under,7.5,0.5454545454545454,-120,0.5216027506069831,TB,BOS,2023 REG,11,7,6,2,9,17,1,0,5,-5,1,1,0,0,0,0,0,0,0,0.47839724939301687,0.5216027506069831
89710,0.47846889952153115,0.5594713656387665,109,-127,0.4603156626027285,0.5396843373972715,away,LAD,over,10,0.5348837209302326,-115,0.5097020142727117,BOS,LAD,2023 REG,14,4,10,7,11,24,0,1,-3,3,1,1,1,1,0,0,0,0,0,0.5097020142727117,0.49029798572728833
89710,0.47846889952153115,0.5594713656387665,109,-127,0.4603156626027285,0.5396843373972715,home,BOS,under,10,0.5121951219512195,-105,0.49029798572728833,BOS,LAD,2023 REG,14,4,10,7,11,24,0,1,-3,3,1,1,1,1,0,0,0,0,0,0.5097020142727117,0.49029798572728833
89711,0.635036496350365,0.40485829959514175,-174,147,0.6097018449105176,0.3902981550894824,away,TEX,over,8.5,0.5121951219512195,-105,0.48808156828023186,TB,TEX,2023 REG,8,8,3,3,11,11,1,0,5,-5,1,1,1,0,0,0,0,0,0,0.48808156828023186,0.5119184317197681
89711,0.635036496350365,0.40485829959514175,-174,147,0.6097018449105176,0.3902981550894824,home,TB,under,8.5,0.5348837209302326,-115,0.5119184317197681,TB,TEX,2023 REG,8,8,3,3,11,11,1,0,5,-5,1,1,1,0,0,0,0,0,0,0.48808156828023186,0.5119184317197681
89712,0.5454545454545454,0.5,-120,100,0.5206611570247933,0.4793388429752067,away,HOU,over,10.5,0.5238095238095238,-110,0.4988662131519274,BOS,HOU,2023 REG,6,2,9,6,8,15,0,1,-4,4,1,1,0,0,0,0,0,0,0,0.4988662131519274,0.5011337868480725
89712,0.5454545454545454,0.5,-120,100,0.5206611570247933,0.4793388429752067,home,BOS,under,10.5,0.5238095238095238,-110,0.5011337868480725,BOS,HOU,2023 REG,6,2,9,6,8,15,0,1,-4,4,1,1,0,0,0,0,0,0,0,0.4988662131519274,0.5011337868480725
89713,0.49019607843137253,0.5515695067264574,104,-123,0.4697227523736127,0.5302772476263873,away,PHI,over,9,0.5327102803738317,-114,0.508788710910954,STL,PHI,2023 REG,6,1,11,6,7,17,0,1,-5,5,1,0,0,0,0,0,0,0,0,0.508788710910954,0.491211289089046
89713,0.49019607843137253,0.5515695067264574,104,-123,0.4697227523736127,0.5302772476263873,home,STL,under,9,0.5121951219512195,-105,0.491211289089046,STL,PHI,2023 REG,6,1,11,6,7,17,0,1,-5,5,1,0,0,0,0,0,0,0,0,0.508788710910954,0.491211289089046
89714,0.45454545454545453,0.5884773662551441,120,-143,0.43498962690881876,0.5650103730911813,away,TOR,over,9.5,0.5391705069124424,-117,0.5127649394825569,CIN,TOR,2023 REG,6,3,9,4,7,15,0,1,-1,1,1,1,1,0,0,0,0,0,0,0.5127649394825569,0.48723506051744314
89714,0.45454545454545453,0.5884773662551441,120,-143,0.43498962690881876,0.5650103730911813,home,CIN,under,9.5,0.5098039215686274,-104,0.48723506051744314,CIN,TOR,2023 REG,6,3,9,4,7,15,0,1,-1,1,1,1,1,0,0,0,0,0,0,0.5127649394825569,0.48723506051744314
89715,0.3802281368821293,0.6551724137931035,163,-190,0.36676785145428414,0.6332321485457159,away,LAD,over,12,0.5327102803738317,-114,0.5075272610403079,COL,LAD,2023 REG,12,9,9,8,17,21,1,0,1,-1,1,1,1,1,1,1,1,1,0,0.5075272610403079,0.4924727389596921
89715,0.3802281368821293,0.6551724137931035,163,-190,0.36676785145428414,0.6332321485457159,home,COL,under,12,0.5145631067961165,-106,0.4924727389596921,COL,LAD,2023 REG,12,9,9,8,17,21,1,0,1,-1,1,1,1,1,1,1,1,1,0,0.5075272610403079,0.4924727389596921
89716,0.782608695652174,0.25510204081632654,-360,292,0.7530959453724779,0.24690405462752207,away,OAK,over,8.5,0.5305164319248826,-113,0.5066009958897986,HOU,OAK,2023 REG,5,2,4,0,2,9,1,0,2,-2,0,0,0,0,0,0,0,0,0,0.5066009958897986,0.49339900411020143
89716,0.782608695652174,0.25510204081632654,-360,292,0.7530959453724779,0.24690405462752207,home,HOU,under,8.5,0.5145631067961165,-106,0.49339900411020143,HOU,OAK,2023 REG,5,2,4,0,2,9,1,0,2,-2,0,0,0,0,0,0,0,0,0,0.5066009958897986,0.49339900411020143
89717,0.5098039215686274,0.5327102803738317,-104,-114,0.4881300146960012,0.5118699853039987,away,TB,over,8.5,0.5121951219512195,-105,0.48808156828023186,NYY,TB,2023 REG,7,2,6,5,7,13,0,1,-3,3,1,1,0,0,0,0,0,0,0,0.48808156828023186,0.5119184317197681
89717,0.5098039215686274,0.5327102803738317,-104,-114,0.4881300146960012,0.5118699853039987,home,NYY,under,8.5,0.5348837209302326,-115,0.5119184317197681,NYY,TB,2023 REG,7,2,6,5,7,13,0,1,-3,3,1,1,0,0,0,0,0,0,0,0.48808156828023186,0.5119184317197681
89718,0.5726495726495727,0.46511627906976744,-134,115,0.5510229738017454,0.44897702619825464,away,SF,over,7.5,0.5238095238095238,-110,0.4988662131519274,CWS,SF,2023 REG,13,7,4,3,10,17,1,0,4,-4,1,1,1,0,0,0,0,0,0,0.4988662131519274,0.5011337868480725
89718,0.5726495726495727,0.46511627906976744,-134,115,0.5510229738017454,0.44897702619825464,home,CWS,under,7.5,0.5238095238095238,-110,0.5011337868480725,CWS,SF,2023 REG,13,7,4,3,10,17,1,0,4,-4,1,1,1,0,0,0,0,0,0,0.4988662131519274,0.5011337868480725
89719,0.696969696969697,0.3389830508474576,-230,195,0.6719117212183469,0.32808827878165314,away,KC,over,9,0.5327102803738317,-114,0.508788710910954,SD,KC,2023 REG,5,4,2,0,4,7,1,0,4,-4,0,0,0,0,0,0,0,0,0,0.508788710910954,0.491211289089046
89719,0.696969696969697,0.3389830508474576,-230,195,0.6719117212183469,0.32808827878165314,home,SD,under,9,0.5121951219512195,-105,0.491211289089046,SD,KC,2023 REG,5,4,2,0,4,7,1,0,4,-4,0,0,0,0,0,0,0,0,0,0.508788710910954,0.491211289089046
89720,0.5305164319248826,0.5145631067961165,-113,-106,0.5066009958897986,0.49339900411020143,away,MIL,over,9,0.5121951219512195,-105,0.48808156828023186,NYY,MIL,2023 REG,3,2,16,8,10,19,0,1,-6,6,1,1,0,0,0,0,0,0,0,0.48808156828023186,0.5119184317197681
89720,0.5305164319248826,0.5145631067961165,-113,-106,0.5066009958897986,0.49339900411020143,home,NYY,under,9,0.5348837209302326,-115,0.5119184317197681,NYY,MIL,2023 REG,3,2,16,8,10,19,0,1,-6,6,1,1,0,0,0,0,0,0,0,0.48808156828023186,0.5119184317197681
89721,0.4484304932735426,0.5918367346938775,123,-145,0.43037344037335423,0.5696265596266458,away,STL,over,10.5,0.5348837209302326,-115,0.5097020142727117,CIN,STL,2023 REG,9,5,12,8,13,21,0,1,-3,3,1,1,1,1,1,0,0,0,0,0.5097020142727117,0.49029798572728833
89721,0.4484304932735426,0.5918367346938775,123,-145,0.43037344037335423,0.5696265596266458,home,CIN,under,10.5,0.5121951219512195,-105,0.49029798572728833,CIN,STL,2023 REG,9,5,12,8,13,21,0,1,-3,3,1,1,1,1,1,0,0,0,0,0.5097020142727117,0.49029798572728833
89722,0.5689655172413793,0.47619047619047616,-132,110,0.5432733140818753,0.4567266859181247,away,NYM,over,9.5,0.5121951219512195,-105,0.48919479393107135,ATL,NYM,2023 REG,14,7,6,5,12,20,1,0,2,-2,1,1,1,1,1,0,0,0,0,0.48919479393107135,0.5108052060689287
89722,0.5689655172413793,0.47619047619047616,-132,110,0.5432733140818753,0.4567266859181247,home,ATL,under,9.5,0.5327102803738317,-114,0.5108052060689287,ATL,NYM,2023 REG,14,7,6,5,12,20,1,0,2,-2,1,1,1,1,1,0,0,0,0,0.48919479393107135,0.5108052060689287
89723,0.6621621621621622,0.37878787878787884,-196,164,0.6350465945060539,0.36495340549394606,away,STL,over,9,0.5495495495495495,-122,0.5250401592387142,BAL,STL,2023 REG,3,0,4,1,1,7,0,1,-1,1,0,0,0,0,0,0,0,0,0,0.5250401592387142,0.47495984076128583
89723,0.6621621621621622,0.37878787878787884,-196,164,0.6350465945060539,0.36495340549394606,home,BAL,under,9,0.49504950495049505,102,0.47495984076128583,BAL,STL,2023 REG,3,0,4,1,1,7,0,1,-1,1,0,0,0,0,0,0,0,0,0,0.5250401592387142,0.47495984076128583
89724,0.574468085106383,0.4716981132075471,-135,112,0.547947077564338,0.452052922435662,away,NYY,over,7.5,0.5121951219512195,-105,0.48808156828023186,SEA,NYY,2023 REG,7,4,18,10,14,25,0,1,-6,6,1,1,1,1,0,0,0,0,0,0.48808156828023186,0.5119184317197681
89724,0.574468085106383,0.4716981132075471,-135,112,0.547947077564338,0.452052922435662,home,SEA,under,7.5,0.5348837209302326,-115,0.5119184317197681,SEA,NYY,2023 REG,7,4,18,10,14,25,0,1,-6,6,1,1,1,1,0,0,0,0,0,0.48808156828023186,0.5119184317197681
89725,0.3891050583657587,0.6527777777777778,157,-188,0.3728082349636045,0.6271917650363955,away,CHC,over,12.5,0.5169082125603864,-107,0.49239402434819424,COL,CHC,2023 REG,9,6,10,4,10,19,1,0,2,-2,1,1,1,1,0,0,0,0,0,0.49239402434819424,0.5076059756518058
89725,0.3891050583657587,0.6527777777777778,157,-188,0.3728082349636045,0.6271917650363955,home,COL,under,12.5,0.5305164319248826,-113,0.5076059756518058,COL,CHC,2023 REG,9,6,10,4,10,19,1,0,2,-2,1,1,1,1,0,0,0,0,0,0.49239402434819424,0.5076059756518058
89726,0.6153846153846154,0.42194092827004215,-160,137,0.5924150500586723,0.40758494994132766,away,MIL,over,9.5,0.49504950495049505,102,0.47297076509898783,TOR,MIL,2023 REG,14,7,4,2,9,18,1,0,5,-5,1,1,0,0,0,0,0,0,0,0.47297076509898783,0.5270292349010122
89726,0.6153846153846154,0.42194092827004215,-160,137,0.5924150500586723,0.40758494994132766,home,TOR,under,9.5,0.5495495495495495,-122,0.5270292349010122,TOR,MIL,2023 REG,14,7,4,2,9,18,1,0,5,-5,1,1,0,0,0,0,0,0,0,0.47297076509898783,0.5270292349010122
89727,0.5454545454545454,0.49504950495049505,-120,102,0.5233614270517961,0.4766385729482039,away,SF,over,7,0.5495495495495495,-122,0.5250401592387142,MIA,SF,2023 REG,9,4,7,3,7,16,1,0,1,-1,1,1,1,0,0,0,0,0,0,0.5250401592387142,0.47495984076128583
89727,0.5454545454545454,0.49504950495049505,-120,102,0.5233614270517961,0.4766385729482039,home,MIA,under,7,0.49504950495049505,102,0.47495984076128583,MIA,SF,2023 REG,9,4,7,3,7,16,1,0,1,-1,1,1,1,0,0,0,0,0,0,0.5250401592387142,0.47495984076128583
89728,0.574468085106383,0.4672897196261683,-135,114,0.550479558983428,0.44952044101657196,away,CIN,over,9,0.5238095238095238,-110,0.4988662131519274,NYM,CIN,2023 REG,13,8,9,4,12,22,1,0,4,-4,1,1,1,1,0,0,0,0,0,0.4988662131519274,0.5011337868480725
89728,0.574468085106383,0.4672897196261683,-135,114,0.550479558983428,0.44952044101657196,home,NYM,under,9,0.5238095238095238,-110,0.5011337868480725,NYM,CIN,2023 REG,13,8,9,4,12,22,1,0,4,-4,1,1,1,1,0,0,0,0,0,0.4988662131519274,0.5011337868480725
89729,0.31746031746031744,0.7159090909090909,215,-252,0.30686685448590206,0.6931331455140979,away,ATL,over,8,0.5348837209302326,-115,0.5109810284308424,DET,ATL,2023 REG,15,7,11,10,17,26,0,1,-3,3,1,1,1,1,1,1,1,0,0,0.5109810284308424,0.48901897156915763
89729,0.31746031746031744,0.7159090909090909,215,-252,0.30686685448590206,0.6931331455140979,home,DET,under,8,0.5098039215686274,-104,0.48901897156915763,DET,ATL,2023 REG,15,7,11,10,17,26,0,1,-3,3,1,1,1,1,1,1,1,0,0,0.5109810284308424,0.48901897156915763
89730,0.3921568627450981,0.6453900709219857,155,-182,0.37743257503251615,0.6225674249674839,away,ATL,over,8.5,0.5121951219512195,-105,0.48919479393107135,SF,ATL,2023 REG,8,3,9,7,10,17,0,1,-4,4,1,1,1,0,0,0,0,0,0,0.48919479393107135,0.5108052060689287
89730,0.3921568627450981,0.6453900709219857,155,-182,0.37743257503251615,0.6225674249674839,home,SF,under,8.5,0.5327102803738317,-114,0.5108052060689287,SF,ATL,2023 REG,8,3,9,7,10,17,0,1,-4,4,1,1,1,0,0,0,0,0,0,0.48919479393107135,0.5108052060689287
89731,0.45454545454545453,0.5850622406639003,120,-141,0.4365419567230205,0.5634580432769796,away,MIN,over,8.5,0.5454545454545454,-120,0.5206611570247933,STL,MIN,2023 REG,8,3,7,5,8,15,0,1,-2,2,1,1,1,0,0,0,0,0,0,0.5206611570247933,0.4793388429752067
89731,0.45454545454545453,0.5850622406639003,120,-141,0.4365419567230205,0.5634580432769796,home,STL,under,8.5,0.5,100,0.4793388429752067,STL,MIN,2023 REG,8,3,7,5,8,15,0,1,-2,2,1,1,1,0,0,0,0,0,0,0.5206611570247933,0.4793388429752067
89732,0.6428571428571428,0.3968253968253968,-180,152,0.6173469387755103,0.3826530612244897,away,OAK,over,9,0.5495495495495495,-122,0.5250401592387142,LAA,OAK,2023 REG,10,5,6,3,8,16,1,0,2,-2,1,1,1,0,0,0,0,0,0,0.5250401592387142,0.47495984076128583
89732,0.6428571428571428,0.3968253968253968,-180,152,0.6173469387755103,0.3826530612244897,home,LAA,under,9,0.49504950495049505,102,0.47495984076128583,LAA,OAK,2023 REG,10,5,6,3,8,16,1,0,2,-2,1,1,1,0,0,0,0,0,0,0.5250401592387142,0.47495984076128583
89733,0.607843137254902,0.4329004329004329,-155,131,0.583077437748718,0.416922562251282,away,MIL,over,8.5,0.5348837209302326,-115,0.5097020142727117,NYM,MIL,2023 REG,7,2,9,5,7,16,0,1,-3,3,1,1,0,0,0,0,0,0,0,0.5097020142727117,0.49029798572728833
89733,0.607843137254902,0.4329004329004329,-155,131,0.583077437748718,0.416922562251282,home,NYM,under,8.5,0.5121951219512195,-105,0.49029798572728833,NYM,MIL,2023 REG,7,2,9,5,7,16,0,1,-3,3,1,1,0,0,0,0,0,0,0,0.5097020142727117,0.49029798572728833
89734,0.5689655172413793,0.4716981132075471,-132,112,0.5458293137100936,0.4541706862899064,away,CIN,over,10,0.5121951219512195,-105,0.48808156828023186,WSH,CIN,2023 REG,8,4,6,5,9,14,0,1,-1,1,1,1,1,1,0,0,0,0,0,0.48808156828023186,0.5119184317197681
89734,0.5689655172413793,0.4716981132075471,-132,112,0.5458293137100936,0.4541706862899064,home,WSH,under,10,0.5348837209302326,-115,0.5119184317197681,WSH,CIN,2023 REG,8,4,6,5,9,14,0,1,-1,1,1,1,1,1,0,0,0,0,0,0.48808156828023186,0.5119184317197681
89735,0.5121951219512195,0.5348837209302326,-105,-115,0.48808156828023186,0.5119184317197681,away,STL,over,9.5,0.5412844036697247,-118,0.5149381613977361,BOS,STL,2023 REG,5,1,14,9,10,19,0,1,-8,8,1,0,0,0,0,0,0,0,0,0.5149381613977361,0.48506183860226393
89735,0.5121951219512195,0.5348837209302326,-105,-115,0.48808156828023186,0.5119184317197681,home,BOS,under,9.5,0.5073891625615764,-103,0.48506183860226393,BOS,STL,2023 REG,5,1,14,9,10,19,0,1,-8,8,1,0,0,0,0,0,0,0,0,0.5149381613977361,0.48506183860226393
89737,0.45454545454545453,0.576271186440678,120,-136,0.4405378904608488,0.5594621095391512,away,MIN,over,9,0.5,100,0.4772727272727273,BOS,MIN,2023 REG,7,4,9,10,14,16,0,1,-6,6,1,1,1,1,0,0,0,0,0,0.4772727272727273,0.5227272727272727
89737,0.45454545454545453,0.576271186440678,120,-136,0.4405378904608488,0.5594621095391512,home,BOS,under,9,0.5454545454545454,-120,0.5227272727272727,BOS,MIN,2023 REG,7,4,9,10,14,16,0,1,-6,6,1,1,1,1,0,0,0,0,0,0.4772727272727273,0.5227272727272727
89738,0.4444444444444444,0.5967741935483871,125,-148,0.42612504978096366,0.5738749502190363,away,SD,over,9,0.5098039215686274,-104,0.48592421718142587,ARI,SD,2023 REG,10,5,11,4,9,21,1,0,1,-1,1,1,1,1,0,0,0,0,0,0.48592421718142587,0.5140757828185741
89738,0.4444444444444444,0.5967741935483871,125,-148,0.42612504978096366,0.5738749502190363,home,ARI,under,9,0.5370370370370371,-116,0.5140757828185741,ARI,SD,2023 REG,10,5,11,4,9,21,1,0,1,-1,1,1,1,1,0,0,0,0,0,0.48592421718142587,0.5140757828185741
89739,0.6363636363636364,0.4065040650406504,-175,146,0.6090841900154538,0.3909158099845462,away,LAA,over,9.5,0.5145631067961165,-106,0.49023796582517226,HOU,LAA,2023 REG,13,11,5,3,14,18,1,0,8,-8,1,1,1,0,0,0,0,0,0,0.49023796582517226,0.5097620341748277
89739,0.6363636363636364,0.4065040650406504,-175,146,0.6090841900154538,0.3909158099845462,home,HOU,under,9.5,0.5327102803738317,-114,0.5097620341748277,HOU,LAA,2023 REG,13,11,5,3,14,18,1,0,8,-8,1,1,1,0,0,0,0,0,0,0.49023796582517226,0.5097620341748277
89740,0.607843137254902,0.4329004329004329,-155,131,0.583077437748718,0.416922562251282,away,SD,over,8.5,0.5238095238095238,-110,0.4988662131519274,LAD,SD,2023 REG,8,4,5,2,6,13,1,0,2,-2,1,1,0,0,0,0,0,0,0,0.4988662131519274,0.5011337868480725
89740,0.607843137254902,0.4329004329004329,-155,131,0.583077437748718,0.416922562251282,home,LAD,under,8.5,0.5238095238095238,-110,0.5011337868480725,LAD,SD,2023 REG,8,4,5,2,6,13,1,0,2,-2,1,1,0,0,0,0,0,0,0,0.4988662131519274,0.5011337868480725
89741,0.574468085106383,0.46511627906976744,-135,115,0.5517281312179562,0.44827186878204384,away,BAL,over,7.5,0.5238095238095238,-110,0.4988662131519274,CWS,BAL,2023 REG,7,4,12,8,12,19,0,1,-4,4,1,1,1,1,0,0,0,0,0,0.4988662131519274,0.5011337868480725
89741,0.574468085106383,0.46511627906976744,-135,115,0.5517281312179562,0.44827186878204384,home,CWS,under,7.5,0.5238095238095238,-110,0.5011337868480725,CWS,BAL,2023 REG,7,4,12,8,12,19,0,1,-4,4,1,1,1,1,0,0,0,0,0,0.4988662131519274,0.5011337868480725
89742,0.6491228070175439,0.390625,-185,156,0.6233215989535241,0.3766784010464759,away,MIL,over,8,0.5145631067961165,-106,0.4913668392989033,TOR,MIL,2023 REG,9,3,6,1,4,15,1,0,2,-2,1,0,0,0,0,0,0,0,0,0.4913668392989033,0.5086331607010968
89742,0.6491228070175439,0.390625,-185,156,0.6233215989535241,0.3766784010464759,home,TOR,under,8,0.5305164319248826,-113,0.5086331607010968,TOR,MIL,2023 REG,9,3,6,1,4,15,1,0,2,-2,1,0,0,0,0,0,0,0,0,0.4913668392989033,0.5086331607010968
89743,0.6402877697841727,0.39370078740157477,-178,154,0.6185253123055287,0.38147468769447135,away,BAL,over,8,0.5121951219512195,-105,0.48808156828023186,TB,BAL,2023 REG,9,3,6,4,7,15,0,1,-1,1,1,1,1,0,0,0,0,0,0,0.48808156828023186,0.5119184317197681
89743,0.6402877697841727,0.39370078740157477,-178,154,0.6185253123055287,0.38147468769447135,home,TB,under,8,0.5348837209302326,-115,0.5119184317197681,TB,BAL,2023 REG,9,3,6,4,7,15,0,1,-1,1,1,1,1,0,0,0,0,0,0,0.48808156828023186,0.5119184317197681
89744,0.5535714285714286,0.48309178743961345,-124,107,0.5332757197081732,0.4667242802918268,away,ARI,over,8.5,0.5238095238095238,-110,0.5000596729920038,MIA,ARI,2023 REG,9,3,6,2,5,15,1,0,1,-1,1,1,0,0,0,0,0,0,0,0.5000596729920038,0.4999403270079962
89744,0.5535714285714286,0.48309178743961345,-124,107,0.5332757197081732,0.4667242802918268,home,MIA,under,8.5,0.5215311004784688,-109,0.4999403270079962,MIA,ARI,2023 REG,9,3,6,2,5,15,1,0,1,-1,1,1,0,0,0,0,0,0,0,0.5000596729920038,0.4999403270079962
89745,0.7142857142857143,0.3278688524590164,-250,205,0.6841753094680495,0.3158246905319505,away,COL,over,8.5,0.5412844036697247,-118,0.5149381613977361,ARI,COL,2023 REG,6,4,5,2,6,11,1,0,2,-2,1,1,0,0,0,0,0,0,0,0.5149381613977361,0.48506183860226393
89745,0.7142857142857143,0.3278688524590164,-250,205,0.6841753094680495,0.3158246905319505,home,ARI,under,8.5,0.5073891625615764,-103,0.48506183860226393,ARI,COL,2023 REG,6,4,5,2,6,11,1,0,2,-2,1,1,0,0,0,0,0,0,0,0.5149381613977361,0.48506183860226393
89746,0.5594713656387665,0.48309178743961345,-127,107,0.5356585002601133,0.4643414997398867,away,TEX,over,8,0.5348837209302326,-115,0.5097020142727117,SF,TEX,2023 REG,10,3,8,2,5,18,1,0,1,-1,1,1,0,0,0,0,0,0,0,0.5097020142727117,0.49029798572728833
89746,0.5594713656387665,0.48309178743961345,-127,107,0.5356585002601133,0.4643414997398867,home,SF,under,8,0.5121951219512195,-105,0.49029798572728833,SF,TEX,2023 REG,10,3,8,2,5,18,1,0,1,-1,1,1,0,0,0,0,0,0,0,0.5097020142727117,0.49029798572728833
89747,0.635036496350365,0.4,-174,150,0.6127870424636368,0.3872129575363632,away,BOS,over,9,0.5348837209302326,-115,0.5097020142727117,SD,BOS,2023 REG,6,7,7,0,7,13,1,0,7,-7,0,0,0,0,0,0,0,0,0,0.5097020142727117,0.49029798572728833
89747,0.635036496350365,0.4,-174,150,0.6127870424636368,0.3872129575363632,home,SD,under,9,0.5121951219512195,-105,0.49029798572728833,SD,BOS,2023 REG,6,7,7,0,7,13,1,0,7,-7,0,0,0,0,0,0,0,0,0,0.5097020142727117,0.49029798572728833
89748,0.6031746031746031,0.43103448275862066,-152,132,0.582540551341865,0.417459448658135,away,STL,over,8,0.5348837209302326,-115,0.5097020142727117,LAD,STL,2023 REG,5,1,3,0,1,8,1,0,1,-1,0,0,0,0,0,0,0,0,0,0.5097020142727117,0.49029798572728833
89748,0.6031746031746031,0.43103448275862066,-152,132,0.582540551341865,0.417459448658135,home,LAD,under,8,0.5121951219512195,-105,0.49029798572728833,LAD,STL,2023 REG,5,1,3,0,1,8,1,0,1,-1,0,0,0,0,0,0,0,0,0,0.5097020142727117,0.49029798572728833
89749,0.36363636363636365,0.6774193548387096,175,-210,0.3487070114636097,0.6512929885363903,away,LAD,over,12.5,0.5238095238095238,-110,0.4988662131519274,COL,LAD,2023 REG,7,2,12,8,10,19,0,1,-6,6,1,1,0,0,0,0,0,0,0,0.4988662131519274,0.5011337868480725
89749,0.36363636363636365,0.6774193548387096,175,-210,0.3487070114636097,0.6512929885363903,home,COL,under,12.5,0.5238095238095238,-110,0.5011337868480725,COL,LAD,2023 REG,7,2,12,8,10,19,0,1,-6,6,1,1,0,0,0,0,0,0,0,0.4988662131519274,0.5011337868480725
89750,0.607843137254902,0.43103448275862066,-155,132,0.5842116427368785,0.41578835726312147,away,CHC,over,9.5,0.5024875621890548,-101,0.47839724939301687,STL,CHC,2023 REG,7,2,8,3,5,15,0,1,-1,1,1,1,0,0,0,0,0,0,0,0.47839724939301687,0.5216027506069831
89750,0.607843137254902,0.43103448275862066,-155,132,0.5842116427368785,0.41578835726312147,home,STL,under,9.5,0.5454545454545454,-120,0.5216027506069831,STL,CHC,2023 REG,7,2,8,3,5,15,0,1,-1,1,1,1,0,0,0,0,0,0,0,0.47839724939301687,0.5216027506069831
89751,0.5833333333333333,0.4566210045662101,-140,119,0.5600266362252664,0.4399733637747336,away,BOS,over,8,0.5215311004784688,-109,0.4978845547971712,SF,BOS,2023 REG,6,2,8,3,5,14,0,1,-1,1,1,1,0,0,0,0,0,0,0,0.4978845547971712,0.5021154452028288
89751,0.5833333333333333,0.4566210045662101,-140,119,0.5600266362252664,0.4399733637747336,home,SF,under,8,0.5238095238095238,-110,0.5021154452028288,SF,BOS,2023 REG,6,2,8,3,5,14,0,1,-1,1,1,1,0,0,0,0,0,0,0,0.4978845547971712,0.5021154452028288
89752,0.75,0.2898550724637681,-300,245,0.720108695652174,0.27989130434782605,away,KC,over,8,0.5145631067961165,-106,0.49023796582517226,TEX,KC,2023 REG,10,8,11,5,13,21,1,0,3,-3,1,1,1,1,1,0,0,0,0,0.49023796582517226,0.5097620341748277
89752,0.75,0.2898550724637681,-300,245,0.720108695652174,0.27989130434782605,home,TEX,under,8,0.5327102803738317,-114,0.5097620341748277,TEX,KC,2023 REG,10,8,11,5,13,21,1,0,3,-3,1,1,1,1,1,0,0,0,0,0.49023796582517226,0.5097620341748277
89753,0.37037037037037035,0.6721311475409836,170,-205,0.35462906744023925,0.6453709325597607,away,SEA,over,9,0.5454545454545454,-120,0.5206611570247933,KC,SEA,2023 REG,10,5,12,6,11,22,0,1,-1,1,1,1,1,1,1,0,0,0,0,0.5206611570247933,0.4793388429752067
89753,0.37037037037037035,0.6721311475409836,170,-205,0.35462906744023925,0.6453709325597607,home,KC,under,9,0.5,100,0.4793388429752067,KC,SEA,2023 REG,10,5,12,6,11,22,0,1,-1,1,1,1,1,1,1,0,0,0,0,0.5206611570247933,0.4793388429752067
89754,0.607843137254902,0.4347826086956522,-155,130,0.5819333701084867,0.41806662989151333,away,PIT,over,9,0.5,100,0.4772727272727273,BOS,PIT,2023 REG,4,1,5,4,5,9,0,1,-3,3,1,0,0,0,0,0,0,0,0,0.4772727272727273,0.5227272727272727
89754,0.607843137254902,0.4347826086956522,-155,130,0.5819333701084867,0.41806662989151333,home,BOS,under,9,0.5454545454545454,-120,0.5227272727272727,BOS,PIT,2023 REG,4,1,5,4,5,9,0,1,-3,3,1,0,0,0,0,0,0,0,0,0.4772727272727273,0.5227272727272727
89755,0.6226415094339623,0.4166666666666667,-165,140,0.5981666073335706,0.40183339266642937,away,WSH,over,10.5,0.5348837209302326,-115,0.5097020142727117,CIN,WSH,2023 REG,7,3,10,6,9,17,0,1,-3,3,1,1,1,0,0,0,0,0,0,0.5097020142727117,0.49029798572728833
89755,0.6226415094339623,0.4166666666666667,-165,140,0.5981666073335706,0.40183339266642937,home,CIN,under,10.5,0.5121951219512195,-105,0.49029798572728833,CIN,WSH,2023 REG,7,3,10,6,9,17,0,1,-3,3,1,1,1,0,0,0,0,0,0,0.5097020142727117,0.49029798572728833
89756,0.6415770609318996,0.4,-179,150,0.6149021723770248,0.3850978276229752,away,CIN,over,8.5,0.5475113122171946,-121,0.5214983313199976,ARI,CIN,2023 REG,10,3,3,2,5,13,1,0,1,-1,1,1,0,0,0,0,0,0,0,0.5214983313199976,0.47850166868000243
89756,0.6415770609318996,0.4,-179,150,0.6149021723770248,0.3850978276229752,home,ARI,under,8.5,0.5,100,0.47850166868000243,ARI,CIN,2023 REG,10,3,3,2,5,13,1,0,1,-1,1,1,0,0,0,0,0,0,0,0.5214983313199976,0.47850166868000243
89757,0.4672897196261683,0.5652173913043479,114,-130,0.45209948087359064,0.5479005191264094,away,ATL,over,9,0.5348837209302326,-115,0.5097020142727117,KC,ATL,2023 REG,7,3,11,10,13,18,0,1,-7,7,1,1,1,0,0,0,0,0,0,0.5097020142727117,0.49029798572728833
89757,0.4672897196261683,0.5652173913043479,114,-130,0.45209948087359064,0.5479005191264094,home,KC,under,9,0.5121951219512195,-105,0.49029798572728833,KC,ATL,2023 REG,7,3,11,10,13,18,0,1,-7,7,1,1,1,0,0,0,0,0,0,0.5097020142727117,0.49029798572728833
89758,0.4587155963302753,0.5833333333333333,118,-140,0.4394270964845833,0.5605729035154168,away,DET,over,7.5,0.5412844036697247,-118,0.5162581740877563,OAK,DET,2023 REG,7,0,11,2,2,18,0,1,-2,2,0,0,0,0,0,0,0,0,0,0.5162581740877563,0.4837418259122437
89758,0.4587155963302753,0.5833333333333333,118,-140,0.4394270964845833,0.5605729035154168,home,OAK,under,7.5,0.504950495049505,-102,0.4837418259122437,OAK,DET,2023 REG,7,0,11,2,2,18,0,1,-2,2,0,0,0,0,0,0,0,0,0,0.5162581740877563,0.4837418259122437
89759,0.4016064257028112,0.6363636363636364,149,-175,0.3863574047925913,0.6136425952074087,away,MIN,over,9,0.5,100,0.4772727272727273,CWS,MIN,2023 REG,7,2,14,10,12,21,0,1,-8,8,1,1,0,0,0,0,0,0,0,0.4772727272727273,0.5227272727272727
89759,0.4016064257028112,0.6363636363636364,149,-175,0.3863574047925913,0.6136425952074087,home,CWS,under,9,0.5454545454545454,-120,0.5227272727272727,CWS,MIN,2023 REG,7,2,14,10,12,21,0,1,-8,8,1,1,0,0,0,0,0,0,0,0.4772727272727273,0.5227272727272727
89760,0.626865671641791,0.4065040650406504,-168,146,0.6059473292438428,0.39405267075615724,away,NYM,over,10.5,0.5238095238095238,-110,0.4988662131519274,ATL,NYM,2023 REG,10,6,4,4,10,14,1,0,2,-2,1,1,1,1,0,0,0,0,0,0.4988662131519274,0.5011337868480725
89760,0.626865671641791,0.4065040650406504,-168,146,0.6059473292438428,0.39405267075615724,home,ATL,under,10.5,0.5238095238095238,-110,0.5011337868480725,ATL,NYM,2023 REG,10,6,4,4,10,14,1,0,2,-2,1,1,1,1,0,0,0,0,0,0.4988662131519274,0.5011337868480725
89761,0.5391705069124424,0.5,-117,100,0.5180509248444435,0.4819490751555565,away,TB,over,8.5,0.5238095238095238,-110,0.5000596729920038,NYY,TB,2023 REG,4,2,11,8,10,15,0,1,-6,6,1,1,0,0,0,0,0,0,0,0.5000596729920038,0.4999403270079962
89761,0.5391705069124424,0.5,-117,100,0.5180509248444435,0.4819490751555565,home,NYY,under,8.5,0.5215311004784688,-109,0.4999403270079962,NYY,TB,2023 REG,4,2,11,8,10,15,0,1,-6,6,1,1,0,0,0,0,0,0,0,0.5000596729920038,0.4999403270079962
89762,0.6254681647940076,0.41152263374485604,-167,143,0.6023315979176397,0.3976684020823603,away,CIN,over,8.5,0.5238095238095238,-110,0.5000596729920038,HOU,CIN,2023 REG,6,1,5,2,3,11,0,1,-1,1,1,0,0,0,0,0,0,0,0,0.5000596729920038,0.4999403270079962
89762,0.6254681647940076,0.41152263374485604,-167,143,0.6023315979176397,0.3976684020823603,home,HOU,under,8.5,0.5215311004784688,-109,0.4999403270079962,HOU,CIN,2023 REG,6,1,5,2,3,11,0,1,-1,1,1,0,0,0,0,0,0,0,0,0.5000596729920038,0.4999403270079962
89763,0.6031746031746031,0.4347826086956522,-152,130,0.5802797769671475,0.4197202230328525,away,TEX,over,9,0.5348837209302326,-115,0.5097020142727117,BAL,TEX,2023 REG,7,3,7,2,5,14,1,0,1,-1,1,1,0,0,0,0,0,0,0,0.5097020142727117,0.49029798572728833
89763,0.6031746031746031,0.4347826086956522,-152,130,0.5802797769671475,0.4197202230328525,home,BAL,under,9,0.5121951219512195,-105,0.49029798572728833,BAL,TEX,2023 REG,7,3,7,2,5,14,1,0,1,-1,1,1,0,0,0,0,0,0,0,0.5097020142727117,0.49029798572728833
89764,0.37037037037037035,0.6688741721854304,170,-202,0.35583535460896265,0.6441646453910373,away,NYM,over,11.5,0.5121951219512195,-105,0.48919479393107135,COL,NYM,2023 REG,14,10,12,7,17,26,1,0,3,-3,1,1,1,1,1,1,1,0,0,0.48919479393107135,0.5108052060689287
89764,0.37037037037037035,0.6688741721854304,170,-202,0.35583535460896265,0.6441646453910373,home,COL,under,11.5,0.5327102803738317,-114,0.5108052060689287,COL,NYM,2023 REG,14,10,12,7,17,26,1,0,3,-3,1,1,1,1,1,1,1,0,0,0.48919479393107135,0.5108052060689287
89765,0.626865671641791,0.4081632653061224,-168,145,0.6049072335550394,0.3950927664449606,away,BAL,over,8,0.5238095238095238,-110,0.4988662131519274,NYY,BAL,2023 REG,11,6,7,5,11,18,1,0,1,-1,1,1,1,1,1,0,0,0,0,0.4988662131519274,0.5011337868480725
89765,0.626865671641791,0.4081632653061224,-168,145,0.6049072335550394,0.3950927664449606,home,NYY,under,8,0.5238095238095238,-110,0.5011337868480725,NYY,BAL,2023 REG,11,6,7,5,11,18,1,0,1,-1,1,1,1,1,1,0,0,0,0,0.4988662131519274,0.5011337868480725
89766,0.7481108312342569,0.29239766081871343,-297,242,0.717805989572463,0.282194010427537,away,OAK,over,9,0.5121951219512195,-105,0.48919479393107135,HOU,OAK,2023 REG,7,3,7,2,5,14,1,0,1,-1,1,1,0,0,0,0,0,0,0,0.48919479393107135,0.5108052060689287
89766,0.7481108312342569,0.29239766081871343,-297,242,0.717805989572463,0.282194010427537,home,HOU,under,9,0.5327102803738317,-114,0.5108052060689287,HOU,OAK,2023 REG,7,3,7,2,5,14,1,0,1,-1,1,1,0,0,0,0,0,0,0,0.48919479393107135,0.5108052060689287
89767,0.6923076923076923,0.3472222222222222,-225,188,0.6649408284023669,0.3350591715976331,away,COL,over,9,0.5454545454545454,-120,0.5206611570247933,PHI,COL,2023 REG,6,0,7,5,5,13,0,1,-5,5,0,0,0,0,0,0,0,0,0,0.5206611570247933,0.4793388429752067
89767,0.6923076923076923,0.3472222222222222,-225,188,0.6649408284023669,0.3350591715976331,home,PHI,under,9,0.5,100,0.4793388429752067,PHI,COL,2023 REG,6,0,7,5,5,13,0,1,-5,5,0,0,0,0,0,0,0,0,0,0.5206611570247933,0.4793388429752067
89768,0.6031746031746031,0.4347826086956522,-152,130,0.5802797769671475,0.4197202230328525,away,CIN,over,8,0.5169082125603864,-107,0.49239402434819424,MIL,CIN,2023 REG,10,3,6,4,7,16,0,1,-1,1,1,1,1,0,0,0,0,0,0,0.49239402434819424,0.5076059756518058
89768,0.6031746031746031,0.4347826086956522,-152,130,0.5802797769671475,0.4197202230328525,home,MIL,under,8,0.5305164319248826,-113,0.5076059756518058,MIL,CIN,2023 REG,10,3,6,4,7,16,0,1,-1,1,1,1,1,0,0,0,0,0,0,0.49239402434819424,0.5076059756518058
89769,0.6453900709219857,0.39370078740157477,-182,154,0.6201612190961417,0.37983878090385825,away,NYM,over,9,0.504950495049505,-102,0.48054649490447493,PHI,NYM,2023 REG,6,5,3,2,7,9,1,0,3,-3,1,1,0,0,0,0,0,0,0,0.48054649490447493,0.5194535050955251
89769,0.6453900709219857,0.39370078740157477,-182,154,0.6201612190961417,0.37983878090385825,home,PHI,under,9,0.5433789954337899,-119,0.5194535050955251,PHI,NYM,2023 REG,6,5,3,2,7,9,1,0,3,-3,1,1,0,0,0,0,0,0,0,0.48054649490447493,0.5194535050955251
89770,0.6389891696750902,0.4016064257028112,-177,149,0.6130490238920991,0.38695097610790086,away,NYM,over,9,0.5,100,0.4772727272727273,MIN,NYM,2023 REG,4,0,4,2,2,8,0,1,-2,2,0,0,0,0,0,0,0,0,0,0.4772727272727273,0.5227272727272727
89770,0.6389891696750902,0.4016064257028112,-177,149,0.6130490238920991,0.38695097610790086,home,MIN,under,9,0.5454545454545454,-120,0.5227272727272727,MIN,NYM,2023 REG,4,0,4,2,2,8,0,1,-2,2,0,0,0,0,0,0,0,0,0,0.4772727272727273,0.5227272727272727
89771,0.5815899581589958,0.45454545454545453,-139,120,0.5605739649961564,0.4394260350038436,away,ATL,over,9.5,0.5238095238095238,-110,0.4988662131519274,STL,ATL,2023 REG,10,1,12,4,5,22,0,1,-3,3,1,0,0,0,0,0,0,0,0,0.4988662131519274,0.5011337868480725
89771,0.5815899581589958,0.45454545454545453,-139,120,0.5605739649961564,0.4394260350038436,home,STL,under,9.5,0.5238095238095238,-110,0.5011337868480725,STL,ATL,2023 REG,10,1,12,4,5,22,0,1,-3,3,1,0,0,0,0,0,0,0,0,0.4988662131519274,0.5011337868480725
89772,0.5652173913043479,0.4694835680751174,-130,113,0.5456038055681285,0.4543961944318715,away,BAL,over,8.5,0.5192307692307692,-108,0.49455035168025013,CHC,BAL,2023 REG,12,10,9,3,13,21,1,0,7,-7,1,1,1,0,0,0,0,0,0,0.49455035168025013,0.5054496483197499
89772,0.5652173913043479,0.4694835680751174,-130,113,0.5456038055681285,0.4543961944318715,home,CHC,under,8.5,0.5283018867924528,-112,0.5054496483197499,CHC,BAL,2023 REG,12,10,9,3,13,21,1,0,7,-7,1,1,1,0,0,0,0,0,0,0.49455035168025013,0.5054496483197499
89773,0.5594713656387665,0.4807692307692307,-127,108,0.5369579042122659,0.46304209578773414,away,CWS,over,9,0.5283018867924528,-112,0.5031902949311281,LAA,CWS,2023 REG,11,5,17,11,16,28,0,1,-6,6,1,1,1,1,1,0,0,0,0,0.5031902949311281,0.4968097050688719
89773,0.5594713656387665,0.4807692307692307,-127,108,0.5369579042122659,0.46304209578773414,home,LAA,under,9,0.5192307692307692,-108,0.4968097050688719,LAA,CWS,2023 REG,11,5,17,11,16,28,0,1,-6,6,1,1,1,1,1,0,0,0,0,0.5031902949311281,0.4968097050688719
89774,0.5652173913043479,0.47619047619047616,-130,110,0.5418129444594474,0.4581870555405526,away,SF,over,8.5,0.5370370370370371,-116,0.5118817074154765,CHC,SF,2023 REG,6,5,2,0,5,8,1,0,5,-5,0,0,0,0,0,0,0,0,0,0.5118817074154765,0.48811829258452355
89774,0.5652173913043479,0.47619047619047616,-130,110,0.5418129444594474,0.4581870555405526,home,CHC,under,8.5,0.5098039215686274,-104,0.48811829258452355,CHC,SF,2023 REG,6,5,2,0,5,8,1,0,5,-5,0,0,0,0,0,0,0,0,0,0.5118817074154765,0.48811829258452355
89775,0.37735849056603776,0.6551724137931035,165,-190,0.3650826776003241,0.6349173223996759,away,BAL,over,9.5,0.5121951219512195,-105,0.48808156828023186,KC,BAL,2023 REG,16,10,10,13,23,26,0,1,-3,3,1,1,1,1,1,1,1,1,1,0.48808156828023186,0.5119184317197681
89775,0.37735849056603776,0.6551724137931035,165,-190,0.3650826776003241,0.6349173223996759,home,KC,under,9.5,0.5348837209302326,-115,0.5119184317197681,KC,BAL,2023 REG,16,10,10,13,23,26,0,1,-3,3,1,1,1,1,1,1,1,1,1,0.48808156828023186,0.5119184317197681
89776,0.5327102803738317,0.5098039215686274,-114,-104,0.5100625279371946,0.48993747206280536,away,TOR,over,10,0.5192307692307692,-108,0.49455035168025013,BOS,TOR,2023 REG,8,1,16,13,14,24,0,1,-12,12,1,0,0,0,0,0,0,0,0,0.49455035168025013,0.5054496483197499
89776,0.5327102803738317,0.5098039215686274,-114,-104,0.5100625279371946,0.48993747206280536,home,BOS,under,10,0.5283018867924528,-112,0.5054496483197499,BOS,TOR,2023 REG,8,1,16,13,14,24,0,1,-12,12,1,0,0,0,0,0,0,0,0,0.49455035168025013,0.5054496483197499
89777,0.5967741935483871,0.4444444444444444,-148,125,0.5721759741010521,0.42782402589894786,away,SEA,over,7.5,0.5327102803738317,-114,0.5075272610403079,HOU,SEA,2023 REG,11,3,17,10,13,28,0,1,-7,7,1,1,1,0,0,0,0,0,0,0.5075272610403079,0.4924727389596921
89777,0.5967741935483871,0.4444444444444444,-148,125,0.5721759741010521,0.42782402589894786,home,HOU,under,7.5,0.5145631067961165,-106,0.4924727389596921,HOU,SEA,2023 REG,11,3,17,10,13,28,0,1,-7,7,1,1,1,0,0,0,0,0,0,0.5075272610403079,0.4924727389596921
89778,0.6031746031746031,0.4347826086956522,-152,130,0.5802797769671475,0.4197202230328525,away,WSH,over,11,0.5283018867924528,-112,0.5031902949311281,COL,WSH,2023 REG,11,6,11,7,13,22,0,1,-1,1,1,1,1,1,1,1,0,0,0,0.5031902949311281,0.4968097050688719
89778,0.6031746031746031,0.4347826086956522,-152,130,0.5802797769671475,0.4197202230328525,home,COL,under,11,0.5192307692307692,-108,0.4968097050688719,COL,WSH,2023 REG,11,6,11,7,13,22,0,1,-1,1,1,1,1,1,1,1,0,0,0,0.5031902949311281,0.4968097050688719
89779,0.6254681647940076,0.4098360655737705,-167,144,0.6033864926164085,0.39661350738359147,away,OAK,over,9.5,0.5260663507109005,-111,0.5022370601254724,MIL,OAK,2023 REG,6,1,7,2,3,13,0,1,-1,1,1,0,0,0,0,0,0,0,0,0.5022370601254724,0.4977629398745276
89779,0.6254681647940076,0.4098360655737705,-167,144,0.6033864926164085,0.39661350738359147,home,MIL,under,9.5,0.5192307692307692,-108,0.4977629398745276,MIL,OAK,2023 REG,6,1,7,2,3,13,0,1,-1,1,1,0,0,0,0,0,0,0,0,0.5022370601254724,0.4977629398745276
89781,0.4484304932735426,0.5884773662551441,123,-143,0.43187988361942303,0.5681201163805769,away,MIA,over,8.5,0.5370370370370371,-116,0.5131785224377817,PIT,MIA,2023 REG,9,3,10,4,7,19,0,1,-1,1,1,1,1,0,0,0,0,0,0,0.5131785224377817,0.4868214775622183
89781,0.4484304932735426,0.5884773662551441,123,-143,0.43187988361942303,0.5681201163805769,home,PIT,under,8.5,0.5073891625615764,-103,0.4868214775622183,PIT,MIA,2023 REG,9,3,10,4,7,19,0,1,-1,1,1,1,1,0,0,0,0,0,0,0.5131785224377817,0.4868214775622183
89782,0.5884773662551441,0.4504504504504505,-143,122,0.5655692272061728,0.43443077279382725,away,LAA,over,8,0.5433789954337899,-119,0.5184560714286826,MIL,LAA,2023 REG,5,7,11,5,12,16,1,0,2,-2,1,1,1,1,1,0,0,0,0,0.5184560714286826,0.48154392857131745
89782,0.5884773662551441,0.4504504504504505,-143,122,0.5655692272061728,0.43443077279382725,home,MIL,under,8,0.5024875621890548,-101,0.48154392857131745,MIL,LAA,2023 REG,5,7,11,5,12,16,1,0,2,-2,1,1,1,1,1,0,0,0,0,0.5184560714286826,0.48154392857131745
89783,0.5121951219512195,0.5305164319248826,-105,-113,0.4903184724049234,0.5096815275950766,away,HOU,over,7,0.5238095238095238,-110,0.4988662131519274,STL,HOU,2023 REG,8,4,7,2,6,15,1,0,2,-2,1,1,0,0,0,0,0,0,0,0.4988662131519274,0.5011337868480725
89783,0.5121951219512195,0.5305164319248826,-105,-113,0.4903184724049234,0.5096815275950766,home,STL,under,7,0.5238095238095238,-110,0.5011337868480725,STL,HOU,2023 REG,8,4,7,2,6,15,1,0,2,-2,1,1,0,0,0,0,0,0,0,0.4988662131519274,0.5011337868480725
89784,0.5412844036697247,0.49751243781094534,-118,101,0.5202842784645914,0.47971572153540865,away,CHC,over,9,0.5348837209302326,-115,0.5097020142727117,TOR,CHC,2023 REG,14,11,5,4,15,19,1,0,7,-7,1,1,1,1,0,0,0,0,0,0.5097020142727117,0.49029798572728833
89784,0.5412844036697247,0.49751243781094534,-118,101,0.5202842784645914,0.47971572153540865,home,TOR,under,9,0.5121951219512195,-105,0.49029798572728833,TOR,CHC,2023 REG,14,11,5,4,15,19,1,0,7,-7,1,1,1,1,0,0,0,0,0,0.5097020142727117,0.49029798572728833
89786,0.6389891696750902,0.39840637450199207,-177,151,0.6150938219518283,0.38490617804817173,away,KC,over,9,0.504950495049505,-102,0.4826715732667395,CWS,KC,2023 REG,9,5,4,2,7,13,1,0,3,-3,1,1,0,0,0,0,0,0,0,0.4826715732667395,0.5173284267332605
89786,0.6389891696750902,0.39840637450199207,-177,151,0.6150938219518283,0.38490617804817173,home,CWS,under,9,0.5391705069124424,-117,0.5173284267332605,CWS,KC,2023 REG,9,5,4,2,7,13,1,0,3,-3,1,1,0,0,0,0,0,0,0,0.4826715732667395,0.5173284267332605
89787,0.5348837209302326,0.5073891625615764,-115,-103,0.5122726437136835,0.48772735628631647,away,TEX,over,8,0.5348837209302326,-115,0.5097020142727117,TB,TEX,2023 REG,7,4,12,8,12,19,0,1,-4,4,1,1,1,1,0,0,0,0,0,0.5097020142727117,0.49029798572728833
89787,0.5348837209302326,0.5073891625615764,-115,-103,0.5122726437136835,0.48772735628631647,home,TB,under,8,0.5121951219512195,-105,0.49029798572728833,TB,TEX,2023 REG,7,4,12,8,12,19,0,1,-4,4,1,1,1,1,0,0,0,0,0,0.5097020142727117,0.49029798572728833
89788,0.6610169491525424,0.37735849056603776,-195,165,0.6356501330673793,0.3643498669326207,away,ARI,over,8.5,0.5145631067961165,-106,0.49023796582517226,SD,ARI,2023 REG,5,1,13,8,9,18,0,1,-7,7,1,0,0,0,0,0,0,0,0,0.49023796582517226,0.5097620341748277
89788,0.6610169491525424,0.37735849056603776,-195,165,0.6356501330673793,0.3643498669326207,home,SD,under,8.5,0.5327102803738317,-114,0.5097620341748277,SD,ARI,2023 REG,5,1,13,8,9,18,0,1,-7,7,1,0,0,0,0,0,0,0,0,0.49023796582517226,0.5097620341748277
89789,0.5024875621890548,0.5391705069124424,-101,-117,0.4815549006007403,0.5184450993992598,away,TB,over,7.5,0.5348837209302326,-115,0.5047083513395318,BAL,TB,2023 REG,12,8,5,0,8,17,1,0,8,-8,0,0,0,0,0,0,0,0,0,0.5047083513395318,0.49529164866046815
89789,0.5024875621890548,0.5391705069124424,-101,-117,0.4815549006007403,0.5184450993992598,home,BAL,under,7.5,0.5215311004784688,-109,0.49529164866046815,BAL,TB,2023 REG,12,8,5,0,8,17,1,0,8,-8,0,0,0,0,0,0,0,0,0,0.5047083513395318,0.49529164866046815
89790,0.5305164319248826,0.5098039215686274,-113,-104,0.5091258218555558,0.49087417814444423,away,SD,over,9.5,0.5073891625615764,-103,0.4826927225525911,MIN,SD,2023 REG,6,1,10,6,7,16,0,1,-5,5,1,0,0,0,0,0,0,0,0,0.4826927225525911,0.5173072774474089
89790,0.5305164319248826,0.5098039215686274,-113,-104,0.5091258218555558,0.49087417814444423,home,MIN,under,9.5,0.5412844036697247,-118,0.5173072774474089,MIN,SD,2023 REG,6,1,10,6,7,16,0,1,-5,5,1,0,0,0,0,0,0,0,0,0.4826927225525911,0.5173072774474089
89791,0.4504504504504505,0.5918367346938775,122,-145,0.43140216885390636,0.5685978311460936,away,SD,over,8.5,0.5348837209302326,-115,0.5097020142727117,CWS,SD,2023 REG,8,2,6,3,5,14,0,1,-1,1,1,1,0,0,0,0,0,0,0,0.5097020142727117,0.49029798572728833
89791,0.4504504504504505,0.5918367346938775,122,-145,0.43140216885390636,0.5685978311460936,home,CWS,under,8.5,0.5121951219512195,-105,0.49029798572728833,CWS,SD,2023 REG,8,2,6,3,5,14,0,1,-1,1,1,1,0,0,0,0,0,0,0,0.5097020142727117,0.49029798572728833
89792,0.5348837209302326,0.5073891625615764,-115,-103,0.5122726437136835,0.48772735628631647,away,TEX,over,8,0.5192307692307692,-108,0.49455035168025013,SEA,TEX,2023 REG,6,8,3,0,8,9,1,0,8,-8,0,0,0,0,0,0,0,0,0,0.49455035168025013,0.5054496483197499
89792,0.5348837209302326,0.5073891625615764,-115,-103,0.5122726437136835,0.48772735628631647,home,SEA,under,8,0.5283018867924528,-112,0.5054496483197499,SEA,TEX,2023 REG,6,8,3,0,8,9,1,0,8,-8,0,0,0,0,0,0,0,0,0,0.49455035168025013,0.5054496483197499
89793,0.5633187772925764,0.47619047619047616,-129,110,0.5410624729287608,0.45893752707123925,away,TB,over,8,0.5238095238095238,-110,0.4988662131519274,TOR,TB,2023 REG,16,11,7,4,15,23,1,0,7,-7,1,1,1,1,0,0,0,0,0,0.4988662131519274,0.5011337868480725
89793,0.5633187772925764,0.47619047619047616,-129,110,0.5410624729287608,0.45893752707123925,home,TOR,under,8,0.5238095238095238,-110,0.5011337868480725,TOR,TB,2023 REG,16,11,7,4,15,23,1,0,7,-7,1,1,1,1,0,0,0,0,0,0.4988662131519274,0.5011337868480725
89794,0.7159090909090909,0.3225806451612903,-252,210,0.6883539389496134,0.3116460610503866,away,OAK,over,7.5,0.5121951219512195,-105,0.48808156828023186,SEA,OAK,2023 REG,5,3,3,2,5,8,1,0,1,-1,1,1,0,0,0,0,0,0,0,0.48808156828023186,0.5119184317197681
89794,0.7159090909090909,0.3225806451612903,-252,210,0.6883539389496134,0.3116460610503866,home,SEA,under,7.5,0.5348837209302326,-115,0.5119184317197681,SEA,OAK,2023 REG,5,3,3,2,5,8,1,0,1,-1,1,1,0,0,0,0,0,0,0,0.48808156828023186,0.5119184317197681
89795,0.4166666666666667,0.6226415094339623,140,-165,0.4002882599580712,0.5997117400419287,away,NYY,over,11.5,0.5327102803738317,-114,0.508788710910954,COL,NYY,2023 REG,6,3,8,6,9,14,0,1,-3,3,1,1,1,0,0,0,0,0,0,0.508788710910954,0.491211289089046
89795,0.4166666666666667,0.6226415094339623,140,-165,0.4002882599580712,0.5997117400419287,home,COL,under,11.5,0.5121951219512195,-105,0.491211289089046,COL,NYY,2023 REG,6,3,8,6,9,14,0,1,-3,3,1,1,1,0,0,0,0,0,0,0.508788710910954,0.491211289089046
89796,0.46511627906976744,0.576271186440678,115,-136,0.44586629511142073,0.5541337048885793,away,CHC,over,8.5,0.5121951219512195,-105,0.48808156828023186,WSH,CHC,2023 REG,6,1,10,5,6,16,0,1,-4,4,1,0,0,0,0,0,0,0,0,0.48808156828023186,0.5119184317197681
89796,0.46511627906976744,0.576271186440678,115,-136,0.44586629511142073,0.5541337048885793,home,WSH,under,8.5,0.5348837209302326,-115,0.5119184317197681,WSH,CHC,2023 REG,6,1,10,5,6,16,0,1,-4,4,1,0,0,0,0,0,0,0,0,0.48808156828023186,0.5119184317197681
89797,0.4065040650406504,0.6296296296296295,146,-170,0.3918155712722439,0.608184428727756,away,MIA,over,9,0.5327102803738317,-114,0.5075272610403079,WSH,MIA,2023 REG,8,2,7,5,7,15,0,1,-3,3,1,1,0,0,0,0,0,0,0,0.5075272610403079,0.4924727389596921
89797,0.4065040650406504,0.6296296296296295,146,-170,0.3918155712722439,0.608184428727756,home,WSH,under,9,0.5145631067961165,-106,0.4924727389596921,WSH,MIA,2023 REG,8,2,7,5,7,15,0,1,-3,3,1,1,0,0,0,0,0,0,0,0.5075272610403079,0.4924727389596921
89798,0.49504950495049505,0.5495495495495495,102,-122,0.47297076509898783,0.5270292349010122,away,ATL,over,9,0.5454545454545454,-120,0.5206611570247933,MIA,ATL,2023 REG,14,11,9,5,16,23,1,0,6,-6,1,1,1,1,1,0,0,0,0,0.5206611570247933,0.4793388429752067
89798,0.49504950495049505,0.5495495495495495,102,-122,0.47297076509898783,0.5270292349010122,home,MIA,under,9,0.5,100,0.4793388429752067,MIA,ATL,2023 REG,14,11,9,5,16,23,1,0,6,-6,1,1,1,1,1,0,0,0,0,0.5206611570247933,0.4793388429752067
89799,0.5934959349593496,0.4444444444444444,-146,125,0.5709784740123824,0.42902152598761756,away,BAL,over,8,0.5348837209302326,-115,0.5097020142727117,NYY,BAL,2023 REG,6,6,10,9,15,16,0,1,-3,3,1,1,1,1,1,1,0,0,0,0.5097020142727117,0.49029798572728833
89799,0.5934959349593496,0.4444444444444444,-146,125,0.5709784740123824,0.42902152598761756,home,NYY,under,8,0.5121951219512195,-105,0.49029798572728833,NYY,BAL,2023 REG,6,6,10,9,15,16,0,1,-3,3,1,1,1,1,1,1,0,0,0,0.5097020142727117,0.49029798572728833
89800,0.5798319327731092,0.4587155963302753,-138,118,0.557480844469466,0.442519155530534,away,ARI,over,9,0.5348837209302326,-115,0.5097020142727117,CHC,ARI,2023 REG,9,5,9,2,7,18,1,0,3,-3,1,1,0,0,0,0,0,0,0,0.5097020142727117,0.49029798572728833
89800,0.5798319327731092,0.4587155963302753,-138,118,0.557480844469466,0.442519155530534,home,CHC,under,9,0.5121951219512195,-105,0.49029798572728833,CHC,ARI,2023 REG,9,5,9,2,7,18,1,0,3,-3,1,1,0,0,0,0,0,0,0,0.5097020142727117,0.49029798572728833
89801,0.5867768595041323,0.45248868778280543,-142,121,0.563736744980392,0.43626325501960805,away,LAA,over,9,0.5,100,0.4772727272727273,CWS,LAA,2023 REG,8,4,8,6,10,16,0,1,-2,2,1,1,1,1,0,0,0,0,0,0.4772727272727273,0.5227272727272727
89801,0.5867768595041323,0.45248868778280543,-142,121,0.563736744980392,0.43626325501960805,home,CWS,under,9,0.5454545454545454,-120,0.5227272727272727,CWS,LAA,2023 REG,8,4,8,6,10,16,0,1,-2,2,1,1,1,1,0,0,0,0,0,0.4772727272727273,0.5227272727272727
89802,0.40322580645161293,0.6363636363636364,148,-175,0.387262321445464,0.612737678554536,away,MIN,over,9.5,0.5,100,0.4772727272727273,KC,MIN,2023 REG,6,2,7,1,3,13,1,0,1,-1,1,0,0,0,0,0,0,0,0,0.4772727272727273,0.5227272727272727
89802,0.40322580645161293,0.6363636363636364,148,-175,0.387262321445464,0.612737678554536,home,KC,under,9.5,0.5454545454545454,-120,0.5227272727272727,KC,MIN,2023 REG,6,2,7,1,3,13,1,0,1,-1,1,0,0,0,0,0,0,0,0,0.4772727272727273,0.5227272727272727
89803,0.4694835680751174,0.5726495726495727,113,-134,0.4497027508334788,0.5502972491665212,away,LAD,over,8.5,0.5327102803738317,-114,0.5075272610403079,SF,LAD,2023 REG,2,2,6,6,8,8,0,1,-4,4,1,1,0,0,0,0,0,0,0,0.5075272610403079,0.4924727389596921
89803,0.4694835680751174,0.5726495726495727,113,-134,0.4497027508334788,0.5502972491665212,home,SF,under,8.5,0.5145631067961165,-106,0.4924727389596921,SF,LAD,2023 REG,2,2,6,6,8,8,0,1,-4,4,1,1,0,0,0,0,0,0,0,0.5075272610403079,0.4924727389596921
89804,0.5391705069124424,0.5,-117,100,0.5180509248444435,0.4819490751555565,away,TOR,over,9.5,0.5,100,0.4762443438914027,LAD,TOR,2023 REG,7,3,13,6,9,20,0,1,-3,3,1,1,1,0,0,0,0,0,0,0.4762443438914027,0.5237556561085973
89804,0.5391705069124424,0.5,-117,100,0.5180509248444435,0.4819490751555565,home,LAD,under,9.5,0.5475113122171946,-121,0.5237556561085973,LAD,TOR,2023 REG,7,3,13,6,9,20,0,1,-3,3,1,1,1,0,0,0,0,0,0,0.4762443438914027,0.5237556561085973
89805,0.5192307692307692,0.5215311004784688,-108,-109,0.49806595226635714,0.5019340477336429,away,BAL,over,8,0.5412844036697247,-118,0.5136310900085983,SF,BAL,2023 REG,5,3,11,8,11,16,0,1,-5,5,1,1,1,0,0,0,0,0,0,0.5136310900085983,0.4863689099914017
89805,0.5192307692307692,0.5215311004784688,-108,-109,0.49806595226635714,0.5019340477336429,home,SF,under,8,0.5098039215686274,-104,0.4863689099914017,SF,BAL,2023 REG,5,3,11,8,11,16,0,1,-5,5,1,1,1,0,0,0,0,0,0,0.5136310900085983,0.4863689099914017
89806,0.48780487804878053,0.5495495495495495,105,-122,0.4695832060495952,0.5304167939504048,away,CWS,over,8.5,0.5327102803738317,-114,0.5075272610403079,PIT,CWS,2023 REG,10,5,14,11,16,24,0,1,-6,6,1,1,1,1,1,0,0,0,0,0.5075272610403079,0.4924727389596921
89806,0.48780487804878053,0.5495495495495495,105,-122,0.4695832060495952,0.5304167939504048,home,PIT,under,8.5,0.5145631067961165,-106,0.4924727389596921,PIT,CWS,2023 REG,10,5,14,11,16,24,0,1,-6,6,1,1,1,1,1,0,0,0,0,0.5075272610403079,0.4924727389596921
89807,0.5327102803738317,0.5098039215686274,-114,-104,0.5100625279371946,0.48993747206280536,away,MIA,over,9,0.5348837209302326,-115,0.5097020142727117,ARI,MIA,2023 REG,11,2,9,6,8,20,0,1,-4,4,1,1,0,0,0,0,0,0,0,0.5097020142727117,0.49029798572728833
89807,0.5327102803738317,0.5098039215686274,-114,-104,0.5100625279371946,0.48993747206280536,home,ARI,under,9,0.5121951219512195,-105,0.49029798572728833,ARI,MIA,2023 REG,11,2,9,6,8,20,0,1,-4,4,1,1,0,0,0,0,0,0,0,0.5097020142727117,0.49029798572728833
89808,0.6363636363636364,0.40322580645161293,-175,148,0.6111703545721141,0.3888296454278859,away,BAL,over,9,0.5098039215686274,-104,0.4870219861770517,HOU,BAL,2023 REG,10,5,10,9,14,20,0,1,-4,4,1,1,1,1,1,0,0,0,0,0.4870219861770517,0.5129780138229483
89808,0.6363636363636364,0.40322580645161293,-175,148,0.6111703545721141,0.3888296454278859,home,HOU,under,9,0.5348837209302326,-115,0.5129780138229483,HOU,BAL,2023 REG,10,5,10,9,14,20,0,1,-4,4,1,1,1,1,1,0,0,0,0,0.4870219861770517,0.5129780138229483
89809,0.42372881355932196,0.6153846153846154,136,-160,0.4071553267186705,0.5928446732813295,away,MIL,over,8.5,0.5454545454545454,-120,0.5206611570247933,WSH,MIL,2023 REG,7,4,6,6,10,13,0,1,-2,2,1,1,1,1,0,0,0,0,0,0.5206611570247933,0.4793388429752067
89809,0.42372881355932196,0.6153846153846154,136,-160,0.4071553267186705,0.5928446732813295,home,WSH,under,8.5,0.5,100,0.4793388429752067,WSH,MIL,2023 REG,7,4,6,6,10,13,0,1,-2,2,1,1,1,1,0,0,0,0,0,0.5206611570247933,0.4793388429752067
89810,0.6323529411764706,0.40485829959514175,-172,147,0.6088223036297157,0.3911776963702843,away,LAA,over,8.5,0.5348837209302326,-115,0.5097020142727117,HOU,LAA,2023 REG,11,9,12,6,15,23,1,0,3,-3,1,1,1,1,1,1,0,0,0,0.5097020142727117,0.49029798572728833
89810,0.6323529411764706,0.40485829959514175,-172,147,0.6088223036297157,0.3911776963702843,home,HOU,under,8.5,0.5121951219512195,-105,0.49029798572728833,HOU,LAA,2023 REG,11,9,12,6,15,23,1,0,3,-3,1,1,1,1,1,1,0,0,0,0.5097020142727117,0.49029798572728833
89811,0.42016806722689076,0.6197718631178707,138,-163,0.4033865838887557,0.5966134161112443,away,BAL,over,8,0.5327102803738317,-114,0.5075272610403079,CLE,BAL,2023 REG,8,5,7,2,7,15,1,0,3,-3,1,1,0,0,0,0,0,0,0,0.5075272610403079,0.4924727389596921
89811,0.42016806722689076,0.6197718631178707,138,-163,0.4033865838887557,0.5966134161112443,home,CLE,under,8,0.5145631067961165,-106,0.4924727389596921,CLE,BAL,2023 REG,8,5,7,2,7,15,1,0,3,-3,1,1,0,0,0,0,0,0,0,0.5075272610403079,0.4924727389596921
89812,0.425531914893617,0.613899613899614,135,-159,0.40875254093905067,0.5912474590609493,away,SD,over,9,0.5121951219512195,-105,0.48808156828023186,DET,SD,2023 REG,8,4,9,5,9,17,0,1,-1,1,1,1,1,1,0,0,0,0,0,0.48808156828023186,0.5119184317197681
89812,0.425531914893617,0.613899613899614,135,-159,0.40875254093905067,0.5912474590609493,home,DET,under,9,0.5348837209302326,-115,0.5119184317197681,DET,SD,2023 REG,8,4,9,5,9,17,0,1,-1,1,1,1,1,1,0,0,0,0,0,0.48808156828023186,0.5119184317197681
89813,0.6108949416342413,0.4273504273504274,-157,134,0.5875310391805721,0.41246896081942785,away,TOR,over,7.5,0.5238095238095238,-110,0.4988662131519274,TB,TOR,2023 REG,8,2,8,6,8,16,0,1,-4,4,1,1,0,0,0,0,0,0,0,0.4988662131519274,0.5011337868480725
89813,0.6108949416342413,0.4273504273504274,-157,134,0.5875310391805721,0.41246896081942785,home,TB,under,7.5,0.5238095238095238,-110,0.5011337868480725,TB,TOR,2023 REG,8,2,8,6,8,16,0,1,-4,4,1,1,0,0,0,0,0,0,0,0.4988662131519274,0.5011337868480725
89814,0.7058823529411764,0.3333333333333333,-240,200,0.6782006920415226,0.32179930795847744,away,OAK,over,10.5,0.5238095238095238,-110,0.4988662131519274,BOS,OAK,2023 REG,10,7,7,3,10,17,1,0,4,-4,1,1,1,0,0,0,0,0,0,0.4988662131519274,0.5011337868480725
89814,0.7058823529411764,0.3333333333333333,-240,200,0.6782006920415226,0.32179930795847744,home,BOS,under,10.5,0.5238095238095238,-110,0.5011337868480725,BOS,OAK,2023 REG,10,7,7,3,10,17,1,0,4,-4,1,1,1,0,0,0,0,0,0,0.4988662131519274,0.5011337868480725
89815,0.7237569060773481,0.31545741324921134,-262,217,0.6953752716476282,0.30462472835237175,away,PHI,over,9,0.504950495049505,-102,0.48054649490447493,ATL,PHI,2023 REG,20,11,6,4,15,26,1,0,7,-7,1,1,1,1,0,0,0,0,0,0.48054649490447493,0.5194535050955251
89815,0.7237569060773481,0.31545741324921134,-262,217,0.6953752716476282,0.30462472835237175,home,ATL,under,9,0.5433789954337899,-119,0.5194535050955251,ATL,PHI,2023 REG,20,11,6,4,15,26,1,0,7,-7,1,1,1,1,0,0,0,0,0,0.48054649490447493,0.5194535050955251
89816,0.5215311004784688,0.5215311004784688,-109,-109,0.49907282342437215,0.5009271765756278,away,CHC,over,8.5,0.5283018867924528,-112,0.5044173060022736,MIL,CHC,2023 REG,8,4,6,3,7,14,1,0,1,-1,1,1,1,0,0,0,0,0,0,0.5044173060022736,0.49558269399772636
89816,0.5215311004784688,0.5215311004784688,-109,-109,0.49907282342437215,0.5009271765756278,home,MIL,under,8.5,0.5169082125603864,-107,0.49558269399772636,MIL,CHC,2023 REG,8,4,6,3,7,14,1,0,1,-1,1,1,1,0,0,0,0,0,0,0.5044173060022736,0.49558269399772636
89817,0.5238095238095238,0.5238095238095238,-110,-110,0.4988662131519274,0.5011337868480725,away,SEA,over,8,0.5454545454545454,-120,0.5179608869977906,ARI,SEA,2023 REG,3,0,10,4,4,13,0,1,-4,4,0,0,0,0,0,0,0,0,0,0.5179608869977906,0.48203911300220936
89817,0.5238095238095238,0.5238095238095238,-110,-110,0.4988662131519274,0.5011337868480725,home,ARI,under,8,0.504950495049505,-102,0.48203911300220936,ARI,SEA,2023 REG,3,0,10,4,4,13,0,1,-4,4,0,0,0,0,0,0,0,0,0,0.5179608869977906,0.48203911300220936
89818,0.5348837209302326,0.5121951219512195,-115,-105,0.5097020142727117,0.49029798572728833,away,SD,over,9.5,0.5121951219512195,-105,0.48808156828023186,ATL,SD,2023 REG,6,4,7,5,9,13,0,1,-1,1,1,1,1,1,0,0,0,0,0,0.48808156828023186,0.5119184317197681
89818,0.5348837209302326,0.5121951219512195,-115,-105,0.5097020142727117,0.49029798572728833,home,ATL,under,9.5,0.5348837209302326,-115,0.5119184317197681,ATL,SD,2023 REG,6,4,7,5,9,13,0,1,-1,1,1,1,1,1,0,0,0,0,0,0.48808156828023186,0.5119184317197681
89819,0.5145631067961165,0.5283018867924528,-106,-112,0.4925063625223866,0.5074936374776133,away,CIN,over,9.5,0.5370370370370371,-116,0.5118817074154765,WSH,CIN,2023 REG,10,2,16,9,11,26,0,1,-7,7,1,1,0,0,0,0,0,0,0,0.5118817074154765,0.48811829258452355
89819,0.5145631067961165,0.5283018867924528,-106,-112,0.4925063625223866,0.5074936374776133,home,WSH,under,9.5,0.5098039215686274,-104,0.48811829258452355,WSH,CIN,2023 REG,10,2,16,9,11,26,0,1,-7,7,1,1,0,0,0,0,0,0,0,0.5118817074154765,0.48811829258452355
89820,0.5833333333333333,0.4566210045662101,-140,119,0.5600266362252664,0.4399733637747336,away,CLE,over,8,0.5098039215686274,-104,0.48592421718142587,BAL,CLE,2023 REG,5,0,9,5,5,14,0,1,-5,5,0,0,0,0,0,0,0,0,0,0.48592421718142587,0.5140757828185741
89820,0.5833333333333333,0.4566210045662101,-140,119,0.5600266362252664,0.4399733637747336,home,BAL,under,8,0.5370370370370371,-116,0.5140757828185741,BAL,CLE,2023 REG,5,0,9,5,5,14,0,1,-5,5,0,0,0,0,0,0,0,0,0,0.48592421718142587,0.5140757828185741
89821,0.5391705069124424,0.5,-117,100,0.5180509248444435,0.4819490751555565,away,PIT,over,9,0.5454545454545454,-120,0.5206611570247933,KC,PIT,2023 REG,2,0,12,5,5,14,0,1,-5,5,0,0,0,0,0,0,0,0,0,0.5206611570247933,0.4793388429752067
89821,0.5391705069124424,0.5,-117,100,0.5180509248444435,0.4819490751555565,home,KC,under,9,0.5,100,0.4793388429752067,KC,PIT,2023 REG,2,0,12,5,5,14,0,1,-5,5,0,0,0,0,0,0,0,0,0,0.5206611570247933,0.4793388429752067
89822,0.6610169491525424,0.37735849056603776,-195,165,0.6356501330673793,0.3643498669326207,away,SF,over,15.5,0.5215311004784688,-109,0.4978845547971712,SD,SF,2023 REG,17,16,13,11,27,30,1,0,5,-5,1,1,1,1,1,1,1,1,1,0.4978845547971712,0.5021154452028288
89822,0.6610169491525424,0.37735849056603776,-195,165,0.6356501330673793,0.3643498669326207,home,SD,under,15.5,0.5238095238095238,-110,0.5021154452028288,SD,SF,2023 REG,17,16,13,11,27,30,1,0,5,-5,1,1,1,1,1,1,1,1,1,0.4978845547971712,0.5021154452028288
89823,0.4807692307692307,0.5535714285714286,108,-124,0.4642592983939138,0.5357407016060862,away,NYM,over,8.5,0.5073891625615764,-103,0.4837652908580103,SF,NYM,2023 REG,7,4,13,9,13,20,0,1,-5,5,1,1,1,1,0,0,0,0,0,0.4837652908580103,0.5162347091419897
89823,0.4807692307692307,0.5535714285714286,108,-124,0.4642592983939138,0.5357407016060862,home,SF,under,8.5,0.5391705069124424,-117,0.5162347091419897,SF,NYM,2023 REG,7,4,13,9,13,20,0,1,-5,5,1,1,1,1,0,0,0,0,0,0.4837652908580103,0.5162347091419897
89824,0.4672897196261683,0.5708154506437768,114,-133,0.44948356529441824,0.5505164347055818,away,DET,over,8.5,0.5121951219512195,-105,0.48808156828023186,CWS,DET,2023 REG,9,2,11,4,6,20,0,1,-2,2,1,1,0,0,0,0,0,0,0,0.48808156828023186,0.5119184317197681
89824,0.4672897196261683,0.5708154506437768,114,-133,0.44948356529441824,0.5505164347055818,home,CWS,under,8.5,0.5348837209302326,-115,0.5119184317197681,CWS,DET,2023 REG,9,2,11,4,6,20,0,1,-2,2,1,1,0,0,0,0,0,0,0,0.48808156828023186,0.5119184317197681
89825,0.48780487804878053,0.5475113122171946,105,-121,0.470577468162939,0.529422531837061,away,CLE,over,8.5,0.5215311004784688,-109,0.49670754937970685,CWS,CLE,2023 REG,16,8,9,3,11,25,1,0,5,-5,1,1,1,0,0,0,0,0,0,0.49670754937970685,0.5032924506202932
89825,0.48780487804878053,0.5475113122171946,105,-121,0.470577468162939,0.529422531837061,home,CWS,under,8.5,0.5260663507109005,-111,0.5032924506202932,CWS,CLE,2023 REG,16,8,9,3,11,25,1,0,5,-5,1,1,1,0,0,0,0,0,0,0.49670754937970685,0.5032924506202932
89826,0.7118155619596541,0.3278688524590164,-247,205,0.6835675782091883,0.31643242179081166,away,WSH,over,8,0.5454545454545454,-120,0.5206611570247933,SEA,WSH,2023 REG,7,4,9,7,11,16,0,1,-3,3,1,1,1,1,0,0,0,0,0,0.5206611570247933,0.4793388429752067
89826,0.7118155619596541,0.3278688524590164,-247,205,0.6835675782091883,0.31643242179081166,home,SEA,under,8,0.5,100,0.4793388429752067,SEA,WSH,2023 REG,7,4,9,7,11,16,0,1,-3,3,1,1,1,1,0,0,0,0,0,0.5206611570247933,0.4793388429752067
89827,0.5535714285714286,0.48780487804878053,-124,105,0.53066668740667,0.46933331259333,away,MIA,over,9.5,0.5215311004784688,-109,0.4978845547971712,CIN,MIA,2023 REG,10,4,8,5,9,18,0,1,-1,1,1,1,1,1,0,0,0,0,0,0.4978845547971712,0.5021154452028288
89827,0.5535714285714286,0.48780487804878053,-124,105,0.53066668740667,0.46933331259333,home,CIN,under,9.5,0.5238095238095238,-110,0.5021154452028288,CIN,MIA,2023 REG,10,4,8,5,9,18,0,1,-1,1,1,1,1,1,0,0,0,0,0,0.4978845547971712,0.5021154452028288
89828,0.6503496503496503,0.3921568627450981,-186,155,0.6227055544208978,0.3772944455791022,away,KC,over,8.5,0.5238095238095238,-110,0.4988662131519274,CLE,KC,2023 REG,18,10,12,6,16,30,1,0,4,-4,1,1,1,1,1,1,0,0,0,0.4988662131519274,0.5011337868480725
89828,0.6503496503496503,0.3921568627450981,-186,155,0.6227055544208978,0.3772944455791022,home,CLE,under,8.5,0.5238095238095238,-110,0.5011337868480725,CLE,KC,2023 REG,18,10,12,6,16,30,1,0,4,-4,1,1,1,1,1,1,0,0,0,0.4988662131519274,0.5011337868480725
89829,0.4672897196261683,0.5652173913043479,114,-130,0.45209948087359064,0.5479005191264094,away,TEX,over,9.5,0.5,100,0.4772727272727273,CIN,TEX,2023 REG,11,7,10,6,13,21,1,0,1,-1,1,1,1,1,1,1,0,0,0,0.4772727272727273,0.5227272727272727
89829,0.4672897196261683,0.5652173913043479,114,-130,0.45209948087359064,0.5479005191264094,home,CIN,under,9.5,0.5454545454545454,-120,0.5227272727272727,CIN,TEX,2023 REG,11,7,10,6,13,21,1,0,1,-1,1,1,1,1,1,1,0,0,0,0.4772727272727273,0.5227272727272727
89830,0.4347826086956522,0.6000000000000001,130,-150,0.4196597353497164,0.5803402646502835,away,TB,over,8.5,0.5169082125603864,-107,0.49239402434819424,NYY,TB,2023 REG,10,9,12,8,17,22,1,0,1,-1,1,1,1,1,1,1,1,1,0,0.49239402434819424,0.5076059756518058
89830,0.4347826086956522,0.6000000000000001,130,-150,0.4196597353497164,0.5803402646502835,home,NYY,under,8.5,0.5305164319248826,-113,0.5076059756518058,NYY,TB,2023 REG,10,9,12,8,17,22,1,0,1,-1,1,1,1,1,1,1,1,1,0,0.49239402434819424,0.5076059756518058
89831,0.7058823529411764,0.3389830508474576,-240,195,0.6742126561491995,0.32578734385080055,away,CIN,over,9,0.5098039215686274,-104,0.48375889301574193,ATL,CIN,2023 REG,11,7,8,6,13,19,1,0,1,-1,1,1,1,1,1,1,0,0,0,0.48375889301574193,0.5162411069842581
89831,0.7058823529411764,0.3389830508474576,-240,195,0.6742126561491995,0.32578734385080055,home,ATL,under,9,0.5412844036697247,-118,0.5162411069842581,ATL,CIN,2023 REG,11,7,8,6,13,19,1,0,1,-1,1,1,1,1,1,1,0,0,0,0.48375889301574193,0.5162411069842581
89832,0.4,0.6428571428571428,150,-180,0.38285714285714295,0.617142857142857,away,BAL,over,8.5,0.5454545454545454,-120,0.5206611570247933,LAA,BAL,2023 REG,8,3,10,6,9,18,0,1,-3,3,1,1,1,0,0,0,0,0,0,0.5206611570247933,0.4793388429752067
89832,0.4,0.6428571428571428,150,-180,0.38285714285714295,0.617142857142857,home,LAA,under,8.5,0.5,100,0.4793388429752067,LAA,BAL,2023 REG,8,3,10,6,9,18,0,1,-3,3,1,1,1,0,0,0,0,0,0,0.5206611570247933,0.4793388429752067
89833,0.609375,0.425531914893617,-156,135,0.5881035987367021,0.41189640126329785,away,BAL,over,9.5,0.5,100,0.4772727272727273,TOR,BAL,2023 REG,8,2,7,6,8,15,0,1,-4,4,1,1,0,0,0,0,0,0,0,0.4772727272727273,0.5227272727272727
89833,0.609375,0.425531914893617,-156,135,0.5881035987367021,0.41189640126329785,home,TOR,under,9.5,0.5454545454545454,-120,0.5227272727272727,TOR,BAL,2023 REG,8,2,7,6,8,15,0,1,-4,4,1,1,0,0,0,0,0,0,0,0.4772727272727273,0.5227272727272727
89834,0.6376811594202898,0.40322580645161293,-176,148,0.6115955579947286,0.38840444200527136,away,DET,over,8,0.5348837209302326,-115,0.5097020142727117,MIN,DET,2023 REG,13,7,12,8,15,25,0,1,-1,1,1,1,1,1,1,1,1,0,0,0.5097020142727117,0.49029798572728833
89834,0.6376811594202898,0.40322580645161293,-176,148,0.6115955579947286,0.38840444200527136,home,MIN,under,8,0.5121951219512195,-105,0.49029798572728833,MIN,DET,2023 REG,13,7,12,8,15,25,0,1,-1,1,1,1,1,1,1,1,1,0,0,0.5097020142727117,0.49029798572728833
89835,0.6503496503496503,0.3861003861003861,-186,159,0.6266443818891371,0.37335561811086293,away,OAK,over,9,0.5098039215686274,-104,0.48592421718142587,PIT,OAK,2023 REG,6,5,8,4,9,14,1,0,1,-1,1,1,1,1,0,0,0,0,0,0.48592421718142587,0.5140757828185741
89835,0.6503496503496503,0.3861003861003861,-186,159,0.6266443818891371,0.37335561811086293,home,PIT,under,9,0.5370370370370371,-116,0.5140757828185741,PIT,OAK,2023 REG,6,5,8,4,9,14,1,0,1,-1,1,1,1,1,0,0,0,0,0,0.48592421718142587,0.5140757828185741
89836,0.7402597402597403,0.29411764705882354,-285,240,0.7148115444524917,0.28518845554750827,away,WSH,over,9.5,0.5391705069124424,-117,0.5140669063204599,LAA,WSH,2023 REG,7,4,14,6,10,21,0,1,-2,2,1,1,1,1,0,0,0,0,0,0.5140669063204599,0.4859330936795401
89836,0.7402597402597403,0.29411764705882354,-285,240,0.7148115444524917,0.28518845554750827,home,LAA,under,9.5,0.5073891625615764,-103,0.4859330936795401,LAA,WSH,2023 REG,7,4,14,6,10,21,0,1,-2,2,1,1,1,1,0,0,0,0,0,0.5140669063204599,0.4859330936795401
89837,0.4608294930875576,0.5815899581589958,117,-139,0.44128135887255604,0.558718641127444,away,TB,over,8.5,0.5260663507109005,-111,0.5010269332605688,CHC,TB,2023 REG,6,3,5,4,7,11,0,1,-1,1,1,1,1,0,0,0,0,0,0,0.5010269332605688,0.4989730667394312
89837,0.4608294930875576,0.5815899581589958,117,-139,0.44128135887255604,0.558718641127444,home,CHC,under,8.5,0.5215311004784688,-109,0.4989730667394312,CHC,TB,2023 REG,6,3,5,4,7,11,0,1,-1,1,1,1,1,0,0,0,0,0,0,0.5010269332605688,0.4989730667394312
89838,0.576271186440678,0.4672897196261683,-136,114,0.5511682914191056,0.4488317085808944,away,MIL,over,7.5,0.5,100,0.4772727272727273,NYY,MIL,2023 REG,3,4,6,3,7,9,1,0,1,-1,1,1,1,0,0,0,0,0,0,0.4772727272727273,0.5227272727272727
89838,0.576271186440678,0.4672897196261683,-136,114,0.5511682914191056,0.4488317085808944,home,NYY,under,7.5,0.5454545454545454,-120,0.5227272727272727,NYY,MIL,2023 REG,3,4,6,3,7,9,1,0,1,-1,1,1,1,0,0,0,0,0,0,0.4772727272727273,0.5227272727272727
89839,0.7333333333333333,0.3125,-275,220,0.6997222222222221,0.30027777777777787,away,WSH,over,8.5,0.5121951219512195,-105,0.48808156828023186,MIN,WSH,2023 REG,9,3,3,1,4,12,1,0,2,-2,1,0,0,0,0,0,0,0,0,0.48808156828023186,0.5119184317197681
89839,0.7333333333333333,0.3125,-275,220,0.6997222222222221,0.30027777777777787,home,MIN,under,8.5,0.5348837209302326,-115,0.5119184317197681,MIN,WSH,2023 REG,9,3,3,1,4,12,1,0,2,-2,1,0,0,0,0,0,0,0,0,0.48808156828023186,0.5119184317197681
89840,0.48780487804878053,0.5535714285714286,105,-124,0.4676213138438005,0.5323786861561994,away,HOU,over,10.5,0.5454545454545454,-120,0.5206611570247933,LAA,HOU,2023 REG,9,8,16,9,17,25,0,1,-1,1,1,1,1,1,1,1,1,1,0,0.5206611570247933,0.4793388429752067
89840,0.48780487804878053,0.5535714285714286,105,-124,0.4676213138438005,0.5323786861561994,home,LAA,under,10.5,0.5,100,0.4793388429752067,LAA,HOU,2023 REG,9,8,16,9,17,25,0,1,-1,1,1,1,1,1,1,1,1,1,0,0.5206611570247933,0.4793388429752067
89841,0.425531914893617,0.613899613899614,135,-159,0.40875254093905067,0.5912474590609493,away,ATL,over,9,0.5454545454545454,-120,0.5206611570247933,KC,ATL,2023 REG,7,4,7,5,9,14,0,1,-1,1,1,1,1,1,0,0,0,0,0,0.5206611570247933,0.4793388429752067
89841,0.425531914893617,0.613899613899614,135,-159,0.40875254093905067,0.5912474590609493,home,KC,under,9,0.5,100,0.4793388429752067,KC,ATL,2023 REG,7,4,7,5,9,14,0,1,-1,1,1,1,1,1,0,0,0,0,0,0.5206611570247933,0.4793388429752067
89842,0.7354497354497355,0.3067484662576687,-278,226,0.7044150791675705,0.2955849208324295,away,COL,over,8,0.5370370370370371,-116,0.5118817074154765,TB,COL,2023 REG,11,6,8,5,11,19,1,0,1,-1,1,1,1,1,1,0,0,0,0,0.5118817074154765,0.48811829258452355
89842,0.7354497354497355,0.3067484662576687,-278,226,0.7044150791675705,0.2955849208324295,home,TB,under,8,0.5098039215686274,-104,0.48811829258452355,TB,COL,2023 REG,11,6,8,5,11,19,1,0,1,-1,1,1,1,1,1,0,0,0,0,0.5118817074154765,0.48811829258452355
89843,0.5614035087719298,0.47619047619047616,-128,110,0.5402981137053159,0.4597018862946841,away,WSH,over,9.5,0.5098039215686274,-104,0.48592421718142587,KC,WSH,2023 REG,7,2,8,4,6,15,0,1,-2,2,1,1,0,0,0,0,0,0,0,0.48592421718142587,0.5140757828185741
89843,0.5614035087719298,0.47619047619047616,-128,110,0.5402981137053159,0.4597018862946841,home,KC,under,9.5,0.5370370370370371,-116,0.5140757828185741,KC,WSH,2023 REG,7,2,8,4,6,15,0,1,-2,2,1,1,0,0,0,0,0,0,0,0.48592421718142587,0.5140757828185741
89844,0.3802281368821293,0.6551724137931035,163,-190,0.36676785145428414,0.6332321485457159,away,SEA,over,8.5,0.5454545454545454,-120,0.5206611570247933,DET,SEA,2023 REG,3,0,6,5,5,9,0,1,-5,5,0,0,0,0,0,0,0,0,0,0.5206611570247933,0.4793388429752067
89844,0.3802281368821293,0.6551724137931035,163,-190,0.36676785145428414,0.6332321485457159,home,DET,under,8.5,0.5,100,0.4793388429752067,DET,SEA,2023 REG,3,0,6,5,5,9,0,1,-5,5,0,0,0,0,0,0,0,0,0,0.5206611570247933,0.4793388429752067
89845,0.5850622406639003,0.4504504504504505,-141,122,0.5642851060285332,0.4357148939714668,away,ARI,over,8,0.5391705069124424,-117,0.5127649394825569,SD,ARI,2023 REG,8,5,9,4,9,17,1,0,1,-1,1,1,1,1,0,0,0,0,0,0.5127649394825569,0.48723506051744314
89845,0.5850622406639003,0.4504504504504505,-141,122,0.5642851060285332,0.4357148939714668,home,SD,under,8,0.5098039215686274,-104,0.48723506051744314,SD,ARI,2023 REG,8,5,9,4,9,17,1,0,1,-1,1,1,1,1,0,0,0,0,0,0.5127649394825569,0.48723506051744314
89846,0.5884773662551441,0.4504504504504505,-143,122,0.5655692272061728,0.43443077279382725,away,KC,over,9.5,0.5,100,0.4772727272727273,BAL,KC,2023 REG,10,6,8,1,7,18,1,0,5,-5,1,0,0,0,0,0,0,0,0,0.4772727272727273,0.5227272727272727
89846,0.5884773662551441,0.4504504504504505,-143,122,0.5655692272061728,0.43443077279382725,home,BAL,under,9.5,0.5454545454545454,-120,0.5227272727272727,BAL,KC,2023 REG,10,6,8,1,7,18,1,0,5,-5,1,0,0,0,0,0,0,0,0,0.4772727272727273,0.5227272727272727
89847,0.6835443037974683,0.35714285714285715,-216,180,0.655732826699018,0.344267173300982,away,COL,over,8.5,0.5238095238095238,-110,0.4988662131519274,SF,COL,2023 REG,11,6,6,3,9,17,1,0,3,-3,1,1,1,0,0,0,0,0,0,0.4988662131519274,0.5011337868480725
89847,0.6835443037974683,0.35714285714285715,-216,180,0.655732826699018,0.344267173300982,home,SF,under,8.5,0.5238095238095238,-110,0.5011337868480725,SF,COL,2023 REG,11,6,6,3,9,17,1,0,3,-3,1,1,1,0,0,0,0,0,0,0.4988662131519274,0.5011337868480725
89848,0.36363636363636365,0.6721311475409836,175,-205,0.3506299959355101,0.6493700040644899,away,TOR,over,8.5,0.5348837209302326,-115,0.5097020142727117,BOS,TOR,2023 REG,16,11,9,5,16,25,1,0,6,-6,1,1,1,1,1,0,0,0,0,0.5097020142727117,0.49029798572728833
89848,0.36363636363636365,0.6721311475409836,175,-205,0.3506299959355101,0.6493700040644899,home,BOS,under,8.5,0.5121951219512195,-105,0.49029798572728833,BOS,TOR,2023 REG,16,11,9,5,16,25,1,0,6,-6,1,1,1,1,1,0,0,0,0,0.5097020142727117,0.49029798572728833
89849,0.574468085106383,0.46511627906976744,-135,115,0.5517281312179562,0.44827186878204384,away,ARI,over,7,0.5121951219512195,-105,0.48808156828023186,MIA,ARI,2023 REG,4,0,7,5,5,11,0,1,-5,5,0,0,0,0,0,0,0,0,0,0.48808156828023186,0.5119184317197681
89849,0.574468085106383,0.46511627906976744,-135,115,0.5517281312179562,0.44827186878204384,home,MIA,under,7,0.5348837209302326,-115,0.5119184317197681,MIA,ARI,2023 REG,4,0,7,5,5,11,0,1,-5,5,0,0,0,0,0,0,0,0,0,0.48808156828023186,0.5119184317197681
89850,0.576271186440678,0.46511627906976744,-136,115,0.552420782587201,0.44757921741279905,away,NYY,over,9,0.5121951219512195,-105,0.48808156828023186,STL,NYY,2023 REG,12,11,10,4,15,22,1,0,7,-7,1,1,1,1,0,0,0,0,0,0.48808156828023186,0.5119184317197681
89850,0.576271186440678,0.46511627906976744,-136,115,0.552420782587201,0.44757921741279905,home,STL,under,9,0.5348837209302326,-115,0.5119184317197681,STL,NYY,2023 REG,12,11,10,4,15,22,1,0,7,-7,1,1,1,1,0,0,0,0,0,0.48808156828023186,0.5119184317197681
89851,0.3663003663003663,0.6688741721854304,173,-202,0.35341591996857263,0.6465840800314273,away,SD,over,9.5,0.5121951219512195,-105,0.48808156828023186,WSH,SD,2023 REG,12,6,9,8,14,21,0,1,-2,2,1,1,1,1,1,1,0,0,0,0.48808156828023186,0.5119184317197681
89851,0.3663003663003663,0.6688741721854304,173,-202,0.35341591996857263,0.6465840800314273,home,WSH,under,9.5,0.5348837209302326,-115,0.5119184317197681,WSH,SD,2023 REG,12,6,9,8,14,21,0,1,-2,2,1,1,1,1,1,1,0,0,0,0.48808156828023186,0.5119184317197681
89852,0.3105590062111801,0.7333333333333333,222,-275,0.29692784486195234,0.7030721551380477,away,ATL,over,9,0.5098039215686274,-104,0.48483656587239576,WSH,ATL,2023 REG,8,3,18,10,13,26,0,1,-7,7,1,1,1,0,0,0,0,0,0,0.48483656587239576,0.5151634341276042
89852,0.3105590062111801,0.7333333333333333,222,-275,0.29692784486195234,0.7030721551380477,home,WSH,under,9,0.5391705069124424,-117,0.5151634341276042,WSH,ATL,2023 REG,8,3,18,10,13,26,0,1,-7,7,1,1,1,0,0,0,0,0,0,0.48483656587239576,0.5151634341276042
89853,0.5454545454545454,0.49019607843137253,-120,104,0.526008750607681,0.47399124939231896,away,SD,over,9,0.5121951219512195,-105,0.48808156828023186,ATL,SD,2023 REG,8,2,13,10,12,21,0,1,-8,8,1,1,0,0,0,0,0,0,0,0.48808156828023186,0.5119184317197681
89853,0.5454545454545454,0.49019607843137253,-120,104,0.526008750607681,0.47399124939231896,home,ATL,under,9,0.5348837209302326,-115,0.5119184317197681,ATL,SD,2023 REG,8,2,13,10,12,21,0,1,-8,8,1,1,0,0,0,0,0,0,0,0.48808156828023186,0.5119184317197681
89854,0.607843137254902,0.4291845493562232,-155,133,0.5853361120599043,0.4146638879400957,away,ARI,over,9.5,0.5121951219512195,-105,0.48808156828023186,PHI,ARI,2023 REG,6,3,10,4,7,16,0,1,-1,1,1,1,1,0,0,0,0,0,0,0.48808156828023186,0.5119184317197681
89854,0.607843137254902,0.4291845493562232,-155,133,0.5853361120599043,0.4146638879400957,home,PHI,under,9.5,0.5348837209302326,-115,0.5119184317197681,PHI,ARI,2023 REG,6,3,10,4,7,16,0,1,-1,1,1,1,1,0,0,0,0,0,0,0.48808156828023186,0.5119184317197681
89855,0.4716981132075471,0.5652173913043479,112,-130,0.4542851393811816,0.5457148606188185,away,BAL,over,9,0.5238095238095238,-110,0.4988662131519274,ARI,BAL,2023 REG,5,3,11,7,10,16,0,1,-4,4,1,1,1,0,0,0,0,0,0,0.4988662131519274,0.5011337868480725
89855,0.4716981132075471,0.5652173913043479,112,-130,0.4542851393811816,0.5457148606188185,home,ARI,under,9,0.5238095238095238,-110,0.5011337868480725,ARI,BAL,2023 REG,5,3,11,7,10,16,0,1,-4,4,1,1,1,0,0,0,0,0,0,0.4988662131519274,0.5011337868480725
89856,0.6551724137931035,0.3802281368821293,-190,163,0.6319789495576061,0.36802105044239386,away,BAL,over,7.5,0.5238095238095238,-110,0.5000596729920038,TEX,BAL,2023 REG,9,5,2,2,7,11,1,0,3,-3,1,1,0,0,0,0,0,0,0,0.5000596729920038,0.4999403270079962
89856,0.6551724137931035,0.3802281368821293,-190,163,0.6319789495576061,0.36802105044239386,home,TEX,under,7.5,0.5215311004784688,-109,0.4999403270079962,TEX,BAL,2023 REG,9,5,2,2,7,11,1,0,3,-3,1,1,0,0,0,0,0,0,0,0.5000596729920038,0.4999403270079962
89857,0.7245179063360881,0.31746031746031744,-263,215,0.6941039315194085,0.3058960684805915,away,COL,over,8.5,0.5238095238095238,-110,0.4988662131519274,SD,COL,2023 REG,8,3,9,2,5,17,1,0,1,-1,1,1,0,0,0,0,0,0,0,0.4988662131519274,0.5011337868480725
89857,0.7245179063360881,0.31746031746031744,-263,215,0.6941039315194085,0.3058960684805915,home,SD,under,8.5,0.5238095238095238,-110,0.5011337868480725,SD,COL,2023 REG,8,3,9,2,5,17,1,0,1,-1,1,1,0,0,0,0,0,0,0,0.4988662131519274,0.5011337868480725
89858,0.6363636363636364,0.4081632653061224,-175,145,0.6080283353010626,0.3919716646989374,away,PIT,over,8,0.5145631067961165,-106,0.49023796582517226,MIA,PIT,2023 REG,12,4,6,3,7,18,1,0,1,-1,1,1,1,0,0,0,0,0,0,0.49023796582517226,0.5097620341748277
89858,0.6363636363636364,0.4081632653061224,-175,145,0.6080283353010626,0.3919716646989374,home,MIA,under,8,0.5327102803738317,-114,0.5097620341748277,MIA,PIT,2023 REG,12,4,6,3,7,18,1,0,1,-1,1,1,1,0,0,0,0,0,0,0.49023796582517226,0.5097620341748277
89859,0.5515695067264574,0.49019607843137253,-123,104,0.5285328835228112,0.47146711647718875,away,TB,over,9,0.5412844036697247,-118,0.5149381613977361,TEX,TB,2023 REG,9,5,10,1,6,19,1,0,4,-4,1,0,0,0,0,0,0,0,0,0.5149381613977361,0.48506183860226393
89859,0.5515695067264574,0.49019607843137253,-123,104,0.5285328835228112,0.47146711647718875,home,TEX,under,9,0.5073891625615764,-103,0.48506183860226393,TEX,TB,2023 REG,9,5,10,1,6,19,1,0,4,-4,1,0,0,0,0,0,0,0,0,0.5149381613977361,0.48506183860226393
89860,0.6363636363636364,0.40485829959514175,-175,147,0.6101314952989593,0.38986850470104073,away,CLE,over,9.5,0.5,100,0.4772727272727273,HOU,CLE,2023 REG,7,7,9,3,10,16,1,0,4,-4,1,1,1,0,0,0,0,0,0,0.4772727272727273,0.5227272727272727
89860,0.6363636363636364,0.40485829959514175,-175,147,0.6101314952989593,0.38986850470104073,home,HOU,under,9.5,0.5454545454545454,-120,0.5227272727272727,HOU,CLE,2023 REG,7,7,9,3,10,16,1,0,4,-4,1,1,1,0,0,0,0,0,0,0.4772727272727273,0.5227272727272727
89861,0.5454545454545454,0.5,-120,100,0.5206611570247933,0.4793388429752067,away,SF,over,9.5,0.5073891625615764,-103,0.4826927225525911,ATL,SF,2023 REG,11,6,11,5,11,22,1,0,1,-1,1,1,1,1,1,0,0,0,0,0.4826927225525911,0.5173072774474089
89861,0.5454545454545454,0.5,-120,100,0.5206611570247933,0.4793388429752067,home,ATL,under,9.5,0.5412844036697247,-118,0.5173072774474089,ATL,SF,2023 REG,11,6,11,5,11,22,1,0,1,-1,1,1,1,1,1,0,0,0,0,0.4826927225525911,0.5173072774474089
89862,0.4166666666666667,0.6183206106870228,140,-162,0.40208863443596277,0.5979113655640372,away,MIN,over,9,0.5169082125603864,-107,0.49239402434819424,KC,MIN,2023 REG,2,0,11,2,2,13,0,1,-2,2,0,0,0,0,0,0,0,0,0,0.49239402434819424,0.5076059756518058
89862,0.4166666666666667,0.6183206106870228,140,-162,0.40208863443596277,0.5979113655640372,home,KC,under,9,0.5305164319248826,-113,0.5076059756518058,KC,MIN,2023 REG,2,0,11,2,2,13,0,1,-2,2,0,0,0,0,0,0,0,0,0,0.49239402434819424,0.5076059756518058
89863,0.6884735202492213,0.35714285714285715,-221,180,0.6570678523250801,0.34293214767491986,away,COL,over,8,0.5348837209302326,-115,0.5097020142727117,SF,COL,2023 REG,13,9,11,8,17,24,1,0,1,-1,1,1,1,1,1,1,1,1,0,0.5097020142727117,0.49029798572728833
89863,0.6884735202492213,0.35714285714285715,-221,180,0.6570678523250801,0.34293214767491986,home,SF,under,8,0.5121951219512195,-105,0.49029798572728833,SF,COL,2023 REG,13,9,11,8,17,24,1,0,1,-1,1,1,1,1,1,1,1,1,0,0.5097020142727117,0.49029798572728833
89864,0.6825396825396826,0.35714285714285715,-215,180,0.6554547745023935,0.34454522549760647,away,KC,over,9,0.5,100,0.4762443438914027,CLE,KC,2023 REG,10,3,7,5,8,17,0,1,-2,2,1,1,1,0,0,0,0,0,0,0.4762443438914027,0.5237556561085973
89864,0.6825396825396826,0.35714285714285715,-215,180,0.6554547745023935,0.34454522549760647,home,CLE,under,9,0.5475113122171946,-121,0.5237556561085973,CLE,KC,2023 REG,10,3,7,5,8,17,0,1,-2,2,1,1,1,0,0,0,0,0,0,0.4762443438914027,0.5237556561085973
89865,0.5412844036697247,0.49751243781094534,-118,101,0.5202842784645914,0.47971572153540865,away,MIN,over,8.5,0.5391705069124424,-117,0.5153817639191344,LAD,MIN,2023 REG,11,9,13,8,17,24,1,0,1,-1,1,1,1,1,1,1,1,1,0,0.5153817639191344,0.4846182360808656
89865,0.5412844036697247,0.49751243781094534,-118,101,0.5202842784645914,0.47971572153540865,home,LAD,under,8.5,0.504950495049505,-102,0.4846182360808656,LAD,MIN,2023 REG,11,9,13,8,17,24,1,0,1,-1,1,1,1,1,1,1,1,1,0,0.5153817639191344,0.4846182360808656
89866,0.6000000000000001,0.44052863436123346,-150,127,0.57568281938326,0.42431718061673995,away,CWS,over,7,0.5238095238095238,-110,0.4988662131519274,SEA,CWS,2023 REG,8,3,12,4,7,20,0,1,-1,1,1,1,1,0,0,0,0,0,0,0.4988662131519274,0.5011337868480725
89866,0.6000000000000001,0.44052863436123346,-150,127,0.57568281938326,0.42431718061673995,home,SEA,under,7,0.5238095238095238,-110,0.5011337868480725,SEA,CWS,2023 REG,8,3,12,4,7,20,0,1,-1,1,1,1,1,0,0,0,0,0,0,0.4988662131519274,0.5011337868480725
89867,0.6875,0.35211267605633806,-220,184,0.6602662852112676,0.3397337147887324,away,KC,over,8,0.504950495049505,-102,0.4837488699364985,MIN,KC,2023 REG,10,7,3,1,8,13,1,0,6,-6,1,0,0,0,0,0,0,0,0,0.4837488699364985,0.5162511300635015
89867,0.6875,0.35211267605633806,-220,184,0.6602662852112676,0.3397337147887324,home,MIN,under,8,0.5370370370370371,-116,0.5162511300635015,MIN,KC,2023 REG,10,7,3,1,8,13,1,0,6,-6,1,0,0,0,0,0,0,0,0,0.4837488699364985,0.5162511300635015
89868,0.5121951219512195,0.5283018867924528,-105,-112,0.49145275161909474,0.5085472483809053,away,NYM,over,10,0.5073891625615764,-103,0.4837652908580103,BOS,NYM,2023 REG,8,4,13,5,9,21,0,1,-1,1,1,1,1,1,0,0,0,0,0,0.4837652908580103,0.5162347091419897
89868,0.5121951219512195,0.5283018867924528,-105,-112,0.49145275161909474,0.5085472483809053,home,BOS,under,10,0.5391705069124424,-117,0.5162347091419897,BOS,NYM,2023 REG,8,4,13,5,9,21,0,1,-1,1,1,1,1,1,0,0,0,0,0,0.4837652908580103,0.5162347091419897
89869,0.6415770609318996,0.4,-179,150,0.6149021723770248,0.3850978276229752,away,BOS,over,8.5,0.5169082125603864,-107,0.49239402434819424,TEX,BOS,2023 REG,5,2,8,4,6,13,0,1,-2,2,1,1,0,0,0,0,0,0,0,0.49239402434819424,0.5076059756518058
89869,0.6415770609318996,0.4,-179,150,0.6149021723770248,0.3850978276229752,home,TEX,under,8.5,0.5305164319248826,-113,0.5076059756518058,TEX,BOS,2023 REG,5,2,8,4,6,13,0,1,-2,2,1,1,0,0,0,0,0,0,0,0.49239402434819424,0.5076059756518058
89870,0.5348837209302326,0.5073891625615764,-115,-103,0.5122726437136835,0.48772735628631647,away,BOS,over,8.5,0.5,100,0.4772727272727273,NYY,BOS,2023 REG,3,2,7,3,5,10,0,1,-1,1,1,1,0,0,0,0,0,0,0,0.4772727272727273,0.5227272727272727
89870,0.5348837209302326,0.5073891625615764,-115,-103,0.5122726437136835,0.48772735628631647,home,NYY,under,8.5,0.5454545454545454,-120,0.5227272727272727,NYY,BOS,2023 REG,3,2,7,3,5,10,0,1,-1,1,1,1,0,0,0,0,0,0,0,0.4772727272727273,0.5227272727272727
89871,0.4672897196261683,0.574468085106383,114,-135,0.4477767267604901,0.5522232732395099,away,STL,over,9,0.5024875621890548,-101,0.47839724939301687,PIT,STL,2023 REG,10,4,10,6,10,20,0,1,-2,2,1,1,1,1,0,0,0,0,0,0.47839724939301687,0.5216027506069831
89871,0.4672897196261683,0.574468085106383,114,-135,0.4477767267604901,0.5522232732395099,home,PIT,under,9,0.5454545454545454,-120,0.5216027506069831,PIT,STL,2023 REG,10,4,10,6,10,20,0,1,-2,2,1,1,1,1,0,0,0,0,0,0.47839724939301687,0.5216027506069831
89872,0.46511627906976744,0.574468085106383,115,-135,0.44670494689481377,0.5532950531051862,away,DET,over,9.5,0.5,100,0.4772727272727273,KC,DET,2023 REG,6,2,5,3,5,11,0,1,-1,1,1,1,0,0,0,0,0,0,0,0.4772727272727273,0.5227272727272727
89872,0.46511627906976744,0.574468085106383,115,-135,0.44670494689481377,0.5532950531051862,home,KC,under,9.5,0.5454545454545454,-120,0.5227272727272727,KC,DET,2023 REG,6,2,5,3,5,11,0,1,-1,1,1,1,0,0,0,0,0,0,0,0.4772727272727273,0.5227272727272727
89873,0.5121951219512195,0.5283018867924528,-105,-112,0.49145275161909474,0.5085472483809053,away,NYY,over,7.5,0.5121951219512195,-105,0.48808156828023186,MIN,NYY,2023 REG,5,6,14,12,18,19,0,1,-6,6,1,1,1,1,1,1,0,0,0,0.48808156828023186,0.5119184317197681
89873,0.5121951219512195,0.5283018867924528,-105,-112,0.49145275161909474,0.5085472483809053,home,MIN,under,7.5,0.5348837209302326,-115,0.5119184317197681,MIN,NYY,2023 REG,5,6,14,12,18,19,0,1,-6,6,1,1,1,1,1,1,0,0,0,0.48808156828023186,0.5119184317197681
89874,0.7142857142857143,0.32573289902280134,-250,207,0.6857009904939174,0.3142990095060826,away,OAK,over,9,0.5192307692307692,-108,0.49688292476754015,CLE,OAK,2023 REG,10,3,6,2,5,16,1,0,1,-1,1,1,0,0,0,0,0,0,0,0.49688292476754015,0.5031170752324599
89874,0.7142857142857143,0.32573289902280134,-250,207,0.6857009904939174,0.3142990095060826,home,CLE,under,9,0.5238095238095238,-110,0.5031170752324599,CLE,OAK,2023 REG,10,3,6,2,5,16,1,0,1,-1,1,1,0,0,0,0,0,0,0,0.49688292476754015,0.5031170752324599
89875,0.47619047619047616,0.5652173913043479,110,-130,0.4564724440500838,0.5435275559499162,away,CHC,over,13.5,0.5098039215686274,-104,0.48592421718142587,STL,CHC,2023 REG,6,1,14,9,10,20,0,1,-8,8,1,0,0,0,0,0,0,0,0,0.48592421718142587,0.5140757828185741
89875,0.47619047619047616,0.5652173913043479,110,-130,0.4564724440500838,0.5435275559499162,home,STL,under,13.5,0.5370370370370371,-116,0.5140757828185741,STL,CHC,2023 REG,6,1,14,9,10,20,0,1,-8,8,1,0,0,0,0,0,0,0,0,0.48592421718142587,0.5140757828185741
89876,0.6551724137931035,0.3846153846153846,-190,160,0.6291045458703008,0.37089545412969915,away,OAK,over,8,0.5238095238095238,-110,0.5000596729920038,BAL,OAK,2023 REG,6,5,8,1,6,14,1,0,4,-4,1,0,0,0,0,0,0,0,0,0.5000596729920038,0.4999403270079962
89876,0.6551724137931035,0.3846153846153846,-190,160,0.6291045458703008,0.37089545412969915,home,BAL,under,8,0.5215311004784688,-109,0.4999403270079962,BAL,OAK,2023 REG,6,5,8,1,6,14,1,0,4,-4,1,0,0,0,0,0,0,0,0,0.5000596729920038,0.4999403270079962
89877,0.5951417004048584,0.4444444444444444,-147,125,0.5715823348467713,0.42841766515322866,away,KC,over,9,0.5238095238095238,-110,0.5012646084074657,DET,KC,2023 REG,8,6,7,4,10,15,1,0,2,-2,1,1,1,1,0,0,0,0,0,0.5012646084074657,0.4987353915925343
89877,0.5951417004048584,0.4444444444444444,-147,125,0.5715823348467713,0.42841766515322866,home,DET,under,9,0.5192307692307692,-108,0.4987353915925343,DET,KC,2023 REG,8,6,7,4,10,15,1,0,2,-2,1,1,1,1,0,0,0,0,0,0.5012646084074657,0.4987353915925343
89878,0.3921568627450981,0.6453900709219857,155,-182,0.37743257503251615,0.6225674249674839,away,CHC,over,8.5,0.5073891625615764,-103,0.4826927225525911,MIA,CHC,2023 REG,8,4,9,3,7,17,1,0,1,-1,1,1,1,0,0,0,0,0,0,0.4826927225525911,0.5173072774474089
89878,0.3921568627450981,0.6453900709219857,155,-182,0.37743257503251615,0.6225674249674839,home,MIA,under,8.5,0.5412844036697247,-118,0.5173072774474089,MIA,CHC,2023 REG,8,4,9,3,7,17,1,0,1,-1,1,1,1,0,0,0,0,0,0,0.4826927225525911,0.5173072774474089
89879,0.5652173913043479,0.4739336492890995,-130,111,0.5430885422732689,0.45691145772673114,away,MIA,over,7.5,0.5454545454545454,-120,0.5206611570247933,SD,MIA,2023 REG,7,4,4,0,4,11,1,0,4,-4,0,0,0,0,0,0,0,0,0,0.5206611570247933,0.4793388429752067
89879,0.5652173913043479,0.4739336492890995,-130,111,0.5430885422732689,0.45691145772673114,home,SD,under,7.5,0.5,100,0.4793388429752067,SD,MIA,2023 REG,7,4,4,0,4,11,1,0,4,-4,0,0,0,0,0,0,0,0,0,0.5206611570247933,0.4793388429752067
89880,0.45248868778280543,0.5918367346938775,121,-145,0.4324319355309127,0.5675680644690873,away,SEA,over,9.5,0.5,100,0.4772727272727273,KC,SEA,2023 REG,15,8,14,10,18,29,0,1,-2,2,1,1,1,1,1,1,1,1,0,0.4772727272727273,0.5227272727272727
89880,0.45248868778280543,0.5918367346938775,121,-145,0.4324319355309127,0.5675680644690873,home,KC,under,9.5,0.5454545454545454,-120,0.5227272727272727,KC,SEA,2023 REG,15,8,14,10,18,29,0,1,-2,2,1,1,1,1,1,1,1,1,0,0.4772727272727273,0.5227272727272727
89881,0.6539792387543253,0.3846153846153846,-189,160,0.6287391563429925,0.3712608436570075,away,DET,over,9.5,0.5145631067961165,-106,0.4913668392989033,TEX,DET,2023 REG,12,8,5,3,11,17,1,0,5,-5,1,1,1,0,0,0,0,0,0,0.4913668392989033,0.5086331607010968
89881,0.6539792387543253,0.3846153846153846,-189,160,0.6287391563429925,0.3712608436570075,home,TEX,under,9.5,0.5305164319248826,-113,0.5086331607010968,TEX,DET,2023 REG,12,8,5,3,11,17,1,0,5,-5,1,1,1,0,0,0,0,0,0,0.4913668392989033,0.5086331607010968
89882,0.6000000000000001,0.4347826086956522,-150,130,0.5791304347826086,0.4208695652173914,away,SF,over,8.5,0.5348837209302326,-115,0.5097020142727117,STL,SF,2023 REG,9,5,11,8,13,20,0,1,-3,3,1,1,1,1,1,0,0,0,0,0.5097020142727117,0.49029798572728833
89882,0.6000000000000001,0.4347826086956522,-150,130,0.5791304347826086,0.4208695652173914,home,STL,under,8.5,0.5121951219512195,-105,0.49029798572728833,STL,SF,2023 REG,9,5,11,8,13,20,0,1,-3,3,1,1,1,1,1,0,0,0,0,0.5097020142727117,0.49029798572728833
89883,0.6503496503496503,0.3921568627450981,-186,155,0.6227055544208978,0.3772944455791022,away,NYM,over,9.5,0.5098039215686274,-104,0.48483656587239576,PHI,NYM,2023 REG,7,7,11,6,13,18,1,0,1,-1,1,1,1,1,1,1,0,0,0,0.48483656587239576,0.5151634341276042
89883,0.6503496503496503,0.3921568627450981,-186,155,0.6227055544208978,0.3772944455791022,home,PHI,under,9.5,0.5391705069124424,-117,0.5151634341276042,PHI,NYM,2023 REG,7,7,11,6,13,18,1,0,1,-1,1,1,1,1,1,1,0,0,0,0.48483656587239576,0.5151634341276042
89884,0.5073891625615764,0.5348837209302326,-103,-115,0.4859403596076043,0.5140596403923957,away,SD,over,9.5,0.5,100,0.4772727272727273,NYY,SD,2023 REG,7,1,9,5,6,16,0,1,-4,4,1,0,0,0,0,0,0,0,0,0.4772727272727273,0.5227272727272727
89884,0.5073891625615764,0.5348837209302326,-103,-115,0.4859403596076043,0.5140596403923957,home,NYY,under,9.5,0.5454545454545454,-120,0.5227272727272727,NYY,SD,2023 REG,7,1,9,5,6,16,0,1,-4,4,1,0,0,0,0,0,0,0,0,0.4772727272727273,0.5227272727272727
89885,0.5689655172413793,0.4716981132075471,-132,112,0.5458293137100936,0.4541706862899064,away,SEA,over,7,0.5238095238095238,-110,0.4988662131519274,HOU,SEA,2023 REG,4,3,5,2,5,9,1,0,1,-1,1,1,0,0,0,0,0,0,0,0.4988662131519274,0.5011337868480725
89885,0.5689655172413793,0.4716981132075471,-132,112,0.5458293137100936,0.4541706862899064,home,HOU,under,7,0.5238095238095238,-110,0.5011337868480725,HOU,SEA,2023 REG,4,3,5,2,5,9,1,0,1,-1,1,1,0,0,0,0,0,0,0,0.4988662131519274,0.5011337868480725
89886,0.4347826086956522,0.607843137254902,130,-155,0.41624967567367205,0.583750324326328,away,MIN,over,9.5,0.5121951219512195,-105,0.48808156828023186,CIN,MIN,2023 REG,9,7,5,3,10,14,1,0,4,-4,1,1,1,0,0,0,0,0,0,0.48808156828023186,0.5119184317197681
89886,0.4347826086956522,0.607843137254902,130,-155,0.41624967567367205,0.583750324326328,home,CIN,under,9.5,0.5348837209302326,-115,0.5119184317197681,CIN,MIN,2023 REG,9,7,5,3,10,14,1,0,4,-4,1,1,1,0,0,0,0,0,0,0.48808156828023186,0.5119184317197681
89887,0.7368421052631579,0.3076923076923077,-280,225,0.7040272746643939,0.29597272533560615,away,KC,over,10,0.5454545454545454,-120,0.5179608869977906,HOU,KC,2023 REG,6,2,7,3,5,13,0,1,-1,1,1,1,0,0,0,0,0,0,0,0.5179608869977906,0.48203911300220936
89887,0.7368421052631579,0.3076923076923077,-280,225,0.7040272746643939,0.29597272533560615,home,HOU,under,10,0.504950495049505,-102,0.48203911300220936,HOU,KC,2023 REG,6,2,7,3,5,13,0,1,-1,1,1,1,0,0,0,0,0,0,0,0.5179608869977906,0.48203911300220936
89888,0.576271186440678,0.4629629629629629,-136,116,0.553661676614851,0.446338323385149,away,MIA,over,8.5,0.5192307692307692,-108,0.49688292476754015,TEX,MIA,2023 REG,10,6,7,2,8,17,1,0,4,-4,1,1,0,0,0,0,0,0,0,0.49688292476754015,0.5031170752324599
89888,0.576271186440678,0.4629629629629629,-136,116,0.553661676614851,0.446338323385149,home,TEX,under,8.5,0.5238095238095238,-110,0.5031170752324599,TEX,MIA,2023 REG,10,6,7,2,8,17,1,0,4,-4,1,1,0,0,0,0,0,0,0,0.49688292476754015,0.5031170752324599
89889,0.36363636363636365,0.6774193548387096,175,-210,0.3487070114636097,0.6512929885363903,away,ATL,over,8,0.5283018867924528,-112,0.5044173060022736,NYM,ATL,2023 REG,9,8,9,9,17,18,0,1,-1,1,1,1,1,1,1,1,1,1,0,0.5044173060022736,0.49558269399772636
89889,0.36363636363636365,0.6774193548387096,175,-210,0.3487070114636097,0.6512929885363903,home,NYM,under,8,0.5169082125603864,-107,0.49558269399772636,NYM,ATL,2023 REG,9,8,9,9,17,18,0,1,-1,1,1,1,1,1,1,1,1,1,0,0.5044173060022736,0.49558269399772636
89890,0.4504504504504505,0.5867768595041323,122,-142,0.43368139191235017,0.5663186080876499,away,SEA,over,8,0.5348837209302326,-115,0.5109810284308424,HOU,SEA,2023 REG,7,1,6,5,6,13,0,1,-4,4,1,0,0,0,0,0,0,0,0,0.5109810284308424,0.48901897156915763
89890,0.4504504504504505,0.5867768595041323,122,-142,0.43368139191235017,0.5663186080876499,home,HOU,under,8,0.5098039215686274,-104,0.48901897156915763,HOU,SEA,2023 REG,7,1,6,5,6,13,0,1,-4,4,1,0,0,0,0,0,0,0,0,0.5109810284308424,0.48901897156915763
89891,0.5,0.5391705069124424,100,-117,0.4804147465437788,0.5195852534562212,away,PHI,over,7.5,0.49504950495049505,102,0.47297076509898783,MIA,PHI,2023 REG,13,9,12,8,17,25,1,0,1,-1,1,1,1,1,1,1,1,1,0,0.47297076509898783,0.5270292349010122
89891,0.5,0.5391705069124424,100,-117,0.4804147465437788,0.5195852534562212,home,MIA,under,7.5,0.5495495495495495,-122,0.5270292349010122,MIA,PHI,2023 REG,13,9,12,8,17,25,1,0,1,-1,1,1,1,1,1,1,1,1,0,0.47297076509898783,0.5270292349010122
89892,0.5833333333333333,0.45454545454545453,-140,120,0.5612373737373737,0.4387626262626263,away,CIN,over,7.5,0.5192307692307692,-108,0.49571111079951763,MIA,CIN,2023 REG,7,4,11,7,11,18,0,1,-3,3,1,1,1,1,0,0,0,0,0,0.49571111079951763,0.5042888892004824
89892,0.5833333333333333,0.45454545454545453,-140,120,0.5612373737373737,0.4387626262626263,home,MIA,under,7.5,0.5260663507109005,-111,0.5042888892004824,MIA,CIN,2023 REG,7,4,11,7,11,18,0,1,-3,3,1,1,1,1,0,0,0,0,0,0.49571111079951763,0.5042888892004824
89893,0.7590361445783133,0.2777777777777778,-315,260,0.7310930468863406,0.2689069531136594,away,OAK,over,9,0.5348837209302326,-115,0.5097020142727117,LAD,OAK,2023 REG,7,7,6,3,10,13,1,0,4,-4,1,1,1,0,0,0,0,0,0,0.5097020142727117,0.49029798572728833
89893,0.7590361445783133,0.2777777777777778,-315,260,0.7310930468863406,0.2689069531136594,home,LAD,under,9,0.5121951219512195,-105,0.49029798572728833,LAD,OAK,2023 REG,7,7,6,3,10,13,1,0,4,-4,1,1,1,0,0,0,0,0,0,0.5097020142727117,0.49029798572728833
89894,0.47846889952153115,0.5594713656387665,109,-127,0.4603156626027285,0.5396843373972715,away,STL,over,10.5,0.5215311004784688,-109,0.4978845547971712,CIN,STL,2023 REG,6,3,8,4,7,14,0,1,-1,1,1,1,1,0,0,0,0,0,0,0.4978845547971712,0.5021154452028288
89894,0.47846889952153115,0.5594713656387665,109,-127,0.4603156626027285,0.5396843373972715,home,CIN,under,10.5,0.5238095238095238,-110,0.5021154452028288,CIN,STL,2023 REG,6,3,8,4,7,14,0,1,-1,1,1,1,1,0,0,0,0,0,0,0.4978845547971712,0.5021154452028288
89895,0.6226415094339623,0.4166666666666667,-165,140,0.5981666073335706,0.40183339266642937,away,PIT,over,7.5,0.5169082125603864,-107,0.49353874091423283,DET,PIT,2023 REG,1,0,14,8,8,15,0,1,-8,8,0,0,0,0,0,0,0,0,0,0.49353874091423283,0.5064612590857671
89895,0.6226415094339623,0.4166666666666667,-165,140,0.5981666073335706,0.40183339266642937,home,DET,under,7.5,0.5283018867924528,-112,0.5064612590857671,DET,PIT,2023 REG,1,0,14,8,8,15,0,1,-8,8,0,0,0,0,0,0,0,0,0,0.49353874091423283,0.5064612590857671
89896,0.607843137254902,0.4347826086956522,-155,130,0.5819333701084867,0.41806662989151333,away,NYY,over,7.5,0.504950495049505,-102,0.48054649490447493,MIA,NYY,2023 REG,8,3,5,1,4,13,1,0,2,-2,1,0,0,0,0,0,0,0,0,0.48054649490447493,0.5194535050955251
89896,0.607843137254902,0.4347826086956522,-155,130,0.5819333701084867,0.41806662989151333,home,MIA,under,7.5,0.5433789954337899,-119,0.5194535050955251,MIA,NYY,2023 REG,8,3,5,1,4,13,1,0,2,-2,1,0,0,0,0,0,0,0,0,0.48054649490447493,0.5194535050955251
89897,0.6240601503759399,0.4166666666666667,-166,140,0.5986441668079975,0.4013558331920025,away,WSH,over,11,0.5145631067961165,-106,0.49023796582517226,COL,WSH,2023 REG,9,1,6,0,1,15,1,0,1,-1,0,0,0,0,0,0,0,0,0,0.49023796582517226,0.5097620341748277
89897,0.6240601503759399,0.4166666666666667,-166,140,0.5986441668079975,0.4013558331920025,home,COL,under,11,0.5327102803738317,-114,0.5097620341748277,COL,WSH,2023 REG,9,1,6,0,1,15,1,0,1,-1,0,0,0,0,0,0,0,0,0,0.49023796582517226,0.5097620341748277
89898,0.35211267605633806,0.6875,184,-220,0.33816455068438805,0.661835449315612,away,LAA,over,7,0.5391705069124424,-117,0.5127649394825569,OAK,LAA,2023 REG,6,2,5,1,3,11,1,0,1,-1,1,0,0,0,0,0,0,0,0,0.5127649394825569,0.48723506051744314
89898,0.35211267605633806,0.6875,184,-220,0.33816455068438805,0.661835449315612,home,OAK,under,7,0.5098039215686274,-104,0.48723506051744314,OAK,LAA,2023 REG,6,2,5,1,3,11,1,0,1,-1,1,0,0,0,0,0,0,0,0,0.5127649394825569,0.48723506051744314
89899,0.5098039215686274,0.5348837209302326,-104,-115,0.4870219861770517,0.5129780138229483,away,PHI,over,8.5,0.5305164319248826,-113,0.5053568787472517,CWS,PHI,2023 REG,6,2,9,5,7,15,0,1,-3,3,1,1,0,0,0,0,0,0,0,0.5053568787472517,0.49464312125274834
89899,0.5098039215686274,0.5348837209302326,-104,-115,0.4870219861770517,0.5129780138229483,home,CWS,under,8.5,0.5169082125603864,-107,0.49464312125274834,CWS,PHI,2023 REG,6,2,9,5,7,15,0,1,-3,3,1,1,0,0,0,0,0,0,0,0.5053568787472517,0.49464312125274834
89900,0.36363636363636365,0.6774193548387096,175,-210,0.3487070114636097,0.6512929885363903,away,SD,over,12,0.5215311004784688,-109,0.4978845547971712,COL,SD,2023 REG,5,4,12,3,7,17,1,0,1,-1,1,1,1,0,0,0,0,0,0,0.4978845547971712,0.5021154452028288
89900,0.36363636363636365,0.6774193548387096,175,-210,0.3487070114636097,0.6512929885363903,home,COL,under,12,0.5238095238095238,-110,0.5021154452028288,COL,SD,2023 REG,5,4,12,3,7,17,1,0,1,-1,1,1,1,0,0,0,0,0,0,0.4978845547971712,0.5021154452028288
89901,0.5867768595041323,0.45248868778280543,-142,121,0.563736744980392,0.43626325501960805,away,SF,over,9,0.5073891625615764,-103,0.4837652908580103,NYM,SF,2023 REG,11,8,8,4,12,19,1,0,4,-4,1,1,1,1,0,0,0,0,0,0.4837652908580103,0.5162347091419897
89901,0.5867768595041323,0.45248868778280543,-142,121,0.563736744980392,0.43626325501960805,home,NYM,under,9,0.5391705069124424,-117,0.5162347091419897,NYM,SF,2023 REG,11,8,8,4,12,19,1,0,4,-4,1,1,1,1,0,0,0,0,0,0.4837652908580103,0.5162347091419897
89902,0.5283018867924528,0.5145631067961165,-112,-106,0.5056562298022652,0.4943437701977348,away,TOR,over,8.5,0.5073891625615764,-103,0.4826927225525911,SEA,TOR,2023 REG,10,3,6,2,5,16,1,0,1,-1,1,1,0,0,0,0,0,0,0,0.4826927225525911,0.5173072774474089
89902,0.5283018867924528,0.5145631067961165,-112,-106,0.5056562298022652,0.4943437701977348,home,SEA,under,8.5,0.5412844036697247,-118,0.5173072774474089,SEA,TOR,2023 REG,10,3,6,2,5,16,1,0,1,-1,1,1,0,0,0,0,0,0,0,0.4826927225525911,0.5173072774474089
89903,0.5515695067264574,0.49019607843137253,-123,104,0.5285328835228112,0.47146711647718875,away,OAK,over,11,0.5238095238095238,-110,0.4988662131519274,COL,OAK,2023 REG,11,5,14,8,13,25,0,1,-3,3,1,1,1,1,1,0,0,0,0,0.4988662131519274,0.5011337868480725
89903,0.5515695067264574,0.49019607843137253,-123,104,0.5285328835228112,0.47146711647718875,home,COL,under,11,0.5238095238095238,-110,0.5011337868480725,COL,OAK,2023 REG,11,5,14,8,13,25,0,1,-3,3,1,1,1,1,1,0,0,0,0,0.4988662131519274,0.5011337868480725
89904,0.6923076923076923,0.3508771929824561,-225,185,0.6624104640298972,0.33758953597010277,away,KC,over,11,0.5073891625615764,-103,0.4826927225525911,BOS,KC,2023 REG,7,4,7,3,7,14,1,0,1,-1,1,1,1,0,0,0,0,0,0,0.4826927225525911,0.5173072774474089
89904,0.6923076923076923,0.3508771929824561,-225,185,0.6624104640298972,0.33758953597010277,home,BOS,under,11,0.5412844036697247,-118,0.5173072774474089,BOS,KC,2023 REG,7,4,7,3,7,14,1,0,1,-1,1,1,1,0,0,0,0,0,0,0.4826927225525911,0.5173072774474089
89905,0.6254681647940076,0.4132231404958678,-167,142,0.6012679850808645,0.39873201491913546,away,CIN,over,9.5,0.5283018867924528,-112,0.5031902949311281,LAD,CIN,2023 REG,6,0,14,9,9,20,0,1,-9,9,0,0,0,0,0,0,0,0,0,0.5031902949311281,0.4968097050688719
89905,0.6254681647940076,0.4132231404958678,-167,142,0.6012679850808645,0.39873201491913546,home,LAD,under,9.5,0.5192307692307692,-108,0.4968097050688719,LAD,CIN,2023 REG,6,0,14,9,9,20,0,1,-9,9,0,0,0,0,0,0,0,0,0,0.5031902949311281,0.4968097050688719
89906,0.7101449275362319,0.3278688524590164,-245,205,0.6831496344961281,0.3168503655038719,away,WSH,over,7.5,0.5327102803738317,-114,0.5075272610403079,BAL,WSH,2023 REG,6,1,3,0,1,9,1,0,1,-1,0,0,0,0,0,0,0,0,0,0.5075272610403079,0.4924727389596921
89906,0.7101449275362319,0.3278688524590164,-245,205,0.6831496344961281,0.3168503655038719,home,BAL,under,7.5,0.5145631067961165,-106,0.4924727389596921,BAL,WSH,2023 REG,6,1,3,0,1,9,1,0,1,-1,0,0,0,0,0,0,0,0,0,0.5075272610403079,0.4924727389596921
89907,0.6610169491525424,0.37735849056603776,-195,165,0.6356501330673793,0.3643498669326207,away,OAK,over,8.5,0.5121951219512195,-105,0.48808156828023186,NYY,OAK,2023 REG,9,7,10,2,9,19,1,0,5,-5,1,1,0,0,0,0,0,0,0,0.48808156828023186,0.5119184317197681
89907,0.6610169491525424,0.37735849056603776,-195,165,0.6356501330673793,0.3643498669326207,home,NYY,under,8.5,0.5348837209302326,-115,0.5119184317197681,NYY,OAK,2023 REG,9,7,10,2,9,19,1,0,5,-5,1,1,0,0,0,0,0,0,0,0.48808156828023186,0.5119184317197681
89908,0.6551724137931035,0.3846153846153846,-190,160,0.6291045458703008,0.37089545412969915,away,WSH,over,9,0.5348837209302326,-115,0.5097020142727117,SD,WSH,2023 REG,4,0,6,2,2,10,0,1,-2,2,0,0,0,0,0,0,0,0,0,0.5097020142727117,0.49029798572728833
89908,0.6551724137931035,0.3846153846153846,-190,160,0.6291045458703008,0.37089545412969915,home,SD,under,9,0.5121951219512195,-105,0.49029798572728833,SD,WSH,2023 REG,4,0,6,2,2,10,0,1,-2,2,0,0,0,0,0,0,0,0,0,0.5097020142727117,0.49029798572728833
89909,0.6254681647940076,0.40322580645161293,-167,148,0.6075209992583573,0.39247900074164266,away,MIL,over,8.5,0.5475113122171946,-121,0.5242087833606768,SD,MIL,2023 REG,9,2,15,11,13,24,0,1,-9,9,1,1,0,0,0,0,0,0,0,0.5242087833606768,0.4757912166393232
89909,0.6254681647940076,0.40322580645161293,-167,148,0.6075209992583573,0.39247900074164266,home,SD,under,8.5,0.49504950495049505,102,0.4757912166393232,SD,MIL,2023 REG,9,2,15,11,13,24,0,1,-9,9,1,1,0,0,0,0,0,0,0,0.5242087833606768,0.4757912166393232
89910,0.5024875621890548,0.5370370370370371,-101,-116,0.48262694267743644,0.5173730573225636,away,SD,over,8.5,0.5348837209302326,-115,0.5097020142727117,MIA,SD,2023 REG,6,2,2,1,3,8,1,0,1,-1,1,0,0,0,0,0,0,0,0,0.5097020142727117,0.49029798572728833
89910,0.5024875621890548,0.5370370370370371,-101,-116,0.48262694267743644,0.5173730573225636,home,MIA,under,8.5,0.5121951219512195,-105,0.49029798572728833,MIA,SD,2023 REG,6,2,2,1,3,8,1,0,1,-1,1,0,0,0,0,0,0,0,0,0.5097020142727117,0.49029798572728833
89911,0.7142857142857143,0.3225806451612903,-250,210,0.6879526003949967,0.3120473996050033,away,COL,over,9,0.5412844036697247,-118,0.5149381613977361,BAL,COL,2023 REG,5,3,9,4,7,14,0,1,-1,1,1,1,1,0,0,0,0,0,0,0.5149381613977361,0.48506183860226393
89911,0.7142857142857143,0.3225806451612903,-250,210,0.6879526003949967,0.3120473996050033,home,BAL,under,9,0.5073891625615764,-103,0.48506183860226393,BAL,COL,2023 REG,5,3,9,4,7,14,0,1,-1,1,1,1,1,0,0,0,0,0,0,0.5149381613977361,0.48506183860226393
89912,0.6254681647940076,0.4081632653061224,-167,145,0.6044327759298813,0.3955672240701187,away,CIN,over,9.5,0.5121951219512195,-105,0.48808156828023186,BOS,CIN,2023 REG,8,8,7,2,10,15,1,0,6,-6,1,1,0,0,0,0,0,0,0,0.48808156828023186,0.5119184317197681
89912,0.6254681647940076,0.4081632653061224,-167,145,0.6044327759298813,0.3955672240701187,home,BOS,under,9.5,0.5348837209302326,-115,0.5119184317197681,BOS,CIN,2023 REG,8,8,7,2,10,15,1,0,6,-6,1,1,0,0,0,0,0,0,0,0.48808156828023186,0.5119184317197681
89913,0.38314176245210724,0.6563573883161512,161,-191,0.3680079882113952,0.6319920117886049,away,MIA,over,9,0.5238095238095238,-110,0.4988662131519274,WSH,MIA,2023 REG,10,4,10,6,10,20,0,1,-2,2,1,1,1,1,0,0,0,0,0,0.4988662131519274,0.5011337868480725
89913,0.38314176245210724,0.6563573883161512,161,-191,0.3680079882113952,0.6319920117886049,home,WSH,under,9,0.5238095238095238,-110,0.5011337868480725,WSH,MIA,2023 REG,10,4,10,6,10,20,0,1,-2,2,1,1,1,1,0,0,0,0,0,0.4988662131519274,0.5011337868480725
89914,0.6825396825396826,0.35714285714285715,-215,180,0.6554547745023935,0.34454522549760647,away,TEX,over,8,0.5098039215686274,-104,0.4870219861770517,HOU,TEX,2023 REG,4,1,8,9,10,12,0,1,-8,8,1,0,0,0,0,0,0,0,0,0.4870219861770517,0.5129780138229483
89914,0.6825396825396826,0.35714285714285715,-215,180,0.6554547745023935,0.34454522549760647,home,HOU,under,8,0.5348837209302326,-115,0.5129780138229483,HOU,TEX,2023 REG,4,1,8,9,10,12,0,1,-8,8,1,0,0,0,0,0,0,0,0,0.4870219861770517,0.5129780138229483
89915,0.46511627906976744,0.5689655172413793,115,-132,0.4492642807855131,0.5507357192144868,away,NYM,over,7,0.5238095238095238,-110,0.4988662131519274,MIA,NYM,2023 REG,5,3,8,5,8,13,0,1,-2,2,1,1,1,0,0,0,0,0,0,0.4988662131519274,0.5011337868480725
89915,0.46511627906976744,0.5689655172413793,115,-132,0.4492642807855131,0.5507357192144868,home,MIA,under,7,0.5238095238095238,-110,0.5011337868480725,MIA,NYM,2023 REG,5,3,8,5,8,13,0,1,-2,2,1,1,1,0,0,0,0,0,0,0.4988662131519274,0.5011337868480725
89916,0.47619047619047616,0.5652173913043479,110,-130,0.4564724440500838,0.5435275559499162,away,MIL,over,7,0.5,100,0.4772727272727273,MIA,MIL,2023 REG,17,6,8,1,7,25,1,0,5,-5,1,0,0,0,0,0,0,0,0,0.4772727272727273,0.5227272727272727
89916,0.47619047619047616,0.5652173913043479,110,-130,0.4564724440500838,0.5435275559499162,home,MIA,under,7,0.5454545454545454,-120,0.5227272727272727,MIA,MIL,2023 REG,17,6,8,1,7,25,1,0,5,-5,1,0,0,0,0,0,0,0,0,0.4772727272727273,0.5227272727272727
89917,0.45454545454545453,0.5833333333333333,120,-140,0.43732782369146006,0.5626721763085399,away,SD,over,12.5,0.5121951219512195,-105,0.48808156828023186,COL,SD,2023 REG,5,2,9,3,5,14,0,1,-1,1,1,1,0,0,0,0,0,0,0,0.48808156828023186,0.5119184317197681
89917,0.45454545454545453,0.5833333333333333,120,-140,0.43732782369146006,0.5626721763085399,home,COL,under,12.5,0.5348837209302326,-115,0.5119184317197681,COL,SD,2023 REG,5,2,9,3,5,14,0,1,-1,1,1,1,0,0,0,0,0,0,0,0.48808156828023186,0.5119184317197681
89918,0.4098360655737705,0.6296296296296295,144,-170,0.3936616003264754,0.6063383996735245,away,MIN,over,8.5,0.5098039215686274,-104,0.48592421718142587,DET,MIN,2023 REG,8,3,12,9,12,20,0,1,-6,6,1,1,1,0,0,0,0,0,0,0.48592421718142587,0.5140757828185741
89918,0.4098360655737705,0.6296296296296295,144,-170,0.3936616003264754,0.6063383996735245,home,DET,under,8.5,0.5370370370370371,-116,0.5140757828185741,DET,MIN,2023 REG,8,3,12,9,12,20,0,1,-6,6,1,1,1,0,0,0,0,0,0,0.48592421718142587,0.5140757828185741
89919,0.5283018867924528,0.5145631067961165,-112,-106,0.5056562298022652,0.4943437701977348,away,STL,over,9,0.5121951219512195,-105,0.48919479393107135,ARI,STL,2023 REG,8,3,5,1,4,13,1,0,2,-2,1,0,0,0,0,0,0,0,0,0.48919479393107135,0.5108052060689287
89919,0.5283018867924528,0.5145631067961165,-112,-106,0.5056562298022652,0.4943437701977348,home,ARI,under,9,0.5327102803738317,-114,0.5108052060689287,ARI,STL,2023 REG,8,3,5,1,4,13,1,0,2,-2,1,0,0,0,0,0,0,0,0,0.48919479393107135,0.5108052060689287
89920,0.5327102803738317,0.5121951219512195,-114,-105,0.508788710910954,0.491211289089046,away,NYM,over,6.5,0.5412844036697247,-118,0.5189377998484975,CHC,NYM,2023 REG,8,4,4,2,6,12,1,0,2,-2,1,1,0,0,0,0,0,0,0,0.5189377998484975,0.4810622001515025
89920,0.5327102803738317,0.5121951219512195,-114,-105,0.508788710910954,0.491211289089046,home,CHC,under,6.5,0.5,100,0.4810622001515025,CHC,NYM,2023 REG,8,4,4,2,6,12,1,0,2,-2,1,1,0,0,0,0,0,0,0,0.5189377998484975,0.4810622001515025
89922,0.4672897196261683,0.574468085106383,114,-135,0.4477767267604901,0.5522232732395099,away,ATL,over,10,0.5145631067961165,-106,0.4913668392989033,SF,ATL,2023 REG,8,8,6,5,13,14,1,0,3,-3,1,1,1,1,1,0,0,0,0,0.4913668392989033,0.5086331607010968
89922,0.4672897196261683,0.574468085106383,114,-135,0.4477767267604901,0.5522232732395099,home,SF,under,10,0.5305164319248826,-113,0.5086331607010968,SF,ATL,2023 REG,8,8,6,5,13,14,1,0,3,-3,1,1,1,1,1,0,0,0,0,0.4913668392989033,0.5086331607010968
89923,0.6226415094339623,0.41493775933609955,-165,141,0.5992430968035465,0.4007569031964535,away,SF,over,8.5,0.5238095238095238,-110,0.4988662131519274,MIN,SF,2023 REG,4,1,5,4,5,9,0,1,-3,3,1,0,0,0,0,0,0,0,0,0.4988662131519274,0.5011337868480725
89923,0.6226415094339623,0.41493775933609955,-165,141,0.5992430968035465,0.4007569031964535,home,MIN,under,8.5,0.5238095238095238,-110,0.5011337868480725,MIN,SF,2023 REG,4,1,5,4,5,9,0,1,-3,3,1,0,0,0,0,0,0,0,0,0.4988662131519274,0.5011337868480725
89924,0.7142857142857143,0.32573289902280134,-250,207,0.6857009904939174,0.3142990095060826,away,CIN,over,7.5,0.5024875621890548,-101,0.48049269377245407,MIA,CIN,2023 REG,9,5,8,6,11,17,0,1,-1,1,1,1,1,1,1,0,0,0,0,0.48049269377245407,0.5195073062275459
89924,0.7142857142857143,0.32573289902280134,-250,207,0.6857009904939174,0.3142990095060826,home,MIA,under,7.5,0.5412844036697247,-118,0.5195073062275459,MIA,CIN,2023 REG,9,5,8,6,11,17,0,1,-1,1,1,1,1,1,1,0,0,0,0,0.48049269377245407,0.5195073062275459
89925,0.5145631067961165,0.5238095238095238,-106,-110,0.4948179667757384,0.5051820332242616,away,NYM,over,8,0.504950495049505,-102,0.4826715732667395,MIA,NYM,2023 REG,10,2,4,1,3,14,1,0,1,-1,1,0,0,0,0,0,0,0,0,0.4826715732667395,0.5173284267332605
89925,0.5145631067961165,0.5238095238095238,-106,-110,0.4948179667757384,0.5051820332242616,home,MIA,under,8,0.5391705069124424,-117,0.5173284267332605,MIA,NYM,2023 REG,10,2,4,1,3,14,1,0,1,-1,1,0,0,0,0,0,0,0,0,0.4826715732667395,0.5173284267332605
89926,0.5454545454545454,0.5,-120,100,0.5206611570247933,0.4793388429752067,away,MIL,over,8.5,0.5073891625615764,-103,0.4826927225525911,CLE,MIL,2023 REG,9,4,4,2,6,13,1,0,2,-2,1,1,0,0,0,0,0,0,0,0.4826927225525911,0.5173072774474089
89926,0.5454545454545454,0.5,-120,100,0.5206611570247933,0.4793388429752067,home,CLE,under,8.5,0.5412844036697247,-118,0.5173072774474089,CLE,MIL,2023 REG,9,4,4,2,6,13,1,0,2,-2,1,1,0,0,0,0,0,0,0,0.4826927225525911,0.5173072774474089
89927,0.5121951219512195,0.5305164319248826,-105,-113,0.4903184724049234,0.5096815275950766,away,ARI,over,7.5,0.5327102803738317,-114,0.508788710910954,SF,ARI,2023 REG,9,4,6,3,7,15,1,0,1,-1,1,1,1,0,0,0,0,0,0,0.508788710910954,0.491211289089046
89927,0.5121951219512195,0.5305164319248826,-105,-113,0.4903184724049234,0.5096815275950766,home,SF,under,7.5,0.5121951219512195,-105,0.491211289089046,SF,ARI,2023 REG,9,4,6,3,7,15,1,0,1,-1,1,1,1,0,0,0,0,0,0,0.508788710910954,0.491211289089046
89928,0.5348837209302326,0.5098039215686274,-115,-104,0.5109810284308424,0.48901897156915763,away,TOR,over,8.5,0.5348837209302326,-115,0.5097020142727117,TB,TOR,2023 REG,6,1,27,20,21,33,0,1,-19,19,1,0,0,0,0,0,0,0,0,0.5097020142727117,0.49029798572728833
89928,0.5348837209302326,0.5098039215686274,-115,-104,0.5109810284308424,0.48901897156915763,home,TB,under,8.5,0.5121951219512195,-105,0.49029798572728833,TB,TOR,2023 REG,6,1,27,20,21,33,0,1,-19,19,1,0,0,0,0,0,0,0,0,0.5097020142727117,0.49029798572728833
89929,0.3921568627450981,0.6503496503496503,155,-186,0.3754876419236281,0.6245123580763718,away,NYY,over,8,0.5454545454545454,-120,0.5206611570247933,OAK,NYY,2023 REG,8,4,13,10,14,21,0,1,-6,6,1,1,1,1,0,0,0,0,0,0.5206611570247933,0.4793388429752067
89929,0.3921568627450981,0.6503496503496503,155,-186,0.3754876419236281,0.6245123580763718,home,OAK,under,8,0.5,100,0.4793388429752067,OAK,NYY,2023 REG,8,4,13,10,14,21,0,1,-6,6,1,1,1,1,0,0,0,0,0,0.5206611570247933,0.4793388429752067
89930,0.4166666666666667,0.6183206106870228,140,-162,0.40208863443596277,0.5979113655640372,away,CHC,over,7.5,0.49504950495049505,102,0.4739797934813417,OAK,CHC,2023 REG,5,2,11,12,14,16,0,1,-10,10,1,1,0,0,0,0,0,0,0,0.4739797934813417,0.5260202065186583
89930,0.4166666666666667,0.6183206106870228,140,-162,0.40208863443596277,0.5979113655640372,home,OAK,under,7.5,0.5475113122171946,-121,0.5260202065186583,OAK,CHC,2023 REG,5,2,11,12,14,16,0,1,-10,10,1,1,0,0,0,0,0,0,0,0.4739797934813417,0.5260202065186583
89931,0.37453183520599254,0.6610169491525424,167,-195,0.3612176837608484,0.6387823162391516,away,SD,over,11.5,0.5192307692307692,-108,0.49455035168025013,COL,SD,2023 REG,10,6,15,9,15,25,0,1,-3,3,1,1,1,1,1,1,0,0,0,0.49455035168025013,0.5054496483197499
89931,0.37453183520599254,0.6610169491525424,167,-195,0.3612176837608484,0.6387823162391516,home,COL,under,11.5,0.5283018867924528,-112,0.5054496483197499,COL,SD,2023 REG,10,6,15,9,15,25,0,1,-3,3,1,1,1,1,1,1,0,0,0,0.49455035168025013,0.5054496483197499
89932,0.3125,0.726027397260274,220,-265,0.3004601883561644,0.6995398116438356,away,ATL,over,7.5,0.5169082125603864,-107,0.49239402434819424,WSH,ATL,2023 REG,8,2,12,7,9,20,0,1,-5,5,1,1,0,0,0,0,0,0,0,0.49239402434819424,0.5076059756518058
89932,0.3125,0.726027397260274,220,-265,0.3004601883561644,0.6995398116438356,home,WSH,under,7.5,0.5305164319248826,-113,0.5076059756518058,WSH,ATL,2023 REG,8,2,12,7,9,20,0,1,-5,5,1,1,0,0,0,0,0,0,0,0.49239402434819424,0.5076059756518058
89934,0.5726495726495727,0.4672897196261683,-134,114,0.5497783539959433,0.4502216460040567,away,CWS,over,8,0.5327102803738317,-114,0.508788710910954,MIN,CWS,2023 REG,6,3,10,2,5,16,1,0,1,-1,1,1,0,0,0,0,0,0,0,0.508788710910954,0.491211289089046
89934,0.5726495726495727,0.4672897196261683,-134,114,0.5497783539959433,0.4502216460040567,home,MIN,under,8,0.5121951219512195,-105,0.491211289089046,MIN,CWS,2023 REG,6,3,10,2,5,16,1,0,1,-1,1,1,0,0,0,0,0,0,0,0.508788710910954,0.491211289089046
89935,0.6226415094339623,0.4132231404958678,-165,142,0.6003106896663323,0.3996893103336677,away,KC,over,9,0.5,100,0.4772727272727273,TEX,KC,2023 REG,4,1,14,10,11,18,0,1,-9,9,1,0,0,0,0,0,0,0,0,0.4772727272727273,0.5227272727272727
89935,0.6226415094339623,0.4132231404958678,-165,142,0.6003106896663323,0.3996893103336677,home,TEX,under,9,0.5454545454545454,-120,0.5227272727272727,TEX,KC,2023 REG,4,1,14,10,11,18,0,1,-9,9,1,0,0,0,0,0,0,0,0,0.4772727272727273,0.5227272727272727
89936,0.6000000000000001,0.4347826086956522,-150,130,0.5791304347826086,0.4208695652173914,away,PIT,over,6.5,0.5515695067264574,-123,0.5285328835228112,CHC,PIT,2023 REG,12,7,6,2,9,18,1,0,5,-5,1,1,0,0,0,0,0,0,0,0.5285328835228112,0.47146711647718875
89936,0.6000000000000001,0.4347826086956522,-150,130,0.5791304347826086,0.4208695652173914,home,CHC,under,6.5,0.49019607843137253,104,0.47146711647718875,CHC,PIT,2023 REG,12,7,6,2,9,18,1,0,5,-5,1,1,0,0,0,0,0,0,0,0.5285328835228112,0.47146711647718875
89937,0.4132231404958678,0.6254681647940076,142,-167,0.3972349978141011,0.6027650021858989,away,MIN,over,10,0.5121951219512195,-105,0.48808156828023186,KC,MIN,2023 REG,9,8,8,5,13,17,1,0,3,-3,1,1,1,1,1,0,0,0,0,0.48808156828023186,0.5119184317197681
89937,0.4132231404958678,0.6254681647940076,142,-167,0.3972349978141011,0.6027650021858989,home,KC,under,10,0.5348837209302326,-115,0.5119184317197681,KC,MIN,2023 REG,9,8,8,5,13,17,1,0,3,-3,1,1,1,1,1,0,0,0,0,0.48808156828023186,0.5119184317197681
89938,0.5260663507109005,0.5169082125603864,-111,-107,0.5034588790373798,0.49654112096262015,away,MIL,over,8.5,0.5391705069124424,-117,0.5127649394825569,PHI,MIL,2023 REG,2,0,8,4,4,10,0,1,-4,4,0,0,0,0,0,0,0,0,0,0.5127649394825569,0.48723506051744314
89938,0.5260663507109005,0.5169082125603864,-111,-107,0.5034588790373798,0.49654112096262015,home,PHI,under,8.5,0.5098039215686274,-104,0.48723506051744314,PHI,MIL,2023 REG,2,0,8,4,4,10,0,1,-4,4,0,0,0,0,0,0,0,0,0,0.5127649394825569,0.48723506051744314
89939,0.5934959349593496,0.4504504504504505,-146,122,0.5674139338624764,0.4325860661375236,away,BOS,over,8.5,0.5073891625615764,-103,0.4837652908580103,TOR,BOS,2023 REG,7,3,9,2,5,16,1,0,1,-1,1,1,0,0,0,0,0,0,0,0.4837652908580103,0.5162347091419897
89939,0.5934959349593496,0.4504504504504505,-146,122,0.5674139338624764,0.4325860661375236,home,TOR,under,8.5,0.5391705069124424,-117,0.5162347091419897,TOR,BOS,2023 REG,7,3,9,2,5,16,1,0,1,-1,1,1,0,0,0,0,0,0,0,0.4837652908580103,0.5162347091419897
89940,0.6666666666666666,0.37037037037037035,-200,170,0.6419753086419753,0.3580246913580247,away,CHC,over,7.5,0.5412844036697247,-118,0.5149381613977361,HOU,CHC,2023 REG,11,6,8,4,10,19,1,0,2,-2,1,1,1,1,0,0,0,0,0,0.5149381613977361,0.48506183860226393
89940,0.6666666666666666,0.37037037037037035,-200,170,0.6419753086419753,0.3580246913580247,home,HOU,under,7.5,0.5073891625615764,-103,0.48506183860226393,HOU,CHC,2023 REG,11,6,8,4,10,19,1,0,2,-2,1,1,1,1,0,0,0,0,0,0.5149381613977361,0.48506183860226393
89941,0.425531914893617,0.6108949416342413,135,-157,0.41003112488176247,0.5899688751182375,away,BOS,over,9,0.5,100,0.4772727272727273,WSH,BOS,2023 REG,9,6,4,2,8,13,1,0,4,-4,1,1,0,0,0,0,0,0,0,0.4772727272727273,0.5227272727272727
89941,0.425531914893617,0.6108949416342413,135,-157,0.41003112488176247,0.5899688751182375,home,WSH,under,9,0.5454545454545454,-120,0.5227272727272727,WSH,BOS,2023 REG,9,6,4,2,8,13,1,0,4,-4,1,1,0,0,0,0,0,0,0,0.4772727272727273,0.5227272727272727
89942,0.4291845493562232,0.6108949416342413,133,-157,0.4119830510770539,0.5880169489229461,away,TB,over,9,0.5024875621890548,-101,0.47839724939301687,NYY,TB,2023 REG,3,1,8,5,6,11,0,1,-4,4,1,0,0,0,0,0,0,0,0,0.47839724939301687,0.5216027506069831
89942,0.4291845493562232,0.6108949416342413,133,-157,0.4119830510770539,0.5880169489229461,home,NYY,under,9,0.5454545454545454,-120,0.5216027506069831,NYY,TB,2023 REG,3,1,8,5,6,11,0,1,-4,4,1,0,0,0,0,0,0,0,0,0.47839724939301687,0.5216027506069831
89943,0.5283018867924528,0.5121951219512195,-112,-105,0.5069072406637203,0.4930927593362797,away,TEX,over,8.5,0.5454545454545454,-120,0.5206611570247933,BAL,TEX,2023 REG,6,3,10,5,8,16,0,1,-2,2,1,1,1,0,0,0,0,0,0,0.5206611570247933,0.4793388429752067
89943,0.5283018867924528,0.5121951219512195,-112,-105,0.5069072406637203,0.4930927593362797,home,BAL,under,8.5,0.5,100,0.4793388429752067,BAL,TEX,2023 REG,6,3,10,5,8,16,0,1,-2,2,1,1,1,0,0,0,0,0,0,0.5206611570247933,0.4793388429752067
89944,0.5169082125603864,0.5215311004784688,-107,-109,0.49703861596542265,0.5029613840345774,away,STL,over,8.5,0.5073891625615764,-103,0.4837652908580103,CLE,STL,2023 REG,8,1,2,2,3,10,0,1,-1,1,1,0,0,0,0,0,0,0,0,0.4837652908580103,0.5162347091419897
89944,0.5169082125603864,0.5215311004784688,-107,-109,0.49703861596542265,0.5029613840345774,home,CLE,under,8.5,0.5391705069124424,-117,0.5162347091419897,CLE,STL,2023 REG,8,1,2,2,3,10,0,1,-1,1,1,0,0,0,0,0,0,0,0,0.4837652908580103,0.5162347091419897
89945,0.49504950495049505,0.5495495495495495,102,-122,0.47297076509898783,0.5270292349010122,away,CHC,over,8.5,0.5412844036697247,-118,0.5162581740877563,MIL,CHC,2023 REG,12,6,13,10,16,25,0,1,-4,4,1,1,1,1,1,1,0,0,0,0.5162581740877563,0.4837418259122437
89945,0.49504950495049505,0.5495495495495495,102,-122,0.47297076509898783,0.5270292349010122,home,MIL,under,8.5,0.504950495049505,-102,0.4837418259122437,MIL,CHC,2023 REG,12,6,13,10,16,25,0,1,-4,4,1,1,1,1,1,1,0,0,0,0.5162581740877563,0.4837418259122437
89946,0.6000000000000001,0.44052863436123346,-150,127,0.57568281938326,0.42431718061673995,away,MIN,over,9,0.5145631067961165,-106,0.49023796582517226,ATL,MIN,2023 REG,10,6,7,2,8,17,1,0,4,-4,1,1,0,0,0,0,0,0,0,0.49023796582517226,0.5097620341748277
89946,0.6000000000000001,0.44052863436123346,-150,127,0.57568281938326,0.42431718061673995,home,ATL,under,9,0.5327102803738317,-114,0.5097620341748277,ATL,MIN,2023 REG,10,6,7,2,8,17,1,0,4,-4,1,1,0,0,0,0,0,0,0,0.49023796582517226,0.5097620341748277
89947,0.29239766081871343,0.7468354430379747,242,-295,0.2809259930243602,0.7190740069756398,away,ATL,over,9.5,0.5121951219512195,-105,0.48808156828023186,PIT,ATL,2023 REG,10,5,15,6,11,25,0,1,-1,1,1,1,1,1,1,0,0,0,0,0.48808156828023186,0.5119184317197681
89947,0.29239766081871343,0.7468354430379747,242,-295,0.2809259930243602,0.7190740069756398,home,PIT,under,9.5,0.5348837209302326,-115,0.5119184317197681,PIT,ATL,2023 REG,10,5,15,6,11,25,0,1,-1,1,1,1,1,1,1,0,0,0,0,0.48808156828023186,0.5119184317197681
89948,0.5121951219512195,0.5283018867924528,-105,-112,0.49145275161909474,0.5085472483809053,away,CLE,over,7.5,0.5192307692307692,-108,0.49571111079951763,CWS,CLE,2023 REG,8,3,13,6,9,21,0,1,-3,3,1,1,1,0,0,0,0,0,0,0.49571111079951763,0.5042888892004824
89948,0.5121951219512195,0.5283018867924528,-105,-112,0.49145275161909474,0.5085472483809053,home,CWS,under,7.5,0.5260663507109005,-111,0.5042888892004824,CWS,CLE,2023 REG,8,3,13,6,9,21,0,1,-3,3,1,1,1,0,0,0,0,0,0,0.49571111079951763,0.5042888892004824
89949,0.6428571428571428,0.3921568627450981,-180,155,0.6203481392557023,0.3796518607442977,away,TB,over,8.5,0.5495495495495495,-122,0.5250401592387142,NYY,TB,2023 REG,9,6,13,5,11,22,1,0,1,-1,1,1,1,1,1,0,0,0,0,0.5250401592387142,0.47495984076128583
89949,0.6428571428571428,0.3921568627450981,-180,155,0.6203481392557023,0.3796518607442977,home,NYY,under,8.5,0.49504950495049505,102,0.47495984076128583,NYY,TB,2023 REG,9,6,13,5,11,22,1,0,1,-1,1,1,1,1,1,0,0,0,0,0.5250401592387142,0.47495984076128583
89950,0.6363636363636364,0.4065040650406504,-175,146,0.6090841900154538,0.3909158099845462,away,BAL,over,7.5,0.5238095238095238,-110,0.5000596729920038,TB,BAL,2023 REG,9,6,10,8,14,19,0,1,-2,2,1,1,1,1,1,1,0,0,0,0.5000596729920038,0.4999403270079962
89950,0.6363636363636364,0.4065040650406504,-175,146,0.6090841900154538,0.3909158099845462,home,TB,under,7.5,0.5215311004784688,-109,0.4999403270079962,TB,BAL,2023 REG,9,6,10,8,14,19,0,1,-2,2,1,1,1,1,1,1,0,0,0,0.5000596729920038,0.4999403270079962
89951,0.47619047619047616,0.5555555555555556,110,-125,0.46107331821617537,0.5389266817838246,away,MIN,over,8,0.5283018867924528,-112,0.5031902949311281,MIA,MIN,2023 REG,12,1,10,11,12,22,0,1,-10,10,1,0,0,0,0,0,0,0,0,0.5031902949311281,0.4968097050688719
89951,0.47619047619047616,0.5555555555555556,110,-125,0.46107331821617537,0.5389266817838246,home,MIA,under,8,0.5192307692307692,-108,0.4968097050688719,MIA,MIN,2023 REG,12,1,10,11,12,22,0,1,-10,10,1,0,0,0,0,0,0,0,0,0.5031902949311281,0.4968097050688719
89952,0.6894409937888198,0.35460992907801414,-222,182,0.6590704817501952,0.3409295182498048,away,OAK,over,9.5,0.5121951219512195,-105,0.48808156828023186,STL,OAK,2023 REG,14,6,6,2,8,20,1,0,4,-4,1,1,0,0,0,0,0,0,0,0.48808156828023186,0.5119184317197681
89952,0.6894409937888198,0.35460992907801414,-222,182,0.6590704817501952,0.3409295182498048,home,STL,under,9.5,0.5348837209302326,-115,0.5119184317197681,STL,OAK,2023 REG,14,6,6,2,8,20,1,0,4,-4,1,1,0,0,0,0,0,0,0,0.48808156828023186,0.5119184317197681
89953,0.425531914893617,0.6108949416342413,135,-157,0.41003112488176247,0.5899688751182375,away,SEA,over,10.5,0.5121951219512195,-105,0.48808156828023186,BOS,SEA,2023 REG,11,9,8,4,13,19,1,0,5,-5,1,1,1,1,0,0,0,0,0,0.48808156828023186,0.5119184317197681
89953,0.425531914893617,0.6108949416342413,135,-157,0.41003112488176247,0.5899688751182375,home,BOS,under,10.5,0.5348837209302326,-115,0.5119184317197681,BOS,SEA,2023 REG,11,9,8,4,13,19,1,0,5,-5,1,1,1,1,0,0,0,0,0,0.48808156828023186,0.5119184317197681
89954,0.4184100418410042,0.6183206106870228,139,-162,0.40304156797990504,0.5969584320200949,away,TEX,over,8,0.5260663507109005,-111,0.5010269332605688,PIT,TEX,2023 REG,6,1,9,6,7,15,0,1,-5,5,1,0,0,0,0,0,0,0,0,0.5010269332605688,0.4989730667394312
89954,0.4184100418410042,0.6183206106870228,139,-162,0.40304156797990504,0.5969584320200949,home,PIT,under,8,0.5215311004784688,-109,0.4989730667394312,PIT,TEX,2023 REG,6,1,9,6,7,15,0,1,-5,5,1,0,0,0,0,0,0,0,0,0.5010269332605688,0.4989730667394312
89955,0.6000000000000001,0.4347826086956522,-150,130,0.5791304347826086,0.4208695652173914,away,NYY,over,8.5,0.5169082125603864,-107,0.49239402434819424,BAL,NYY,2023 REG,12,9,9,3,12,21,1,0,6,-6,1,1,1,0,0,0,0,0,0,0.49239402434819424,0.5076059756518058
89955,0.6000000000000001,0.4347826086956522,-150,130,0.5791304347826086,0.4208695652173914,home,BAL,under,8.5,0.5305164319248826,-113,0.5076059756518058,BAL,NYY,2023 REG,12,9,9,3,12,21,1,0,6,-6,1,1,1,0,0,0,0,0,0,0.49239402434819424,0.5076059756518058
89956,0.6794871794871794,0.36101083032490977,-212,177,0.6519693010251187,0.34803069897488126,away,MIA,over,7.5,0.5,100,0.4762443438914027,TB,MIA,2023 REG,9,4,2,1,5,11,1,0,3,-3,1,0,0,0,0,0,0,0,0,0.4762443438914027,0.5237556561085973
89956,0.6794871794871794,0.36101083032490977,-212,177,0.6519693010251187,0.34803069897488126,home,TB,under,7.5,0.5475113122171946,-121,0.5237556561085973,TB,MIA,2023 REG,9,4,2,1,5,11,1,0,3,-3,1,0,0,0,0,0,0,0,0,0.4762443438914027,0.5237556561085973
89957,0.6376811594202898,0.4,-176,150,0.6136525939928585,0.38634740600714146,away,WSH,over,8.5,0.5121951219512195,-105,0.48808156828023186,NYY,WSH,2023 REG,2,1,7,2,3,9,0,1,-1,1,1,0,0,0,0,0,0,0,0,0.48808156828023186,0.5119184317197681
89957,0.6376811594202898,0.4,-176,150,0.6136525939928585,0.38634740600714146,home,NYY,under,8.5,0.5348837209302326,-115,0.5119184317197681,NYY,WSH,2023 REG,2,1,7,2,3,9,0,1,-1,1,1,0,0,0,0,0,0,0,0,0.48808156828023186,0.5119184317197681
89958,0.5,0.5412844036697247,100,-118,0.47935779816513757,0.5206422018348624,away,TEX,over,9,0.5238095238095238,-110,0.4988662131519274,PIT,TEX,2023 REG,8,2,8,3,5,16,0,1,-1,1,1,1,0,0,0,0,0,0,0,0.4988662131519274,0.5011337868480725
89958,0.5,0.5412844036697247,100,-118,0.47935779816513757,0.5206422018348624,home,PIT,under,9,0.5238095238095238,-110,0.5011337868480725,PIT,TEX,2023 REG,8,2,8,3,5,16,0,1,-1,1,1,1,0,0,0,0,0,0,0,0.4988662131519274,0.5011337868480725
89959,0.35714285714285715,0.6875,180,-220,0.3411989795918367,0.6588010204081634,away,NYM,over,11.5,0.5121951219512195,-105,0.48919479393107135,COL,NYM,2023 REG,8,2,7,5,7,15,0,1,-3,3,1,1,0,0,0,0,0,0,0,0.48919479393107135,0.5108052060689287
89959,0.35714285714285715,0.6875,180,-220,0.3411989795918367,0.6588010204081634,home,COL,under,11.5,0.5327102803738317,-114,0.5108052060689287,COL,NYM,2023 REG,8,2,7,5,7,15,0,1,-3,3,1,1,0,0,0,0,0,0,0,0.48919479393107135,0.5108052060689287
89960,0.5412844036697247,0.5024875621890548,-118,-101,0.5175913212324037,0.4824086787675963,away,TB,over,8.5,0.49504950495049505,102,0.4719707862985384,SF,TB,2023 REG,8,1,14,6,7,22,0,1,-5,5,1,0,0,0,0,0,0,0,0,0.4719707862985384,0.5280292137014616
89960,0.5412844036697247,0.5024875621890548,-118,-101,0.5175913212324037,0.4824086787675963,home,SF,under,8.5,0.5515695067264574,-123,0.5280292137014616,SF,TB,2023 REG,8,1,14,6,7,22,0,1,-5,5,1,0,0,0,0,0,0,0,0,0.4719707862985384,0.5280292137014616
89961,0.5652173913043479,0.47619047619047616,-130,110,0.5418129444594474,0.4581870555405526,away,SD,over,11,0.5,100,0.4772727272727273,CIN,SD,2023 REG,5,4,7,3,7,12,1,0,1,-1,1,1,1,0,0,0,0,0,0,0.4772727272727273,0.5227272727272727
89961,0.5652173913043479,0.47619047619047616,-130,110,0.5418129444594474,0.4581870555405526,home,CIN,under,11,0.5454545454545454,-120,0.5227272727272727,CIN,SD,2023 REG,5,4,7,3,7,12,1,0,1,-1,1,1,1,0,0,0,0,0,0,0.4772727272727273,0.5227272727272727
89962,0.5535714285714286,0.48780487804878053,-124,105,0.53066668740667,0.46933331259333,away,TB,over,9.5,0.5391705069124424,-117,0.5140669063204599,TOR,TB,2023 REG,7,5,8,2,7,15,1,0,3,-3,1,1,0,0,0,0,0,0,0,0.5140669063204599,0.4859330936795401
89962,0.5535714285714286,0.48780487804878053,-124,105,0.53066668740667,0.46933331259333,home,TOR,under,9.5,0.5073891625615764,-103,0.4859330936795401,TOR,TB,2023 REG,7,5,8,2,7,15,1,0,3,-3,1,1,0,0,0,0,0,0,0,0.5140669063204599,0.4859330936795401
89963,0.5073891625615764,0.5327102803738317,-103,-114,0.487043139791394,0.512956860208606,away,CIN,over,9,0.5192307692307692,-108,0.49688292476754015,OAK,CIN,2023 REG,11,7,16,11,18,27,0,1,-4,4,1,1,1,1,1,1,1,0,0,0.49688292476754015,0.5031170752324599
89963,0.5073891625615764,0.5327102803738317,-103,-114,0.487043139791394,0.512956860208606,home,OAK,under,9,0.5238095238095238,-110,0.5031170752324599,OAK,CIN,2023 REG,11,7,16,11,18,27,0,1,-4,4,1,1,1,1,1,1,1,0,0,0.49688292476754015,0.5031170752324599
89964,0.5633187772925764,0.47619047619047616,-129,110,0.5410624729287608,0.45893752707123925,away,STL,over,8,0.5121951219512195,-105,0.48808156828023186,MIA,STL,2023 REG,9,0,7,3,3,16,0,1,-3,3,0,0,0,0,0,0,0,0,0,0.48808156828023186,0.5119184317197681
89964,0.5633187772925764,0.47619047619047616,-129,110,0.5410624729287608,0.45893752707123925,home,MIA,under,8,0.5348837209302326,-115,0.5119184317197681,MIA,STL,2023 REG,9,0,7,3,3,16,0,1,-3,3,0,0,0,0,0,0,0,0,0,0.48808156828023186,0.5119184317197681
89965,0.5475113122171946,0.49019607843137253,-121,104,0.5268660892829112,0.47313391071708877,away,DET,over,9,0.5098039215686274,-104,0.48592421718142587,PIT,DET,2023 REG,8,4,6,1,5,14,1,0,3,-3,1,0,0,0,0,0,0,0,0,0.48592421718142587,0.5140757828185741
89965,0.5475113122171946,0.49019607843137253,-121,104,0.5268660892829112,0.47313391071708877,home,PIT,under,9,0.5370370370370371,-116,0.5140757828185741,PIT,DET,2023 REG,8,4,6,1,5,14,1,0,3,-3,1,0,0,0,0,0,0,0,0,0.48592421718142587,0.5140757828185741
89966,0.5884773662551441,0.4504504504504505,-143,122,0.5655692272061728,0.43443077279382725,away,BAL,over,8,0.5121951219512195,-105,0.48919479393107135,TB,BAL,2023 REG,10,7,4,2,9,14,1,0,5,-5,1,1,0,0,0,0,0,0,0,0.48919479393107135,0.5108052060689287
89966,0.5884773662551441,0.4504504504504505,-143,122,0.5655692272061728,0.43443077279382725,home,TB,under,8,0.5327102803738317,-114,0.5108052060689287,TB,BAL,2023 REG,10,7,4,2,9,14,1,0,5,-5,1,1,0,0,0,0,0,0,0,0.48919479393107135,0.5108052060689287
89967,0.4016064257028112,0.6402877697841727,149,-178,0.3847814475955888,0.6152185524044111,away,CHC,over,11.5,0.5,100,0.4772727272727273,COL,CHC,2023 REG,7,4,12,5,9,19,0,1,-1,1,1,1,1,1,0,0,0,0,0,0.4772727272727273,0.5227272727272727
89967,0.4016064257028112,0.6402877697841727,149,-178,0.3847814475955888,0.6152185524044111,home,COL,under,11.5,0.5454545454545454,-120,0.5227272727272727,COL,CHC,2023 REG,7,4,12,5,9,19,0,1,-1,1,1,1,1,1,0,0,0,0,0,0.4772727272727273,0.5227272727272727
89968,0.6389891696750902,0.4,-177,150,0.614075512518083,0.385924487481917,away,OAK,over,9,0.5,100,0.4772727272727273,DET,OAK,2023 REG,13,9,4,0,9,17,1,0,9,-9,0,0,0,0,0,0,0,0,0,0.4772727272727273,0.5227272727272727
89968,0.6389891696750902,0.4,-177,150,0.614075512518083,0.385924487481917,home,DET,under,9,0.5454545454545454,-120,0.5227272727272727,DET,OAK,2023 REG,13,9,4,0,9,17,1,0,9,-9,0,0,0,0,0,0,0,0,0,0.4772727272727273,0.5227272727272727
89969,0.46511627906976744,0.576271186440678,115,-136,0.44586629511142073,0.5541337048885793,away,SF,over,9,0.5370370370370371,-116,0.5118817074154765,MIL,SF,2023 REG,4,0,11,5,5,15,0,1,-5,5,0,0,0,0,0,0,0,0,0,0.5118817074154765,0.48811829258452355
89969,0.46511627906976744,0.576271186440678,115,-136,0.44586629511142073,0.5541337048885793,home,MIL,under,9,0.5098039215686274,-104,0.48811829258452355,MIL,SF,2023 REG,4,0,11,5,5,15,0,1,-5,5,0,0,0,0,0,0,0,0,0,0.5118817074154765,0.48811829258452355
89970,0.5283018867924528,0.5098039215686274,-112,-104,0.5081705163375425,0.4918294836624575,away,NYY,over,7,0.5555555555555556,-125,0.5314664257753688,NYM,NYY,2023 REG,8,4,6,3,7,14,1,0,1,-1,1,1,1,0,0,0,0,0,0,0.5314664257753688,0.46853357422463116
89970,0.5283018867924528,0.5098039215686274,-112,-104,0.5081705163375425,0.4918294836624575,home,NYM,under,7,0.48780487804878053,105,0.46853357422463116,NYM,NYY,2023 REG,8,4,6,3,7,14,1,0,1,-1,1,1,1,0,0,0,0,0,0,0.5314664257753688,0.46853357422463116
89971,0.7402597402597403,0.303951367781155,-285,229,0.7075320369047918,0.29246796309520817,away,OAK,over,7.5,0.5121951219512195,-105,0.48808156828023186,MIN,OAK,2023 REG,13,6,9,4,10,22,1,0,2,-2,1,1,1,1,0,0,0,0,0,0.48808156828023186,0.5119184317197681
89971,0.7402597402597403,0.303951367781155,-285,229,0.7075320369047918,0.29246796309520817,home,MIN,under,7.5,0.5348837209302326,-115,0.5119184317197681,MIN,OAK,2023 REG,13,6,9,4,10,22,1,0,2,-2,1,1,1,1,0,0,0,0,0,0.48808156828023186,0.5119184317197681
89972,0.609375,0.4329004329004329,-156,131,0.5836134080762987,0.4163865919237013,away,PIT,over,9.5,0.5283018867924528,-112,0.5044173060022736,CIN,PIT,2023 REG,7,5,8,7,12,15,0,1,-2,2,1,1,1,1,1,0,0,0,0,0.5044173060022736,0.49558269399772636
89972,0.609375,0.4329004329004329,-156,131,0.5836134080762987,0.4163865919237013,home,CIN,under,9.5,0.5169082125603864,-107,0.49558269399772636,CIN,PIT,2023 REG,7,5,8,7,12,15,0,1,-2,2,1,1,1,1,1,0,0,0,0,0.5044173060022736,0.49558269399772636
89973,0.4098360655737705,0.6309963099630996,144,-171,0.393101485435709,0.606898514564291,away,BOS,over,9.5,0.5073891625615764,-103,0.4826927225525911,WSH,BOS,2023 REG,6,4,7,5,9,13,0,1,-1,1,1,1,1,1,0,0,0,0,0,0.4826927225525911,0.5173072774474089
89973,0.4098360655737705,0.6309963099630996,144,-171,0.393101485435709,0.606898514564291,home,WSH,under,9.5,0.5412844036697247,-118,0.5173072774474089,WSH,BOS,2023 REG,6,4,7,5,9,13,0,1,-1,1,1,1,1,1,0,0,0,0,0,0.4826927225525911,0.5173072774474089
89974,0.7142857142857143,0.3278688524590164,-250,205,0.6841753094680495,0.3158246905319505,away,DET,over,8,0.5283018867924528,-112,0.5044173060022736,HOU,DET,2023 REG,9,6,9,7,13,18,0,1,-1,1,1,1,1,1,1,1,0,0,0,0.5044173060022736,0.49558269399772636
89974,0.7142857142857143,0.3278688524590164,-250,205,0.6841753094680495,0.3158246905319505,home,HOU,under,8,0.5169082125603864,-107,0.49558269399772636,HOU,DET,2023 REG,9,6,9,7,13,18,0,1,-1,1,1,1,1,1,1,1,0,0,0,0.5044173060022736,0.49558269399772636
89975,0.5726495726495727,0.4694835680751174,-134,113,0.5485220476191947,0.45147795238080535,away,CIN,over,9,0.5098039215686274,-104,0.48483656587239576,ARI,CIN,2023 REG,10,10,8,8,18,18,1,0,2,-2,1,1,1,1,1,1,1,1,0,0.48483656587239576,0.5151634341276042
89975,0.5726495726495727,0.4694835680751174,-134,113,0.5485220476191947,0.45147795238080535,home,ARI,under,9,0.5391705069124424,-117,0.5151634341276042,ARI,CIN,2023 REG,10,10,8,8,18,18,1,0,2,-2,1,1,1,1,1,1,1,1,0,0.48483656587239576,0.5151634341276042
89976,0.49504950495049505,0.5475113122171946,102,-121,0.4739797934813417,0.5260202065186583,away,NYM,over,9.5,0.5073891625615764,-103,0.4826927225525911,PHI,NYM,2023 REG,9,2,9,4,6,18,0,1,-2,2,1,1,0,0,0,0,0,0,0,0.4826927225525911,0.5173072774474089
89976,0.49504950495049505,0.5475113122171946,102,-121,0.4739797934813417,0.5260202065186583,home,PHI,under,9.5,0.5412844036697247,-118,0.5173072774474089,PHI,NYM,2023 REG,9,2,9,4,6,18,0,1,-2,2,1,1,0,0,0,0,0,0,0,0.4826927225525911,0.5173072774474089
89977,0.4587155963302753,0.5833333333333333,118,-140,0.4394270964845833,0.5605729035154168,away,LAD,over,9,0.5192307692307692,-108,0.49455035168025013,CLE,LAD,2023 REG,10,3,15,9,12,25,0,1,-6,6,1,1,1,0,0,0,0,0,0,0.49455035168025013,0.5054496483197499
89977,0.4587155963302753,0.5833333333333333,118,-140,0.4394270964845833,0.5605729035154168,home,CLE,under,9,0.5283018867924528,-112,0.5054496483197499,CLE,LAD,2023 REG,10,3,15,9,12,25,0,1,-6,6,1,1,1,0,0,0,0,0,0,0.49455035168025013,0.5054496483197499
89978,0.49019607843137253,0.5495495495495495,104,-122,0.4707129274603323,0.5292870725396677,away,PHI,over,7.5,0.5391705069124424,-117,0.5140669063204599,TEX,PHI,2023 REG,17,16,9,3,19,26,1,0,13,-13,1,1,1,0,0,0,0,0,0,0.5140669063204599,0.4859330936795401
89978,0.49019607843137253,0.5495495495495495,104,-122,0.4707129274603323,0.5292870725396677,home,TEX,under,7.5,0.5073891625615764,-103,0.4859330936795401,TEX,PHI,2023 REG,17,16,9,3,19,26,1,0,13,-13,1,1,1,0,0,0,0,0,0,0.5140669063204599,0.4859330936795401
89979,0.6363636363636364,0.4,-175,150,0.6132231404958678,0.3867768595041322,away,PHI,over,7.5,0.5348837209302326,-115,0.5097020142727117,NYY,PHI,2023 REG,9,8,11,1,9,20,1,0,7,-7,1,0,0,0,0,0,0,0,0,0.5097020142727117,0.49029798572728833
89979,0.6363636363636364,0.4,-175,150,0.6132231404958678,0.3867768595041322,home,NYY,under,7.5,0.5121951219512195,-105,0.49029798572728833,NYY,PHI,2023 REG,9,8,11,1,9,20,1,0,7,-7,1,0,0,0,0,0,0,0,0,0.5097020142727117,0.49029798572728833
89980,0.4739336492890995,0.5670995670995671,111,-131,0.4544866273039494,0.5455133726960506,away,DET,over,8.5,0.5348837209302326,-115,0.5097020142727117,OAK,DET,2023 REG,6,4,6,1,5,12,1,0,3,-3,1,0,0,0,0,0,0,0,0,0.5097020142727117,0.49029798572728833
89980,0.4739336492890995,0.5670995670995671,111,-131,0.4544866273039494,0.5455133726960506,home,OAK,under,8.5,0.5121951219512195,-105,0.49029798572728833,OAK,DET,2023 REG,6,4,6,1,5,12,1,0,3,-3,1,0,0,0,0,0,0,0,0,0.5097020142727117,0.49029798572728833
89981,0.5535714285714286,0.48780487804878053,-124,105,0.53066668740667,0.46933331259333,away,CWS,over,8.5,0.5,100,0.4772727272727273,LAA,CWS,2023 REG,5,2,3,1,3,8,1,0,1,-1,1,0,0,0,0,0,0,0,0,0.4772727272727273,0.5227272727272727
89981,0.5535714285714286,0.48780487804878053,-124,105,0.53066668740667,0.46933331259333,home,LAA,under,8.5,0.5454545454545454,-120,0.5227272727272727,LAA,CWS,2023 REG,5,2,3,1,3,8,1,0,1,-1,1,0,0,0,0,0,0,0,0,0.4772727272727273,0.5227272727272727
89982,0.5305164319248826,0.5121951219512195,-113,-105,0.5078572507605655,0.49214274923943446,away,TOR,over,8,0.5121951219512195,-105,0.48919479393107135,BAL,TOR,2023 REG,9,3,12,6,9,21,0,1,-3,3,1,1,1,0,0,0,0,0,0,0.48919479393107135,0.5108052060689287
89982,0.5305164319248826,0.5121951219512195,-113,-105,0.5078572507605655,0.49214274923943446,home,BAL,under,8,0.5327102803738317,-114,0.5108052060689287,BAL,TOR,2023 REG,9,3,12,6,9,21,0,1,-3,3,1,1,1,0,0,0,0,0,0,0.48919479393107135,0.5108052060689287
89983,0.6923076923076923,0.3448275862068966,-225,190,0.6665986533360538,0.33340134666394616,away,WSH,over,8.5,0.5348837209302326,-115,0.5109810284308424,SF,WSH,2023 REG,6,1,11,5,6,17,0,1,-4,4,1,0,0,0,0,0,0,0,0,0.5109810284308424,0.48901897156915763
89983,0.6923076923076923,0.3448275862068966,-225,190,0.6665986533360538,0.33340134666394616,home,SF,under,8.5,0.5098039215686274,-104,0.48901897156915763,SF,WSH,2023 REG,6,1,11,5,6,17,0,1,-4,4,1,0,0,0,0,0,0,0,0,0.5109810284308424,0.48901897156915763
89984,0.4347826086956522,0.607843137254902,130,-155,0.41624967567367205,0.583750324326328,away,CLE,over,7.5,0.5370370370370371,-116,0.5118817074154765,OAK,CLE,2023 REG,14,11,16,12,23,30,0,1,-1,1,1,1,1,1,1,1,1,1,1,0.5118817074154765,0.48811829258452355
89984,0.4347826086956522,0.607843137254902,130,-155,0.41624967567367205,0.583750324326328,home,OAK,under,7.5,0.5098039215686274,-104,0.48811829258452355,OAK,CLE,2023 REG,14,11,16,12,23,30,0,1,-1,1,1,1,1,1,1,1,1,1,1,0.5118817074154765,0.48811829258452355
89985,0.5327102803738317,0.504950495049505,-114,-102,0.5126479981389701,0.4873520018610299,away,CLE,over,8,0.5238095238095238,-110,0.4988662131519274,SEA,CLE,2023 REG,9,5,9,6,11,18,0,1,-1,1,1,1,1,1,1,0,0,0,0,0.4988662131519274,0.5011337868480725
89985,0.5327102803738317,0.504950495049505,-114,-102,0.5126479981389701,0.4873520018610299,home,SEA,under,8,0.5238095238095238,-110,0.5011337868480725,SEA,CLE,2023 REG,9,5,9,6,11,18,0,1,-1,1,1,1,1,1,1,0,0,0,0,0.4988662131519274,0.5011337868480725
89986,0.6923076923076923,0.35714285714285715,-225,180,0.658072696534235,0.34192730346576505,away,COL,over,8.5,0.5327102803738317,-114,0.508788710910954,LAD,COL,2023 REG,13,13,6,4,17,19,1,0,9,-9,1,1,1,1,0,0,0,0,0,0.508788710910954,0.491211289089046
89986,0.6923076923076923,0.35714285714285715,-225,180,0.658072696534235,0.34192730346576505,home,LAD,under,8.5,0.5121951219512195,-105,0.491211289089046,LAD,COL,2023 REG,13,13,6,4,17,19,1,0,9,-9,1,1,1,1,0,0,0,0,0,0.508788710910954,0.491211289089046
89987,0.7198879551820728,0.3205128205128205,-257,212,0.6908039233793066,0.30919607662069337,away,COL,over,9,0.5391705069124424,-117,0.5153817639191344,ATL,COL,2023 REG,11,8,7,3,11,18,1,0,5,-5,1,1,1,0,0,0,0,0,0,0.5153817639191344,0.4846182360808656
89987,0.7198879551820728,0.3205128205128205,-257,212,0.6908039233793066,0.30919607662069337,home,ATL,under,9,0.504950495049505,-102,0.4846182360808656,ATL,COL,2023 REG,11,8,7,3,11,18,1,0,5,-5,1,1,1,0,0,0,0,0,0,0.5153817639191344,0.4846182360808656
89988,0.5652173913043479,0.4716981132075471,-130,112,0.5443521061454507,0.4556478938545493,away,TB,over,8,0.5192307692307692,-108,0.49455035168025013,ARI,TB,2023 REG,10,8,6,4,12,16,1,0,4,-4,1,1,1,1,0,0,0,0,0,0.49455035168025013,0.5054496483197499
89988,0.5652173913043479,0.4716981132075471,-130,112,0.5443521061454507,0.4556478938545493,home,ARI,under,8,0.5283018867924528,-112,0.5054496483197499,ARI,TB,2023 REG,10,8,6,4,12,16,1,0,4,-4,1,1,1,1,0,0,0,0,0,0.49455035168025013,0.5054496483197499
89989,0.42016806722689076,0.6226415094339623,138,-165,0.40218085014249866,0.5978191498575014,away,NYY,over,7.5,0.5348837209302326,-115,0.5109810284308424,PIT,NYY,2023 REG,9,5,11,7,12,20,0,1,-2,2,1,1,1,1,1,0,0,0,0,0.5109810284308424,0.48901897156915763
89989,0.42016806722689076,0.6226415094339623,138,-165,0.40218085014249866,0.5978191498575014,home,PIT,under,7.5,0.5098039215686274,-104,0.48901897156915763,PIT,NYY,2023 REG,9,5,11,7,12,20,0,1,-2,2,1,1,1,1,1,0,0,0,0,0.5109810284308424,0.48901897156915763
89991,0.5238095238095238,0.5169082125603864,-110,-107,0.5024811857109994,0.4975188142890006,away,DET,over,8.5,0.5348837209302326,-115,0.5097020142727117,CWS,DET,2023 REG,4,0,18,10,10,22,0,1,-10,10,0,0,0,0,0,0,0,0,0,0.5097020142727117,0.49029798572728833
89991,0.5238095238095238,0.5169082125603864,-110,-107,0.5024811857109994,0.4975188142890006,home,CWS,under,8.5,0.5121951219512195,-105,0.49029798572728833,CWS,DET,2023 REG,4,0,18,10,10,22,0,1,-10,10,0,0,0,0,0,0,0,0,0,0.5097020142727117,0.49029798572728833
89992,0.5305164319248826,0.5098039215686274,-113,-104,0.5091258218555558,0.49087417814444423,away,CIN,over,9,0.5073891625615764,-103,0.4837652908580103,PIT,CIN,2023 REG,6,2,11,9,11,17,0,1,-7,7,1,1,0,0,0,0,0,0,0,0.4837652908580103,0.5162347091419897
89992,0.5305164319248826,0.5098039215686274,-113,-104,0.5091258218555558,0.49087417814444423,home,PIT,under,9,0.5391705069124424,-117,0.5162347091419897,PIT,CIN,2023 REG,6,2,11,9,11,17,0,1,-7,7,1,1,0,0,0,0,0,0,0,0.4837652908580103,0.5162347091419897
89993,0.46511627906976744,0.5726495726495727,115,-134,0.4475507666421673,0.5524492333578327,away,ATL,over,12,0.5391705069124424,-117,0.5127649394825569,CIN,ATL,2023 REG,10,6,14,7,13,24,0,1,-1,1,1,1,1,1,1,1,0,0,0,0.5127649394825569,0.48723506051744314
89993,0.46511627906976744,0.5726495726495727,115,-134,0.4475507666421673,0.5524492333578327,home,CIN,under,12,0.5098039215686274,-104,0.48723506051744314,CIN,ATL,2023 REG,10,6,14,7,13,24,0,1,-1,1,1,1,1,1,1,1,0,0,0,0.5127649394825569,0.48723506051744314
89994,0.5348837209302326,0.5098039215686274,-115,-104,0.5109810284308424,0.48901897156915763,away,STL,over,9.5,0.5098039215686274,-104,0.48483656587239576,SF,STL,2023 REG,9,5,9,4,9,18,1,0,1,-1,1,1,1,1,0,0,0,0,0,0.48483656587239576,0.5151634341276042
89994,0.5348837209302326,0.5098039215686274,-115,-104,0.5109810284308424,0.48901897156915763,home,SF,under,9.5,0.5391705069124424,-117,0.5151634341276042,SF,STL,2023 REG,9,5,9,4,9,18,1,0,1,-1,1,1,1,1,0,0,0,0,0,0.48483656587239576,0.5151634341276042
89995,0.6875,0.35211267605633806,-220,184,0.6602662852112676,0.3397337147887324,away,COL,over,9.5,0.5,100,0.4772727272727273,HOU,COL,2023 REG,10,6,8,4,10,18,1,0,2,-2,1,1,1,1,0,0,0,0,0,0.4772727272727273,0.5227272727272727
89995,0.6875,0.35211267605633806,-220,184,0.6602662852112676,0.3397337147887324,home,HOU,under,9.5,0.5454545454545454,-120,0.5227272727272727,HOU,COL,2023 REG,10,6,8,4,10,18,1,0,2,-2,1,1,1,1,0,0,0,0,0,0.4772727272727273,0.5227272727272727
89996,0.6428571428571428,0.4,-180,150,0.6153061224489796,0.38469387755102036,away,TEX,over,8.5,0.5412844036697247,-118,0.5149381613977361,HOU,TEX,2023 REG,6,5,17,13,18,23,0,1,-8,8,1,1,1,1,1,0,0,0,0,0.5149381613977361,0.48506183860226393
89996,0.6428571428571428,0.4,-180,150,0.6153061224489796,0.38469387755102036,home,HOU,under,8.5,0.5073891625615764,-103,0.48506183860226393,HOU,TEX,2023 REG,6,5,17,13,18,23,0,1,-8,8,1,1,1,1,1,0,0,0,0,0.5149381613977361,0.48506183860226393
89997,0.5918367346938775,0.4444444444444444,-145,125,0.5703642001018094,0.42963579989819056,away,MIA,over,8.5,0.5327102803738317,-114,0.508788710910954,ARI,MIA,2023 REG,5,4,7,5,9,12,0,1,-1,1,1,1,1,1,0,0,0,0,0,0.508788710910954,0.491211289089046
89997,0.5918367346938775,0.4444444444444444,-145,125,0.5703642001018094,0.42963579989819056,home,ARI,under,8.5,0.5121951219512195,-105,0.491211289089046,ARI,MIA,2023 REG,5,4,7,5,9,12,0,1,-1,1,1,1,1,1,0,0,0,0,0,0.508788710910954,0.491211289089046
89998,0.6047430830039526,0.4347826086956522,-153,130,0.5808401943476698,0.41915980565233024,away,COL,over,9.5,0.5073891625615764,-103,0.4837652908580103,KC,COL,2023 REG,11,4,8,6,10,19,0,1,-2,2,1,1,1,1,0,0,0,0,0,0.4837652908580103,0.5162347091419897
89998,0.6047430830039526,0.4347826086956522,-153,130,0.5808401943476698,0.41915980565233024,home,KC,under,9.5,0.5391705069124424,-117,0.5162347091419897,KC,COL,2023 REG,11,4,8,6,10,19,0,1,-2,2,1,1,1,1,0,0,0,0,0,0.4837652908580103,0.5162347091419897
89999,0.7711670480549199,0.273972602739726,-337,265,0.7363568368013828,0.26364316319861725,away,STL,over,10.5,0.5098039215686274,-104,0.4870219861770517,ATL,STL,2023 REG,10,8,8,5,13,18,1,0,3,-3,1,1,1,1,1,0,0,0,0,0.4870219861770517,0.5129780138229483
89999,0.7711670480549199,0.273972602739726,-337,265,0.7363568368013828,0.26364316319861725,home,ATL,under,10.5,0.5348837209302326,-115,0.5129780138229483,ATL,STL,2023 REG,10,8,8,5,13,18,1,0,3,-3,1,1,1,1,1,0,0,0,0,0.4870219861770517,0.5129780138229483
90000,0.5,0.5454545454545454,100,-120,0.4772727272727273,0.5227272727272727,away,MIL,over,7,0.5098039215686274,-104,0.48592421718142587,CHC,MIL,2023 REG,3,3,5,2,5,8,1,0,1,-1,1,1,0,0,0,0,0,0,0,0.48592421718142587,0.5140757828185741
90000,0.5,0.5454545454545454,100,-120,0.4772727272727273,0.5227272727272727,home,CHC,under,7,0.5370370370370371,-116,0.5140757828185741,CHC,MIL,2023 REG,3,3,5,2,5,8,1,0,1,-1,1,1,0,0,0,0,0,0,0,0.48592421718142587,0.5140757828185741
90001,0.3389830508474576,0.7032640949554896,195,-237,0.3246619844735772,0.6753380155264228,away,SEA,over,9,0.5,100,0.4772727272727273,KC,SEA,2023 REG,9,4,11,6,10,20,0,1,-2,2,1,1,1,1,0,0,0,0,0,0.4772727272727273,0.5227272727272727
90001,0.3389830508474576,0.7032640949554896,195,-237,0.3246619844735772,0.6753380155264228,home,KC,under,9,0.5454545454545454,-120,0.5227272727272727,KC,SEA,2023 REG,9,4,11,6,10,20,0,1,-2,2,1,1,1,1,0,0,0,0,0,0.4772727272727273,0.5227272727272727
90002,0.6376811594202898,0.4,-176,150,0.6136525939928585,0.38634740600714146,away,PIT,over,8.5,0.5145631067961165,-106,0.49023796582517226,LAD,PIT,2023 REG,9,5,7,2,7,16,1,0,3,-3,1,1,0,0,0,0,0,0,0,0.49023796582517226,0.5097620341748277
90002,0.6376811594202898,0.4,-176,150,0.6136525939928585,0.38634740600714146,home,LAD,under,8.5,0.5327102803738317,-114,0.5097620341748277,LAD,PIT,2023 REG,9,5,7,2,7,16,1,0,3,-3,1,1,0,0,0,0,0,0,0,0.49023796582517226,0.5097620341748277
90003,0.7409326424870467,0.29850746268656714,-286,235,0.7117101811407941,0.2882898188592059,away,OAK,over,9,0.5348837209302326,-115,0.5097020142727117,TOR,OAK,2023 REG,11,12,3,1,13,14,1,0,11,-11,1,0,0,0,0,0,0,0,0,0.5097020142727117,0.49029798572728833
90003,0.7409326424870467,0.29850746268656714,-286,235,0.7117101811407941,0.2882898188592059,home,TOR,under,9,0.5121951219512195,-105,0.49029798572728833,TOR,OAK,2023 REG,11,12,3,1,13,14,1,0,11,-11,1,0,0,0,0,0,0,0,0,0.5097020142727117,0.49029798572728833
90004,0.6363636363636364,0.4098360655737705,-175,144,0.6069638260398319,0.3930361739601681,away,WSH,over,9.5,0.5348837209302326,-115,0.5097020142727117,NYM,WSH,2023 REG,10,6,12,11,17,22,0,1,-5,5,1,1,1,1,1,1,0,0,0,0.5097020142727117,0.49029798572728833
90004,0.6363636363636364,0.4098360655737705,-175,144,0.6069638260398319,0.3930361739601681,home,NYM,under,9.5,0.5121951219512195,-105,0.49029798572728833,NYM,WSH,2023 REG,10,6,12,11,17,22,0,1,-5,5,1,1,1,1,1,1,0,0,0,0.5097020142727117,0.49029798572728833
90005,0.5,0.5348837209302326,100,-115,0.4825581395348837,0.5174418604651163,away,TB,over,9.5,0.5121951219512195,-105,0.48808156828023186,BAL,TB,2023 REG,6,2,6,1,3,12,1,0,1,-1,1,0,0,0,0,0,0,0,0,0.48808156828023186,0.5119184317197681
90005,0.5,0.5348837209302326,100,-115,0.4825581395348837,0.5174418604651163,home,BAL,under,9.5,0.5348837209302326,-115,0.5119184317197681,BAL,TB,2023 REG,6,2,6,1,3,12,1,0,1,-1,1,0,0,0,0,0,0,0,0,0.48808156828023186,0.5119184317197681
90006,0.5708154506437768,0.46511627906976744,-133,115,0.5503050641549297,0.44969493584507025,away,CLE,over,7.5,0.5121951219512195,-105,0.48919479393107135,MIN,CLE,2023 REG,8,2,12,4,6,20,0,1,-2,2,1,1,0,0,0,0,0,0,0,0.48919479393107135,0.5108052060689287
90006,0.5708154506437768,0.46511627906976744,-133,115,0.5503050641549297,0.44969493584507025,home,MIN,under,7.5,0.5327102803738317,-114,0.5108052060689287,MIN,CLE,2023 REG,8,2,12,4,6,20,0,1,-2,2,1,1,0,0,0,0,0,0,0,0.48919479393107135,0.5108052060689287
90007,0.5633187772925764,0.47619047619047616,-129,110,0.5410624729287608,0.45893752707123925,away,ARI,over,8.5,0.5433789954337899,-119,0.5184560714286826,SF,ARI,2023 REG,2,1,6,0,1,8,1,0,1,-1,0,0,0,0,0,0,0,0,0,0.5184560714286826,0.48154392857131745
90007,0.5633187772925764,0.47619047619047616,-129,110,0.5410624729287608,0.45893752707123925,home,SF,under,8.5,0.5024875621890548,-101,0.48154392857131745,SF,ARI,2023 REG,2,1,6,0,1,8,1,0,1,-1,0,0,0,0,0,0,0,0,0,0.5184560714286826,0.48154392857131745
90008,0.607843137254902,0.425531914893617,-155,135,0.5875563408509002,0.41244365914909975,away,STL,over,9,0.5,100,0.4772727272727273,NYM,STL,2023 REG,9,3,8,5,8,17,0,1,-2,2,1,1,1,0,0,0,0,0,0,0.4772727272727273,0.5227272727272727
90008,0.607843137254902,0.425531914893617,-155,135,0.5875563408509002,0.41244365914909975,home,NYM,under,9,0.5454545454545454,-120,0.5227272727272727,NYM,STL,2023 REG,9,3,8,5,8,17,0,1,-2,2,1,1,1,0,0,0,0,0,0,0.4772727272727273,0.5227272727272727
90009,0.5867768595041323,0.45454545454545453,-142,120,0.5625298818386723,0.43747011816132775,away,CLE,over,7.5,0.5348837209302326,-115,0.5097020142727117,SF,CLE,2023 REG,12,6,12,5,11,24,1,0,1,-1,1,1,1,1,1,0,0,0,0,0.5097020142727117,0.49029798572728833
90009,0.5867768595041323,0.45454545454545453,-142,120,0.5625298818386723,0.43747011816132775,home,SF,under,7.5,0.5121951219512195,-105,0.49029798572728833,SF,CLE,2023 REG,12,6,12,5,11,24,1,0,1,-1,1,1,1,1,1,0,0,0,0,0.5097020142727117,0.49029798572728833
90010,0.5215311004784688,0.5215311004784688,-109,-109,0.49907282342437215,0.5009271765756278,away,MIL,over,8,0.5348837209302326,-115,0.5097020142727117,CLE,MIL,2023 REG,10,4,8,5,9,18,0,1,-1,1,1,1,1,1,0,0,0,0,0,0.5097020142727117,0.49029798572728833
90010,0.5215311004784688,0.5215311004784688,-109,-109,0.49907282342437215,0.5009271765756278,home,CLE,under,8,0.5121951219512195,-105,0.49029798572728833,CLE,MIL,2023 REG,10,4,8,5,9,18,0,1,-1,1,1,1,1,1,0,0,0,0,0,0.5097020142727117,0.49029798572728833
90011,0.5121951219512195,0.5348837209302326,-105,-115,0.48808156828023186,0.5119184317197681,away,SD,over,9,0.5454545454545454,-120,0.5206611570247933,ARI,SD,2023 REG,12,9,2,0,9,14,1,0,9,-9,0,0,0,0,0,0,0,0,0,0.5206611570247933,0.4793388429752067
90011,0.5121951219512195,0.5348837209302326,-105,-115,0.48808156828023186,0.5119184317197681,home,ARI,under,9,0.5,100,0.4793388429752067,ARI,SD,2023 REG,12,9,2,0,9,14,1,0,9,-9,0,0,0,0,0,0,0,0,0,0.5206611570247933,0.4793388429752067
90012,0.44052863436123346,0.6000000000000001,127,-150,0.42267461041355353,0.5773253895864465,away,STL,over,9.5,0.5433789954337899,-119,0.5184560714286826,WSH,STL,2023 REG,11,6,11,8,14,22,0,1,-2,2,1,1,1,1,1,1,0,0,0,0.5184560714286826,0.48154392857131745
90012,0.44052863436123346,0.6000000000000001,127,-150,0.42267461041355353,0.5773253895864465,home,WSH,under,9.5,0.5024875621890548,-101,0.48154392857131745,WSH,STL,2023 REG,11,6,11,8,14,22,0,1,-2,2,1,1,1,1,1,1,0,0,0,0.5184560714286826,0.48154392857131745
90013,0.613899613899614,0.425531914893617,-159,135,0.589692613597978,0.410307386402022,away,CIN,over,8.5,0.5073891625615764,-103,0.4826927225525911,LAA,CIN,2023 REG,10,4,9,9,13,19,0,1,-5,5,1,1,1,1,0,0,0,0,0,0.4826927225525911,0.5173072774474089
90013,0.613899613899614,0.425531914893617,-159,135,0.589692613597978,0.410307386402022,home,LAA,under,8.5,0.5412844036697247,-118,0.5173072774474089,LAA,CIN,2023 REG,10,4,9,9,13,19,0,1,-5,5,1,1,1,1,0,0,0,0,0,0.4826927225525911,0.5173072774474089
90014,0.7101449275362319,0.3389830508474576,-245,195,0.6752569428869452,0.32474305711305484,away,COL,over,9,0.5169082125603864,-107,0.49239402434819424,STL,COL,2023 REG,11,6,7,2,8,18,1,0,4,-4,1,1,0,0,0,0,0,0,0,0.49239402434819424,0.5076059756518058
90014,0.7101449275362319,0.3389830508474576,-245,195,0.6752569428869452,0.32474305711305484,home,STL,under,9,0.5305164319248826,-113,0.5076059756518058,STL,COL,2023 REG,11,6,7,2,8,18,1,0,4,-4,1,1,0,0,0,0,0,0,0,0.49239402434819424,0.5076059756518058
90015,0.48780487804878053,0.5495495495495495,105,-122,0.4695832060495952,0.5304167939504048,away,CHC,over,9,0.5098039215686274,-104,0.48592421718142587,DET,CHC,2023 REG,11,6,9,7,13,20,0,1,-1,1,1,1,1,1,1,1,0,0,0,0.48592421718142587,0.5140757828185741
90015,0.48780487804878053,0.5495495495495495,105,-122,0.4695832060495952,0.5304167939504048,home,DET,under,9,0.5370370370370371,-116,0.5140757828185741,DET,CHC,2023 REG,11,6,9,7,13,20,0,1,-1,1,1,1,1,1,1,1,0,0,0,0.48592421718142587,0.5140757828185741
90017,0.5850622406639003,0.4484304932735426,-141,123,0.5654669067005001,0.43453309329949985,away,STL,over,10.5,0.5192307692307692,-108,0.49455035168025013,LAD,STL,2023 REG,7,6,10,3,9,17,1,0,3,-3,1,1,1,0,0,0,0,0,0,0.49455035168025013,0.5054496483197499
90017,0.5850622406639003,0.4484304932735426,-141,123,0.5654669067005001,0.43453309329949985,home,LAD,under,10.5,0.5283018867924528,-112,0.5054496483197499,LAD,STL,2023 REG,7,6,10,3,9,17,1,0,3,-3,1,1,1,0,0,0,0,0,0,0.49455035168025013,0.5054496483197499
90018,0.5967741935483871,0.4444444444444444,-148,125,0.5721759741010521,0.42782402589894786,away,CIN,over,9,0.5,100,0.47935779816513757,LAA,CIN,2023 REG,6,3,12,7,10,18,0,1,-4,4,1,1,1,0,0,0,0,0,0,0.47935779816513757,0.5206422018348624
90018,0.5967741935483871,0.4444444444444444,-148,125,0.5721759741010521,0.42782402589894786,home,LAA,under,9,0.5412844036697247,-118,0.5206422018348624,LAA,CIN,2023 REG,6,3,12,7,10,18,0,1,-4,4,1,1,1,0,0,0,0,0,0,0.47935779816513757,0.5206422018348624
90019,0.41152263374485604,0.6240601503759399,143,-166,0.3968795127074915,0.6031204872925084,away,PHI,over,8.5,0.5260663507109005,-111,0.5010269332605688,PIT,PHI,2023 REG,5,1,7,2,3,12,0,1,-1,1,1,0,0,0,0,0,0,0,0,0.5010269332605688,0.4989730667394312
90019,0.41152263374485604,0.6240601503759399,143,-166,0.3968795127074915,0.6031204872925084,home,PIT,under,8.5,0.5215311004784688,-109,0.4989730667394312,PIT,PHI,2023 REG,5,1,7,2,3,12,0,1,-1,1,1,0,0,0,0,0,0,0,0,0.5010269332605688,0.4989730667394312
90020,0.5260663507109005,0.5169082125603864,-111,-107,0.5034588790373798,0.49654112096262015,away,NYY,over,8,0.5348837209302326,-115,0.5097020142727117,DET,NYY,2023 REG,7,2,6,4,6,13,0,1,-2,2,1,1,0,0,0,0,0,0,0,0.5097020142727117,0.49029798572728833
90020,0.5260663507109005,0.5169082125603864,-111,-107,0.5034588790373798,0.49654112096262015,home,DET,under,8,0.5121951219512195,-105,0.49029798572728833,DET,NYY,2023 REG,7,2,6,4,6,13,0,1,-2,2,1,1,0,0,0,0,0,0,0,0.5097020142727117,0.49029798572728833
90021,0.4329004329004329,0.6031746031746031,131,-152,0.41728353416665104,0.582716465833349,away,DET,over,8.5,0.5327102803738317,-114,0.5075272610403079,KC,DET,2023 REG,11,4,8,1,5,19,1,0,3,-3,1,0,0,0,0,0,0,0,0,0.5075272610403079,0.4924727389596921
90021,0.4329004329004329,0.6031746031746031,131,-152,0.41728353416665104,0.582716465833349,home,KC,under,8.5,0.5145631067961165,-106,0.4924727389596921,KC,DET,2023 REG,11,4,8,1,5,19,1,0,3,-3,1,0,0,0,0,0,0,0,0,0.5075272610403079,0.4924727389596921
90022,0.36363636363636365,0.6774193548387096,175,-210,0.3487070114636097,0.6512929885363903,away,PHI,over,9.5,0.5238095238095238,-110,0.4988662131519274,CIN,PHI,2023 REG,8,3,23,14,17,31,0,1,-11,11,1,1,1,0,0,0,0,0,0,0.4988662131519274,0.5011337868480725
90022,0.36363636363636365,0.6774193548387096,175,-210,0.3487070114636097,0.6512929885363903,home,CIN,under,9.5,0.5238095238095238,-110,0.5011337868480725,CIN,PHI,2023 REG,8,3,23,14,17,31,0,1,-11,11,1,1,1,0,0,0,0,0,0,0.4988662131519274,0.5011337868480725
90023,0.47619047619047616,0.5594713656387665,110,-127,0.4592086467479796,0.5407913532520203,away,CWS,over,8.5,0.5327102803738317,-114,0.5075272610403079,KC,CWS,2023 REG,14,12,8,5,17,22,1,0,7,-7,1,1,1,1,1,0,0,0,0,0.5075272610403079,0.4924727389596921
90023,0.47619047619047616,0.5594713656387665,110,-127,0.4592086467479796,0.5407913532520203,home,KC,under,8.5,0.5145631067961165,-106,0.4924727389596921,KC,CWS,2023 REG,14,12,8,5,17,22,1,0,7,-7,1,1,1,1,1,0,0,0,0,0.5075272610403079,0.4924727389596921
90024,0.5391705069124424,0.49504950495049505,-117,102,0.5207200857697526,0.4792799142302474,away,TB,over,8.5,0.5121951219512195,-105,0.48919479393107135,SD,TB,2023 REG,4,2,3,0,2,7,1,0,2,-2,0,0,0,0,0,0,0,0,0,0.48919479393107135,0.5108052060689287
90024,0.5391705069124424,0.49504950495049505,-117,102,0.5207200857697526,0.4792799142302474,home,SD,under,8.5,0.5327102803738317,-114,0.5108052060689287,SD,TB,2023 REG,4,2,3,0,2,7,1,0,2,-2,0,0,0,0,0,0,0,0,0,0.48919479393107135,0.5108052060689287
90025,0.5454545454545454,0.49019607843137253,-120,104,0.526008750607681,0.47399124939231896,away,TB,over,9,0.5169082125603864,-107,0.49353874091423283,BOS,TB,2023 REG,12,8,10,5,13,22,1,0,3,-3,1,1,1,1,1,0,0,0,0,0.49353874091423283,0.5064612590857671
90025,0.5454545454545454,0.49019607843137253,-120,104,0.526008750607681,0.47399124939231896,home,BOS,under,9,0.5283018867924528,-112,0.5064612590857671,BOS,TB,2023 REG,12,8,10,5,13,22,1,0,3,-3,1,1,1,1,1,0,0,0,0,0.49353874091423283,0.5064612590857671
90026,0.3921568627450981,0.6551724137931035,155,-190,0.37359636214188174,0.6264036378581183,away,MIL,over,8.5,0.5348837209302326,-115,0.5097020142727117,PIT,MIL,2023 REG,9,4,6,2,6,15,1,0,2,-2,1,1,0,0,0,0,0,0,0,0.5097020142727117,0.49029798572728833
90026,0.3921568627450981,0.6551724137931035,155,-190,0.37359636214188174,0.6264036378581183,home,PIT,under,8.5,0.5121951219512195,-105,0.49029798572728833,PIT,MIL,2023 REG,9,4,6,2,6,15,1,0,2,-2,1,1,0,0,0,0,0,0,0,0.5097020142727117,0.49029798572728833
90027,0.36363636363636365,0.6721311475409836,175,-205,0.3506299959355101,0.6493700040644899,away,TB,over,8.5,0.5327102803738317,-114,0.508788710910954,OAK,TB,2023 REG,5,3,10,4,7,15,0,1,-1,1,1,1,1,0,0,0,0,0,0,0.508788710910954,0.491211289089046
90027,0.36363636363636365,0.6721311475409836,175,-205,0.3506299959355101,0.6493700040644899,home,OAK,under,8.5,0.5121951219512195,-105,0.491211289089046,OAK,TB,2023 REG,5,3,10,4,7,15,0,1,-1,1,1,1,1,0,0,0,0,0,0,0.508788710910954,0.491211289089046
90028,0.5515695067264574,0.4926108374384236,-123,103,0.527200976088429,0.472799023911571,away,CIN,over,7.5,0.5,100,0.4762443438914027,MIL,CIN,2023 REG,14,7,4,3,10,18,1,0,4,-4,1,1,1,0,0,0,0,0,0,0.4762443438914027,0.5237556561085973
90028,0.5515695067264574,0.4926108374384236,-123,103,0.527200976088429,0.472799023911571,home,MIL,under,7.5,0.5475113122171946,-121,0.5237556561085973,MIL,CIN,2023 REG,14,7,4,3,10,18,1,0,4,-4,1,1,1,0,0,0,0,0,0,0.4762443438914027,0.5237556561085973
90029,0.4807692307692307,0.5594713656387665,108,-127,0.46142279018846283,0.5385772098115371,away,STL,over,9.5,0.5454545454545454,-120,0.5179608869977906,CHC,STL,2023 REG,15,8,10,6,14,25,1,0,2,-2,1,1,1,1,1,1,0,0,0,0.5179608869977906,0.48203911300220936
90029,0.4807692307692307,0.5594713656387665,108,-127,0.46142279018846283,0.5385772098115371,home,CHC,under,9.5,0.504950495049505,-102,0.48203911300220936,CHC,STL,2023 REG,15,8,10,6,14,25,1,0,2,-2,1,1,1,1,1,1,0,0,0,0.5179608869977906,0.48203911300220936
90030,0.6551724137931035,0.3802281368821293,-190,163,0.6319789495576061,0.36802105044239386,away,LAD,over,8.5,0.5238095238095238,-110,0.4988662131519274,ATL,LAD,2023 REG,5,1,9,8,9,14,0,1,-7,7,1,0,0,0,0,0,0,0,0,0.4988662131519274,0.5011337868480725
90030,0.6551724137931035,0.3802281368821293,-190,163,0.6319789495576061,0.36802105044239386,home,ATL,under,8.5,0.5238095238095238,-110,0.5011337868480725,ATL,LAD,2023 REG,5,1,9,8,9,14,0,1,-7,7,1,0,0,0,0,0,0,0,0,0.4988662131519274,0.5011337868480725
90031,0.6632996632996633,0.3717472118959108,-197,169,0.6400530827827337,0.35994691721726635,away,TEX,over,8.5,0.5145631067961165,-106,0.49023796582517226,TB,TEX,2023 REG,12,7,5,3,10,17,1,0,4,-4,1,1,1,0,0,0,0,0,0,0.49023796582517226,0.5097620341748277
90031,0.6632996632996633,0.3717472118959108,-197,169,0.6400530827827337,0.35994691721726635,home,TB,under,8.5,0.5327102803738317,-114,0.5097620341748277,TB,TEX,2023 REG,12,7,5,3,10,17,1,0,4,-4,1,1,1,0,0,0,0,0,0,0.49023796582517226,0.5097620341748277
90032,0.6575342465753424,0.38167938931297707,-192,162,0.6317499380460364,0.3682500619539636,away,PIT,over,8.5,0.5098039215686274,-104,0.48592421718142587,SD,PIT,2023 REG,4,2,5,3,5,9,0,1,-1,1,1,1,0,0,0,0,0,0,0,0.48592421718142587,0.5140757828185741
90032,0.6575342465753424,0.38167938931297707,-192,162,0.6317499380460364,0.3682500619539636,home,SD,under,8.5,0.5370370370370371,-116,0.5140757828185741,SD,PIT,2023 REG,4,2,5,3,5,9,0,1,-1,1,1,1,0,0,0,0,0,0,0,0.48592421718142587,0.5140757828185741
90033,0.31746031746031744,0.7237569060773481,215,-262,0.30437548459121727,0.6956245154087828,away,ATL,over,8.5,0.5260663507109005,-111,0.5010269332605688,OAK,ATL,2023 REG,5,2,4,1,3,9,1,0,1,-1,1,0,0,0,0,0,0,0,0,0.5010269332605688,0.4989730667394312
90033,0.31746031746031744,0.7237569060773481,215,-262,0.30437548459121727,0.6956245154087828,home,OAK,under,8.5,0.5215311004784688,-109,0.4989730667394312,OAK,ATL,2023 REG,5,2,4,1,3,9,1,0,1,-1,1,0,0,0,0,0,0,0,0,0.5010269332605688,0.4989730667394312
90034,0.47619047619047616,0.5594713656387665,110,-127,0.4592086467479796,0.5407913532520203,away,TB,over,9,0.5454545454545454,-120,0.5233614270517961,CIN,TB,2023 REG,4,0,17,10,10,21,0,1,-10,10,0,0,0,0,0,0,0,0,0,0.5233614270517961,0.4766385729482039
90034,0.47619047619047616,0.5594713656387665,110,-127,0.4592086467479796,0.5407913532520203,home,CIN,under,9,0.49504950495049505,102,0.4766385729482039,CIN,TB,2023 REG,4,0,17,10,10,21,0,1,-10,10,0,0,0,0,0,0,0,0,0,0.5233614270517961,0.4766385729482039
90035,0.607843137254902,0.4291845493562232,-155,133,0.5853361120599043,0.4146638879400957,away,CIN,over,8.5,0.5,100,0.4772727272727273,MIA,CIN,2023 REG,11,3,5,1,4,16,1,0,2,-2,1,0,0,0,0,0,0,0,0,0.4772727272727273,0.5227272727272727
90035,0.607843137254902,0.4291845493562232,-155,133,0.5853361120599043,0.4146638879400957,home,MIA,under,8.5,0.5454545454545454,-120,0.5227272727272727,MIA,CIN,2023 REG,11,3,5,1,4,16,1,0,2,-2,1,0,0,0,0,0,0,0,0,0.4772727272727273,0.5227272727272727
90036,0.6389891696750902,0.4,-177,150,0.614075512518083,0.385924487481917,away,LAA,over,9.5,0.5121951219512195,-105,0.48808156828023186,PHI,LAA,2023 REG,13,12,11,7,19,24,1,0,5,-5,1,1,1,1,1,1,1,0,0,0.48808156828023186,0.5119184317197681
90036,0.6389891696750902,0.4,-177,150,0.614075512518083,0.385924487481917,home,PHI,under,9.5,0.5348837209302326,-115,0.5119184317197681,PHI,LAA,2023 REG,13,12,11,7,19,24,1,0,5,-5,1,1,1,1,1,1,1,0,0,0.48808156828023186,0.5119184317197681
90037,0.5454545454545454,0.5,-120,100,0.5206611570247933,0.4793388429752067,away,CHC,over,8,0.5169082125603864,-107,0.49353874091423283,SF,CHC,2023 REG,7,2,7,3,5,14,0,1,-1,1,1,1,0,0,0,0,0,0,0,0.49353874091423283,0.5064612590857671
90037,0.5454545454545454,0.5,-120,100,0.5206611570247933,0.4793388429752067,home,SF,under,8,0.5283018867924528,-112,0.5064612590857671,SF,CHC,2023 REG,7,2,7,3,5,14,0,1,-1,1,1,1,0,0,0,0,0,0,0,0.49353874091423283,0.5064612590857671
90038,0.6226415094339623,0.4166666666666667,-165,140,0.5981666073335706,0.40183339266642937,away,BOS,over,8,0.5391705069124424,-117,0.5127649394825569,NYY,BOS,2023 REG,2,1,12,8,9,14,0,1,-7,7,1,0,0,0,0,0,0,0,0,0.5127649394825569,0.48723506051744314
90038,0.6226415094339623,0.4166666666666667,-165,140,0.5981666073335706,0.40183339266642937,home,NYY,under,8,0.5098039215686274,-104,0.48723506051744314,NYY,BOS,2023 REG,2,1,12,8,9,14,0,1,-7,7,1,0,0,0,0,0,0,0,0,0.5127649394825569,0.48723506051744314
90039,0.6865203761755486,0.35714285714285715,-219,180,0.656544676812756,0.34345532318724403,away,NYY,over,10.5,0.5283018867924528,-112,0.5031902949311281,ATL,NYY,2023 REG,6,5,1,0,5,7,1,0,5,-5,0,0,0,0,0,0,0,0,0,0.5031902949311281,0.4968097050688719
90039,0.6865203761755486,0.35714285714285715,-219,180,0.656544676812756,0.34345532318724403,home,ATL,under,10.5,0.5192307692307692,-108,0.4968097050688719,ATL,NYY,2023 REG,6,5,1,0,5,7,1,0,5,-5,0,0,0,0,0,0,0,0,0,0.5031902949311281,0.4968097050688719
90040,0.4081632653061224,0.6323529411764706,145,-172,0.39162603817037017,0.6083739618296298,away,LAA,over,7.5,0.5283018867924528,-112,0.5031902949311281,OAK,LAA,2023 REG,5,1,11,13,14,16,0,1,-12,12,1,0,0,0,0,0,0,0,0,0.5031902949311281,0.4968097050688719
90040,0.4081632653061224,0.6323529411764706,145,-172,0.39162603817037017,0.6083739618296298,home,OAK,under,7.5,0.5192307692307692,-108,0.4968097050688719,OAK,LAA,2023 REG,5,1,11,13,14,16,0,1,-12,12,1,0,0,0,0,0,0,0,0,0.5031902949311281,0.4968097050688719
90041,0.5833333333333333,0.45454545454545453,-140,120,0.5612373737373737,0.4387626262626263,away,MIN,over,8.5,0.5145631067961165,-106,0.4913668392989033,NYY,MIN,2023 REG,6,6,5,1,7,11,1,0,5,-5,1,0,0,0,0,0,0,0,0,0.4913668392989033,0.5086331607010968
90041,0.5833333333333333,0.45454545454545453,-140,120,0.5612373737373737,0.4387626262626263,home,NYY,under,8.5,0.5305164319248826,-113,0.5086331607010968,NYY,MIN,2023 REG,6,6,5,1,7,11,1,0,5,-5,1,0,0,0,0,0,0,0,0,0.4913668392989033,0.5086331607010968
90042,0.609375,0.425531914893617,-156,135,0.5881035987367021,0.41189640126329785,away,KC,over,9,0.5260663507109005,-111,0.5010269332605688,BAL,KC,2023 REG,14,11,8,3,14,22,1,0,8,-8,1,1,1,0,0,0,0,0,0,0.5010269332605688,0.4989730667394312
90042,0.609375,0.425531914893617,-156,135,0.5881035987367021,0.41189640126329785,home,BAL,under,9,0.5215311004784688,-109,0.4989730667394312,BAL,KC,2023 REG,14,11,8,3,14,22,1,0,8,-8,1,1,1,0,0,0,0,0,0,0.5010269332605688,0.4989730667394312
90043,0.7118155619596541,0.3278688524590164,-247,205,0.6835675782091883,0.31643242179081166,away,WSH,over,8,0.5121951219512195,-105,0.48808156828023186,TOR,WSH,2023 REG,9,6,7,3,9,16,1,0,3,-3,1,1,1,0,0,0,0,0,0,0.48808156828023186,0.5119184317197681
90043,0.7118155619596541,0.3278688524590164,-247,205,0.6835675782091883,0.31643242179081166,home,TOR,under,8,0.5348837209302326,-115,0.5119184317197681,TOR,WSH,2023 REG,9,6,7,3,9,16,1,0,3,-3,1,1,1,0,0,0,0,0,0,0.48808156828023186,0.5119184317197681
90044,0.6923076923076923,0.3508771929824561,-225,185,0.6624104640298972,0.33758953597010277,away,KC,over,7.5,0.5121951219512195,-105,0.48808156828023186,MIN,KC,2023 REG,7,8,10,4,12,17,1,0,4,-4,1,1,1,1,0,0,0,0,0,0.48808156828023186,0.5119184317197681
90044,0.6923076923076923,0.3508771929824561,-225,185,0.6624104640298972,0.33758953597010277,home,MIN,under,7.5,0.5348837209302326,-115,0.5119184317197681,MIN,KC,2023 REG,7,8,10,4,12,17,1,0,4,-4,1,1,1,1,0,0,0,0,0,0.48808156828023186,0.5119184317197681
90045,0.5454545454545454,0.5,-120,100,0.5206611570247933,0.4793388429752067,away,BAL,over,9,0.5121951219512195,-105,0.48808156828023186,NYY,BAL,2023 REG,7,8,7,4,12,14,1,0,4,-4,1,1,1,1,0,0,0,0,0,0.48808156828023186,0.5119184317197681
90045,0.5454545454545454,0.5,-120,100,0.5206611570247933,0.4793388429752067,home,NYY,under,9,0.5348837209302326,-115,0.5119184317197681,NYY,BAL,2023 REG,7,8,7,4,12,14,1,0,4,-4,1,1,1,1,0,0,0,0,0,0.48808156828023186,0.5119184317197681
90046,0.45454545454545453,0.5850622406639003,120,-141,0.4365419567230205,0.5634580432769796,away,SD,over,10,0.5121951219512195,-105,0.48808156828023186,DET,SD,2023 REG,8,3,18,14,17,26,0,1,-11,11,1,1,1,0,0,0,0,0,0,0.48808156828023186,0.5119184317197681
90046,0.45454545454545453,0.5850622406639003,120,-141,0.4365419567230205,0.5634580432769796,home,DET,under,10,0.5348837209302326,-115,0.5119184317197681,DET,SD,2023 REG,8,3,18,14,17,26,0,1,-11,11,1,1,1,0,0,0,0,0,0,0.48808156828023186,0.5119184317197681
90047,0.36363636363636365,0.6794871794871794,175,-212,0.34795507522780256,0.6520449247721974,away,MIL,over,8.5,0.5305164319248826,-113,0.5053568787472517,WSH,MIL,2023 REG,7,5,10,3,8,17,1,0,2,-2,1,1,1,0,0,0,0,0,0,0.5053568787472517,0.49464312125274834
90047,0.36363636363636365,0.6794871794871794,175,-212,0.34795507522780256,0.6520449247721974,home,WSH,under,8.5,0.5169082125603864,-107,0.49464312125274834,WSH,MIL,2023 REG,7,5,10,3,8,17,1,0,2,-2,1,1,1,0,0,0,0,0,0,0.5053568787472517,0.49464312125274834
90048,0.5555555555555556,0.4807692307692307,-125,108,0.5353751187084521,0.4646248812915479,away,NYM,over,8.5,0.5454545454545454,-120,0.5179608869977906,SF,NYM,2023 REG,7,7,10,4,11,17,1,0,3,-3,1,1,1,1,0,0,0,0,0,0.5179608869977906,0.48203911300220936
90048,0.5555555555555556,0.4807692307692307,-125,108,0.5353751187084521,0.4646248812915479,home,SF,under,8.5,0.504950495049505,-102,0.48203911300220936,SF,NYM,2023 REG,7,7,10,4,11,17,1,0,3,-3,1,1,1,1,0,0,0,0,0,0.5179608869977906,0.48203911300220936
90049,0.6108949416342413,0.4273504273504274,-157,134,0.5875310391805721,0.41246896081942785,away,DET,over,7,0.5238095238095238,-110,0.4988662131519274,MIA,DET,2023 REG,13,8,10,6,14,23,1,0,2,-2,1,1,1,1,1,1,0,0,0,0.4988662131519274,0.5011337868480725
90049,0.6108949416342413,0.4273504273504274,-157,134,0.5875310391805721,0.41246896081942785,home,MIA,under,7,0.5238095238095238,-110,0.5011337868480725,MIA,DET,2023 REG,13,8,10,6,14,23,1,0,2,-2,1,1,1,1,1,1,0,0,0,0.4988662131519274,0.5011337868480725
90050,0.5192307692307692,0.5238095238095238,-108,-110,0.49688292476754015,0.5031170752324599,away,TEX,over,8.5,0.5575221238938054,-126,0.5322513175010363,HOU,TEX,2023 REG,9,10,10,9,19,19,1,0,1,-1,1,1,1,1,1,1,1,1,1,0.5322513175010363,0.46774868249896373
90050,0.5192307692307692,0.5238095238095238,-108,-110,0.49688292476754015,0.5031170752324599,home,HOU,under,8.5,0.48780487804878053,105,0.46774868249896373,HOU,TEX,2023 REG,9,10,10,9,19,19,1,0,1,-1,1,1,1,1,1,1,1,1,1,0.5322513175010363,0.46774868249896373
90051,0.4854368932038835,0.5555555555555556,106,-125,0.465537646233282,0.534462353766718,away,ARI,over,9,0.5348837209302326,-115,0.5097020142727117,DET,ARI,2023 REG,6,0,7,5,5,13,0,1,-5,5,0,0,0,0,0,0,0,0,0,0.5097020142727117,0.49029798572728833
90051,0.4854368932038835,0.5555555555555556,106,-125,0.465537646233282,0.534462353766718,home,DET,under,9,0.5121951219512195,-105,0.49029798572728833,DET,ARI,2023 REG,6,0,7,5,5,13,0,1,-5,5,0,0,0,0,0,0,0,0,0,0.5097020142727117,0.49029798572728833
90052,0.7340425531914894,0.3076923076923077,-276,225,0.7034073893512554,0.29659261064874465,away,WSH,over,9.5,0.5238095238095238,-110,0.4988662131519274,ATL,WSH,2023 REG,9,2,9,6,8,18,0,1,-4,4,1,1,0,0,0,0,0,0,0,0.4988662131519274,0.5011337868480725
90052,0.7340425531914894,0.3076923076923077,-276,225,0.7034073893512554,0.29659261064874465,home,ATL,under,9.5,0.5238095238095238,-110,0.5011337868480725,ATL,WSH,2023 REG,9,2,9,6,8,18,0,1,-4,4,1,1,0,0,0,0,0,0,0,0.4988662131519274,0.5011337868480725
90053,0.6000000000000001,0.4347826086956522,-150,130,0.5791304347826086,0.4208695652173914,away,CIN,over,9,0.5412844036697247,-118,0.5175913212324037,HOU,CIN,2023 REG,13,7,10,9,16,23,0,1,-2,2,1,1,1,1,1,1,1,0,0,0.5175913212324037,0.4824086787675963
90053,0.6000000000000001,0.4347826086956522,-150,130,0.5791304347826086,0.4208695652173914,home,HOU,under,9,0.5024875621890548,-101,0.4824086787675963,HOU,CIN,2023 REG,13,7,10,9,16,23,0,1,-2,2,1,1,1,1,1,1,1,0,0,0.5175913212324037,0.4824086787675963
90054,0.7590361445783133,0.273972602739726,-315,265,0.7339813122766691,0.2660186877233309,away,CWS,over,8.5,0.5433789954337899,-119,0.5171177654451503,TEX,CWS,2023 REG,8,5,9,3,8,17,1,0,2,-2,1,1,1,0,0,0,0,0,0,0.5171177654451503,0.4828822345548497
90054,0.7590361445783133,0.273972602739726,-315,265,0.7339813122766691,0.2660186877233309,home,TEX,under,8.5,0.504950495049505,-102,0.4828822345548497,TEX,CWS,2023 REG,8,5,9,3,8,17,1,0,2,-2,1,1,1,0,0,0,0,0,0,0.5171177654451503,0.4828822345548497
90055,0.37593984962406013,0.6632996632996633,166,-197,0.3611881530361942,0.6388118469638058,away,STL,over,10,0.5305164319248826,-113,0.5066009958897986,CIN,STL,2023 REG,8,6,7,5,11,15,1,0,1,-1,1,1,1,1,1,0,0,0,0,0.5066009958897986,0.49339900411020143
90055,0.37593984962406013,0.6632996632996633,166,-197,0.3611881530361942,0.6388118469638058,home,CIN,under,10,0.5145631067961165,-106,0.49339900411020143,CIN,STL,2023 REG,8,6,7,5,11,15,1,0,1,-1,1,1,1,1,1,0,0,0,0,0.5066009958897986,0.49339900411020143
90056,0.49019607843137253,0.5515695067264574,104,-123,0.4697227523736127,0.5302772476263873,away,MIN,over,7.5,0.5121951219512195,-105,0.48808156828023186,DET,MIN,2023 REG,6,3,12,6,9,18,0,1,-3,3,1,1,1,0,0,0,0,0,0,0.48808156828023186,0.5119184317197681
90056,0.49019607843137253,0.5515695067264574,104,-123,0.4697227523736127,0.5302772476263873,home,DET,under,7.5,0.5348837209302326,-115,0.5119184317197681,DET,MIN,2023 REG,6,3,12,6,9,18,0,1,-3,3,1,1,1,0,0,0,0,0,0,0.48808156828023186,0.5119184317197681
90057,0.613899613899614,0.425531914893617,-159,135,0.589692613597978,0.410307386402022,away,SD,over,8.5,0.5192307692307692,-108,0.49455035168025013,ATL,SD,2023 REG,13,7,7,6,13,20,1,0,1,-1,1,1,1,1,1,1,0,0,0,0.49455035168025013,0.5054496483197499
90057,0.613899613899614,0.425531914893617,-159,135,0.589692613597978,0.410307386402022,home,ATL,under,8.5,0.5283018867924528,-112,0.5054496483197499,ATL,SD,2023 REG,13,7,7,6,13,20,1,0,1,-1,1,1,1,1,1,1,0,0,0,0.49455035168025013,0.5054496483197499
90058,0.5098039215686274,0.5305164319248826,-104,-113,0.4892484472386027,0.5107515527613973,away,TEX,over,8,0.5391705069124424,-117,0.5140669063204599,CIN,TEX,2023 REG,8,7,10,6,13,18,1,0,1,-1,1,1,1,1,1,1,0,0,0,0.5140669063204599,0.4859330936795401
90058,0.5098039215686274,0.5305164319248826,-104,-113,0.4892484472386027,0.5107515527613973,home,CIN,under,8,0.5073891625615764,-103,0.4859330936795401,CIN,TEX,2023 REG,8,7,10,6,13,18,1,0,1,-1,1,1,1,1,1,1,0,0,0,0.5140669063204599,0.4859330936795401
90059,0.41152263374485604,0.6254681647940076,143,-167,0.39630008290581753,0.6036999170941825,away,NYY,over,10.5,0.5121951219512195,-105,0.48919479393107135,CIN,NYY,2023 REG,6,2,7,6,8,13,0,1,-4,4,1,1,0,0,0,0,0,0,0,0.48919479393107135,0.5108052060689287
90059,0.41152263374485604,0.6254681647940076,143,-167,0.39630008290581753,0.6036999170941825,home,CIN,under,10.5,0.5327102803738317,-114,0.5108052060689287,CIN,NYY,2023 REG,6,2,7,6,8,13,0,1,-4,4,1,1,0,0,0,0,0,0,0,0.48919479393107135,0.5108052060689287
90060,0.7142857142857143,0.3225806451612903,-250,210,0.6879526003949967,0.3120473996050033,away,COL,over,8.5,0.5454545454545454,-120,0.5220180091279142,ARI,COL,2023 REG,6,5,8,1,6,14,1,0,4,-4,1,0,0,0,0,0,0,0,0,0.5220180091279142,0.4779819908720858
90060,0.7142857142857143,0.3225806451612903,-250,210,0.6879526003949967,0.3120473996050033,home,ARI,under,8.5,0.49751243781094534,101,0.4779819908720858,ARI,COL,2023 REG,6,5,8,1,6,14,1,0,4,-4,1,0,0,0,0,0,0,0,0,0.5220180091279142,0.4779819908720858
90061,0.5121951219512195,0.5348837209302326,-105,-115,0.48808156828023186,0.5119184317197681,away,SEA,over,9.5,0.5,100,0.4762443438914027,ARI,SEA,2023 REG,9,4,10,3,7,19,1,0,1,-1,1,1,1,0,0,0,0,0,0,0.4762443438914027,0.5237556561085973
90061,0.5121951219512195,0.5348837209302326,-105,-115,0.48808156828023186,0.5119184317197681,home,ARI,under,9.5,0.5475113122171946,-121,0.5237556561085973,ARI,SEA,2023 REG,9,4,10,3,7,19,1,0,1,-1,1,1,1,0,0,0,0,0,0,0.4762443438914027,0.5237556561085973
90062,0.6453900709219857,0.3921568627450981,-182,155,0.6211576527396834,0.3788423472603166,away,KC,over,10,0.5169082125603864,-107,0.49353874091423283,BOS,KC,2023 REG,6,3,15,9,12,21,0,1,-6,6,1,1,1,0,0,0,0,0,0,0.49353874091423283,0.5064612590857671
90062,0.6453900709219857,0.3921568627450981,-182,155,0.6211576527396834,0.3788423472603166,home,BOS,under,10,0.5283018867924528,-112,0.5064612590857671,BOS,KC,2023 REG,6,3,15,9,12,21,0,1,-6,6,1,1,1,0,0,0,0,0,0,0.49353874091423283,0.5064612590857671
90063,0.6376811594202898,0.40485829959514175,-176,147,0.6105545478742175,0.3894454521257825,away,CLE,over,8.5,0.5073891625615764,-103,0.4837652908580103,TOR,CLE,2023 REG,11,8,5,3,11,16,1,0,5,-5,1,1,1,0,0,0,0,0,0,0.4837652908580103,0.5162347091419897
90063,0.6376811594202898,0.40485829959514175,-176,147,0.6105545478742175,0.3894454521257825,home,TOR,under,8.5,0.5391705069124424,-117,0.5162347091419897,TOR,CLE,2023 REG,11,8,5,3,11,16,1,0,5,-5,1,1,1,0,0,0,0,0,0,0.4837652908580103,0.5162347091419897
90064,0.3448275862068966,0.696969696969697,190,-230,0.3304147299391057,0.6695852700608943,away,BOS,over,8.5,0.5121951219512195,-105,0.48919479393107135,OAK,BOS,2023 REG,10,6,6,5,11,16,1,0,1,-1,1,1,1,1,1,0,0,0,0,0.48919479393107135,0.5108052060689287
90064,0.3448275862068966,0.696969696969697,190,-230,0.3304147299391057,0.6695852700608943,home,OAK,under,8.5,0.5327102803738317,-114,0.5108052060689287,OAK,BOS,2023 REG,10,6,6,5,11,16,1,0,1,-1,1,1,1,1,1,0,0,0,0,0.48919479393107135,0.5108052060689287
90065,0.5833333333333333,0.4587155963302753,-140,118,0.5588047910295616,0.4411952089704384,away,NYM,over,8.5,0.5238095238095238,-110,0.4988662131519274,LAD,NYM,2023 REG,9,6,14,8,14,23,0,1,-2,2,1,1,1,1,1,1,0,0,0,0.4988662131519274,0.5011337868480725
90065,0.5833333333333333,0.4587155963302753,-140,118,0.5588047910295616,0.4411952089704384,home,LAD,under,8.5,0.5238095238095238,-110,0.5011337868480725,LAD,NYM,2023 REG,9,6,14,8,14,23,0,1,-2,2,1,1,1,1,1,1,0,0,0,0.4988662131519274,0.5011337868480725
90066,0.5535714285714286,0.48780487804878053,-124,105,0.53066668740667,0.46933331259333,away,CHC,over,8,0.504950495049505,-102,0.47949844489399435,DET,CHC,2023 REG,5,4,9,6,10,14,0,1,-2,2,1,1,1,1,0,0,0,0,0,0.47949844489399435,0.5205015551060057
90066,0.5535714285714286,0.48780487804878053,-124,105,0.53066668740667,0.46933331259333,home,DET,under,8,0.5454545454545454,-120,0.5205015551060057,DET,CHC,2023 REG,5,4,9,6,10,14,0,1,-2,2,1,1,1,1,0,0,0,0,0,0.47949844489399435,0.5205015551060057
90067,0.6183206106870228,0.4166666666666667,-162,140,0.5966872559874133,0.40331274401258665,away,PIT,over,6.5,0.5495495495495495,-122,0.5250401592387142,SEA,PIT,2023 REG,7,6,15,11,17,22,0,1,-5,5,1,1,1,1,1,1,0,0,0,0.5250401592387142,0.47495984076128583
90067,0.6183206106870228,0.4166666666666667,-162,140,0.5966872559874133,0.40331274401258665,home,SEA,under,6.5,0.49504950495049505,102,0.47495984076128583,SEA,PIT,2023 REG,7,6,15,11,17,22,0,1,-5,5,1,1,1,1,1,1,0,0,0,0.5250401592387142,0.47495984076128583
90068,0.607843137254902,0.43103448275862066,-155,132,0.5842116427368785,0.41578835726312147,away,SF,over,9,0.5454545454545454,-120,0.5206611570247933,TOR,SF,2023 REG,3,2,5,1,3,8,1,0,1,-1,1,0,0,0,0,0,0,0,0,0.5206611570247933,0.4793388429752067
90068,0.607843137254902,0.43103448275862066,-155,132,0.5842116427368785,0.41578835726312147,home,TOR,under,9,0.5,100,0.4793388429752067,TOR,SF,2023 REG,3,2,5,1,3,8,1,0,1,-1,1,0,0,0,0,0,0,0,0,0.5206611570247933,0.4793388429752067
90069,0.5,0.5391705069124424,100,-117,0.4804147465437788,0.5195852534562212,away,CHC,over,9,0.5412844036697247,-118,0.5162581740877563,ARI,CHC,2023 REG,9,6,7,2,8,16,1,0,4,-4,1,1,0,0,0,0,0,0,0,0.5162581740877563,0.4837418259122437
90069,0.5,0.5391705069124424,100,-117,0.4804147465437788,0.5195852534562212,home,ARI,under,9,0.504950495049505,-102,0.4837418259122437,ARI,CHC,2023 REG,9,6,7,2,8,16,1,0,4,-4,1,1,0,0,0,0,0,0,0,0.5162581740877563,0.4837418259122437
90070,0.4,0.6402877697841727,150,-178,0.383884892086331,0.6161151079136691,away,ATL,over,8.5,0.5192307692307692,-108,0.49688292476754015,WSH,ATL,2023 REG,6,4,4,1,5,10,1,0,3,-3,1,0,0,0,0,0,0,0,0,0.49688292476754015,0.5031170752324599
90070,0.4,0.6402877697841727,150,-178,0.383884892086331,0.6161151079136691,home,WSH,under,8.5,0.5238095238095238,-110,0.5031170752324599,WSH,ATL,2023 REG,6,4,4,1,5,10,1,0,3,-3,1,0,0,0,0,0,0,0,0,0.49688292476754015,0.5031170752324599
90071,0.607843137254902,0.4329004329004329,-155,131,0.583077437748718,0.416922562251282,away,PIT,over,9.5,0.5024875621890548,-101,0.4794401874631478,STL,PIT,2023 REG,8,6,11,7,13,19,0,1,-1,1,1,1,1,1,1,1,0,0,0,0.4794401874631478,0.5205598125368522
90071,0.607843137254902,0.4329004329004329,-155,131,0.583077437748718,0.416922562251282,home,STL,under,9.5,0.5433789954337899,-119,0.5205598125368522,STL,PIT,2023 REG,8,6,11,7,13,19,0,1,-1,1,1,1,1,1,1,1,0,0,0,0.4794401874631478,0.5205598125368522
90072,0.5,0.5348837209302326,100,-115,0.4825581395348837,0.5174418604651163,away,BOS,over,10,0.5391705069124424,-117,0.5127649394825569,CWS,BOS,2023 REG,7,4,5,1,5,12,1,0,3,-3,1,0,0,0,0,0,0,0,0,0.5127649394825569,0.48723506051744314
90072,0.5,0.5348837209302326,100,-115,0.4825581395348837,0.5174418604651163,home,CWS,under,10,0.5098039215686274,-104,0.48723506051744314,CWS,BOS,2023 REG,7,4,5,1,5,12,1,0,3,-3,1,0,0,0,0,0,0,0,0,0.5127649394825569,0.48723506051744314
90073,0.5192307692307692,0.5238095238095238,-108,-110,0.49688292476754015,0.5031170752324599,away,TB,over,9,0.5215311004784688,-109,0.4978845547971712,TOR,TB,2023 REG,12,8,16,12,20,28,0,1,-4,4,1,1,1,1,1,1,1,1,0,0.4978845547971712,0.5021154452028288
90073,0.5192307692307692,0.5238095238095238,-108,-110,0.49688292476754015,0.5031170752324599,home,TOR,under,9,0.5238095238095238,-110,0.5021154452028288,TOR,TB,2023 REG,12,8,16,12,20,28,0,1,-4,4,1,1,1,1,1,1,1,1,0,0.4978845547971712,0.5021154452028288
90074,0.6296296296296295,0.4081632653061224,-170,145,0.6058341031886005,0.39416589681139946,away,MIA,over,8.5,0.5215311004784688,-109,0.4978845547971712,ATL,MIA,2023 REG,5,4,11,5,9,16,0,1,-1,1,1,1,1,1,0,0,0,0,0,0.4978845547971712,0.5021154452028288
90074,0.6296296296296295,0.4081632653061224,-170,145,0.6058341031886005,0.39416589681139946,home,ATL,under,8.5,0.5238095238095238,-110,0.5021154452028288,ATL,MIA,2023 REG,5,4,11,5,9,16,0,1,-1,1,1,1,1,1,0,0,0,0,0,0.4978845547971712,0.5021154452028288
90075,0.5,0.5412844036697247,100,-118,0.47935779816513757,0.5206422018348624,away,KC,over,8.5,0.5433789954337899,-119,0.5171177654451503,OAK,KC,2023 REG,7,5,6,4,9,13,1,0,1,-1,1,1,1,1,0,0,0,0,0,0.5171177654451503,0.4828822345548497
90075,0.5,0.5412844036697247,100,-118,0.47935779816513757,0.5206422018348624,home,OAK,under,8.5,0.504950495049505,-102,0.4828822345548497,OAK,KC,2023 REG,7,5,6,4,9,13,1,0,1,-1,1,1,1,1,0,0,0,0,0,0.5171177654451503,0.4828822345548497
90076,0.42372881355932196,0.613899613899614,136,-159,0.407784564636044,0.5922154353639559,away,STL,over,9,0.5121951219512195,-105,0.48808156828023186,MIL,STL,2023 REG,5,0,12,6,6,17,0,1,-6,6,0,0,0,0,0,0,0,0,0,0.48808156828023186,0.5119184317197681
90076,0.42372881355932196,0.613899613899614,136,-159,0.407784564636044,0.5922154353639559,home,MIL,under,9,0.5348837209302326,-115,0.5119184317197681,MIL,STL,2023 REG,5,0,12,6,6,17,0,1,-6,6,0,0,0,0,0,0,0,0,0,0.48808156828023186,0.5119184317197681
90077,0.3278688524590164,0.7142857142857143,205,-250,0.3140476830345145,0.6859523169654855,away,SEA,over,8.5,0.5238095238095238,-110,0.4988662131519274,OAK,SEA,2023 REG,8,3,7,5,8,15,0,1,-2,2,1,1,1,0,0,0,0,0,0,0.4988662131519274,0.5011337868480725
90077,0.3278688524590164,0.7142857142857143,205,-250,0.3140476830345145,0.6859523169654855,home,OAK,under,8.5,0.5238095238095238,-110,0.5011337868480725,OAK,SEA,2023 REG,8,3,7,5,8,15,0,1,-2,2,1,1,1,0,0,0,0,0,0,0.4988662131519274,0.5011337868480725
90078,0.4587155963302753,0.5833333333333333,118,-140,0.4394270964845833,0.5605729035154168,away,PHI,over,8.5,0.5238095238095238,-110,0.4988662131519274,OAK,PHI,2023 REG,7,1,7,6,7,14,0,1,-5,5,1,0,0,0,0,0,0,0,0,0.4988662131519274,0.5011337868480725
90078,0.4587155963302753,0.5833333333333333,118,-140,0.4394270964845833,0.5605729035154168,home,OAK,under,8.5,0.5238095238095238,-110,0.5011337868480725,OAK,PHI,2023 REG,7,1,7,6,7,14,0,1,-5,5,1,0,0,0,0,0,0,0,0,0.4988662131519274,0.5011337868480725
90079,0.6254681647940076,0.41152263374485604,-167,143,0.6023315979176397,0.3976684020823603,away,CWS,over,8.5,0.5,100,0.4772727272727273,LAA,CWS,2023 REG,6,4,9,2,6,15,1,0,2,-2,1,1,0,0,0,0,0,0,0,0.4772727272727273,0.5227272727272727
90079,0.6254681647940076,0.41152263374485604,-167,143,0.6023315979176397,0.3976684020823603,home,LAA,under,8.5,0.5454545454545454,-120,0.5227272727272727,LAA,CWS,2023 REG,6,4,9,2,6,15,1,0,2,-2,1,1,0,0,0,0,0,0,0,0.4772727272727273,0.5227272727272727
90080,0.48780487804878053,0.5535714285714286,105,-124,0.4676213138438005,0.5323786861561994,away,CWS,over,9,0.5348837209302326,-115,0.5097020142727117,WSH,CWS,2023 REG,6,1,15,6,7,21,0,1,-5,5,1,0,0,0,0,0,0,0,0,0.5097020142727117,0.49029798572728833
90080,0.48780487804878053,0.5535714285714286,105,-124,0.4676213138438005,0.5323786861561994,home,WSH,under,9,0.5121951219512195,-105,0.49029798572728833,WSH,CWS,2023 REG,6,1,15,6,7,21,0,1,-5,5,1,0,0,0,0,0,0,0,0,0.5097020142727117,0.49029798572728833
90081,0.49504950495049505,0.5454545454545454,102,-120,0.47499799484898986,0.5250020051510101,away,CHC,over,9,0.5169082125603864,-107,0.49239402434819424,CIN,CHC,2023 REG,10,7,12,6,13,22,1,0,1,-1,1,1,1,1,1,1,0,0,0,0.49239402434819424,0.5076059756518058
90081,0.49504950495049505,0.5454545454545454,102,-120,0.47499799484898986,0.5250020051510101,home,CIN,under,9,0.5305164319248826,-113,0.5076059756518058,CIN,CHC,2023 REG,10,7,12,6,13,22,1,0,1,-1,1,1,1,1,1,1,0,0,0,0.49239402434819424,0.5076059756518058
90082,0.5454545454545454,0.5,-120,100,0.5206611570247933,0.4793388429752067,away,CHC,over,9.5,0.5238095238095238,-110,0.5012646084074657,LAA,CHC,2023 REG,5,7,8,4,11,13,1,0,3,-3,1,1,1,1,0,0,0,0,0,0.5012646084074657,0.4987353915925343
90082,0.5454545454545454,0.5,-120,100,0.5206611570247933,0.4793388429752067,home,LAA,under,9.5,0.5192307692307692,-108,0.4987353915925343,LAA,CHC,2023 REG,5,7,8,4,11,13,1,0,3,-3,1,1,1,1,0,0,0,0,0,0.5012646084074657,0.4987353915925343
90083,0.7340425531914894,0.3125,-276,220,0.6998783386147578,0.3001216613852422,away,LAA,over,7.5,0.5238095238095238,-110,0.4976840657273969,TB,LAA,2023 REG,9,5,10,4,9,19,1,0,1,-1,1,1,1,1,0,0,0,0,0,0.4976840657273969,0.5023159342726031
90083,0.7340425531914894,0.3125,-276,220,0.6998783386147578,0.3001216613852422,home,TB,under,7.5,0.5260663507109005,-111,0.5023159342726031,TB,LAA,2023 REG,9,5,10,4,9,19,1,0,1,-1,1,1,1,1,0,0,0,0,0,0.4976840657273969,0.5023159342726031
90084,0.5495495495495495,0.49019607843137253,-122,104,0.5277073575960698,0.4722926424039302,away,CWS,over,9.5,0.5348837209302326,-115,0.5097020142727117,CIN,CWS,2023 REG,10,4,18,17,21,28,0,1,-13,13,1,1,1,1,0,0,0,0,0,0.5097020142727117,0.49029798572728833
90084,0.5495495495495495,0.49019607843137253,-122,104,0.5277073575960698,0.4722926424039302,home,CIN,under,9.5,0.5121951219512195,-105,0.49029798572728833,CIN,CWS,2023 REG,10,4,18,17,21,28,0,1,-13,13,1,1,1,1,0,0,0,0,0,0.5097020142727117,0.49029798572728833
90085,0.5391705069124424,0.5,-117,100,0.5180509248444435,0.4819490751555565,away,SD,over,8.5,0.5348837209302326,-115,0.5097020142727117,SF,SD,2023 REG,5,2,10,5,7,15,0,1,-3,3,1,1,0,0,0,0,0,0,0,0.5097020142727117,0.49029798572728833
90085,0.5391705069124424,0.5,-117,100,0.5180509248444435,0.4819490751555565,home,SF,under,8.5,0.5121951219512195,-105,0.49029798572728833,SF,SD,2023 REG,5,2,10,5,7,15,0,1,-3,3,1,1,0,0,0,0,0,0,0,0.5097020142727117,0.49029798572728833
90086,0.7422680412371133,0.29411764705882354,-288,240,0.7152601076566242,0.2847398923433758,away,COL,over,9.5,0.5098039215686274,-104,0.48483656587239576,LAD,COL,2023 REG,8,4,3,1,5,11,1,0,3,-3,1,0,0,0,0,0,0,0,0,0.48483656587239576,0.5151634341276042
90086,0.7422680412371133,0.29411764705882354,-288,240,0.7152601076566242,0.2847398923433758,home,LAD,under,9.5,0.5391705069124424,-117,0.5151634341276042,LAD,COL,2023 REG,8,4,3,1,5,11,1,0,3,-3,1,0,0,0,0,0,0,0,0,0.48483656587239576,0.5151634341276042
90087,0.5918367346938775,0.4444444444444444,-145,125,0.5703642001018094,0.42963579989819056,away,MIA,over,8,0.5215311004784688,-109,0.4978845547971712,ATL,MIA,2023 REG,9,6,5,4,10,14,1,0,2,-2,1,1,1,1,0,0,0,0,0,0.4978845547971712,0.5021154452028288
90087,0.5918367346938775,0.4444444444444444,-145,125,0.5703642001018094,0.42963579989819056,home,ATL,under,8,0.5238095238095238,-110,0.5021154452028288,ATL,MIA,2023 REG,9,6,5,4,10,14,1,0,2,-2,1,1,1,1,0,0,0,0,0,0.4978845547971712,0.5021154452028288
90088,0.5121951219512195,0.5348837209302326,-105,-115,0.48808156828023186,0.5119184317197681,away,PHI,over,9.5,0.5391705069124424,-117,0.5127649394825569,MIL,PHI,2023 REG,7,2,6,4,6,13,0,1,-2,2,1,1,0,0,0,0,0,0,0,0.5127649394825569,0.48723506051744314
90088,0.5121951219512195,0.5348837209302326,-105,-115,0.48808156828023186,0.5119184317197681,home,MIL,under,9.5,0.5098039215686274,-104,0.48723506051744314,MIL,PHI,2023 REG,7,2,6,4,6,13,0,1,-2,2,1,1,0,0,0,0,0,0,0,0.5127649394825569,0.48723506051744314
90089,0.6666666666666666,0.37735849056603776,-200,165,0.6373165618448637,0.36268343815513626,away,SF,over,8,0.5454545454545454,-120,0.5193043049216726,TOR,SF,2023 REG,8,0,6,3,3,14,0,1,-3,3,0,0,0,0,0,0,0,0,0,0.5193043049216726,0.48069569507832743
90089,0.6666666666666666,0.37735849056603776,-200,165,0.6373165618448637,0.36268343815513626,home,TOR,under,8,0.5024875621890548,-101,0.48069569507832743,TOR,SF,2023 REG,8,0,6,3,3,14,0,1,-3,3,0,0,0,0,0,0,0,0,0,0.5193043049216726,0.48069569507832743
90090,0.5884773662551441,0.4504504504504505,-143,122,0.5655692272061728,0.43443077279382725,away,STL,over,8,0.5121951219512195,-105,0.48808156828023186,MIA,STL,2023 REG,6,5,11,4,9,17,1,0,1,-1,1,1,1,1,0,0,0,0,0,0.48808156828023186,0.5119184317197681
90090,0.5884773662551441,0.4504504504504505,-143,122,0.5655692272061728,0.43443077279382725,home,MIA,under,8,0.5348837209302326,-115,0.5119184317197681,MIA,STL,2023 REG,6,5,11,4,9,17,1,0,1,-1,1,1,1,1,0,0,0,0,0,0.48808156828023186,0.5119184317197681
90091,0.5594713656387665,0.47619047619047616,-127,110,0.5395195862893665,0.46048041371063353,away,CIN,over,10,0.5391705069124424,-117,0.5127649394825569,BAL,CIN,2023 REG,12,10,7,3,13,19,1,0,7,-7,1,1,1,0,0,0,0,0,0,0.5127649394825569,0.48723506051744314
90091,0.5594713656387665,0.47619047619047616,-127,110,0.5395195862893665,0.46048041371063353,home,BAL,under,10,0.5098039215686274,-104,0.48723506051744314,BAL,CIN,2023 REG,12,10,7,3,13,19,1,0,7,-7,1,1,1,0,0,0,0,0,0,0.5127649394825569,0.48723506051744314
90092,0.5454545454545454,0.49751243781094534,-120,101,0.5220180091279142,0.4779819908720858,away,OAK,over,9,0.5305164319248826,-113,0.5053568787472517,WSH,OAK,2023 REG,12,8,6,2,10,18,1,0,6,-6,1,1,0,0,0,0,0,0,0,0.5053568787472517,0.49464312125274834
90092,0.5454545454545454,0.49751243781094534,-120,101,0.5220180091279142,0.4779819908720858,home,WSH,under,9,0.5169082125603864,-107,0.49464312125274834,WSH,OAK,2023 REG,12,8,6,2,10,18,1,0,6,-6,1,1,0,0,0,0,0,0,0,0.5053568787472517,0.49464312125274834
90093,0.726027397260274,0.31746031746031744,-265,215,0.6944541249288857,0.3055458750711143,away,KC,over,8.5,0.5348837209302326,-115,0.5097020142727117,SEA,KC,2023 REG,13,15,5,2,17,18,1,0,13,-13,1,1,0,0,0,0,0,0,0,0.5097020142727117,0.49029798572728833
90093,0.726027397260274,0.31746031746031744,-265,215,0.6944541249288857,0.3055458750711143,home,SEA,under,8.5,0.5121951219512195,-105,0.49029798572728833,SEA,KC,2023 REG,13,15,5,2,17,18,1,0,13,-13,1,1,0,0,0,0,0,0,0,0.5097020142727117,0.49029798572728833
90094,0.4347826086956522,0.6031746031746031,130,-152,0.418279473099889,0.581720526900111,away,NYM,over,9,0.5454545454545454,-120,0.5206611570247933,ARI,NYM,2023 REG,8,5,8,8,13,16,0,1,-3,3,1,1,1,1,1,0,0,0,0,0.5206611570247933,0.4793388429752067
90094,0.4347826086956522,0.6031746031746031,130,-152,0.418279473099889,0.581720526900111,home,ARI,under,9,0.5,100,0.4793388429752067,ARI,NYM,2023 REG,8,5,8,8,13,16,0,1,-3,3,1,1,1,1,1,0,0,0,0,0.5206611570247933,0.4793388429752067
90095,0.5901639344262295,0.4464285714285714,-144,124,0.5685683572004454,0.4314316427995546,away,BAL,over,8,0.5121951219512195,-105,0.48808156828023186,MIL,BAL,2023 REG,16,10,5,2,12,21,1,0,8,-8,1,1,0,0,0,0,0,0,0,0.48808156828023186,0.5119184317197681
90095,0.5901639344262295,0.4464285714285714,-144,124,0.5685683572004454,0.4314316427995546,home,MIL,under,8,0.5348837209302326,-115,0.5119184317197681,MIL,BAL,2023 REG,16,10,5,2,12,21,1,0,8,-8,1,1,0,0,0,0,0,0,0,0.48808156828023186,0.5119184317197681
90096,0.7118155619596541,0.3333333333333333,-247,200,0.6796778756848186,0.32032212431518137,away,OAK,over,8.5,0.5283018867924528,-112,0.5031902949311281,TEX,OAK,2023 REG,9,3,10,6,9,19,0,1,-3,3,1,1,1,0,0,0,0,0,0,0.5031902949311281,0.4968097050688719
90096,0.7118155619596541,0.3333333333333333,-247,200,0.6796778756848186,0.32032212431518137,home,TEX,under,8.5,0.5192307692307692,-108,0.4968097050688719,TEX,OAK,2023 REG,9,3,10,6,9,19,0,1,-3,3,1,1,1,0,0,0,0,0,0,0.5031902949311281,0.4968097050688719
90097,0.6197718631178707,0.4166666666666667,-163,140,0.597188287624032,0.402811712375968,away,CLE,over,8.5,0.5283018867924528,-112,0.5031902949311281,SD,CLE,2023 REG,9,5,5,0,5,14,1,0,5,-5,0,0,0,0,0,0,0,0,0,0.5031902949311281,0.4968097050688719
90097,0.6197718631178707,0.4166666666666667,-163,140,0.597188287624032,0.402811712375968,home,SD,under,8.5,0.5192307692307692,-108,0.4968097050688719,SD,CLE,2023 REG,9,5,5,0,5,14,1,0,5,-5,0,0,0,0,0,0,0,0,0,0.5031902949311281,0.4968097050688719
90098,0.7245179063360881,0.31746031746031744,-263,215,0.6941039315194085,0.3058960684805915,away,DET,over,8,0.5215311004784688,-109,0.4978845547971712,LAD,DET,2023 REG,3,2,7,4,6,10,0,1,-2,2,1,1,0,0,0,0,0,0,0,0.4978845547971712,0.5021154452028288
90098,0.7245179063360881,0.31746031746031744,-263,215,0.6941039315194085,0.3058960684805915,home,LAD,under,8,0.5238095238095238,-110,0.5021154452028288,LAD,DET,2023 REG,3,2,7,4,6,10,0,1,-2,2,1,1,0,0,0,0,0,0,0,0.4978845547971712,0.5021154452028288
90099,0.49019607843137253,0.5515695067264574,104,-123,0.4697227523736127,0.5302772476263873,away,STL,over,11,0.5370370370370371,-116,0.5118817074154765,KC,STL,2023 REG,16,12,11,8,20,27,1,0,4,-4,1,1,1,1,1,1,1,1,0,0.5118817074154765,0.48811829258452355
90099,0.49019607843137253,0.5515695067264574,104,-123,0.4697227523736127,0.5302772476263873,home,KC,under,11,0.5098039215686274,-104,0.48811829258452355,KC,STL,2023 REG,16,12,11,8,20,27,1,0,4,-4,1,1,1,1,1,1,1,1,0,0.5118817074154765,0.48811829258452355
90100,0.5073891625615764,0.5348837209302326,-103,-115,0.4859403596076043,0.5140596403923957,away,TB,over,7,0.5412844036697247,-118,0.5149381613977361,SEA,TB,2023 REG,13,8,5,3,11,18,1,0,5,-5,1,1,1,0,0,0,0,0,0,0.5149381613977361,0.48506183860226393
90100,0.5073891625615764,0.5348837209302326,-103,-115,0.4859403596076043,0.5140596403923957,home,SEA,under,7,0.5073891625615764,-103,0.48506183860226393,SEA,TB,2023 REG,13,8,5,3,11,18,1,0,5,-5,1,1,1,0,0,0,0,0,0,0.5149381613977361,0.48506183860226393
90101,0.47619047619047616,0.5652173913043479,110,-130,0.4564724440500838,0.5435275559499162,away,NYY,over,8.5,0.5348837209302326,-115,0.5097020142727117,BAL,NYY,2023 REG,10,7,9,6,13,19,1,0,1,-1,1,1,1,1,1,1,0,0,0,0.5097020142727117,0.49029798572728833
90101,0.47619047619047616,0.5652173913043479,110,-130,0.4564724440500838,0.5435275559499162,home,BAL,under,8.5,0.5121951219512195,-105,0.49029798572728833,BAL,NYY,2023 REG,10,7,9,6,13,19,1,0,1,-1,1,1,1,1,1,1,0,0,0,0.5097020142727117,0.49029798572728833
90102,0.6000000000000001,0.4347826086956522,-150,130,0.5791304347826086,0.4208695652173914,away,PIT,over,8.5,0.5370370370370371,-116,0.5118817074154765,CHC,PIT,2023 REG,13,10,12,6,16,25,1,0,4,-4,1,1,1,1,1,1,0,0,0,0.5118817074154765,0.48811829258452355
90102,0.6000000000000001,0.4347826086956522,-150,130,0.5791304347826086,0.4208695652173914,home,CHC,under,8.5,0.5098039215686274,-104,0.48811829258452355,CHC,PIT,2023 REG,13,10,12,6,16,25,1,0,4,-4,1,1,1,1,1,1,0,0,0,0.5118817074154765,0.48811829258452355
90103,0.7409326424870467,0.29850746268656714,-286,235,0.7117101811407941,0.2882898188592059,away,OAK,over,9.5,0.5145631067961165,-106,0.49023796582517226,LAD,OAK,2023 REG,13,10,6,1,11,19,1,0,9,-9,1,0,0,0,0,0,0,0,0,0.49023796582517226,0.5097620341748277
90103,0.7409326424870467,0.29850746268656714,-286,235,0.7117101811407941,0.2882898188592059,home,LAD,under,9.5,0.5327102803738317,-114,0.5097620341748277,LAD,OAK,2023 REG,13,10,6,1,11,19,1,0,9,-9,1,0,0,0,0,0,0,0,0,0.49023796582517226,0.5097620341748277
90104,0.6923076923076923,0.3508771929824561,-225,185,0.6624104640298972,0.33758953597010277,away,KC,over,9.5,0.5348837209302326,-115,0.5109810284308424,LAA,KC,2023 REG,7,4,8,3,7,15,1,0,1,-1,1,1,1,0,0,0,0,0,0,0.5109810284308424,0.48901897156915763
90104,0.6923076923076923,0.3508771929824561,-225,185,0.6624104640298972,0.33758953597010277,home,LAA,under,9.5,0.5098039215686274,-104,0.48901897156915763,LAA,KC,2023 REG,7,4,8,3,7,15,1,0,1,-1,1,1,1,0,0,0,0,0,0,0.5109810284308424,0.48901897156915763
90105,0.37735849056603776,0.6610169491525424,165,-195,0.36287719255902645,0.6371228074409736,away,SF,over,8.5,0.5454545454545454,-120,0.5206611570247933,WSH,SF,2023 REG,14,10,5,1,11,19,1,0,9,-9,1,0,0,0,0,0,0,0,0,0.5206611570247933,0.4793388429752067
90105,0.37735849056603776,0.6610169491525424,165,-195,0.36287719255902645,0.6371228074409736,home,WSH,under,8.5,0.5,100,0.4793388429752067,WSH,SF,2023 REG,14,10,5,1,11,19,1,0,9,-9,1,0,0,0,0,0,0,0,0,0.5206611570247933,0.4793388429752067
90106,0.5121951219512195,0.5348837209302326,-105,-115,0.48808156828023186,0.5119184317197681,away,NYY,over,9.5,0.5305164319248826,-113,0.5053568787472517,CLE,NYY,2023 REG,6,3,7,4,7,13,0,1,-1,1,1,1,1,0,0,0,0,0,0,0.5053568787472517,0.49464312125274834
90106,0.5121951219512195,0.5348837209302326,-105,-115,0.48808156828023186,0.5119184317197681,home,CLE,under,9.5,0.5169082125603864,-107,0.49464312125274834,CLE,NYY,2023 REG,6,3,7,4,7,13,0,1,-1,1,1,1,1,0,0,0,0,0,0,0.5053568787472517,0.49464312125274834
90107,0.6376811594202898,0.40322580645161293,-176,148,0.6115955579947286,0.38840444200527136,away,HOU,over,8.5,0.5169082125603864,-107,0.49353874091423283,TEX,HOU,2023 REG,5,3,8,5,8,13,0,1,-2,2,1,1,1,0,0,0,0,0,0,0.49353874091423283,0.5064612590857671
90107,0.6376811594202898,0.40322580645161293,-176,148,0.6115955579947286,0.38840444200527136,home,TEX,under,8.5,0.5283018867924528,-112,0.5064612590857671,TEX,HOU,2023 REG,5,3,8,5,8,13,0,1,-2,2,1,1,1,0,0,0,0,0,0,0.49353874091423283,0.5064612590857671
90108,0.5121951219512195,0.5348837209302326,-105,-115,0.48808156828023186,0.5119184317197681,away,SEA,over,7.5,0.5121951219512195,-105,0.48808156828023186,NYM,SEA,2023 REG,9,2,7,1,3,16,1,0,1,-1,1,0,0,0,0,0,0,0,0,0.48808156828023186,0.5119184317197681
90108,0.5121951219512195,0.5348837209302326,-105,-115,0.48808156828023186,0.5119184317197681,home,NYM,under,7.5,0.5348837209302326,-115,0.5119184317197681,NYM,SEA,2023 REG,9,2,7,1,3,16,1,0,1,-1,1,0,0,0,0,0,0,0,0,0.48808156828023186,0.5119184317197681
90109,0.7101449275362319,0.3389830508474576,-245,195,0.6752569428869452,0.32474305711305484,away,WSH,over,8,0.5412844036697247,-118,0.5149381613977361,SF,WSH,2023 REG,10,4,10,1,5,20,1,0,3,-3,1,0,0,0,0,0,0,0,0,0.5149381613977361,0.48506183860226393
90109,0.7101449275362319,0.3389830508474576,-245,195,0.6752569428869452,0.32474305711305484,home,SF,under,8,0.5073891625615764,-103,0.48506183860226393,SF,WSH,2023 REG,10,4,10,1,5,20,1,0,3,-3,1,0,0,0,0,0,0,0,0,0.5149381613977361,0.48506183860226393
90110,0.5024875621890548,0.5412844036697247,-101,-118,0.48049269377245407,0.5195073062275459,away,BAL,over,9.5,0.5169082125603864,-107,0.49239402434819424,BOS,BAL,2023 REG,8,7,7,3,10,15,1,0,4,-4,1,1,1,0,0,0,0,0,0,0.49239402434819424,0.5076059756518058
90110,0.5024875621890548,0.5412844036697247,-101,-118,0.48049269377245407,0.5195073062275459,home,BOS,under,9.5,0.5305164319248826,-113,0.5076059756518058,BOS,BAL,2023 REG,8,7,7,3,10,15,1,0,4,-4,1,1,1,0,0,0,0,0,0,0.49239402434819424,0.5076059756518058
90111,0.635036496350365,0.4065040650406504,-174,146,0.6086567237881874,0.39134327621181264,away,ARI,over,8,0.5238095238095238,-110,0.4988662131519274,STL,ARI,2023 REG,8,7,14,8,15,22,0,1,-1,1,1,1,1,1,1,1,1,0,0,0.4988662131519274,0.5011337868480725
90111,0.635036496350365,0.4065040650406504,-174,146,0.6086567237881874,0.39134327621181264,home,STL,under,8,0.5238095238095238,-110,0.5011337868480725,STL,ARI,2023 REG,8,7,14,8,15,22,0,1,-1,1,1,1,1,1,1,1,1,0,0,0.4988662131519274,0.5011337868480725
90112,0.5260663507109005,0.5169082125603864,-111,-107,0.5034588790373798,0.49654112096262015,away,BAL,over,9,0.5145631067961165,-106,0.4913668392989033,NYY,BAL,2023 REG,6,3,10,6,9,16,0,1,-3,3,1,1,1,0,0,0,0,0,0,0.4913668392989033,0.5086331607010968
90112,0.5260663507109005,0.5169082125603864,-111,-107,0.5034588790373798,0.49654112096262015,home,NYY,under,9,0.5305164319248826,-113,0.5086331607010968,NYY,BAL,2023 REG,6,3,10,6,9,16,0,1,-3,3,1,1,1,0,0,0,0,0,0,0.4913668392989033,0.5086331607010968
90113,0.5215311004784688,0.5238095238095238,-109,-110,0.4978845547971712,0.5021154452028288,away,CLE,over,7.5,0.5283018867924528,-112,0.5031902949311281,CHC,CLE,2023 REG,8,6,10,8,14,18,0,1,-2,2,1,1,1,1,1,1,0,0,0,0.5031902949311281,0.4968097050688719
90113,0.5215311004784688,0.5238095238095238,-109,-110,0.4978845547971712,0.5021154452028288,home,CHC,under,7.5,0.5192307692307692,-108,0.4968097050688719,CHC,CLE,2023 REG,8,6,10,8,14,18,0,1,-2,2,1,1,1,1,1,1,0,0,0,0.5031902949311281,0.4968097050688719
90114,0.4291845493562232,0.607843137254902,133,-155,0.41329283836432396,0.586707161635676,away,LAD,over,8.5,0.5145631067961165,-106,0.4913668392989033,SF,LAD,2023 REG,7,5,3,0,5,10,1,0,5,-5,0,0,0,0,0,0,0,0,0,0.4913668392989033,0.5086331607010968
90114,0.4291845493562232,0.607843137254902,133,-155,0.41329283836432396,0.586707161635676,home,SF,under,8.5,0.5305164319248826,-113,0.5086331607010968,SF,LAD,2023 REG,7,5,3,0,5,10,1,0,5,-5,0,0,0,0,0,0,0,0,0,0.4913668392989033,0.5086331607010968
90115,0.5652173913043479,0.47619047619047616,-130,110,0.5418129444594474,0.4581870555405526,away,LAA,over,8,0.5348837209302326,-115,0.5097020142727117,DET,LAA,2023 REG,12,6,12,7,13,24,0,1,-1,1,1,1,1,1,1,1,0,0,0,0.5097020142727117,0.49029798572728833
90115,0.5652173913043479,0.47619047619047616,-130,110,0.5418129444594474,0.4581870555405526,home,DET,under,8,0.5121951219512195,-105,0.49029798572728833,DET,LAA,2023 REG,12,6,12,7,13,24,0,1,-1,1,1,1,1,1,1,1,0,0,0,0.5097020142727117,0.49029798572728833
90116,0.5121951219512195,0.5348837209302326,-105,-115,0.48808156828023186,0.5119184317197681,away,ARI,over,7,0.5238095238095238,-110,0.4988662131519274,NYY,ARI,2023 REG,6,1,8,7,8,14,0,1,-6,6,1,0,0,0,0,0,0,0,0,0.4988662131519274,0.5011337868480725
90116,0.5121951219512195,0.5348837209302326,-105,-115,0.48808156828023186,0.5119184317197681,home,NYY,under,7,0.5238095238095238,-110,0.5011337868480725,NYY,ARI,2023 REG,6,1,8,7,8,14,0,1,-6,6,1,0,0,0,0,0,0,0,0,0.4988662131519274,0.5011337868480725
90117,0.6363636363636364,0.4081632653061224,-175,145,0.6080283353010626,0.3919716646989374,away,DET,over,8,0.5121951219512195,-105,0.48808156828023186,SEA,DET,2023 REG,6,2,6,0,2,12,1,0,2,-2,0,0,0,0,0,0,0,0,0,0.48808156828023186,0.5119184317197681
90117,0.6363636363636364,0.4081632653061224,-175,145,0.6080283353010626,0.3919716646989374,home,SEA,under,8,0.5348837209302326,-115,0.5119184317197681,SEA,DET,2023 REG,6,2,6,0,2,12,1,0,2,-2,0,0,0,0,0,0,0,0,0,0.48808156828023186,0.5119184317197681
90118,0.4608294930875576,0.5780590717299579,117,-137,0.44290849547579936,0.5570915045242006,away,TOR,over,9.5,0.5238095238095238,-110,0.4988662131519274,CWS,TOR,2023 REG,9,4,16,5,9,25,0,1,-1,1,1,1,1,1,0,0,0,0,0,0.4988662131519274,0.5011337868480725
90118,0.4608294930875576,0.5780590717299579,117,-137,0.44290849547579936,0.5570915045242006,home,CWS,under,9.5,0.5238095238095238,-110,0.5011337868480725,CWS,TOR,2023 REG,9,4,16,5,9,25,0,1,-1,1,1,1,1,1,0,0,0,0,0,0.4988662131519274,0.5011337868480725
90119,0.6774193548387096,0.36764705882352944,-210,172,0.6468904939707413,0.3531095060292587,away,STL,over,9,0.5121951219512195,-105,0.48808156828023186,PHI,STL,2023 REG,11,3,2,0,3,13,1,0,3,-3,0,0,0,0,0,0,0,0,0,0.48808156828023186,0.5119184317197681
90119,0.6774193548387096,0.36764705882352944,-210,172,0.6468904939707413,0.3531095060292587,home,PHI,under,9,0.5348837209302326,-115,0.5119184317197681,PHI,STL,2023 REG,11,3,2,0,3,13,1,0,3,-3,0,0,0,0,0,0,0,0,0,0.48808156828023186,0.5119184317197681
90120,0.6240601503759399,0.41493775933609955,-166,141,0.5997231089766972,0.40027689102330277,away,COL,over,8.5,0.5348837209302326,-115,0.5097020142727117,MIA,COL,2023 REG,9,3,6,4,7,15,0,1,-1,1,1,1,1,0,0,0,0,0,0,0.5097020142727117,0.49029798572728833
90120,0.6240601503759399,0.41493775933609955,-166,141,0.5997231089766972,0.40027689102330277,home,MIA,under,8.5,0.5121951219512195,-105,0.49029798572728833,MIA,COL,2023 REG,9,3,6,4,7,15,0,1,-1,1,1,1,1,0,0,0,0,0,0,0.5097020142727117,0.49029798572728833
90121,0.3076923076923077,0.7340425531914894,225,-276,0.29485081203575475,0.7051491879642453,away,HOU,over,8.5,0.5169082125603864,-107,0.49353874091423283,OAK,HOU,2023 REG,5,2,9,5,7,14,0,1,-3,3,1,1,0,0,0,0,0,0,0,0.49353874091423283,0.5064612590857671
90121,0.3076923076923077,0.7340425531914894,225,-276,0.29485081203575475,0.7051491879642453,home,OAK,under,8.5,0.5283018867924528,-112,0.5064612590857671,OAK,HOU,2023 REG,5,2,9,5,7,14,0,1,-3,3,1,1,0,0,0,0,0,0,0,0.49353874091423283,0.5064612590857671
90122,0.5348837209302326,0.5098039215686274,-115,-104,0.5109810284308424,0.48901897156915763,away,ATL,over,8.5,0.5348837209302326,-115,0.5097020142727117,MIA,ATL,2023 REG,10,3,12,6,9,22,0,1,-3,3,1,1,1,0,0,0,0,0,0,0.5097020142727117,0.49029798572728833
90122,0.5348837209302326,0.5098039215686274,-115,-104,0.5109810284308424,0.48901897156915763,home,MIA,under,8.5,0.5121951219512195,-105,0.49029798572728833,MIA,ATL,2023 REG,10,3,12,6,9,22,0,1,-3,3,1,1,1,0,0,0,0,0,0,0.5097020142727117,0.49029798572728833
90123,0.7142857142857143,0.3333333333333333,-250,200,0.6802721088435374,0.3197278911564626,away,MIA,over,9,0.5238095238095238,-110,0.4988662131519274,ATL,MIA,2023 REG,10,7,10,4,11,20,1,0,3,-3,1,1,1,1,0,0,0,0,0,0.4988662131519274,0.5011337868480725
90123,0.7142857142857143,0.3333333333333333,-250,200,0.6802721088435374,0.3197278911564626,home,ATL,under,9,0.5238095238095238,-110,0.5011337868480725,ATL,MIA,2023 REG,10,7,10,4,11,20,1,0,3,-3,1,1,1,1,0,0,0,0,0,0.4988662131519274,0.5011337868480725
90124,0.4347826086956522,0.6000000000000001,130,-150,0.4196597353497164,0.5803402646502835,away,CWS,over,9,0.504950495049505,-102,0.4826715732667395,KC,CWS,2023 REG,5,2,6,4,6,11,0,1,-2,2,1,1,0,0,0,0,0,0,0,0.4826715732667395,0.5173284267332605
90124,0.4347826086956522,0.6000000000000001,130,-150,0.4196597353497164,0.5803402646502835,home,KC,under,9,0.5391705069124424,-117,0.5173284267332605,KC,CWS,2023 REG,5,2,6,4,6,11,0,1,-2,2,1,1,0,0,0,0,0,0,0,0.4826715732667395,0.5173284267332605
90125,0.6108949416342413,0.425531914893617,-157,135,0.5886419592417365,0.41135804075826354,away,CHC,over,7.5,0.5121951219512195,-105,0.48919479393107135,MIN,CHC,2023 REG,5,2,11,6,8,16,0,1,-4,4,1,1,0,0,0,0,0,0,0,0.48919479393107135,0.5108052060689287
90125,0.6108949416342413,0.425531914893617,-157,135,0.5886419592417365,0.41135804075826354,home,MIN,under,7.5,0.5327102803738317,-114,0.5108052060689287,MIN,CHC,2023 REG,5,2,11,6,8,16,0,1,-4,4,1,1,0,0,0,0,0,0,0,0.48919479393107135,0.5108052060689287
90126,0.7354497354497355,0.30303030303030304,-278,230,0.7071496013294954,0.29285039867050455,away,WSH,over,10,0.5238095238095238,-110,0.4988662131519274,ATL,WSH,2023 REG,17,6,10,10,16,27,0,1,-4,4,1,1,1,1,1,1,0,0,0,0.4988662131519274,0.5011337868480725
90126,0.7354497354497355,0.30303030303030304,-278,230,0.7071496013294954,0.29285039867050455,home,ATL,under,10,0.5238095238095238,-110,0.5011337868480725,ATL,WSH,2023 REG,17,6,10,10,16,27,0,1,-4,4,1,1,1,1,1,1,0,0,0,0.4988662131519274,0.5011337868480725
90127,0.613899613899614,0.425531914893617,-159,135,0.589692613597978,0.410307386402022,away,KC,over,8,0.5098039215686274,-104,0.48592421718142587,DET,KC,2023 REG,7,6,8,3,9,15,1,0,3,-3,1,1,1,0,0,0,0,0,0,0.48592421718142587,0.5140757828185741
90127,0.613899613899614,0.425531914893617,-159,135,0.589692613597978,0.410307386402022,home,DET,under,8,0.5370370370370371,-116,0.5140757828185741,DET,KC,2023 REG,7,6,8,3,9,15,1,0,3,-3,1,1,1,0,0,0,0,0,0,0.48592421718142587,0.5140757828185741
90128,0.6610169491525424,0.37735849056603776,-195,165,0.6356501330673793,0.3643498669326207,away,LAA,over,8.5,0.5260663507109005,-111,0.5010269332605688,TOR,LAA,2023 REG,8,4,9,1,5,17,1,0,3,-3,1,0,0,0,0,0,0,0,0,0.5010269332605688,0.4989730667394312
90128,0.6610169491525424,0.37735849056603776,-195,165,0.6356501330673793,0.3643498669326207,home,TOR,under,8.5,0.5215311004784688,-109,0.4989730667394312,TOR,LAA,2023 REG,8,4,9,1,5,17,1,0,3,-3,1,0,0,0,0,0,0,0,0,0.5010269332605688,0.4989730667394312
90129,0.3846153846153846,0.6551724137931035,160,-190,0.3693123852275045,0.6306876147724956,away,ARI,over,9,0.5348837209302326,-115,0.5097020142727117,CWS,ARI,2023 REG,8,0,4,3,3,12,0,1,-3,3,0,0,0,0,0,0,0,0,0,0.5097020142727117,0.49029798572728833
90129,0.3846153846153846,0.6551724137931035,160,-190,0.3693123852275045,0.6306876147724956,home,CWS,under,9,0.5121951219512195,-105,0.49029798572728833,CWS,ARI,2023 REG,8,0,4,3,3,12,0,1,-3,3,0,0,0,0,0,0,0,0,0,0.5097020142727117,0.49029798572728833
90130,0.6923076923076923,0.3472222222222222,-225,188,0.6649408284023669,0.3350591715976331,away,WSH,over,10.5,0.5454545454545454,-120,0.5206611570247933,ATL,WSH,2023 REG,11,9,15,10,19,26,0,1,-1,1,1,1,1,1,1,1,1,1,1,0.5206611570247933,0.4793388429752067
90130,0.6923076923076923,0.3472222222222222,-225,188,0.6649408284023669,0.3350591715976331,home,ATL,under,10.5,0.5,100,0.4793388429752067,ATL,WSH,2023 REG,11,9,15,10,19,26,0,1,-1,1,1,1,1,1,1,1,1,1,1,0.5206611570247933,0.4793388429752067
90131,0.47619047619047616,0.5652173913043479,110,-130,0.4564724440500838,0.5435275559499162,away,NYY,over,8.5,0.5305164319248826,-113,0.5066009958897986,BAL,NYY,2023 REG,4,1,4,0,1,8,1,0,1,-1,0,0,0,0,0,0,0,0,0,0.5066009958897986,0.49339900411020143
90131,0.47619047619047616,0.5652173913043479,110,-130,0.4564724440500838,0.5435275559499162,home,BAL,under,8.5,0.5145631067961165,-106,0.49339900411020143,BAL,NYY,2023 REG,4,1,4,0,1,8,1,0,1,-1,0,0,0,0,0,0,0,0,0,0.5066009958897986,0.49339900411020143
90132,0.5689655172413793,0.4716981132075471,-132,112,0.5458293137100936,0.4541706862899064,away,PIT,over,8.5,0.5145631067961165,-106,0.49023796582517226,MIL,PIT,2023 REG,16,14,6,1,15,22,1,0,13,-13,1,0,0,0,0,0,0,0,0,0.49023796582517226,0.5097620341748277
90132,0.5689655172413793,0.4716981132075471,-132,112,0.5458293137100936,0.4541706862899064,home,MIL,under,8.5,0.5327102803738317,-114,0.5097620341748277,MIL,PIT,2023 REG,16,14,6,1,15,22,1,0,13,-13,1,0,0,0,0,0,0,0,0,0.49023796582517226,0.5097620341748277
90133,0.574468085106383,0.46511627906976744,-135,115,0.5517281312179562,0.44827186878204384,away,CIN,over,8.5,0.5098039215686274,-104,0.48592421718142587,DET,CIN,2023 REG,7,3,5,4,7,12,0,1,-1,1,1,1,1,0,0,0,0,0,0,0.48592421718142587,0.5140757828185741
90133,0.574468085106383,0.46511627906976744,-135,115,0.5517281312179562,0.44827186878204384,home,DET,under,8.5,0.5370370370370371,-116,0.5140757828185741,DET,CIN,2023 REG,7,3,5,4,7,12,0,1,-1,1,1,1,1,0,0,0,0,0,0,0.48592421718142587,0.5140757828185741
90134,0.47619047619047616,0.5652173913043479,110,-130,0.4564724440500838,0.5435275559499162,away,MIN,over,8.5,0.5391705069124424,-117,0.5153817639191344,DET,MIN,2023 REG,7,1,6,4,5,13,0,1,-3,3,1,0,0,0,0,0,0,0,0,0.5153817639191344,0.4846182360808656
90134,0.47619047619047616,0.5652173913043479,110,-130,0.4564724440500838,0.5435275559499162,home,DET,under,8.5,0.504950495049505,-102,0.4846182360808656,DET,MIN,2023 REG,7,1,6,4,5,13,0,1,-3,3,1,0,0,0,0,0,0,0,0,0.5153817639191344,0.4846182360808656
90135,0.5594713656387665,0.48309178743961345,-127,107,0.5356585002601133,0.4643414997398867,away,NYY,over,10,0.5145631067961165,-106,0.49023796582517226,BOS,NYY,2023 REG,17,15,10,5,20,27,1,0,10,-10,1,1,1,1,1,0,0,0,0,0.49023796582517226,0.5097620341748277
90135,0.5594713656387665,0.48309178743961345,-127,107,0.5356585002601133,0.4643414997398867,home,BOS,under,10,0.5327102803738317,-114,0.5097620341748277,BOS,NYY,2023 REG,17,15,10,5,20,27,1,0,10,-10,1,1,1,1,1,0,0,0,0,0.49023796582517226,0.5097620341748277
90136,0.6721311475409836,0.36363636363636365,-205,175,0.6480906892086682,0.3519093107913318,away,WSH,over,10,0.5348837209302326,-115,0.5109810284308424,ATL,WSH,2023 REG,8,3,6,2,5,14,1,0,1,-1,1,1,0,0,0,0,0,0,0,0.5109810284308424,0.48901897156915763
90136,0.6721311475409836,0.36363636363636365,-205,175,0.6480906892086682,0.3519093107913318,home,ATL,under,10,0.5098039215686274,-104,0.48901897156915763,ATL,WSH,2023 REG,8,3,6,2,5,14,1,0,1,-1,1,1,0,0,0,0,0,0,0,0.5109810284308424,0.48901897156915763
90137,0.6108949416342413,0.425531914893617,-157,135,0.5886419592417365,0.41135804075826354,away,BOS,over,8.5,0.5454545454545454,-120,0.5206611570247933,TB,BOS,2023 REG,5,1,3,0,1,8,1,0,1,-1,0,0,0,0,0,0,0,0,0,0.5206611570247933,0.4793388429752067
90137,0.6108949416342413,0.425531914893617,-157,135,0.5886419592417365,0.41135804075826354,home,TB,under,8.5,0.5,100,0.4793388429752067,TB,BOS,2023 REG,5,1,3,0,1,8,1,0,1,-1,0,0,0,0,0,0,0,0,0,0.5206611570247933,0.4793388429752067
90138,0.43859649122807015,0.6000000000000001,128,-150,0.4216682056017235,0.5783317943982764,away,MIA,over,10,0.5238095238095238,-110,0.5000596729920038,CIN,MIA,2023 REG,6,2,7,3,5,13,0,1,-1,1,1,1,0,0,0,0,0,0,0,0.5000596729920038,0.4999403270079962
90138,0.43859649122807015,0.6000000000000001,128,-150,0.4216682056017235,0.5783317943982764,home,CIN,under,10,0.5215311004784688,-109,0.4999403270079962,CIN,MIA,2023 REG,6,2,7,3,5,13,0,1,-1,1,1,1,0,0,0,0,0,0,0,0.5000596729920038,0.4999403270079962
90139,0.5283018867924528,0.5121951219512195,-112,-105,0.5069072406637203,0.4930927593362797,away,STL,over,8,0.5327102803738317,-114,0.5075272610403079,CWS,STL,2023 REG,9,8,16,7,15,25,1,0,1,-1,1,1,1,1,1,1,1,0,0,0.5075272610403079,0.4924727389596921
90139,0.5283018867924528,0.5121951219512195,-112,-105,0.5069072406637203,0.4930927593362797,home,CWS,under,8,0.5145631067961165,-106,0.4924727389596921,CWS,STL,2023 REG,9,8,16,7,15,25,1,0,1,-1,1,1,1,1,1,1,1,0,0,0.5075272610403079,0.4924727389596921
90140,0.7590361445783133,0.28169014084507044,-315,255,0.7281234219075522,0.2718765780924478,away,LAA,over,7.5,0.5348837209302326,-115,0.5097020142727117,SEA,LAA,2023 REG,5,3,6,2,5,11,1,0,1,-1,1,1,0,0,0,0,0,0,0,0.5097020142727117,0.49029798572728833
90140,0.7590361445783133,0.28169014084507044,-315,255,0.7281234219075522,0.2718765780924478,home,SEA,under,7.5,0.5121951219512195,-105,0.49029798572728833,SEA,LAA,2023 REG,5,3,6,2,5,11,1,0,1,-1,1,1,0,0,0,0,0,0,0,0.5097020142727117,0.49029798572728833
90141,0.5689655172413793,0.4672897196261683,-132,114,0.5483375376443265,0.45166246235567353,away,PHI,over,9.5,0.5215311004784688,-109,0.4978845547971712,TB,PHI,2023 REG,4,1,6,3,4,10,0,1,-2,2,1,0,0,0,0,0,0,0,0,0.4978845547971712,0.5021154452028288
90141,0.5689655172413793,0.4672897196261683,-132,114,0.5483375376443265,0.45166246235567353,home,TB,under,9.5,0.5238095238095238,-110,0.5021154452028288,TB,PHI,2023 REG,4,1,6,3,4,10,0,1,-2,2,1,0,0,0,0,0,0,0,0,0.4978845547971712,0.5021154452028288
90142,0.607843137254902,0.425531914893617,-155,135,0.5875563408509002,0.41244365914909975,away,ARI,over,7,0.5454545454545454,-120,0.5206611570247933,SD,ARI,2023 REG,10,6,9,8,14,19,0,1,-2,2,1,1,1,1,1,1,0,0,0,0.5206611570247933,0.4793388429752067
90142,0.607843137254902,0.425531914893617,-155,135,0.5875563408509002,0.41244365914909975,home,SD,under,7,0.5,100,0.4793388429752067,SD,ARI,2023 REG,10,6,9,8,14,19,0,1,-2,2,1,1,1,1,1,1,0,0,0,0.5206611570247933,0.4793388429752067
90143,0.4587155963302753,0.5815899581589958,118,-139,0.4402268098673069,0.5597731901326931,away,TOR,over,8.5,0.5145631067961165,-106,0.4913668392989033,DET,TOR,2023 REG,11,3,5,4,7,16,0,1,-1,1,1,1,1,0,0,0,0,0,0,0.4913668392989033,0.5086331607010968
90143,0.4587155963302753,0.5815899581589958,118,-139,0.4402268098673069,0.5597731901326931,home,DET,under,8.5,0.5305164319248826,-113,0.5086331607010968,DET,TOR,2023 REG,11,3,5,4,7,16,0,1,-1,1,1,1,1,0,0,0,0,0,0,0.4913668392989033,0.5086331607010968
90144,0.574468085106383,0.46511627906976744,-135,115,0.5517281312179562,0.44827186878204384,away,TEX,over,8.5,0.5495495495495495,-122,0.5236866555946829,BAL,TEX,2023 REG,8,2,13,12,14,21,0,1,-10,10,1,1,0,0,0,0,0,0,0,0.5236866555946829,0.47631334440531714
90144,0.574468085106383,0.46511627906976744,-135,115,0.5517281312179562,0.44827186878204384,home,BAL,under,8.5,0.49751243781094534,101,0.47631334440531714,BAL,TEX,2023 REG,8,2,13,12,14,21,0,1,-10,10,1,1,0,0,0,0,0,0,0,0.5236866555946829,0.47631334440531714
90145,0.4347826086956522,0.6062992125984252,130,-154,0.4169209472634447,0.5830790527365552,away,MIL,over,8,0.5121951219512195,-105,0.48808156828023186,CWS,MIL,2023 REG,9,3,7,7,10,16,0,1,-4,4,1,1,1,0,0,0,0,0,0,0.48808156828023186,0.5119184317197681
90145,0.4347826086956522,0.6062992125984252,130,-154,0.4169209472634447,0.5830790527365552,home,CWS,under,8,0.5348837209302326,-115,0.5119184317197681,CWS,MIL,2023 REG,9,3,7,7,10,16,0,1,-4,4,1,1,1,0,0,0,0,0,0,0.48808156828023186,0.5119184317197681
90146,0.5901639344262295,0.4444444444444444,-144,125,0.569739317387799,0.43026068261220096,away,CWS,over,8,0.5238095238095238,-110,0.4988662131519274,NYY,CWS,2023 REG,3,2,7,3,5,10,0,1,-1,1,1,1,0,0,0,0,0,0,0,0.4988662131519274,0.5011337868480725
90146,0.5901639344262295,0.4444444444444444,-144,125,0.569739317387799,0.43026068261220096,home,NYY,under,8,0.5238095238095238,-110,0.5011337868480725,NYY,CWS,2023 REG,3,2,7,3,5,10,0,1,-1,1,1,1,0,0,0,0,0,0,0,0.4988662131519274,0.5011337868480725
90147,0.6794871794871794,0.36363636363636365,-212,175,0.6501852848006694,0.3498147151993306,away,LAA,over,8.5,0.5192307692307692,-108,0.49571111079951763,TB,LAA,2023 REG,9,6,5,2,8,14,1,0,4,-4,1,1,0,0,0,0,0,0,0,0.49571111079951763,0.5042888892004824
90147,0.6794871794871794,0.36363636363636365,-212,175,0.6501852848006694,0.3498147151993306,home,TB,under,8.5,0.5260663507109005,-111,0.5042888892004824,TB,LAA,2023 REG,9,6,5,2,8,14,1,0,4,-4,1,1,0,0,0,0,0,0,0,0.49571111079951763,0.5042888892004824
90148,0.3846153846153846,0.6551724137931035,160,-190,0.3693123852275045,0.6306876147724956,away,PHI,over,9,0.5145631067961165,-106,0.4913668392989033,WSH,PHI,2023 REG,11,8,12,7,15,23,1,0,1,-1,1,1,1,1,1,1,1,0,0,0.4913668392989033,0.5086331607010968
90148,0.3846153846153846,0.6551724137931035,160,-190,0.3693123852275045,0.6306876147724956,home,WSH,under,9,0.5305164319248826,-113,0.5086331607010968,WSH,PHI,2023 REG,11,8,12,7,15,23,1,0,1,-1,1,1,1,1,1,1,1,0,0,0.4913668392989033,0.5086331607010968
90149,0.7101449275362319,0.33557046979865773,-245,198,0.6776803700085567,0.32231962999144326,away,OAK,over,9.5,0.5024875621890548,-101,0.47839724939301687,TEX,OAK,2023 REG,5,3,7,2,5,12,1,0,1,-1,1,1,0,0,0,0,0,0,0,0.47839724939301687,0.5216027506069831
90149,0.7101449275362319,0.33557046979865773,-245,198,0.6776803700085567,0.32231962999144326,home,TEX,under,9.5,0.5454545454545454,-120,0.5216027506069831,TEX,OAK,2023 REG,5,3,7,2,5,12,1,0,1,-1,1,1,0,0,0,0,0,0,0,0.47839724939301687,0.5216027506069831
90150,0.49504950495049505,0.5391705069124424,102,-117,0.4781089050183478,0.5218910949816522,away,CHC,over,7.5,0.5121951219512195,-105,0.48808156828023186,MIA,CHC,2023 REG,8,3,10,2,5,18,1,0,1,-1,1,1,0,0,0,0,0,0,0,0.48808156828023186,0.5119184317197681
90150,0.49504950495049505,0.5391705069124424,102,-117,0.4781089050183478,0.5218910949816522,home,MIA,under,7.5,0.5348837209302326,-115,0.5119184317197681,MIA,CHC,2023 REG,8,3,10,2,5,18,1,0,1,-1,1,1,0,0,0,0,0,0,0,0.48808156828023186,0.5119184317197681
90151,0.44052863436123346,0.6000000000000001,127,-150,0.42267461041355353,0.5773253895864465,away,SD,over,8.5,0.5348837209302326,-115,0.5097020142727117,CWS,SD,2023 REG,6,1,12,6,7,18,0,1,-5,5,1,0,0,0,0,0,0,0,0,0.5097020142727117,0.49029798572728833
90151,0.44052863436123346,0.6000000000000001,127,-150,0.42267461041355353,0.5773253895864465,home,CWS,under,8.5,0.5121951219512195,-105,0.49029798572728833,CWS,SD,2023 REG,6,1,12,6,7,18,0,1,-5,5,1,0,0,0,0,0,0,0,0,0.5097020142727117,0.49029798572728833
90152,0.3472222222222222,0.696969696969697,188,-230,0.3318778058361392,0.6681221941638609,away,NYY,over,11,0.5348837209302326,-115,0.5097020142727117,COL,NYY,2023 REG,8,8,9,7,15,17,1,0,1,-1,1,1,1,1,1,1,1,0,0,0.5097020142727117,0.49029798572728833
90152,0.3472222222222222,0.696969696969697,188,-230,0.3318778058361392,0.6681221941638609,home,COL,under,11,0.5121951219512195,-105,0.49029798572728833,COL,NYY,2023 REG,8,8,9,7,15,17,1,0,1,-1,1,1,1,1,1,1,1,0,0,0.5097020142727117,0.49029798572728833
90153,0.39840637450199207,0.6428571428571428,151,-180,0.3819667261517391,0.6180332738482609,away,MIL,over,8.5,0.5215311004784688,-109,0.4978845547971712,CWS,MIL,2023 REG,10,6,11,7,13,21,0,1,-1,1,1,1,1,1,1,1,0,0,0,0.4978845547971712,0.5021154452028288
90153,0.39840637450199207,0.6428571428571428,151,-180,0.3819667261517391,0.6180332738482609,home,CWS,under,8.5,0.5238095238095238,-110,0.5021154452028288,CWS,MIL,2023 REG,10,6,11,7,13,21,0,1,-1,1,1,1,1,1,1,1,0,0,0,0.4978845547971712,0.5021154452028288
90154,0.6240601503759399,0.4132231404958678,-166,142,0.6007931342679697,0.39920686573203035,away,WSH,over,7.5,0.5283018867924528,-112,0.5044173060022736,MIA,WSH,2023 REG,12,5,8,4,9,20,1,0,1,-1,1,1,1,1,0,0,0,0,0,0.5044173060022736,0.49558269399772636
90154,0.6240601503759399,0.4132231404958678,-166,142,0.6007931342679697,0.39920686573203035,home,MIA,under,7.5,0.5169082125603864,-107,0.49558269399772636,MIA,WSH,2023 REG,12,5,8,4,9,20,1,0,1,-1,1,1,1,1,0,0,0,0,0,0.5044173060022736,0.49558269399772636
90155,0.5192307692307692,0.5238095238095238,-108,-110,0.49688292476754015,0.5031170752324599,away,LAD,over,7.5,0.5454545454545454,-120,0.5206611570247933,SEA,LAD,2023 REG,11,3,8,6,9,19,0,1,-3,3,1,1,1,0,0,0,0,0,0,0.5206611570247933,0.4793388429752067
90155,0.5192307692307692,0.5238095238095238,-108,-110,0.49688292476754015,0.5031170752324599,home,SEA,under,7.5,0.5,100,0.4793388429752067,SEA,LAD,2023 REG,11,3,8,6,9,19,0,1,-3,3,1,1,1,0,0,0,0,0,0,0.5206611570247933,0.4793388429752067
90156,0.37735849056603776,0.6610169491525424,165,-195,0.36287719255902645,0.6371228074409736,away,TOR,over,8.5,0.5348837209302326,-115,0.5097020142727117,OAK,TOR,2023 REG,8,5,8,6,11,16,0,1,-1,1,1,1,1,1,1,0,0,0,0,0.5097020142727117,0.49029798572728833
90156,0.37735849056603776,0.6610169491525424,165,-195,0.36287719255902645,0.6371228074409736,home,OAK,under,8.5,0.5121951219512195,-105,0.49029798572728833,OAK,TOR,2023 REG,8,5,8,6,11,16,0,1,-1,1,1,1,1,1,1,0,0,0,0,0.5097020142727117,0.49029798572728833
90157,0.6503496503496503,0.3861003861003861,-186,159,0.6266443818891371,0.37335561811086293,away,DET,over,7.5,0.5305164319248826,-113,0.5066009958897986,MIN,DET,2023 REG,7,4,11,6,10,18,0,1,-2,2,1,1,1,1,0,0,0,0,0,0.5066009958897986,0.49339900411020143
90157,0.6503496503496503,0.3861003861003861,-186,159,0.6266443818891371,0.37335561811086293,home,MIN,under,7.5,0.5145631067961165,-106,0.49339900411020143,MIN,DET,2023 REG,7,4,11,6,10,18,0,1,-2,2,1,1,1,1,0,0,0,0,0,0.5066009958897986,0.49339900411020143
90158,0.6282527881040892,0.4098360655737705,-169,144,0.6043233595852853,0.39567664041471473,away,MIA,over,9,0.5348837209302326,-115,0.5097020142727117,ATL,MIA,2023 REG,9,7,6,0,7,15,1,0,7,-7,0,0,0,0,0,0,0,0,0,0.5097020142727117,0.49029798572728833
90158,0.6282527881040892,0.4098360655737705,-169,144,0.6043233595852853,0.39567664041471473,home,ATL,under,9,0.5121951219512195,-105,0.49029798572728833,ATL,MIA,2023 REG,9,7,6,0,7,15,1,0,7,-7,0,0,0,0,0,0,0,0,0,0.5097020142727117,0.49029798572728833
90159,0.6296296296296295,0.40322580645161293,-170,148,0.6089428735784769,0.3910571264215231,away,CIN,over,9.5,0.5238095238095238,-110,0.4988662131519274,BOS,CIN,2023 REG,14,8,12,9,17,26,0,1,-1,1,1,1,1,1,1,1,1,1,0,0.4988662131519274,0.5011337868480725
90159,0.6296296296296295,0.40322580645161293,-170,148,0.6089428735784769,0.3910571264215231,home,BOS,under,9.5,0.5238095238095238,-110,0.5011337868480725,BOS,CIN,2023 REG,14,8,12,9,17,26,0,1,-1,1,1,1,1,1,1,1,1,1,0,0.4988662131519274,0.5011337868480725
90160,0.6774193548387096,0.36363636363636365,-210,175,0.6496074165168858,0.3503925834831142,away,COL,over,9,0.5121951219512195,-105,0.48808156828023186,ARI,COL,2023 REG,13,12,6,5,17,19,1,0,7,-7,1,1,1,1,1,0,0,0,0,0.48808156828023186,0.5119184317197681
90160,0.6774193548387096,0.36363636363636365,-210,175,0.6496074165168858,0.3503925834831142,home,ARI,under,9,0.5348837209302326,-115,0.5119184317197681,ARI,COL,2023 REG,13,12,6,5,17,19,1,0,7,-7,1,1,1,1,1,0,0,0,0,0.48808156828023186,0.5119184317197681
90161,0.6389891696750902,0.4,-177,150,0.614075512518083,0.385924487481917,away,KC,over,8.5,0.5145631067961165,-106,0.49023796582517226,TOR,KC,2023 REG,6,5,8,2,7,14,1,0,3,-3,1,1,0,0,0,0,0,0,0,0.49023796582517226,0.5097620341748277
90161,0.6389891696750902,0.4,-177,150,0.614075512518083,0.385924487481917,home,TOR,under,8.5,0.5327102803738317,-114,0.5097620341748277,TOR,KC,2023 REG,6,5,8,2,7,14,1,0,3,-3,1,1,0,0,0,0,0,0,0,0.49023796582517226,0.5097620341748277
90162,0.574468085106383,0.46511627906976744,-135,115,0.5517281312179562,0.44827186878204384,away,MIA,over,8,0.5024875621890548,-101,0.48049269377245407,CLE,MIA,2023 REG,7,2,11,3,5,18,0,1,-1,1,1,1,0,0,0,0,0,0,0,0.48049269377245407,0.5195073062275459
90162,0.574468085106383,0.46511627906976744,-135,115,0.5517281312179562,0.44827186878204384,home,CLE,under,8,0.5412844036697247,-118,0.5195073062275459,CLE,MIA,2023 REG,7,2,11,3,5,18,0,1,-1,1,1,1,0,0,0,0,0,0,0,0.48049269377245407,0.5195073062275459
90163,0.6323529411764706,0.4081632653061224,-172,145,0.6067323988418897,0.3932676011581103,away,CIN,over,8.5,0.5454545454545454,-120,0.5206611570247933,CHC,CIN,2023 REG,8,5,12,8,13,20,0,1,-3,3,1,1,1,1,1,0,0,0,0,0.5206611570247933,0.4793388429752067
90163,0.6323529411764706,0.4081632653061224,-172,145,0.6067323988418897,0.3932676011581103,home,CHC,under,8.5,0.5,100,0.4793388429752067,CHC,CIN,2023 REG,8,5,12,8,13,20,0,1,-3,3,1,1,1,1,1,0,0,0,0,0.5206611570247933,0.4793388429752067
90164,0.6212121212121212,0.4166666666666667,-164,140,0.5976813590449954,0.4023186409550046,away,CHC,over,7.5,0.5073891625615764,-103,0.4837652908580103,MIN,CHC,2023 REG,13,11,6,1,12,19,1,0,10,-10,1,0,0,0,0,0,0,0,0,0.4837652908580103,0.5162347091419897
90164,0.6212121212121212,0.4166666666666667,-164,140,0.5976813590449954,0.4023186409550046,home,MIN,under,7.5,0.5391705069124424,-117,0.5162347091419897,MIN,CHC,2023 REG,13,11,6,1,12,19,1,0,10,-10,1,0,0,0,0,0,0,0,0,0.4837652908580103,0.5162347091419897
90165,0.6825396825396826,0.35714285714285715,-215,180,0.6554547745023935,0.34454522549760647,away,WSH,over,9,0.5,100,0.4772727272727273,TOR,WSH,2023 REG,12,7,5,0,7,17,1,0,7,-7,0,0,0,0,0,0,0,0,0,0.4772727272727273,0.5227272727272727
90165,0.6825396825396826,0.35714285714285715,-215,180,0.6554547745023935,0.34454522549760647,home,TOR,under,9,0.5454545454545454,-120,0.5227272727272727,TOR,WSH,2023 REG,12,7,5,0,7,17,1,0,7,-7,0,0,0,0,0,0,0,0,0,0.4772727272727273,0.5227272727272727
90166,0.48780487804878053,0.5535714285714286,105,-124,0.4676213138438005,0.5323786861561994,away,TEX,over,7.5,0.5327102803738317,-114,0.5075272610403079,MIN,TEX,2023 REG,5,2,9,6,8,14,0,1,-4,4,1,1,0,0,0,0,0,0,0,0.5075272610403079,0.4924727389596921
90166,0.48780487804878053,0.5535714285714286,105,-124,0.4676213138438005,0.5323786861561994,home,MIN,under,7.5,0.5145631067961165,-106,0.4924727389596921,MIN,TEX,2023 REG,5,2,9,6,8,14,0,1,-4,4,1,1,0,0,0,0,0,0,0,0.5075272610403079,0.4924727389596921
90167,0.5098039215686274,0.5348837209302326,-104,-115,0.4870219861770517,0.5129780138229483,away,PHI,over,7.5,0.5305164319248826,-113,0.5066009958897986,TOR,PHI,2023 REG,4,2,4,1,3,8,1,0,1,-1,1,0,0,0,0,0,0,0,0,0.5066009958897986,0.49339900411020143
90167,0.5098039215686274,0.5348837209302326,-104,-115,0.4870219861770517,0.5129780138229483,home,TOR,under,7.5,0.5145631067961165,-106,0.49339900411020143,TOR,PHI,2023 REG,4,2,4,1,3,8,1,0,1,-1,1,0,0,0,0,0,0,0,0,0.5066009958897986,0.49339900411020143
90168,0.3278688524590164,0.7118155619596541,205,-247,0.3148575690430589,0.6851424309569412,away,LAD,over,9,0.5454545454545454,-120,0.5220180091279142,CIN,LAD,2023 REG,6,0,12,6,6,18,0,1,-6,6,0,0,0,0,0,0,0,0,0,0.5220180091279142,0.4779819908720858
90168,0.3278688524590164,0.7118155619596541,205,-247,0.3148575690430589,0.6851424309569412,home,CIN,under,9,0.49751243781094534,101,0.4779819908720858,CIN,LAD,2023 REG,6,0,12,6,6,18,0,1,-6,6,0,0,0,0,0,0,0,0,0,0.5220180091279142,0.4779819908720858
90169,0.7340425531914894,0.3058103975535168,-276,227,0.7047887914744104,0.2952112085255896,away,OAK,over,9,0.5169082125603864,-107,0.49239402434819424,HOU,OAK,2023 REG,9,6,2,2,8,11,1,0,4,-4,1,1,0,0,0,0,0,0,0,0.49239402434819424,0.5076059756518058
90169,0.7340425531914894,0.3058103975535168,-276,227,0.7047887914744104,0.2952112085255896,home,HOU,under,9,0.5305164319248826,-113,0.5076059756518058,HOU,OAK,2023 REG,9,6,2,2,8,11,1,0,4,-4,1,1,0,0,0,0,0,0,0,0.49239402434819424,0.5076059756518058
90170,0.6363636363636364,0.4016064257028112,-175,149,0.6122008695940788,0.3877991304059212,away,NYY,over,8.5,0.5348837209302326,-115,0.5097020142727117,LAD,NYY,2023 REG,4,1,5,4,5,9,0,1,-3,3,1,0,0,0,0,0,0,0,0,0.5097020142727117,0.49029798572728833
90170,0.6363636363636364,0.4016064257028112,-175,149,0.6122008695940788,0.3877991304059212,home,LAD,under,8.5,0.5121951219512195,-105,0.49029798572728833,LAD,NYY,2023 REG,4,1,5,4,5,9,0,1,-3,3,1,0,0,0,0,0,0,0,0,0.5097020142727117,0.49029798572728833
90171,0.5833333333333333,0.4587155963302753,-140,118,0.5588047910295616,0.4411952089704384,away,PHI,over,6.5,0.5454545454545454,-120,0.5206611570247933,TEX,PHI,2023 REG,10,11,12,7,18,22,1,0,4,-4,1,1,1,1,1,1,1,0,0,0.5206611570247933,0.4793388429752067
90171,0.5833333333333333,0.4587155963302753,-140,118,0.5588047910295616,0.4411952089704384,home,TEX,under,6.5,0.5,100,0.4793388429752067,TEX,PHI,2023 REG,10,11,12,7,18,22,1,0,4,-4,1,1,1,1,1,1,1,0,0,0.5206611570247933,0.4793388429752067
90172,0.601593625498008,0.4329004329004329,-151,131,0.58084221984795,0.41915778015204996,away,SEA,over,8.5,0.5495495495495495,-122,0.5236866555946829,ATL,SEA,2023 REG,11,6,8,2,8,19,1,0,4,-4,1,1,0,0,0,0,0,0,0,0.5236866555946829,0.47631334440531714
90172,0.601593625498008,0.4329004329004329,-151,131,0.58084221984795,0.41915778015204996,home,ATL,under,8.5,0.49751243781094534,101,0.47631334440531714,ATL,SEA,2023 REG,11,6,8,2,8,19,1,0,4,-4,1,1,0,0,0,0,0,0,0,0.5236866555946829,0.47631334440531714
90173,0.47619047619047616,0.5670995670995671,110,-131,0.4555761698618841,0.5444238301381159,away,TB,over,8.5,0.5391705069124424,-117,0.5140669063204599,LAA,TB,2023 REG,8,4,19,18,22,27,0,1,-14,14,1,1,1,1,0,0,0,0,0,0.5140669063204599,0.4859330936795401
90173,0.47619047619047616,0.5670995670995671,110,-131,0.4555761698618841,0.5444238301381159,home,LAA,under,8.5,0.5073891625615764,-103,0.4859330936795401,LAA,TB,2023 REG,8,4,19,18,22,27,0,1,-14,14,1,1,1,1,0,0,0,0,0,0.5140669063204599,0.4859330936795401
90174,0.5689655172413793,0.4716981132075471,-132,112,0.5458293137100936,0.4541706862899064,away,CIN,over,7.5,0.5348837209302326,-115,0.5097020142727117,SF,CIN,2023 REG,8,4,6,1,5,14,1,0,3,-3,1,0,0,0,0,0,0,0,0,0.5097020142727117,0.49029798572728833
90174,0.5689655172413793,0.4716981132075471,-132,112,0.5458293137100936,0.4541706862899064,home,SF,under,7.5,0.5121951219512195,-105,0.49029798572728833,SF,CIN,2023 REG,8,4,6,1,5,14,1,0,3,-3,1,0,0,0,0,0,0,0,0,0.5097020142727117,0.49029798572728833
90175,0.390625,0.6503496503496503,156,-186,0.3746192772071678,0.6253807227928322,away,MIL,over,8.5,0.5192307692307692,-108,0.49571111079951763,PIT,MIL,2023 REG,8,5,8,4,9,16,1,0,1,-1,1,1,1,1,0,0,0,0,0,0.49571111079951763,0.5042888892004824
90175,0.390625,0.6503496503496503,156,-186,0.3746192772071678,0.6253807227928322,home,PIT,under,8.5,0.5260663507109005,-111,0.5042888892004824,PIT,MIL,2023 REG,8,5,8,4,9,16,1,0,1,-1,1,1,1,1,0,0,0,0,0,0.49571111079951763,0.5042888892004824
90176,0.6197718631178707,0.42016806722689076,-163,138,0.5950182180753,0.4049817819247,away,SD,over,9.5,0.5283018867924528,-112,0.5031902949311281,LAD,SD,2023 REG,9,8,13,11,19,22,0,1,-3,3,1,1,1,1,1,1,1,1,0,0.5031902949311281,0.4968097050688719
90176,0.6197718631178707,0.42016806722689076,-163,138,0.5950182180753,0.4049817819247,home,LAD,under,9.5,0.5192307692307692,-108,0.4968097050688719,LAD,SD,2023 REG,9,8,13,11,19,22,0,1,-3,3,1,1,1,1,1,1,1,1,0,0.5031902949311281,0.4968097050688719
90177,0.6923076923076923,0.3484320557491289,-225,187,0.6641032513452776,0.3358967486547224,away,ARI,over,9,0.504950495049505,-102,0.4837488699364985,PHI,ARI,2023 REG,6,3,10,6,9,16,0,1,-3,3,1,1,1,0,0,0,0,0,0,0.4837488699364985,0.5162511300635015
90177,0.6923076923076923,0.3484320557491289,-225,187,0.6641032513452776,0.3358967486547224,home,PHI,under,9,0.5370370370370371,-116,0.5162511300635015,PHI,ARI,2023 REG,6,3,10,6,9,16,0,1,-3,3,1,1,1,0,0,0,0,0,0,0.4837488699364985,0.5162511300635015
90178,0.5454545454545454,0.49504950495049505,-120,102,0.5233614270517961,0.4766385729482039,away,HOU,over,9.5,0.5215311004784688,-109,0.49670754937970685,ARI,HOU,2023 REG,4,1,8,2,3,12,0,1,-1,1,1,0,0,0,0,0,0,0,0,0.49670754937970685,0.5032924506202932
90178,0.5454545454545454,0.49504950495049505,-120,102,0.5233614270517961,0.4766385729482039,home,ARI,under,9.5,0.5260663507109005,-111,0.5032924506202932,ARI,HOU,2023 REG,4,1,8,2,3,12,0,1,-1,1,1,0,0,0,0,0,0,0,0,0.49670754937970685,0.5032924506202932
90179,0.7142857142857143,0.3225806451612903,-250,210,0.6879526003949967,0.3120473996050033,away,LAA,over,9,0.5454545454545454,-120,0.5193043049216726,ATL,LAA,2023 REG,7,5,6,1,6,13,1,0,4,-4,1,0,0,0,0,0,0,0,0,0.5193043049216726,0.48069569507832743
90179,0.7142857142857143,0.3225806451612903,-250,210,0.6879526003949967,0.3120473996050033,home,ATL,under,9,0.5024875621890548,-101,0.48069569507832743,ATL,LAA,2023 REG,7,5,6,1,6,13,1,0,4,-4,1,0,0,0,0,0,0,0,0,0.5193043049216726,0.48069569507832743
90180,0.7701149425287357,0.2777777777777778,-335,260,0.7332320429823401,0.2667679570176599,away,CWS,over,8,0.5391705069124424,-117,0.5127649394825569,ATL,CWS,2023 REG,11,5,11,6,11,22,0,1,-1,1,1,1,1,1,1,0,0,0,0,0.5127649394825569,0.48723506051744314
90180,0.7701149425287357,0.2777777777777778,-335,260,0.7332320429823401,0.2667679570176599,home,ATL,under,8,0.5098039215686274,-104,0.48723506051744314,ATL,CWS,2023 REG,11,5,11,6,11,22,0,1,-1,1,1,1,1,1,1,0,0,0,0,0.5127649394825569,0.48723506051744314
90181,0.5238095238095238,0.5169082125603864,-110,-107,0.5024811857109994,0.4975188142890006,away,HOU,over,9.5,0.5348837209302326,-115,0.5097020142727117,TEX,HOU,2023 REG,9,6,16,13,19,25,0,1,-7,7,1,1,1,1,1,1,0,0,0,0.5097020142727117,0.49029798572728833
90181,0.5238095238095238,0.5169082125603864,-110,-107,0.5024811857109994,0.4975188142890006,home,TEX,under,9.5,0.5121951219512195,-105,0.49029798572728833,TEX,HOU,2023 REG,9,6,16,13,19,25,0,1,-7,7,1,1,1,1,1,1,0,0,0,0.5097020142727117,0.49029798572728833
90182,0.6254681647940076,0.41152263374485604,-167,143,0.6023315979176397,0.3976684020823603,away,CIN,over,8.5,0.5348837209302326,-115,0.5097020142727117,CHC,CIN,2023 REG,21,20,12,9,29,33,1,0,11,-11,1,1,1,1,1,1,1,1,1,0.5097020142727117,0.49029798572728833
90182,0.6254681647940076,0.41152263374485604,-167,143,0.6023315979176397,0.3976684020823603,home,CHC,under,8.5,0.5121951219512195,-105,0.49029798572728833,CHC,CIN,2023 REG,21,20,12,9,29,33,1,0,11,-11,1,1,1,1,1,1,1,1,1,0.5097020142727117,0.49029798572728833
90183,0.6254681647940076,0.41152263374485604,-167,143,0.6023315979176397,0.3976684020823603,away,CLE,over,7.5,0.5145631067961165,-106,0.4913668392989033,MIN,CLE,2023 REG,7,2,11,4,6,18,0,1,-2,2,1,1,0,0,0,0,0,0,0,0.4913668392989033,0.5086331607010968
90183,0.6254681647940076,0.41152263374485604,-167,143,0.6023315979176397,0.3976684020823603,home,MIN,under,7.5,0.5305164319248826,-113,0.5086331607010968,MIN,CLE,2023 REG,7,2,11,4,6,18,0,1,-2,2,1,1,0,0,0,0,0,0,0,0.4913668392989033,0.5086331607010968
90184,0.5726495726495727,0.4694835680751174,-134,113,0.5485220476191947,0.45147795238080535,away,DET,over,8.5,0.5348837209302326,-115,0.5097020142727117,WSH,DET,2023 REG,18,6,6,4,10,24,1,0,2,-2,1,1,1,1,0,0,0,0,0,0.5097020142727117,0.49029798572728833
90184,0.5726495726495727,0.4694835680751174,-134,113,0.5485220476191947,0.45147795238080535,home,WSH,under,8.5,0.5121951219512195,-105,0.49029798572728833,WSH,DET,2023 REG,18,6,6,4,10,24,1,0,2,-2,1,1,1,1,0,0,0,0,0,0.5097020142727117,0.49029798572728833
90185,0.5555555555555556,0.48309178743961345,-125,107,0.5340848094471283,0.46591519055287167,away,STL,over,9.5,0.5098039215686274,-104,0.48592421718142587,CWS,STL,2023 REG,5,3,5,4,7,10,0,1,-1,1,1,1,1,0,0,0,0,0,0,0.48592421718142587,0.5140757828185741
90185,0.5555555555555556,0.48309178743961345,-125,107,0.5340848094471283,0.46591519055287167,home,CWS,under,9.5,0.5370370370370371,-116,0.5140757828185741,CWS,STL,2023 REG,5,3,5,4,7,10,0,1,-1,1,1,1,1,0,0,0,0,0,0,0.48592421718142587,0.5140757828185741
90186,0.4716981132075471,0.5652173913043479,112,-130,0.4542851393811816,0.5457148606188185,away,TOR,over,9,0.5,100,0.4772727272727273,PIT,TOR,2023 REG,8,1,15,10,11,23,0,1,-9,9,1,0,0,0,0,0,0,0,0,0.4772727272727273,0.5227272727272727
90186,0.4716981132075471,0.5652173913043479,112,-130,0.4542851393811816,0.5457148606188185,home,PIT,under,9,0.5454545454545454,-120,0.5227272727272727,PIT,TOR,2023 REG,8,1,15,10,11,23,0,1,-9,9,1,0,0,0,0,0,0,0,0,0.4772727272727273,0.5227272727272727
90187,0.43859649122807015,0.6000000000000001,128,-150,0.4216682056017235,0.5783317943982764,away,LAD,over,17.5,0.49504950495049505,102,0.4615351100989763,STL,LAD,2023 REG,12,16,9,8,24,21,1,0,8,-8,1,1,1,1,1,1,1,1,0,0.4615351100989763,0.5384648899010237
90187,0.43859649122807015,0.6000000000000001,128,-150,0.4216682056017235,0.5783317943982764,home,STL,under,17.5,0.5726495726495727,-134,0.5384648899010237,STL,LAD,2023 REG,12,16,9,8,24,21,1,0,8,-8,1,1,1,1,1,1,1,1,0,0.4615351100989763,0.5384648899010237
90188,0.5495495495495495,0.49019607843137253,-122,104,0.5277073575960698,0.4722926424039302,away,SEA,over,9.5,0.5238095238095238,-110,0.4988662131519274,LAA,SEA,2023 REG,6,2,7,3,5,13,0,1,-1,1,1,1,0,0,0,0,0,0,0,0.4988662131519274,0.5011337868480725
90188,0.5495495495495495,0.49019607843137253,-122,104,0.5277073575960698,0.4722926424039302,home,LAA,under,9.5,0.5238095238095238,-110,0.5011337868480725,LAA,SEA,2023 REG,6,2,7,3,5,13,0,1,-1,1,1,1,0,0,0,0,0,0,0,0.4988662131519274,0.5011337868480725
90189,0.5454545454545454,0.5,-120,100,0.5206611570247933,0.4793388429752067,away,TEX,over,8.5,0.5433789954337899,-119,0.5198077604720502,MIN,TEX,2023 REG,11,7,10,5,12,21,1,0,2,-2,1,1,1,1,1,0,0,0,0,0.5198077604720502,0.48019223952794976
90189,0.5454545454545454,0.5,-120,100,0.5206611570247933,0.4793388429752067,home,MIN,under,8.5,0.5,100,0.48019223952794976,MIN,TEX,2023 REG,11,7,10,5,12,21,1,0,2,-2,1,1,1,1,1,0,0,0,0,0.5198077604720502,0.48019223952794976
90190,0.6923076923076923,0.3472222222222222,-225,188,0.6649408284023669,0.3350591715976331,away,COL,over,9.5,0.5121951219512195,-105,0.48808156828023186,MIL,COL,2023 REG,10,7,7,6,13,17,1,0,1,-1,1,1,1,1,1,1,0,0,0,0.48808156828023186,0.5119184317197681
90190,0.6923076923076923,0.3472222222222222,-225,188,0.6649408284023669,0.3350591715976331,home,MIL,under,9.5,0.5348837209302326,-115,0.5119184317197681,MIL,COL,2023 REG,10,7,7,6,13,17,1,0,1,-1,1,1,1,1,1,1,0,0,0,0.48808156828023186,0.5119184317197681
90191,0.5305164319248826,0.5121951219512195,-113,-105,0.5078572507605655,0.49214274923943446,away,CIN,over,9.5,0.5412844036697247,-118,0.5149381613977361,PIT,CIN,2023 REG,9,5,12,6,11,21,0,1,-1,1,1,1,1,1,1,0,0,0,0,0.5149381613977361,0.48506183860226393
90191,0.5305164319248826,0.5121951219512195,-113,-105,0.5078572507605655,0.49214274923943446,home,PIT,under,9.5,0.5073891625615764,-103,0.48506183860226393,PIT,CIN,2023 REG,9,5,12,6,11,21,0,1,-1,1,1,1,1,1,1,0,0,0,0,0.5149381613977361,0.48506183860226393
90192,0.5348837209302326,0.5024875621890548,-115,-101,0.514894429959451,0.485105570040549,away,DET,over,8.5,0.5348837209302326,-115,0.5097020142727117,KC,DET,2023 REG,5,5,11,8,13,16,0,1,-3,3,1,1,1,1,1,0,0,0,0,0.5097020142727117,0.49029798572728833
90192,0.5348837209302326,0.5024875621890548,-115,-101,0.514894429959451,0.485105570040549,home,KC,under,8.5,0.5121951219512195,-105,0.49029798572728833,KC,DET,2023 REG,5,5,11,8,13,16,0,1,-3,3,1,1,1,1,1,0,0,0,0,0.5097020142727117,0.49029798572728833
90193,0.49751243781094534,0.5454545454545454,101,-120,0.476135829221149,0.523864170778851,away,PHI,over,7.5,0.5348837209302326,-115,0.5097020142727117,SD,PHI,2023 REG,3,1,12,5,6,15,0,1,-4,4,1,0,0,0,0,0,0,0,0,0.5097020142727117,0.49029798572728833
90193,0.49751243781094534,0.5454545454545454,101,-120,0.476135829221149,0.523864170778851,home,SD,under,7.5,0.5121951219512195,-105,0.49029798572728833,SD,PHI,2023 REG,3,1,12,5,6,15,0,1,-4,4,1,0,0,0,0,0,0,0,0,0.5097020142727117,0.49029798572728833
90194,0.4926108374384236,0.5495495495495495,103,-122,0.4718421738975501,0.5281578261024499,away,STL,over,10,0.5145631067961165,-106,0.49023796582517226,PIT,STL,2023 REG,16,11,5,1,12,21,1,0,10,-10,1,0,0,0,0,0,0,0,0,0.49023796582517226,0.5097620341748277
90194,0.4926108374384236,0.5495495495495495,103,-122,0.4718421738975501,0.5281578261024499,home,PIT,under,10,0.5327102803738317,-114,0.5097620341748277,PIT,STL,2023 REG,16,11,5,1,12,21,1,0,10,-10,1,0,0,0,0,0,0,0,0,0.49023796582517226,0.5097620341748277
90195,0.38759689922480617,0.6491228070175439,158,-185,0.3733644549448255,0.6266355450551745,away,BAL,over,8.5,0.5412844036697247,-118,0.5136310900085983,KC,BAL,2023 REG,7,7,15,11,18,22,0,1,-4,4,1,1,1,1,1,1,1,0,0,0.5136310900085983,0.4863689099914017
90195,0.38759689922480617,0.6491228070175439,158,-185,0.3733644549448255,0.6266355450551745,home,KC,under,8.5,0.5098039215686274,-104,0.4863689099914017,KC,BAL,2023 REG,7,7,15,11,18,22,0,1,-4,4,1,1,1,1,1,1,1,0,0,0.5136310900085983,0.4863689099914017
90196,0.4807692307692307,0.5575221238938054,108,-126,0.46235992564277106,0.5376400743572289,away,DET,over,8.5,0.5238095238095238,-110,0.5000596729920038,PIT,DET,2023 REG,9,3,8,6,9,17,0,1,-3,3,1,1,1,0,0,0,0,0,0,0.5000596729920038,0.4999403270079962
90196,0.4807692307692307,0.5575221238938054,108,-126,0.46235992564277106,0.5376400743572289,home,PIT,under,8.5,0.5215311004784688,-109,0.4999403270079962,PIT,DET,2023 REG,9,3,8,6,9,17,0,1,-3,3,1,1,1,0,0,0,0,0,0,0.5000596729920038,0.4999403270079962
90197,0.43103448275862066,0.607843137254902,132,-155,0.4142768879252058,0.5857231120747942,away,NYM,over,9.5,0.5283018867924528,-112,0.5044173060022736,KC,NYM,2023 REG,9,7,8,6,13,17,1,0,1,-1,1,1,1,1,1,1,0,0,0,0.5044173060022736,0.49558269399772636
90197,0.43103448275862066,0.607843137254902,132,-155,0.4142768879252058,0.5857231120747942,home,KC,under,9.5,0.5169082125603864,-107,0.49558269399772636,KC,NYM,2023 REG,9,7,8,6,13,17,1,0,1,-1,1,1,1,1,1,1,0,0,0,0.5044173060022736,0.49558269399772636
90198,0.425531914893617,0.6153846153846154,135,-160,0.4081206254135181,0.5918793745864819,away,NYM,over,9,0.5,100,0.4772727272727273,KC,NYM,2023 REG,12,4,9,0,4,21,1,0,4,-4,0,0,0,0,0,0,0,0,0,0.4772727272727273,0.5227272727272727
90198,0.425531914893617,0.6153846153846154,135,-160,0.4081206254135181,0.5918793745864819,home,KC,under,9,0.5454545454545454,-120,0.5227272727272727,KC,NYM,2023 REG,12,4,9,0,4,21,1,0,4,-4,0,0,0,0,0,0,0,0,0,0.4772727272727273,0.5227272727272727
90199,0.5454545454545454,0.5,-120,100,0.5206611570247933,0.4793388429752067,away,MIL,over,9.5,0.5121951219512195,-105,0.48808156828023186,CIN,MIL,2023 REG,6,1,7,5,6,13,0,1,-4,4,1,0,0,0,0,0,0,0,0,0.48808156828023186,0.5119184317197681
90199,0.5454545454545454,0.5,-120,100,0.5206611570247933,0.4793388429752067,home,CIN,under,9.5,0.5348837209302326,-115,0.5119184317197681,CIN,MIL,2023 REG,6,1,7,5,6,13,0,1,-4,4,1,0,0,0,0,0,0,0,0,0.48808156828023186,0.5119184317197681
90200,0.5633187772925764,0.47619047619047616,-129,110,0.5410624729287608,0.45893752707123925,away,SEA,over,7.5,0.5238095238095238,-110,0.4988662131519274,CLE,SEA,2023 REG,7,3,10,5,8,17,0,1,-2,2,1,1,1,0,0,0,0,0,0,0.4988662131519274,0.5011337868480725
90200,0.5633187772925764,0.47619047619047616,-129,110,0.5410624729287608,0.45893752707123925,home,CLE,under,7.5,0.5238095238095238,-110,0.5011337868480725,CLE,SEA,2023 REG,7,3,10,5,8,17,0,1,-2,2,1,1,1,0,0,0,0,0,0,0.4988662131519274,0.5011337868480725
90201,0.6825396825396826,0.35714285714285715,-215,180,0.6554547745023935,0.34454522549760647,away,KC,over,8,0.5121951219512195,-105,0.48808156828023186,SF,KC,2023 REG,5,1,9,3,4,14,0,1,-2,2,1,0,0,0,0,0,0,0,0,0.48808156828023186,0.5119184317197681
90201,0.6825396825396826,0.35714285714285715,-215,180,0.6554547745023935,0.34454522549760647,home,SF,under,8,0.5348837209302326,-115,0.5119184317197681,SF,KC,2023 REG,5,1,9,3,4,14,0,1,-2,2,1,0,0,0,0,0,0,0,0,0.48808156828023186,0.5119184317197681
90202,0.5238095238095238,0.5215311004784688,-110,-109,0.5000596729920038,0.4999403270079962,away,PHI,over,9.5,0.5098039215686274,-104,0.4870219861770517,ATL,PHI,2023 REG,12,8,11,5,13,23,1,0,3,-3,1,1,1,1,1,0,0,0,0,0.4870219861770517,0.5129780138229483
90202,0.5238095238095238,0.5215311004784688,-110,-109,0.5000596729920038,0.4999403270079962,home,ATL,under,9.5,0.5348837209302326,-115,0.5129780138229483,ATL,PHI,2023 REG,12,8,11,5,13,23,1,0,3,-3,1,1,1,1,1,0,0,0,0,0.4870219861770517,0.5129780138229483
90203,0.6551724137931035,0.38759689922480617,-190,158,0.6271511397468869,0.37284886025311315,away,COL,over,8.5,0.5121951219512195,-105,0.48808156828023186,SF,COL,2023 REG,5,2,9,5,7,14,0,1,-3,3,1,1,0,0,0,0,0,0,0,0.48808156828023186,0.5119184317197681
90203,0.6551724137931035,0.38759689922480617,-190,158,0.6271511397468869,0.37284886025311315,home,SF,under,8.5,0.5348837209302326,-115,0.5119184317197681,SF,COL,2023 REG,5,2,9,5,7,14,0,1,-3,3,1,1,0,0,0,0,0,0,0,0.48808156828023186,0.5119184317197681
90204,0.5867768595041323,0.45454545454545453,-142,120,0.5625298818386723,0.43747011816132775,away,BOS,over,7.5,0.5215311004784688,-109,0.49907282342437215,MIN,BOS,2023 REG,7,3,10,9,12,17,0,1,-6,6,1,1,1,0,0,0,0,0,0,0.49907282342437215,0.5009271765756278
90204,0.5867768595041323,0.45454545454545453,-142,120,0.5625298818386723,0.43747011816132775,home,MIN,under,7.5,0.5215311004784688,-109,0.5009271765756278,MIN,BOS,2023 REG,7,3,10,9,12,17,0,1,-6,6,1,1,1,0,0,0,0,0,0,0.49907282342437215,0.5009271765756278
90205,0.6666666666666666,0.37037037037037035,-200,170,0.6419753086419753,0.3580246913580247,away,WSH,over,8.5,0.5391705069124424,-117,0.5127649394825569,MIA,WSH,2023 REG,6,2,7,1,3,13,1,0,1,-1,1,0,0,0,0,0,0,0,0,0.5127649394825569,0.48723506051744314
90205,0.6666666666666666,0.37037037037037035,-200,170,0.6419753086419753,0.3580246913580247,home,MIA,under,8.5,0.5098039215686274,-104,0.48723506051744314,MIA,WSH,2023 REG,6,2,7,1,3,13,1,0,1,-1,1,0,0,0,0,0,0,0,0,0.5127649394825569,0.48723506051744314
90206,0.5798319327731092,0.4608294930875576,-138,117,0.5562551396270082,0.44374486037299177,away,BAL,over,8,0.5348837209302326,-115,0.5097020142727117,CHC,BAL,2023 REG,4,3,7,2,5,11,1,0,1,-1,1,1,0,0,0,0,0,0,0,0.5097020142727117,0.49029798572728833
90206,0.5798319327731092,0.4608294930875576,-138,117,0.5562551396270082,0.44374486037299177,home,CHC,under,8,0.5121951219512195,-105,0.49029798572728833,CHC,BAL,2023 REG,4,3,7,2,5,11,1,0,1,-1,1,1,0,0,0,0,0,0,0,0.5097020142727117,0.49029798572728833
90207,0.6000000000000001,0.4424778761061947,-150,126,0.5745132743362832,0.4254867256637168,away,MIA,over,9,0.5305164319248826,-113,0.5066009958897986,TEX,MIA,2023 REG,9,9,11,8,17,20,1,0,1,-1,1,1,1,1,1,1,1,1,0,0.5066009958897986,0.49339900411020143
90207,0.6000000000000001,0.4424778761061947,-150,126,0.5745132743362832,0.4254867256637168,home,TEX,under,9,0.5145631067961165,-106,0.49339900411020143,TEX,MIA,2023 REG,9,9,11,8,17,20,1,0,1,-1,1,1,1,1,1,1,1,1,0,0.5066009958897986,0.49339900411020143
90208,0.574468085106383,0.46511627906976744,-135,115,0.5517281312179562,0.44827186878204384,away,CIN,over,12.5,0.5238095238095238,-110,0.4988662131519274,COL,CIN,2023 REG,4,1,6,3,4,10,0,1,-2,2,1,0,0,0,0,0,0,0,0,0.4988662131519274,0.5011337868480725
90208,0.574468085106383,0.46511627906976744,-135,115,0.5517281312179562,0.44827186878204384,home,COL,under,12.5,0.5238095238095238,-110,0.5011337868480725,COL,CIN,2023 REG,4,1,6,3,4,10,0,1,-2,2,1,0,0,0,0,0,0,0,0,0.4988662131519274,0.5011337868480725
90209,0.4672897196261683,0.5726495726495727,114,-134,0.44862649893656975,0.5513735010634302,away,SEA,over,9,0.5327102803738317,-114,0.5075272610403079,LAA,SEA,2023 REG,6,2,7,3,5,13,0,1,-1,1,1,1,0,0,0,0,0,0,0,0.5075272610403079,0.4924727389596921
90209,0.4672897196261683,0.5726495726495727,114,-134,0.44862649893656975,0.5513735010634302,home,LAA,under,9,0.5145631067961165,-106,0.4924727389596921,LAA,SEA,2023 REG,6,2,7,3,5,13,0,1,-1,1,1,1,0,0,0,0,0,0,0,0.5075272610403079,0.4924727389596921
90210,0.6389891696750902,0.4,-177,150,0.614075512518083,0.385924487481917,away,DET,over,8.5,0.5348837209302326,-115,0.5097020142727117,MIL,DET,2023 REG,5,3,12,4,7,17,0,1,-1,1,1,1,1,0,0,0,0,0,0,0.5097020142727117,0.49029798572728833
90210,0.6389891696750902,0.4,-177,150,0.614075512518083,0.385924487481917,home,MIL,under,8.5,0.5121951219512195,-105,0.49029798572728833,MIL,DET,2023 REG,5,3,12,4,7,17,0,1,-1,1,1,1,1,0,0,0,0,0,0,0.5097020142727117,0.49029798572728833
90211,0.574468085106383,0.46511627906976744,-135,115,0.5517281312179562,0.44827186878204384,away,HOU,over,8.5,0.5,100,0.4772727272727273,LAD,HOU,2023 REG,6,5,10,6,11,16,0,1,-1,1,1,1,1,1,1,0,0,0,0,0.4772727272727273,0.5227272727272727
90211,0.574468085106383,0.46511627906976744,-135,115,0.5517281312179562,0.44827186878204384,home,LAD,under,8.5,0.5454545454545454,-120,0.5227272727272727,LAD,HOU,2023 REG,6,5,10,6,11,16,0,1,-1,1,1,1,1,1,1,0,0,0,0,0.4772727272727273,0.5227272727272727
90212,0.4444444444444444,0.5967741935483871,125,-148,0.42612504978096366,0.5738749502190363,away,HOU,over,9.5,0.504950495049505,-102,0.48160416005266615,KC,HOU,2023 REG,9,10,12,8,18,21,1,0,2,-2,1,1,1,1,1,1,1,1,0,0.48160416005266615,0.5183958399473338
90212,0.4444444444444444,0.5967741935483871,125,-148,0.42612504978096366,0.5738749502190363,home,KC,under,9.5,0.5412844036697247,-118,0.5183958399473338,KC,HOU,2023 REG,9,10,12,8,18,21,1,0,2,-2,1,1,1,1,1,1,1,1,0,0.48160416005266615,0.5183958399473338
90213,0.45454545454545453,0.5850622406639003,120,-141,0.4365419567230205,0.5634580432769796,away,BOS,over,8,0.5283018867924528,-112,0.5031902949311281,DET,BOS,2023 REG,6,3,7,6,9,13,0,1,-3,3,1,1,1,0,0,0,0,0,0,0.5031902949311281,0.4968097050688719
90213,0.45454545454545453,0.5850622406639003,120,-141,0.4365419567230205,0.5634580432769796,home,DET,under,8,0.5192307692307692,-108,0.4968097050688719,DET,BOS,2023 REG,6,3,7,6,9,13,0,1,-3,3,1,1,1,0,0,0,0,0,0,0.5031902949311281,0.4968097050688719
90214,0.48309178743961345,0.5652173913043479,107,-130,0.4597540199304534,0.5402459800695466,away,MIA,over,9.5,0.5238095238095238,-110,0.4988662131519274,WSH,MIA,2023 REG,10,5,18,11,16,28,0,1,-6,6,1,1,1,1,1,0,0,0,0,0.4988662131519274,0.5011337868480725
90214,0.48309178743961345,0.5652173913043479,107,-130,0.4597540199304534,0.5402459800695466,home,WSH,under,9.5,0.5238095238095238,-110,0.5011337868480725,WSH,MIA,2023 REG,10,5,18,11,16,28,0,1,-6,6,1,1,1,1,1,0,0,0,0,0.4988662131519274,0.5011337868480725
90215,0.6376811594202898,0.4,-176,150,0.6136525939928585,0.38634740600714146,away,OAK,over,9,0.5495495495495495,-122,0.5223196169142115,STL,OAK,2023 REG,9,0,14,8,8,23,0,1,-8,8,0,0,0,0,0,0,0,0,0,0.5223196169142115,0.47768038308578853
90215,0.6376811594202898,0.4,-176,150,0.6136525939928585,0.38634740600714146,home,STL,under,9,0.5,100,0.47768038308578853,STL,OAK,2023 REG,9,0,14,8,8,23,0,1,-8,8,0,0,0,0,0,0,0,0,0,0.5223196169142115,0.47768038308578853
90216,0.5708154506437768,0.4716981132075471,-133,112,0.5465480515355103,0.45345194846448966,away,NYY,over,7,0.5412844036697247,-118,0.5149381613977361,TB,NYY,2023 REG,4,2,11,6,8,15,0,1,-4,4,1,1,0,0,0,0,0,0,0,0.5149381613977361,0.48506183860226393
90216,0.5708154506437768,0.4716981132075471,-133,112,0.5465480515355103,0.45345194846448966,home,TB,under,7,0.5073891625615764,-103,0.48506183860226393,TB,NYY,2023 REG,4,2,11,6,8,15,0,1,-4,4,1,1,0,0,0,0,0,0,0,0.5149381613977361,0.48506183860226393
90217,0.49504950495049505,0.5412844036697247,102,-118,0.47706242147513866,0.5229375785248613,away,BOS,over,8.5,0.5192307692307692,-108,0.49455035168025013,BAL,BOS,2023 REG,13,5,7,4,9,20,1,0,1,-1,1,1,1,1,0,0,0,0,0,0.49455035168025013,0.5054496483197499
90217,0.49504950495049505,0.5412844036697247,102,-118,0.47706242147513866,0.5229375785248613,home,BAL,under,8.5,0.5283018867924528,-112,0.5054496483197499,BAL,BOS,2023 REG,13,5,7,4,9,20,1,0,1,-1,1,1,1,1,0,0,0,0,0,0.49455035168025013,0.5054496483197499
90218,0.4854368932038835,0.5555555555555556,106,-125,0.465537646233282,0.534462353766718,away,CHC,over,10,0.5348837209302326,-115,0.5097020142727117,CIN,CHC,2023 REG,8,3,5,2,5,13,1,0,1,-1,1,1,0,0,0,0,0,0,0,0.5097020142727117,0.49029798572728833
90218,0.4854368932038835,0.5555555555555556,106,-125,0.465537646233282,0.534462353766718,home,CIN,under,10,0.5121951219512195,-105,0.49029798572728833,CIN,CHC,2023 REG,8,3,5,2,5,13,1,0,1,-1,1,1,0,0,0,0,0,0,0,0.5097020142727117,0.49029798572728833
90219,0.5633187772925764,0.47619047619047616,-129,110,0.5410624729287608,0.45893752707123925,away,TB,over,8,0.5238095238095238,-110,0.4988662131519274,MIN,TB,2023 REG,6,3,6,2,5,12,1,0,1,-1,1,1,0,0,0,0,0,0,0,0.4988662131519274,0.5011337868480725
90219,0.5633187772925764,0.47619047619047616,-129,110,0.5410624729287608,0.45893752707123925,home,MIN,under,8,0.5238095238095238,-110,0.5011337868480725,MIN,TB,2023 REG,6,3,6,2,5,12,1,0,1,-1,1,1,0,0,0,0,0,0,0,0.4988662131519274,0.5011337868480725
90220,0.5934959349593496,0.4444444444444444,-146,125,0.5709784740123824,0.42902152598761756,away,TOR,over,9,0.5121951219512195,-105,0.48919479393107135,LAD,TOR,2023 REG,12,8,12,7,15,24,1,0,1,-1,1,1,1,1,1,1,1,0,0,0.48919479393107135,0.5108052060689287
90220,0.5934959349593496,0.4444444444444444,-146,125,0.5709784740123824,0.42902152598761756,home,LAD,under,9,0.5327102803738317,-114,0.5108052060689287,LAD,TOR,2023 REG,12,8,12,7,15,24,1,0,1,-1,1,1,1,1,1,1,1,0,0,0.48919479393107135,0.5108052060689287
90221,0.6108949416342413,0.4291845493562232,-157,133,0.5864105833248914,0.4135894166751086,away,SEA,over,8.5,0.5454545454545454,-120,0.5193043049216726,MIN,SEA,2023 REG,12,7,10,8,15,22,0,1,-1,1,1,1,1,1,1,1,1,0,0,0.5193043049216726,0.48069569507832743
90221,0.6108949416342413,0.4291845493562232,-157,133,0.5864105833248914,0.4135894166751086,home,MIN,under,8.5,0.5024875621890548,-101,0.48069569507832743,MIN,SEA,2023 REG,12,7,10,8,15,22,0,1,-1,1,1,1,1,1,1,1,1,0,0,0.5193043049216726,0.48069569507832743
90222,0.425531914893617,0.607843137254902,135,-155,0.4113297650431834,0.5886702349568166,away,TEX,over,8.5,0.5238095238095238,-110,0.4988662131519274,CWS,TEX,2023 REG,9,7,11,6,13,20,1,0,1,-1,1,1,1,1,1,1,0,0,0,0.4988662131519274,0.5011337868480725
90222,0.425531914893617,0.607843137254902,135,-155,0.4113297650431834,0.5886702349568166,home,CWS,under,8.5,0.5238095238095238,-110,0.5011337868480725,CWS,TEX,2023 REG,9,7,11,6,13,20,1,0,1,-1,1,1,1,1,1,1,0,0,0,0.4988662131519274,0.5011337868480725
90223,0.6376811594202898,0.40322580645161293,-176,148,0.6115955579947286,0.38840444200527136,away,CLE,over,8.5,0.5555555555555556,-125,0.5314664257753688,MIN,CLE,2023 REG,12,10,7,6,16,19,1,0,4,-4,1,1,1,1,1,1,0,0,0,0.5314664257753688,0.46853357422463116
90223,0.6376811594202898,0.40322580645161293,-176,148,0.6115955579947286,0.38840444200527136,home,MIN,under,8.5,0.48780487804878053,105,0.46853357422463116,MIN,CLE,2023 REG,12,10,7,6,16,19,1,0,4,-4,1,1,1,1,1,1,0,0,0,0.5314664257753688,0.46853357422463116
90224,0.5260663507109005,0.5169082125603864,-111,-107,0.5034588790373798,0.49654112096262015,away,BAL,over,9,0.5,100,0.4772727272727273,CHC,BAL,2023 REG,3,3,14,6,9,17,0,1,-3,3,1,1,1,0,0,0,0,0,0,0.4772727272727273,0.5227272727272727
90224,0.5260663507109005,0.5169082125603864,-111,-107,0.5034588790373798,0.49654112096262015,home,CHC,under,9,0.5454545454545454,-120,0.5227272727272727,CHC,BAL,2023 REG,3,3,14,6,9,17,0,1,-3,3,1,1,1,0,0,0,0,0,0,0.4772727272727273,0.5227272727272727
90225,0.4672897196261683,0.5726495726495727,114,-134,0.44862649893656975,0.5513735010634302,away,CLE,over,10.5,0.5121951219512195,-105,0.48808156828023186,CWS,CLE,2023 REG,6,3,6,0,3,12,1,0,3,-3,0,0,0,0,0,0,0,0,0,0.48808156828023186,0.5119184317197681
90225,0.4672897196261683,0.5726495726495727,114,-134,0.44862649893656975,0.5513735010634302,home,CWS,under,10.5,0.5348837209302326,-115,0.5119184317197681,CWS,CLE,2023 REG,6,3,6,0,3,12,1,0,3,-3,0,0,0,0,0,0,0,0,0,0.48808156828023186,0.5119184317197681
90226,0.4587155963302753,0.5780590717299579,118,-137,0.4418464825411775,0.5581535174588226,away,CHC,over,8,0.5215311004784688,-109,0.4978845547971712,PIT,CHC,2023 REG,5,0,7,4,4,12,0,1,-4,4,0,0,0,0,0,0,0,0,0,0.4978845547971712,0.5021154452028288
90226,0.4587155963302753,0.5780590717299579,118,-137,0.4418464825411775,0.5581535174588226,home,PIT,under,8,0.5238095238095238,-110,0.5021154452028288,PIT,CHC,2023 REG,5,0,7,4,4,12,0,1,-4,4,0,0,0,0,0,0,0,0,0,0.4978845547971712,0.5021154452028288
90227,0.6621621621621622,0.37878787878787884,-196,164,0.6350465945060539,0.36495340549394606,away,ARI,over,8.5,0.5475113122171946,-121,0.5228602997583487,LAD,ARI,2023 REG,4,1,9,2,3,13,0,1,-1,1,1,0,0,0,0,0,0,0,0,0.5228602997583487,0.4771397002416513
90227,0.6621621621621622,0.37878787878787884,-196,164,0.6350465945060539,0.36495340549394606,home,LAD,under,8.5,0.49751243781094534,101,0.4771397002416513,LAD,ARI,2023 REG,4,1,9,2,3,13,0,1,-1,1,1,0,0,0,0,0,0,0,0,0.5228602997583487,0.4771397002416513
90228,0.6825396825396826,0.35714285714285715,-215,180,0.6554547745023935,0.34454522549760647,away,OAK,over,10,0.5283018867924528,-112,0.5031902949311281,LAA,OAK,2023 REG,13,10,14,11,21,27,0,1,-1,1,1,1,1,1,1,1,1,1,1,0.5031902949311281,0.4968097050688719
90228,0.6825396825396826,0.35714285714285715,-215,180,0.6554547745023935,0.34454522549760647,home,LAA,under,10,0.5192307692307692,-108,0.4968097050688719,LAA,OAK,2023 REG,13,10,14,11,21,27,0,1,-1,1,1,1,1,1,1,1,1,1,1,0.5031902949311281,0.4968097050688719
90229,0.3367003367003367,0.7058823529411764,197,-240,0.3223627307604333,0.6776372692395667,away,MIN,over,8,0.5238095238095238,-110,0.4988662131519274,OAK,MIN,2023 REG,10,7,11,10,17,21,0,1,-3,3,1,1,1,1,1,1,1,0,0,0.4988662131519274,0.5011337868480725
90229,0.3367003367003367,0.7058823529411764,197,-240,0.3223627307604333,0.6776372692395667,home,OAK,under,8,0.5238095238095238,-110,0.5011337868480725,OAK,MIN,2023 REG,10,7,11,10,17,21,0,1,-3,3,1,1,1,1,1,1,1,0,0,0.4988662131519274,0.5011337868480725
90230,0.6226415094339623,0.4132231404958678,-165,142,0.6003106896663323,0.3996893103336677,away,CLE,over,7.5,0.5454545454545454,-120,0.5206611570247933,SEA,CLE,2023 REG,7,4,13,9,13,20,0,1,-5,5,1,1,1,1,0,0,0,0,0,0.5206611570247933,0.4793388429752067
90230,0.6226415094339623,0.4132231404958678,-165,142,0.6003106896663323,0.3996893103336677,home,SEA,under,7.5,0.5,100,0.4793388429752067,SEA,CLE,2023 REG,7,4,13,9,13,20,0,1,-5,5,1,1,1,1,0,0,0,0,0,0.5206611570247933,0.4793388429752067
90231,0.5495495495495495,0.4926108374384236,-122,103,0.5263803278714742,0.47361967212852585,away,ARI,over,9,0.5495495495495495,-122,0.5250401592387142,MIL,ARI,2023 REG,10,7,10,5,12,20,1,0,2,-2,1,1,1,1,1,0,0,0,0,0.5250401592387142,0.47495984076128583
90231,0.5495495495495495,0.4926108374384236,-122,103,0.5263803278714742,0.47361967212852585,home,MIL,under,9,0.49504950495049505,102,0.47495984076128583,MIL,ARI,2023 REG,10,7,10,5,12,20,1,0,2,-2,1,1,1,1,1,0,0,0,0,0.5250401592387142,0.47495984076128583
90232,0.5833333333333333,0.45454545454545453,-140,120,0.5612373737373737,0.4387626262626263,away,PIT,over,8.5,0.5098039215686274,-104,0.48483656587239576,CIN,PIT,2023 REG,7,4,6,5,9,13,0,1,-1,1,1,1,1,1,0,0,0,0,0,0.48483656587239576,0.5151634341276042
90232,0.5833333333333333,0.45454545454545453,-140,120,0.5612373737373737,0.4387626262626263,home,CIN,under,8.5,0.5391705069124424,-117,0.5151634341276042,CIN,PIT,2023 REG,7,4,6,5,9,13,0,1,-1,1,1,1,1,1,0,0,0,0,0,0.48483656587239576,0.5151634341276042
90233,0.7493734335839599,0.29673590504451036,-299,237,0.7148203201756576,0.28517967982434245,away,WSH,over,8,0.5073891625615764,-103,0.4837652908580103,MIL,WSH,2023 REG,6,1,4,2,3,10,0,1,-1,1,1,0,0,0,0,0,0,0,0,0.4837652908580103,0.5162347091419897
90233,0.7493734335839599,0.29673590504451036,-299,237,0.7148203201756576,0.28517967982434245,home,MIL,under,8,0.5391705069124424,-117,0.5162347091419897,MIL,WSH,2023 REG,6,1,4,2,3,10,0,1,-1,1,1,0,0,0,0,0,0,0,0,0.4837652908580103,0.5162347091419897
90234,0.5833333333333333,0.4566210045662101,-140,119,0.5600266362252664,0.4399733637747336,away,SD,over,8.5,0.5348837209302326,-115,0.5097020142727117,HOU,SD,2023 REG,6,2,10,11,13,16,0,1,-9,9,1,1,0,0,0,0,0,0,0,0.5097020142727117,0.49029798572728833
90234,0.5833333333333333,0.4566210045662101,-140,119,0.5600266362252664,0.4399733637747336,home,HOU,under,8.5,0.5121951219512195,-105,0.49029798572728833,HOU,SD,2023 REG,6,2,10,11,13,16,0,1,-9,9,1,1,0,0,0,0,0,0,0,0.5097020142727117,0.49029798572728833
90235,0.5555555555555556,0.4854368932038835,-125,106,0.5327819729114227,0.4672180270885773,away,CLE,over,8.5,0.5495495495495495,-122,0.5250401592387142,BOS,CLE,2023 REG,9,7,4,1,8,13,1,0,6,-6,1,0,0,0,0,0,0,0,0,0.5250401592387142,0.47495984076128583
90235,0.5555555555555556,0.4854368932038835,-125,106,0.5327819729114227,0.4672180270885773,home,BOS,under,8.5,0.49504950495049505,102,0.47495984076128583,BOS,CLE,2023 REG,9,7,4,1,8,13,1,0,6,-6,1,0,0,0,0,0,0,0,0,0.5250401592387142,0.47495984076128583
90236,0.5555555555555556,0.49019607843137253,-125,104,0.5301379811183733,0.4698620188816267,away,CIN,over,8.5,0.5283018867924528,-112,0.5044173060022736,DET,CIN,2023 REG,9,8,5,2,10,14,1,0,6,-6,1,1,0,0,0,0,0,0,0,0.5044173060022736,0.49558269399772636
90236,0.5555555555555556,0.49019607843137253,-125,104,0.5301379811183733,0.4698620188816267,home,DET,under,8.5,0.5169082125603864,-107,0.49558269399772636,DET,CIN,2023 REG,9,8,5,2,10,14,1,0,6,-6,1,1,0,0,0,0,0,0,0,0.5044173060022736,0.49558269399772636
90237,0.4166666666666667,0.6226415094339623,140,-165,0.4002882599580712,0.5997117400419287,away,SD,over,9,0.5121951219512195,-105,0.48808156828023186,PHI,SD,2023 REG,10,6,9,4,10,19,1,0,2,-2,1,1,1,1,0,0,0,0,0,0.48808156828023186,0.5119184317197681
90237,0.4166666666666667,0.6226415094339623,140,-165,0.4002882599580712,0.5997117400419287,home,PHI,under,9,0.5348837209302326,-115,0.5119184317197681,PHI,SD,2023 REG,10,6,9,4,10,19,1,0,2,-2,1,1,1,1,0,0,0,0,0,0.48808156828023186,0.5119184317197681
90238,0.5689655172413793,0.47619047619047616,-132,110,0.5432733140818753,0.4567266859181247,away,KC,over,9,0.5,100,0.4772727272727273,CWS,KC,2023 REG,9,6,7,2,8,16,1,0,4,-4,1,1,0,0,0,0,0,0,0,0.4772727272727273,0.5227272727272727
90238,0.5689655172413793,0.47619047619047616,-132,110,0.5432733140818753,0.4567266859181247,home,CWS,under,9,0.5454545454545454,-120,0.5227272727272727,CWS,KC,2023 REG,9,6,7,2,8,16,1,0,4,-4,1,1,0,0,0,0,0,0,0,0.4772727272727273,0.5227272727272727
90239,0.35842293906810035,0.6774193548387096,179,-210,0.34557623874307886,0.6544237612569211,away,TEX,over,10,0.5121951219512195,-105,0.48808156828023186,WSH,TEX,2023 REG,12,8,8,3,11,20,1,0,5,-5,1,1,1,0,0,0,0,0,0,0.48808156828023186,0.5119184317197681
90239,0.35842293906810035,0.6774193548387096,179,-210,0.34557623874307886,0.6544237612569211,home,WSH,under,10,0.5348837209302326,-115,0.5119184317197681,WSH,TEX,2023 REG,12,8,8,3,11,20,1,0,5,-5,1,1,1,0,0,0,0,0,0,0.48808156828023186,0.5119184317197681
90240,0.425531914893617,0.6108949416342413,135,-157,0.41003112488176247,0.5899688751182375,away,LAD,over,11,0.5327102803738317,-114,0.5075272610403079,CIN,LAD,2023 REG,13,8,8,6,14,21,1,0,2,-2,1,1,1,1,1,1,0,0,0,0.5075272610403079,0.4924727389596921
90240,0.425531914893617,0.6108949416342413,135,-157,0.41003112488176247,0.5899688751182375,home,CIN,under,11,0.5145631067961165,-106,0.4924727389596921,CIN,LAD,2023 REG,13,8,8,6,14,21,1,0,2,-2,1,1,1,1,1,1,0,0,0,0.5075272610403079,0.4924727389596921
90241,0.5238095238095238,0.5145631067961165,-110,-106,0.5037095744446646,0.4962904255553354,away,SEA,over,7,0.5098039215686274,-104,0.48592421718142587,NYY,SEA,2023 REG,8,3,4,1,4,12,1,0,2,-2,1,0,0,0,0,0,0,0,0,0.48592421718142587,0.5140757828185741
90241,0.5238095238095238,0.5145631067961165,-110,-106,0.5037095744446646,0.4962904255553354,home,NYY,under,7,0.5370370370370371,-116,0.5140757828185741,NYY,SEA,2023 REG,8,3,4,1,4,12,1,0,2,-2,1,0,0,0,0,0,0,0,0,0.48592421718142587,0.5140757828185741
90242,0.5614035087719298,0.47846889952153115,-128,109,0.5390189988527938,0.4609810011472062,away,ARI,over,8.5,0.5454545454545454,-120,0.5179608869977906,NYM,ARI,2023 REG,6,3,10,4,7,16,0,1,-1,1,1,1,1,0,0,0,0,0,0,0.5179608869977906,0.48203911300220936
90242,0.5614035087719298,0.47846889952153115,-128,109,0.5390189988527938,0.4609810011472062,home,NYM,under,8.5,0.504950495049505,-102,0.48203911300220936,NYM,ARI,2023 REG,6,3,10,4,7,16,0,1,-1,1,1,1,1,0,0,0,0,0,0,0.5179608869977906,0.48203911300220936
90243,0.7118155619596541,0.3278688524590164,-247,205,0.6835675782091883,0.31643242179081166,away,OAK,over,9.5,0.5098039215686274,-104,0.48592421718142587,MIL,OAK,2023 REG,4,2,6,5,7,10,0,1,-3,3,1,1,0,0,0,0,0,0,0,0.48592421718142587,0.5140757828185741
90243,0.7118155619596541,0.3278688524590164,-247,205,0.6835675782091883,0.31643242179081166,home,MIL,under,9.5,0.5370370370370371,-116,0.5140757828185741,MIL,OAK,2023 REG,4,2,6,5,7,10,0,1,-3,3,1,1,0,0,0,0,0,0,0,0.48592421718142587,0.5140757828185741
90244,0.7118155619596541,0.3333333333333333,-247,200,0.6796778756848186,0.32032212431518137,away,LAA,over,8,0.5348837209302326,-115,0.5097020142727117,MIN,LAA,2023 REG,10,9,11,3,12,21,1,0,6,-6,1,1,1,0,0,0,0,0,0,0.5097020142727117,0.49029798572728833
90244,0.7118155619596541,0.3333333333333333,-247,200,0.6796778756848186,0.32032212431518137,home,MIN,under,8,0.5121951219512195,-105,0.49029798572728833,MIN,LAA,2023 REG,10,9,11,3,12,21,1,0,6,-6,1,1,1,0,0,0,0,0,0,0.5097020142727117,0.49029798572728833
90245,0.7142857142857143,0.32573289902280134,-250,207,0.6857009904939174,0.3142990095060826,away,WSH,over,7.5,0.5121951219512195,-105,0.48808156828023186,HOU,WSH,2023 REG,8,5,7,4,9,15,1,0,1,-1,1,1,1,1,0,0,0,0,0,0.48808156828023186,0.5119184317197681
90245,0.7142857142857143,0.32573289902280134,-250,207,0.6857009904939174,0.3142990095060826,home,HOU,under,7.5,0.5348837209302326,-115,0.5119184317197681,HOU,WSH,2023 REG,8,5,7,4,9,15,1,0,1,-1,1,1,1,1,0,0,0,0,0,0.48808156828023186,0.5119184317197681
90246,0.7101449275362319,0.3367003367003367,-245,197,0.6768780007595383,0.3231219992404617,away,OAK,over,9,0.5073891625615764,-103,0.4837652908580103,TEX,OAK,2023 REG,12,9,9,4,13,21,1,0,5,-5,1,1,1,1,0,0,0,0,0,0.4837652908580103,0.5162347091419897
90246,0.7101449275362319,0.3367003367003367,-245,197,0.6768780007595383,0.3231219992404617,home,TEX,under,9,0.5391705069124424,-117,0.5162347091419897,TEX,OAK,2023 REG,12,9,9,4,13,21,1,0,5,-5,1,1,1,1,0,0,0,0,0,0.4837652908580103,0.5162347091419897
90247,0.5726495726495727,0.4716981132075471,-134,112,0.5472538892954956,0.45274611070450443,away,KC,over,8.5,0.5433789954337899,-119,0.5171177654451503,CWS,KC,2023 REG,10,10,12,11,21,22,0,1,-1,1,1,1,1,1,1,1,1,1,1,0.5171177654451503,0.4828822345548497
90247,0.5726495726495727,0.4716981132075471,-134,112,0.5472538892954956,0.45274611070450443,home,CWS,under,8.5,0.504950495049505,-102,0.4828822345548497,CWS,KC,2023 REG,10,10,12,11,21,22,0,1,-1,1,1,1,1,1,1,1,1,1,1,0.5171177654451503,0.4828822345548497
90248,0.48780487804878053,0.5555555555555556,105,-125,0.4666534470222751,0.5333465529777248,away,CHC,over,9.5,0.5348837209302326,-115,0.5097020142727117,CIN,CHC,2023 REG,9,2,5,1,3,14,1,0,1,-1,1,0,0,0,0,0,0,0,0,0.5097020142727117,0.49029798572728833
90248,0.48780487804878053,0.5555555555555556,105,-125,0.4666534470222751,0.5333465529777248,home,CIN,under,9.5,0.5121951219512195,-105,0.49029798572728833,CIN,CHC,2023 REG,9,2,5,1,3,14,1,0,1,-1,1,0,0,0,0,0,0,0,0,0.5097020142727117,0.49029798572728833
90249,0.5121951219512195,0.5305164319248826,-105,-113,0.4903184724049234,0.5096815275950766,away,PHI,over,9.5,0.5169082125603864,-107,0.49353874091423283,ATL,PHI,2023 REG,4,1,7,7,8,11,0,1,-6,6,1,0,0,0,0,0,0,0,0,0.49353874091423283,0.5064612590857671
90249,0.5121951219512195,0.5305164319248826,-105,-113,0.4903184724049234,0.5096815275950766,home,ATL,under,9.5,0.5283018867924528,-112,0.5064612590857671,ATL,PHI,2023 REG,4,1,7,7,8,11,0,1,-6,6,1,0,0,0,0,0,0,0,0,0.49353874091423283,0.5064612590857671
90250,0.7590361445783133,0.2857142857142857,-315,250,0.7250689505007983,0.27493104949920166,away,WSH,over,8.5,0.5454545454545454,-120,0.5206611570247933,LAD,WSH,2023 REG,14,9,6,3,12,20,1,0,6,-6,1,1,1,0,0,0,0,0,0,0.5206611570247933,0.4793388429752067
90250,0.7590361445783133,0.2857142857142857,-315,250,0.7250689505007983,0.27493104949920166,home,LAD,under,8.5,0.5,100,0.4793388429752067,LAD,WSH,2023 REG,14,9,6,3,12,20,1,0,6,-6,1,1,1,0,0,0,0,0,0,0.5206611570247933,0.4793388429752067
90251,0.6774193548387096,0.36764705882352944,-210,172,0.6468904939707413,0.3531095060292587,away,OAK,over,8.5,0.5412844036697247,-118,0.5136310900085983,MIA,OAK,2023 REG,9,4,5,0,4,14,1,0,4,-4,0,0,0,0,0,0,0,0,0,0.5136310900085983,0.4863689099914017
90251,0.6774193548387096,0.36764705882352944,-210,172,0.6468904939707413,0.3531095060292587,home,MIA,under,8.5,0.5098039215686274,-104,0.4863689099914017,MIA,OAK,2023 REG,9,4,5,0,4,14,1,0,4,-4,0,0,0,0,0,0,0,0,0,0.5136310900085983,0.4863689099914017
90252,0.45454545454545453,0.5918367346938775,120,-145,0.433462641254849,0.566537358745151,away,BOS,over,8,0.5348837209302326,-115,0.5109810284308424,DET,BOS,2023 REG,6,5,12,14,19,18,0,1,-9,9,1,1,1,1,1,0,0,0,0,0.5109810284308424,0.48901897156915763
90252,0.45454545454545453,0.5918367346938775,120,-145,0.433462641254849,0.566537358745151,home,DET,under,8,0.5098039215686274,-104,0.48901897156915763,DET,BOS,2023 REG,6,5,12,14,19,18,0,1,-9,9,1,1,1,1,1,0,0,0,0,0.5109810284308424,0.48901897156915763
90253,0.4,0.6402877697841727,150,-178,0.383884892086331,0.6161151079136691,away,STL,over,12,0.5391705069124424,-117,0.5140669063204599,COL,STL,2023 REG,12,6,11,9,15,23,0,1,-3,3,1,1,1,1,1,1,0,0,0,0.5140669063204599,0.4859330936795401
90253,0.4,0.6402877697841727,150,-178,0.383884892086331,0.6161151079136691,home,COL,under,12,0.5073891625615764,-103,0.4859330936795401,COL,STL,2023 REG,12,6,11,9,15,23,0,1,-3,3,1,1,1,1,1,1,0,0,0,0.5140669063204599,0.4859330936795401
90254,0.5689655172413793,0.47619047619047616,-132,110,0.5432733140818753,0.4567266859181247,away,SF,over,10.5,0.5238095238095238,-110,0.4988662131519274,CHC,SF,2023 REG,15,11,12,8,19,27,1,0,3,-3,1,1,1,1,1,1,1,1,0,0.4988662131519274,0.5011337868480725
90254,0.5689655172413793,0.47619047619047616,-132,110,0.5432733140818753,0.4567266859181247,home,CHC,under,10.5,0.5238095238095238,-110,0.5011337868480725,CHC,SF,2023 REG,15,11,12,8,19,27,1,0,3,-3,1,1,1,1,1,1,1,1,0,0.4988662131519274,0.5011337868480725
90255,0.42372881355932196,0.6183206106870228,136,-162,0.40591126091256574,0.5940887390874343,away,TEX,over,9,0.5454545454545454,-120,0.5206611570247933,NYM,TEX,2023 REG,11,6,7,5,11,18,1,0,1,-1,1,1,1,1,1,0,0,0,0,0.5206611570247933,0.4793388429752067
90255,0.42372881355932196,0.6183206106870228,136,-162,0.40591126091256574,0.5940887390874343,home,NYM,under,9,0.5,100,0.4793388429752067,NYM,TEX,2023 REG,11,6,7,5,11,18,1,0,1,-1,1,1,1,1,1,0,0,0,0,0.5206611570247933,0.4793388429752067
90256,0.574468085106383,0.46511627906976744,-135,115,0.5517281312179562,0.44827186878204384,away,LAA,over,9,0.5454545454545454,-120,0.5193043049216726,NYY,LAA,2023 REG,6,3,7,2,5,13,1,0,1,-1,1,1,0,0,0,0,0,0,0,0.5193043049216726,0.48069569507832743
90256,0.574468085106383,0.46511627906976744,-135,115,0.5517281312179562,0.44827186878204384,home,NYY,under,9,0.5024875621890548,-101,0.48069569507832743,NYY,LAA,2023 REG,6,3,7,2,5,13,1,0,1,-1,1,1,0,0,0,0,0,0,0,0.5193043049216726,0.48069569507832743
90257,0.5901639344262295,0.4484304932735426,-144,123,0.5673868951280033,0.43261310487199667,away,SF,over,8.5,0.5121951219512195,-105,0.48808156828023186,PHI,SF,2023 REG,17,10,9,4,14,26,1,0,6,-6,1,1,1,1,0,0,0,0,0,0.48808156828023186,0.5119184317197681
90257,0.5901639344262295,0.4484304932735426,-144,123,0.5673868951280033,0.43261310487199667,home,PHI,under,8.5,0.5348837209302326,-115,0.5119184317197681,PHI,SF,2023 REG,17,10,9,4,14,26,1,0,6,-6,1,1,1,1,0,0,0,0,0,0.48808156828023186,0.5119184317197681
90258,0.5454545454545454,0.49504950495049505,-120,102,0.5233614270517961,0.4766385729482039,away,HOU,over,8.5,0.5,100,0.4783105022831051,TB,HOU,2023 REG,2,0,5,1,1,7,0,1,-1,1,0,0,0,0,0,0,0,0,0,0.4783105022831051,0.5216894977168949
90258,0.5454545454545454,0.49504950495049505,-120,102,0.5233614270517961,0.4766385729482039,home,TB,under,8.5,0.5433789954337899,-119,0.5216894977168949,TB,HOU,2023 REG,2,0,5,1,1,7,0,1,-1,1,0,0,0,0,0,0,0,0,0,0.4783105022831051,0.5216894977168949
90260,0.574468085106383,0.4629629629629629,-135,116,0.5529651425984609,0.44703485740153914,away,BOS,over,8.5,0.5073891625615764,-103,0.4826927225525911,TB,BOS,2023 REG,11,9,10,7,16,21,1,0,2,-2,1,1,1,1,1,1,1,0,0,0.4826927225525911,0.5173072774474089
90260,0.574468085106383,0.4629629629629629,-135,116,0.5529651425984609,0.44703485740153914,home,TB,under,8.5,0.5412844036697247,-118,0.5173072774474089,TB,BOS,2023 REG,11,9,10,7,16,21,1,0,2,-2,1,1,1,1,1,1,1,0,0,0.4826927225525911,0.5173072774474089
90261,0.425531914893617,0.6212121212121212,135,-164,0.40564083569968584,0.5943591643003141,away,NYM,over,10.5,0.5327102803738317,-114,0.508788710910954,CIN,NYM,2023 REG,10,7,7,6,13,17,1,0,1,-1,1,1,1,1,1,1,0,0,0,0.508788710910954,0.491211289089046
90261,0.425531914893617,0.6212121212121212,135,-164,0.40564083569968584,0.5943591643003141,home,CIN,under,10.5,0.5121951219512195,-105,0.491211289089046,CIN,NYM,2023 REG,10,7,7,6,13,17,1,0,1,-1,1,1,1,1,1,1,0,0,0,0.508788710910954,0.491211289089046
90262,0.5391705069124424,0.5,-117,100,0.5180509248444435,0.4819490751555565,away,MIA,over,8.5,0.5348837209302326,-115,0.5097020142727117,TEX,MIA,2023 REG,8,6,6,0,6,14,1,0,6,-6,0,0,0,0,0,0,0,0,0,0.5097020142727117,0.49029798572728833
90262,0.5391705069124424,0.5,-117,100,0.5180509248444435,0.4819490751555565,home,TEX,under,8.5,0.5121951219512195,-105,0.49029798572728833,TEX,MIA,2023 REG,8,6,6,0,6,14,1,0,6,-6,0,0,0,0,0,0,0,0,0,0.5097020142727117,0.49029798572728833
90263,0.5327102803738317,0.5098039215686274,-114,-104,0.5100625279371946,0.48993747206280536,away,SEA,over,9.5,0.5238095238095238,-110,0.4988662131519274,ATL,SEA,2023 REG,7,3,3,2,5,10,1,0,1,-1,1,1,0,0,0,0,0,0,0,0.4988662131519274,0.5011337868480725
90263,0.5327102803738317,0.5098039215686274,-114,-104,0.5100625279371946,0.48993747206280536,home,ATL,under,9.5,0.5238095238095238,-110,0.5011337868480725,ATL,SEA,2023 REG,7,3,3,2,5,10,1,0,1,-1,1,1,0,0,0,0,0,0,0,0.4988662131519274,0.5011337868480725
90264,0.7530864197530864,0.2881844380403458,-305,247,0.7220058972172918,0.2779941027827082,away,COL,over,9,0.5412844036697247,-118,0.5189377998484975,ATL,COL,2023 REG,18,14,11,6,20,29,1,0,8,-8,1,1,1,1,1,1,0,0,0,0.5189377998484975,0.4810622001515025
90264,0.7530864197530864,0.2881844380403458,-305,247,0.7220058972172918,0.2779941027827082,home,ATL,under,9,0.5,100,0.4810622001515025,ATL,COL,2023 REG,18,14,11,6,20,29,1,0,8,-8,1,1,1,1,1,1,0,0,0,0.5189377998484975,0.4810622001515025
90265,0.5348837209302326,0.5073891625615764,-115,-103,0.5122726437136835,0.48772735628631647,away,MIA,over,8.5,0.5145631067961165,-106,0.49023796582517226,CWS,MIA,2023 REG,5,1,10,5,6,15,0,1,-4,4,1,0,0,0,0,0,0,0,0,0.49023796582517226,0.5097620341748277
90265,0.5348837209302326,0.5073891625615764,-115,-103,0.5122726437136835,0.48772735628631647,home,CWS,under,8.5,0.5327102803738317,-114,0.5097620341748277,CWS,MIA,2023 REG,5,1,10,5,6,15,0,1,-4,4,1,0,0,0,0,0,0,0,0,0.49023796582517226,0.5097620341748277
90266,0.5652173913043479,0.47619047619047616,-130,110,0.5418129444594474,0.4581870555405526,away,SD,over,8.5,0.5348837209302326,-115,0.5109810284308424,MIN,SD,2023 REG,9,4,4,3,7,13,1,0,1,-1,1,1,1,0,0,0,0,0,0,0.5109810284308424,0.48901897156915763
90266,0.5652173913043479,0.47619047619047616,-130,110,0.5418129444594474,0.4581870555405526,home,MIN,under,8.5,0.5098039215686274,-104,0.48901897156915763,MIN,SD,2023 REG,9,4,4,3,7,13,1,0,1,-1,1,1,1,0,0,0,0,0,0,0.5109810284308424,0.48901897156915763
90267,0.6825396825396826,0.3508771929824561,-215,185,0.6597313389293339,0.3402686610706661,away,PIT,over,7,0.5495495495495495,-122,0.5223196169142115,TB,PIT,2023 REG,10,8,7,1,9,17,1,0,7,-7,1,0,0,0,0,0,0,0,0,0.5223196169142115,0.47768038308578853
90267,0.6825396825396826,0.3508771929824561,-215,185,0.6597313389293339,0.3402686610706661,home,TB,under,7,0.5,100,0.47768038308578853,TB,PIT,2023 REG,10,8,7,1,9,17,1,0,7,-7,1,0,0,0,0,0,0,0,0,0.5223196169142115,0.47768038308578853
90268,0.4166666666666667,0.6153846153846154,140,-160,0.40331196581196577,0.5966880341880343,away,NYM,over,10,0.5327102803738317,-114,0.508788710910954,WSH,NYM,2023 REG,15,10,11,3,13,26,1,0,7,-7,1,1,1,0,0,0,0,0,0,0.508788710910954,0.491211289089046
90268,0.4166666666666667,0.6153846153846154,140,-160,0.40331196581196577,0.5966880341880343,home,WSH,under,10,0.5121951219512195,-105,0.491211289089046,WSH,NYM,2023 REG,15,10,11,3,13,26,1,0,7,-7,1,1,1,0,0,0,0,0,0,0.508788710910954,0.491211289089046
90269,0.5850622406639003,0.45454545454545453,-141,120,0.5618892737571823,0.43811072624281766,away,HOU,over,10,0.5098039215686274,-104,0.48592421718142587,BAL,HOU,2023 REG,7,2,11,8,10,18,0,1,-6,6,1,1,0,0,0,0,0,0,0,0.48592421718142587,0.5140757828185741
90269,0.5850622406639003,0.45454545454545453,-141,120,0.5618892737571823,0.43811072624281766,home,BAL,under,10,0.5370370370370371,-116,0.5140757828185741,BAL,HOU,2023 REG,7,2,11,8,10,18,0,1,-6,6,1,1,0,0,0,0,0,0,0,0.48592421718142587,0.5140757828185741
90270,0.7435897435897436,0.3058103975535168,-290,227,0.7068563053037293,0.29314369469627066,away,OAK,over,8.5,0.5283018867924528,-112,0.5031902949311281,SEA,OAK,2023 REG,14,7,4,0,7,18,1,0,7,-7,0,0,0,0,0,0,0,0,0,0.5031902949311281,0.4968097050688719
90270,0.7435897435897436,0.3058103975535168,-290,227,0.7068563053037293,0.29314369469627066,home,SEA,under,8.5,0.5192307692307692,-108,0.4968097050688719,SEA,OAK,2023 REG,14,7,4,0,7,18,1,0,7,-7,0,0,0,0,0,0,0,0,0,0.5031902949311281,0.4968097050688719
90271,0.4587155963302753,0.5780590717299579,118,-137,0.4418464825411775,0.5581535174588226,away,LAD,over,9.5,0.5238095238095238,-110,0.4988662131519274,ARI,LAD,2023 REG,16,11,7,6,17,23,1,0,5,-5,1,1,1,1,1,1,0,0,0,0.4988662131519274,0.5011337868480725
90271,0.4587155963302753,0.5780590717299579,118,-137,0.4418464825411775,0.5581535174588226,home,ARI,under,9.5,0.5238095238095238,-110,0.5011337868480725,ARI,LAD,2023 REG,16,11,7,6,17,23,1,0,5,-5,1,1,1,1,1,1,0,0,0,0.4988662131519274,0.5011337868480725
90272,0.5348837209302326,0.5073891625615764,-115,-103,0.5122726437136835,0.48772735628631647,away,LAD,over,8,0.5215311004784688,-109,0.49670754937970685,TB,LAD,2023 REG,9,5,9,6,11,18,0,1,-1,1,1,1,1,1,1,0,0,0,0,0.49670754937970685,0.5032924506202932
90272,0.5348837209302326,0.5073891625615764,-115,-103,0.5122726437136835,0.48772735628631647,home,TB,under,8,0.5260663507109005,-111,0.5032924506202932,TB,LAD,2023 REG,9,5,9,6,11,18,0,1,-1,1,1,1,1,1,1,0,0,0,0,0.49670754937970685,0.5032924506202932
90273,0.5,0.5454545454545454,100,-120,0.4772727272727273,0.5227272727272727,away,MIL,over,8.5,0.5169082125603864,-107,0.49353874091423283,STL,MIL,2023 REG,6,2,10,8,10,16,0,1,-6,6,1,1,0,0,0,0,0,0,0,0.49353874091423283,0.5064612590857671
90273,0.5,0.5454545454545454,100,-120,0.4772727272727273,0.5227272727272727,home,STL,under,8.5,0.5283018867924528,-112,0.5064612590857671,STL,MIL,2023 REG,6,2,10,8,10,16,0,1,-6,6,1,1,0,0,0,0,0,0,0,0.49353874091423283,0.5064612590857671
90274,0.5555555555555556,0.4854368932038835,-125,106,0.5327819729114227,0.4672180270885773,away,ATL,over,8,0.5238095238095238,-110,0.5000596729920038,TB,ATL,2023 REG,10,10,9,4,14,19,1,0,6,-6,1,1,1,1,0,0,0,0,0,0.5000596729920038,0.4999403270079962
90274,0.5555555555555556,0.4854368932038835,-125,106,0.5327819729114227,0.4672180270885773,home,TB,under,8,0.5215311004784688,-109,0.4999403270079962,TB,ATL,2023 REG,10,10,9,4,14,19,1,0,6,-6,1,1,1,1,0,0,0,0,0,0.5000596729920038,0.4999403270079962
90275,0.6721311475409836,0.36363636363636365,-205,175,0.6480906892086682,0.3519093107913318,away,MIA,over,7.5,0.5283018867924528,-112,0.5044173060022736,LAA,MIA,2023 REG,8,5,8,8,13,16,0,1,-3,3,1,1,1,1,1,0,0,0,0,0.5044173060022736,0.49558269399772636
90275,0.6721311475409836,0.36363636363636365,-205,175,0.6480906892086682,0.3519093107913318,home,LAA,under,7.5,0.5169082125603864,-107,0.49558269399772636,LAA,MIA,2023 REG,8,5,8,8,13,16,0,1,-3,3,1,1,1,1,1,0,0,0,0,0.5044173060022736,0.49558269399772636
90276,0.45248868778280543,0.5833333333333333,121,-140,0.4362796284542359,0.5637203715457642,away,STL,over,8.5,0.5073891625615764,-103,0.4826927225525911,CLE,STL,2023 REG,11,4,8,3,7,19,1,0,1,-1,1,1,1,0,0,0,0,0,0,0.4826927225525911,0.5173072774474089
90276,0.45248868778280543,0.5833333333333333,121,-140,0.4362796284542359,0.5637203715457642,home,CLE,under,8.5,0.5412844036697247,-118,0.5173072774474089,CLE,STL,2023 REG,11,4,8,3,7,19,1,0,1,-1,1,1,1,0,0,0,0,0,0,0.4826927225525911,0.5173072774474089
90277,0.607843137254902,0.4366812227074236,-155,129,0.5807793106111354,0.4192206893888646,away,NYY,over,9.5,0.5121951219512195,-105,0.48808156828023186,BOS,NYY,2023 REG,7,2,5,3,5,12,0,1,-1,1,1,1,0,0,0,0,0,0,0,0.48808156828023186,0.5119184317197681
90277,0.607843137254902,0.4366812227074236,-155,129,0.5807793106111354,0.4192206893888646,home,BOS,under,9.5,0.5348837209302326,-115,0.5119184317197681,BOS,NYY,2023 REG,7,2,5,3,5,12,0,1,-1,1,1,1,0,0,0,0,0,0,0,0.48808156828023186,0.5119184317197681
90278,0.574468085106383,0.4672897196261683,-135,114,0.550479558983428,0.44952044101657196,away,PIT,over,9.5,0.5073891625615764,-103,0.4826927225525911,NYM,PIT,2023 REG,9,7,5,2,9,14,1,0,5,-5,1,1,0,0,0,0,0,0,0,0.4826927225525911,0.5173072774474089
90278,0.574468085106383,0.4672897196261683,-135,114,0.550479558983428,0.44952044101657196,home,NYM,under,9.5,0.5412844036697247,-118,0.5173072774474089,NYM,PIT,2023 REG,9,7,5,2,9,14,1,0,5,-5,1,1,0,0,0,0,0,0,0,0.4826927225525911,0.5173072774474089
90279,0.49751243781094534,0.5454545454545454,101,-120,0.476135829221149,0.523864170778851,away,TEX,over,8,0.5121951219512195,-105,0.48808156828023186,CLE,TEX,2023 REG,15,12,6,3,15,21,1,0,9,-9,1,1,1,0,0,0,0,0,0,0.48808156828023186,0.5119184317197681
90279,0.49751243781094534,0.5454545454545454,101,-120,0.476135829221149,0.523864170778851,home,CLE,under,8,0.5348837209302326,-115,0.5119184317197681,CLE,TEX,2023 REG,15,12,6,3,15,21,1,0,9,-9,1,1,1,0,0,0,0,0,0,0.48808156828023186,0.5119184317197681
90280,0.6296296296296295,0.4065040650406504,-170,146,0.606878784837231,0.393121215162769,away,COL,over,10.5,0.5121951219512195,-105,0.48808156828023186,CIN,COL,2023 REG,8,5,10,4,9,18,1,0,1,-1,1,1,1,1,0,0,0,0,0,0.48808156828023186,0.5119184317197681
90280,0.6296296296296295,0.4065040650406504,-170,146,0.606878784837231,0.393121215162769,home,CIN,under,10.5,0.5348837209302326,-115,0.5119184317197681,CIN,COL,2023 REG,8,5,10,4,9,18,1,0,1,-1,1,1,1,1,0,0,0,0,0,0.48808156828023186,0.5119184317197681
90281,0.425531914893617,0.6153846153846154,135,-160,0.4081206254135181,0.5918793745864819,away,TB,over,9,0.5169082125603864,-107,0.49239402434819424,DET,TB,2023 REG,11,6,13,10,16,24,0,1,-4,4,1,1,1,1,1,1,0,0,0,0.49239402434819424,0.5076059756518058
90281,0.425531914893617,0.6153846153846154,135,-160,0.4081206254135181,0.5918793745864819,home,DET,under,9,0.5305164319248826,-113,0.5076059756518058,DET,TB,2023 REG,11,6,13,10,16,24,0,1,-4,4,1,1,1,1,1,1,0,0,0,0.49239402434819424,0.5076059756518058
90282,0.5238095238095238,0.5215311004784688,-110,-109,0.5000596729920038,0.4999403270079962,away,CLE,over,9,0.5073891625615764,-103,0.4826927225525911,ARI,CLE,2023 REG,8,6,10,3,9,18,1,0,3,-3,1,1,1,0,0,0,0,0,0,0.4826927225525911,0.5173072774474089
90282,0.5238095238095238,0.5215311004784688,-110,-109,0.5000596729920038,0.4999403270079962,home,ARI,under,9,0.5412844036697247,-118,0.5173072774474089,ARI,CLE,2023 REG,8,6,10,3,9,18,1,0,3,-3,1,1,1,0,0,0,0,0,0,0.4826927225525911,0.5173072774474089
90283,0.6226415094339623,0.4166666666666667,-165,140,0.5981666073335706,0.40183339266642937,away,WSH,over,9,0.5169082125603864,-107,0.49353874091423283,SF,WSH,2023 REG,8,6,12,11,17,20,0,1,-5,5,1,1,1,1,1,1,0,0,0,0.49353874091423283,0.5064612590857671
90283,0.6226415094339623,0.4166666666666667,-165,140,0.5981666073335706,0.40183339266642937,home,SF,under,9,0.5283018867924528,-112,0.5064612590857671,SF,WSH,2023 REG,8,6,12,11,17,20,0,1,-5,5,1,1,1,1,1,1,0,0,0,0.49353874091423283,0.5064612590857671
90284,0.49504950495049505,0.5475113122171946,102,-121,0.4739797934813417,0.5260202065186583,away,CIN,over,8.5,0.5121951219512195,-105,0.48808156828023186,STL,CIN,2023 REG,9,4,9,3,7,18,1,0,1,-1,1,1,1,0,0,0,0,0,0,0.48808156828023186,0.5119184317197681
90284,0.49504950495049505,0.5475113122171946,102,-121,0.4739797934813417,0.5260202065186583,home,STL,under,8.5,0.5348837209302326,-115,0.5119184317197681,STL,CIN,2023 REG,9,4,9,3,7,18,1,0,1,-1,1,1,1,0,0,0,0,0,0,0.48808156828023186,0.5119184317197681
90285,0.5238095238095238,0.5121951219512195,-110,-105,0.5049499474586583,0.4950500525413417,away,CWS,over,9,0.5145631067961165,-106,0.4913668392989033,KC,CWS,2023 REG,6,4,8,3,7,14,1,0,1,-1,1,1,1,0,0,0,0,0,0,0.4913668392989033,0.5086331607010968
90285,0.5238095238095238,0.5121951219512195,-110,-105,0.5049499474586583,0.4950500525413417,home,KC,under,9,0.5305164319248826,-113,0.5086331607010968,KC,CWS,2023 REG,6,4,8,3,7,14,1,0,1,-1,1,1,1,0,0,0,0,0,0,0.4913668392989033,0.5086331607010968
90286,0.6363636363636364,0.4081632653061224,-175,145,0.6080283353010626,0.3919716646989374,away,MIL,over,8.5,0.5192307692307692,-108,0.49688292476754015,SF,MIL,2023 REG,6,4,6,1,5,12,1,0,3,-3,1,0,0,0,0,0,0,0,0,0.49688292476754015,0.5031170752324599
90286,0.6363636363636364,0.4081632653061224,-175,145,0.6080283353010626,0.3919716646989374,home,SF,under,8.5,0.5238095238095238,-110,0.5031170752324599,SF,MIL,2023 REG,6,4,6,1,5,12,1,0,3,-3,1,0,0,0,0,0,0,0,0,0.49688292476754015,0.5031170752324599
90287,0.6428571428571428,0.3921568627450981,-180,155,0.6203481392557023,0.3796518607442977,away,PIT,over,9,0.5098039215686274,-104,0.4870219861770517,MIL,PIT,2023 REG,8,4,12,8,12,20,0,1,-4,4,1,1,1,1,0,0,0,0,0,0.4870219861770517,0.5129780138229483
90287,0.6428571428571428,0.3921568627450981,-180,155,0.6203481392557023,0.3796518607442977,home,MIL,under,9,0.5348837209302326,-115,0.5129780138229483,MIL,PIT,2023 REG,8,4,12,8,12,20,0,1,-4,4,1,1,1,1,0,0,0,0,0,0.4870219861770517,0.5129780138229483
90288,0.5633187772925764,0.47619047619047616,-129,110,0.5410624729287608,0.45893752707123925,away,NYY,over,9.5,0.5098039215686274,-104,0.48592421718142587,BOS,NYY,2023 REG,6,1,9,4,5,15,0,1,-3,3,1,0,0,0,0,0,0,0,0,0.48592421718142587,0.5140757828185741
90288,0.5633187772925764,0.47619047619047616,-129,110,0.5410624729287608,0.45893752707123925,home,BOS,under,9.5,0.5370370370370371,-116,0.5140757828185741,BOS,NYY,2023 REG,6,1,9,4,5,15,0,1,-3,3,1,0,0,0,0,0,0,0,0,0.48592421718142587,0.5140757828185741
90289,0.6108949416342413,0.425531914893617,-157,135,0.5886419592417365,0.41135804075826354,away,PHI,over,9,0.5073891625615764,-103,0.4826927225525911,HOU,PHI,2023 REG,9,4,5,3,7,14,1,0,1,-1,1,1,1,0,0,0,0,0,0,0.4826927225525911,0.5173072774474089
90289,0.6108949416342413,0.425531914893617,-157,135,0.5886419592417365,0.41135804075826354,home,HOU,under,9,0.5412844036697247,-118,0.5173072774474089,HOU,PHI,2023 REG,9,4,5,3,7,14,1,0,1,-1,1,1,1,0,0,0,0,0,0,0.4826927225525911,0.5173072774474089
90290,0.6183206106870228,0.42194092827004215,-162,137,0.5934260713318911,0.40657392866810893,away,DET,over,7.5,0.5,100,0.4772727272727273,MIA,DET,2023 REG,12,6,11,5,11,23,1,0,1,-1,1,1,1,1,1,0,0,0,0,0.4772727272727273,0.5227272727272727
90290,0.6183206106870228,0.42194092827004215,-162,137,0.5934260713318911,0.40657392866810893,home,MIA,under,7.5,0.5454545454545454,-120,0.5227272727272727,MIA,DET,2023 REG,12,6,11,5,11,23,1,0,1,-1,1,1,1,1,1,0,0,0,0,0.4772727272727273,0.5227272727272727
90291,0.5867768595041323,0.45248868778280543,-142,121,0.563736744980392,0.43626325501960805,away,NYY,over,7.5,0.5169082125603864,-107,0.49353874091423283,SEA,NYY,2023 REG,5,1,3,0,1,8,1,0,1,-1,0,0,0,0,0,0,0,0,0,0.49353874091423283,0.5064612590857671
90291,0.5867768595041323,0.45248868778280543,-142,121,0.563736744980392,0.43626325501960805,home,SEA,under,7.5,0.5283018867924528,-112,0.5064612590857671,SEA,NYY,2023 REG,5,1,3,0,1,8,1,0,1,-1,0,0,0,0,0,0,0,0,0,0.49353874091423283,0.5064612590857671
90292,0.5238095238095238,0.5238095238095238,-110,-110,0.4988662131519274,0.5011337868480725,away,CIN,over,8.5,0.5169082125603864,-107,0.49353874091423283,NYM,CIN,2023 REG,8,2,9,3,5,17,0,1,-1,1,1,1,0,0,0,0,0,0,0,0.49353874091423283,0.5064612590857671
90292,0.5238095238095238,0.5238095238095238,-110,-110,0.4988662131519274,0.5011337868480725,home,NYM,under,8.5,0.5283018867924528,-112,0.5064612590857671,NYM,CIN,2023 REG,8,2,9,3,5,17,0,1,-1,1,1,1,0,0,0,0,0,0,0,0.49353874091423283,0.5064612590857671
90293,0.5348837209302326,0.5121951219512195,-115,-105,0.5097020142727117,0.49029798572728833,away,MIL,over,8.5,0.5454545454545454,-120,0.5206611570247933,PIT,MIL,2023 REG,7,3,8,6,9,15,0,1,-3,3,1,1,1,0,0,0,0,0,0,0.5206611570247933,0.4793388429752067
90293,0.5348837209302326,0.5121951219512195,-115,-105,0.5097020142727117,0.49029798572728833,home,PIT,under,8.5,0.5,100,0.4793388429752067,PIT,MIL,2023 REG,7,3,8,6,9,15,0,1,-3,3,1,1,1,0,0,0,0,0,0,0.5206611570247933,0.4793388429752067
90294,0.39370078740157477,0.6453900709219857,154,-182,0.3783106856993856,0.6216893143006144,away,BAL,over,8.5,0.5348837209302326,-115,0.5097020142727117,LAA,BAL,2023 REG,12,4,13,5,9,25,0,1,-1,1,1,1,1,1,0,0,0,0,0,0.5097020142727117,0.49029798572728833
90294,0.39370078740157477,0.6453900709219857,154,-182,0.3783106856993856,0.6216893143006144,home,LAA,under,8.5,0.5121951219512195,-105,0.49029798572728833,LAA,BAL,2023 REG,12,4,13,5,9,25,0,1,-1,1,1,1,1,1,0,0,0,0,0,0.5097020142727117,0.49029798572728833
90295,0.39840637450199207,0.6428571428571428,151,-180,0.3819667261517391,0.6180332738482609,away,BOS,over,10,0.5412844036697247,-118,0.5149381613977361,KC,BOS,2023 REG,11,5,13,9,14,24,0,1,-4,4,1,1,1,1,1,0,0,0,0,0.5149381613977361,0.48506183860226393
90295,0.39840637450199207,0.6428571428571428,151,-180,0.3819667261517391,0.6180332738482609,home,KC,under,10,0.5073891625615764,-103,0.48506183860226393,KC,BOS,2023 REG,11,5,13,9,14,24,0,1,-4,4,1,1,1,1,1,0,0,0,0,0.5149381613977361,0.48506183860226393
90296,0.425531914893617,0.613899613899614,135,-159,0.40875254093905067,0.5912474590609493,away,SD,over,9,0.5348837209302326,-115,0.5097020142727117,ARI,SD,2023 REG,6,5,8,7,12,14,0,1,-2,2,1,1,1,1,1,0,0,0,0,0.5097020142727117,0.49029798572728833
90296,0.425531914893617,0.613899613899614,135,-159,0.40875254093905067,0.5912474590609493,home,ARI,under,9,0.5121951219512195,-105,0.49029798572728833,ARI,SD,2023 REG,6,5,8,7,12,14,0,1,-2,2,1,1,1,1,1,0,0,0,0,0.5097020142727117,0.49029798572728833
90297,0.6875,0.35714285714285715,-220,180,0.6568080357142857,0.3431919642857143,away,PIT,over,7.5,0.5145631067961165,-106,0.4913668392989033,MIA,PIT,2023 REG,7,1,7,3,4,14,0,1,-2,2,1,0,0,0,0,0,0,0,0,0.4913668392989033,0.5086331607010968
90297,0.6875,0.35714285714285715,-220,180,0.6568080357142857,0.3431919642857143,home,MIA,under,7.5,0.5305164319248826,-113,0.5086331607010968,MIA,PIT,2023 REG,7,1,7,3,4,14,0,1,-2,2,1,0,0,0,0,0,0,0,0,0.4913668392989033,0.5086331607010968
90298,0.5555555555555556,0.47619047619047616,-125,110,0.5379188712522047,0.4620811287477953,away,SF,over,8,0.5433789954337899,-119,0.5184560714286826,CWS,SF,2023 REG,11,6,20,16,22,31,0,1,-10,10,1,1,1,1,1,1,0,0,0,0.5184560714286826,0.48154392857131745
90298,0.5555555555555556,0.47619047619047616,-125,110,0.5379188712522047,0.4620811287477953,home,CWS,under,8,0.5024875621890548,-101,0.48154392857131745,CWS,SF,2023 REG,11,6,20,16,22,31,0,1,-10,10,1,1,1,1,1,1,0,0,0,0.5184560714286826,0.48154392857131745
90299,0.6296296296296295,0.4098360655737705,-170,144,0.6047808585756369,0.3952191414243631,away,STL,over,10,0.5121951219512195,-105,0.48808156828023186,BAL,STL,2023 REG,13,11,12,5,16,25,1,0,6,-6,1,1,1,1,1,0,0,0,0,0.48808156828023186,0.5119184317197681
90299,0.6296296296296295,0.4098360655737705,-170,144,0.6047808585756369,0.3952191414243631,home,BAL,under,10,0.5348837209302326,-115,0.5119184317197681,BAL,STL,2023 REG,13,11,12,5,16,25,1,0,6,-6,1,1,1,1,1,0,0,0,0,0.48808156828023186,0.5119184317197681
90300,0.4347826086956522,0.607843137254902,130,-155,0.41624967567367205,0.583750324326328,away,DET,over,9.5,0.5238095238095238,-110,0.4988662131519274,CWS,DET,2023 REG,6,2,5,3,5,11,0,1,-1,1,1,1,0,0,0,0,0,0,0,0.4988662131519274,0.5011337868480725
90300,0.4347826086956522,0.607843137254902,130,-155,0.41624967567367205,0.583750324326328,home,CWS,under,9.5,0.5238095238095238,-110,0.5011337868480725,CWS,DET,2023 REG,6,2,5,3,5,11,0,1,-1,1,1,1,0,0,0,0,0,0,0,0.4988662131519274,0.5011337868480725
90301,0.45454545454545453,0.5780590717299579,120,-137,0.439725215329358,0.560274784670642,away,ATL,over,8.5,0.5145631067961165,-106,0.49023796582517226,KC,ATL,2023 REG,11,3,14,9,12,25,0,1,-6,6,1,1,1,0,0,0,0,0,0,0.49023796582517226,0.5097620341748277
90301,0.45454545454545453,0.5780590717299579,120,-137,0.439725215329358,0.560274784670642,home,KC,under,8.5,0.5327102803738317,-114,0.5097620341748277,KC,ATL,2023 REG,11,3,14,9,12,25,0,1,-6,6,1,1,1,0,0,0,0,0,0,0.49023796582517226,0.5097620341748277
90302,0.6428571428571428,0.4,-180,150,0.6153061224489796,0.38469387755102036,away,WSH,over,10.5,0.5454545454545454,-120,0.5206611570247933,CIN,WSH,2023 REG,7,3,7,6,9,14,0,1,-3,3,1,1,1,0,0,0,0,0,0,0.5206611570247933,0.4793388429752067
90302,0.6428571428571428,0.4,-180,150,0.6153061224489796,0.38469387755102036,home,CIN,under,10.5,0.5,100,0.4793388429752067,CIN,WSH,2023 REG,7,3,7,6,9,14,0,1,-3,3,1,1,1,0,0,0,0,0,0,0.5206611570247933,0.4793388429752067
90303,0.6254681647940076,0.4081632653061224,-167,145,0.6044327759298813,0.3955672240701187,away,MIN,over,7,0.49504950495049505,102,0.4739797934813417,NYY,MIN,2023 REG,7,2,2,0,2,9,1,0,2,-2,0,0,0,0,0,0,0,0,0,0.4739797934813417,0.5260202065186583
90303,0.6254681647940076,0.4081632653061224,-167,145,0.6044327759298813,0.3955672240701187,home,NYY,under,7,0.5475113122171946,-121,0.5260202065186583,NYY,MIN,2023 REG,7,2,2,0,2,9,1,0,2,-2,0,0,0,0,0,0,0,0,0,0.4739797934813417,0.5260202065186583
90304,0.5215311004784688,0.5192307692307692,-109,-108,0.50027251771145,0.49972748228855,away,TB,over,7.5,0.5454545454545454,-120,0.5206611570247933,SD,TB,2023 REG,7,2,9,6,8,16,0,1,-4,4,1,1,0,0,0,0,0,0,0,0.5206611570247933,0.4793388429752067
90304,0.5215311004784688,0.5192307692307692,-109,-108,0.50027251771145,0.49972748228855,home,SD,under,7.5,0.5,100,0.4793388429752067,SD,TB,2023 REG,7,2,9,6,8,16,0,1,-4,4,1,1,0,0,0,0,0,0,0,0.5206611570247933,0.4793388429752067
90305,0.6000000000000001,0.4347826086956522,-150,130,0.5791304347826086,0.4208695652173914,away,BOS,over,8.5,0.5169082125603864,-107,0.49353874091423283,CLE,BOS,2023 REG,15,10,8,3,13,23,1,0,7,-7,1,1,1,0,0,0,0,0,0,0.49353874091423283,0.5064612590857671
90305,0.6000000000000001,0.4347826086956522,-150,130,0.5791304347826086,0.4208695652173914,home,CLE,under,8.5,0.5283018867924528,-112,0.5064612590857671,CLE,BOS,2023 REG,15,10,8,3,13,23,1,0,7,-7,1,1,1,0,0,0,0,0,0,0.49353874091423283,0.5064612590857671
90306,0.574468085106383,0.46511627906976744,-135,115,0.5517281312179562,0.44827186878204384,away,PIT,over,9.5,0.5327102803738317,-114,0.508788710910954,CIN,PIT,2023 REG,16,12,16,13,25,32,0,1,-1,1,1,1,1,1,1,1,1,1,1,0.508788710910954,0.491211289089046
90306,0.574468085106383,0.46511627906976744,-135,115,0.5517281312179562,0.44827186878204384,home,CIN,under,9.5,0.5121951219512195,-105,0.491211289089046,CIN,PIT,2023 REG,16,12,16,13,25,32,0,1,-1,1,1,1,1,1,1,1,1,1,1,0.508788710910954,0.491211289089046
90307,0.48780487804878053,0.5454545454545454,105,-120,0.4715807690227679,0.5284192309772321,away,NYY,over,8,0.5391705069124424,-117,0.5140669063204599,TEX,NYY,2023 REG,11,15,8,2,17,19,1,0,13,-13,1,1,0,0,0,0,0,0,0,0.5140669063204599,0.4859330936795401
90307,0.48780487804878053,0.5454545454545454,105,-120,0.4715807690227679,0.5284192309772321,home,TEX,under,8,0.5073891625615764,-103,0.4859330936795401,TEX,NYY,2023 REG,11,15,8,2,17,19,1,0,13,-13,1,1,0,0,0,0,0,0,0,0.5140669063204599,0.4859330936795401
90308,0.5555555555555556,0.4854368932038835,-125,106,0.5327819729114227,0.4672180270885773,away,MIL,over,8,0.5283018867924528,-112,0.5031902949311281,TEX,MIL,2023 REG,8,8,14,9,17,22,0,1,-1,1,1,1,1,1,1,1,1,1,0,0.5031902949311281,0.4968097050688719
90308,0.5555555555555556,0.4854368932038835,-125,106,0.5327819729114227,0.4672180270885773,home,TEX,under,8,0.5192307692307692,-108,0.4968097050688719,TEX,MIL,2023 REG,8,8,14,9,17,22,0,1,-1,1,1,1,1,1,1,1,1,1,0,0.5031902949311281,0.4968097050688719
90309,0.5495495495495495,0.48780487804878053,-122,105,0.529021440689206,0.470978559310794,away,BOS,over,10,0.5145631067961165,-106,0.4913668392989033,PHI,BOS,2023 REG,9,6,5,1,7,14,1,0,5,-5,1,0,0,0,0,0,0,0,0,0.4913668392989033,0.5086331607010968
90309,0.5495495495495495,0.48780487804878053,-122,105,0.529021440689206,0.470978559310794,home,PHI,under,10,0.5305164319248826,-113,0.5086331607010968,PHI,BOS,2023 REG,9,6,5,1,7,14,1,0,5,-5,1,0,0,0,0,0,0,0,0,0.4913668392989033,0.5086331607010968
90310,0.6666666666666666,0.37037037037037035,-200,170,0.6419753086419753,0.3580246913580247,away,CWS,over,8.5,0.5454545454545454,-120,0.5206611570247933,LAD,CWS,2023 REG,8,5,3,1,6,11,1,0,4,-4,1,0,0,0,0,0,0,0,0,0.5206611570247933,0.4793388429752067
90310,0.6666666666666666,0.37037037037037035,-200,170,0.6419753086419753,0.3580246913580247,home,LAD,under,8.5,0.5,100,0.4793388429752067,LAD,CWS,2023 REG,8,5,3,1,6,11,1,0,4,-4,1,0,0,0,0,0,0,0,0,0.5206611570247933,0.4793388429752067
90311,0.5515695067264574,0.49019607843137253,-123,104,0.5285328835228112,0.47146711647718875,away,BAL,over,8,0.5169082125603864,-107,0.49239402434819424,MIN,BAL,2023 REG,9,2,6,6,8,15,0,1,-4,4,1,1,0,0,0,0,0,0,0,0.49239402434819424,0.5076059756518058
90311,0.5515695067264574,0.49019607843137253,-123,104,0.5285328835228112,0.47146711647718875,home,MIN,under,8,0.5305164319248826,-113,0.5076059756518058,MIN,BAL,2023 REG,9,2,6,6,8,15,0,1,-4,4,1,1,0,0,0,0,0,0,0,0.49239402434819424,0.5076059756518058
90312,0.44052863436123346,0.601593625498008,127,-151,0.42197257274923283,0.5780274272507672,away,ARI,over,9,0.5238095238095238,-110,0.5000596729920038,CWS,ARI,2023 REG,9,4,12,15,19,21,0,1,-11,11,1,1,1,1,0,0,0,0,0,0.5000596729920038,0.4999403270079962
90312,0.44052863436123346,0.601593625498008,127,-151,0.42197257274923283,0.5780274272507672,home,CWS,under,9,0.5215311004784688,-109,0.4999403270079962,CWS,ARI,2023 REG,9,4,12,15,19,21,0,1,-11,11,1,1,1,1,0,0,0,0,0,0.5000596729920038,0.4999403270079962
90313,0.613899613899614,0.42016806722689076,-159,138,0.5929854776095975,0.4070145223904025,away,SD,over,9.5,0.5169082125603864,-107,0.49353874091423283,LAD,SD,2023 REG,4,4,3,0,4,7,1,0,4,-4,0,0,0,0,0,0,0,0,0,0.49353874091423283,0.5064612590857671
90313,0.613899613899614,0.42016806722689076,-159,138,0.5929854776095975,0.4070145223904025,home,LAD,under,9.5,0.5283018867924528,-112,0.5064612590857671,LAD,SD,2023 REG,4,4,3,0,4,7,1,0,4,-4,0,0,0,0,0,0,0,0,0,0.49353874091423283,0.5064612590857671
90314,0.3921568627450981,0.6428571428571428,155,-180,0.37842588015598405,0.6215741198440159,away,NYY,over,8.5,0.5098039215686274,-104,0.48592421718142587,CLE,NYY,2023 REG,7,2,13,11,13,20,0,1,-9,9,1,1,0,0,0,0,0,0,0,0.48592421718142587,0.5140757828185741
90314,0.3921568627450981,0.6428571428571428,155,-180,0.37842588015598405,0.6215741198440159,home,CLE,under,8.5,0.5370370370370371,-116,0.5140757828185741,CLE,NYY,2023 REG,7,2,13,11,13,20,0,1,-9,9,1,1,0,0,0,0,0,0,0,0.48592421718142587,0.5140757828185741
90315,0.6226415094339623,0.4166666666666667,-165,140,0.5981666073335706,0.40183339266642937,away,TEX,over,8.5,0.5215311004784688,-109,0.4978845547971712,SD,TEX,2023 REG,9,7,6,1,8,15,1,0,6,-6,1,0,0,0,0,0,0,0,0,0.4978845547971712,0.5021154452028288
90315,0.6226415094339623,0.4166666666666667,-165,140,0.5981666073335706,0.40183339266642937,home,SD,under,8.5,0.5238095238095238,-110,0.5021154452028288,SD,TEX,2023 REG,9,7,6,1,8,15,1,0,6,-6,1,0,0,0,0,0,0,0,0,0.4978845547971712,0.5021154452028288
90316,0.5555555555555556,0.47619047619047616,-125,110,0.5379188712522047,0.4620811287477953,away,SEA,over,9,0.5,100,0.47935779816513757,PHI,SEA,2023 REG,10,3,8,5,8,18,0,1,-2,2,1,1,1,0,0,0,0,0,0,0.47935779816513757,0.5206422018348624
90316,0.5555555555555556,0.47619047619047616,-125,110,0.5379188712522047,0.4620811287477953,home,PHI,under,9,0.5412844036697247,-118,0.5206422018348624,PHI,SEA,2023 REG,10,3,8,5,8,18,0,1,-2,2,1,1,1,0,0,0,0,0,0,0.47935779816513757,0.5206422018348624
90317,0.5983935742971888,0.4444444444444444,-149,125,0.5727595791465728,0.42724042085342717,away,MIN,over,9,0.5391705069124424,-117,0.5127649394825569,PHI,MIN,2023 REG,15,13,7,2,15,22,1,0,11,-11,1,1,0,0,0,0,0,0,0,0.5127649394825569,0.48723506051744314
90317,0.5983935742971888,0.4444444444444444,-149,125,0.5727595791465728,0.42724042085342717,home,PHI,under,9,0.5098039215686274,-104,0.48723506051744314,PHI,MIN,2023 REG,15,13,7,2,15,22,1,0,11,-11,1,1,0,0,0,0,0,0,0,0.5127649394825569,0.48723506051744314
90318,0.7382198952879581,0.30120481927710846,-282,232,0.709115786629977,0.290884213370023,away,OAK,over,8.5,0.5327102803738317,-114,0.508788710910954,SEA,OAK,2023 REG,6,5,9,4,9,15,1,0,1,-1,1,1,1,1,0,0,0,0,0,0.508788710910954,0.491211289089046
90318,0.7382198952879581,0.30120481927710846,-282,232,0.709115786629977,0.290884213370023,home,SEA,under,8.5,0.5121951219512195,-105,0.491211289089046,SEA,OAK,2023 REG,6,5,9,4,9,15,1,0,1,-1,1,1,1,1,0,0,0,0,0,0.508788710910954,0.491211289089046
90319,0.6000000000000001,0.43859649122807015,-150,128,0.5768421052631579,0.42315789473684207,away,LAA,over,8.5,0.5454545454545454,-120,0.5206611570247933,LAD,LAA,2023 REG,10,10,9,5,15,19,1,0,5,-5,1,1,1,1,1,0,0,0,0,0.5206611570247933,0.4793388429752067
90319,0.6000000000000001,0.43859649122807015,-150,128,0.5768421052631579,0.42315789473684207,home,LAD,under,8.5,0.5,100,0.4793388429752067,LAD,LAA,2023 REG,10,10,9,5,15,19,1,0,5,-5,1,1,1,1,1,0,0,0,0,0.5206611570247933,0.4793388429752067
90320,0.3508771929824561,0.6875,185,-220,0.3374115112342259,0.662588488765774,away,SF,over,11,0.5121951219512195,-105,0.48808156828023186,COL,SF,2023 REG,9,4,8,5,9,17,0,1,-1,1,1,1,1,1,0,0,0,0,0,0.48808156828023186,0.5119184317197681
90320,0.3508771929824561,0.6875,185,-220,0.3374115112342259,0.662588488765774,home,COL,under,11,0.5348837209302326,-115,0.5119184317197681,COL,SF,2023 REG,9,4,8,5,9,17,0,1,-1,1,1,1,1,1,0,0,0,0,0,0.48808156828023186,0.5119184317197681
90321,0.6363636363636364,0.4065040650406504,-175,146,0.6090841900154538,0.3909158099845462,away,LAD,over,8,0.5121951219512195,-105,0.48808156828023186,SEA,LAD,2023 REG,7,1,10,6,7,17,0,1,-5,5,1,0,0,0,0,0,0,0,0,0.48808156828023186,0.5119184317197681
90321,0.6363636363636364,0.4065040650406504,-175,146,0.6090841900154538,0.3909158099845462,home,SEA,under,8,0.5348837209302326,-115,0.5119184317197681,SEA,LAD,2023 REG,7,1,10,6,7,17,0,1,-5,5,1,0,0,0,0,0,0,0,0,0.48808156828023186,0.5119184317197681
90322,0.5073891625615764,0.5348837209302326,-103,-115,0.4859403596076043,0.5140596403923957,away,LAD,over,8.5,0.5454545454545454,-120,0.5206611570247933,STL,LAD,2023 REG,2,0,10,5,5,12,0,1,-5,5,0,0,0,0,0,0,0,0,0,0.5206611570247933,0.4793388429752067
90322,0.5073891625615764,0.5348837209302326,-103,-115,0.4859403596076043,0.5140596403923957,home,STL,under,8.5,0.5,100,0.4793388429752067,STL,LAD,2023 REG,2,0,10,5,5,12,0,1,-5,5,0,0,0,0,0,0,0,0,0,0.5206611570247933,0.4793388429752067
90323,0.4347826086956522,0.6031746031746031,130,-152,0.418279473099889,0.581720526900111,away,BAL,over,8.5,0.5121951219512195,-105,0.48808156828023186,DET,BAL,2023 REG,7,3,9,5,8,16,0,1,-2,2,1,1,1,0,0,0,0,0,0,0.48808156828023186,0.5119184317197681
90323,0.4347826086956522,0.6031746031746031,130,-152,0.418279473099889,0.581720526900111,home,DET,under,8.5,0.5348837209302326,-115,0.5119184317197681,DET,BAL,2023 REG,7,3,9,5,8,16,0,1,-2,2,1,1,1,0,0,0,0,0,0,0.48808156828023186,0.5119184317197681
90324,0.607843137254902,0.425531914893617,-155,135,0.5875563408509002,0.41244365914909975,away,PIT,over,8.5,0.5121951219512195,-105,0.48808156828023186,STL,PIT,2023 REG,12,5,8,4,9,20,1,0,1,-1,1,1,1,1,0,0,0,0,0,0.48808156828023186,0.5119184317197681
90324,0.607843137254902,0.425531914893617,-155,135,0.5875563408509002,0.41244365914909975,home,STL,under,8.5,0.5348837209302326,-115,0.5119184317197681,STL,PIT,2023 REG,12,5,8,4,9,20,1,0,1,-1,1,1,1,1,0,0,0,0,0,0.48808156828023186,0.5119184317197681
90325,0.5348837209302326,0.5098039215686274,-115,-104,0.5109810284308424,0.48901897156915763,away,TOR,over,8.5,0.5,100,0.4772727272727273,PHI,TOR,2023 REG,7,2,4,1,3,11,1,0,1,-1,1,0,0,0,0,0,0,0,0,0.4772727272727273,0.5227272727272727
90325,0.5348837209302326,0.5098039215686274,-115,-104,0.5109810284308424,0.48901897156915763,home,PHI,under,8.5,0.5454545454545454,-120,0.5227272727272727,PHI,TOR,2023 REG,7,2,4,1,3,11,1,0,1,-1,1,0,0,0,0,0,0,0,0,0.4772727272727273,0.5227272727272727
90326,0.5867768595041323,0.45454545454545453,-142,120,0.5625298818386723,0.43747011816132775,away,TEX,over,7.5,0.504950495049505,-102,0.47949844489399435,SEA,TEX,2023 REG,7,1,8,6,7,15,0,1,-5,5,1,0,0,0,0,0,0,0,0,0.47949844489399435,0.5205015551060057
90326,0.5867768595041323,0.45454545454545453,-142,120,0.5625298818386723,0.43747011816132775,home,SEA,under,7.5,0.5454545454545454,-120,0.5205015551060057,SEA,TEX,2023 REG,7,1,8,6,7,15,0,1,-5,5,1,0,0,0,0,0,0,0,0,0.47949844489399435,0.5205015551060057
90327,0.5238095238095238,0.5215311004784688,-110,-109,0.5000596729920038,0.4999403270079962,away,NYY,over,9,0.5145631067961165,-106,0.4913668392989033,LAA,NYY,2023 REG,5,5,2,1,6,7,1,0,4,-4,1,0,0,0,0,0,0,0,0,0.4913668392989033,0.5086331607010968
90327,0.5238095238095238,0.5215311004784688,-110,-109,0.5000596729920038,0.4999403270079962,home,LAA,under,9,0.5305164319248826,-113,0.5086331607010968,LAA,NYY,2023 REG,5,5,2,1,6,7,1,0,4,-4,1,0,0,0,0,0,0,0,0,0.4913668392989033,0.5086331607010968
90328,0.7014925373134329,0.3389830508474576,-235,195,0.6730992142751963,0.32690078572480374,away,COL,over,8.5,0.5,100,0.4772727272727273,MIA,COL,2023 REG,7,1,9,6,7,16,0,1,-5,5,1,0,0,0,0,0,0,0,0,0.4772727272727273,0.5227272727272727
90328,0.7014925373134329,0.3389830508474576,-235,195,0.6730992142751963,0.32690078572480374,home,MIA,under,8.5,0.5454545454545454,-120,0.5227272727272727,MIA,COL,2023 REG,7,1,9,6,7,16,0,1,-5,5,1,0,0,0,0,0,0,0,0,0.4772727272727273,0.5227272727272727
90329,0.635036496350365,0.4,-174,150,0.6127870424636368,0.3872129575363632,away,SD,over,10,0.5145631067961165,-106,0.49023796582517226,HOU,SD,2023 REG,11,12,7,2,14,18,1,0,10,-10,1,1,0,0,0,0,0,0,0,0.49023796582517226,0.5097620341748277
90329,0.635036496350365,0.4,-174,150,0.6127870424636368,0.3872129575363632,home,HOU,under,10,0.5327102803738317,-114,0.5097620341748277,HOU,SD,2023 REG,11,12,7,2,14,18,1,0,10,-10,1,1,0,0,0,0,0,0,0,0.49023796582517226,0.5097620341748277
90330,0.5867768595041323,0.4608294930875576,-142,117,0.5588425534379341,0.4411574465620659,away,LAA,over,8.5,0.5454545454545454,-120,0.5114384956282189,HOU,LAA,2023 REG,7,1,4,2,3,11,0,1,-1,1,1,0,0,0,0,0,0,0,0,0.5114384956282189,0.48856150437178114
90330,0.5867768595041323,0.4608294930875576,-142,117,0.5588425534379341,0.4411574465620659,home,HOU,under,8.5,0.5169082125603864,-107,0.48856150437178114,HOU,LAA,2023 REG,7,1,4,2,3,11,0,1,-1,1,1,0,0,0,0,0,0,0,0,0.5114384956282189,0.48856150437178114
90331,0.5238095238095238,0.5238095238095238,-110,-110,0.4988662131519274,0.5011337868480725,away,KC,over,7,0.5454545454545454,-120,0.5193043049216726,DET,KC,2023 REG,10,7,6,3,10,16,1,0,4,-4,1,1,1,0,0,0,0,0,0,0.5193043049216726,0.48069569507832743
90331,0.5238095238095238,0.5238095238095238,-110,-110,0.4988662131519274,0.5011337868480725,home,DET,under,7,0.5024875621890548,-101,0.48069569507832743,DET,KC,2023 REG,10,7,6,3,10,16,1,0,4,-4,1,1,1,0,0,0,0,0,0,0.5193043049216726,0.48069569507832743
90332,0.5815899581589958,0.4587155963302753,-139,118,0.5581486524100054,0.44185134758999456,away,STL,over,9.5,0.5370370370370371,-116,0.5118817074154765,PHI,STL,2023 REG,11,7,5,2,9,16,1,0,5,-5,1,1,0,0,0,0,0,0,0,0.5118817074154765,0.48811829258452355
90332,0.5815899581589958,0.4587155963302753,-139,118,0.5581486524100054,0.44185134758999456,home,PHI,under,9.5,0.5098039215686274,-104,0.48811829258452355,PHI,STL,2023 REG,11,7,5,2,9,16,1,0,5,-5,1,1,0,0,0,0,0,0,0,0.5118817074154765,0.48811829258452355
90333,0.7590361445783133,0.2777777777777778,-315,260,0.7310930468863406,0.2689069531136594,away,OAK,over,7.5,0.5433789954337899,-119,0.5198077604720502,TB,OAK,2023 REG,12,11,1,0,11,13,1,0,11,-11,0,0,0,0,0,0,0,0,0,0.5198077604720502,0.48019223952794976
90333,0.7590361445783133,0.2777777777777778,-315,260,0.7310930468863406,0.2689069531136594,home,TB,under,7.5,0.5,100,0.48019223952794976,TB,OAK,2023 REG,12,11,1,0,11,13,1,0,11,-11,0,0,0,0,0,0,0,0,0,0.5198077604720502,0.48019223952794976
90335,0.4,0.6376811594202898,150,-176,0.384927536231884,0.615072463768116,away,SF,over,12,0.5121951219512195,-105,0.48808156828023186,COL,SF,2023 REG,15,10,14,11,21,29,0,1,-1,1,1,1,1,1,1,1,1,1,1,0.48808156828023186,0.5119184317197681
90335,0.4,0.6376811594202898,150,-176,0.384927536231884,0.615072463768116,home,COL,under,12,0.5348837209302326,-115,0.5119184317197681,COL,SF,2023 REG,15,10,14,11,21,29,0,1,-1,1,1,1,1,1,1,1,1,1,1,0.48808156828023186,0.5119184317197681
90336,0.6491228070175439,0.3861003861003861,-185,159,0.6262586290287122,0.3737413709712878,away,MIN,over,7.5,0.5348837209302326,-115,0.5097020142727117,HOU,MIN,2023 REG,6,2,11,8,10,17,0,1,-6,6,1,1,0,0,0,0,0,0,0,0.5097020142727117,0.49029798572728833
90336,0.6491228070175439,0.3861003861003861,-185,159,0.6262586290287122,0.3737413709712878,home,HOU,under,7.5,0.5121951219512195,-105,0.49029798572728833,HOU,MIN,2023 REG,6,2,11,8,10,17,0,1,-6,6,1,1,0,0,0,0,0,0,0,0.5097020142727117,0.49029798572728833
90337,0.5918367346938775,0.4444444444444444,-145,125,0.5703642001018094,0.42963579989819056,away,MIL,over,9,0.5305164319248826,-113,0.5078572507605655,ARI,MIL,2023 REG,8,3,3,0,3,11,1,0,3,-3,0,0,0,0,0,0,0,0,0,0.5078572507605655,0.49214274923943446
90337,0.5918367346938775,0.4444444444444444,-145,125,0.5703642001018094,0.42963579989819056,home,ARI,under,9,0.5121951219512195,-105,0.49214274923943446,ARI,MIL,2023 REG,8,3,3,0,3,11,1,0,3,-3,0,0,0,0,0,0,0,0,0,0.5078572507605655,0.49214274923943446
90338,0.7058823529411764,0.3333333333333333,-240,200,0.6782006920415226,0.32179930795847744,away,DET,over,9.5,0.5145631067961165,-106,0.4913668392989033,TOR,DET,2023 REG,8,1,7,3,4,15,0,1,-2,2,1,0,0,0,0,0,0,0,0,0.4913668392989033,0.5086331607010968
90338,0.7058823529411764,0.3333333333333333,-240,200,0.6782006920415226,0.32179930795847744,home,TOR,under,9.5,0.5305164319248826,-113,0.5086331607010968,TOR,DET,2023 REG,8,1,7,3,4,15,0,1,-2,2,1,0,0,0,0,0,0,0,0,0.4913668392989033,0.5086331607010968
90339,0.5833333333333333,0.45454545454545453,-140,120,0.5612373737373737,0.4387626262626263,away,CLE,over,7.5,0.49504950495049505,102,0.47297076509898783,NYM,CLE,2023 REG,7,2,3,1,3,10,1,0,1,-1,1,0,0,0,0,0,0,0,0,0.47297076509898783,0.5270292349010122
90339,0.5833333333333333,0.45454545454545453,-140,120,0.5612373737373737,0.4387626262626263,home,NYM,under,7.5,0.5495495495495495,-122,0.5270292349010122,NYM,CLE,2023 REG,7,2,3,1,3,10,1,0,1,-1,1,0,0,0,0,0,0,0,0,0.47297076509898783,0.5270292349010122
90340,0.7590361445783133,0.2777777777777778,-315,260,0.7310930468863406,0.2689069531136594,away,COL,over,8.5,0.5412844036697247,-118,0.5149381613977361,PHI,COL,2023 REG,9,4,4,3,7,13,1,0,1,-1,1,1,1,0,0,0,0,0,0,0.5149381613977361,0.48506183860226393
90340,0.7590361445783133,0.2777777777777778,-315,260,0.7310930468863406,0.2689069531136594,home,PHI,under,8.5,0.5073891625615764,-103,0.48506183860226393,PHI,COL,2023 REG,9,4,4,3,7,13,1,0,1,-1,1,1,1,0,0,0,0,0,0,0.5149381613977361,0.48506183860226393
90341,0.5098039215686274,0.5348837209302326,-104,-115,0.4870219861770517,0.5129780138229483,away,STL,over,7.5,0.5169082125603864,-107,0.49239402434819424,CHC,STL,2023 REG,14,10,10,4,14,24,1,0,6,-6,1,1,1,1,0,0,0,0,0,0.49239402434819424,0.5076059756518058
90341,0.5098039215686274,0.5348837209302326,-104,-115,0.4870219861770517,0.5129780138229483,home,CHC,under,7.5,0.5305164319248826,-113,0.5076059756518058,CHC,STL,2023 REG,14,10,10,4,14,24,1,0,6,-6,1,1,1,1,0,0,0,0,0,0.49239402434819424,0.5076059756518058
90342,0.7118155619596541,0.3333333333333333,-247,200,0.6796778756848186,0.32032212431518137,away,DET,over,8,0.5305164319248826,-113,0.5066009958897986,NYY,DET,2023 REG,6,5,9,1,6,15,1,0,4,-4,1,0,0,0,0,0,0,0,0,0.5066009958897986,0.49339900411020143
90342,0.7118155619596541,0.3333333333333333,-247,200,0.6796778756848186,0.32032212431518137,home,NYY,under,8,0.5145631067961165,-106,0.49339900411020143,NYY,DET,2023 REG,6,5,9,1,6,15,1,0,4,-4,1,0,0,0,0,0,0,0,0,0.5066009958897986,0.49339900411020143
90343,0.5934959349593496,0.4484304932735426,-146,123,0.5686127702357632,0.4313872297642368,away,WSH,over,8.5,0.5305164319248826,-113,0.5066009958897986,NYY,WSH,2023 REG,8,9,3,1,10,11,1,0,8,-8,1,0,0,0,0,0,0,0,0,0.5066009958897986,0.49339900411020143
90343,0.5934959349593496,0.4484304932735426,-146,123,0.5686127702357632,0.4313872297642368,home,NYY,under,8.5,0.5145631067961165,-106,0.49339900411020143,NYY,WSH,2023 REG,8,9,3,1,10,11,1,0,8,-8,1,0,0,0,0,0,0,0,0,0.5066009958897986,0.49339900411020143
90344,0.5918367346938775,0.4464285714285714,-145,124,0.5691899208663057,0.4308100791336943,away,HOU,over,9,0.5454545454545454,-120,0.5206611570247933,TEX,HOU,2023 REG,12,11,13,12,23,25,0,1,-1,1,1,1,1,1,1,1,1,1,1,0.5206611570247933,0.4793388429752067
90344,0.5918367346938775,0.4464285714285714,-145,124,0.5691899208663057,0.4308100791336943,home,TEX,under,9,0.5,100,0.4793388429752067,TEX,HOU,2023 REG,12,11,13,12,23,25,0,1,-1,1,1,1,1,1,1,1,1,1,1,0.5206611570247933,0.4793388429752067
90345,0.33557046979865773,0.7101449275362319,198,-245,0.32022973243795655,0.6797702675620434,away,HOU,over,8.5,0.5169082125603864,-107,0.49353874091423283,OAK,HOU,2023 REG,7,2,5,3,5,12,0,1,-1,1,1,1,0,0,0,0,0,0,0,0.49353874091423283,0.5064612590857671
90345,0.33557046979865773,0.7101449275362319,198,-245,0.32022973243795655,0.6797702675620434,home,OAK,under,8.5,0.5283018867924528,-112,0.5064612590857671,OAK,HOU,2023 REG,7,2,5,3,5,12,0,1,-1,1,1,1,0,0,0,0,0,0,0,0.49353874091423283,0.5064612590857671
90346,0.4716981132075471,0.5652173913043479,112,-130,0.4542851393811816,0.5457148606188185,away,CLE,over,8.5,0.5238095238095238,-110,0.4988662131519274,DET,CLE,2023 REG,5,1,4,0,1,9,1,0,1,-1,0,0,0,0,0,0,0,0,0,0.4988662131519274,0.5011337868480725
90346,0.4716981132075471,0.5652173913043479,112,-130,0.4542851393811816,0.5457148606188185,home,DET,under,8.5,0.5238095238095238,-110,0.5011337868480725,DET,CLE,2023 REG,5,1,4,0,1,9,1,0,1,-1,0,0,0,0,0,0,0,0,0,0.4988662131519274,0.5011337868480725
90347,0.6428571428571428,0.3921568627450981,-180,155,0.6203481392557023,0.3796518607442977,away,CHC,over,9,0.5,100,0.4772727272727273,SD,CHC,2023 REG,4,1,4,2,3,8,0,1,-1,1,1,0,0,0,0,0,0,0,0,0.4772727272727273,0.5227272727272727
90347,0.6428571428571428,0.3921568627450981,-180,155,0.6203481392557023,0.3796518607442977,home,SD,under,9,0.5454545454545454,-120,0.5227272727272727,SD,CHC,2023 REG,4,1,4,2,3,8,0,1,-1,1,1,0,0,0,0,0,0,0,0,0.4772727272727273,0.5227272727272727
90348,0.5238095238095238,0.5215311004784688,-110,-109,0.5000596729920038,0.4999403270079962,away,SF,over,8.5,0.5215311004784688,-109,0.4978845547971712,TOR,SF,2023 REG,12,6,6,1,7,18,1,0,5,-5,1,0,0,0,0,0,0,0,0,0.4978845547971712,0.5021154452028288
90348,0.5238095238095238,0.5215311004784688,-110,-109,0.5000596729920038,0.4999403270079962,home,TOR,under,8.5,0.5238095238095238,-110,0.5021154452028288,TOR,SF,2023 REG,12,6,6,1,7,18,1,0,5,-5,1,0,0,0,0,0,0,0,0,0.4978845547971712,0.5021154452028288
90349,0.6721311475409836,0.37037037037037035,-205,170,0.6435645535349916,0.35643544646500835,away,SF,over,8.5,0.5348837209302326,-115,0.5097020142727117,HOU,SF,2023 REG,10,7,5,3,10,15,1,0,4,-4,1,1,1,0,0,0,0,0,0,0.5097020142727117,0.49029798572728833
90349,0.6721311475409836,0.37037037037037035,-205,170,0.6435645535349916,0.35643544646500835,home,HOU,under,8.5,0.5121951219512195,-105,0.49029798572728833,HOU,SF,2023 REG,10,7,5,3,10,15,1,0,4,-4,1,1,1,0,0,0,0,0,0,0.5097020142727117,0.49029798572728833
90350,0.45454545454545453,0.5918367346938775,120,-145,0.433462641254849,0.566537358745151,away,MIN,over,9,0.5215311004784688,-109,0.4978845547971712,KC,MIN,2023 REG,6,4,13,7,11,19,0,1,-3,3,1,1,1,1,0,0,0,0,0,0.4978845547971712,0.5021154452028288
90350,0.45454545454545453,0.5918367346938775,120,-145,0.433462641254849,0.566537358745151,home,KC,under,9,0.5238095238095238,-110,0.5021154452028288,KC,MIN,2023 REG,6,4,13,7,11,19,0,1,-3,3,1,1,1,1,0,0,0,0,0,0.4978845547971712,0.5021154452028288
90351,0.607843137254902,0.4329004329004329,-155,131,0.583077437748718,0.416922562251282,away,BOS,over,9,0.5475113122171946,-121,0.5228602997583487,TEX,BOS,2023 REG,7,6,5,4,10,12,1,0,2,-2,1,1,1,1,0,0,0,0,0,0.5228602997583487,0.4771397002416513
90351,0.607843137254902,0.4329004329004329,-155,131,0.583077437748718,0.416922562251282,home,TEX,under,9,0.49751243781094534,101,0.4771397002416513,TEX,BOS,2023 REG,7,6,5,4,10,12,1,0,2,-2,1,1,1,1,0,0,0,0,0,0.5228602997583487,0.4771397002416513
90352,0.47846889952153115,0.5555555555555556,109,-125,0.4621892559439777,0.5378107440560222,away,LAA,over,8,0.5433789954337899,-119,0.5198077604720502,CLE,LAA,2023 REG,12,8,10,6,14,22,1,0,2,-2,1,1,1,1,1,1,0,0,0,0.5198077604720502,0.48019223952794976
90352,0.47846889952153115,0.5555555555555556,109,-125,0.4621892559439777,0.5378107440560222,home,CLE,under,8,0.5,100,0.48019223952794976,CLE,LAA,2023 REG,12,8,10,6,14,22,1,0,2,-2,1,1,1,1,1,1,0,0,0,0.5198077604720502,0.48019223952794976
90353,0.5951417004048584,0.4444444444444444,-147,125,0.5715823348467713,0.42841766515322866,away,MIL,over,9,0.5454545454545454,-120,0.5206611570247933,NYM,MIL,2023 REG,9,7,7,2,9,16,1,0,5,-5,1,1,0,0,0,0,0,0,0,0.5206611570247933,0.4793388429752067
90353,0.5951417004048584,0.4444444444444444,-147,125,0.5715823348467713,0.42841766515322866,home,NYM,under,9,0.5,100,0.4793388429752067,NYM,MIL,2023 REG,9,7,7,2,9,16,1,0,5,-5,1,1,0,0,0,0,0,0,0,0.5206611570247933,0.4793388429752067
90354,0.3802281368821293,0.6587030716723549,163,-193,0.36542539598688817,0.6345746040131118,away,BOS,over,10,0.5348837209302326,-115,0.5097020142727117,KC,BOS,2023 REG,8,3,8,7,10,16,0,1,-4,4,1,1,1,0,0,0,0,0,0,0.5097020142727117,0.49029798572728833
90354,0.3802281368821293,0.6587030716723549,163,-193,0.36542539598688817,0.6345746040131118,home,KC,under,10,0.5121951219512195,-105,0.49029798572728833,KC,BOS,2023 REG,8,3,8,7,10,16,0,1,-4,4,1,1,1,0,0,0,0,0,0,0.5097020142727117,0.49029798572728833
90355,0.4716981132075471,0.5689655172413793,112,-132,0.45251715544861953,0.5474828445513804,away,ARI,over,12,0.5238095238095238,-110,0.4988662131519274,COL,ARI,2023 REG,13,7,12,9,16,25,0,1,-2,2,1,1,1,1,1,1,1,0,0,0.4988662131519274,0.5011337868480725
90355,0.4716981132075471,0.5689655172413793,112,-132,0.45251715544861953,0.5474828445513804,home,COL,under,12,0.5238095238095238,-110,0.5011337868480725,COL,ARI,2023 REG,13,7,12,9,16,25,0,1,-2,2,1,1,1,1,1,1,1,0,0,0.4988662131519274,0.5011337868480725
90356,0.6226415094339623,0.4166666666666667,-165,140,0.5981666073335706,0.40183339266642937,away,CWS,over,9.5,0.49504950495049505,102,0.47297076509898783,NYM,CWS,2023 REG,4,2,9,6,8,13,0,1,-4,4,1,1,0,0,0,0,0,0,0,0.47297076509898783,0.5270292349010122
90356,0.6226415094339623,0.4166666666666667,-165,140,0.5981666073335706,0.40183339266642937,home,NYM,under,9.5,0.5495495495495495,-122,0.5270292349010122,NYM,CWS,2023 REG,4,2,9,6,8,13,0,1,-4,4,1,1,0,0,0,0,0,0,0,0.47297076509898783,0.5270292349010122
90357,0.5454545454545454,0.49504950495049505,-120,102,0.5233614270517961,0.4766385729482039,away,WSH,over,11,0.5433789954337899,-119,0.5184560714286826,COL,WSH,2023 REG,10,5,18,10,15,28,0,1,-5,5,1,1,1,1,1,0,0,0,0,0.5184560714286826,0.48154392857131745
90357,0.5454545454545454,0.49504950495049505,-120,102,0.5233614270517961,0.4766385729482039,home,COL,under,11,0.5024875621890548,-101,0.48154392857131745,COL,WSH,2023 REG,10,5,18,10,15,28,0,1,-5,5,1,1,1,1,1,0,0,0,0,0.5184560714286826,0.48154392857131745
90358,0.5238095238095238,0.5121951219512195,-110,-105,0.5049499474586583,0.4950500525413417,away,TEX,over,9.5,0.5121951219512195,-105,0.48808156828023186,CWS,TEX,2023 REG,4,3,7,6,9,11,0,1,-3,3,1,1,1,0,0,0,0,0,0,0.48808156828023186,0.5119184317197681
90358,0.5238095238095238,0.5121951219512195,-110,-105,0.5049499474586583,0.4950500525413417,home,CWS,under,9.5,0.5348837209302326,-115,0.5119184317197681,CWS,TEX,2023 REG,4,3,7,6,9,11,0,1,-3,3,1,1,1,0,0,0,0,0,0,0.48808156828023186,0.5119184317197681
90359,0.4629629629629629,0.5833333333333333,116,-140,0.44152949245541834,0.5584705075445817,away,PHI,over,9.5,0.5121951219512195,-105,0.48808156828023186,STL,PHI,2023 REG,9,6,11,5,11,20,1,0,1,-1,1,1,1,1,1,0,0,0,0,0.48808156828023186,0.5119184317197681
90359,0.4629629629629629,0.5833333333333333,116,-140,0.44152949245541834,0.5584705075445817,home,STL,under,9.5,0.5348837209302326,-115,0.5119184317197681,STL,PHI,2023 REG,9,6,11,5,11,20,1,0,1,-1,1,1,1,1,1,0,0,0,0,0.48808156828023186,0.5119184317197681
90360,0.5918367346938775,0.4484304932735426,-145,123,0.5680051099784656,0.43199489002153435,away,NYM,over,9,0.5412844036697247,-118,0.5149381613977361,MIN,NYM,2023 REG,13,8,7,4,12,20,1,0,4,-4,1,1,1,1,0,0,0,0,0,0.5149381613977361,0.48506183860226393
90360,0.5918367346938775,0.4484304932735426,-145,123,0.5680051099784656,0.43199489002153435,home,MIN,under,9,0.5073891625615764,-103,0.48506183860226393,MIN,NYM,2023 REG,13,8,7,4,12,20,1,0,4,-4,1,1,1,1,0,0,0,0,0,0.5149381613977361,0.48506183860226393
90361,0.6226415094339623,0.4166666666666667,-165,140,0.5981666073335706,0.40183339266642937,away,MIA,over,7.5,0.5283018867924528,-112,0.5031902949311281,SF,MIA,2023 REG,3,0,5,1,1,8,0,1,-1,1,0,0,0,0,0,0,0,0,0,0.5031902949311281,0.4968097050688719
90361,0.6226415094339623,0.4166666666666667,-165,140,0.5981666073335706,0.40183339266642937,home,SF,under,7.5,0.5192307692307692,-108,0.4968097050688719,SF,MIA,2023 REG,3,0,5,1,1,8,0,1,-1,1,0,0,0,0,0,0,0,0,0,0.5031902949311281,0.4968097050688719
90362,0.5073891625615764,0.5348837209302326,-103,-115,0.4859403596076043,0.5140596403923957,away,NYM,over,8.5,0.5169082125603864,-107,0.49239402434819424,MIN,NYM,2023 REG,8,5,4,2,7,12,1,0,3,-3,1,1,0,0,0,0,0,0,0,0.49239402434819424,0.5076059756518058
90362,0.5073891625615764,0.5348837209302326,-103,-115,0.4859403596076043,0.5140596403923957,home,MIN,under,8.5,0.5305164319248826,-113,0.5076059756518058,MIN,NYM,2023 REG,8,5,4,2,7,12,1,0,3,-3,1,1,0,0,0,0,0,0,0,0.49239402434819424,0.5076059756518058
90363,0.3125,0.7297297297297298,220,-270,0.29930320945945943,0.7006967905405406,away,TEX,over,8.5,0.5454545454545454,-120,0.5206611570247933,OAK,TEX,2023 REG,3,0,7,4,4,10,0,1,-4,4,0,0,0,0,0,0,0,0,0,0.5206611570247933,0.4793388429752067
90363,0.3125,0.7297297297297298,220,-270,0.29930320945945943,0.7006967905405406,home,OAK,under,8.5,0.5,100,0.4793388429752067,OAK,TEX,2023 REG,3,0,7,4,4,10,0,1,-4,4,0,0,0,0,0,0,0,0,0,0.5206611570247933,0.4793388429752067
90364,0.5594713656387665,0.47619047619047616,-127,110,0.5395195862893665,0.46048041371063353,away,TB,over,8.5,0.5305164319248826,-113,0.5066009958897986,NYM,TB,2023 REG,8,8,10,7,15,18,1,0,1,-1,1,1,1,1,1,1,1,0,0,0.5066009958897986,0.49339900411020143
90364,0.5594713656387665,0.47619047619047616,-127,110,0.5395195862893665,0.46048041371063353,home,NYM,under,8.5,0.5145631067961165,-106,0.49339900411020143,NYM,TB,2023 REG,8,8,10,7,15,18,1,0,1,-1,1,1,1,1,1,1,1,0,0,0.5066009958897986,0.49339900411020143
90365,0.6124031007751938,0.425531914893617,-158,135,0.5891715795516586,0.41082842044834145,away,WSH,over,8,0.5073891625615764,-103,0.4837652908580103,MIA,WSH,2023 REG,9,5,8,3,8,17,1,0,2,-2,1,1,1,0,0,0,0,0,0,0.4837652908580103,0.5162347091419897
90365,0.6124031007751938,0.425531914893617,-158,135,0.5891715795516586,0.41082842044834145,home,MIA,under,8,0.5391705069124424,-117,0.5162347091419897,MIA,WSH,2023 REG,9,5,8,3,8,17,1,0,2,-2,1,1,1,0,0,0,0,0,0,0.4837652908580103,0.5162347091419897
90366,0.6610169491525424,0.37878787878787884,-195,164,0.6347052832258232,0.3652947167741768,away,WSH,over,9,0.5098039215686274,-104,0.48483656587239576,STL,WSH,2023 REG,17,9,11,6,15,28,1,0,3,-3,1,1,1,1,1,1,0,0,0,0.48483656587239576,0.5151634341276042
90366,0.6610169491525424,0.37878787878787884,-195,164,0.6347052832258232,0.3652947167741768,home,STL,under,9,0.5391705069124424,-117,0.5151634341276042,STL,WSH,2023 REG,17,9,11,6,15,28,1,0,3,-3,1,1,1,1,1,1,0,0,0,0.48483656587239576,0.5151634341276042
90367,0.34965034965034963,0.6923076923076923,186,-225,0.33497970560907625,0.6650202943909238,away,ARI,over,11.5,0.5121951219512195,-105,0.48919479393107135,COL,ARI,2023 REG,11,6,5,4,10,16,1,0,2,-2,1,1,1,1,0,0,0,0,0,0.48919479393107135,0.5108052060689287
90367,0.34965034965034963,0.6923076923076923,186,-225,0.33497970560907625,0.6650202943909238,home,COL,under,11.5,0.5327102803738317,-114,0.5108052060689287,COL,ARI,2023 REG,11,6,5,4,10,16,1,0,2,-2,1,1,1,1,0,0,0,0,0,0.48919479393107135,0.5108052060689287
90368,0.7237569060773481,0.31545741324921134,-262,217,0.6953752716476282,0.30462472835237175,away,CWS,over,9,0.5121951219512195,-105,0.48808156828023186,BAL,CWS,2023 REG,11,9,2,0,9,13,1,0,9,-9,0,0,0,0,0,0,0,0,0,0.48808156828023186,0.5119184317197681
90368,0.7237569060773481,0.31545741324921134,-262,217,0.6953752716476282,0.30462472835237175,home,BAL,under,9,0.5348837209302326,-115,0.5119184317197681,BAL,CWS,2023 REG,11,9,2,0,9,13,1,0,9,-9,0,0,0,0,0,0,0,0,0,0.48808156828023186,0.5119184317197681
90369,0.5815899581589958,0.45454545454545453,-139,120,0.5605739649961564,0.4394260350038436,away,NYM,over,7.5,0.5169082125603864,-107,0.49353874091423283,HOU,NYM,2023 REG,9,4,4,2,6,13,1,0,2,-2,1,1,0,0,0,0,0,0,0,0.49353874091423283,0.5064612590857671
90369,0.5815899581589958,0.45454545454545453,-139,120,0.5605739649961564,0.4394260350038436,home,HOU,under,7.5,0.5283018867924528,-112,0.5064612590857671,HOU,NYM,2023 REG,9,4,4,2,6,13,1,0,2,-2,1,1,0,0,0,0,0,0,0,0.49353874091423283,0.5064612590857671
90370,0.504950495049505,0.5391705069124424,-102,-117,0.4826715732667395,0.5173284267332605,away,DET,over,11,0.5238095238095238,-110,0.4988662131519274,COL,DET,2023 REG,11,8,9,5,13,20,1,0,3,-3,1,1,1,1,1,0,0,0,0,0.4988662131519274,0.5011337868480725
90370,0.504950495049505,0.5391705069124424,-102,-117,0.4826715732667395,0.5173284267332605,home,COL,under,11,0.5238095238095238,-110,0.5011337868480725,COL,DET,2023 REG,11,8,9,5,13,20,1,0,3,-3,1,1,1,1,1,0,0,0,0,0.4988662131519274,0.5011337868480725
90371,0.5215311004784688,0.5145631067961165,-109,-106,0.5027068488376564,0.4972931511623436,away,MIN,over,8.5,0.5121951219512195,-105,0.48808156828023186,HOU,MIN,2023 REG,5,5,7,1,6,12,1,0,4,-4,1,0,0,0,0,0,0,0,0,0.48808156828023186,0.5119184317197681
90371,0.5215311004784688,0.5145631067961165,-109,-106,0.5027068488376564,0.4972931511623436,home,HOU,under,8.5,0.5348837209302326,-115,0.5119184317197681,HOU,MIN,2023 REG,5,5,7,1,6,12,1,0,4,-4,1,0,0,0,0,0,0,0,0,0.48808156828023186,0.5119184317197681
90372,0.6000000000000001,0.4366812227074236,-150,129,0.5779912663755458,0.42200873362445424,away,BOS,over,8,0.5121951219512195,-105,0.48808156828023186,NYY,BOS,2023 REG,9,2,10,3,5,19,0,1,-1,1,1,1,0,0,0,0,0,0,0,0.48808156828023186,0.5119184317197681
90372,0.6000000000000001,0.4366812227074236,-150,129,0.5779912663755458,0.42200873362445424,home,NYY,under,8,0.5348837209302326,-115,0.5119184317197681,NYY,BOS,2023 REG,9,2,10,3,5,19,0,1,-1,1,1,1,0,0,0,0,0,0,0,0.48808156828023186,0.5119184317197681
90373,0.576271186440678,0.4587155963302753,-136,118,0.5561093116235184,0.4438906883764816,away,TEX,over,9.5,0.504950495049505,-102,0.47949844489399435,LAA,TEX,2023 REG,9,5,8,4,9,17,1,0,1,-1,1,1,1,1,0,0,0,0,0,0.47949844489399435,0.5205015551060057
90373,0.576271186440678,0.4587155963302753,-136,118,0.5561093116235184,0.4438906883764816,home,LAA,under,9.5,0.5454545454545454,-120,0.5205015551060057,LAA,TEX,2023 REG,9,5,8,4,9,17,1,0,1,-1,1,1,1,1,0,0,0,0,0,0.47949844489399435,0.5205015551060057
90374,0.4672897196261683,0.5689655172413793,114,-132,0.4503480201553517,0.5496519798446483,away,LAA,over,9,0.5495495495495495,-122,0.5223196169142115,DET,LAA,2023 REG,7,4,13,11,15,20,0,1,-7,7,1,1,1,1,0,0,0,0,0,0.5223196169142115,0.47768038308578853
90374,0.4672897196261683,0.5689655172413793,114,-132,0.4503480201553517,0.5496519798446483,home,DET,under,9,0.5,100,0.47768038308578853,DET,LAA,2023 REG,7,4,13,11,15,20,0,1,-7,7,1,1,1,1,0,0,0,0,0,0.5223196169142115,0.47768038308578853
90375,0.5169082125603864,0.5260663507109005,-107,-111,0.4946943078742622,0.5053056921257377,away,MIA,over,8,0.5,100,0.47935779816513757,MIL,MIA,2023 REG,7,4,6,2,6,13,1,0,2,-2,1,1,0,0,0,0,0,0,0,0.47935779816513757,0.5206422018348624
90375,0.5169082125603864,0.5260663507109005,-107,-111,0.4946943078742622,0.5053056921257377,home,MIL,under,8,0.5412844036697247,-118,0.5206422018348624,MIL,MIA,2023 REG,7,4,6,2,6,13,1,0,2,-2,1,1,0,0,0,0,0,0,0,0.47935779816513757,0.5206422018348624
90376,0.47619047619047616,0.5633187772925764,110,-129,0.45737654596045113,0.5426234540395489,away,NYY,over,9,0.5454545454545454,-120,0.5206611570247933,CWS,NYY,2023 REG,11,9,6,2,11,17,1,0,7,-7,1,1,0,0,0,0,0,0,0,0.5206611570247933,0.4793388429752067
90376,0.47619047619047616,0.5633187772925764,110,-129,0.45737654596045113,0.5426234540395489,home,CWS,under,9,0.5,100,0.4793388429752067,CWS,NYY,2023 REG,11,9,6,2,11,17,1,0,7,-7,1,1,0,0,0,0,0,0,0,0.5206611570247933,0.4793388429752067
90377,0.6575342465753424,0.3846153846153846,-192,160,0.6298194205869192,0.3701805794130808,away,CWS,over,9.5,0.5215311004784688,-109,0.4978845547971712,TEX,CWS,2023 REG,4,2,3,0,2,7,1,0,2,-2,0,0,0,0,0,0,0,0,0,0.4978845547971712,0.5021154452028288
90377,0.6575342465753424,0.3846153846153846,-192,160,0.6298194205869192,0.3701805794130808,home,TEX,under,9.5,0.5238095238095238,-110,0.5021154452028288,TEX,CWS,2023 REG,4,2,3,0,2,7,1,0,2,-2,0,0,0,0,0,0,0,0,0,0.4978845547971712,0.5021154452028288
90378,0.5833333333333333,0.4566210045662101,-140,119,0.5600266362252664,0.4399733637747336,away,SD,over,8,0.5454545454545454,-120,0.5179608869977906,MIA,SD,2023 REG,10,4,11,9,13,21,0,1,-5,5,1,1,1,1,0,0,0,0,0,0.5179608869977906,0.48203911300220936
90378,0.5833333333333333,0.4566210045662101,-140,119,0.5600266362252664,0.4399733637747336,home,MIA,under,8,0.504950495049505,-102,0.48203911300220936,MIA,SD,2023 REG,10,4,11,9,13,21,0,1,-5,5,1,1,1,1,0,0,0,0,0,0.5179608869977906,0.48203911300220936
90379,0.5192307692307692,0.5215311004784688,-108,-109,0.49806595226635714,0.5019340477336429,away,SEA,over,8.5,0.5098039215686274,-104,0.4881300146960012,PHI,SEA,2023 REG,4,1,3,0,1,7,1,0,1,-1,0,0,0,0,0,0,0,0,0,0.4881300146960012,0.5118699853039987
90379,0.5192307692307692,0.5215311004784688,-108,-109,0.49806595226635714,0.5019340477336429,home,PHI,under,8.5,0.5327102803738317,-114,0.5118699853039987,PHI,SEA,2023 REG,4,1,3,0,1,7,1,0,1,-1,0,0,0,0,0,0,0,0,0,0.4881300146960012,0.5118699853039987
90380,0.5391705069124424,0.49751243781094534,-117,101,0.5193921450108923,0.48060785498910774,away,MIN,over,8,0.5238095238095238,-110,0.4988662131519274,TB,MIN,2023 REG,4,4,6,2,6,10,1,0,2,-2,1,1,0,0,0,0,0,0,0,0.4988662131519274,0.5011337868480725
90380,0.5391705069124424,0.49751243781094534,-117,101,0.5193921450108923,0.48060785498910774,home,TB,under,8,0.5238095238095238,-110,0.5011337868480725,TB,MIN,2023 REG,4,4,6,2,6,10,1,0,2,-2,1,1,0,0,0,0,0,0,0,0.4988662131519274,0.5011337868480725
90381,0.7058823529411764,0.33112582781456956,-240,202,0.679758931231238,0.320241068768762,away,WSH,over,9.5,0.504950495049505,-102,0.47949844489399435,LAD,WSH,2023 REG,11,6,12,10,16,23,0,1,-4,4,1,1,1,1,1,1,0,0,0,0.47949844489399435,0.5205015551060057
90381,0.7058823529411764,0.33112582781456956,-240,202,0.679758931231238,0.320241068768762,home,LAD,under,9.5,0.5454545454545454,-120,0.5205015551060057,LAD,WSH,2023 REG,11,6,12,10,16,23,0,1,-4,4,1,1,1,1,1,1,0,0,0,0.47949844489399435,0.5205015551060057
90382,0.49019607843137253,0.5495495495495495,104,-122,0.4707129274603323,0.5292870725396677,away,PHI,over,8.5,0.5348837209302326,-115,0.5097020142727117,MIA,PHI,2023 REG,7,2,6,4,6,13,0,1,-2,2,1,1,0,0,0,0,0,0,0,0.5097020142727117,0.49029798572728833
90382,0.49019607843137253,0.5495495495495495,104,-122,0.4707129274603323,0.5292870725396677,home,MIA,under,8.5,0.5121951219512195,-105,0.49029798572728833,MIA,PHI,2023 REG,7,2,6,4,6,13,0,1,-2,2,1,1,0,0,0,0,0,0,0,0.5097020142727117,0.49029798572728833
90383,0.4291845493562232,0.607843137254902,133,-155,0.41329283836432396,0.586707161635676,away,TB,over,9.5,0.5145631067961165,-106,0.4913668392989033,CIN,TB,2023 REG,7,8,8,1,9,15,1,0,7,-7,1,0,0,0,0,0,0,0,0,0.4913668392989033,0.5086331607010968
90383,0.4291845493562232,0.607843137254902,133,-155,0.41329283836432396,0.586707161635676,home,CIN,under,9.5,0.5305164319248826,-113,0.5086331607010968,CIN,TB,2023 REG,7,8,8,1,9,15,1,0,7,-7,1,0,0,0,0,0,0,0,0,0.4913668392989033,0.5086331607010968
90384,0.6551724137931035,0.3921568627450981,-190,155,0.6241635774404887,0.37583642255951133,away,COL,over,7.5,0.5433789954337899,-119,0.5198077604720502,SD,COL,2023 REG,5,1,9,4,5,14,0,1,-3,3,1,0,0,0,0,0,0,0,0,0.5198077604720502,0.48019223952794976
90384,0.6551724137931035,0.3921568627450981,-190,155,0.6241635774404887,0.37583642255951133,home,SD,under,7.5,0.5,100,0.48019223952794976,SD,COL,2023 REG,5,1,9,4,5,14,0,1,-3,3,1,0,0,0,0,0,0,0,0,0.5198077604720502,0.48019223952794976
90385,0.5238095238095238,0.5192307692307692,-110,-108,0.5012646084074657,0.4987353915925343,away,NYY,over,7.5,0.5192307692307692,-108,0.49455035168025013,STL,NYY,2023 REG,11,5,3,1,6,14,1,0,4,-4,1,0,0,0,0,0,0,0,0,0.49455035168025013,0.5054496483197499
90385,0.5238095238095238,0.5192307692307692,-110,-108,0.5012646084074657,0.4987353915925343,home,STL,under,7.5,0.5283018867924528,-112,0.5054496483197499,STL,NYY,2023 REG,11,5,3,1,6,14,1,0,4,-4,1,0,0,0,0,0,0,0,0,0.49455035168025013,0.5054496483197499
90386,0.6296296296296295,0.4081632653061224,-170,145,0.6058341031886005,0.39416589681139946,away,CHC,over,9,0.5215311004784688,-109,0.4978845547971712,SD,CHC,2023 REG,8,5,4,0,5,12,1,0,5,-5,0,0,0,0,0,0,0,0,0,0.4978845547971712,0.5021154452028288
90386,0.6296296296296295,0.4081632653061224,-170,145,0.6058341031886005,0.39416589681139946,home,SD,under,9,0.5238095238095238,-110,0.5021154452028288,SD,CHC,2023 REG,8,5,4,0,5,12,1,0,5,-5,0,0,0,0,0,0,0,0,0,0.4978845547971712,0.5021154452028288
90387,0.4166666666666667,0.6183206106870228,140,-162,0.40208863443596277,0.5979113655640372,away,MIN,over,8,0.5283018867924528,-112,0.5031902949311281,KC,MIN,2023 REG,4,0,5,2,2,9,0,1,-2,2,0,0,0,0,0,0,0,0,0,0.5031902949311281,0.4968097050688719
90387,0.4166666666666667,0.6183206106870228,140,-162,0.40208863443596277,0.5979113655640372,home,KC,under,8,0.5192307692307692,-108,0.4968097050688719,KC,MIN,2023 REG,4,0,5,2,2,9,0,1,-2,2,0,0,0,0,0,0,0,0,0,0.5031902949311281,0.4968097050688719
90388,0.6825396825396826,0.35714285714285715,-215,180,0.6554547745023935,0.34454522549760647,away,KC,over,9,0.5454545454545454,-120,0.5206611570247933,CHC,KC,2023 REG,5,4,7,3,7,12,1,0,1,-1,1,1,1,0,0,0,0,0,0,0.5206611570247933,0.4793388429752067
90388,0.6825396825396826,0.35714285714285715,-215,180,0.6554547745023935,0.34454522549760647,home,CHC,under,9,0.5,100,0.4793388429752067,CHC,KC,2023 REG,5,4,7,3,7,12,1,0,1,-1,1,1,1,0,0,0,0,0,0,0.5206611570247933,0.4793388429752067
90389,0.7530864197530864,0.2857142857142857,-305,250,0.7238661353887691,0.2761338646112309,away,OAK,over,7.5,0.5348837209302326,-115,0.5109810284308424,TB,OAK,2023 REG,8,11,3,0,11,11,1,0,11,-11,0,0,0,0,0,0,0,0,0,0.5109810284308424,0.48901897156915763
90389,0.7530864197530864,0.2857142857142857,-305,250,0.7238661353887691,0.2761338646112309,home,TB,under,7.5,0.5098039215686274,-104,0.48901897156915763,TB,OAK,2023 REG,8,11,3,0,11,11,1,0,11,-11,0,0,0,0,0,0,0,0,0,0.5109810284308424,0.48901897156915763
90390,0.45454545454545453,0.5815899581589958,120,-139,0.43812026695252254,0.5618797330474774,away,CLE,over,8,0.5412844036697247,-118,0.5189377998484975,DET,CLE,2023 REG,8,2,5,3,5,13,0,1,-1,1,1,1,0,0,0,0,0,0,0,0.5189377998484975,0.4810622001515025
90390,0.45454545454545453,0.5815899581589958,120,-139,0.43812026695252254,0.5618797330474774,home,DET,under,8,0.5,100,0.4810622001515025,DET,CLE,2023 REG,8,2,5,3,5,13,0,1,-1,1,1,1,0,0,0,0,0,0,0,0.5189377998484975,0.4810622001515025
90391,0.5098039215686274,0.5348837209302326,-104,-115,0.4870219861770517,0.5129780138229483,away,SD,over,9,0.5098039215686274,-104,0.48483656587239576,MIL,SD,2023 REG,10,10,9,6,16,19,1,0,4,-4,1,1,1,1,1,1,0,0,0,0.48483656587239576,0.5151634341276042
90391,0.5098039215686274,0.5348837209302326,-104,-115,0.4870219861770517,0.5129780138229483,home,MIL,under,9,0.5391705069124424,-117,0.5151634341276042,MIL,SD,2023 REG,10,10,9,6,16,19,1,0,4,-4,1,1,1,1,1,1,0,0,0,0.48483656587239576,0.5151634341276042
90392,0.5454545454545454,0.4926108374384236,-120,103,0.5246916093311078,0.4753083906688922,away,CHC,over,8.5,0.5238095238095238,-110,0.4988662131519274,PHI,CHC,2023 REG,7,2,3,1,3,10,1,0,1,-1,1,0,0,0,0,0,0,0,0,0.4988662131519274,0.5011337868480725
90392,0.5454545454545454,0.4926108374384236,-120,103,0.5246916093311078,0.4753083906688922,home,PHI,under,8.5,0.5238095238095238,-110,0.5011337868480725,PHI,CHC,2023 REG,7,2,3,1,3,10,1,0,1,-1,1,0,0,0,0,0,0,0,0,0.4988662131519274,0.5011337868480725
90393,0.5670995670995671,0.4716981132075471,-131,112,0.5450974193929352,0.4549025806070648,away,ATL,over,8.5,0.5370370370370371,-116,0.5118817074154765,ARI,ATL,2023 REG,8,5,14,8,13,22,0,1,-3,3,1,1,1,1,1,0,0,0,0,0.5118817074154765,0.48811829258452355
90393,0.5670995670995671,0.4716981132075471,-131,112,0.5450974193929352,0.4549025806070648,home,ARI,under,8.5,0.5098039215686274,-104,0.48811829258452355,ARI,ATL,2023 REG,8,5,14,8,13,22,0,1,-3,3,1,1,1,1,1,0,0,0,0,0.5118817074154765,0.48811829258452355
90394,0.5708154506437768,0.4694835680751174,-133,113,0.5478121481132493,0.4521878518867507,away,SEA,over,9.5,0.5,100,0.4772727272727273,ATL,SEA,2023 REG,8,3,9,7,10,17,0,1,-4,4,1,1,1,0,0,0,0,0,0,0.4772727272727273,0.5227272727272727
90394,0.5708154506437768,0.4694835680751174,-133,113,0.5478121481132493,0.4521878518867507,home,ATL,under,9.5,0.5454545454545454,-120,0.5227272727272727,ATL,SEA,2023 REG,8,3,9,7,10,17,0,1,-4,4,1,1,1,0,0,0,0,0,0,0.4772727272727273,0.5227272727272727
90395,0.726027397260274,0.31746031746031744,-265,215,0.6944541249288857,0.3055458750711143,away,KC,over,8,0.5327102803738317,-114,0.508788710910954,NYY,KC,2023 REG,8,5,7,2,7,15,1,0,3,-3,1,1,0,0,0,0,0,0,0,0.508788710910954,0.491211289089046
90395,0.726027397260274,0.31746031746031744,-265,215,0.6944541249288857,0.3055458750711143,home,NYY,under,8,0.5121951219512195,-105,0.491211289089046,NYY,KC,2023 REG,8,5,7,2,7,15,1,0,3,-3,1,1,0,0,0,0,0,0,0,0.508788710910954,0.491211289089046
90396,0.6415770609318996,0.3921568627450981,-179,155,0.6199341493255103,0.3800658506744897,away,LAA,over,9,0.5121951219512195,-105,0.48808156828023186,PHI,LAA,2023 REG,11,8,12,10,18,23,0,1,-2,2,1,1,1,1,1,1,1,1,0,0.48808156828023186,0.5119184317197681
90396,0.6415770609318996,0.3921568627450981,-179,155,0.6199341493255103,0.3800658506744897,home,PHI,under,9,0.5348837209302326,-115,0.5119184317197681,PHI,LAA,2023 REG,11,8,12,10,18,23,0,1,-2,2,1,1,1,1,1,1,1,1,0,0.48808156828023186,0.5119184317197681
90397,0.5555555555555556,0.48309178743961345,-125,107,0.5340848094471283,0.46591519055287167,away,HOU,over,9.5,0.5073891625615764,-103,0.4826927225525911,NYY,HOU,2023 REG,8,7,6,9,16,14,0,1,-2,2,1,1,1,1,1,1,1,0,0,0.4826927225525911,0.5173072774474089
90397,0.5555555555555556,0.48309178743961345,-125,107,0.5340848094471283,0.46591519055287167,home,NYY,under,9.5,0.5412844036697247,-118,0.5173072774474089,NYY,HOU,2023 REG,8,7,6,9,16,14,0,1,-2,2,1,1,1,1,1,1,1,0,0,0.4826927225525911,0.5173072774474089
90398,0.4629629629629629,0.574468085106383,116,-135,0.44563377404196935,0.5543662259580306,away,ARI,over,10,0.5348837209302326,-115,0.5097020142727117,WSH,ARI,2023 REG,7,5,12,10,15,19,0,1,-5,5,1,1,1,1,1,0,0,0,0,0.5097020142727117,0.49029798572728833
90398,0.4629629629629629,0.574468085106383,116,-135,0.44563377404196935,0.5543662259580306,home,WSH,under,10,0.5121951219512195,-105,0.49029798572728833,WSH,ARI,2023 REG,7,5,12,10,15,19,0,1,-5,5,1,1,1,1,1,0,0,0,0,0.5097020142727117,0.49029798572728833
90399,0.4484304932735426,0.5934959349593496,123,-146,0.429629404379869,0.570370595620131,away,PHI,over,8.5,0.5024875621890548,-101,0.4794401874631478,STL,PHI,2023 REG,9,4,8,5,9,17,0,1,-1,1,1,1,1,1,0,0,0,0,0,0.4794401874631478,0.5205598125368522
90399,0.4484304932735426,0.5934959349593496,123,-146,0.429629404379869,0.570370595620131,home,STL,under,8.5,0.5433789954337899,-119,0.5205598125368522,STL,PHI,2023 REG,9,4,8,5,9,17,0,1,-1,1,1,1,1,1,0,0,0,0,0,0.4794401874631478,0.5205598125368522
90400,0.6721311475409836,0.37037037037037035,-205,170,0.6435645535349916,0.35643544646500835,away,CWS,over,9,0.5348837209302326,-115,0.5109810284308424,TOR,CWS,2023 REG,10,7,4,0,7,14,1,0,7,-7,0,0,0,0,0,0,0,0,0,0.5109810284308424,0.48901897156915763
90400,0.6721311475409836,0.37037037037037035,-205,170,0.6435645535349916,0.35643544646500835,home,TOR,under,9,0.5098039215686274,-104,0.48901897156915763,TOR,CWS,2023 REG,10,7,4,0,7,14,1,0,7,-7,0,0,0,0,0,0,0,0,0,0.5109810284308424,0.48901897156915763
90401,0.5,0.5348837209302326,100,-115,0.4825581395348837,0.5174418604651163,away,SEA,over,8.5,0.5283018867924528,-112,0.5044173060022736,LAA,SEA,2023 REG,13,9,9,4,13,22,1,0,5,-5,1,1,1,1,0,0,0,0,0,0.5044173060022736,0.49558269399772636
90401,0.5,0.5348837209302326,100,-115,0.4825581395348837,0.5174418604651163,home,LAA,under,8.5,0.5169082125603864,-107,0.49558269399772636,LAA,SEA,2023 REG,13,9,9,4,13,22,1,0,5,-5,1,1,1,1,0,0,0,0,0,0.5044173060022736,0.49558269399772636
90402,0.6363636363636364,0.40322580645161293,-175,148,0.6111703545721141,0.3888296454278859,away,CIN,over,9.5,0.5,100,0.4762443438914027,PIT,CIN,2023 REG,4,4,8,3,7,12,1,0,1,-1,1,1,1,0,0,0,0,0,0,0.4762443438914027,0.5237556561085973
90402,0.6363636363636364,0.40322580645161293,-175,148,0.6111703545721141,0.3888296454278859,home,PIT,under,9.5,0.5475113122171946,-121,0.5237556561085973,PIT,CIN,2023 REG,4,4,8,3,7,12,1,0,1,-1,1,1,1,0,0,0,0,0,0,0.4762443438914027,0.5237556561085973
90403,0.7938144329896907,0.25,-385,300,0.7590339037092146,0.24096609629078536,away,OAK,over,7,0.5555555555555556,-125,0.5301379811183733,TEX,OAK,2023 REG,9,5,5,2,7,14,1,0,3,-3,1,1,0,0,0,0,0,0,0,0.5301379811183733,0.4698620188816267
90403,0.7938144329896907,0.25,-385,300,0.7590339037092146,0.24096609629078536,home,TEX,under,7,0.49019607843137253,104,0.4698620188816267,TEX,OAK,2023 REG,9,5,5,2,7,14,1,0,3,-3,1,1,0,0,0,0,0,0,0,0.5301379811183733,0.4698620188816267
90404,0.5555555555555556,0.4854368932038835,-125,106,0.5327819729114227,0.4672180270885773,away,CWS,over,9.5,0.5098039215686274,-104,0.48483656587239576,KC,CWS,2023 REG,10,7,13,6,13,23,1,0,1,-1,1,1,1,1,1,1,0,0,0,0.48483656587239576,0.5151634341276042
90404,0.5555555555555556,0.4854368932038835,-125,106,0.5327819729114227,0.4672180270885773,home,KC,under,9.5,0.5391705069124424,-117,0.5151634341276042,KC,CWS,2023 REG,10,7,13,6,13,23,1,0,1,-1,1,1,1,1,1,1,0,0,0,0.48483656587239576,0.5151634341276042
90405,0.5073891625615764,0.5348837209302326,-103,-115,0.4859403596076043,0.5140596403923957,away,MIL,over,7,0.504950495049505,-102,0.4826715732667395,MIA,MIL,2023 REG,8,5,6,4,9,14,1,0,1,-1,1,1,1,1,0,0,0,0,0,0.4826715732667395,0.5173284267332605
90405,0.5073891625615764,0.5348837209302326,-103,-115,0.4859403596076043,0.5140596403923957,home,MIA,under,7,0.5391705069124424,-117,0.5173284267332605,MIA,MIL,2023 REG,8,5,6,4,9,14,1,0,1,-1,1,1,1,1,0,0,0,0,0,0.4826715732667395,0.5173284267332605
90406,0.5260663507109005,0.5169082125603864,-111,-107,0.5034588790373798,0.49654112096262015,away,OAK,over,8.5,0.5454545454545454,-120,0.5206611570247933,CWS,OAK,2023 REG,13,6,2,1,7,15,1,0,5,-5,1,0,0,0,0,0,0,0,0,0.5206611570247933,0.4793388429752067
90406,0.5260663507109005,0.5169082125603864,-111,-107,0.5034588790373798,0.49654112096262015,home,CWS,under,8.5,0.5,100,0.4793388429752067,CWS,OAK,2023 REG,13,6,2,1,7,15,1,0,5,-5,1,0,0,0,0,0,0,0,0,0.5206611570247933,0.4793388429752067
90407,0.36764705882352944,0.6721311475409836,172,-205,0.3530227182483408,0.64697728175165925,away,SD,over,9.5,0.5073891625615764,-103,0.4826927225525911,STL,SD,2023 REG,4,1,12,4,5,16,0,1,-3,3,1,0,0,0,0,0,0,0,0,0.4826927225525911,0.5173072774474089
90407,0.36764705882352944,0.6721311475409836,172,-205,0.3530227182483408,0.64697728175165925,home,STL,under,9.5,0.5412844036697247,-118,0.5173072774474089,STL,SD,2023 REG,4,1,12,4,5,16,0,1,-3,3,1,0,0,0,0,0,0,0,0,0.4826927225525911,0.5173072774474089
90408,0.5594713656387665,0.48309178743961345,-127,107,0.5356585002601133,0.4643414997398867,away,MIL,over,8,0.5327102803738317,-114,0.5075272610403079,TEX,MIL,2023 REG,5,1,15,6,7,20,0,1,-5,5,1,0,0,0,0,0,0,0,0,0.5075272610403079,0.4924727389596921
90408,0.5594713656387665,0.48309178743961345,-127,107,0.5356585002601133,0.4643414997398867,home,TEX,under,8,0.5145631067961165,-106,0.4924727389596921,TEX,MIL,2023 REG,5,1,15,6,7,20,0,1,-5,5,1,0,0,0,0,0,0,0,0,0.5075272610403079,0.4924727389596921
90409,0.5918367346938775,0.4444444444444444,-145,125,0.5703642001018094,0.42963579989819056,away,PHI,over,7.5,0.5,100,0.4772727272727273,HOU,PHI,2023 REG,3,1,8,3,4,11,0,1,-2,2,1,0,0,0,0,0,0,0,0,0.4772727272727273,0.5227272727272727
90409,0.5918367346938775,0.4444444444444444,-145,125,0.5703642001018094,0.42963579989819056,home,HOU,under,7.5,0.5454545454545454,-120,0.5227272727272727,HOU,PHI,2023 REG,3,1,8,3,4,11,0,1,-2,2,1,0,0,0,0,0,0,0,0,0.4772727272727273,0.5227272727272727
90410,0.6389891696750902,0.4,-177,150,0.614075512518083,0.385924487481917,away,CLE,over,8.5,0.5145631067961165,-106,0.4913668392989033,SF,CLE,2023 REG,6,1,4,3,4,10,0,1,-2,2,1,0,0,0,0,0,0,0,0,0.4913668392989033,0.5086331607010968
90410,0.6389891696750902,0.4,-177,150,0.614075512518083,0.385924487481917,home,SF,under,8.5,0.5305164319248826,-113,0.5086331607010968,SF,CLE,2023 REG,6,1,4,3,4,10,0,1,-2,2,1,0,0,0,0,0,0,0,0,0.4913668392989033,0.5086331607010968
90411,0.6610169491525424,0.3802281368821293,-195,163,0.6337532482143695,0.3662467517856305,away,WSH,over,10,0.5121951219512195,-105,0.48808156828023186,PHI,WSH,2023 REG,8,1,8,2,3,16,0,1,-1,1,1,0,0,0,0,0,0,0,0,0.48808156828023186,0.5119184317197681
90411,0.6610169491525424,0.3802281368821293,-195,163,0.6337532482143695,0.3662467517856305,home,PHI,under,10,0.5348837209302326,-115,0.5119184317197681,PHI,WSH,2023 REG,8,1,8,2,3,16,0,1,-1,1,1,0,0,0,0,0,0,0,0,0.48808156828023186,0.5119184317197681
90412,0.6212121212121212,0.4184100418410042,-164,139,0.5965983532548766,0.40340164674512335,away,STL,over,8.5,0.5283018867924528,-112,0.5044173060022736,MIL,STL,2023 REG,5,1,5,4,5,10,0,1,-3,3,1,0,0,0,0,0,0,0,0,0.5044173060022736,0.49558269399772636
90412,0.6212121212121212,0.4184100418410042,-164,139,0.5965983532548766,0.40340164674512335,home,MIL,under,8.5,0.5169082125603864,-107,0.49558269399772636,MIL,STL,2023 REG,5,1,5,4,5,10,0,1,-3,3,1,0,0,0,0,0,0,0,0,0.5044173060022736,0.49558269399772636
90413,0.2898550724637681,0.75,245,-300,0.2783028775467339,0.7216971224532661,away,ATL,over,9,0.5145631067961165,-106,0.49023796582517226,PIT,ATL,2023 REG,9,7,10,6,13,19,1,0,1,-1,1,1,1,1,1,1,0,0,0,0.49023796582517226,0.5097620341748277
90413,0.2898550724637681,0.75,245,-300,0.2783028775467339,0.7216971224532661,home,PIT,under,9,0.5327102803738317,-114,0.5097620341748277,PIT,ATL,2023 REG,9,7,10,6,13,19,1,0,1,-1,1,1,1,1,1,1,0,0,0,0.49023796582517226,0.5097620341748277
90414,0.7542997542997544,0.2840909090909091,-307,252,0.7253416863367723,0.2746583136632277,away,OAK,over,8.5,0.5121951219512195,-105,0.48808156828023186,SEA,OAK,2023 REG,11,6,7,1,7,18,1,0,5,-5,1,0,0,0,0,0,0,0,0,0.48808156828023186,0.5119184317197681
90414,0.7542997542997544,0.2840909090909091,-307,252,0.7253416863367723,0.2746583136632277,home,SEA,under,8.5,0.5348837209302326,-115,0.5119184317197681,SEA,OAK,2023 REG,11,6,7,1,7,18,1,0,5,-5,1,0,0,0,0,0,0,0,0,0.48808156828023186,0.5119184317197681
90415,0.6666666666666666,0.37037037037037035,-200,170,0.6419753086419753,0.3580246913580247,away,COL,over,8,0.5260663507109005,-111,0.5010269332605688,CLE,COL,2023 REG,4,0,10,6,6,14,0,1,-6,6,0,0,0,0,0,0,0,0,0,0.5010269332605688,0.4989730667394312
90415,0.6666666666666666,0.37037037037037035,-200,170,0.6419753086419753,0.3580246913580247,home,CLE,under,8,0.5215311004784688,-109,0.4989730667394312,CLE,COL,2023 REG,4,0,10,6,6,14,0,1,-6,6,0,0,0,0,0,0,0,0,0,0.5010269332605688,0.4989730667394312
90416,0.5,0.5454545454545454,100,-120,0.4772727272727273,0.5227272727272727,away,BAL,over,9.5,0.5348837209302326,-115,0.5109810284308424,ARI,BAL,2023 REG,10,4,8,2,6,18,1,0,2,-2,1,1,0,0,0,0,0,0,0,0.5109810284308424,0.48901897156915763
90416,0.5,0.5454545454545454,100,-120,0.4772727272727273,0.5227272727272727,home,ARI,under,9.5,0.5098039215686274,-104,0.48901897156915763,ARI,BAL,2023 REG,10,4,8,2,6,18,1,0,2,-2,1,1,0,0,0,0,0,0,0,0.5109810284308424,0.48901897156915763
90417,0.5555555555555556,0.48780487804878053,-125,105,0.5314664257753688,0.46853357422463116,away,ARI,over,8.5,0.5348837209302326,-115,0.5097020142727117,TEX,ARI,2023 REG,12,7,10,12,19,22,0,1,-5,5,1,1,1,1,1,1,1,0,0,0.5097020142727117,0.49029798572728833
90417,0.5555555555555556,0.48780487804878053,-125,105,0.5314664257753688,0.46853357422463116,home,TEX,under,8.5,0.5121951219512195,-105,0.49029798572728833,TEX,ARI,2023 REG,12,7,10,12,19,22,0,1,-5,5,1,1,1,1,1,1,1,0,0,0.5097020142727117,0.49029798572728833
90418,0.48780487804878053,0.5535714285714286,105,-124,0.4676213138438005,0.5323786861561994,away,CIN,over,9,0.5238095238095238,-110,0.4988662131519274,DET,CIN,2023 REG,9,5,9,6,11,18,0,1,-1,1,1,1,1,1,1,0,0,0,0,0.4988662131519274,0.5011337868480725
90418,0.48780487804878053,0.5535714285714286,105,-124,0.4676213138438005,0.5323786861561994,home,DET,under,9,0.5238095238095238,-110,0.5011337868480725,DET,CIN,2023 REG,9,5,9,6,11,18,0,1,-1,1,1,1,1,1,1,0,0,0,0,0.4988662131519274,0.5011337868480725
90419,0.5833333333333333,0.45454545454545453,-140,120,0.5612373737373737,0.4387626262626263,away,TOR,over,7,0.5,100,0.4772727272727273,NYY,TOR,2023 REG,10,5,4,3,8,14,1,0,2,-2,1,1,1,0,0,0,0,0,0,0.4772727272727273,0.5227272727272727
90419,0.5833333333333333,0.45454545454545453,-140,120,0.5612373737373737,0.4387626262626263,home,NYY,under,7,0.5454545454545454,-120,0.5227272727272727,NYY,TOR,2023 REG,10,5,4,3,8,14,1,0,2,-2,1,1,1,0,0,0,0,0,0,0.4772727272727273,0.5227272727272727
90421,0.7267759562841529,0.3125,-266,220,0.6982311355967631,0.3017688644032369,away,OAK,over,9.5,0.5348837209302326,-115,0.5097020142727117,HOU,OAK,2023 REG,10,5,8,1,6,18,1,0,4,-4,1,0,0,0,0,0,0,0,0,0.5097020142727117,0.49029798572728833
90421,0.7267759562841529,0.3125,-266,220,0.6982311355967631,0.3017688644032369,home,HOU,under,9.5,0.5121951219512195,-105,0.49029798572728833,HOU,OAK,2023 REG,10,5,8,1,6,18,1,0,4,-4,1,0,0,0,0,0,0,0,0,0.5097020142727117,0.49029798572728833
90422,0.7142857142857143,0.3278688524590164,-250,205,0.6841753094680495,0.3158246905319505,away,BOS,over,8,0.5305164319248826,-113,0.5078572507605655,TB,BOS,2023 REG,10,9,4,3,12,14,1,0,6,-6,1,1,1,0,0,0,0,0,0,0.5078572507605655,0.49214274923943446
90422,0.7142857142857143,0.3278688524590164,-250,205,0.6841753094680495,0.3158246905319505,home,TB,under,8,0.5121951219512195,-105,0.49214274923943446,TB,BOS,2023 REG,10,9,4,3,12,14,1,0,6,-6,1,1,1,0,0,0,0,0,0,0.5078572507605655,0.49214274923943446
90423,0.5983935742971888,0.4464285714285714,-149,124,0.5715722903086816,0.4284277096913184,away,BAL,over,10,0.5098039215686274,-104,0.48592421718142587,BOS,BAL,2023 REG,23,12,14,13,25,37,0,1,-1,1,1,1,1,1,1,1,1,1,1,0.48592421718142587,0.5140757828185741
90423,0.5983935742971888,0.4464285714285714,-149,124,0.5715722903086816,0.4284277096913184,home,BOS,under,10,0.5370370370370371,-116,0.5140757828185741,BOS,BAL,2023 REG,23,12,14,13,25,37,0,1,-1,1,1,1,1,1,1,1,1,1,1,0.48592421718142587,0.5140757828185741
90424,0.4587155963302753,0.5780590717299579,118,-137,0.4418464825411775,0.5581535174588226,away,CHC,over,8,0.5192307692307692,-108,0.49455035168025013,OAK,CHC,2023 REG,8,1,20,10,11,28,0,1,-9,9,1,0,0,0,0,0,0,0,0,0.49455035168025013,0.5054496483197499
90424,0.4587155963302753,0.5780590717299579,118,-137,0.4418464825411775,0.5581535174588226,home,OAK,under,8,0.5283018867924528,-112,0.5054496483197499,OAK,CHC,2023 REG,8,1,20,10,11,28,0,1,-9,9,1,0,0,0,0,0,0,0,0,0.49455035168025013,0.5054496483197499
90425,0.4081632653061224,0.6336996336996338,145,-173,0.39107636775275256,0.6089236322472474,away,PHI,over,9,0.5238095238095238,-110,0.4988662131519274,WSH,PHI,2023 REG,13,8,10,7,15,23,1,0,1,-1,1,1,1,1,1,1,1,0,0,0.4988662131519274,0.5011337868480725
90425,0.4081632653061224,0.6336996336996338,145,-173,0.39107636775275256,0.6089236322472474,home,WSH,under,9,0.5238095238095238,-110,0.5011337868480725,WSH,PHI,2023 REG,13,8,10,7,15,23,1,0,1,-1,1,1,1,1,1,1,1,0,0,0.4988662131519274,0.5011337868480725
90426,0.5918367346938775,0.45248868778280543,-145,121,0.5656033213913509,0.43439667860864906,away,LAA,over,9.5,0.5,100,0.4772727272727273,CWS,LAA,2023 REG,11,7,5,3,10,16,1,0,4,-4,1,1,1,0,0,0,0,0,0,0.4772727272727273,0.5227272727272727
90426,0.5918367346938775,0.45248868778280543,-145,121,0.5656033213913509,0.43439667860864906,home,CWS,under,9.5,0.5454545454545454,-120,0.5227272727272727,CWS,LAA,2023 REG,11,7,5,3,10,16,1,0,4,-4,1,1,1,0,0,0,0,0,0,0.4772727272727273,0.5227272727272727
90427,0.5,0.5454545454545454,100,-120,0.4772727272727273,0.5227272727272727,away,PHI,over,7.5,0.5348837209302326,-115,0.5097020142727117,MIL,PHI,2023 REG,7,7,5,5,12,12,1,0,2,-2,1,1,1,1,1,0,0,0,0,0.5097020142727117,0.49029798572728833
90427,0.5,0.5454545454545454,100,-120,0.4772727272727273,0.5227272727272727,home,MIL,under,7.5,0.5121951219512195,-105,0.49029798572728833,MIL,PHI,2023 REG,7,7,5,5,12,12,1,0,2,-2,1,1,1,1,1,0,0,0,0,0.5097020142727117,0.49029798572728833
90428,0.5689655172413793,0.4716981132075471,-132,112,0.5458293137100936,0.4541706862899064,away,HOU,over,8.5,0.5391705069124424,-117,0.5140669063204599,TEX,HOU,2023 REG,5,3,14,12,15,19,0,1,-9,9,1,1,1,0,0,0,0,0,0,0.5140669063204599,0.4859330936795401
90428,0.5689655172413793,0.4716981132075471,-132,112,0.5458293137100936,0.4541706862899064,home,TEX,under,8.5,0.5073891625615764,-103,0.4859330936795401,TEX,HOU,2023 REG,5,3,14,12,15,19,0,1,-9,9,1,1,1,0,0,0,0,0,0,0.5140669063204599,0.4859330936795401
90429,0.4716981132075471,0.5726495726495727,112,-134,0.4507793934636226,0.5492206065363774,away,MIN,over,13,0.5327102803738317,-114,0.5075272610403079,COL,MIN,2023 REG,11,6,12,14,20,23,0,1,-8,8,1,1,1,1,1,1,0,0,0,0.5075272610403079,0.4924727389596921
90429,0.4716981132075471,0.5726495726495727,112,-134,0.4507793934636226,0.5492206065363774,home,COL,under,13,0.5145631067961165,-106,0.4924727389596921,COL,MIN,2023 REG,11,6,12,14,20,23,0,1,-8,8,1,1,1,1,1,1,0,0,0,0.5075272610403079,0.4924727389596921
90430,0.5983935742971888,0.4464285714285714,-149,124,0.5715722903086816,0.4284277096913184,away,BOS,over,8.5,0.5412844036697247,-118,0.5149381613977361,TEX,BOS,2023 REG,16,15,11,5,20,27,1,0,10,-10,1,1,1,1,1,0,0,0,0,0.5149381613977361,0.48506183860226393
90430,0.5983935742971888,0.4464285714285714,-149,124,0.5715722903086816,0.4284277096913184,home,TEX,under,8.5,0.5073891625615764,-103,0.48506183860226393,TEX,BOS,2023 REG,16,15,11,5,20,27,1,0,10,-10,1,1,1,1,1,0,0,0,0,0.5149381613977361,0.48506183860226393
90431,0.5726495726495727,0.4672897196261683,-134,114,0.5497783539959433,0.4502216460040567,away,PIT,over,8,0.5238095238095238,-110,0.5000596729920038,ARI,PIT,2023 REG,5,3,4,2,5,9,1,0,1,-1,1,1,0,0,0,0,0,0,0,0.5000596729920038,0.4999403270079962
90431,0.5726495726495727,0.4672897196261683,-134,114,0.5497783539959433,0.4502216460040567,home,ARI,under,8,0.5215311004784688,-109,0.4999403270079962,ARI,PIT,2023 REG,5,3,4,2,5,9,1,0,1,-1,1,1,0,0,0,0,0,0,0,0.5000596729920038,0.4999403270079962
90432,0.6309963099630996,0.4098360655737705,-171,144,0.6052312316723071,0.3947687683276929,away,MIA,over,9.5,0.5,100,0.4772727272727273,PHI,MIA,2023 REG,8,4,5,5,9,13,0,1,-1,1,1,1,1,1,0,0,0,0,0,0.4772727272727273,0.5227272727272727
90432,0.6309963099630996,0.4098360655737705,-171,144,0.6052312316723071,0.3947687683276929,home,PHI,under,9.5,0.5454545454545454,-120,0.5227272727272727,PHI,MIA,2023 REG,8,4,5,5,9,13,0,1,-1,1,1,1,1,1,0,0,0,0,0,0.4772727272727273,0.5227272727272727
90433,0.4854368932038835,0.5555555555555556,106,-125,0.465537646233282,0.534462353766718,away,ARI,over,11,0.5145631067961165,-106,0.49023796582517226,COL,ARI,2023 REG,7,1,10,9,10,17,0,1,-8,8,1,0,0,0,0,0,0,0,0,0.49023796582517226,0.5097620341748277
90433,0.4854368932038835,0.5555555555555556,106,-125,0.465537646233282,0.534462353766718,home,COL,under,11,0.5327102803738317,-114,0.5097620341748277,COL,ARI,2023 REG,7,1,10,9,10,17,0,1,-8,8,1,0,0,0,0,0,0,0,0,0.49023796582517226,0.5097620341748277
90434,0.4484304932735426,0.5901639344262295,123,-144,0.43112357502252374,0.5688764249774763,away,STL,over,9.5,0.5327102803738317,-114,0.5075272610403079,PIT,STL,2023 REG,11,7,13,5,12,24,1,0,2,-2,1,1,1,1,1,0,0,0,0,0.5075272610403079,0.4924727389596921
90434,0.4484304932735426,0.5901639344262295,123,-144,0.43112357502252374,0.5688764249774763,home,PIT,under,9.5,0.5145631067961165,-106,0.4924727389596921,PIT,STL,2023 REG,11,7,13,5,12,24,1,0,2,-2,1,1,1,1,1,0,0,0,0,0.5075272610403079,0.4924727389596921
90435,0.626865671641791,0.41152263374485604,-168,143,0.6028013608024003,0.3971986391975997,away,CWS,over,9,0.5121951219512195,-105,0.48808156828023186,TEX,CWS,2023 REG,15,11,4,1,12,19,1,0,10,-10,1,0,0,0,0,0,0,0,0,0.48808156828023186,0.5119184317197681
90435,0.626865671641791,0.41152263374485604,-168,143,0.6028013608024003,0.3971986391975997,home,TEX,under,9,0.5348837209302326,-115,0.5119184317197681,TEX,CWS,2023 REG,15,11,4,1,12,19,1,0,10,-10,1,0,0,0,0,0,0,0,0,0.48808156828023186,0.5119184317197681
90436,0.6923076923076923,0.3448275862068966,-225,190,0.6665986533360538,0.33340134666394616,away,NYY,over,7,0.5145631067961165,-106,0.4913668392989033,TEX,NYY,2023 REG,10,5,5,2,7,15,1,0,3,-3,1,1,0,0,0,0,0,0,0,0.4913668392989033,0.5086331607010968
90436,0.6923076923076923,0.3448275862068966,-225,190,0.6665986533360538,0.33340134666394616,home,TEX,under,7,0.5305164319248826,-113,0.5086331607010968,TEX,NYY,2023 REG,10,5,5,2,7,15,1,0,3,-3,1,1,0,0,0,0,0,0,0,0.4913668392989033,0.5086331607010968
90437,0.5726495726495727,0.4629629629629629,-134,116,0.5522560693500865,0.44774393064991347,away,MIL,over,9.5,0.5098039215686274,-104,0.48375889301574193,ARI,MIL,2023 REG,12,7,11,3,10,23,1,0,4,-4,1,1,1,0,0,0,0,0,0,0.48375889301574193,0.5162411069842581
90437,0.5726495726495727,0.4629629629629629,-134,116,0.5522560693500865,0.44774393064991347,home,ARI,under,9.5,0.5412844036697247,-118,0.5162411069842581,ARI,MIL,2023 REG,12,7,11,3,10,23,1,0,4,-4,1,1,1,0,0,0,0,0,0,0.48375889301574193,0.5162411069842581
90438,0.5780590717299579,0.4608294930875576,-137,117,0.5555791840506346,0.44442081594936544,away,TB,over,9,0.5,100,0.4772727272727273,TEX,TB,2023 REG,8,5,6,3,8,14,1,0,2,-2,1,1,1,0,0,0,0,0,0,0.4772727272727273,0.5227272727272727
90438,0.5780590717299579,0.4608294930875576,-137,117,0.5555791840506346,0.44442081594936544,home,TEX,under,9,0.5454545454545454,-120,0.5227272727272727,TEX,TB,2023 REG,8,5,6,3,8,14,1,0,2,-2,1,1,1,0,0,0,0,0,0,0.4772727272727273,0.5227272727272727
90439,0.47619047619047616,0.5633187772925764,110,-129,0.45737654596045113,0.5426234540395489,away,ATL,over,10,0.5412844036697247,-118,0.5149381613977361,PHI,ATL,2023 REG,8,7,7,5,12,15,1,0,2,-2,1,1,1,1,1,0,0,0,0,0.5149381613977361,0.48506183860226393
90439,0.47619047619047616,0.5633187772925764,110,-129,0.45737654596045113,0.5426234540395489,home,PHI,under,10,0.5073891625615764,-103,0.48506183860226393,PHI,ATL,2023 REG,8,7,7,5,12,15,1,0,2,-2,1,1,1,1,1,0,0,0,0,0.5149381613977361,0.48506183860226393
90440,0.765807962529274,0.27624309392265195,-327,262,0.7336049286656211,0.2663950713343789,away,OAK,over,7.5,0.5433789954337899,-119,0.5198077604720502,SEA,OAK,2023 REG,13,11,5,2,13,18,1,0,9,-9,1,1,0,0,0,0,0,0,0,0.5198077604720502,0.48019223952794976
90440,0.765807962529274,0.27624309392265195,-327,262,0.7336049286656211,0.2663950713343789,home,SEA,under,7.5,0.5,100,0.48019223952794976,SEA,OAK,2023 REG,13,11,5,2,13,18,1,0,9,-9,1,1,0,0,0,0,0,0,0,0.5198077604720502,0.48019223952794976
90441,0.3484320557491289,0.6894409937888198,187,-222,0.33523587124113285,0.6647641287588671,away,PHI,over,7.5,0.5305164319248826,-113,0.5066009958897986,OAK,PHI,2023 REG,9,2,7,3,5,16,0,1,-1,1,1,1,0,0,0,0,0,0,0,0.5066009958897986,0.49339900411020143
90441,0.3484320557491289,0.6894409937888198,187,-222,0.33523587124113285,0.6647641287588671,home,OAK,under,7.5,0.5145631067961165,-106,0.49339900411020143,OAK,PHI,2023 REG,9,2,7,3,5,16,0,1,-1,1,1,1,0,0,0,0,0,0,0,0.5066009958897986,0.49339900411020143
90442,0.6363636363636364,0.4081632653061224,-175,145,0.6080283353010626,0.3919716646989374,away,BAL,over,8,0.5327102803738317,-114,0.5100625279371946,TOR,BAL,2023 REG,5,1,15,6,7,20,0,1,-5,5,1,0,0,0,0,0,0,0,0,0.5100625279371946,0.48993747206280536
90442,0.6363636363636364,0.4081632653061224,-175,145,0.6080283353010626,0.3919716646989374,home,TOR,under,8,0.5098039215686274,-104,0.48993747206280536,TOR,BAL,2023 REG,5,1,15,6,7,20,0,1,-5,5,1,0,0,0,0,0,0,0,0,0.5100625279371946,0.48993747206280536
90443,0.574468085106383,0.46511627906976744,-135,115,0.5517281312179562,0.44827186878204384,away,HOU,over,8,0.5121951219512195,-105,0.48808156828023186,TEX,HOU,2023 REG,15,5,4,2,7,19,1,0,3,-3,1,1,0,0,0,0,0,0,0,0.48808156828023186,0.5119184317197681
90443,0.574468085106383,0.46511627906976744,-135,115,0.5517281312179562,0.44827186878204384,home,TEX,under,8,0.5348837209302326,-115,0.5119184317197681,TEX,HOU,2023 REG,15,5,4,2,7,19,1,0,3,-3,1,1,0,0,0,0,0,0,0,0.48808156828023186,0.5119184317197681
90444,0.5098039215686274,0.5305164319248826,-104,-113,0.4892484472386027,0.5107515527613973,away,PHI,over,10,0.5348837209302326,-115,0.5097020142727117,ARI,PHI,2023 REG,12,9,13,8,17,25,1,0,1,-1,1,1,1,1,1,1,1,1,0,0.5097020142727117,0.49029798572728833
90444,0.5098039215686274,0.5305164319248826,-104,-113,0.4892484472386027,0.5107515527613973,home,ARI,under,10,0.5121951219512195,-105,0.49029798572728833,ARI,PHI,2023 REG,12,9,13,8,17,25,1,0,1,-1,1,1,1,1,1,1,1,1,0,0.5097020142727117,0.49029798572728833
90445,0.5238095238095238,0.5192307692307692,-110,-108,0.5012646084074657,0.4987353915925343,away,MIN,over,8.5,0.5454545454545454,-120,0.5206611570247933,BOS,MIN,2023 REG,12,5,4,4,9,16,1,0,1,-1,1,1,1,1,0,0,0,0,0,0.5206611570247933,0.4793388429752067
90445,0.5238095238095238,0.5192307692307692,-110,-108,0.5012646084074657,0.4987353915925343,home,BOS,under,8.5,0.5,100,0.4793388429752067,BOS,MIN,2023 REG,12,5,4,4,9,16,1,0,1,-1,1,1,1,1,0,0,0,0,0,0.5206611570247933,0.4793388429752067
90446,0.6047430830039526,0.4366812227074236,-153,129,0.5796920206567566,0.4203079793432434,away,PIT,over,8.5,0.5348837209302326,-115,0.5097020142727117,KC,PIT,2023 REG,6,3,9,6,9,15,0,1,-3,3,1,1,1,0,0,0,0,0,0,0.5097020142727117,0.49029798572728833
90446,0.6047430830039526,0.4366812227074236,-153,129,0.5796920206567566,0.4203079793432434,home,KC,under,8.5,0.5121951219512195,-105,0.49029798572728833,KC,PIT,2023 REG,6,3,9,6,9,15,0,1,-3,3,1,1,1,0,0,0,0,0,0,0.5097020142727117,0.49029798572728833
90447,0.3846153846153846,0.6551724137931035,160,-190,0.3693123852275045,0.6306876147724956,away,DET,over,7.5,0.5238095238095238,-110,0.4988662131519274,OAK,DET,2023 REG,5,3,9,7,10,14,0,1,-4,4,1,1,1,0,0,0,0,0,0,0.4988662131519274,0.5011337868480725
90447,0.3846153846153846,0.6551724137931035,160,-190,0.3693123852275045,0.6306876147724956,home,OAK,under,7.5,0.5238095238095238,-110,0.5011337868480725,OAK,DET,2023 REG,5,3,9,7,10,14,0,1,-4,4,1,1,1,0,0,0,0,0,0,0.4988662131519274,0.5011337868480725
90448,0.5833333333333333,0.45454545454545453,-140,120,0.5612373737373737,0.4387626262626263,away,STL,over,9,0.49504950495049505,102,0.47297076509898783,LAD,STL,2023 REG,9,7,6,3,10,15,1,0,4,-4,1,1,1,0,0,0,0,0,0,0.47297076509898783,0.5270292349010122
90448,0.5833333333333333,0.45454545454545453,-140,120,0.5612373737373737,0.4387626262626263,home,LAD,under,9,0.5495495495495495,-122,0.5270292349010122,LAD,STL,2023 REG,9,7,6,3,10,15,1,0,4,-4,1,1,1,0,0,0,0,0,0,0.47297076509898783,0.5270292349010122
90449,0.3921568627450981,0.6453900709219857,155,-182,0.37743257503251615,0.6225674249674839,away,TB,over,8,0.5305164319248826,-113,0.5053568787472517,WSH,TB,2023 REG,4,2,9,6,8,13,0,1,-4,4,1,1,0,0,0,0,0,0,0,0.5053568787472517,0.49464312125274834
90449,0.3921568627450981,0.6453900709219857,155,-182,0.37743257503251615,0.6225674249674839,home,WSH,under,8,0.5169082125603864,-107,0.49464312125274834,WSH,TB,2023 REG,4,2,9,6,8,13,0,1,-4,4,1,1,0,0,0,0,0,0,0,0.5053568787472517,0.49464312125274834
90450,0.6108949416342413,0.42372881355932196,-157,136,0.5897434647261112,0.41025653527388883,away,LAA,over,8.5,0.5348837209302326,-115,0.5097020142727117,BAL,LAA,2023 REG,11,3,4,1,4,15,1,0,2,-2,1,0,0,0,0,0,0,0,0,0.5097020142727117,0.49029798572728833
90450,0.6108949416342413,0.42372881355932196,-157,136,0.5897434647261112,0.41025653527388883,home,BAL,under,8.5,0.5121951219512195,-105,0.49029798572728833,BAL,LAA,2023 REG,11,3,4,1,4,15,1,0,2,-2,1,0,0,0,0,0,0,0,0,0.5097020142727117,0.49029798572728833
90451,0.7333333333333333,0.30303030303030304,-275,230,0.7066666666666666,0.29333333333333345,away,KC,over,8,0.5348837209302326,-115,0.5109810284308424,MIL,KC,2023 REG,11,5,3,1,6,14,1,0,4,-4,1,0,0,0,0,0,0,0,0,0.5109810284308424,0.48901897156915763
90451,0.7333333333333333,0.30303030303030304,-275,230,0.7066666666666666,0.29333333333333345,home,MIL,under,8,0.5098039215686274,-104,0.48901897156915763,MIL,KC,2023 REG,11,5,3,1,6,14,1,0,4,-4,1,0,0,0,0,0,0,0,0,0.5109810284308424,0.48901897156915763
90452,0.6551724137931035,0.3846153846153846,-190,160,0.6291045458703008,0.37089545412969915,away,KC,over,9,0.504950495049505,-102,0.4826715732667395,STL,KC,2023 REG,5,2,5,1,3,10,1,0,1,-1,1,0,0,0,0,0,0,0,0,0.4826715732667395,0.5173284267332605
90452,0.6551724137931035,0.3846153846153846,-190,160,0.6291045458703008,0.37089545412969915,home,STL,under,9,0.5391705069124424,-117,0.5173284267332605,STL,KC,2023 REG,5,2,5,1,3,10,1,0,1,-1,1,0,0,0,0,0,0,0,0,0.4826715732667395,0.5173284267332605
90453,0.39525691699604737,0.6415770609318996,153,-179,0.3806980324395466,0.6193019675604534,away,TB,over,8.5,0.5283018867924528,-112,0.5044173060022736,CHC,TB,2023 REG,8,2,7,1,3,15,1,0,1,-1,1,0,0,0,0,0,0,0,0,0.5044173060022736,0.49558269399772636
90453,0.39525691699604737,0.6415770609318996,153,-179,0.3806980324395466,0.6193019675604534,home,CHC,under,8.5,0.5169082125603864,-107,0.49558269399772636,CHC,TB,2023 REG,8,2,7,1,3,15,1,0,1,-1,1,0,0,0,0,0,0,0,0,0.5044173060022736,0.49558269399772636
90454,0.607843137254902,0.43103448275862066,-155,132,0.5842116427368785,0.41578835726312147,away,STL,over,8.5,0.5327102803738317,-114,0.508788710910954,SF,STL,2023 REG,6,0,12,6,6,18,0,1,-6,6,0,0,0,0,0,0,0,0,0,0.508788710910954,0.491211289089046
90454,0.607843137254902,0.43103448275862066,-155,132,0.5842116427368785,0.41578835726312147,home,SF,under,8.5,0.5121951219512195,-105,0.491211289089046,SF,STL,2023 REG,6,0,12,6,6,18,0,1,-6,6,0,0,0,0,0,0,0,0,0,0.508788710910954,0.491211289089046
90455,0.6575342465753424,0.38314176245210724,-192,161,0.6307883776257865,0.36921162237421346,away,OAK,over,9.5,0.5454545454545454,-120,0.5206611570247933,BOS,OAK,2023 REG,7,4,11,3,7,18,1,0,1,-1,1,1,1,0,0,0,0,0,0,0.5206611570247933,0.4793388429752067
90455,0.6575342465753424,0.38314176245210724,-192,161,0.6307883776257865,0.36921162237421346,home,BOS,under,9.5,0.5,100,0.4793388429752067,BOS,OAK,2023 REG,7,4,11,3,7,18,1,0,1,-1,1,1,1,0,0,0,0,0,0,0.5206611570247933,0.4793388429752067
90456,0.45454545454545453,0.5867768595041323,120,-142,0.43576258452291505,0.564237415477085,away,NYY,over,8.5,0.5348837209302326,-115,0.5097020142727117,KC,NYY,2023 REG,11,5,7,2,7,18,1,0,3,-3,1,1,0,0,0,0,0,0,0,0.5097020142727117,0.49029798572728833
90456,0.45454545454545453,0.5867768595041323,120,-142,0.43576258452291505,0.564237415477085,home,KC,under,8.5,0.5121951219512195,-105,0.49029798572728833,KC,NYY,2023 REG,11,5,7,2,7,18,1,0,3,-3,1,1,0,0,0,0,0,0,0,0.5097020142727117,0.49029798572728833
90457,0.5689655172413793,0.4716981132075471,-132,112,0.5458293137100936,0.4541706862899064,away,SEA,over,7,0.5073891625615764,-103,0.4837652908580103,SF,SEA,2023 REG,7,5,10,6,11,17,0,1,-1,1,1,1,1,1,1,0,0,0,0,0.4837652908580103,0.5162347091419897
90457,0.5689655172413793,0.4716981132075471,-132,112,0.5458293137100936,0.4541706862899064,home,SF,under,7,0.5391705069124424,-117,0.5162347091419897,SF,SEA,2023 REG,7,5,10,6,11,17,0,1,-1,1,1,1,1,1,1,0,0,0,0,0.4837652908580103,0.5162347091419897
90458,0.5884773662551441,0.45248868778280543,-143,121,0.5643697706690257,0.4356302293309743,away,OAK,over,8.5,0.5121951219512195,-105,0.48808156828023186,LAA,OAK,2023 REG,9,5,4,1,6,13,1,0,4,-4,1,0,0,0,0,0,0,0,0,0.48808156828023186,0.5119184317197681
90458,0.5884773662551441,0.45248868778280543,-143,121,0.5643697706690257,0.4356302293309743,home,LAA,under,8.5,0.5348837209302326,-115,0.5119184317197681,LAA,OAK,2023 REG,9,5,4,1,6,13,1,0,4,-4,1,0,0,0,0,0,0,0,0,0.48808156828023186,0.5119184317197681
90459,0.6363636363636364,0.4,-175,150,0.6132231404958678,0.3867768595041322,away,CHC,over,7.5,0.5305164319248826,-113,0.5066009958897986,HOU,CHC,2023 REG,9,7,6,3,10,15,1,0,4,-4,1,1,1,0,0,0,0,0,0,0.5066009958897986,0.49339900411020143
90459,0.6363636363636364,0.4,-175,150,0.6132231404958678,0.3867768595041322,home,HOU,under,7.5,0.5145631067961165,-106,0.49339900411020143,HOU,CHC,2023 REG,9,7,6,3,10,15,1,0,4,-4,1,1,1,0,0,0,0,0,0,0.5066009958897986,0.49339900411020143
90460,0.5555555555555556,0.47846889952153115,-125,109,0.5366530805127296,0.46334691948727036,away,COL,over,9.5,0.5073891625615764,-103,0.4837652908580103,KC,COL,2023 REG,6,2,9,7,9,15,0,1,-5,5,1,1,0,0,0,0,0,0,0,0.4837652908580103,0.5162347091419897
90460,0.5555555555555556,0.47846889952153115,-125,109,0.5366530805127296,0.46334691948727036,home,KC,under,9.5,0.5391705069124424,-117,0.5162347091419897,KC,COL,2023 REG,6,2,9,7,9,15,0,1,-5,5,1,1,0,0,0,0,0,0,0,0.4837652908580103,0.5162347091419897
90461,0.3448275862068966,0.6923076923076923,190,-225,0.3320223177535901,0.6679776822464099,away,ARI,over,8.5,0.5073891625615764,-103,0.4837652908580103,DET,ARI,2023 REG,11,5,9,7,12,20,0,1,-2,2,1,1,1,1,1,0,0,0,0,0.4837652908580103,0.5162347091419897
90461,0.3448275862068966,0.6923076923076923,190,-225,0.3320223177535901,0.6679776822464099,home,DET,under,8.5,0.5391705069124424,-117,0.5162347091419897,DET,ARI,2023 REG,11,5,9,7,12,20,0,1,-2,2,1,1,1,1,1,0,0,0,0,0.4837652908580103,0.5162347091419897
90462,0.5815899581589958,0.4587155963302753,-139,118,0.5581486524100054,0.44185134758999456,away,SD,over,9,0.5454545454545454,-120,0.5206611570247933,LAD,SD,2023 REG,6,4,8,2,6,14,1,0,2,-2,1,1,0,0,0,0,0,0,0,0.5206611570247933,0.4793388429752067
90462,0.5815899581589958,0.4587155963302753,-139,118,0.5581486524100054,0.44185134758999456,home,LAD,under,9,0.5,100,0.4793388429752067,LAD,SD,2023 REG,6,4,8,2,6,14,1,0,2,-2,1,1,0,0,0,0,0,0,0,0.5206611570247933,0.4793388429752067
90463,0.5850622406639003,0.45454545454545453,-141,120,0.5618892737571823,0.43811072624281766,away,CWS,over,8.5,0.5412844036697247,-118,0.5149381613977361,HOU,CWS,2023 REG,11,6,10,4,10,21,1,0,2,-2,1,1,1,1,0,0,0,0,0,0.5149381613977361,0.48506183860226393
90463,0.5850622406639003,0.45454545454545453,-141,120,0.5618892737571823,0.43811072624281766,home,HOU,under,8.5,0.5073891625615764,-103,0.48506183860226393,HOU,CWS,2023 REG,11,6,10,4,10,21,1,0,2,-2,1,1,1,1,0,0,0,0,0,0.5149381613977361,0.48506183860226393
90464,0.5918367346938775,0.4504504504504505,-145,122,0.566809625118663,0.43319037488133705,away,LAA,over,9,0.5412844036697247,-118,0.5136310900085983,CWS,LAA,2023 REG,12,5,13,12,17,25,0,1,-7,7,1,1,1,1,1,0,0,0,0,0.5136310900085983,0.4863689099914017
90464,0.5918367346938775,0.4504504504504505,-145,122,0.566809625118663,0.43319037488133705,home,CWS,under,9,0.5098039215686274,-104,0.4863689099914017,CWS,LAA,2023 REG,12,5,13,12,17,25,0,1,-7,7,1,1,1,1,1,0,0,0,0,0.5136310900085983,0.4863689099914017
90465,0.38759689922480617,0.6551724137931035,158,-190,0.37101964611708926,0.6289803538829107,away,HOU,over,8,0.5192307692307692,-108,0.49455035168025013,PIT,HOU,2023 REG,3,2,13,8,10,16,0,1,-6,6,1,1,0,0,0,0,0,0,0,0.49455035168025013,0.5054496483197499
90465,0.38759689922480617,0.6551724137931035,158,-190,0.37101964611708926,0.6289803538829107,home,PIT,under,8,0.5283018867924528,-112,0.5054496483197499,PIT,HOU,2023 REG,3,2,13,8,10,16,0,1,-6,6,1,1,0,0,0,0,0,0,0,0.49455035168025013,0.5054496483197499
90466,0.7354497354497355,0.30303030303030304,-278,230,0.7071496013294954,0.29285039867050455,away,PIT,over,8.5,0.5305164319248826,-113,0.5066009958897986,STL,PIT,2023 REG,6,0,9,5,5,15,0,1,-5,5,0,0,0,0,0,0,0,0,0,0.5066009958897986,0.49339900411020143
90466,0.7354497354497355,0.30303030303030304,-278,230,0.7071496013294954,0.29285039867050455,home,STL,under,8.5,0.5145631067961165,-106,0.49339900411020143,STL,PIT,2023 REG,6,0,9,5,5,15,0,1,-5,5,0,0,0,0,0,0,0,0,0,0.5066009958897986,0.49339900411020143
90467,0.4347826086956522,0.607843137254902,130,-155,0.41624967567367205,0.583750324326328,away,SEA,over,10.5,0.5073891625615764,-103,0.4837652908580103,CIN,SEA,2023 REG,8,6,9,3,9,17,1,0,3,-3,1,1,1,0,0,0,0,0,0,0.4837652908580103,0.5162347091419897
90467,0.4347826086956522,0.607843137254902,130,-155,0.41624967567367205,0.583750324326328,home,CIN,under,10.5,0.5391705069124424,-117,0.5162347091419897,CIN,SEA,2023 REG,8,6,9,3,9,17,1,0,3,-3,1,1,1,0,0,0,0,0,0,0.4837652908580103,0.5162347091419897
90468,0.6240601503759399,0.41152263374485604,-166,143,0.6018543527667214,0.3981456472332786,away,KC,over,9,0.5433789954337899,-119,0.5198077604720502,MIL,KC,2023 REG,7,4,9,3,7,16,1,0,1,-1,1,1,1,0,0,0,0,0,0,0.5198077604720502,0.48019223952794976
90468,0.6240601503759399,0.41152263374485604,-166,143,0.6018543527667214,0.3981456472332786,home,MIL,under,9,0.5,100,0.48019223952794976,MIL,KC,2023 REG,7,4,9,3,7,16,1,0,1,-1,1,1,1,0,0,0,0,0,0,0.5198077604720502,0.48019223952794976
90469,0.47619047619047616,0.5652173913043479,110,-130,0.4564724440500838,0.5435275559499162,away,TOR,over,6.5,0.5454545454545454,-120,0.5206611570247933,MIA,TOR,2023 REG,9,3,11,6,9,20,0,1,-3,3,1,1,1,0,0,0,0,0,0,0.5206611570247933,0.4793388429752067
90469,0.47619047619047616,0.5652173913043479,110,-130,0.4564724440500838,0.5435275559499162,home,MIA,under,6.5,0.5,100,0.4793388429752067,MIA,TOR,2023 REG,9,3,11,6,9,20,0,1,-3,3,1,1,1,0,0,0,0,0,0,0.5206611570247933,0.4793388429752067
90470,0.5967741935483871,0.4444444444444444,-148,125,0.5721759741010521,0.42782402589894786,away,CWS,over,8,0.5073891625615764,-103,0.4837652908580103,HOU,CWS,2023 REG,7,3,13,6,9,20,0,1,-3,3,1,1,1,0,0,0,0,0,0,0.4837652908580103,0.5162347091419897
90470,0.5967741935483871,0.4444444444444444,-148,125,0.5721759741010521,0.42782402589894786,home,HOU,under,8,0.5391705069124424,-117,0.5162347091419897,HOU,CWS,2023 REG,7,3,13,6,9,20,0,1,-3,3,1,1,1,0,0,0,0,0,0,0.4837652908580103,0.5162347091419897
90471,0.5833333333333333,0.45454545454545453,-140,120,0.5612373737373737,0.4387626262626263,away,MIA,over,8.5,0.5238095238095238,-110,0.5000596729920038,LAA,MIA,2023 REG,10,2,16,6,8,26,0,1,-4,4,1,1,0,0,0,0,0,0,0,0.5000596729920038,0.4999403270079962
90471,0.5833333333333333,0.45454545454545453,-140,120,0.5612373737373737,0.4387626262626263,home,LAA,under,8.5,0.5215311004784688,-109,0.4999403270079962,LAA,MIA,2023 REG,10,2,16,6,8,26,0,1,-4,4,1,1,0,0,0,0,0,0,0,0.5000596729920038,0.4999403270079962
90472,0.5121951219512195,0.5348837209302326,-105,-115,0.48808156828023186,0.5119184317197681,away,CLE,over,8,0.5145631067961165,-106,0.49023796582517226,BAL,CLE,2023 REG,12,8,17,12,20,29,0,1,-4,4,1,1,1,1,1,1,1,1,0,0.49023796582517226,0.5097620341748277
90472,0.5121951219512195,0.5348837209302326,-105,-115,0.48808156828023186,0.5119184317197681,home,BAL,under,8,0.5327102803738317,-114,0.5097620341748277,BAL,CLE,2023 REG,12,8,17,12,20,29,0,1,-4,4,1,1,1,1,1,1,1,1,0,0.49023796582517226,0.5097620341748277
90473,0.5670995670995671,0.4716981132075471,-131,112,0.5450974193929352,0.4549025806070648,away,SF,over,8.5,0.5454545454545454,-120,0.5206611570247933,SD,SF,2023 REG,7,2,10,7,9,17,0,1,-5,5,1,1,0,0,0,0,0,0,0,0.5206611570247933,0.4793388429752067
90473,0.5670995670995671,0.4716981132075471,-131,112,0.5450974193929352,0.4549025806070648,home,SD,under,8.5,0.5,100,0.4793388429752067,SD,SF,2023 REG,7,2,10,7,9,17,0,1,-5,5,1,1,0,0,0,0,0,0,0,0.5206611570247933,0.4793388429752067
90474,0.576271186440678,0.4629629629629629,-136,116,0.553661676614851,0.446338323385149,away,ARI,over,8.5,0.5454545454545454,-120,0.5206611570247933,SF,ARI,2023 REG,5,3,5,4,7,10,0,1,-1,1,1,1,1,0,0,0,0,0,0,0.5206611570247933,0.4793388429752067
90474,0.576271186440678,0.4629629629629629,-136,116,0.553661676614851,0.446338323385149,home,SF,under,8.5,0.5,100,0.4793388429752067,SF,ARI,2023 REG,5,3,5,4,7,10,0,1,-1,1,1,1,1,0,0,0,0,0,0,0.5206611570247933,0.4793388429752067
90475,0.6212121212121212,0.4166666666666667,-164,140,0.5976813590449954,0.4023186409550046,away,BOS,over,9,0.49504950495049505,102,0.4739797934813417,BAL,BOS,2023 REG,11,6,11,8,14,22,0,1,-2,2,1,1,1,1,1,1,0,0,0,0.4739797934813417,0.5260202065186583
90475,0.6212121212121212,0.4166666666666667,-164,140,0.5976813590449954,0.4023186409550046,home,BAL,under,9,0.5475113122171946,-121,0.5260202065186583,BAL,BOS,2023 REG,11,6,11,8,14,22,0,1,-2,2,1,1,1,1,1,1,0,0,0,0.4739797934813417,0.5260202065186583
90476,0.5348837209302326,0.5024875621890548,-115,-101,0.514894429959451,0.485105570040549,away,TOR,over,8,0.5260663507109005,-111,0.5010269332605688,MIN,TOR,2023 REG,14,9,10,7,16,24,1,0,2,-2,1,1,1,1,1,1,1,0,0,0.5010269332605688,0.4989730667394312
90476,0.5348837209302326,0.5024875621890548,-115,-101,0.514894429959451,0.485105570040549,home,MIN,under,8,0.5215311004784688,-109,0.4989730667394312,MIN,TOR,2023 REG,14,9,10,7,16,24,1,0,2,-2,1,1,1,1,1,1,1,0,0,0.5010269332605688,0.4989730667394312
90477,0.574468085106383,0.46511627906976744,-135,115,0.5517281312179562,0.44827186878204384,away,MIL,over,8.5,0.5348837209302326,-115,0.5097020142727117,SEA,MIL,2023 REG,7,3,9,5,8,16,0,1,-2,2,1,1,1,0,0,0,0,0,0,0.5097020142727117,0.49029798572728833
90477,0.574468085106383,0.46511627906976744,-135,115,0.5517281312179562,0.44827186878204384,home,SEA,under,8.5,0.5121951219512195,-105,0.49029798572728833,SEA,MIL,2023 REG,7,3,9,5,8,16,0,1,-2,2,1,1,1,0,0,0,0,0,0,0.5097020142727117,0.49029798572728833
90478,0.5238095238095238,0.5192307692307692,-110,-108,0.5012646084074657,0.4987353915925343,away,HOU,over,7.5,0.5121951219512195,-105,0.48808156828023186,MIL,HOU,2023 REG,6,2,15,12,14,21,0,1,-10,10,1,1,0,0,0,0,0,0,0,0.48808156828023186,0.5119184317197681
90478,0.5238095238095238,0.5192307692307692,-110,-108,0.5012646084074657,0.4987353915925343,home,MIL,under,7.5,0.5348837209302326,-115,0.5119184317197681,MIL,HOU,2023 REG,6,2,15,12,14,21,0,1,-10,10,1,1,0,0,0,0,0,0,0,0.48808156828023186,0.5119184317197681
90479,0.7333333333333333,0.3076923076923077,-275,225,0.7032478632478633,0.29675213675213674,away,MIA,over,7.5,0.5348837209302326,-115,0.5097020142727117,ATL,MIA,2023 REG,12,11,2,0,11,14,1,0,11,-11,0,0,0,0,0,0,0,0,0,0.5097020142727117,0.49029798572728833
90479,0.7333333333333333,0.3076923076923077,-275,225,0.7032478632478633,0.29675213675213674,home,ATL,under,7.5,0.5121951219512195,-105,0.49029798572728833,ATL,MIA,2023 REG,12,11,2,0,11,14,1,0,11,-11,0,0,0,0,0,0,0,0,0,0.5097020142727117,0.49029798572728833
90480,0.5098039215686274,0.5348837209302326,-104,-115,0.4870219861770517,0.5129780138229483,away,TEX,over,9.5,0.5327102803738317,-114,0.5075272610403079,BOS,TEX,2023 REG,10,4,9,2,6,19,1,0,2,-2,1,1,0,0,0,0,0,0,0,0.5075272610403079,0.4924727389596921
90480,0.5098039215686274,0.5348837209302326,-104,-115,0.4870219861770517,0.5129780138229483,home,BOS,under,9.5,0.5145631067961165,-106,0.4924727389596921,BOS,TEX,2023 REG,10,4,9,2,6,19,1,0,2,-2,1,1,0,0,0,0,0,0,0,0.5075272610403079,0.4924727389596921
90481,0.7282608695652174,0.31545741324921134,-268,217,0.6964225549068834,0.30357744509311657,away,OAK,over,9,0.5412844036697247,-118,0.5162581740877563,BOS,OAK,2023 REG,15,10,9,3,13,24,1,0,7,-7,1,1,1,0,0,0,0,0,0,0.5162581740877563,0.4837418259122437
90481,0.7282608695652174,0.31545741324921134,-268,217,0.6964225549068834,0.30357744509311657,home,BOS,under,9,0.504950495049505,-102,0.4837418259122437,BOS,OAK,2023 REG,15,10,9,3,13,24,1,0,7,-7,1,1,1,0,0,0,0,0,0,0.5162581740877563,0.4837418259122437
90482,0.6062992125984252,0.4347826086956522,-154,130,0.581391336695717,0.41860866330428304,away,ARI,over,9,0.5145631067961165,-106,0.49023796582517226,MIA,ARI,2023 REG,11,5,6,1,6,17,1,0,4,-4,1,0,0,0,0,0,0,0,0,0.49023796582517226,0.5097620341748277
90482,0.6062992125984252,0.4347826086956522,-154,130,0.581391336695717,0.41860866330428304,home,MIA,under,9,0.5327102803738317,-114,0.5097620341748277,MIA,ARI,2023 REG,11,5,6,1,6,17,1,0,4,-4,1,0,0,0,0,0,0,0,0,0.49023796582517226,0.5097620341748277
90483,0.5327102803738317,0.5073891625615764,-114,-103,0.511348894884876,0.488651105115124,away,CIN,over,8,0.5238095238095238,-110,0.4988662131519274,NYM,CIN,2023 REG,5,3,8,5,8,13,0,1,-2,2,1,1,1,0,0,0,0,0,0,0.4988662131519274,0.5011337868480725
90483,0.5327102803738317,0.5073891625615764,-114,-103,0.511348894884876,0.488651105115124,home,NYM,under,8,0.5238095238095238,-110,0.5011337868480725,NYM,CIN,2023 REG,5,3,8,5,8,13,0,1,-2,2,1,1,1,0,0,0,0,0,0,0.4988662131519274,0.5011337868480725
90484,0.6183206106870228,0.42016806722689076,-162,138,0.5945222678547557,0.4054777321452443,away,CIN,over,10,0.5327102803738317,-114,0.5075272610403079,CHC,CIN,2023 REG,7,5,8,3,8,15,1,0,2,-2,1,1,1,0,0,0,0,0,0,0.5075272610403079,0.4924727389596921
90484,0.6183206106870228,0.42016806722689076,-162,138,0.5945222678547557,0.4054777321452443,home,CHC,under,10,0.5145631067961165,-106,0.4924727389596921,CHC,CIN,2023 REG,7,5,8,3,8,15,1,0,2,-2,1,1,1,0,0,0,0,0,0,0.5075272610403079,0.4924727389596921
90485,0.5370370370370371,0.504950495049505,-116,-102,0.514488177212783,0.48551182278721705,away,NYM,over,8.5,0.5433789954337899,-119,0.5184560714286826,CHC,NYM,2023 REG,8,7,6,2,9,14,1,0,5,-5,1,1,0,0,0,0,0,0,0,0.5184560714286826,0.48154392857131745
90485,0.5370370370370371,0.504950495049505,-116,-102,0.514488177212783,0.48551182278721705,home,CHC,under,8.5,0.5024875621890548,-101,0.48154392857131745,CHC,NYM,2023 REG,8,7,6,2,9,14,1,0,5,-5,1,1,0,0,0,0,0,0,0,0.5184560714286826,0.48154392857131745
90486,0.5,0.5348837209302326,100,-115,0.4825581395348837,0.5174418604651163,away,MIA,over,11.5,0.5,100,0.4772727272727273,COL,MIA,2023 REG,7,5,11,3,8,18,1,0,2,-2,1,1,1,0,0,0,0,0,0,0.4772727272727273,0.5227272727272727
90486,0.5,0.5348837209302326,100,-115,0.4825581395348837,0.5174418604651163,home,COL,under,11.5,0.5454545454545454,-120,0.5227272727272727,COL,MIA,2023 REG,7,5,11,3,8,18,1,0,2,-2,1,1,1,0,0,0,0,0,0,0.4772727272727273,0.5227272727272727
90487,0.5901639344262295,0.4484304932735426,-144,123,0.5673868951280033,0.43261310487199667,away,STL,over,10,0.5348837209302326,-115,0.5097020142727117,TEX,STL,2023 REG,11,4,6,3,7,17,1,0,1,-1,1,1,1,0,0,0,0,0,0,0.5097020142727117,0.49029798572728833
90487,0.5901639344262295,0.4484304932735426,-144,123,0.5673868951280033,0.43261310487199667,home,TEX,under,10,0.5121951219512195,-105,0.49029798572728833,TEX,STL,2023 REG,11,4,6,3,7,17,1,0,1,-1,1,1,1,0,0,0,0,0,0,0.5097020142727117,0.49029798572728833
90488,0.574468085106383,0.46511627906976744,-135,115,0.5517281312179562,0.44827186878204384,away,LAD,over,9,0.5348837209302326,-115,0.5097020142727117,STL,LAD,2023 REG,8,6,9,5,11,17,1,0,1,-1,1,1,1,1,1,0,0,0,0,0.5097020142727117,0.49029798572728833
90488,0.574468085106383,0.46511627906976744,-135,115,0.5517281312179562,0.44827186878204384,home,STL,under,9,0.5121951219512195,-105,0.49029798572728833,STL,LAD,2023 REG,8,6,9,5,11,17,1,0,1,-1,1,1,1,1,1,0,0,0,0,0.5097020142727117,0.49029798572728833
90489,0.4807692307692307,0.5575221238938054,108,-126,0.46235992564277106,0.5376400743572289,away,HOU,over,8.5,0.5215311004784688,-109,0.4978845547971712,BAL,HOU,2023 REG,8,6,10,7,13,18,0,1,-1,1,1,1,1,1,1,1,0,0,0,0.4978845547971712,0.5021154452028288
90489,0.4807692307692307,0.5575221238938054,108,-126,0.46235992564277106,0.5376400743572289,home,BAL,under,8.5,0.5238095238095238,-110,0.5021154452028288,BAL,HOU,2023 REG,8,6,10,7,13,18,0,1,-1,1,1,1,1,1,1,1,0,0,0,0.4978845547971712,0.5021154452028288
90490,0.4166666666666667,0.6168582375478928,140,-161,0.40269795657726687,0.5973020434227332,away,SF,over,11,0.5348837209302326,-115,0.5097020142727117,COL,SF,2023 REG,9,4,14,10,14,23,0,1,-6,6,1,1,1,1,0,0,0,0,0,0.5097020142727117,0.49029798572728833
90490,0.4166666666666667,0.6168582375478928,140,-161,0.40269795657726687,0.5973020434227332,home,COL,under,11,0.5121951219512195,-105,0.49029798572728833,COL,SF,2023 REG,9,4,14,10,14,23,0,1,-6,6,1,1,1,1,0,0,0,0,0,0.5097020142727117,0.49029798572728833
90491,0.6923076923076923,0.34965034965034963,-225,186,0.663259817105971,0.33674018289402896,away,NYM,over,10.5,0.5260663507109005,-111,0.5010269332605688,ATL,NYM,2023 REG,9,4,14,10,14,23,0,1,-6,6,1,1,1,1,0,0,0,0,0,0.5010269332605688,0.4989730667394312
90491,0.6923076923076923,0.34965034965034963,-225,186,0.663259817105971,0.33674018289402896,home,ATL,under,10.5,0.5215311004784688,-109,0.4989730667394312,ATL,NYM,2023 REG,9,4,14,10,14,23,0,1,-6,6,1,1,1,1,0,0,0,0,0,0.5010269332605688,0.4989730667394312
90492,0.7041420118343195,0.3389830508474576,-238,195,0.6737758434370918,0.32622415656290815,away,WSH,over,10.5,0.5169082125603864,-107,0.49353874091423283,CIN,WSH,2023 REG,4,3,12,7,10,16,0,1,-4,4,1,1,1,0,0,0,0,0,0,0.49353874091423283,0.5064612590857671
90492,0.7041420118343195,0.3389830508474576,-238,195,0.6737758434370918,0.32622415656290815,home,CIN,under,10.5,0.5283018867924528,-112,0.5064612590857671,CIN,WSH,2023 REG,4,3,12,7,10,16,0,1,-4,4,1,1,1,0,0,0,0,0,0,0.49353874091423283,0.5064612590857671
90493,0.5238095238095238,0.5192307692307692,-110,-108,0.5012646084074657,0.4987353915925343,away,TEX,over,8,0.5283018867924528,-112,0.5031902949311281,NYY,TEX,2023 REG,8,5,12,3,8,20,1,0,2,-2,1,1,1,0,0,0,0,0,0,0.5031902949311281,0.4968097050688719
90493,0.5238095238095238,0.5192307692307692,-110,-108,0.5012646084074657,0.4987353915925343,home,NYY,under,8,0.5192307692307692,-108,0.4968097050688719,NYY,TEX,2023 REG,8,5,12,3,8,20,1,0,2,-2,1,1,1,0,0,0,0,0,0,0.5031902949311281,0.4968097050688719
90494,0.5884773662551441,0.4484304932735426,-143,123,0.5667579262855877,0.43324207371441226,away,ARI,over,8.5,0.5121951219512195,-105,0.48808156828023186,STL,ARI,2023 REG,6,3,5,6,9,11,0,1,-3,3,1,1,1,0,0,0,0,0,0,0.48808156828023186,0.5119184317197681
90494,0.5884773662551441,0.4484304932735426,-143,123,0.5667579262855877,0.43324207371441226,home,STL,under,8.5,0.5348837209302326,-115,0.5119184317197681,STL,ARI,2023 REG,6,3,5,6,9,11,0,1,-3,3,1,1,1,0,0,0,0,0,0,0.48808156828023186,0.5119184317197681
90495,0.3802281368821293,0.6551724137931035,163,-190,0.36676785145428414,0.6332321485457159,away,NYM,over,9.5,0.5073891625615764,-103,0.4826927225525911,OAK,NYM,2023 REG,5,2,5,3,5,10,0,1,-1,1,1,1,0,0,0,0,0,0,0,0.4826927225525911,0.5173072774474089
90495,0.3802281368821293,0.6551724137931035,163,-190,0.36676785145428414,0.6332321485457159,home,OAK,under,9.5,0.5412844036697247,-118,0.5173072774474089,OAK,NYM,2023 REG,5,2,5,3,5,10,0,1,-1,1,1,1,0,0,0,0,0,0,0,0.4826927225525911,0.5173072774474089
90496,0.43103448275862066,0.6031746031746031,132,-152,0.4162891870977483,0.5837108129022517,away,MIN,over,8.5,0.5238095238095238,-110,0.5000596729920038,CLE,MIN,2023 REG,8,2,1,0,2,9,1,0,2,-2,0,0,0,0,0,0,0,0,0,0.5000596729920038,0.4999403270079962
90496,0.43103448275862066,0.6031746031746031,132,-152,0.4162891870977483,0.5837108129022517,home,CLE,under,8.5,0.5215311004784688,-109,0.4999403270079962,CLE,MIN,2023 REG,8,2,1,0,2,9,1,0,2,-2,0,0,0,0,0,0,0,0,0,0.5000596729920038,0.4999403270079962
90497,0.6503496503496503,0.38759689922480617,-186,158,0.6256711251019269,0.3743288748980731,away,NYY,over,7.5,0.5348837209302326,-115,0.5097020142727117,TB,NYY,2023 REG,9,2,8,3,5,17,0,1,-1,1,1,1,0,0,0,0,0,0,0,0.5097020142727117,0.49029798572728833
90497,0.6503496503496503,0.38759689922480617,-186,158,0.6256711251019269,0.3743288748980731,home,TB,under,7.5,0.5121951219512195,-105,0.49029798572728833,TB,NYY,2023 REG,9,2,8,3,5,17,0,1,-1,1,1,1,0,0,0,0,0,0,0,0.5097020142727117,0.49029798572728833
90498,0.37735849056603776,0.6666666666666666,165,-200,0.36074522368577194,0.639254776314228,away,SF,over,8.5,0.5073891625615764,-103,0.4826927225525911,OAK,SF,2023 REG,11,8,9,6,14,20,1,0,2,-2,1,1,1,1,1,1,0,0,0,0.4826927225525911,0.5173072774474089
90498,0.37735849056603776,0.6666666666666666,165,-200,0.36074522368577194,0.639254776314228,home,OAK,under,8.5,0.5412844036697247,-118,0.5173072774474089,OAK,SF,2023 REG,11,8,9,6,14,20,1,0,2,-2,1,1,1,1,1,1,0,0,0,0.4826927225525911,0.5173072774474089
90499,0.6453900709219857,0.39370078740157477,-182,154,0.6201612190961417,0.37983878090385825,away,CLE,over,7,0.5454545454545454,-120,0.5206611570247933,TB,CLE,2023 REG,8,2,15,9,11,23,0,1,-7,7,1,1,0,0,0,0,0,0,0,0.5206611570247933,0.4793388429752067
90499,0.6453900709219857,0.39370078740157477,-182,154,0.6201612190961417,0.37983878090385825,home,TB,under,7,0.5,100,0.4793388429752067,TB,CLE,2023 REG,8,2,15,9,11,23,0,1,-7,7,1,1,0,0,0,0,0,0,0,0.5206611570247933,0.4793388429752067
90500,0.5633187772925764,0.47619047619047616,-129,110,0.5410624729287608,0.45893752707123925,away,LAD,over,8.5,0.5,100,0.47935779816513757,SD,LAD,2023 REG,10,5,11,10,15,21,0,1,-5,5,1,1,1,1,1,0,0,0,0,0.47935779816513757,0.5206422018348624
90500,0.5633187772925764,0.47619047619047616,-129,110,0.5410624729287608,0.45893752707123925,home,SD,under,8.5,0.5412844036697247,-118,0.5206422018348624,SD,LAD,2023 REG,10,5,11,10,15,21,0,1,-5,5,1,1,1,1,1,0,0,0,0,0.47935779816513757,0.5206422018348624
90501,0.46511627906976744,0.5726495726495727,115,-134,0.4475507666421673,0.5524492333578327,away,PHI,over,11,0.5454545454545454,-120,0.5206611570247933,COL,PHI,2023 REG,10,3,7,6,9,17,0,1,-3,3,1,1,1,0,0,0,0,0,0,0.5206611570247933,0.4793388429752067
90501,0.46511627906976744,0.5726495726495727,115,-134,0.4475507666421673,0.5524492333578327,home,COL,under,11,0.5,100,0.4793388429752067,COL,PHI,2023 REG,10,3,7,6,9,17,0,1,-3,3,1,1,1,0,0,0,0,0,0,0.5206611570247933,0.4793388429752067
90502,0.5121951219512195,0.5348837209302326,-105,-115,0.48808156828023186,0.5119184317197681,away,CHC,over,9.5,0.5,100,0.4772727272727273,CWS,CHC,2023 REG,5,3,13,7,10,18,0,1,-4,4,1,1,1,0,0,0,0,0,0,0.4772727272727273,0.5227272727272727
90502,0.5121951219512195,0.5348837209302326,-105,-115,0.48808156828023186,0.5119184317197681,home,CWS,under,9.5,0.5454545454545454,-120,0.5227272727272727,CWS,CHC,2023 REG,5,3,13,7,10,18,0,1,-4,4,1,1,1,0,0,0,0,0,0,0.4772727272727273,0.5227272727272727
90503,0.5726495726495727,0.4672897196261683,-134,114,0.5497783539959433,0.4502216460040567,away,PIT,over,10,0.5098039215686274,-104,0.48483656587239576,MIN,PIT,2023 REG,5,2,2,0,2,7,1,0,2,-2,0,0,0,0,0,0,0,0,0,0.48483656587239576,0.5151634341276042
90503,0.5726495726495727,0.4672897196261683,-134,114,0.5497783539959433,0.4502216460040567,home,MIN,under,10,0.5391705069124424,-117,0.5151634341276042,MIN,PIT,2023 REG,5,2,2,0,2,7,1,0,2,-2,0,0,0,0,0,0,0,0,0,0.48483656587239576,0.5151634341276042
90504,0.6923076923076923,0.34965034965034963,-225,186,0.663259817105971,0.33674018289402896,away,PIT,over,7.5,0.5215311004784688,-109,0.4978845547971712,SEA,PIT,2023 REG,11,5,2,0,5,13,1,0,5,-5,0,0,0,0,0,0,0,0,0,0.4978845547971712,0.5021154452028288
90504,0.6923076923076923,0.34965034965034963,-225,186,0.663259817105971,0.33674018289402896,home,SEA,under,7.5,0.5238095238095238,-110,0.5021154452028288,SEA,PIT,2023 REG,11,5,2,0,5,13,1,0,5,-5,0,0,0,0,0,0,0,0,0,0.4978845547971712,0.5021154452028288
90505,0.5391705069124424,0.5024875621890548,-117,-101,0.5167097046779946,0.4832902953220054,away,BAL,over,8,0.5215311004784688,-109,0.49670754937970685,CLE,BAL,2023 REG,13,9,10,8,17,23,1,0,1,-1,1,1,1,1,1,1,1,1,0,0.49670754937970685,0.5032924506202932
90505,0.5391705069124424,0.5024875621890548,-117,-101,0.5167097046779946,0.4832902953220054,home,CLE,under,8,0.5260663507109005,-111,0.5032924506202932,CLE,BAL,2023 REG,13,9,10,8,17,23,1,0,1,-1,1,1,1,1,1,1,1,1,0,0.49670754937970685,0.5032924506202932
90506,0.5833333333333333,0.45454545454545453,-140,120,0.5612373737373737,0.4387626262626263,away,STL,over,9.5,0.5348837209302326,-115,0.5097020142727117,TEX,STL,2023 REG,12,6,7,4,10,19,1,0,2,-2,1,1,1,1,0,0,0,0,0,0.5097020142727117,0.49029798572728833
90506,0.5833333333333333,0.45454545454545453,-140,120,0.5612373737373737,0.4387626262626263,home,TEX,under,9.5,0.5121951219512195,-105,0.49029798572728833,TEX,STL,2023 REG,12,6,7,4,10,19,1,0,2,-2,1,1,1,1,0,0,0,0,0,0.5097020142727117,0.49029798572728833
90507,0.3921568627450981,0.6491228070175439,155,-185,0.37596875695582666,0.6240312430441733,away,BOS,over,10,0.5145631067961165,-106,0.49023796582517226,WSH,BOS,2023 REG,10,10,11,7,17,21,1,0,3,-3,1,1,1,1,1,1,1,0,0,0.49023796582517226,0.5097620341748277
90507,0.3921568627450981,0.6491228070175439,155,-185,0.37596875695582666,0.6240312430441733,home,WSH,under,10,0.5327102803738317,-114,0.5097620341748277,WSH,BOS,2023 REG,10,10,11,7,17,21,1,0,3,-3,1,1,1,1,1,1,1,0,0,0.49023796582517226,0.5097620341748277
90508,0.3389830508474576,0.7014925373134329,195,-235,0.3252625124878337,0.6747374875121663,away,ATL,over,9.5,0.5121951219512195,-105,0.48808156828023186,OAK,ATL,2023 REG,3,2,7,4,6,10,0,1,-2,2,1,1,0,0,0,0,0,0,0,0.48808156828023186,0.5119184317197681
90508,0.3389830508474576,0.7014925373134329,195,-235,0.3252625124878337,0.6747374875121663,home,OAK,under,9.5,0.5348837209302326,-115,0.5119184317197681,OAK,ATL,2023 REG,3,2,7,4,6,10,0,1,-2,2,1,1,0,0,0,0,0,0,0,0.48808156828023186,0.5119184317197681
90509,0.5348837209302326,0.5024875621890548,-115,-101,0.514894429959451,0.485105570040549,away,DET,over,8.5,0.5348837209302326,-115,0.5109810284308424,KC,DET,2023 REG,9,4,10,6,10,19,0,1,-2,2,1,1,1,1,0,0,0,0,0,0.5109810284308424,0.48901897156915763
90509,0.5348837209302326,0.5024875621890548,-115,-101,0.514894429959451,0.485105570040549,home,KC,under,8.5,0.5098039215686274,-104,0.48901897156915763,KC,DET,2023 REG,9,4,10,6,10,19,0,1,-2,2,1,1,1,1,0,0,0,0,0,0.5109810284308424,0.48901897156915763
90510,0.5412844036697247,0.49751243781094534,-118,101,0.5202842784645914,0.47971572153540865,away,HOU,over,10,0.5215311004784688,-109,0.4978845547971712,TOR,HOU,2023 REG,12,4,19,11,15,31,0,1,-7,7,1,1,1,1,0,0,0,0,0,0.4978845547971712,0.5021154452028288
90510,0.5412844036697247,0.49751243781094534,-118,101,0.5202842784645914,0.47971572153540865,home,TOR,under,10,0.5238095238095238,-110,0.5021154452028288,TOR,HOU,2023 REG,12,4,19,11,15,31,0,1,-7,7,1,1,1,1,0,0,0,0,0,0.4978845547971712,0.5021154452028288
90511,0.613899613899614,0.4166666666666667,-159,140,0.595134986061627,0.40486501393837304,away,CWS,over,9,0.5121951219512195,-105,0.48919479393107135,TOR,CWS,2023 REG,8,5,3,2,7,11,1,0,3,-3,1,1,0,0,0,0,0,0,0,0.48919479393107135,0.5108052060689287
90511,0.613899613899614,0.4166666666666667,-159,140,0.595134986061627,0.40486501393837304,home,TOR,under,9,0.5327102803738317,-114,0.5108052060689287,TOR,CWS,2023 REG,8,5,3,2,7,11,1,0,3,-3,1,1,0,0,0,0,0,0,0,0.48919479393107135,0.5108052060689287
90512,0.6226415094339623,0.41152263374485604,-165,143,0.6013694957565848,0.3986305042434152,away,PHI,over,8.5,0.5391705069124424,-117,0.5127649394825569,LAD,PHI,2023 REG,15,13,9,4,17,24,1,0,9,-9,1,1,1,1,0,0,0,0,0,0.5127649394825569,0.48723506051744314
90512,0.6226415094339623,0.41152263374485604,-165,143,0.6013694957565848,0.3986305042434152,home,LAD,under,8.5,0.5098039215686274,-104,0.48723506051744314,LAD,PHI,2023 REG,15,13,9,4,17,24,1,0,9,-9,1,1,1,1,0,0,0,0,0,0.5127649394825569,0.48723506051744314
90513,0.7333333333333333,0.3076923076923077,-275,225,0.7032478632478633,0.29675213675213674,away,PIT,over,8.5,0.5,100,0.4772727272727273,SD,PIT,2023 REG,6,4,13,8,12,19,0,1,-4,4,1,1,1,1,0,0,0,0,0,0.4772727272727273,0.5227272727272727
90513,0.7333333333333333,0.3076923076923077,-275,225,0.7032478632478633,0.29675213675213674,home,SD,under,8.5,0.5454545454545454,-120,0.5227272727272727,SD,PIT,2023 REG,6,4,13,8,12,19,0,1,-4,4,1,1,1,1,0,0,0,0,0,0.4772727272727273,0.5227272727272727
90514,0.5327102803738317,0.5098039215686274,-114,-104,0.5100625279371946,0.48993747206280536,away,SF,over,7.5,0.504950495049505,-102,0.4826715732667395,MIL,SF,2023 REG,5,1,6,3,4,11,0,1,-2,2,1,0,0,0,0,0,0,0,0,0.4826715732667395,0.5173284267332605
90514,0.5327102803738317,0.5098039215686274,-114,-104,0.5100625279371946,0.48993747206280536,home,MIL,under,7.5,0.5391705069124424,-117,0.5173284267332605,MIL,SF,2023 REG,5,1,6,3,4,11,0,1,-2,2,1,0,0,0,0,0,0,0,0,0.4826715732667395,0.5173284267332605
90515,0.4484304932735426,0.5884773662551441,123,-143,0.43187988361942303,0.5681201163805769,away,TB,over,8.5,0.5145631067961165,-106,0.4913668392989033,LAA,TB,2023 REG,9,7,8,6,13,17,1,0,1,-1,1,1,1,1,1,1,0,0,0,0.4913668392989033,0.5086331607010968
90515,0.4484304932735426,0.5884773662551441,123,-143,0.43187988361942303,0.5681201163805769,home,LAA,under,8.5,0.5305164319248826,-113,0.5086331607010968,LAA,TB,2023 REG,9,7,8,6,13,17,1,0,1,-1,1,1,1,1,1,1,0,0,0,0.4913668392989033,0.5086331607010968
90516,0.6551724137931035,0.3846153846153846,-190,160,0.6291045458703008,0.37089545412969915,away,CIN,over,8.5,0.5305164319248826,-113,0.5053568787472517,ATL,CIN,2023 REG,10,5,12,4,9,22,1,0,1,-1,1,1,1,1,0,0,0,0,0,0.5053568787472517,0.49464312125274834
90516,0.6551724137931035,0.3846153846153846,-190,160,0.6291045458703008,0.37089545412969915,home,ATL,under,8.5,0.5169082125603864,-107,0.49464312125274834,ATL,CIN,2023 REG,10,5,12,4,9,22,1,0,1,-1,1,1,1,1,0,0,0,0,0,0.5053568787472517,0.49464312125274834
90517,0.5555555555555556,0.4854368932038835,-125,106,0.5327819729114227,0.4672180270885773,away,CIN,over,9,0.5391705069124424,-117,0.5140669063204599,PIT,CIN,2023 REG,3,4,7,2,6,10,1,0,2,-2,1,1,0,0,0,0,0,0,0,0.5140669063204599,0.4859330936795401
90517,0.5555555555555556,0.4854368932038835,-125,106,0.5327819729114227,0.4672180270885773,home,PIT,under,9,0.5073891625615764,-103,0.4859330936795401,PIT,CIN,2023 REG,3,4,7,2,6,10,1,0,2,-2,1,1,0,0,0,0,0,0,0,0.5140669063204599,0.4859330936795401
90518,0.6666666666666666,0.37037037037037035,-200,170,0.6419753086419753,0.3580246913580247,away,NYM,over,8.5,0.5305164319248826,-113,0.5066009958897986,BAL,NYM,2023 REG,6,2,4,0,2,10,1,0,2,-2,0,0,0,0,0,0,0,0,0,0.5066009958897986,0.49339900411020143
90518,0.6666666666666666,0.37037037037037035,-200,170,0.6419753086419753,0.3580246913580247,home,BAL,under,8.5,0.5145631067961165,-106,0.49339900411020143,BAL,NYM,2023 REG,6,2,4,0,2,10,1,0,2,-2,0,0,0,0,0,0,0,0,0,0.5066009958897986,0.49339900411020143
90519,0.4016064257028112,0.6363636363636364,149,-175,0.3863574047925913,0.6136425952074087,away,SF,over,12,0.5215311004784688,-109,0.4978845547971712,COL,SF,2023 REG,9,4,9,6,10,18,0,1,-2,2,1,1,1,1,0,0,0,0,0,0.4978845547971712,0.5021154452028288
90519,0.4016064257028112,0.6363636363636364,149,-175,0.3863574047925913,0.6136425952074087,home,COL,under,12,0.5238095238095238,-110,0.5021154452028288,COL,SF,2023 REG,9,4,9,6,10,18,0,1,-2,2,1,1,1,1,0,0,0,0,0,0.4978845547971712,0.5021154452028288
90520,0.43103448275862066,0.609375,132,-156,0.41361660225921526,0.5863833977407847,away,NYY,over,9.5,0.5073891625615764,-103,0.4816299493915137,KC,NYY,2023 REG,15,12,8,5,17,23,1,0,7,-7,1,1,1,1,1,0,0,0,0,0.4816299493915137,0.5183700506084863
90520,0.43103448275862066,0.609375,132,-156,0.41361660225921526,0.5863833977407847,home,KC,under,9.5,0.5433789954337899,-119,0.5183700506084863,KC,NYY,2023 REG,15,12,8,5,17,23,1,0,7,-7,1,1,1,1,1,0,0,0,0,0.4816299493915137,0.5183700506084863
90521,0.613899613899614,0.425531914893617,-159,135,0.589692613597978,0.410307386402022,away,TEX,over,7.5,0.49751243781094534,101,0.476135829221149,SEA,TEX,2023 REG,6,5,7,0,5,13,1,0,5,-5,0,0,0,0,0,0,0,0,0,0.476135829221149,0.523864170778851
90521,0.613899613899614,0.425531914893617,-159,135,0.589692613597978,0.410307386402022,home,SEA,under,7.5,0.5454545454545454,-120,0.523864170778851,SEA,TEX,2023 REG,6,5,7,0,5,13,1,0,5,-5,0,0,0,0,0,0,0,0,0,0.476135829221149,0.523864170778851
90522,0.7014925373134329,0.3389830508474576,-235,195,0.6730992142751963,0.32690078572480374,away,COL,over,8.5,0.5098039215686274,-104,0.48592421718142587,SF,COL,2023 REG,11,5,9,3,8,20,1,0,2,-2,1,1,1,0,0,0,0,0,0,0.48592421718142587,0.5140757828185741
90522,0.7014925373134329,0.3389830508474576,-235,195,0.6730992142751963,0.32690078572480374,home,SF,under,8.5,0.5370370370370371,-116,0.5140757828185741,SF,COL,2023 REG,11,5,9,3,8,20,1,0,2,-2,1,1,1,0,0,0,0,0,0,0.48592421718142587,0.5140757828185741
90523,0.5833333333333333,0.4504504504504505,-140,122,0.5636261261261261,0.43637387387387394,away,TOR,over,9.5,0.49751243781094534,101,0.476135829221149,LAA,TOR,2023 REG,4,3,9,4,7,13,0,1,-1,1,1,1,1,0,0,0,0,0,0,0.476135829221149,0.523864170778851
90523,0.5833333333333333,0.4504504504504505,-140,122,0.5636261261261261,0.43637387387387394,home,LAA,under,9.5,0.5454545454545454,-120,0.523864170778851,LAA,TOR,2023 REG,4,3,9,4,7,13,0,1,-1,1,1,1,1,0,0,0,0,0,0,0.476135829221149,0.523864170778851
90524,0.4807692307692307,0.5555555555555556,108,-125,0.4633053911900066,0.5366946088099934,away,LAA,over,8.5,0.5121951219512195,-105,0.48808156828023186,DET,LAA,2023 REG,1,0,11,6,6,12,0,1,-6,6,0,0,0,0,0,0,0,0,0,0.48808156828023186,0.5119184317197681
90524,0.4807692307692307,0.5555555555555556,108,-125,0.4633053911900066,0.5366946088099934,home,DET,under,8.5,0.5348837209302326,-115,0.5119184317197681,DET,LAA,2023 REG,1,0,11,6,6,12,0,1,-6,6,0,0,0,0,0,0,0,0,0,0.48808156828023186,0.5119184317197681
90525,0.4854368932038835,0.5535714285714286,106,-124,0.4665008146721786,0.5334991853278215,away,TOR,over,8.5,0.5348837209302326,-115,0.5097020142727117,NYM,TOR,2023 REG,6,1,10,2,3,16,0,1,-1,1,1,0,0,0,0,0,0,0,0,0.5097020142727117,0.49029798572728833
90525,0.4854368932038835,0.5535714285714286,106,-124,0.4665008146721786,0.5334991853278215,home,NYM,under,8.5,0.5121951219512195,-105,0.49029798572728833,NYM,TOR,2023 REG,6,1,10,2,3,16,0,1,-1,1,1,0,0,0,0,0,0,0,0,0.5097020142727117,0.49029798572728833
90526,0.5,0.5348837209302326,100,-115,0.4825581395348837,0.5174418604651163,away,NYY,over,7.5,0.5,100,0.4772727272727273,TB,NYY,2023 REG,10,8,11,7,15,21,1,0,1,-1,1,1,1,1,1,1,1,0,0,0.4772727272727273,0.5227272727272727
90526,0.5,0.5348837209302326,100,-115,0.4825581395348837,0.5174418604651163,home,TB,under,7.5,0.5454545454545454,-120,0.5227272727272727,TB,NYY,2023 REG,10,8,11,7,15,21,1,0,1,-1,1,1,1,1,1,1,1,0,0,0.4772727272727273,0.5227272727272727
90527,0.6363636363636364,0.4,-175,150,0.6132231404958678,0.3867768595041322,away,NYY,over,8,0.5327102803738317,-114,0.508788710910954,TOR,NYY,2023 REG,9,3,9,6,9,18,0,1,-3,3,1,1,1,0,0,0,0,0,0,0.508788710910954,0.491211289089046
90527,0.6363636363636364,0.4,-175,150,0.6132231404958678,0.3867768595041322,home,TOR,under,8,0.5121951219512195,-105,0.491211289089046,TOR,NYY,2023 REG,9,3,9,6,9,18,0,1,-3,3,1,1,1,0,0,0,0,0,0,0.508788710910954,0.491211289089046
90528,0.3921568627450981,0.6503496503496503,155,-186,0.3754876419236281,0.6245123580763718,away,MIN,over,9,0.5348837209302326,-115,0.5097020142727117,CWS,MIN,2023 REG,6,2,10,10,12,16,0,1,-8,8,1,1,0,0,0,0,0,0,0,0.5097020142727117,0.49029798572728833
90528,0.3921568627450981,0.6503496503496503,155,-186,0.3754876419236281,0.6245123580763718,home,CWS,under,9,0.5121951219512195,-105,0.49029798572728833,CWS,MIN,2023 REG,6,2,10,10,12,16,0,1,-8,8,1,1,0,0,0,0,0,0,0,0.5097020142727117,0.49029798572728833
90529,0.5238095238095238,0.5145631067961165,-110,-106,0.5037095744446646,0.4962904255553354,away,CIN,over,8.5,0.5,100,0.4772727272727273,KC,CIN,2023 REG,8,4,10,5,9,18,0,1,-1,1,1,1,1,1,0,0,0,0,0,0.4772727272727273,0.5227272727272727
90529,0.5238095238095238,0.5145631067961165,-110,-106,0.5037095744446646,0.4962904255553354,home,KC,under,8.5,0.5454545454545454,-120,0.5227272727272727,KC,CIN,2023 REG,8,4,10,5,9,18,0,1,-1,1,1,1,1,1,0,0,0,0,0,0.4772727272727273,0.5227272727272727
90530,0.6610169491525424,0.3802281368821293,-195,163,0.6337532482143695,0.3662467517856305,away,KC,over,9,0.5121951219512195,-105,0.48808156828023186,MIN,KC,2023 REG,10,9,5,3,12,15,1,0,6,-6,1,1,1,0,0,0,0,0,0,0.48808156828023186,0.5119184317197681
90530,0.6610169491525424,0.3802281368821293,-195,163,0.6337532482143695,0.3662467517856305,home,MIN,under,9,0.5348837209302326,-115,0.5119184317197681,MIN,KC,2023 REG,10,9,5,3,12,15,1,0,6,-6,1,1,1,0,0,0,0,0,0,0.48808156828023186,0.5119184317197681
90531,0.425531914893617,0.6153846153846154,135,-160,0.4081206254135181,0.5918793745864819,away,ATL,over,10.5,0.5121951219512195,-105,0.48808156828023186,MIL,ATL,2023 REG,7,2,7,4,6,14,0,1,-2,2,1,1,0,0,0,0,0,0,0,0.48808156828023186,0.5119184317197681
90531,0.425531914893617,0.6153846153846154,135,-160,0.4081206254135181,0.5918793745864819,home,MIL,under,10.5,0.5348837209302326,-115,0.5119184317197681,MIL,ATL,2023 REG,7,2,7,4,6,14,0,1,-2,2,1,1,0,0,0,0,0,0,0,0.48808156828023186,0.5119184317197681
90532,0.6402877697841727,0.4,-178,150,0.6144920035194866,0.38550799648051337,away,LAA,over,9.5,0.5283018867924528,-112,0.5044173060022736,ATL,LAA,2023 REG,12,12,8,5,17,20,1,0,7,-7,1,1,1,1,1,0,0,0,0,0.5044173060022736,0.49558269399772636
90532,0.6402877697841727,0.4,-178,150,0.6144920035194866,0.38550799648051337,home,ATL,under,9.5,0.5169082125603864,-107,0.49558269399772636,ATL,LAA,2023 REG,12,12,8,5,17,20,1,0,7,-7,1,1,1,1,1,0,0,0,0,0.5044173060022736,0.49558269399772636
90533,0.5,0.5348837209302326,100,-115,0.4825581395348837,0.5174418604651163,away,HOU,over,8,0.5238095238095238,-110,0.5000596729920038,MIN,HOU,2023 REG,2,1,11,5,6,13,0,1,-4,4,1,0,0,0,0,0,0,0,0,0.5000596729920038,0.4999403270079962
90533,0.5,0.5348837209302326,100,-115,0.4825581395348837,0.5174418604651163,home,MIN,under,8,0.5215311004784688,-109,0.4999403270079962,MIN,HOU,2023 REG,2,1,11,5,6,13,0,1,-4,4,1,0,0,0,0,0,0,0,0,0.5000596729920038,0.4999403270079962
90534,0.6226415094339623,0.41152263374485604,-165,143,0.6013694957565848,0.3986305042434152,away,SF,over,8.5,0.5348837209302326,-115,0.5097020142727117,LAD,SF,2023 REG,6,0,16,15,15,22,0,1,-15,15,0,0,0,0,0,0,0,0,0,0.5097020142727117,0.49029798572728833
90534,0.6226415094339623,0.41152263374485604,-165,143,0.6013694957565848,0.3986305042434152,home,LAD,under,8.5,0.5121951219512195,-105,0.49029798572728833,LAD,SF,2023 REG,6,0,16,15,15,22,0,1,-15,15,0,0,0,0,0,0,0,0,0,0.5097020142727117,0.49029798572728833
90535,0.5798319327731092,0.45454545454545453,-138,120,0.5598988258404966,0.44010117415950345,away,CLE,over,9,0.5305164319248826,-113,0.5066009958897986,BAL,CLE,2023 REG,11,8,11,5,13,22,1,0,3,-3,1,1,1,1,1,0,0,0,0,0.5066009958897986,0.49339900411020143
90535,0.5798319327731092,0.45454545454545453,-138,120,0.5598988258404966,0.44010117415950345,home,BAL,under,9,0.5145631067961165,-106,0.49339900411020143,BAL,CLE,2023 REG,11,8,11,5,13,22,1,0,3,-3,1,1,1,1,1,0,0,0,0,0.5066009958897986,0.49339900411020143
90536,0.574468085106383,0.46511627906976744,-135,115,0.5517281312179562,0.44827186878204384,away,MIN,over,8.5,0.5412844036697247,-118,0.5162581740877563,LAD,MIN,2023 REG,9,7,8,3,10,17,1,0,4,-4,1,1,1,0,0,0,0,0,0,0.5162581740877563,0.4837418259122437
90536,0.574468085106383,0.46511627906976744,-135,115,0.5517281312179562,0.44827186878204384,home,LAD,under,8.5,0.504950495049505,-102,0.4837418259122437,LAD,MIN,2023 REG,9,7,8,3,10,17,1,0,4,-4,1,1,1,0,0,0,0,0,0,0.5162581740877563,0.4837418259122437
90537,0.31746031746031744,0.7222222222222222,215,-260,0.3048626858150668,0.6951373141849332,away,TEX,over,7.5,0.5305164319248826,-113,0.5066009958897986,OAK,TEX,2023 REG,3,1,13,6,7,16,0,1,-5,5,1,0,0,0,0,0,0,0,0,0.5066009958897986,0.49339900411020143
90537,0.31746031746031744,0.7222222222222222,215,-260,0.3048626858150668,0.6951373141849332,home,OAK,under,7.5,0.5145631067961165,-106,0.49339900411020143,OAK,TEX,2023 REG,3,1,13,6,7,16,0,1,-5,5,1,0,0,0,0,0,0,0,0,0.5066009958897986,0.49339900411020143
90538,0.726027397260274,0.3125,-265,220,0.6980554513041847,0.30194454869581533,away,COL,over,7.5,0.5283018867924528,-112,0.5044173060022736,LAD,COL,2023 REG,7,5,7,2,7,14,1,0,3,-3,1,1,0,0,0,0,0,0,0,0.5044173060022736,0.49558269399772636
90538,0.726027397260274,0.3125,-265,220,0.6980554513041847,0.30194454869581533,home,LAD,under,7.5,0.5169082125603864,-107,0.49558269399772636,LAD,COL,2023 REG,7,5,7,2,7,14,1,0,3,-3,1,1,0,0,0,0,0,0,0,0.5044173060022736,0.49558269399772636
90539,0.37037037037037035,0.6666666666666666,170,-200,0.35665294924554186,0.6433470507544581,away,BOS,over,10,0.5121951219512195,-105,0.48808156828023186,KC,BOS,2023 REG,17,13,5,2,15,22,1,0,11,-11,1,1,0,0,0,0,0,0,0,0.48808156828023186,0.5119184317197681
90539,0.37037037037037035,0.6666666666666666,170,-200,0.35665294924554186,0.6433470507544581,home,KC,under,10,0.5348837209302326,-115,0.5119184317197681,KC,BOS,2023 REG,17,13,5,2,15,22,1,0,11,-11,1,1,0,0,0,0,0,0,0,0.48808156828023186,0.5119184317197681
90540,0.4608294930875576,0.5780590717299579,117,-137,0.44290849547579936,0.5570915045242006,away,TEX,over,8.5,0.5433789954337899,-119,0.5171177654451503,NYM,TEX,2023 REG,7,1,6,2,3,13,0,1,-1,1,1,0,0,0,0,0,0,0,0,0.5171177654451503,0.4828822345548497
90540,0.4608294930875576,0.5780590717299579,117,-137,0.44290849547579936,0.5570915045242006,home,NYM,under,8.5,0.504950495049505,-102,0.4828822345548497,NYM,TEX,2023 REG,7,1,6,2,3,13,0,1,-1,1,1,0,0,0,0,0,0,0,0,0.5171177654451503,0.4828822345548497
90541,0.5283018867924528,0.5121951219512195,-112,-105,0.5069072406637203,0.4930927593362797,away,CHC,over,10,0.5121951219512195,-105,0.48808156828023186,STL,CHC,2023 REG,5,1,10,5,6,15,0,1,-4,4,1,0,0,0,0,0,0,0,0,0.48808156828023186,0.5119184317197681
90541,0.5283018867924528,0.5121951219512195,-112,-105,0.5069072406637203,0.4930927593362797,home,STL,under,10,0.5348837209302326,-115,0.5119184317197681,STL,CHC,2023 REG,5,1,10,5,6,15,0,1,-4,4,1,0,0,0,0,0,0,0,0,0.48808156828023186,0.5119184317197681
90542,0.3508771929824561,0.6923076923076923,185,-225,0.3357246016525795,0.6642753983474206,away,ATL,over,10.5,0.5391705069124424,-117,0.5127649394825569,NYM,ATL,2023 REG,6,3,22,21,24,28,0,1,-18,18,1,1,1,0,0,0,0,0,0,0.5127649394825569,0.48723506051744314
90542,0.3508771929824561,0.6923076923076923,185,-225,0.3357246016525795,0.6642753983474206,home,NYM,under,10.5,0.5098039215686274,-104,0.48723506051744314,NYM,ATL,2023 REG,6,3,22,21,24,28,0,1,-18,18,1,1,1,0,0,0,0,0,0,0.5127649394825569,0.48723506051744314
90543,0.5305164319248826,0.5098039215686274,-113,-104,0.5091258218555558,0.49087417814444423,away,PIT,over,8.5,0.5283018867924528,-112,0.5031902949311281,STL,PIT,2023 REG,6,2,7,4,6,13,0,1,-2,2,1,1,0,0,0,0,0,0,0,0.5031902949311281,0.4968097050688719
90543,0.5305164319248826,0.5098039215686274,-113,-104,0.5091258218555558,0.49087417814444423,home,STL,under,8.5,0.5192307692307692,-108,0.4968097050688719,STL,PIT,2023 REG,6,2,7,4,6,13,0,1,-2,2,1,1,0,0,0,0,0,0,0,0.5031902949311281,0.4968097050688719
90544,0.5,0.5412844036697247,100,-118,0.47935779816513757,0.5206422018348624,away,CHC,over,9,0.5348837209302326,-115,0.5097020142727117,PIT,CHC,2023 REG,7,2,5,1,3,12,1,0,1,-1,1,0,0,0,0,0,0,0,0,0.5097020142727117,0.49029798572728833
90544,0.5,0.5412844036697247,100,-118,0.47935779816513757,0.5206422018348624,home,PIT,under,9,0.5121951219512195,-105,0.49029798572728833,PIT,CHC,2023 REG,7,2,5,1,3,12,1,0,1,-1,1,0,0,0,0,0,0,0,0,0.5097020142727117,0.49029798572728833
90545,0.7333333333333333,0.30959752321981426,-275,223,0.7018507051943583,0.2981492948056417,away,OAK,over,8,0.5327102803738317,-114,0.5075272610403079,MIN,OAK,2023 REG,4,1,4,2,3,8,0,1,-1,1,1,0,0,0,0,0,0,0,0,0.5075272610403079,0.4924727389596921
90545,0.7333333333333333,0.30959752321981426,-275,223,0.7018507051943583,0.2981492948056417,home,MIN,under,8,0.5145631067961165,-106,0.4924727389596921,MIN,OAK,2023 REG,4,1,4,2,3,8,0,1,-1,1,1,0,0,0,0,0,0,0,0,0.5075272610403079,0.4924727389596921
90546,0.3846153846153846,0.6551724137931035,160,-190,0.3693123852275045,0.6306876147724956,away,SEA,over,8,0.5098039215686274,-104,0.4870219861770517,OAK,SEA,2023 REG,6,2,11,7,9,17,0,1,-5,5,1,1,0,0,0,0,0,0,0,0.4870219861770517,0.5129780138229483
90546,0.3846153846153846,0.6551724137931035,160,-190,0.3693123852275045,0.6306876147724956,home,OAK,under,8,0.5348837209302326,-115,0.5129780138229483,OAK,SEA,2023 REG,6,2,11,7,9,17,0,1,-5,5,1,1,0,0,0,0,0,0,0,0.4870219861770517,0.5129780138229483
90547,0.6610169491525424,0.37735849056603776,-195,165,0.6356501330673793,0.3643498669326207,away,OAK,over,9,0.5412844036697247,-118,0.5149381613977361,BAL,OAK,2023 REG,8,4,15,8,12,23,0,1,-4,4,1,1,1,1,0,0,0,0,0,0.5149381613977361,0.48506183860226393
90547,0.6610169491525424,0.37735849056603776,-195,165,0.6356501330673793,0.3643498669326207,home,BAL,under,9,0.5073891625615764,-103,0.48506183860226393,BAL,OAK,2023 REG,8,4,15,8,12,23,0,1,-4,4,1,1,1,1,0,0,0,0,0,0.5149381613977361,0.48506183860226393
90548,0.48780487804878053,0.5555555555555556,105,-125,0.4666534470222751,0.5333465529777248,away,TB,over,8.5,0.5454545454545454,-120,0.5206611570247933,MIN,TB,2023 REG,5,4,9,5,9,14,0,1,-1,1,1,1,1,1,0,0,0,0,0,0.5206611570247933,0.4793388429752067
90548,0.48780487804878053,0.5555555555555556,105,-125,0.4666534470222751,0.5333465529777248,home,MIN,under,8.5,0.5,100,0.4793388429752067,MIN,TB,2023 REG,5,4,9,5,9,14,0,1,-1,1,1,1,1,1,0,0,0,0,0,0.5206611570247933,0.4793388429752067
90549,0.5652173913043479,0.47619047619047616,-130,110,0.5418129444594474,0.4581870555405526,away,SEA,over,7.5,0.5348837209302326,-115,0.5097020142727117,SD,SEA,2023 REG,4,1,8,4,5,12,0,1,-3,3,1,0,0,0,0,0,0,0,0,0.5097020142727117,0.49029798572728833
90549,0.5652173913043479,0.47619047619047616,-130,110,0.5418129444594474,0.4581870555405526,home,SD,under,7.5,0.5121951219512195,-105,0.49029798572728833,SD,SEA,2023 REG,4,1,8,4,5,12,0,1,-3,3,1,0,0,0,0,0,0,0,0,0.5097020142727117,0.49029798572728833
90550,0.574468085106383,0.4629629629629629,-135,116,0.5529651425984609,0.44703485740153914,away,HOU,over,7,0.5073891625615764,-103,0.48057683780462784,SEA,HOU,2023 REG,8,4,7,6,10,15,0,1,-2,2,1,1,1,1,0,0,0,0,0,0.48057683780462784,0.5194231621953722
90550,0.574468085106383,0.4629629629629629,-135,116,0.5529651425984609,0.44703485740153914,home,SEA,under,7,0.5454545454545454,-120,0.5194231621953722,SEA,HOU,2023 REG,8,4,7,6,10,15,0,1,-2,2,1,1,1,1,0,0,0,0,0,0.48057683780462784,0.5194231621953722
90551,0.6108949416342413,0.42372881355932196,-157,136,0.5897434647261112,0.41025653527388883,away,BOS,over,9,0.5454545454545454,-120,0.5193043049216726,PHI,BOS,2023 REG,10,4,10,7,11,20,0,1,-3,3,1,1,1,1,0,0,0,0,0,0.5193043049216726,0.48069569507832743
90551,0.6108949416342413,0.42372881355932196,-157,136,0.5897434647261112,0.41025653527388883,home,PHI,under,9,0.5024875621890548,-101,0.48069569507832743,PHI,BOS,2023 REG,10,4,10,7,11,20,0,1,-3,3,1,1,1,1,0,0,0,0,0,0.5193043049216726,0.48069569507832743
90552,0.5614035087719298,0.47846889952153115,-128,109,0.5390189988527938,0.4609810011472062,away,MIL,over,9,0.5,100,0.4772727272727273,CHC,MIL,2023 REG,5,2,10,6,8,15,0,1,-4,4,1,1,0,0,0,0,0,0,0,0.4772727272727273,0.5227272727272727
90552,0.5614035087719298,0.47846889952153115,-128,109,0.5390189988527938,0.4609810011472062,home,CHC,under,9,0.5454545454545454,-120,0.5227272727272727,CHC,MIL,2023 REG,5,2,10,6,8,15,0,1,-4,4,1,1,0,0,0,0,0,0,0,0.4772727272727273,0.5227272727272727
90553,0.5121951219512195,0.5305164319248826,-105,-113,0.4903184724049234,0.5096815275950766,away,NYM,over,8.5,0.5348837209302326,-115,0.5097020142727117,STL,NYM,2023 REG,5,2,13,13,15,18,0,1,-11,11,1,1,0,0,0,0,0,0,0,0.5097020142727117,0.49029798572728833
90553,0.5121951219512195,0.5305164319248826,-105,-113,0.4903184724049234,0.5096815275950766,home,STL,under,8.5,0.5121951219512195,-105,0.49029798572728833,STL,NYM,2023 REG,5,2,13,13,15,18,0,1,-11,11,1,1,0,0,0,0,0,0,0,0.5097020142727117,0.49029798572728833
90554,0.601593625498008,0.43859649122807015,-151,128,0.5774155074675785,0.4225844925324215,away,SD,over,8.5,0.5348837209302326,-115,0.5097020142727117,PHI,SD,2023 REG,10,7,7,6,13,17,1,0,1,-1,1,1,1,1,1,1,0,0,0,0.5097020142727117,0.49029798572728833
90554,0.601593625498008,0.43859649122807015,-151,128,0.5774155074675785,0.4225844925324215,home,PHI,under,8.5,0.5121951219512195,-105,0.49029798572728833,PHI,SD,2023 REG,10,7,7,6,13,17,1,0,1,-1,1,1,1,1,1,1,0,0,0,0.5097020142727117,0.49029798572728833
90555,0.425531914893617,0.613899613899614,135,-159,0.40875254093905067,0.5912474590609493,away,TB,over,8.5,0.5238095238095238,-110,0.5000596729920038,BOS,TB,2023 REG,5,2,10,4,6,15,0,1,-2,2,1,1,0,0,0,0,0,0,0,0.5000596729920038,0.4999403270079962
90555,0.425531914893617,0.613899613899614,135,-159,0.40875254093905067,0.5912474590609493,home,BOS,under,8.5,0.5215311004784688,-109,0.4999403270079962,BOS,TB,2023 REG,5,2,10,4,6,15,0,1,-2,2,1,1,0,0,0,0,0,0,0,0.5000596729920038,0.4999403270079962
90556,0.4,0.6389891696750902,150,-177,0.3844043321299639,0.6155956678700361,away,TB,over,8,0.5121951219512195,-105,0.48808156828023186,CLE,TB,2023 REG,8,3,5,2,5,13,1,0,1,-1,1,1,0,0,0,0,0,0,0,0.48808156828023186,0.5119184317197681
90556,0.4,0.6389891696750902,150,-177,0.3844043321299639,0.6155956678700361,home,CLE,under,8,0.5348837209302326,-115,0.5119184317197681,CLE,TB,2023 REG,8,3,5,2,5,13,1,0,1,-1,1,1,0,0,0,0,0,0,0,0.48808156828023186,0.5119184317197681
90557,0.4347826086956522,0.6000000000000001,130,-150,0.4196597353497164,0.5803402646502835,away,BAL,over,8,0.5238095238095238,-110,0.5000596729920038,DET,BAL,2023 REG,8,4,9,7,11,17,0,1,-3,3,1,1,1,1,0,0,0,0,0,0.5000596729920038,0.4999403270079962
90557,0.4347826086956522,0.6000000000000001,130,-150,0.4196597353497164,0.5803402646502835,home,DET,under,8,0.5215311004784688,-109,0.4999403270079962,DET,BAL,2023 REG,8,4,9,7,11,17,0,1,-3,3,1,1,1,1,0,0,0,0,0,0.5000596729920038,0.4999403270079962
90558,0.35211267605633806,0.6923076923076923,184,-225,0.33647170128027104,0.663528298719729,away,TEX,over,7.5,0.5348837209302326,-115,0.5071810588305992,KC,TEX,2023 REG,1,0,5,4,4,6,0,1,-4,4,0,0,0,0,0,0,0,0,0,0.5071810588305992,0.49281894116940084
90558,0.35211267605633806,0.6923076923076923,184,-225,0.33647170128027104,0.663528298719729,home,KC,under,7.5,0.5169082125603864,-107,0.49281894116940084,KC,TEX,2023 REG,1,0,5,4,4,6,0,1,-4,4,0,0,0,0,0,0,0,0,0,0.5071810588305992,0.49281894116940084
90559,0.7395833333333334,0.3048780487804878,-284,228,0.7067004361449865,0.29329956385501355,away,KC,over,8,0.5370370370370371,-116,0.5118817074154765,MIN,KC,2023 REG,5,5,4,0,5,9,1,0,5,-5,0,0,0,0,0,0,0,0,0,0.5118817074154765,0.48811829258452355
90559,0.7395833333333334,0.3048780487804878,-284,228,0.7067004361449865,0.29329956385501355,home,MIN,under,8,0.5098039215686274,-104,0.48811829258452355,MIN,KC,2023 REG,5,5,4,0,5,9,1,0,5,-5,0,0,0,0,0,0,0,0,0,0.5118817074154765,0.48811829258452355
90560,0.5305164319248826,0.5073891625615764,-113,-103,0.5104068911879349,0.4895931088120651,away,SD,over,9,0.5327102803738317,-114,0.5075272610403079,NYM,SD,2023 REG,8,5,6,2,7,14,1,0,3,-3,1,1,0,0,0,0,0,0,0,0.5075272610403079,0.4924727389596921
90560,0.5305164319248826,0.5073891625615764,-113,-103,0.5104068911879349,0.4895931088120651,home,NYM,under,9,0.5145631067961165,-106,0.4924727389596921,NYM,SD,2023 REG,8,5,6,2,7,14,1,0,3,-3,1,1,0,0,0,0,0,0,0,0.5075272610403079,0.4924727389596921
90561,0.5918367346938775,0.4444444444444444,-145,125,0.5703642001018094,0.42963579989819056,away,CIN,over,8.5,0.5348837209302326,-115,0.5097020142727117,PIT,CIN,2023 REG,6,4,5,2,6,11,1,0,2,-2,1,1,0,0,0,0,0,0,0,0.5097020142727117,0.49029798572728833
90561,0.5918367346938775,0.4444444444444444,-145,125,0.5703642001018094,0.42963579989819056,home,PIT,under,8.5,0.5121951219512195,-105,0.49029798572728833,PIT,CIN,2023 REG,6,4,5,2,6,11,1,0,2,-2,1,1,0,0,0,0,0,0,0,0.5097020142727117,0.49029798572728833
90562,0.3389830508474576,0.7032640949554896,195,-237,0.3246619844735772,0.6753380155264228,away,CWS,over,8.5,0.5495495495495495,-122,0.5250401592387142,OAK,CWS,2023 REG,11,7,10,6,13,21,1,0,1,-1,1,1,1,1,1,1,0,0,0,0.5250401592387142,0.47495984076128583
90562,0.3389830508474576,0.7032640949554896,195,-237,0.3246619844735772,0.6753380155264228,home,OAK,under,8.5,0.49504950495049505,102,0.47495984076128583,OAK,CWS,2023 REG,11,7,10,6,13,21,1,0,1,-1,1,1,1,1,1,1,0,0,0,0.5250401592387142,0.47495984076128583
90563,0.5454545454545454,0.49504950495049505,-120,102,0.5233614270517961,0.4766385729482039,away,PHI,over,9,0.5283018867924528,-112,0.5031902949311281,CIN,PHI,2023 REG,10,6,9,2,8,19,1,0,4,-4,1,1,0,0,0,0,0,0,0,0.5031902949311281,0.4968097050688719
90563,0.5454545454545454,0.49504950495049505,-120,102,0.5233614270517961,0.4766385729482039,home,CIN,under,9,0.5192307692307692,-108,0.4968097050688719,CIN,PHI,2023 REG,10,6,9,2,8,19,1,0,4,-4,1,1,0,0,0,0,0,0,0,0.5031902949311281,0.4968097050688719
90564,0.4273504273504274,0.6108949416342413,134,-157,0.41100625257065443,0.5889937474293456,away,SF,over,8.5,0.5454545454545454,-120,0.5206611570247933,PIT,SF,2023 REG,7,1,3,3,4,10,0,1,-2,2,1,0,0,0,0,0,0,0,0,0.5206611570247933,0.4793388429752067
90564,0.4273504273504274,0.6108949416342413,134,-157,0.41100625257065443,0.5889937474293456,home,PIT,under,8.5,0.5,100,0.4793388429752067,PIT,SF,2023 REG,7,1,3,3,4,10,0,1,-2,2,1,0,0,0,0,0,0,0,0,0.5206611570247933,0.4793388429752067
90565,0.4424778761061947,0.5967741935483871,126,-148,0.4251097036926629,0.5748902963073371,away,SD,over,10.5,0.5348837209302326,-115,0.5097020142727117,CIN,SD,2023 REG,10,7,9,5,12,19,1,0,2,-2,1,1,1,1,1,0,0,0,0,0.5097020142727117,0.49029798572728833
90565,0.4424778761061947,0.5967741935483871,126,-148,0.4251097036926629,0.5748902963073371,home,CIN,under,10.5,0.5121951219512195,-105,0.49029798572728833,CIN,SD,2023 REG,10,7,9,5,12,19,1,0,2,-2,1,1,1,1,1,0,0,0,0,0.5097020142727117,0.49029798572728833
90566,0.6774193548387096,0.35714285714285715,-210,180,0.6540062434963579,0.34599375650364206,away,CIN,over,8.5,0.5327102803738317,-114,0.508788710910954,SD,CIN,2023 REG,16,8,8,3,11,24,1,0,5,-5,1,1,1,0,0,0,0,0,0,0.508788710910954,0.491211289089046
90566,0.6774193548387096,0.35714285714285715,-210,180,0.6540062434963579,0.34599375650364206,home,SD,under,8.5,0.5121951219512195,-105,0.491211289089046,SD,CIN,2023 REG,16,8,8,3,11,24,1,0,5,-5,1,1,1,0,0,0,0,0,0,0.508788710910954,0.491211289089046
90567,0.38759689922480617,0.6515679442508712,158,-187,0.37241672733500875,0.6275832726649913,away,MIN,over,9.5,0.5,100,0.4772727272727273,KC,MIN,2023 REG,18,10,12,7,17,30,1,0,3,-3,1,1,1,1,1,1,1,0,0,0.4772727272727273,0.5227272727272727
90567,0.38759689922480617,0.6515679442508712,158,-187,0.37241672733500875,0.6275832726649913,home,KC,under,9.5,0.5454545454545454,-120,0.5227272727272727,KC,MIN,2023 REG,18,10,12,7,17,30,1,0,3,-3,1,1,1,1,1,1,1,0,0,0.4772727272727273,0.5227272727272727
90568,0.5098039215686274,0.5305164319248826,-104,-113,0.4892484472386027,0.5107515527613973,away,SEA,over,8,0.5327102803738317,-114,0.5075272610403079,TB,SEA,2023 REG,8,7,7,4,11,15,1,0,3,-3,1,1,1,1,0,0,0,0,0,0.5075272610403079,0.4924727389596921
90568,0.5098039215686274,0.5305164319248826,-104,-113,0.4892484472386027,0.5107515527613973,home,TB,under,8,0.5145631067961165,-106,0.4924727389596921,TB,SEA,2023 REG,8,7,7,4,11,15,1,0,3,-3,1,1,1,1,0,0,0,0,0,0.5075272610403079,0.4924727389596921
90569,0.576271186440678,0.45454545454545453,-136,120,0.5585124441774829,0.4414875558225171,away,TOR,over,9,0.5098039215686274,-104,0.4870219861770517,PHI,TOR,2023 REG,9,8,7,4,12,16,1,0,4,-4,1,1,1,1,0,0,0,0,0,0.4870219861770517,0.5129780138229483
90569,0.576271186440678,0.45454545454545453,-136,120,0.5585124441774829,0.4414875558225171,home,PHI,under,9,0.5348837209302326,-115,0.5129780138229483,PHI,TOR,2023 REG,9,8,7,4,12,16,1,0,4,-4,1,1,1,1,0,0,0,0,0,0.4870219861770517,0.5129780138229483
90570,0.6551724137931035,0.3846153846153846,-190,160,0.6291045458703008,0.37089545412969915,away,CIN,over,10.5,0.5305164319248826,-113,0.5053568787472517,LAD,CIN,2023 REG,2,3,6,2,5,8,1,0,1,-1,1,1,0,0,0,0,0,0,0,0.5053568787472517,0.49464312125274834
90570,0.6551724137931035,0.3846153846153846,-190,160,0.6291045458703008,0.37089545412969915,home,LAD,under,10.5,0.5169082125603864,-107,0.49464312125274834,LAD,CIN,2023 REG,2,3,6,2,5,8,1,0,1,-1,1,1,0,0,0,0,0,0,0,0.5053568787472517,0.49464312125274834
90571,0.5918367346938775,0.45248868778280543,-145,121,0.5656033213913509,0.43439667860864906,away,TB,over,8.5,0.5391705069124424,-117,0.5140669063204599,HOU,TB,2023 REG,18,17,7,4,21,25,1,0,13,-13,1,1,1,1,0,0,0,0,0,0.5140669063204599,0.4859330936795401
90571,0.5918367346938775,0.45248868778280543,-145,121,0.5656033213913509,0.43439667860864906,home,HOU,under,8.5,0.5073891625615764,-103,0.4859330936795401,HOU,TB,2023 REG,18,17,7,4,21,25,1,0,13,-13,1,1,1,1,0,0,0,0,0,0.5140669063204599,0.4859330936795401
90572,0.3333333333333333,0.7142857142857143,200,-250,0.31746031746031744,0.6825396825396826,away,LAD,over,12,0.5121951219512195,-105,0.48808156828023186,COL,LAD,2023 REG,9,4,9,1,5,18,1,0,3,-3,1,0,0,0,0,0,0,0,0,0.48808156828023186,0.5119184317197681
90572,0.3333333333333333,0.7142857142857143,200,-250,0.31746031746031744,0.6825396825396826,home,COL,under,12,0.5348837209302326,-115,0.5119184317197681,COL,LAD,2023 REG,9,4,9,1,5,18,1,0,3,-3,1,0,0,0,0,0,0,0,0,0.48808156828023186,0.5119184317197681
90573,0.42016806722689076,0.6108949416342413,138,-157,0.4071163828314571,0.5928836171685429,away,TB,over,7,0.5495495495495495,-122,0.5223196169142115,CWS,TB,2023 REG,11,5,16,14,19,27,0,1,-9,9,1,1,1,1,1,0,0,0,0,0.5223196169142115,0.47768038308578853
90573,0.42016806722689076,0.6108949416342413,138,-157,0.4071163828314571,0.5928836171685429,home,CWS,under,7,0.5,100,0.47768038308578853,CWS,TB,2023 REG,11,5,16,14,19,27,0,1,-9,9,1,1,1,1,1,0,0,0,0,0.5223196169142115,0.47768038308578853
90574,0.5073891625615764,0.5348837209302326,-103,-115,0.4859403596076043,0.5140596403923957,away,MIN,over,8,0.5238095238095238,-110,0.5000596729920038,CLE,MIN,2023 REG,13,6,20,20,26,33,0,1,-14,14,1,1,1,1,1,1,0,0,0,0.5000596729920038,0.4999403270079962
90574,0.5073891625615764,0.5348837209302326,-103,-115,0.4859403596076043,0.5140596403923957,home,CLE,under,8,0.5215311004784688,-109,0.4999403270079962,CLE,MIN,2023 REG,13,6,20,20,26,33,0,1,-14,14,1,1,1,1,1,1,0,0,0,0.5000596729920038,0.4999403270079962
90575,0.35460992907801414,0.6894409937888198,182,-222,0.33898903444438505,0.6610109655556149,away,LAD,over,10,0.5121951219512195,-105,0.48808156828023186,WSH,LAD,2023 REG,9,3,14,7,10,23,0,1,-4,4,1,1,1,0,0,0,0,0,0,0.48808156828023186,0.5119184317197681
90575,0.35460992907801414,0.6894409937888198,182,-222,0.33898903444438505,0.6610109655556149,home,WSH,under,10,0.5348837209302326,-115,0.5119184317197681,WSH,LAD,2023 REG,9,3,14,7,10,23,0,1,-4,4,1,1,1,0,0,0,0,0,0,0.48808156828023186,0.5119184317197681
90576,0.5391705069124424,0.5024875621890548,-117,-101,0.5167097046779946,0.4832902953220054,away,PIT,over,8.5,0.5475113122171946,-121,0.5214983313199976,NYM,PIT,2023 REG,9,8,7,3,11,16,1,0,5,-5,1,1,1,0,0,0,0,0,0,0.5214983313199976,0.47850166868000243
90576,0.5391705069124424,0.5024875621890548,-117,-101,0.5167097046779946,0.4832902953220054,home,NYM,under,8.5,0.5,100,0.47850166868000243,NYM,PIT,2023 REG,9,8,7,3,11,16,1,0,5,-5,1,1,1,0,0,0,0,0,0,0.5214983313199976,0.47850166868000243
90577,0.5967741935483871,0.4366812227074236,-148,129,0.5768088644925001,0.42319113550749987,away,SF,over,8,0.5145631067961165,-106,0.49023796582517226,MIL,SF,2023 REG,4,1,19,15,16,23,0,1,-14,14,1,0,0,0,0,0,0,0,0,0.49023796582517226,0.5097620341748277
90577,0.5967741935483871,0.4366812227074236,-148,129,0.5768088644925001,0.42319113550749987,home,MIL,under,8,0.5327102803738317,-114,0.5097620341748277,MIL,SF,2023 REG,4,1,19,15,16,23,0,1,-14,14,1,0,0,0,0,0,0,0,0,0.49023796582517226,0.5097620341748277
90578,0.6923076923076923,0.35460992907801414,-225,182,0.6598262621175878,0.34017373788241223,away,MIL,over,9,0.5215311004784688,-109,0.4978845547971712,LAD,MIL,2023 REG,10,6,2,2,8,12,1,0,4,-4,1,1,0,0,0,0,0,0,0,0.4978845547971712,0.5021154452028288
90578,0.6923076923076923,0.35460992907801414,-225,182,0.6598262621175878,0.34017373788241223,home,LAD,under,9,0.5238095238095238,-110,0.5021154452028288,LAD,MIL,2023 REG,10,6,2,2,8,12,1,0,4,-4,1,1,0,0,0,0,0,0,0,0.4978845547971712,0.5021154452028288
90579,0.5535714285714286,0.48780487804878053,-124,105,0.53066668740667,0.46933331259333,away,MIN,over,8,0.5348837209302326,-115,0.5097020142727117,HOU,MIN,2023 REG,8,5,14,7,12,22,0,1,-2,2,1,1,1,1,1,0,0,0,0,0.5097020142727117,0.49029798572728833
90579,0.5535714285714286,0.48780487804878053,-124,105,0.53066668740667,0.46933331259333,home,HOU,under,8,0.5121951219512195,-105,0.49029798572728833,HOU,MIN,2023 REG,8,5,14,7,12,22,0,1,-2,2,1,1,1,1,1,0,0,0,0,0.5097020142727117,0.49029798572728833
90580,0.5833333333333333,0.45454545454545453,-140,120,0.5612373737373737,0.4387626262626263,away,BAL,over,8,0.5238095238095238,-110,0.4988662131519274,TB,BAL,2023 REG,7,3,2,0,3,9,1,0,3,-3,0,0,0,0,0,0,0,0,0,0.4988662131519274,0.5011337868480725
90580,0.5833333333333333,0.45454545454545453,-140,120,0.5612373737373737,0.4387626262626263,home,TB,under,8,0.5238095238095238,-110,0.5011337868480725,TB,BAL,2023 REG,7,3,2,0,3,9,1,0,3,-3,0,0,0,0,0,0,0,0,0,0.4988662131519274,0.5011337868480725
90581,0.5454545454545454,0.5,-120,100,0.5206611570247933,0.4793388429752067,away,TB,over,9.5,0.5238095238095238,-110,0.4988662131519274,ARI,TB,2023 REG,8,1,9,6,7,17,0,1,-5,5,1,0,0,0,0,0,0,0,0,0.4988662131519274,0.5011337868480725
90581,0.5454545454545454,0.5,-120,100,0.5206611570247933,0.4793388429752067,home,ARI,under,9.5,0.5238095238095238,-110,0.5011337868480725,ARI,TB,2023 REG,8,1,9,6,7,17,0,1,-5,5,1,0,0,0,0,0,0,0,0,0.4988662131519274,0.5011337868480725
90582,0.6551724137931035,0.3846153846153846,-190,160,0.6291045458703008,0.37089545412969915,away,DET,over,9,0.5348837209302326,-115,0.5097020142727117,STL,DET,2023 REG,9,5,13,6,11,22,0,1,-1,1,1,1,1,1,1,0,0,0,0,0.5097020142727117,0.49029798572728833
90582,0.6551724137931035,0.3846153846153846,-190,160,0.6291045458703008,0.37089545412969915,home,STL,under,9,0.5121951219512195,-105,0.49029798572728833,STL,DET,2023 REG,9,5,13,6,11,22,0,1,-1,1,1,1,1,1,1,0,0,0,0,0.5097020142727117,0.49029798572728833
90583,0.6587030716723549,0.37735849056603776,-193,165,0.6349492098566218,0.36505079014337816,away,WSH,over,8.5,0.5370370370370371,-116,0.5118817074154765,NYM,WSH,2023 REG,8,5,8,1,6,16,1,0,4,-4,1,0,0,0,0,0,0,0,0,0.5118817074154765,0.48811829258452355
90583,0.6587030716723549,0.37735849056603776,-193,165,0.6349492098566218,0.36505079014337816,home,NYM,under,8.5,0.5098039215686274,-104,0.48811829258452355,NYM,WSH,2023 REG,8,5,8,1,6,16,1,0,4,-4,1,0,0,0,0,0,0,0,0,0.5118817074154765,0.48811829258452355
90585,0.7590361445783133,0.2777777777777778,-315,260,0.7310930468863406,0.2689069531136594,away,WSH,over,7.5,0.49504950495049505,102,0.47297076509898783,MIN,WSH,2023 REG,9,4,15,10,14,24,0,1,-6,6,1,1,1,1,0,0,0,0,0,0.47297076509898783,0.5270292349010122
90585,0.7590361445783133,0.2777777777777778,-315,260,0.7310930468863406,0.2689069531136594,home,MIN,under,7.5,0.5495495495495495,-122,0.5270292349010122,MIN,WSH,2023 REG,9,4,15,10,14,24,0,1,-6,6,1,1,1,1,0,0,0,0,0,0.47297076509898783,0.5270292349010122
90586,0.6575342465753424,0.38314176245210724,-192,161,0.6307883776257865,0.36921162237421346,away,STL,over,8.5,0.5098039215686274,-104,0.48483656587239576,SD,STL,2023 REG,6,2,6,5,7,12,0,1,-3,3,1,1,0,0,0,0,0,0,0,0.48483656587239576,0.5151634341276042
90586,0.6575342465753424,0.38314176245210724,-192,161,0.6307883776257865,0.36921162237421346,home,SD,under,8.5,0.5391705069124424,-117,0.5151634341276042,SD,STL,2023 REG,6,2,6,5,7,12,0,1,-3,3,1,1,0,0,0,0,0,0,0,0.48483656587239576,0.5151634341276042
90587,0.5850622406639003,0.45454545454545453,-141,120,0.5618892737571823,0.43811072624281766,away,TOR,over,8.5,0.5495495495495495,-122,0.5236866555946829,SEA,TOR,2023 REG,5,3,6,4,7,11,0,1,-1,1,1,1,1,0,0,0,0,0,0,0.5236866555946829,0.47631334440531714
90587,0.5850622406639003,0.45454545454545453,-141,120,0.5618892737571823,0.43811072624281766,home,SEA,under,8.5,0.49751243781094534,101,0.47631334440531714,SEA,TOR,2023 REG,5,3,6,4,7,11,0,1,-1,1,1,1,1,0,0,0,0,0,0,0.5236866555946829,0.47631334440531714
90588,0.47619047619047616,0.5652173913043479,110,-130,0.4564724440500838,0.5435275559499162,away,CLE,over,8.5,0.5433789954337899,-119,0.5184560714286826,LAA,CLE,2023 REG,9,3,9,2,5,18,1,0,1,-1,1,1,0,0,0,0,0,0,0,0.5184560714286826,0.48154392857131745
90588,0.47619047619047616,0.5652173913043479,110,-130,0.4564724440500838,0.5435275559499162,home,LAA,under,8.5,0.5024875621890548,-101,0.48154392857131745,LAA,CLE,2023 REG,9,3,9,2,5,18,1,0,1,-1,1,1,0,0,0,0,0,0,0,0.5184560714286826,0.48154392857131745
90589,0.49751243781094534,0.5454545454545454,101,-120,0.476135829221149,0.523864170778851,away,HOU,over,8,0.5121951219512195,-105,0.48808156828023186,SEA,HOU,2023 REG,8,3,14,8,11,22,0,1,-5,5,1,1,1,0,0,0,0,0,0,0.48808156828023186,0.5119184317197681
90589,0.49751243781094534,0.5454545454545454,101,-120,0.476135829221149,0.523864170778851,home,SEA,under,8,0.5348837209302326,-115,0.5119184317197681,SEA,HOU,2023 REG,8,3,14,8,11,22,0,1,-5,5,1,1,1,0,0,0,0,0,0,0.48808156828023186,0.5119184317197681
90590,0.5192307692307692,0.5238095238095238,-108,-110,0.49688292476754015,0.5031170752324599,away,BAL,over,9,0.5121951219512195,-105,0.48808156828023186,MIL,BAL,2023 REG,8,3,10,6,9,18,0,1,-3,3,1,1,1,0,0,0,0,0,0,0.48808156828023186,0.5119184317197681
90590,0.5192307692307692,0.5238095238095238,-108,-110,0.49688292476754015,0.5031170752324599,home,MIL,under,9,0.5348837209302326,-115,0.5119184317197681,MIL,BAL,2023 REG,8,3,10,6,9,18,0,1,-3,3,1,1,1,0,0,0,0,0,0,0.48808156828023186,0.5119184317197681
90591,0.6153846153846154,0.425531914893617,-160,135,0.5902052121364724,0.40979478786352763,away,PIT,over,9,0.5121951219512195,-105,0.48808156828023186,STL,PIT,2023 REG,9,3,8,0,3,17,1,0,3,-3,0,0,0,0,0,0,0,0,0,0.48808156828023186,0.5119184317197681
90591,0.6153846153846154,0.425531914893617,-160,135,0.5902052121364724,0.40979478786352763,home,STL,under,9,0.5348837209302326,-115,0.5119184317197681,STL,PIT,2023 REG,9,3,8,0,3,17,1,0,3,-3,0,0,0,0,0,0,0,0,0,0.48808156828023186,0.5119184317197681
90592,0.5145631067961165,0.5238095238095238,-106,-110,0.4948179667757384,0.5051820332242616,away,BAL,over,8.5,0.5370370370370371,-116,0.5118817074154765,NYY,BAL,2023 REG,11,6,12,3,9,23,1,0,3,-3,1,1,1,0,0,0,0,0,0,0.5118817074154765,0.48811829258452355
90592,0.5145631067961165,0.5238095238095238,-106,-110,0.4948179667757384,0.5051820332242616,home,NYY,under,8.5,0.5098039215686274,-104,0.48811829258452355,NYY,BAL,2023 REG,11,6,12,3,9,23,1,0,3,-3,1,1,1,0,0,0,0,0,0,0.5118817074154765,0.48811829258452355
90593,0.5,0.5454545454545454,100,-120,0.4772727272727273,0.5227272727272727,away,BOS,over,8.5,0.5121951219512195,-105,0.48808156828023186,SF,BOS,2023 REG,11,3,5,2,5,16,1,0,1,-1,1,1,0,0,0,0,0,0,0,0.48808156828023186,0.5119184317197681
90593,0.5,0.5454545454545454,100,-120,0.4772727272727273,0.5227272727272727,home,SF,under,8.5,0.5348837209302326,-115,0.5119184317197681,SF,BOS,2023 REG,11,3,5,2,5,16,1,0,1,-1,1,1,0,0,0,0,0,0,0,0.48808156828023186,0.5119184317197681
90594,0.6774193548387096,0.36101083032490977,-210,177,0.6513860035988384,0.34861399640116164,away,WSH,over,8.5,0.5145631067961165,-106,0.49023796582517226,SD,WSH,2023 REG,8,3,11,8,11,19,0,1,-5,5,1,1,1,0,0,0,0,0,0,0.49023796582517226,0.5097620341748277
90594,0.6774193548387096,0.36101083032490977,-210,177,0.6513860035988384,0.34861399640116164,home,SD,under,8.5,0.5327102803738317,-114,0.5097620341748277,SD,WSH,2023 REG,8,3,11,8,11,19,0,1,-5,5,1,1,1,0,0,0,0,0,0,0.49023796582517226,0.5097620341748277
90595,0.5370370370370371,0.504950495049505,-116,-102,0.514488177212783,0.48551182278721705,away,CLE,over,9.5,0.5145631067961165,-106,0.4913668392989033,CIN,CLE,2023 REG,6,0,7,3,3,13,0,1,-3,3,0,0,0,0,0,0,0,0,0,0.4913668392989033,0.5086331607010968
90595,0.5370370370370371,0.504950495049505,-116,-102,0.514488177212783,0.48551182278721705,home,CIN,under,9.5,0.5305164319248826,-113,0.5086331607010968,CIN,CLE,2023 REG,6,0,7,3,3,13,0,1,-3,3,0,0,0,0,0,0,0,0,0,0.4913668392989033,0.5086331607010968
90596,0.39840637450199207,0.6402877697841727,151,-178,0.38299038076248415,0.6170096192375158,away,BAL,over,8.5,0.5454545454545454,-120,0.5179608869977906,OAK,BAL,2023 REG,6,2,9,7,9,15,0,1,-5,5,1,1,0,0,0,0,0,0,0,0.5179608869977906,0.48203911300220936
90596,0.39840637450199207,0.6402877697841727,151,-178,0.38299038076248415,0.6170096192375158,home,OAK,under,8.5,0.504950495049505,-102,0.48203911300220936,OAK,BAL,2023 REG,6,2,9,7,9,15,0,1,-5,5,1,1,0,0,0,0,0,0,0,0.5179608869977906,0.48203911300220936
90597,0.607843137254902,0.43103448275862066,-155,132,0.5842116427368785,0.41578835726312147,away,SD,over,9.5,0.5,100,0.4772727272727273,LAD,SD,2023 REG,11,11,5,2,13,16,1,0,9,-9,1,1,0,0,0,0,0,0,0,0.4772727272727273,0.5227272727272727
90597,0.607843137254902,0.43103448275862066,-155,132,0.5842116427368785,0.41578835726312147,home,LAD,under,9.5,0.5454545454545454,-120,0.5227272727272727,LAD,SD,2023 REG,11,11,5,2,13,16,1,0,9,-9,1,1,0,0,0,0,0,0,0,0.4772727272727273,0.5227272727272727
90598,0.6428571428571428,0.3921568627450981,-180,155,0.6203481392557023,0.3796518607442977,away,HOU,over,7.5,0.5283018867924528,-112,0.5031902949311281,TB,HOU,2023 REG,5,0,11,5,5,16,0,1,-5,5,0,0,0,0,0,0,0,0,0,0.5031902949311281,0.4968097050688719
90598,0.6428571428571428,0.3921568627450981,-180,155,0.6203481392557023,0.3796518607442977,home,TB,under,7.5,0.5192307692307692,-108,0.4968097050688719,TB,HOU,2023 REG,5,0,11,5,5,16,0,1,-5,5,0,0,0,0,0,0,0,0,0,0.5031902949311281,0.4968097050688719
90599,0.5867768595041323,0.45454545454545453,-142,120,0.5625298818386723,0.43747011816132775,away,BAL,over,8.5,0.5121951219512195,-105,0.48808156828023186,ARI,BAL,2023 REG,9,5,14,8,13,23,0,1,-3,3,1,1,1,1,1,0,0,0,0,0.48808156828023186,0.5119184317197681
90599,0.5867768595041323,0.45454545454545453,-142,120,0.5625298818386723,0.43747011816132775,home,ARI,under,8.5,0.5348837209302326,-115,0.5119184317197681,ARI,BAL,2023 REG,9,5,14,8,13,23,0,1,-3,3,1,1,1,1,1,0,0,0,0,0.48808156828023186,0.5119184317197681
90600,0.5121951219512195,0.5348837209302326,-105,-115,0.48808156828023186,0.5119184317197681,away,NYY,over,9.5,0.5348837209302326,-115,0.5097020142727117,BOS,NYY,2023 REG,9,5,12,8,13,21,0,1,-3,3,1,1,1,1,1,0,0,0,0,0.5097020142727117,0.49029798572728833
90600,0.5121951219512195,0.5348837209302326,-105,-115,0.48808156828023186,0.5119184317197681,home,BOS,under,9.5,0.5121951219512195,-105,0.49029798572728833,BOS,NYY,2023 REG,9,5,12,8,13,21,0,1,-3,3,1,1,1,1,1,0,0,0,0,0.5097020142727117,0.49029798572728833
90601,0.6845425867507886,0.3508771929824561,-217,185,0.6602962391100501,0.3397037608899499,away,OAK,over,8,0.5305164319248826,-113,0.5066009958897986,MIA,OAK,2023 REG,14,12,8,1,13,22,1,0,11,-11,1,0,0,0,0,0,0,0,0,0.5066009958897986,0.49339900411020143
90601,0.6845425867507886,0.3508771929824561,-217,185,0.6602962391100501,0.3397037608899499,home,MIA,under,8,0.5145631067961165,-106,0.49339900411020143,MIA,OAK,2023 REG,14,12,8,1,13,22,1,0,11,-11,1,0,0,0,0,0,0,0,0,0.5066009958897986,0.49339900411020143
90602,0.6428571428571428,0.3921568627450981,-180,155,0.6203481392557023,0.3796518607442977,away,NYY,over,8.5,0.5348837209302326,-115,0.5097020142727117,TB,NYY,2023 REG,7,5,8,4,9,15,1,0,1,-1,1,1,1,1,0,0,0,0,0,0.5097020142727117,0.49029798572728833
90602,0.6428571428571428,0.3921568627450981,-180,155,0.6203481392557023,0.3796518607442977,home,TB,under,8.5,0.5121951219512195,-105,0.49029798572728833,TB,NYY,2023 REG,7,5,8,4,9,15,1,0,1,-1,1,1,1,1,0,0,0,0,0,0.5097020142727117,0.49029798572728833
90603,0.5475113122171946,0.49019607843137253,-121,104,0.5268660892829112,0.47313391071708877,away,ARI,over,8,0.5215311004784688,-109,0.4978845547971712,SD,ARI,2023 REG,3,1,3,3,4,6,0,1,-2,2,1,0,0,0,0,0,0,0,0,0.4978845547971712,0.5021154452028288
90603,0.5475113122171946,0.49019607843137253,-121,104,0.5268660892829112,0.47313391071708877,home,SD,under,8,0.5238095238095238,-110,0.5021154452028288,SD,ARI,2023 REG,3,1,3,3,4,6,0,1,-2,2,1,0,0,0,0,0,0,0,0,0.4978845547971712,0.5021154452028288
90604,0.6621621621621622,0.37735849056603776,-196,165,0.6359930813015974,0.3640069186984026,away,WSH,over,9,0.5305164319248826,-113,0.5053568787472517,STL,WSH,2023 REG,6,5,8,7,12,14,0,1,-2,2,1,1,1,1,1,0,0,0,0,0.5053568787472517,0.49464312125274834
90604,0.6621621621621622,0.37735849056603776,-196,165,0.6359930813015974,0.3640069186984026,home,STL,under,9,0.5169082125603864,-107,0.49464312125274834,STL,WSH,2023 REG,6,5,8,7,12,14,0,1,-2,2,1,1,1,1,1,0,0,0,0,0.5053568787472517,0.49464312125274834
90605,0.5073891625615764,0.5348837209302326,-103,-115,0.4859403596076043,0.5140596403923957,away,CIN,over,9,0.5454545454545454,-120,0.5206611570247933,STL,CIN,2023 REG,6,2,17,19,21,23,0,1,-17,17,1,1,0,0,0,0,0,0,0,0.5206611570247933,0.4793388429752067
90605,0.5073891625615764,0.5348837209302326,-103,-115,0.4859403596076043,0.5140596403923957,home,STL,under,9,0.5,100,0.4793388429752067,STL,CIN,2023 REG,6,2,17,19,21,23,0,1,-17,17,1,1,0,0,0,0,0,0,0,0.5206611570247933,0.4793388429752067
90606,0.6551724137931035,0.3846153846153846,-190,160,0.6291045458703008,0.37089545412969915,away,WSH,over,8.5,0.5238095238095238,-110,0.4988662131519274,MIL,WSH,2023 REG,7,5,6,3,8,13,1,0,2,-2,1,1,1,0,0,0,0,0,0,0.4988662131519274,0.5011337868480725
90606,0.6551724137931035,0.3846153846153846,-190,160,0.6291045458703008,0.37089545412969915,home,MIL,under,8.5,0.5238095238095238,-110,0.5011337868480725,MIL,WSH,2023 REG,7,5,6,3,8,13,1,0,2,-2,1,1,1,0,0,0,0,0,0,0.4988662131519274,0.5011337868480725
90607,0.36363636363636365,0.6794871794871794,175,-212,0.34795507522780256,0.6520449247721974,away,HOU,over,9.5,0.5238095238095238,-110,0.5000596729920038,ARI,HOU,2023 REG,6,1,9,8,9,15,0,1,-7,7,1,0,0,0,0,0,0,0,0,0.5000596729920038,0.4999403270079962
90607,0.36363636363636365,0.6794871794871794,175,-212,0.34795507522780256,0.6520449247721974,home,ARI,under,9.5,0.5215311004784688,-109,0.4999403270079962,ARI,HOU,2023 REG,6,1,9,8,9,15,0,1,-7,7,1,0,0,0,0,0,0,0,0,0.5000596729920038,0.4999403270079962
90608,0.5454545454545454,0.5,-120,100,0.5206611570247933,0.4793388429752067,away,ARI,over,10,0.5348837209302326,-115,0.5097020142727117,LAA,ARI,2023 REG,3,1,9,3,4,12,0,1,-2,2,1,0,0,0,0,0,0,0,0,0.5097020142727117,0.49029798572728833
90608,0.5454545454545454,0.5,-120,100,0.5206611570247933,0.4793388429752067,home,LAA,under,10,0.5121951219512195,-105,0.49029798572728833,LAA,ARI,2023 REG,3,1,9,3,4,12,0,1,-2,2,1,0,0,0,0,0,0,0,0,0.5097020142727117,0.49029798572728833
90609,0.3921568627450981,0.6428571428571428,155,-180,0.37842588015598405,0.6215741198440159,away,BOS,over,9,0.5,100,0.4772727272727273,OAK,BOS,2023 REG,7,3,5,0,3,12,1,0,3,-3,0,0,0,0,0,0,0,0,0,0.4772727272727273,0.5227272727272727
90609,0.3921568627450981,0.6428571428571428,155,-180,0.37842588015598405,0.6215741198440159,home,OAK,under,9,0.5454545454545454,-120,0.5227272727272727,OAK,BOS,2023 REG,7,3,5,0,3,12,1,0,3,-3,0,0,0,0,0,0,0,0,0,0.4772727272727273,0.5227272727272727
90610,0.6226415094339623,0.4132231404958678,-165,142,0.6003106896663323,0.3996893103336677,away,CIN,over,7.5,0.5454545454545454,-120,0.5206611570247933,CHC,CIN,2023 REG,9,5,14,8,13,23,0,1,-3,3,1,1,1,1,1,0,0,0,0,0.5206611570247933,0.4793388429752067
90610,0.6226415094339623,0.4132231404958678,-165,142,0.6003106896663323,0.3996893103336677,home,CHC,under,7.5,0.5,100,0.4793388429752067,CHC,CIN,2023 REG,9,5,14,8,13,23,0,1,-3,3,1,1,1,1,1,0,0,0,0,0.5206611570247933,0.4793388429752067
90611,0.6610169491525424,0.37878787878787884,-195,164,0.6347052832258232,0.3652947167741768,away,CIN,over,7,0.5475113122171946,-121,0.5242087833606768,PHI,CIN,2023 REG,10,5,6,2,7,16,1,0,3,-3,1,1,0,0,0,0,0,0,0,0.5242087833606768,0.4757912166393232
90611,0.6610169491525424,0.37878787878787884,-195,164,0.6347052832258232,0.3652947167741768,home,PHI,under,7,0.49504950495049505,102,0.4757912166393232,PHI,CIN,2023 REG,10,5,6,2,7,16,1,0,3,-3,1,1,0,0,0,0,0,0,0,0.5242087833606768,0.4757912166393232
90612,0.5238095238095238,0.5192307692307692,-110,-108,0.5012646084074657,0.4987353915925343,away,BAL,over,9.5,0.5024875621890548,-101,0.4794401874631478,PHI,BAL,2023 REG,9,6,8,4,10,17,1,0,2,-2,1,1,1,1,0,0,0,0,0,0.4794401874631478,0.5205598125368522
90612,0.5238095238095238,0.5192307692307692,-110,-108,0.5012646084074657,0.4987353915925343,home,PHI,under,9.5,0.5433789954337899,-119,0.5205598125368522,PHI,BAL,2023 REG,9,6,8,4,10,17,1,0,2,-2,1,1,1,1,0,0,0,0,0,0.4794401874631478,0.5205598125368522
90613,0.6296296296296295,0.4098360655737705,-170,144,0.6047808585756369,0.3952191414243631,away,BOS,over,9,0.5238095238095238,-110,0.5000596729920038,TOR,BOS,2023 REG,10,6,13,7,13,23,0,1,-1,1,1,1,1,1,1,1,0,0,0,0.5000596729920038,0.4999403270079962
90613,0.6296296296296295,0.4098360655737705,-170,144,0.6047808585756369,0.3952191414243631,home,TOR,under,9,0.5215311004784688,-109,0.4999403270079962,TOR,BOS,2023 REG,10,6,13,7,13,23,0,1,-1,1,1,1,1,1,1,1,0,0,0,0.5000596729920038,0.4999403270079962
90614,0.5689655172413793,0.47846889952153115,-132,109,0.5419769697728268,0.45802303022717317,away,MIN,over,8.5,0.5348837209302326,-115,0.5097020142727117,CIN,MIN,2023 REG,6,3,9,5,8,15,0,1,-2,2,1,1,1,0,0,0,0,0,0,0.5097020142727117,0.49029798572728833
90614,0.5689655172413793,0.47846889952153115,-132,109,0.5419769697728268,0.45802303022717317,home,CIN,under,8.5,0.5121951219512195,-105,0.49029798572728833,CIN,MIN,2023 REG,6,3,9,5,8,15,0,1,-2,2,1,1,1,0,0,0,0,0,0,0.5097020142727117,0.49029798572728833
90615,0.5555555555555556,0.4854368932038835,-125,106,0.5327819729114227,0.4672180270885773,away,CHC,over,9,0.5238095238095238,-110,0.5000596729920038,MIA,CHC,2023 REG,12,7,9,6,13,21,1,0,1,-1,1,1,1,1,1,1,0,0,0,0.5000596729920038,0.4999403270079962
90615,0.5555555555555556,0.4854368932038835,-125,106,0.5327819729114227,0.4672180270885773,home,MIA,under,9,0.5215311004784688,-109,0.4999403270079962,MIA,CHC,2023 REG,12,7,9,6,13,21,1,0,1,-1,1,1,1,1,1,1,0,0,0,0.5000596729920038,0.4999403270079962
90616,0.6124031007751938,0.425531914893617,-158,135,0.5891715795516586,0.41082842044834145,away,DET,over,9,0.5073891625615764,-103,0.4837652908580103,CWS,DET,2023 REG,6,3,6,0,3,12,1,0,3,-3,0,0,0,0,0,0,0,0,0,0.4837652908580103,0.5162347091419897
90616,0.6124031007751938,0.425531914893617,-158,135,0.5891715795516586,0.41082842044834145,home,CWS,under,9,0.5391705069124424,-117,0.5162347091419897,CWS,DET,2023 REG,6,3,6,0,3,12,1,0,3,-3,0,0,0,0,0,0,0,0,0,0.4837652908580103,0.5162347091419897
90617,0.5918367346938775,0.4444444444444444,-145,125,0.5703642001018094,0.42963579989819056,away,BOS,over,8,0.5348837209302326,-115,0.5097020142727117,TOR,BOS,2023 REG,4,3,5,0,3,9,1,0,3,-3,0,0,0,0,0,0,0,0,0,0.5097020142727117,0.49029798572728833
90617,0.5918367346938775,0.4444444444444444,-145,125,0.5703642001018094,0.42963579989819056,home,TOR,under,8,0.5121951219512195,-105,0.49029798572728833,TOR,BOS,2023 REG,4,3,5,0,3,9,1,0,3,-3,0,0,0,0,0,0,0,0,0,0.5097020142727117,0.49029798572728833
90618,0.425531914893617,0.6153846153846154,135,-160,0.4081206254135181,0.5918793745864819,away,ARI,over,12.5,0.5348837209302326,-115,0.5097020142727117,COL,ARI,2023 REG,10,5,14,8,13,24,0,1,-3,3,1,1,1,1,1,0,0,0,0,0.5097020142727117,0.49029798572728833
90618,0.425531914893617,0.6153846153846154,135,-160,0.4081206254135181,0.5918793745864819,home,COL,under,12.5,0.5121951219512195,-105,0.49029798572728833,COL,ARI,2023 REG,10,5,14,8,13,24,0,1,-3,3,1,1,1,1,1,0,0,0,0,0.5097020142727117,0.49029798572728833
90619,0.6226415094339623,0.42016806722689076,-165,138,0.5959864900036198,0.4040135099963802,away,CWS,over,8.5,0.5,100,0.4772727272727273,CLE,CWS,2023 REG,9,4,7,2,6,16,1,0,2,-2,1,1,0,0,0,0,0,0,0,0.4772727272727273,0.5227272727272727
90619,0.6226415094339623,0.42016806722689076,-165,138,0.5959864900036198,0.4040135099963802,home,CLE,under,8.5,0.5454545454545454,-120,0.5227272727272727,CLE,CWS,2023 REG,9,4,7,2,6,16,1,0,2,-2,1,1,0,0,0,0,0,0,0,0.4772727272727273,0.5227272727272727
90620,0.6226415094339623,0.41152263374485604,-165,143,0.6013694957565848,0.3986305042434152,away,KC,over,7.5,0.5192307692307692,-108,0.49688292476754015,MIA,KC,2023 REG,7,6,5,1,7,12,1,0,5,-5,1,0,0,0,0,0,0,0,0,0.49688292476754015,0.5031170752324599
90620,0.6226415094339623,0.41152263374485604,-165,143,0.6013694957565848,0.3986305042434152,home,MIA,under,7.5,0.5238095238095238,-110,0.5031170752324599,MIA,KC,2023 REG,7,6,5,1,7,12,1,0,5,-5,1,0,0,0,0,0,0,0,0,0.49688292476754015,0.5031170752324599
90621,0.6453900709219857,0.3861003861003861,-182,159,0.6250664426309515,0.37493355736904854,away,DET,over,9,0.5098039215686274,-104,0.4870219861770517,PHI,DET,2023 REG,3,1,3,0,1,6,1,0,1,-1,0,0,0,0,0,0,0,0,0,0.4870219861770517,0.5129780138229483
90621,0.6453900709219857,0.3861003861003861,-182,159,0.6250664426309515,0.37493355736904854,home,PHI,under,9,0.5348837209302326,-115,0.5129780138229483,PHI,DET,2023 REG,3,1,3,0,1,6,1,0,1,-1,0,0,0,0,0,0,0,0,0,0.4870219861770517,0.5129780138229483
90622,0.5833333333333333,0.4566210045662101,-140,119,0.5600266362252664,0.4399733637747336,away,BOS,over,9,0.5,100,0.4772727272727273,TOR,BOS,2023 REG,3,0,9,5,5,12,0,1,-5,5,0,0,0,0,0,0,0,0,0,0.4772727272727273,0.5227272727272727
90622,0.5833333333333333,0.4566210045662101,-140,119,0.5600266362252664,0.4399733637747336,home,TOR,under,9,0.5454545454545454,-120,0.5227272727272727,TOR,BOS,2023 REG,3,0,9,5,5,12,0,1,-5,5,0,0,0,0,0,0,0,0,0,0.4772727272727273,0.5227272727272727
90623,0.45454545454545453,0.5884773662551441,120,-143,0.43498962690881876,0.5650103730911813,away,CLE,over,9,0.5121951219512195,-105,0.48808156828023186,KC,CLE,2023 REG,5,1,14,14,15,19,0,1,-13,13,1,0,0,0,0,0,0,0,0,0.48808156828023186,0.5119184317197681
90623,0.45454545454545453,0.5884773662551441,120,-143,0.43498962690881876,0.5650103730911813,home,KC,under,9,0.5348837209302326,-115,0.5119184317197681,KC,CLE,2023 REG,5,1,14,14,15,19,0,1,-13,13,1,0,0,0,0,0,0,0,0,0.48808156828023186,0.5119184317197681
90624,0.6363636363636364,0.40485829959514175,-175,147,0.6101314952989593,0.38986850470104073,away,SF,over,7.5,0.5238095238095238,-110,0.4988662131519274,SD,SF,2023 REG,6,6,5,1,7,11,1,0,5,-5,1,0,0,0,0,0,0,0,0,0.4988662131519274,0.5011337868480725
90624,0.6363636363636364,0.40485829959514175,-175,147,0.6101314952989593,0.38986850470104073,home,SD,under,7.5,0.5238095238095238,-110,0.5011337868480725,SD,SF,2023 REG,6,6,5,1,7,11,1,0,5,-5,1,0,0,0,0,0,0,0,0,0.4988662131519274,0.5011337868480725
90625,0.4081632653061224,0.6323529411764706,145,-172,0.39162603817037017,0.6083739618296298,away,SD,over,8.5,0.5370370370370371,-116,0.5131785224377817,OAK,SD,2023 REG,6,1,13,10,11,19,0,1,-9,9,1,0,0,0,0,0,0,0,0,0.5131785224377817,0.4868214775622183
90625,0.4081632653061224,0.6323529411764706,145,-172,0.39162603817037017,0.6083739618296298,home,OAK,under,8.5,0.5073891625615764,-103,0.4868214775622183,OAK,SD,2023 REG,6,1,13,10,11,19,0,1,-9,9,1,0,0,0,0,0,0,0,0,0.5131785224377817,0.4868214775622183
90626,0.5535714285714286,0.48309178743961345,-124,107,0.5332757197081732,0.4667242802918268,away,PIT,over,7.5,0.5145631067961165,-106,0.4913668392989033,MIA,PIT,2023 REG,10,6,5,4,10,15,1,0,2,-2,1,1,1,1,0,0,0,0,0,0.4913668392989033,0.5086331607010968
90626,0.5535714285714286,0.48309178743961345,-124,107,0.5332757197081732,0.4667242802918268,home,MIA,under,7.5,0.5305164319248826,-113,0.5086331607010968,MIA,PIT,2023 REG,10,6,5,4,10,15,1,0,2,-2,1,1,1,1,0,0,0,0,0,0.4913668392989033,0.5086331607010968
90627,0.6632996632996633,0.37735849056603776,-197,165,0.6363311235301577,0.36366887646984225,away,BAL,over,7.5,0.5454545454545454,-120,0.5206611570247933,TB,BAL,2023 REG,7,5,7,6,11,14,0,1,-1,1,1,1,1,1,1,0,0,0,0,0.5206611570247933,0.4793388429752067
90627,0.6632996632996633,0.37735849056603776,-197,165,0.6363311235301577,0.36366887646984225,home,TB,under,7.5,0.5,100,0.4793388429752067,TB,BAL,2023 REG,7,5,7,6,11,14,0,1,-1,1,1,1,1,1,1,0,0,0,0,0.5206611570247933,0.4793388429752067
90628,0.45454545454545453,0.5833333333333333,120,-140,0.43732782369146006,0.5626721763085399,away,STL,over,11.5,0.5121951219512195,-105,0.48919479393107135,COL,STL,2023 REG,13,7,6,4,11,19,1,0,3,-3,1,1,1,1,0,0,0,0,0,0.48919479393107135,0.5108052060689287
90628,0.45454545454545453,0.5833333333333333,120,-140,0.43732782369146006,0.5626721763085399,home,COL,under,11.5,0.5327102803738317,-114,0.5108052060689287,COL,STL,2023 REG,13,7,6,4,11,19,1,0,3,-3,1,1,1,1,0,0,0,0,0,0.48919479393107135,0.5108052060689287
90629,0.5833333333333333,0.45454545454545453,-140,120,0.5612373737373737,0.4387626262626263,away,SD,over,9,0.5238095238095238,-110,0.4988662131519274,NYM,SD,2023 REG,5,2,9,4,6,14,0,1,-2,2,1,1,0,0,0,0,0,0,0,0.4988662131519274,0.5011337868480725
90629,0.5833333333333333,0.45454545454545453,-140,120,0.5612373737373737,0.4387626262626263,home,NYM,under,9,0.5238095238095238,-110,0.5011337868480725,NYM,SD,2023 REG,5,2,9,4,6,14,0,1,-2,2,1,1,0,0,0,0,0,0,0,0.4988662131519274,0.5011337868480725
90630,0.6323529411764706,0.4081632653061224,-172,145,0.6067323988418897,0.3932676011581103,away,CLE,over,9,0.49751243781094534,101,0.4740985137509976,TEX,CLE,2023 REG,5,2,8,0,2,13,1,0,2,-2,0,0,0,0,0,0,0,0,0,0.4740985137509976,0.5259014862490023
90630,0.6323529411764706,0.4081632653061224,-172,145,0.6067323988418897,0.3932676011581103,home,TEX,under,9,0.5495495495495495,-122,0.5259014862490023,TEX,CLE,2023 REG,5,2,8,0,2,13,1,0,2,-2,0,0,0,0,0,0,0,0,0,0.4740985137509976,0.5259014862490023
90631,0.6000000000000001,0.43859649122807015,-150,128,0.5768421052631579,0.42315789473684207,away,NYM,over,9,0.5215311004784688,-109,0.4978845547971712,STL,NYM,2023 REG,6,1,13,7,8,19,0,1,-6,6,1,0,0,0,0,0,0,0,0,0.4978845547971712,0.5021154452028288
90631,0.6000000000000001,0.43859649122807015,-150,128,0.5768421052631579,0.42315789473684207,home,STL,under,9,0.5238095238095238,-110,0.5021154452028288,STL,NYM,2023 REG,6,1,13,7,8,19,0,1,-6,6,1,0,0,0,0,0,0,0,0,0.4978845547971712,0.5021154452028288
90632,0.6923076923076923,0.35211267605633806,-225,184,0.6615551295941329,0.3384448704058671,away,OAK,over,7.5,0.5454545454545454,-120,0.5179608869977906,MIN,OAK,2023 REG,8,11,8,3,14,16,1,0,8,-8,1,1,1,0,0,0,0,0,0,0.5179608869977906,0.48203911300220936
90632,0.6923076923076923,0.35211267605633806,-225,184,0.6615551295941329,0.3384448704058671,home,MIN,under,7.5,0.504950495049505,-102,0.48203911300220936,MIN,OAK,2023 REG,8,11,8,3,14,16,1,0,8,-8,1,1,1,0,0,0,0,0,0,0.5179608869977906,0.48203911300220936
90634,0.574468085106383,0.4629629629629629,-135,116,0.5529651425984609,0.44703485740153914,away,CLE,over,8.5,0.5391705069124424,-117,0.5140669063204599,CWS,CLE,2023 REG,12,7,6,2,9,18,1,0,5,-5,1,1,0,0,0,0,0,0,0,0.5140669063204599,0.4859330936795401
90634,0.574468085106383,0.4629629629629629,-135,116,0.5529651425984609,0.44703485740153914,home,CWS,under,8.5,0.5073891625615764,-103,0.4859330936795401,CWS,CLE,2023 REG,12,7,6,2,9,18,1,0,5,-5,1,1,0,0,0,0,0,0,0,0.5140669063204599,0.4859330936795401
90635,0.6666666666666666,0.37037037037037035,-200,170,0.6419753086419753,0.3580246913580247,away,STL,over,10.5,0.5121951219512195,-105,0.48808156828023186,ATL,STL,2023 REG,11,6,12,10,16,23,0,1,-4,4,1,1,1,1,1,1,0,0,0,0.48808156828023186,0.5119184317197681
90635,0.6666666666666666,0.37037037037037035,-200,170,0.6419753086419753,0.3580246913580247,home,ATL,under,10.5,0.5348837209302326,-115,0.5119184317197681,ATL,STL,2023 REG,11,6,12,10,16,23,0,1,-4,4,1,1,1,1,1,1,0,0,0,0.48808156828023186,0.5119184317197681
90636,0.48780487804878053,0.5555555555555556,105,-125,0.4666534470222751,0.5333465529777248,away,NYM,over,9,0.5283018867924528,-112,0.5044173060022736,SF,NYM,2023 REG,8,5,8,4,9,16,1,0,1,-1,1,1,1,1,0,0,0,0,0,0.5044173060022736,0.49558269399772636
90636,0.48780487804878053,0.5555555555555556,105,-125,0.4666534470222751,0.5333465529777248,home,SF,under,9,0.5169082125603864,-107,0.49558269399772636,SF,NYM,2023 REG,8,5,8,4,9,16,1,0,1,-1,1,1,1,1,0,0,0,0,0,0.5044173060022736,0.49558269399772636
90637,0.5475113122171946,0.49504950495049505,-121,102,0.5242087833606768,0.4757912166393232,away,HOU,over,7.5,0.5454545454545454,-120,0.5206611570247933,SEA,HOU,2023 REG,8,6,10,2,8,18,1,0,4,-4,1,1,0,0,0,0,0,0,0,0.5206611570247933,0.4793388429752067
90637,0.5475113122171946,0.49504950495049505,-121,102,0.5242087833606768,0.4757912166393232,home,SEA,under,7.5,0.5,100,0.4793388429752067,SEA,HOU,2023 REG,8,6,10,2,8,18,1,0,4,-4,1,1,0,0,0,0,0,0,0,0.5206611570247933,0.4793388429752067
90638,0.5073891625615764,0.5327102803738317,-103,-114,0.487043139791394,0.512956860208606,away,NYY,over,9,0.5370370370370371,-116,0.5118817074154765,BOS,NYY,2023 REG,11,6,4,2,8,15,1,0,4,-4,1,1,0,0,0,0,0,0,0,0.5118817074154765,0.48811829258452355
90638,0.5073891625615764,0.5327102803738317,-103,-114,0.487043139791394,0.512956860208606,home,BOS,under,9,0.5098039215686274,-104,0.48811829258452355,BOS,NYY,2023 REG,11,6,4,2,8,15,1,0,4,-4,1,1,0,0,0,0,0,0,0,0.5118817074154765,0.48811829258452355
90639,0.49504950495049505,0.5454545454545454,102,-120,0.47499799484898986,0.5250020051510101,away,SEA,over,8,0.5348837209302326,-115,0.5097020142727117,BAL,SEA,2023 REG,7,3,3,2,5,10,1,0,1,-1,1,1,0,0,0,0,0,0,0,0.5097020142727117,0.49029798572728833
90639,0.49504950495049505,0.5454545454545454,102,-120,0.47499799484898986,0.5250020051510101,home,BAL,under,8,0.5121951219512195,-105,0.49029798572728833,BAL,SEA,2023 REG,7,3,3,2,5,10,1,0,1,-1,1,1,0,0,0,0,0,0,0,0.5097020142727117,0.49029798572728833
90640,0.5348837209302326,0.5098039215686274,-115,-104,0.5109810284308424,0.48901897156915763,away,PHI,over,8.5,0.5215311004784688,-109,0.49670754937970685,MIA,PHI,2023 REG,7,2,6,4,6,13,0,1,-2,2,1,1,0,0,0,0,0,0,0,0.49670754937970685,0.5032924506202932
90640,0.5348837209302326,0.5098039215686274,-115,-104,0.5109810284308424,0.48901897156915763,home,MIA,under,8.5,0.5260663507109005,-111,0.5032924506202932,MIA,PHI,2023 REG,7,2,6,4,6,13,0,1,-2,2,1,1,0,0,0,0,0,0,0,0.49670754937970685,0.5032924506202932
90641,0.4854368932038835,0.5555555555555556,106,-125,0.465537646233282,0.534462353766718,away,TOR,over,8.5,0.5433789954337899,-119,0.5198077604720502,BAL,TOR,2023 REG,17,11,15,6,17,32,1,0,5,-5,1,1,1,1,1,1,0,0,0,0.5198077604720502,0.48019223952794976
90641,0.4854368932038835,0.5555555555555556,106,-125,0.465537646233282,0.534462353766718,home,BAL,under,8.5,0.5,100,0.48019223952794976,BAL,TOR,2023 REG,17,11,15,6,17,32,1,0,5,-5,1,1,1,1,1,1,0,0,0,0.5198077604720502,0.48019223952794976
90642,0.6721311475409836,0.37037037037037035,-205,170,0.6435645535349916,0.35643544646500835,away,CLE,over,8.5,0.5238095238095238,-110,0.4988662131519274,CHC,CLE,2023 REG,13,10,5,1,11,18,1,0,9,-9,1,0,0,0,0,0,0,0,0,0.4988662131519274,0.5011337868480725
90642,0.6721311475409836,0.37037037037037035,-205,170,0.6435645535349916,0.35643544646500835,home,CHC,under,8.5,0.5238095238095238,-110,0.5011337868480725,CHC,CLE,2023 REG,13,10,5,1,11,18,1,0,9,-9,1,0,0,0,0,0,0,0,0,0.4988662131519274,0.5011337868480725
90643,0.4716981132075471,0.5689655172413793,112,-132,0.45251715544861953,0.5474828445513804,away,ATL,over,8.5,0.5495495495495495,-122,0.5250401592387142,PHI,ATL,2023 REG,4,1,6,5,6,10,0,1,-4,4,1,0,0,0,0,0,0,0,0,0.5250401592387142,0.47495984076128583
90643,0.4716981132075471,0.5689655172413793,112,-132,0.45251715544861953,0.5474828445513804,home,PHI,under,8.5,0.49504950495049505,102,0.47495984076128583,PHI,ATL,2023 REG,4,1,6,5,6,10,0,1,-4,4,1,0,0,0,0,0,0,0,0,0.5250401592387142,0.47495984076128583
90644,0.4629629629629629,0.5833333333333333,116,-140,0.44152949245541834,0.5584705075445817,away,CLE,over,9,0.5370370370370371,-116,0.5118817074154765,LAA,CLE,2023 REG,6,6,4,2,8,10,1,0,4,-4,1,1,0,0,0,0,0,0,0,0.5118817074154765,0.48811829258452355
90644,0.4629629629629629,0.5833333333333333,116,-140,0.44152949245541834,0.5584705075445817,home,LAA,under,9,0.5098039215686274,-104,0.48811829258452355,LAA,CLE,2023 REG,6,6,4,2,8,10,1,0,4,-4,1,1,0,0,0,0,0,0,0,0.5118817074154765,0.48811829258452355
90645,0.5884773662551441,0.45454545454545453,-143,120,0.5631594099815408,0.4368405900184592,away,MIA,over,9,0.5024875621890548,-101,0.4794401874631478,PHI,MIA,2023 REG,5,2,7,3,5,12,0,1,-1,1,1,1,0,0,0,0,0,0,0,0.4794401874631478,0.5205598125368522
90645,0.5884773662551441,0.45454545454545453,-143,120,0.5631594099815408,0.4368405900184592,home,PHI,under,9,0.5433789954337899,-119,0.5205598125368522,PHI,MIA,2023 REG,5,2,7,3,5,12,0,1,-1,1,1,1,0,0,0,0,0,0,0,0.4794401874631478,0.5205598125368522
90646,0.46511627906976744,0.574468085106383,115,-135,0.44670494689481377,0.5532950531051862,away,NYY,over,8.5,0.5348837209302326,-115,0.5097020142727117,CIN,NYY,2023 REG,6,1,6,4,5,12,0,1,-3,3,1,0,0,0,0,0,0,0,0,0.5097020142727117,0.49029798572728833
90646,0.46511627906976744,0.574468085106383,115,-135,0.44670494689481377,0.5532950531051862,home,CIN,under,8.5,0.5121951219512195,-105,0.49029798572728833,CIN,NYY,2023 REG,6,1,6,4,5,12,0,1,-3,3,1,0,0,0,0,0,0,0,0,0.5097020142727117,0.49029798572728833
90647,0.5884773662551441,0.45248868778280543,-143,121,0.5643697706690257,0.4356302293309743,away,NYY,over,8,0.5215311004784688,-109,0.4978845547971712,MIA,NYY,2023 REG,6,4,14,9,13,20,0,1,-5,5,1,1,1,1,0,0,0,0,0,0.4978845547971712,0.5021154452028288
90647,0.5884773662551441,0.45248868778280543,-143,121,0.5643697706690257,0.4356302293309743,home,MIA,under,8,0.5238095238095238,-110,0.5021154452028288,MIA,NYY,2023 REG,6,4,14,9,13,20,0,1,-5,5,1,1,1,1,0,0,0,0,0,0.4978845547971712,0.5021154452028288
90648,0.5192307692307692,0.5215311004784688,-108,-109,0.49806595226635714,0.5019340477336429,away,LAD,over,9.5,0.5192307692307692,-108,0.49455035168025013,SD,LAD,2023 REG,7,2,12,8,10,19,0,1,-6,6,1,1,0,0,0,0,0,0,0,0.49455035168025013,0.5054496483197499
90648,0.5192307692307692,0.5215311004784688,-108,-109,0.49806595226635714,0.5019340477336429,home,SD,under,9.5,0.5283018867924528,-112,0.5054496483197499,SD,LAD,2023 REG,7,2,12,8,10,19,0,1,-6,6,1,1,0,0,0,0,0,0,0,0.49455035168025013,0.5054496483197499
90649,0.6610169491525424,0.3802281368821293,-195,163,0.6337532482143695,0.3662467517856305,away,MIL,over,9.5,0.5,100,0.4772727272727273,PHI,MIL,2023 REG,12,4,4,3,7,16,1,0,1,-1,1,1,1,0,0,0,0,0,0,0.4772727272727273,0.5227272727272727
90649,0.6610169491525424,0.3802281368821293,-195,163,0.6337532482143695,0.3662467517856305,home,PHI,under,9.5,0.5454545454545454,-120,0.5227272727272727,PHI,MIL,2023 REG,12,4,4,3,7,16,1,0,1,-1,1,1,1,0,0,0,0,0,0,0.4772727272727273,0.5227272727272727
90650,0.6226415094339623,0.4166666666666667,-165,140,0.5981666073335706,0.40183339266642937,away,PIT,over,8.5,0.5348837209302326,-115,0.5097020142727117,TB,PIT,2023 REG,6,4,5,1,5,11,1,0,3,-3,1,0,0,0,0,0,0,0,0,0.5097020142727117,0.49029798572728833
90650,0.6226415094339623,0.4166666666666667,-165,140,0.5981666073335706,0.40183339266642937,home,TB,under,8.5,0.5121951219512195,-105,0.49029798572728833,TB,PIT,2023 REG,6,4,5,1,5,11,1,0,3,-3,1,0,0,0,0,0,0,0,0,0.5097020142727117,0.49029798572728833
90651,0.576271186440678,0.45454545454545453,-136,120,0.5585124441774829,0.4414875558225171,away,SEA,over,8.5,0.5073891625615764,-103,0.4837652908580103,CLE,SEA,2023 REG,9,2,11,3,5,20,0,1,-1,1,1,1,0,0,0,0,0,0,0,0.4837652908580103,0.5162347091419897
90651,0.576271186440678,0.45454545454545453,-136,120,0.5585124441774829,0.4414875558225171,home,CLE,under,8.5,0.5391705069124424,-117,0.5162347091419897,CLE,SEA,2023 REG,9,2,11,3,5,20,0,1,-1,1,1,1,0,0,0,0,0,0,0,0.4837652908580103,0.5162347091419897
90652,0.6000000000000001,0.4347826086956522,-150,130,0.5791304347826086,0.4208695652173914,away,HOU,over,9,0.5454545454545454,-120,0.5220180091279142,TOR,HOU,2023 REG,5,3,5,2,5,10,1,0,1,-1,1,1,0,0,0,0,0,0,0,0.5220180091279142,0.4779819908720858
90652,0.6000000000000001,0.4347826086956522,-150,130,0.5791304347826086,0.4208695652173914,home,TOR,under,9,0.49751243781094534,101,0.4779819908720858,TOR,HOU,2023 REG,5,3,5,2,5,10,1,0,1,-1,1,1,0,0,0,0,0,0,0,0.5220180091279142,0.4779819908720858
90653,0.576271186440678,0.46511627906976744,-136,115,0.552420782587201,0.44757921741279905,away,TEX,over,9,0.5,100,0.4772727272727273,HOU,TEX,2023 REG,8,4,9,3,7,17,1,0,1,-1,1,1,1,0,0,0,0,0,0,0.4772727272727273,0.5227272727272727
90653,0.576271186440678,0.46511627906976744,-136,115,0.552420782587201,0.44757921741279905,home,HOU,under,9,0.5454545454545454,-120,0.5227272727272727,HOU,TEX,2023 REG,8,4,9,3,7,17,1,0,1,-1,1,1,1,0,0,0,0,0,0,0.4772727272727273,0.5227272727272727
90654,0.43103448275862066,0.607843137254902,132,-155,0.4142768879252058,0.5857231120747942,away,LAD,over,9.5,0.5,100,0.4772727272727273,ARI,LAD,2023 REG,10,4,9,5,9,19,0,1,-1,1,1,1,1,1,0,0,0,0,0,0.4772727272727273,0.5227272727272727
90654,0.43103448275862066,0.607843137254902,132,-155,0.4142768879252058,0.5857231120747942,home,ARI,under,9.5,0.5454545454545454,-120,0.5227272727272727,ARI,LAD,2023 REG,10,4,9,5,9,19,0,1,-1,1,1,1,1,1,0,0,0,0,0,0.4772727272727273,0.5227272727272727
90655,0.607843137254902,0.4329004329004329,-155,131,0.583077437748718,0.416922562251282,away,TEX,over,7.5,0.5215311004784688,-109,0.4978845547971712,TOR,TEX,2023 REG,4,2,11,9,11,15,0,1,-7,7,1,1,0,0,0,0,0,0,0,0.4978845547971712,0.5021154452028288
90655,0.607843137254902,0.4329004329004329,-155,131,0.583077437748718,0.416922562251282,home,TOR,under,7.5,0.5238095238095238,-110,0.5021154452028288,TOR,TEX,2023 REG,4,2,11,9,11,15,0,1,-7,7,1,1,0,0,0,0,0,0,0,0.4978845547971712,0.5021154452028288
90656,0.6296296296296295,0.40322580645161293,-170,148,0.6089428735784769,0.3910571264215231,away,OAK,over,10.5,0.5412844036697247,-118,0.5149381613977361,KC,OAK,2023 REG,7,4,9,5,9,16,0,1,-1,1,1,1,1,1,0,0,0,0,0,0.5149381613977361,0.48506183860226393
90656,0.6296296296296295,0.40322580645161293,-170,148,0.6089428735784769,0.3910571264215231,home,KC,under,10.5,0.5073891625615764,-103,0.48506183860226393,KC,OAK,2023 REG,7,4,9,5,9,16,0,1,-1,1,1,1,1,1,0,0,0,0,0,0.5149381613977361,0.48506183860226393
90657,0.49751243781094534,0.5348837209302326,101,-115,0.4813949458999116,0.5186050541000884,away,SD,over,8,0.5391705069124424,-117,0.5140669063204599,SF,SD,2023 REG,6,7,10,4,11,16,1,0,3,-3,1,1,1,1,0,0,0,0,0,0.5140669063204599,0.4859330936795401
90657,0.49751243781094534,0.5348837209302326,101,-115,0.4813949458999116,0.5186050541000884,home,SF,under,8,0.5073891625615764,-103,0.4859330936795401,SF,SD,2023 REG,6,7,10,4,11,16,1,0,3,-3,1,1,1,1,0,0,0,0,0,0.5140669063204599,0.4859330936795401
90658,0.5348837209302326,0.5073891625615764,-115,-103,0.5122726437136835,0.48772735628631647,away,PHI,over,9,0.5,100,0.4772727272727273,SF,PHI,2023 REG,10,6,6,3,9,16,1,0,3,-3,1,1,1,0,0,0,0,0,0,0.4772727272727273,0.5227272727272727
90658,0.5348837209302326,0.5073891625615764,-115,-103,0.5122726437136835,0.48772735628631647,home,SF,under,9,0.5454545454545454,-120,0.5227272727272727,SF,PHI,2023 REG,10,6,6,3,9,16,1,0,3,-3,1,1,1,0,0,0,0,0,0,0.4772727272727273,0.5227272727272727
90659,0.5327102803738317,0.5169082125603864,-114,-107,0.5062779990911175,0.4937220009088825,away,PHI,over,8,0.5121951219512195,-105,0.48808156828023186,NYM,PHI,2023 REG,10,11,8,4,15,18,1,0,7,-7,1,1,1,1,0,0,0,0,0,0.48808156828023186,0.5119184317197681
90659,0.5327102803738317,0.5169082125603864,-114,-107,0.5062779990911175,0.4937220009088825,home,NYM,under,8,0.5348837209302326,-115,0.5119184317197681,NYM,PHI,2023 REG,10,11,8,4,15,18,1,0,7,-7,1,1,1,1,0,0,0,0,0,0.48808156828023186,0.5119184317197681
90660,0.6153846153846154,0.425531914893617,-160,135,0.5902052121364724,0.40979478786352763,away,CHC,over,9,0.5121951219512195,-105,0.48808156828023186,PHI,CHC,2023 REG,13,12,6,3,15,19,1,0,9,-9,1,1,1,0,0,0,0,0,0,0.48808156828023186,0.5119184317197681
90660,0.6153846153846154,0.425531914893617,-160,135,0.5902052121364724,0.40979478786352763,home,PHI,under,9,0.5348837209302326,-115,0.5119184317197681,PHI,CHC,2023 REG,13,12,6,3,15,19,1,0,9,-9,1,1,1,0,0,0,0,0,0,0.48808156828023186,0.5119184317197681
90661,0.5652173913043479,0.47619047619047616,-130,110,0.5418129444594474,0.4581870555405526,away,CHC,over,9,0.5412844036697247,-118,0.5189377998484975,LAA,CHC,2023 REG,8,3,5,1,4,13,1,0,2,-2,1,0,0,0,0,0,0,0,0,0.5189377998484975,0.4810622001515025
90661,0.5652173913043479,0.47619047619047616,-130,110,0.5418129444594474,0.4581870555405526,home,LAA,under,9,0.5,100,0.4810622001515025,LAA,CHC,2023 REG,8,3,5,1,4,13,1,0,2,-2,1,0,0,0,0,0,0,0,0,0.5189377998484975,0.4810622001515025
90662,0.7333333333333333,0.3076923076923077,-275,225,0.7032478632478633,0.29675213675213674,away,COL,over,8,0.5145631067961165,-106,0.49023796582517226,SF,COL,2023 REG,13,9,7,1,10,20,1,0,8,-8,1,0,0,0,0,0,0,0,0,0.49023796582517226,0.5097620341748277
90662,0.7333333333333333,0.3076923076923077,-275,225,0.7032478632478633,0.29675213675213674,home,SF,under,8,0.5327102803738317,-114,0.5097620341748277,SF,COL,2023 REG,13,9,7,1,10,20,1,0,8,-8,1,0,0,0,0,0,0,0,0,0.49023796582517226,0.5097620341748277
90663,0.43103448275862066,0.609375,132,-156,0.41361660225921526,0.5863833977407847,away,MIA,over,8.5,0.5238095238095238,-110,0.4988662131519274,WSH,MIA,2023 REG,3,1,13,6,7,16,0,1,-5,5,1,0,0,0,0,0,0,0,0,0.4988662131519274,0.5011337868480725
90663,0.43103448275862066,0.609375,132,-156,0.41361660225921526,0.5863833977407847,home,WSH,under,8.5,0.5238095238095238,-110,0.5011337868480725,WSH,MIA,2023 REG,3,1,13,6,7,16,0,1,-5,5,1,0,0,0,0,0,0,0,0,0.4988662131519274,0.5011337868480725
90664,0.6031746031746031,0.44052863436123346,-152,127,0.5768139202164795,0.4231860797835205,away,KC,over,9,0.5475113122171946,-121,0.5228602997583487,CWS,KC,2023 REG,5,1,10,7,8,15,0,1,-6,6,1,0,0,0,0,0,0,0,0,0.5228602997583487,0.4771397002416513
90664,0.6031746031746031,0.44052863436123346,-152,127,0.5768139202164795,0.4231860797835205,home,CWS,under,9,0.49751243781094534,101,0.4771397002416513,CWS,KC,2023 REG,5,1,10,7,8,15,0,1,-6,6,1,0,0,0,0,0,0,0,0,0.5228602997583487,0.4771397002416513
90665,0.5169082125603864,0.5238095238095238,-107,-110,0.49586088023391106,0.5041391197660889,away,LAD,over,9.5,0.5192307692307692,-108,0.49455035168025013,BAL,LAD,2023 REG,7,4,11,6,10,18,0,1,-2,2,1,1,1,1,0,0,0,0,0,0.49455035168025013,0.5054496483197499
90665,0.5169082125603864,0.5238095238095238,-107,-110,0.49586088023391106,0.5041391197660889,home,BAL,under,9.5,0.5283018867924528,-112,0.5054496483197499,BAL,LAD,2023 REG,7,4,11,6,10,18,0,1,-2,2,1,1,1,1,0,0,0,0,0,0.49455035168025013,0.5054496483197499
90666,0.6515679442508712,0.390625,-187,156,0.6240763743034393,0.3759236256965607,away,OAK,over,9.5,0.5121951219512195,-105,0.48808156828023186,PIT,OAK,2023 REG,9,5,17,9,14,26,0,1,-4,4,1,1,1,1,1,0,0,0,0,0.48808156828023186,0.5119184317197681
90666,0.6515679442508712,0.390625,-187,156,0.6240763743034393,0.3759236256965607,home,PIT,under,9.5,0.5348837209302326,-115,0.5119184317197681,PIT,OAK,2023 REG,9,5,17,9,14,26,0,1,-4,4,1,1,1,1,1,0,0,0,0,0.48808156828023186,0.5119184317197681
90667,0.47619047619047616,0.5652173913043479,110,-130,0.4564724440500838,0.5435275559499162,away,BOS,over,8.5,0.5238095238095238,-110,0.5000596729920038,ARI,BOS,2023 REG,7,2,14,7,9,21,0,1,-5,5,1,1,0,0,0,0,0,0,0,0.5000596729920038,0.4999403270079962
90667,0.47619047619047616,0.5652173913043479,110,-130,0.4564724440500838,0.5435275559499162,home,ARI,under,8.5,0.5215311004784688,-109,0.4999403270079962,ARI,BOS,2023 REG,7,2,14,7,9,21,0,1,-5,5,1,1,0,0,0,0,0,0,0,0.5000596729920038,0.4999403270079962
90668,0.48780487804878053,0.5555555555555556,105,-125,0.4666534470222751,0.5333465529777248,away,CIN,over,11,0.5121951219512195,-105,0.48808156828023186,COL,CIN,2023 REG,12,9,12,8,17,24,1,0,1,-1,1,1,1,1,1,1,1,1,0,0.48808156828023186,0.5119184317197681
90668,0.48780487804878053,0.5555555555555556,105,-125,0.4666534470222751,0.5333465529777248,home,COL,under,11,0.5348837209302326,-115,0.5119184317197681,COL,CIN,2023 REG,12,9,12,8,17,24,1,0,1,-1,1,1,1,1,1,1,1,1,0,0.48808156828023186,0.5119184317197681
90669,0.4504504504504505,0.5833333333333333,122,-140,0.43523252982712446,0.5647674701728755,away,TB,over,9.5,0.5,100,0.4772727272727273,CWS,TB,2023 REG,4,3,11,12,15,15,0,1,-9,9,1,1,1,0,0,0,0,0,0,0.4772727272727273,0.5227272727272727
90669,0.4504504504504505,0.5833333333333333,122,-140,0.43523252982712446,0.5647674701728755,home,CWS,under,9.5,0.5454545454545454,-120,0.5227272727272727,CWS,TB,2023 REG,4,3,11,12,15,15,0,1,-9,9,1,1,1,0,0,0,0,0,0,0.4772727272727273,0.5227272727272727
90670,0.7058823529411764,0.3333333333333333,-240,200,0.6782006920415226,0.32179930795847744,away,OAK,over,8.5,0.5215311004784688,-109,0.4978845547971712,TEX,OAK,2023 REG,7,4,8,5,9,15,0,1,-1,1,1,1,1,1,0,0,0,0,0,0.4978845547971712,0.5021154452028288
90670,0.7058823529411764,0.3333333333333333,-240,200,0.6782006920415226,0.32179930795847744,home,TEX,under,8.5,0.5238095238095238,-110,0.5021154452028288,TEX,OAK,2023 REG,7,4,8,5,9,15,0,1,-1,1,1,1,1,1,0,0,0,0,0,0.4978845547971712,0.5021154452028288
90671,0.5098039215686274,0.5327102803738317,-104,-114,0.4881300146960012,0.5118699853039987,away,TEX,over,8.5,0.5073891625615764,-103,0.4826927225525911,TOR,TEX,2023 REG,7,3,9,6,9,16,0,1,-3,3,1,1,1,0,0,0,0,0,0,0.4826927225525911,0.5173072774474089
90671,0.5098039215686274,0.5327102803738317,-104,-114,0.4881300146960012,0.5118699853039987,home,TOR,under,8.5,0.5412844036697247,-118,0.5173072774474089,TOR,TEX,2023 REG,7,3,9,6,9,16,0,1,-3,3,1,1,1,0,0,0,0,0,0,0.4826927225525911,0.5173072774474089
90672,0.5726495726495727,0.4672897196261683,-134,114,0.5497783539959433,0.4502216460040567,away,COL,over,9.5,0.49751243781094534,101,0.47511256217505476,WSH,COL,2023 REG,10,6,15,5,11,25,1,0,1,-1,1,1,1,1,1,0,0,0,0,0.47511256217505476,0.5248874378249453
90672,0.5726495726495727,0.4672897196261683,-134,114,0.5497783539959433,0.4502216460040567,home,WSH,under,9.5,0.5475113122171946,-121,0.5248874378249453,WSH,COL,2023 REG,10,6,15,5,11,25,1,0,1,-1,1,1,1,1,1,0,0,0,0,0.47511256217505476,0.5248874378249453
90673,0.7802197802197802,0.26666666666666666,-355,275,0.7436380469347502,0.2563619530652498,away,COL,over,8.5,0.5348837209302326,-115,0.5097020142727117,LAD,COL,2023 REG,10,8,5,3,11,15,1,0,5,-5,1,1,1,0,0,0,0,0,0,0.5097020142727117,0.49029798572728833
90673,0.7802197802197802,0.26666666666666666,-355,275,0.7436380469347502,0.2563619530652498,home,LAD,under,8.5,0.5121951219512195,-105,0.49029798572728833,LAD,COL,2023 REG,10,8,5,3,11,15,1,0,5,-5,1,1,1,0,0,0,0,0,0,0.5097020142727117,0.49029798572728833
90674,0.4,0.6363636363636364,150,-175,0.3854545454545455,0.6145454545454545,away,PHI,over,9.5,0.504950495049505,-102,0.4826715732667395,OAK,PHI,2023 REG,9,2,9,3,5,18,0,1,-1,1,1,1,0,0,0,0,0,0,0,0.4826715732667395,0.5173284267332605
90674,0.4,0.6363636363636364,150,-175,0.3854545454545455,0.6145454545454545,home,OAK,under,9.5,0.5391705069124424,-117,0.5173284267332605,OAK,PHI,2023 REG,9,2,9,3,5,18,0,1,-1,1,1,1,0,0,0,0,0,0,0,0.4826715732667395,0.5173284267332605
90675,0.5,0.5391705069124424,100,-117,0.4804147465437788,0.5195852534562212,away,NYY,over,8,0.5121951219512195,-105,0.48808156828023186,TOR,NYY,2023 REG,10,3,3,0,3,13,1,0,3,-3,0,0,0,0,0,0,0,0,0,0.48808156828023186,0.5119184317197681
90675,0.5,0.5391705069124424,100,-117,0.4804147465437788,0.5195852534562212,home,TOR,under,8,0.5348837209302326,-115,0.5119184317197681,TOR,NYY,2023 REG,10,3,3,0,3,13,1,0,3,-3,0,0,0,0,0,0,0,0,0,0.48808156828023186,0.5119184317197681
90676,0.3921568627450981,0.6491228070175439,155,-185,0.37596875695582666,0.6240312430441733,away,TEX,over,9,0.5348837209302326,-115,0.5097020142727117,LAA,TEX,2023 REG,8,1,9,5,6,17,0,1,-4,4,1,0,0,0,0,0,0,0,0,0.5097020142727117,0.49029798572728833
90676,0.3921568627450981,0.6491228070175439,155,-185,0.37596875695582666,0.6240312430441733,home,LAA,under,9,0.5121951219512195,-105,0.49029798572728833,LAA,TEX,2023 REG,8,1,9,5,6,17,0,1,-4,4,1,0,0,0,0,0,0,0,0,0.5097020142727117,0.49029798572728833
90677,0.5,0.5433789954337899,100,-119,0.4783105022831051,0.5216894977168949,away,ARI,over,7,0.5454545454545454,-120,0.5206611570247933,CHC,ARI,2023 REG,3,0,4,1,1,7,0,1,-1,1,0,0,0,0,0,0,0,0,0,0.5206611570247933,0.4793388429752067
90677,0.5,0.5433789954337899,100,-119,0.4783105022831051,0.5216894977168949,home,CHC,under,7,0.5,100,0.4793388429752067,CHC,ARI,2023 REG,3,0,4,1,1,7,0,1,-1,1,0,0,0,0,0,0,0,0,0,0.5206611570247933,0.4793388429752067
90678,0.3861003861003861,0.6491228070175439,159,-185,0.3725006976378649,0.6274993023621351,away,PHI,over,9,0.5412844036697247,-118,0.5149381613977361,PIT,PHI,2023 REG,11,7,8,6,13,19,1,0,1,-1,1,1,1,1,1,1,0,0,0,0.5149381613977361,0.48506183860226393
90678,0.3861003861003861,0.6491228070175439,159,-185,0.3725006976378649,0.6274993023621351,home,PIT,under,9,0.5073891625615764,-103,0.48506183860226393,PIT,PHI,2023 REG,11,7,8,6,13,19,1,0,1,-1,1,1,1,1,1,1,0,0,0,0.5149381613977361,0.48506183860226393
90679,0.6363636363636364,0.4081632653061224,-175,145,0.6080283353010626,0.3919716646989374,away,SEA,over,8.5,0.5098039215686274,-104,0.48592421718142587,SF,SEA,2023 REG,8,2,7,0,2,15,1,0,2,-2,0,0,0,0,0,0,0,0,0,0.48592421718142587,0.5140757828185741
90679,0.6363636363636364,0.4081632653061224,-175,145,0.6080283353010626,0.3919716646989374,home,SF,under,8.5,0.5370370370370371,-116,0.5140757828185741,SF,SEA,2023 REG,8,2,7,0,2,15,1,0,2,-2,0,0,0,0,0,0,0,0,0,0.48592421718142587,0.5140757828185741
90680,0.6503496503496503,0.3921568627450981,-186,155,0.6227055544208978,0.3772944455791022,away,KC,over,8,0.5238095238095238,-110,0.4988662131519274,MIA,KC,2023 REG,8,6,3,1,7,11,1,0,5,-5,1,0,0,0,0,0,0,0,0,0.4988662131519274,0.5011337868480725
90680,0.6503496503496503,0.3921568627450981,-186,155,0.6227055544208978,0.3772944455791022,home,MIA,under,8,0.5238095238095238,-110,0.5011337868480725,MIA,KC,2023 REG,8,6,3,1,7,11,1,0,5,-5,1,0,0,0,0,0,0,0,0,0.4988662131519274,0.5011337868480725
90681,0.6551724137931035,0.3861003861003861,-190,159,0.6281316138628862,0.3718683861371138,away,NYM,over,7.5,0.5121951219512195,-105,0.48808156828023186,PHI,NYM,2023 REG,11,7,9,5,12,20,1,0,2,-2,1,1,1,1,1,0,0,0,0,0.48808156828023186,0.5119184317197681
90681,0.6551724137931035,0.3861003861003861,-190,159,0.6281316138628862,0.3718683861371138,home,PHI,under,7.5,0.5348837209302326,-115,0.5119184317197681,PHI,NYM,2023 REG,11,7,9,5,12,20,1,0,2,-2,1,1,1,1,1,0,0,0,0,0.48808156828023186,0.5119184317197681
90682,0.4566210045662101,0.5833333333333333,119,-140,0.4383770146577428,0.5616229853422572,away,MIL,over,8,0.5370370370370371,-116,0.5118817074154765,PIT,MIL,2023 REG,7,8,12,11,19,19,0,1,-3,3,1,1,1,1,1,1,1,1,0,0.5118817074154765,0.48811829258452355
90682,0.4566210045662101,0.5833333333333333,119,-140,0.4383770146577428,0.5616229853422572,home,PIT,under,8,0.5098039215686274,-104,0.48811829258452355,PIT,MIL,2023 REG,7,8,12,11,19,19,0,1,-3,3,1,1,1,1,1,1,1,1,0,0.5118817074154765,0.48811829258452355
90683,0.5555555555555556,0.47619047619047616,-125,110,0.5379188712522047,0.4620811287477953,away,TEX,over,9.5,0.5238095238095238,-110,0.4988662131519274,LAA,TEX,2023 REG,13,8,17,16,24,30,0,1,-8,8,1,1,1,1,1,1,1,1,0,0.4988662131519274,0.5011337868480725
90683,0.5555555555555556,0.47619047619047616,-125,110,0.5379188712522047,0.4620811287477953,home,LAA,under,9.5,0.5238095238095238,-110,0.5011337868480725,LAA,TEX,2023 REG,13,8,17,16,24,30,0,1,-8,8,1,1,1,1,1,1,1,1,0,0.4988662131519274,0.5011337868480725
90684,0.7175141242937854,0.33112582781456956,-254,202,0.6826142716510675,0.3173857283489325,away,STL,over,8,0.5454545454545454,-120,0.5179608869977906,MIL,STL,2023 REG,8,3,6,0,3,14,1,0,3,-3,0,0,0,0,0,0,0,0,0,0.5179608869977906,0.48203911300220936
90684,0.7175141242937854,0.33112582781456956,-254,202,0.6826142716510675,0.3173857283489325,home,MIL,under,8,0.504950495049505,-102,0.48203911300220936,MIL,STL,2023 REG,8,3,6,0,3,14,1,0,3,-3,0,0,0,0,0,0,0,0,0,0.5179608869977906,0.48203911300220936
90685,0.5555555555555556,0.4854368932038835,-125,106,0.5327819729114227,0.4672180270885773,away,BAL,over,8.5,0.5454545454545454,-120,0.5220180091279142,BOS,BAL,2023 REG,11,9,15,10,19,26,0,1,-1,1,1,1,1,1,1,1,1,1,1,0.5220180091279142,0.4779819908720858
90685,0.5555555555555556,0.4854368932038835,-125,106,0.5327819729114227,0.4672180270885773,home,BOS,under,8.5,0.49751243781094534,101,0.4779819908720858,BOS,BAL,2023 REG,11,9,15,10,19,26,0,1,-1,1,1,1,1,1,1,1,1,1,1,0.5220180091279142,0.4779819908720858
90686,0.5,0.5348837209302326,100,-115,0.4825581395348837,0.5174418604651163,away,SD,over,8.5,0.5454545454545454,-120,0.5206611570247933,SF,SD,2023 REG,8,4,10,3,7,18,1,0,1,-1,1,1,1,0,0,0,0,0,0,0.5206611570247933,0.4793388429752067
90686,0.5,0.5348837209302326,100,-115,0.4825581395348837,0.5174418604651163,home,SF,under,8.5,0.5,100,0.4793388429752067,SF,SD,2023 REG,8,4,10,3,7,18,1,0,1,-1,1,1,1,0,0,0,0,0,0,0.5206611570247933,0.4793388429752067
90687,0.6742671009771988,0.3597122302158273,-207,178,0.651355955840533,0.34864404415946704,away,OAK,over,8,0.5305164319248826,-113,0.5066009958897986,MIL,OAK,2023 REG,10,6,6,8,14,16,0,1,-2,2,1,1,1,1,1,1,0,0,0,0.5066009958897986,0.49339900411020143
90687,0.6742671009771988,0.3597122302158273,-207,178,0.651355955840533,0.34864404415946704,home,MIL,under,8,0.5145631067961165,-106,0.49339900411020143,MIL,OAK,2023 REG,10,6,6,8,14,16,0,1,-2,2,1,1,1,1,1,1,0,0,0,0.5066009958897986,0.49339900411020143
90688,0.45454545454545453,0.5833333333333333,120,-140,0.43732782369146006,0.5626721763085399,away,PHI,over,9,0.5073891625615764,-103,0.4826927225525911,ARI,PHI,2023 REG,8,3,20,15,18,28,0,1,-12,12,1,1,1,0,0,0,0,0,0,0.4826927225525911,0.5173072774474089
90688,0.45454545454545453,0.5833333333333333,120,-140,0.43732782369146006,0.5626721763085399,home,ARI,under,9,0.5412844036697247,-118,0.5173072774474089,ARI,PHI,2023 REG,8,3,20,15,18,28,0,1,-12,12,1,1,1,0,0,0,0,0,0,0.4826927225525911,0.5173072774474089
90689,0.4444444444444444,0.5934959349593496,125,-146,0.42758205359831375,0.5724179464016863,away,STL,over,10,0.5260663507109005,-111,0.5010269332605688,CWS,STL,2023 REG,7,0,8,3,3,15,0,1,-3,3,0,0,0,0,0,0,0,0,0,0.5010269332605688,0.4989730667394312
90689,0.4444444444444444,0.5934959349593496,125,-146,0.42758205359831375,0.5724179464016863,home,CWS,under,10,0.5215311004784688,-109,0.4989730667394312,CWS,STL,2023 REG,7,0,8,3,3,15,0,1,-3,3,0,0,0,0,0,0,0,0,0,0.5010269332605688,0.4989730667394312
90690,0.3448275862068966,0.7014925373134329,190,-235,0.3288551298205761,0.6711448701794239,away,ATL,over,9.5,0.5238095238095238,-110,0.4988662131519274,WSH,ATL,2023 REG,10,3,6,2,5,16,1,0,1,-1,1,1,0,0,0,0,0,0,0,0.4988662131519274,0.5011337868480725
90690,0.3448275862068966,0.7014925373134329,190,-235,0.3288551298205761,0.6711448701794239,home,WSH,under,9.5,0.5238095238095238,-110,0.5011337868480725,WSH,ATL,2023 REG,10,3,6,2,5,16,1,0,1,-1,1,1,0,0,0,0,0,0,0,0.4988662131519274,0.5011337868480725
90691,0.5555555555555556,0.48780487804878053,-125,105,0.5314664257753688,0.46853357422463116,away,LAA,over,9.5,0.5305164319248826,-113,0.5053568787472517,MIL,LAA,2023 REG,3,0,5,3,3,8,0,1,-3,3,0,0,0,0,0,0,0,0,0,0.5053568787472517,0.49464312125274834
90691,0.5555555555555556,0.48780487804878053,-125,105,0.5314664257753688,0.46853357422463116,home,MIL,under,9.5,0.5169082125603864,-107,0.49464312125274834,MIL,LAA,2023 REG,3,0,5,3,3,8,0,1,-3,3,0,0,0,0,0,0,0,0,0,0.5053568787472517,0.49464312125274834
90692,0.6240601503759399,0.4132231404958678,-166,142,0.6007931342679697,0.39920686573203035,away,LAA,over,13,0.4807692307692307,108,0.44747759758443506,BAL,LAA,2023 REG,10,5,13,6,11,23,0,1,-1,1,1,1,1,1,1,0,0,0,0,0.44747759758443506,0.5525224024155649
90692,0.6240601503759399,0.4132231404958678,-166,142,0.6007931342679697,0.39920686573203035,home,BAL,under,13,0.5884773662551441,-143,0.5525224024155649,BAL,LAA,2023 REG,10,5,13,6,11,23,0,1,-1,1,1,1,1,1,1,0,0,0,0,0.44747759758443506,0.5525224024155649
90693,0.3333333333333333,0.7058823529411764,200,-240,0.32026143790849676,0.6797385620915033,away,HOU,over,7.5,0.5098039215686274,-104,0.48592421718142587,OAK,HOU,2023 REG,7,4,9,6,10,16,0,1,-2,2,1,1,1,1,0,0,0,0,0,0.48592421718142587,0.5140757828185741
90693,0.3333333333333333,0.7058823529411764,200,-240,0.32026143790849676,0.6797385620915033,home,OAK,under,7.5,0.5370370370370371,-116,0.5140757828185741,OAK,HOU,2023 REG,7,4,9,6,10,16,0,1,-2,2,1,1,1,1,0,0,0,0,0,0.48592421718142587,0.5140757828185741
90694,0.607843137254902,0.425531914893617,-155,135,0.5875563408509002,0.41244365914909975,away,CWS,over,8.5,0.5348837209302326,-115,0.5097020142727117,MIN,CWS,2023 REG,10,3,6,1,4,16,1,0,2,-2,1,0,0,0,0,0,0,0,0,0.5097020142727117,0.49029798572728833
90694,0.607843137254902,0.425531914893617,-155,135,0.5875563408509002,0.41244365914909975,home,MIN,under,8.5,0.5121951219512195,-105,0.49029798572728833,MIN,CWS,2023 REG,10,3,6,1,4,16,1,0,2,-2,1,0,0,0,0,0,0,0,0,0.5097020142727117,0.49029798572728833
90695,0.6363636363636364,0.4016064257028112,-175,149,0.6122008695940788,0.3877991304059212,away,COL,over,9.5,0.5348837209302326,-115,0.5097020142727117,ARI,COL,2023 REG,9,5,10,4,9,19,1,0,1,-1,1,1,1,1,0,0,0,0,0,0.5097020142727117,0.49029798572728833
90695,0.6363636363636364,0.4016064257028112,-175,149,0.6122008695940788,0.3877991304059212,home,ARI,under,9.5,0.5121951219512195,-105,0.49029798572728833,ARI,COL,2023 REG,9,5,10,4,9,19,1,0,1,-1,1,1,1,1,0,0,0,0,0,0.5097020142727117,0.49029798572728833
90696,0.5169082125603864,0.5238095238095238,-107,-110,0.49586088023391106,0.5041391197660889,away,PIT,over,8,0.5121951219512195,-105,0.48808156828023186,BAL,PIT,2023 REG,8,0,7,4,4,15,0,1,-4,4,0,0,0,0,0,0,0,0,0,0.48808156828023186,0.5119184317197681
90696,0.5169082125603864,0.5238095238095238,-107,-110,0.49586088023391106,0.5041391197660889,home,BAL,under,8,0.5348837209302326,-115,0.5119184317197681,BAL,PIT,2023 REG,8,0,7,4,4,15,0,1,-4,4,0,0,0,0,0,0,0,0,0,0.48808156828023186,0.5119184317197681
90697,0.6183206106870228,0.4166666666666667,-162,140,0.5966872559874133,0.40331274401258665,away,NYY,over,7.5,0.5,100,0.4772727272727273,NYM,NYY,2023 REG,9,6,11,7,13,20,0,1,-1,1,1,1,1,1,1,1,0,0,0,0.4772727272727273,0.5227272727272727
90697,0.6183206106870228,0.4166666666666667,-162,140,0.5966872559874133,0.40331274401258665,home,NYM,under,7.5,0.5454545454545454,-120,0.5227272727272727,NYM,NYY,2023 REG,9,6,11,7,13,20,0,1,-1,1,1,1,1,1,1,1,0,0,0,0.4772727272727273,0.5227272727272727
90698,0.6666666666666666,0.37037037037037035,-200,170,0.6419753086419753,0.3580246913580247,away,TEX,over,9,0.5073891625615764,-103,0.4826927225525911,SD,TEX,2023 REG,13,5,8,3,8,21,1,0,2,-2,1,1,1,0,0,0,0,0,0,0.4826927225525911,0.5173072774474089
90698,0.6666666666666666,0.37037037037037035,-200,170,0.6419753086419753,0.3580246913580247,home,SD,under,9,0.5412844036697247,-118,0.5173072774474089,SD,TEX,2023 REG,13,5,8,3,8,21,1,0,2,-2,1,1,1,0,0,0,0,0,0,0.4826927225525911,0.5173072774474089
90699,0.6153846153846154,0.42016806722689076,-160,138,0.5935060414698423,0.4064939585301577,away,CIN,over,9,0.5327102803738317,-114,0.508788710910954,PIT,CIN,2023 REG,8,2,8,1,3,16,1,0,1,-1,1,0,0,0,0,0,0,0,0,0.508788710910954,0.491211289089046
90699,0.6153846153846154,0.42016806722689076,-160,138,0.5935060414698423,0.4064939585301577,home,PIT,under,9,0.5121951219512195,-105,0.491211289089046,PIT,CIN,2023 REG,8,2,8,1,3,16,1,0,1,-1,1,0,0,0,0,0,0,0,0,0.508788710910954,0.491211289089046
90700,0.5475113122171946,0.49504950495049505,-121,102,0.5242087833606768,0.4757912166393232,away,NYM,over,9.5,0.5073891625615764,-103,0.4837652908580103,BOS,NYM,2023 REG,10,8,8,6,14,18,1,0,2,-2,1,1,1,1,1,1,0,0,0,0.4837652908580103,0.5162347091419897
90700,0.5475113122171946,0.49504950495049505,-121,102,0.5242087833606768,0.4757912166393232,home,BOS,under,9.5,0.5391705069124424,-117,0.5162347091419897,BOS,NYM,2023 REG,10,8,8,6,14,18,1,0,2,-2,1,1,1,1,1,1,0,0,0,0.4837652908580103,0.5162347091419897
90701,0.607843137254902,0.425531914893617,-155,135,0.5875563408509002,0.41244365914909975,away,BAL,over,7.5,0.5238095238095238,-110,0.4988662131519274,SF,BAL,2023 REG,6,2,4,3,5,10,0,1,-1,1,1,1,0,0,0,0,0,0,0,0.4988662131519274,0.5011337868480725
90701,0.607843137254902,0.425531914893617,-155,135,0.5875563408509002,0.41244365914909975,home,SF,under,7.5,0.5238095238095238,-110,0.5011337868480725,SF,BAL,2023 REG,6,2,4,3,5,10,0,1,-1,1,1,1,0,0,0,0,0,0,0,0.4988662131519274,0.5011337868480725
90702,0.5454545454545454,0.49504950495049505,-120,102,0.5233614270517961,0.4766385729482039,away,NYM,over,7.5,0.5215311004784688,-109,0.4978845547971712,HOU,NYM,2023 REG,5,1,14,11,12,19,0,1,-10,10,1,0,0,0,0,0,0,0,0,0.4978845547971712,0.5021154452028288
90702,0.5454545454545454,0.49504950495049505,-120,102,0.5233614270517961,0.4766385729482039,home,HOU,under,7.5,0.5238095238095238,-110,0.5021154452028288,HOU,NYM,2023 REG,5,1,14,11,12,19,0,1,-10,10,1,0,0,0,0,0,0,0,0,0.4978845547971712,0.5021154452028288
90703,0.425531914893617,0.6108949416342413,135,-157,0.41003112488176247,0.5899688751182375,away,CLE,over,9.5,0.5073891625615764,-103,0.4826927225525911,WSH,CLE,2023 REG,8,3,7,4,7,15,0,1,-1,1,1,1,1,0,0,0,0,0,0,0.4826927225525911,0.5173072774474089
90703,0.425531914893617,0.6108949416342413,135,-157,0.41003112488176247,0.5899688751182375,home,WSH,under,9.5,0.5412844036697247,-118,0.5173072774474089,WSH,CLE,2023 REG,8,3,7,4,7,15,0,1,-1,1,1,1,1,0,0,0,0,0,0,0.4826927225525911,0.5173072774474089
90704,0.6666666666666666,0.37037037037037035,-200,170,0.6419753086419753,0.3580246913580247,away,KC,over,8.5,0.5348837209302326,-115,0.5097020142727117,NYY,KC,2023 REG,5,5,9,4,9,14,1,0,1,-1,1,1,1,1,0,0,0,0,0,0.5097020142727117,0.49029798572728833
90704,0.6666666666666666,0.37037037037037035,-200,170,0.6419753086419753,0.3580246913580247,home,NYY,under,8.5,0.5121951219512195,-105,0.49029798572728833,NYY,KC,2023 REG,5,5,9,4,9,14,1,0,1,-1,1,1,1,1,0,0,0,0,0,0.5097020142727117,0.49029798572728833
90705,0.6047430830039526,0.43103448275862066,-153,132,0.5831068475823175,0.41689315241768254,away,PIT,over,9,0.5169082125603864,-107,0.49353874091423283,BAL,PIT,2023 REG,9,6,7,3,9,16,1,0,3,-3,1,1,1,0,0,0,0,0,0,0.49353874091423283,0.5064612590857671
90705,0.6047430830039526,0.43103448275862066,-153,132,0.5831068475823175,0.41689315241768254,home,BAL,under,9,0.5283018867924528,-112,0.5064612590857671,BAL,PIT,2023 REG,9,6,7,3,9,16,1,0,3,-3,1,1,1,0,0,0,0,0,0,0.49353874091423283,0.5064612590857671
90706,0.5215311004784688,0.5192307692307692,-109,-108,0.50027251771145,0.49972748228855,away,BOS,over,8.5,0.5370370370370371,-116,0.5118817074154765,HOU,BOS,2023 REG,12,5,9,7,12,21,0,1,-2,2,1,1,1,1,1,0,0,0,0,0.5118817074154765,0.48811829258452355
90706,0.5215311004784688,0.5192307692307692,-109,-108,0.50027251771145,0.49972748228855,home,HOU,under,8.5,0.5098039215686274,-104,0.48811829258452355,HOU,BOS,2023 REG,12,5,9,7,12,21,0,1,-2,2,1,1,1,1,1,0,0,0,0,0.5118817074154765,0.48811829258452355
90707,0.7032640949554896,0.3389830508474576,-237,195,0.6735531941979274,0.32644680580207264,away,OAK,over,7.5,0.5433789954337899,-119,0.5171177654451503,MIA,OAK,2023 REG,12,7,6,5,12,18,1,0,2,-2,1,1,1,1,1,0,0,0,0,0.5171177654451503,0.4828822345548497
90707,0.7032640949554896,0.3389830508474576,-237,195,0.6735531941979274,0.32644680580207264,home,MIA,under,7.5,0.504950495049505,-102,0.4828822345548497,MIA,OAK,2023 REG,12,7,6,5,12,18,1,0,2,-2,1,1,1,1,1,0,0,0,0,0.5171177654451503,0.4828822345548497
90708,0.4444444444444444,0.5967741935483871,125,-148,0.42612504978096366,0.5738749502190363,away,MIL,over,8,0.5073891625615764,-103,0.4826927225525911,MIA,MIL,2023 REG,5,1,15,16,17,20,0,1,-15,15,1,0,0,0,0,0,0,0,0,0.4826927225525911,0.5173072774474089
90708,0.4444444444444444,0.5967741935483871,125,-148,0.42612504978096366,0.5738749502190363,home,MIA,under,8,0.5412844036697247,-118,0.5173072774474089,MIA,MIL,2023 REG,5,1,15,16,17,20,0,1,-15,15,1,0,0,0,0,0,0,0,0,0.4826927225525911,0.5173072774474089
90709,0.7183098591549296,0.3225806451612903,-255,210,0.6889378067587716,0.3110621932412284,away,DET,over,8.5,0.5370370370370371,-116,0.5118817074154765,LAD,DET,2023 REG,11,3,6,2,5,17,1,0,1,-1,1,1,0,0,0,0,0,0,0,0.5118817074154765,0.48811829258452355
90709,0.7183098591549296,0.3225806451612903,-255,210,0.6889378067587716,0.3110621932412284,home,LAD,under,8.5,0.5098039215686274,-104,0.48811829258452355,LAD,DET,2023 REG,11,3,6,2,5,17,1,0,1,-1,1,1,0,0,0,0,0,0,0,0.5118817074154765,0.48811829258452355
90710,0.3921568627450981,0.6491228070175439,155,-185,0.37596875695582666,0.6240312430441733,away,CHC,over,8.5,0.5391705069124424,-117,0.5153817639191344,PIT,CHC,2023 REG,6,4,10,5,9,16,0,1,-1,1,1,1,1,1,0,0,0,0,0,0.5153817639191344,0.4846182360808656
90710,0.3921568627450981,0.6491228070175439,155,-185,0.37596875695582666,0.6240312430441733,home,PIT,under,8.5,0.504950495049505,-102,0.4846182360808656,PIT,CHC,2023 REG,6,4,10,5,9,16,0,1,-1,1,1,1,1,1,0,0,0,0,0,0.5153817639191344,0.4846182360808656
90711,0.696969696969697,0.3448275862068966,-230,190,0.6678382571799499,0.33216174282005007,away,WSH,over,9,0.5024875621890548,-101,0.47839724939301687,NYM,WSH,2023 REG,11,5,6,2,7,17,1,0,3,-3,1,1,0,0,0,0,0,0,0,0.47839724939301687,0.5216027506069831
90711,0.696969696969697,0.3448275862068966,-230,190,0.6678382571799499,0.33216174282005007,home,NYM,under,9,0.5454545454545454,-120,0.5216027506069831,NYM,WSH,2023 REG,11,5,6,2,7,17,1,0,3,-3,1,1,0,0,0,0,0,0,0,0.47839724939301687,0.5216027506069831
90712,0.6742671009771988,0.37037037037037035,-207,170,0.6441695225767204,0.35583047742327956,away,STL,over,8.5,0.5495495495495495,-122,0.5250401592387142,SD,STL,2023 REG,18,12,6,2,14,24,1,0,10,-10,1,1,0,0,0,0,0,0,0,0.5250401592387142,0.47495984076128583
90712,0.6742671009771988,0.37037037037037035,-207,170,0.6441695225767204,0.35583047742327956,home,SD,under,8.5,0.49504950495049505,102,0.47495984076128583,SD,STL,2023 REG,18,12,6,2,14,24,1,0,10,-10,1,1,0,0,0,0,0,0,0,0.5250401592387142,0.47495984076128583
90713,0.4587155963302753,0.5833333333333333,118,-140,0.4394270964845833,0.5605729035154168,away,CWS,over,11.5,0.5391705069124424,-117,0.5127649394825569,COL,CWS,2023 REG,8,5,14,10,15,22,0,1,-5,5,1,1,1,1,1,0,0,0,0,0.5127649394825569,0.48723506051744314
90713,0.4587155963302753,0.5833333333333333,118,-140,0.4394270964845833,0.5605729035154168,home,COL,under,11.5,0.5098039215686274,-104,0.48723506051744314,COL,CWS,2023 REG,8,5,14,10,15,22,0,1,-5,5,1,1,1,1,1,0,0,0,0,0.5127649394825569,0.48723506051744314
90714,0.5145631067961165,0.5238095238095238,-106,-110,0.4948179667757384,0.5051820332242616,away,TOR,over,9.5,0.5283018867924528,-112,0.5044173060022736,BOS,TOR,2023 REG,10,4,14,5,9,24,0,1,-1,1,1,1,1,1,0,0,0,0,0,0.5044173060022736,0.49558269399772636
90714,0.5145631067961165,0.5238095238095238,-106,-110,0.4948179667757384,0.5051820332242616,home,BOS,under,9.5,0.5169082125603864,-107,0.49558269399772636,BOS,TOR,2023 REG,10,4,14,5,9,24,0,1,-1,1,1,1,1,1,0,0,0,0,0,0.5044173060022736,0.49558269399772636
90715,0.5,0.5454545454545454,100,-120,0.4772727272727273,0.5227272727272727,away,LAA,over,8,0.5098039215686274,-104,0.48375889301574193,BAL,LAA,2023 REG,6,5,17,9,14,23,0,1,-4,4,1,1,1,1,1,0,0,0,0,0.48375889301574193,0.5162411069842581
90715,0.5,0.5454545454545454,100,-120,0.4772727272727273,0.5227272727272727,home,BAL,under,8,0.5412844036697247,-118,0.5162411069842581,BAL,LAA,2023 REG,6,5,17,9,14,23,0,1,-4,4,1,1,1,1,1,0,0,0,0,0.48375889301574193,0.5162411069842581
90716,0.47619047619047616,0.5652173913043479,110,-130,0.4564724440500838,0.5435275559499162,away,ARI,over,8.5,0.5454545454545454,-120,0.5206611570247933,PIT,ARI,2023 REG,3,3,9,8,11,12,0,1,-5,5,1,1,1,0,0,0,0,0,0,0.5206611570247933,0.4793388429752067
90716,0.47619047619047616,0.5652173913043479,110,-130,0.4564724440500838,0.5435275559499162,home,PIT,under,8.5,0.5,100,0.4793388429752067,PIT,ARI,2023 REG,3,3,9,8,11,12,0,1,-5,5,1,1,1,0,0,0,0,0,0,0.5206611570247933,0.4793388429752067
90717,0.5215311004784688,0.5215311004784688,-109,-109,0.49907282342437215,0.5009271765756278,away,BOS,over,7.5,0.5260663507109005,-111,0.5010269332605688,CLE,BOS,2023 REG,10,4,10,5,9,20,0,1,-1,1,1,1,1,1,0,0,0,0,0,0.5010269332605688,0.4989730667394312
90717,0.5215311004784688,0.5215311004784688,-109,-109,0.49907282342437215,0.5009271765756278,home,CLE,under,7.5,0.5215311004784688,-109,0.4989730667394312,CLE,BOS,2023 REG,10,4,10,5,9,20,0,1,-1,1,1,1,1,1,0,0,0,0,0,0.5010269332605688,0.4989730667394312
90718,0.5918367346938775,0.4444444444444444,-145,125,0.5703642001018094,0.42963579989819056,away,MIL,over,7.5,0.5283018867924528,-112,0.5031902949311281,SD,MIL,2023 REG,12,10,12,3,13,24,1,0,7,-7,1,1,1,0,0,0,0,0,0,0.5031902949311281,0.4968097050688719
90718,0.5918367346938775,0.4444444444444444,-145,125,0.5703642001018094,0.42963579989819056,home,SD,under,7.5,0.5192307692307692,-108,0.4968097050688719,SD,MIL,2023 REG,12,10,12,3,13,24,1,0,7,-7,1,1,1,0,0,0,0,0,0,0.5031902949311281,0.4968097050688719
90719,0.5884773662551441,0.4444444444444444,-143,125,0.5691036258022998,0.4308963741977002,away,KC,over,9.5,0.5348837209302326,-115,0.5097020142727117,ARI,KC,2023 REG,10,4,14,5,9,24,0,1,-1,1,1,1,1,1,0,0,0,0,0,0.5097020142727117,0.49029798572728833
90719,0.5884773662551441,0.4444444444444444,-143,125,0.5691036258022998,0.4308963741977002,home,ARI,under,9.5,0.5121951219512195,-105,0.49029798572728833,ARI,KC,2023 REG,10,4,14,5,9,24,0,1,-1,1,1,1,1,1,0,0,0,0,0,0.5097020142727117,0.49029798572728833
90720,0.6031746031746031,0.4366812227074236,-152,129,0.5791345812140156,0.4208654187859844,away,BAL,over,8.5,0.5215311004784688,-109,0.49670754937970685,TB,BAL,2023 REG,3,3,8,5,8,11,0,1,-2,2,1,1,1,0,0,0,0,0,0,0.49670754937970685,0.5032924506202932
90720,0.6031746031746031,0.4366812227074236,-152,129,0.5791345812140156,0.4208654187859844,home,TB,under,8.5,0.5260663507109005,-111,0.5032924506202932,TB,BAL,2023 REG,3,3,8,5,8,11,0,1,-2,2,1,1,1,0,0,0,0,0,0,0.49670754937970685,0.5032924506202932
90721,0.5967741935483871,0.4444444444444444,-148,125,0.5721759741010521,0.42782402589894786,away,BAL,over,7.5,0.5348837209302326,-115,0.5097020142727117,SEA,BAL,2023 REG,12,9,4,2,11,16,1,0,7,-7,1,1,0,0,0,0,0,0,0,0.5097020142727117,0.49029798572728833
90721,0.5967741935483871,0.4444444444444444,-148,125,0.5721759741010521,0.42782402589894786,home,SEA,under,7.5,0.5121951219512195,-105,0.49029798572728833,SEA,BAL,2023 REG,12,9,4,2,11,16,1,0,7,-7,1,1,0,0,0,0,0,0,0,0.5097020142727117,0.49029798572728833
90722,0.4166666666666667,0.6226415094339623,140,-165,0.4002882599580712,0.5997117400419287,away,MIA,over,8,0.5283018867924528,-112,0.5044173060022736,WSH,MIA,2023 REG,8,5,9,8,13,17,0,1,-3,3,1,1,1,1,1,0,0,0,0,0.5044173060022736,0.49558269399772636
90722,0.4166666666666667,0.6226415094339623,140,-165,0.4002882599580712,0.5997117400419287,home,WSH,under,8,0.5169082125603864,-107,0.49558269399772636,WSH,MIA,2023 REG,8,5,9,8,13,17,0,1,-3,3,1,1,1,1,1,0,0,0,0,0.5044173060022736,0.49558269399772636
90723,0.5192307692307692,0.5215311004784688,-108,-109,0.49806595226635714,0.5019340477336429,away,BOS,over,8,0.5238095238095238,-110,0.4988662131519274,SEA,BOS,2023 REG,9,4,9,6,10,18,0,1,-2,2,1,1,1,1,0,0,0,0,0,0.4988662131519274,0.5011337868480725
90723,0.5192307692307692,0.5215311004784688,-108,-109,0.49806595226635714,0.5019340477336429,home,SEA,under,8,0.5238095238095238,-110,0.5011337868480725,SEA,BOS,2023 REG,9,4,9,6,10,18,0,1,-2,2,1,1,1,1,0,0,0,0,0,0.4988662131519274,0.5011337868480725
90724,0.607843137254902,0.4291845493562232,-155,133,0.5853361120599043,0.4146638879400957,away,MIL,over,9,0.5192307692307692,-108,0.49455035168025013,SD,MIL,2023 REG,6,3,6,4,7,12,0,1,-1,1,1,1,1,0,0,0,0,0,0,0.49455035168025013,0.5054496483197499
90724,0.607843137254902,0.4291845493562232,-155,133,0.5853361120599043,0.4146638879400957,home,SD,under,9,0.5283018867924528,-112,0.5054496483197499,SD,MIL,2023 REG,6,3,6,4,7,12,0,1,-1,1,1,1,1,0,0,0,0,0,0,0.49455035168025013,0.5054496483197499
90725,0.5555555555555556,0.4854368932038835,-125,106,0.5327819729114227,0.4672180270885773,away,HOU,over,9,0.5,100,0.4772727272727273,STL,HOU,2023 REG,11,7,11,10,17,22,0,1,-3,3,1,1,1,1,1,1,1,0,0,0.4772727272727273,0.5227272727272727
90725,0.5555555555555556,0.4854368932038835,-125,106,0.5327819729114227,0.4672180270885773,home,STL,under,9,0.5454545454545454,-120,0.5227272727272727,STL,HOU,2023 REG,11,7,11,10,17,22,0,1,-3,3,1,1,1,1,1,1,1,0,0,0.4772727272727273,0.5227272727272727
90726,0.5495495495495495,0.49019607843137253,-122,104,0.5277073575960698,0.4722926424039302,away,DET,over,7,0.5215311004784688,-109,0.4978845547971712,CLE,DET,2023 REG,5,2,8,4,6,13,0,1,-2,2,1,1,0,0,0,0,0,0,0,0.4978845547971712,0.5021154452028288
90726,0.5495495495495495,0.49019607843137253,-122,104,0.5277073575960698,0.4722926424039302,home,CLE,under,7,0.5238095238095238,-110,0.5021154452028288,CLE,DET,2023 REG,5,2,8,4,6,13,0,1,-2,2,1,1,0,0,0,0,0,0,0,0.4978845547971712,0.5021154452028288
90727,0.48780487804878053,0.5555555555555556,105,-125,0.4666534470222751,0.5333465529777248,away,HOU,over,9.5,0.5,100,0.4772727272727273,LAA,HOU,2023 REG,8,4,8,5,9,16,0,1,-1,1,1,1,1,1,0,0,0,0,0,0.4772727272727273,0.5227272727272727
90727,0.48780487804878053,0.5555555555555556,105,-125,0.4666534470222751,0.5333465529777248,home,LAA,under,9.5,0.5454545454545454,-120,0.5227272727272727,LAA,HOU,2023 REG,8,4,8,5,9,16,0,1,-1,1,1,1,1,1,0,0,0,0,0,0.4772727272727273,0.5227272727272727
90728,0.5283018867924528,0.5169082125603864,-112,-107,0.5044173060022736,0.49558269399772636,away,CHC,over,8.5,0.5238095238095238,-110,0.4988662131519274,TOR,CHC,2023 REG,8,4,7,5,9,15,0,1,-1,1,1,1,1,1,0,0,0,0,0,0.4988662131519274,0.5011337868480725
90728,0.5283018867924528,0.5169082125603864,-112,-107,0.5044173060022736,0.49558269399772636,home,TOR,under,8.5,0.5238095238095238,-110,0.5011337868480725,TOR,CHC,2023 REG,8,4,7,5,9,15,0,1,-1,1,1,1,1,1,0,0,0,0,0,0.4988662131519274,0.5011337868480725
90729,0.6632996632996633,0.37037037037037035,-197,170,0.6409663413030415,0.35903365869695847,away,COL,over,10,0.5238095238095238,-110,0.4988662131519274,CIN,COL,2023 REG,11,8,8,6,14,19,1,0,2,-2,1,1,1,1,1,1,0,0,0,0.4988662131519274,0.5011337868480725
90729,0.6632996632996633,0.37037037037037035,-197,170,0.6409663413030415,0.35903365869695847,home,CIN,under,10,0.5238095238095238,-110,0.5011337868480725,CIN,COL,2023 REG,11,8,8,6,14,19,1,0,2,-2,1,1,1,1,1,1,0,0,0,0.4988662131519274,0.5011337868480725
90730,0.42016806722689076,0.6108949416342413,138,-157,0.4071163828314571,0.5928836171685429,away,TB,over,8.5,0.5238095238095238,-110,0.5000596729920038,CWS,TB,2023 REG,7,2,9,3,5,16,0,1,-1,1,1,1,0,0,0,0,0,0,0,0.5000596729920038,0.4999403270079962
90730,0.42016806722689076,0.6108949416342413,138,-157,0.4071163828314571,0.5928836171685429,home,CWS,under,8.5,0.5215311004784688,-109,0.4999403270079962,CWS,TB,2023 REG,7,2,9,3,5,16,0,1,-1,1,1,1,0,0,0,0,0,0,0,0.5000596729920038,0.4999403270079962
90731,0.5495495495495495,0.49019607843137253,-122,104,0.5277073575960698,0.4722926424039302,away,BOS,over,7.5,0.5433789954337899,-119,0.5184560714286826,SD,BOS,2023 REG,3,2,7,4,6,10,0,1,-2,2,1,1,0,0,0,0,0,0,0,0.5184560714286826,0.48154392857131745
90731,0.5495495495495495,0.49019607843137253,-122,104,0.5277073575960698,0.4722926424039302,home,SD,under,7.5,0.5024875621890548,-101,0.48154392857131745,SD,BOS,2023 REG,3,2,7,4,6,10,0,1,-2,2,1,1,0,0,0,0,0,0,0,0.5184560714286826,0.48154392857131745
90732,0.5283018867924528,0.5121951219512195,-112,-105,0.5069072406637203,0.4930927593362797,away,HOU,over,7.5,0.5238095238095238,-110,0.4988662131519274,MIN,HOU,2023 REG,12,9,7,6,15,19,1,0,3,-3,1,1,1,1,1,1,0,0,0,0.4988662131519274,0.5011337868480725
90732,0.5283018867924528,0.5121951219512195,-112,-105,0.5069072406637203,0.4930927593362797,home,MIN,under,7.5,0.5238095238095238,-110,0.5011337868480725,MIN,HOU,2023 REG,12,9,7,6,15,19,1,0,3,-3,1,1,1,1,1,1,0,0,0,0.4988662131519274,0.5011337868480725
90733,0.576271186440678,0.4587155963302753,-136,118,0.5561093116235184,0.4438906883764816,away,SF,over,8,0.5024875621890548,-101,0.48049269377245407,CWS,SF,2023 REG,5,3,14,12,15,19,0,1,-9,9,1,1,1,0,0,0,0,0,0,0.48049269377245407,0.5195073062275459
90733,0.576271186440678,0.4587155963302753,-136,118,0.5561093116235184,0.4438906883764816,home,CWS,under,8,0.5412844036697247,-118,0.5195073062275459,CWS,SF,2023 REG,5,3,14,12,15,19,0,1,-9,9,1,1,1,0,0,0,0,0,0,0.48049269377245407,0.5195073062275459
90734,0.5633187772925764,0.47619047619047616,-129,110,0.5410624729287608,0.45893752707123925,away,CWS,over,8.5,0.5348837209302326,-115,0.5097020142727117,NYY,CWS,2023 REG,6,3,2,0,3,8,1,0,3,-3,0,0,0,0,0,0,0,0,0,0.5097020142727117,0.49029798572728833
90734,0.5633187772925764,0.47619047619047616,-129,110,0.5410624729287608,0.45893752707123925,home,NYY,under,8.5,0.5121951219512195,-105,0.49029798572728833,NYY,CWS,2023 REG,6,3,2,0,3,8,1,0,3,-3,0,0,0,0,0,0,0,0,0,0.5097020142727117,0.49029798572728833
90735,0.5,0.5433789954337899,100,-119,0.4783105022831051,0.5216894977168949,away,STL,over,9,0.5098039215686274,-104,0.48483656587239576,NYM,STL,2023 REG,8,6,5,1,7,13,1,0,5,-5,1,0,0,0,0,0,0,0,0,0.48483656587239576,0.5151634341276042
90735,0.5,0.5433789954337899,100,-119,0.4783105022831051,0.5216894977168949,home,NYM,under,9,0.5391705069124424,-117,0.5151634341276042,NYM,STL,2023 REG,8,6,5,1,7,13,1,0,5,-5,1,0,0,0,0,0,0,0,0,0.48483656587239576,0.5151634341276042
90736,0.33112582781456956,0.7142857142857143,202,-250,0.31608889334427687,0.6839111066557231,away,LAD,over,9.5,0.5238095238095238,-110,0.4988662131519274,KC,LAD,2023 REG,9,3,11,9,12,20,0,1,-6,6,1,1,1,0,0,0,0,0,0,0.4988662131519274,0.5011337868480725
90736,0.33112582781456956,0.7142857142857143,202,-250,0.31608889334427687,0.6839111066557231,home,KC,under,9.5,0.5238095238095238,-110,0.5011337868480725,KC,LAD,2023 REG,9,3,11,9,12,20,0,1,-6,6,1,1,1,0,0,0,0,0,0,0.4988662131519274,0.5011337868480725
90737,0.7076023391812866,0.33557046979865773,-242,198,0.677053158558051,0.32294684144194896,away,LAA,over,8,0.5098039215686274,-104,0.48375889301574193,SEA,LAA,2023 REG,10,5,12,8,13,22,0,1,-3,3,1,1,1,1,1,0,0,0,0,0.48375889301574193,0.5162411069842581
90737,0.7076023391812866,0.33557046979865773,-242,198,0.677053158558051,0.32294684144194896,home,SEA,under,8,0.5412844036697247,-118,0.5162411069842581,SEA,LAA,2023 REG,10,5,12,8,13,22,0,1,-3,3,1,1,1,1,1,0,0,0,0,0.48375889301574193,0.5162411069842581
90738,0.7142857142857143,0.31746031746031744,-250,215,0.6916099773242631,0.3083900226757369,away,DET,over,7.5,0.5238095238095238,-110,0.5000596729920038,HOU,DET,2023 REG,11,8,7,2,10,18,1,0,6,-6,1,1,0,0,0,0,0,0,0,0.5000596729920038,0.4999403270079962
90738,0.7142857142857143,0.31746031746031744,-250,215,0.6916099773242631,0.3083900226757369,home,HOU,under,7.5,0.5215311004784688,-109,0.4999403270079962,HOU,DET,2023 REG,11,8,7,2,10,18,1,0,6,-6,1,1,0,0,0,0,0,0,0,0.5000596729920038,0.4999403270079962
90739,0.4166666666666667,0.6226415094339623,140,-165,0.4002882599580712,0.5997117400419287,away,LAA,over,10,0.5238095238095238,-110,0.5000596729920038,KC,LAA,2023 REG,11,10,12,9,19,23,1,0,1,-1,1,1,1,1,1,1,1,1,1,0.5000596729920038,0.4999403270079962
90739,0.4166666666666667,0.6226415094339623,140,-165,0.4002882599580712,0.5997117400419287,home,KC,under,10,0.5215311004784688,-109,0.4999403270079962,KC,LAA,2023 REG,11,10,12,9,19,23,1,0,1,-1,1,1,1,1,1,1,1,1,1,0.5000596729920038,0.4999403270079962
90740,0.5726495726495727,0.4694835680751174,-134,113,0.5485220476191947,0.45147795238080535,away,DET,over,9.5,0.5348837209302326,-115,0.5097020142727117,BOS,DET,2023 REG,12,6,7,3,9,19,1,0,3,-3,1,1,1,0,0,0,0,0,0,0.5097020142727117,0.49029798572728833
90740,0.5726495726495727,0.4694835680751174,-134,113,0.5485220476191947,0.45147795238080535,home,BOS,under,9.5,0.5121951219512195,-105,0.49029798572728833,BOS,DET,2023 REG,12,6,7,3,9,19,1,0,3,-3,1,1,1,0,0,0,0,0,0,0.5097020142727117,0.49029798572728833
90741,0.5215311004784688,0.5215311004784688,-109,-109,0.49907282342437215,0.5009271765756278,away,SF,over,9,0.5121951219512195,-105,0.48919479393107135,DET,SF,2023 REG,12,5,4,1,6,16,1,0,4,-4,1,0,0,0,0,0,0,0,0,0.48919479393107135,0.5108052060689287
90741,0.5215311004784688,0.5215311004784688,-109,-109,0.49907282342437215,0.5009271765756278,home,DET,under,9,0.5327102803738317,-114,0.5108052060689287,DET,SF,2023 REG,12,5,4,1,6,16,1,0,4,-4,1,0,0,0,0,0,0,0,0,0.48919479393107135,0.5108052060689287
90742,0.647887323943662,0.38759689922480617,-184,158,0.6248975455528234,0.3751024544471766,away,CWS,over,9,0.5327102803738317,-114,0.5075272610403079,TB,CWS,2023 REG,10,8,10,7,15,20,1,0,1,-1,1,1,1,1,1,1,1,0,0,0.5075272610403079,0.4924727389596921
90742,0.647887323943662,0.38759689922480617,-184,158,0.6248975455528234,0.3751024544471766,home,TB,under,9,0.5145631067961165,-106,0.4924727389596921,TB,CWS,2023 REG,10,8,10,7,15,20,1,0,1,-1,1,1,1,1,1,1,1,0,0,0.5075272610403079,0.4924727389596921
90743,0.6428571428571428,0.3921568627450981,-180,155,0.6203481392557023,0.3796518607442977,away,COL,over,8.5,0.5073891625615764,-103,0.4837652908580103,PIT,COL,2023 REG,7,2,4,0,2,11,1,0,2,-2,0,0,0,0,0,0,0,0,0,0.4837652908580103,0.5162347091419897
90743,0.6428571428571428,0.3921568627450981,-180,155,0.6203481392557023,0.3796518607442977,home,PIT,under,8.5,0.5391705069124424,-117,0.5162347091419897,PIT,COL,2023 REG,7,2,4,0,2,11,1,0,2,-2,0,0,0,0,0,0,0,0,0,0.4837652908580103,0.5162347091419897
90744,0.5594713656387665,0.4807692307692307,-127,108,0.5369579042122659,0.46304209578773414,away,SEA,over,9.5,0.5024875621890548,-101,0.48049269377245407,TEX,SEA,2023 REG,8,8,8,5,13,16,1,0,3,-3,1,1,1,1,1,0,0,0,0,0.48049269377245407,0.5195073062275459
90744,0.5594713656387665,0.4807692307692307,-127,108,0.5369579042122659,0.46304209578773414,home,TEX,under,9.5,0.5412844036697247,-118,0.5195073062275459,TEX,SEA,2023 REG,8,8,8,5,13,16,1,0,3,-3,1,1,1,1,1,0,0,0,0,0.48049269377245407,0.5195073062275459
90745,0.6226415094339623,0.41152263374485604,-165,143,0.6013694957565848,0.3986305042434152,away,BOS,over,9,0.49504950495049505,102,0.47297076509898783,MIL,BOS,2023 REG,8,3,8,5,8,16,0,1,-2,2,1,1,1,0,0,0,0,0,0,0.47297076509898783,0.5270292349010122
90745,0.6226415094339623,0.41152263374485604,-165,143,0.6013694957565848,0.3986305042434152,home,MIL,under,9,0.5495495495495495,-122,0.5270292349010122,MIL,BOS,2023 REG,8,3,8,5,8,16,0,1,-2,2,1,1,1,0,0,0,0,0,0,0.47297076509898783,0.5270292349010122
90746,0.696969696969697,0.3448275862068966,-230,190,0.6678382571799499,0.33216174282005007,away,KC,over,8.5,0.5192307692307692,-108,0.49571111079951763,HOU,KC,2023 REG,8,5,5,7,12,13,0,1,-2,2,1,1,1,1,1,0,0,0,0,0.49571111079951763,0.5042888892004824
90746,0.696969696969697,0.3448275862068966,-230,190,0.6678382571799499,0.33216174282005007,home,HOU,under,8.5,0.5260663507109005,-111,0.5042888892004824,HOU,KC,2023 REG,8,5,5,7,12,13,0,1,-2,2,1,1,1,1,1,0,0,0,0,0.49571111079951763,0.5042888892004824
90747,0.6000000000000001,0.43859649122807015,-150,128,0.5768421052631579,0.42315789473684207,away,CHC,over,8.5,0.5454545454545454,-120,0.5206611570247933,NYY,CHC,2023 REG,11,4,6,7,11,17,0,1,-3,3,1,1,1,1,0,0,0,0,0,0.5206611570247933,0.4793388429752067
90747,0.6000000000000001,0.43859649122807015,-150,128,0.5768421052631579,0.42315789473684207,home,NYY,under,8.5,0.5,100,0.4793388429752067,NYY,CHC,2023 REG,11,4,6,7,11,17,0,1,-3,3,1,1,1,1,0,0,0,0,0,0.5206611570247933,0.4793388429752067
90748,0.4587155963302753,0.5815899581589958,118,-139,0.4402268098673069,0.5597731901326931,away,NYY,over,8,0.5121951219512195,-105,0.48808156828023186,OAK,NYY,2023 REG,5,2,7,1,3,12,1,0,1,-1,1,0,0,0,0,0,0,0,0,0.48808156828023186,0.5119184317197681
90748,0.4587155963302753,0.5815899581589958,118,-139,0.4402268098673069,0.5597731901326931,home,OAK,under,8,0.5348837209302326,-115,0.5119184317197681,OAK,NYY,2023 REG,5,2,7,1,3,12,1,0,1,-1,1,0,0,0,0,0,0,0,0,0.48808156828023186,0.5119184317197681
90749,0.4694835680751174,0.5708154506437768,113,-133,0.45056384097704505,0.549436159022955,away,CLE,over,8.5,0.5098039215686274,-104,0.48592421718142587,LAA,CLE,2023 REG,5,3,13,6,9,18,0,1,-3,3,1,1,1,0,0,0,0,0,0,0.48592421718142587,0.5140757828185741
90749,0.4694835680751174,0.5708154506437768,113,-133,0.45056384097704505,0.549436159022955,home,LAA,under,8.5,0.5370370370370371,-116,0.5140757828185741,LAA,CLE,2023 REG,5,3,13,6,9,18,0,1,-3,3,1,1,1,0,0,0,0,0,0,0.48592421718142587,0.5140757828185741
90750,0.4716981132075471,0.5689655172413793,112,-132,0.45251715544861953,0.5474828445513804,away,MIL,over,8.5,0.5192307692307692,-108,0.49455035168025013,PIT,MIL,2023 REG,11,8,9,7,15,20,1,0,1,-1,1,1,1,1,1,1,1,0,0,0.49455035168025013,0.5054496483197499
90750,0.4716981132075471,0.5689655172413793,112,-132,0.45251715544861953,0.5474828445513804,home,PIT,under,8.5,0.5283018867924528,-112,0.5054496483197499,PIT,MIL,2023 REG,11,8,9,7,15,20,1,0,1,-1,1,1,1,1,1,1,1,0,0,0.49455035168025013,0.5054496483197499
90751,0.5,0.5391705069124424,100,-117,0.4804147465437788,0.5195852534562212,away,SEA,over,8.5,0.5475113122171946,-121,0.5214983313199976,DET,SEA,2023 REG,7,2,11,9,11,18,0,1,-7,7,1,1,0,0,0,0,0,0,0,0.5214983313199976,0.47850166868000243
90751,0.5,0.5391705069124424,100,-117,0.4804147465437788,0.5195852534562212,home,DET,under,8.5,0.5,100,0.47850166868000243,DET,SEA,2023 REG,7,2,11,9,11,18,0,1,-7,7,1,1,0,0,0,0,0,0,0,0.5214983313199976,0.47850166868000243
90752,0.5098039215686274,0.5283018867924528,-104,-112,0.4903774310316062,0.5096225689683938,away,MIA,over,7.5,0.5391705069124424,-117,0.5140669063204599,CHC,MIA,2023 REG,11,4,9,5,9,20,0,1,-1,1,1,1,1,1,0,0,0,0,0,0.5140669063204599,0.4859330936795401
90752,0.5098039215686274,0.5283018867924528,-104,-112,0.4903774310316062,0.5096225689683938,home,CHC,under,7.5,0.5073891625615764,-103,0.4859330936795401,CHC,MIA,2023 REG,11,4,9,5,9,20,0,1,-1,1,1,1,1,1,0,0,0,0,0,0.5140669063204599,0.4859330936795401
90753,0.48780487804878053,0.5515695067264574,105,-123,0.4685978610852498,0.5314021389147502,away,SF,over,8,0.5283018867924528,-112,0.5044173060022736,STL,SF,2023 REG,10,3,12,4,7,22,0,1,-1,1,1,1,1,0,0,0,0,0,0,0.5044173060022736,0.49558269399772636
90753,0.48780487804878053,0.5515695067264574,105,-123,0.4685978610852498,0.5314021389147502,home,STL,under,8,0.5169082125603864,-107,0.49558269399772636,STL,SF,2023 REG,10,3,12,4,7,22,0,1,-1,1,1,1,1,0,0,0,0,0,0,0.5044173060022736,0.49558269399772636
90754,0.6124031007751938,0.425531914893617,-158,135,0.5891715795516586,0.41082842044834145,away,COL,over,10,0.5238095238095238,-110,0.4988662131519274,ARI,COL,2023 REG,10,6,3,0,6,13,1,0,6,-6,0,0,0,0,0,0,0,0,0,0.4988662131519274,0.5011337868480725
90754,0.6124031007751938,0.425531914893617,-158,135,0.5891715795516586,0.41082842044834145,home,ARI,under,10,0.5238095238095238,-110,0.5011337868480725,ARI,COL,2023 REG,10,6,3,0,6,13,1,0,6,-6,0,0,0,0,0,0,0,0,0,0.4988662131519274,0.5011337868480725
90755,0.5780590717299579,0.4608294930875576,-137,117,0.5555791840506346,0.44442081594936544,away,MIA,over,8,0.5121951219512195,-105,0.48808156828023186,NYM,MIA,2023 REG,6,2,7,4,6,13,0,1,-2,2,1,1,0,0,0,0,0,0,0,0.48808156828023186,0.5119184317197681
90755,0.5780590717299579,0.4608294930875576,-137,117,0.5555791840506346,0.44442081594936544,home,NYM,under,8,0.5348837209302326,-115,0.5119184317197681,NYM,MIA,2023 REG,6,2,7,4,6,13,0,1,-2,2,1,1,0,0,0,0,0,0,0,0.48808156828023186,0.5119184317197681
90756,0.5967741935483871,0.4424778761061947,-148,126,0.5733495713351688,0.42665042866483116,away,CWS,over,9,0.5098039215686274,-104,0.4881300146960012,LAD,CWS,2023 REG,9,5,8,4,9,17,1,0,1,-1,1,1,1,1,0,0,0,0,0,0.4881300146960012,0.5118699853039987
90756,0.5967741935483871,0.4424778761061947,-148,126,0.5733495713351688,0.42665042866483116,home,LAD,under,9,0.5327102803738317,-114,0.5118699853039987,LAD,CWS,2023 REG,9,5,8,4,9,17,1,0,1,-1,1,1,1,1,0,0,0,0,0,0.4881300146960012,0.5118699853039987
90757,0.5934959349593496,0.4464285714285714,-146,124,0.5698009027128599,0.4301990972871401,away,CWS,over,7.5,0.5145631067961165,-106,0.4913668392989033,HOU,CWS,2023 REG,4,2,11,3,5,15,0,1,-1,1,1,1,0,0,0,0,0,0,0,0.4913668392989033,0.5086331607010968
90757,0.5934959349593496,0.4464285714285714,-146,124,0.5698009027128599,0.4301990972871401,home,HOU,under,7.5,0.5305164319248826,-113,0.5086331607010968,HOU,CWS,2023 REG,4,2,11,3,5,15,0,1,-1,1,1,1,0,0,0,0,0,0,0,0.4913668392989033,0.5086331607010968
90758,0.5689655172413793,0.47619047619047616,-132,110,0.5432733140818753,0.4567266859181247,away,MIL,over,6.5,0.5283018867924528,-112,0.5044173060022736,CHC,MIL,2023 REG,8,1,7,0,1,15,1,0,1,-1,0,0,0,0,0,0,0,0,0,0.5044173060022736,0.49558269399772636
90758,0.5689655172413793,0.47619047619047616,-132,110,0.5432733140818753,0.4567266859181247,home,CHC,under,6.5,0.5169082125603864,-107,0.49558269399772636,CHC,MIL,2023 REG,8,1,7,0,1,15,1,0,1,-1,0,0,0,0,0,0,0,0,0,0.5044173060022736,0.49558269399772636
90759,0.3472222222222222,0.6923076923076923,188,-225,0.3334965574548908,0.6665034425451092,away,MIN,over,8.5,0.5495495495495495,-122,0.5250401592387142,CWS,MIN,2023 REG,11,7,9,6,13,20,1,0,1,-1,1,1,1,1,1,1,0,0,0,0.5250401592387142,0.47495984076128583
90759,0.3472222222222222,0.6923076923076923,188,-225,0.3334965574548908,0.6665034425451092,home,CWS,under,8.5,0.49504950495049505,102,0.47495984076128583,CWS,MIN,2023 REG,11,7,9,6,13,20,1,0,1,-1,1,1,1,1,1,1,0,0,0,0.5250401592387142,0.47495984076128583
90760,0.6875,0.3508771929824561,-220,185,0.6611156798245614,0.33888432017543857,away,OAK,over,8.5,0.5098039215686274,-104,0.48592421718142587,DET,OAK,2023 REG,4,3,14,12,15,18,0,1,-9,9,1,1,1,0,0,0,0,0,0,0.48592421718142587,0.5140757828185741
90760,0.6875,0.3508771929824561,-220,185,0.6611156798245614,0.33888432017543857,home,DET,under,8.5,0.5370370370370371,-116,0.5140757828185741,DET,OAK,2023 REG,4,3,14,12,15,18,0,1,-9,9,1,1,1,0,0,0,0,0,0,0.48592421718142587,0.5140757828185741
90761,0.41152263374485604,0.6363636363636364,143,-175,0.3918163497495917,0.6081836502504083,away,SF,over,11.5,0.5283018867924528,-112,0.4972280580361247,COL,SF,2023 REG,10,5,10,2,7,20,1,0,3,-3,1,1,0,0,0,0,0,0,0,0.4972280580361247,0.5027719419638753
90761,0.41152263374485604,0.6363636363636364,143,-175,0.3918163497495917,0.6081836502504083,home,COL,under,11.5,0.5305164319248826,-113,0.5027719419638753,COL,SF,2023 REG,10,5,10,2,7,20,1,0,3,-3,1,1,0,0,0,0,0,0,0,0.4972280580361247,0.5027719419638753
90762,0.6363636363636364,0.4081632653061224,-175,145,0.6080283353010626,0.3919716646989374,away,PIT,over,8.5,0.5215311004784688,-109,0.4978845547971712,CHC,PIT,2023 REG,10,6,11,8,14,21,0,1,-2,2,1,1,1,1,1,1,0,0,0,0.4978845547971712,0.5021154452028288
90762,0.6363636363636364,0.4081632653061224,-175,145,0.6080283353010626,0.3919716646989374,home,CHC,under,8.5,0.5238095238095238,-110,0.5021154452028288,CHC,PIT,2023 REG,10,6,11,8,14,21,0,1,-2,2,1,1,1,1,1,1,0,0,0,0.4978845547971712,0.5021154452028288
90763,0.6551724137931035,0.38759689922480617,-190,158,0.6271511397468869,0.37284886025311315,away,CLE,over,8.5,0.5348837209302326,-115,0.5097020142727117,ARI,CLE,2023 REG,11,5,7,1,6,18,1,0,4,-4,1,0,0,0,0,0,0,0,0,0.5097020142727117,0.49029798572728833
90763,0.6551724137931035,0.38759689922480617,-190,158,0.6271511397468869,0.37284886025311315,home,ARI,under,8.5,0.5121951219512195,-105,0.49029798572728833,ARI,CLE,2023 REG,11,5,7,1,6,18,1,0,4,-4,1,0,0,0,0,0,0,0,0,0.5097020142727117,0.49029798572728833
90764,0.5454545454545454,0.49751243781094534,-120,101,0.5220180091279142,0.4779819908720858,away,PIT,over,7.5,0.5348837209302326,-115,0.5097020142727117,SF,PIT,2023 REG,12,4,14,9,13,26,0,1,-5,5,1,1,1,1,0,0,0,0,0,0.5097020142727117,0.49029798572728833
90764,0.5454545454545454,0.49751243781094534,-120,101,0.5220180091279142,0.4779819908720858,home,SF,under,7.5,0.5121951219512195,-105,0.49029798572728833,SF,PIT,2023 REG,12,4,14,9,13,26,0,1,-5,5,1,1,1,1,0,0,0,0,0,0.5097020142727117,0.49029798572728833
90765,0.4608294930875576,0.5833333333333333,117,-140,0.4404779601747047,0.5595220398252954,away,TB,over,7.5,0.5098039215686274,-104,0.48592421718142587,BOS,TB,2023 REG,3,0,10,5,5,13,0,1,-5,5,0,0,0,0,0,0,0,0,0,0.48592421718142587,0.5140757828185741
90765,0.4608294930875576,0.5833333333333333,117,-140,0.4404779601747047,0.5595220398252954,home,BOS,under,7.5,0.5370370370370371,-116,0.5140757828185741,BOS,TB,2023 REG,3,0,10,5,5,13,0,1,-5,5,0,0,0,0,0,0,0,0,0,0.48592421718142587,0.5140757828185741
90766,0.5918367346938775,0.4444444444444444,-145,125,0.5703642001018094,0.42963579989819056,away,CHC,over,9,0.5024875621890548,-101,0.47839724939301687,LAD,CHC,2023 REG,5,2,4,1,3,9,1,0,1,-1,1,0,0,0,0,0,0,0,0,0.47839724939301687,0.5216027506069831
90766,0.5918367346938775,0.4444444444444444,-145,125,0.5703642001018094,0.42963579989819056,home,LAD,under,9,0.5454545454545454,-120,0.5216027506069831,LAD,CHC,2023 REG,5,2,4,1,3,9,1,0,1,-1,1,0,0,0,0,0,0,0,0,0.47839724939301687,0.5216027506069831
90767,0.46511627906976744,0.5726495726495727,115,-134,0.4475507666421673,0.5524492333578327,away,TB,over,8.5,0.5238095238095238,-110,0.4988662131519274,TOR,TB,2023 REG,6,1,11,8,9,17,0,1,-7,7,1,0,0,0,0,0,0,0,0,0.4988662131519274,0.5011337868480725
90767,0.46511627906976744,0.5726495726495727,115,-134,0.4475507666421673,0.5524492333578327,home,TOR,under,8.5,0.5238095238095238,-110,0.5011337868480725,TOR,TB,2023 REG,6,1,11,8,9,17,0,1,-7,7,1,0,0,0,0,0,0,0,0,0.4988662131519274,0.5011337868480725
90768,0.5454545454545454,0.5,-120,100,0.5206611570247933,0.4793388429752067,away,NYM,over,7.5,0.5215311004784688,-109,0.49670754937970685,MIA,NYM,2023 REG,10,3,10,8,11,20,0,1,-5,5,1,1,1,0,0,0,0,0,0,0.49670754937970685,0.5032924506202932
90768,0.5454545454545454,0.5,-120,100,0.5206611570247933,0.4793388429752067,home,MIA,under,7.5,0.5260663507109005,-111,0.5032924506202932,MIA,NYM,2023 REG,10,3,10,8,11,20,0,1,-5,5,1,1,1,0,0,0,0,0,0,0.49670754937970685,0.5032924506202932
90769,0.6441281138790036,0.39370078740157477,-181,154,0.6197614550470296,0.3802385449529704,away,OAK,over,8,0.5145631067961165,-106,0.4913668392989033,CLE,OAK,2023 REG,6,6,3,1,7,9,1,0,5,-5,1,0,0,0,0,0,0,0,0,0.4913668392989033,0.5086331607010968
90769,0.6441281138790036,0.39370078740157477,-181,154,0.6197614550470296,0.3802385449529704,home,CLE,under,8,0.5305164319248826,-113,0.5086331607010968,CLE,OAK,2023 REG,6,6,3,1,7,9,1,0,5,-5,1,0,0,0,0,0,0,0,0,0.4913668392989033,0.5086331607010968
90770,0.6491228070175439,0.3921568627450981,-185,155,0.6223272319084604,0.3776727680915396,away,HOU,over,8.5,0.5024875621890548,-101,0.48049269377245407,TB,HOU,2023 REG,14,8,6,3,11,20,1,0,5,-5,1,1,1,0,0,0,0,0,0,0.48049269377245407,0.5195073062275459
90770,0.6491228070175439,0.3921568627450981,-185,155,0.6223272319084604,0.3776727680915396,home,TB,under,8.5,0.5412844036697247,-118,0.5195073062275459,TB,HOU,2023 REG,14,8,6,3,11,20,1,0,5,-5,1,1,1,0,0,0,0,0,0,0.48049269377245407,0.5195073062275459
90771,0.5454545454545454,0.49019607843137253,-120,104,0.526008750607681,0.47399124939231896,away,MIA,over,7.5,0.5121951219512195,-105,0.48808156828023186,CLE,MIA,2023 REG,13,7,8,4,11,21,1,0,3,-3,1,1,1,1,0,0,0,0,0,0.48808156828023186,0.5119184317197681
90771,0.5454545454545454,0.49019607843137253,-120,104,0.526008750607681,0.47399124939231896,home,CLE,under,7.5,0.5348837209302326,-115,0.5119184317197681,CLE,MIA,2023 REG,13,7,8,4,11,21,1,0,3,-3,1,1,1,1,0,0,0,0,0,0.48808156828023186,0.5119184317197681
90772,0.4273504273504274,0.609375,134,-156,0.4116558002775952,0.5883441997224048,away,CWS,over,8.5,0.5370370370370371,-116,0.5118817074154765,DET,CWS,2023 REG,3,3,17,12,15,20,0,1,-9,9,1,1,1,0,0,0,0,0,0,0.5118817074154765,0.48811829258452355
90772,0.4273504273504274,0.609375,134,-156,0.4116558002775952,0.5883441997224048,home,DET,under,8.5,0.5098039215686274,-104,0.48811829258452355,DET,CWS,2023 REG,3,3,17,12,15,20,0,1,-9,9,1,1,1,0,0,0,0,0,0,0.5118817074154765,0.48811829258452355
90773,0.6875,0.35460992907801414,-220,182,0.6585494237588654,0.3414505762411346,away,DET,over,7.5,0.5238095238095238,-110,0.5024811857109994,MIN,DET,2023 REG,7,4,12,8,12,19,0,1,-4,4,1,1,1,1,0,0,0,0,0,0.5024811857109994,0.4975188142890006
90773,0.6875,0.35460992907801414,-220,182,0.6585494237588654,0.3414505762411346,home,MIN,under,7.5,0.5169082125603864,-107,0.4975188142890006,MIN,DET,2023 REG,7,4,12,8,12,19,0,1,-4,4,1,1,1,1,0,0,0,0,0,0.5024811857109994,0.4975188142890006
90774,0.5689655172413793,0.47846889952153115,-132,109,0.5419769697728268,0.45802303022717317,away,CHC,over,8.5,0.5348837209302326,-115,0.5097020142727117,MIL,CHC,2023 REG,6,4,5,0,4,11,1,0,4,-4,0,0,0,0,0,0,0,0,0,0.5097020142727117,0.49029798572728833
90774,0.5689655172413793,0.47846889952153115,-132,109,0.5419769697728268,0.45802303022717317,home,MIL,under,8.5,0.5121951219512195,-105,0.49029798572728833,MIL,CHC,2023 REG,6,4,5,0,4,11,1,0,4,-4,0,0,0,0,0,0,0,0,0,0.5097020142727117,0.49029798572728833
90775,0.4854368932038835,0.5535714285714286,106,-124,0.4665008146721786,0.5334991853278215,away,TOR,over,8,0.5412844036697247,-118,0.5149381613977361,CWS,TOR,2023 REG,7,3,6,4,7,13,0,1,-1,1,1,1,1,0,0,0,0,0,0,0.5149381613977361,0.48506183860226393
90775,0.4854368932038835,0.5535714285714286,106,-124,0.4665008146721786,0.5334991853278215,home,CWS,under,8,0.5073891625615764,-103,0.48506183860226393,CWS,TOR,2023 REG,7,3,6,4,7,13,0,1,-1,1,1,1,1,0,0,0,0,0,0,0.5149381613977361,0.48506183860226393
90776,0.5901639344262295,0.4444444444444444,-144,125,0.569739317387799,0.43026068261220096,away,MIN,over,9,0.5,100,0.4772727272727273,NYY,MIN,2023 REG,4,2,13,11,13,17,0,1,-9,9,1,1,0,0,0,0,0,0,0,0.4772727272727273,0.5227272727272727
90776,0.5901639344262295,0.4444444444444444,-144,125,0.569739317387799,0.43026068261220096,home,NYY,under,9,0.5454545454545454,-120,0.5227272727272727,NYY,MIN,2023 REG,4,2,13,11,13,17,0,1,-9,9,1,1,0,0,0,0,0,0,0,0.4772727272727273,0.5227272727272727
90777,0.5454545454545454,0.49751243781094534,-120,101,0.5220180091279142,0.4779819908720858,away,ARI,over,8,0.5391705069124424,-117,0.5140669063204599,TOR,ARI,2023 REG,8,5,10,2,7,18,1,0,3,-3,1,1,0,0,0,0,0,0,0,0.5140669063204599,0.4859330936795401
90777,0.5454545454545454,0.49751243781094534,-120,101,0.5220180091279142,0.4779819908720858,home,TOR,under,8,0.5073891625615764,-103,0.4859330936795401,TOR,ARI,2023 REG,8,5,10,2,7,18,1,0,3,-3,1,1,0,0,0,0,0,0,0,0.5140669063204599,0.4859330936795401
90778,0.5798319327731092,0.4608294930875576,-138,117,0.5562551396270082,0.44374486037299177,away,CLE,over,9,0.5348837209302326,-115,0.5097020142727117,TEX,CLE,2023 REG,8,6,9,5,11,17,1,0,1,-1,1,1,1,1,1,0,0,0,0,0.5097020142727117,0.49029798572728833
90778,0.5798319327731092,0.4608294930875576,-138,117,0.5562551396270082,0.44374486037299177,home,TEX,under,9,0.5121951219512195,-105,0.49029798572728833,TEX,CLE,2023 REG,8,6,9,5,11,17,1,0,1,-1,1,1,1,1,1,0,0,0,0,0.5097020142727117,0.49029798572728833
90779,0.5145631067961165,0.5238095238095238,-106,-110,0.4948179667757384,0.5051820332242616,away,TEX,over,8.5,0.5412844036697247,-118,0.5189377998484975,CIN,TEX,2023 REG,7,5,5,3,8,12,1,0,2,-2,1,1,1,0,0,0,0,0,0,0.5189377998484975,0.4810622001515025
90779,0.5145631067961165,0.5238095238095238,-106,-110,0.4948179667757384,0.5051820332242616,home,CIN,under,8.5,0.5,100,0.4810622001515025,CIN,TEX,2023 REG,7,5,5,3,8,12,1,0,2,-2,1,1,1,0,0,0,0,0,0,0.5189377998484975,0.4810622001515025
90780,0.6402877697841727,0.4,-178,150,0.6144920035194866,0.38550799648051337,away,KC,over,9.5,0.5238095238095238,-110,0.5000596729920038,LAA,KC,2023 REG,12,8,12,11,19,24,0,1,-3,3,1,1,1,1,1,1,1,1,0,0.5000596729920038,0.4999403270079962
90780,0.6402877697841727,0.4,-178,150,0.6144920035194866,0.38550799648051337,home,LAA,under,9.5,0.5215311004784688,-109,0.4999403270079962,LAA,KC,2023 REG,12,8,12,11,19,24,0,1,-3,3,1,1,1,1,1,1,1,1,0,0.5000596729920038,0.4999403270079962
90781,0.5192307692307692,0.5238095238095238,-108,-110,0.49688292476754015,0.5031170752324599,away,BOS,over,8,0.5327102803738317,-114,0.508788710910954,SF,BOS,2023 REG,11,4,8,3,7,19,1,0,1,-1,1,1,1,0,0,0,0,0,0,0.508788710910954,0.491211289089046
90781,0.5192307692307692,0.5238095238095238,-108,-110,0.49688292476754015,0.5031170752324599,home,SF,under,8,0.5121951219512195,-105,0.491211289089046,SF,BOS,2023 REG,11,4,8,3,7,19,1,0,1,-1,1,1,1,0,0,0,0,0,0,0.508788710910954,0.491211289089046
90782,0.6774193548387096,0.36363636363636365,-210,175,0.6496074165168858,0.3503925834831142,away,MIL,over,8.5,0.5215311004784688,-109,0.49670754937970685,TEX,MIL,2023 REG,8,2,7,6,8,15,0,1,-4,4,1,1,0,0,0,0,0,0,0,0.49670754937970685,0.5032924506202932
90782,0.6774193548387096,0.36363636363636365,-210,175,0.6496074165168858,0.3503925834831142,home,TEX,under,8.5,0.5260663507109005,-111,0.5032924506202932,TEX,MIL,2023 REG,8,2,7,6,8,15,0,1,-4,4,1,1,0,0,0,0,0,0,0,0.49670754937970685,0.5032924506202932
90783,0.3472222222222222,0.696969696969697,188,-230,0.3318778058361392,0.6681221941638609,away,TEX,over,8.5,0.5495495495495495,-122,0.5250401592387142,OAK,TEX,2023 REG,6,3,7,5,8,13,0,1,-2,2,1,1,1,0,0,0,0,0,0,0.5250401592387142,0.47495984076128583
90783,0.3472222222222222,0.696969696969697,188,-230,0.3318778058361392,0.6681221941638609,home,OAK,under,8.5,0.49504950495049505,102,0.47495984076128583,OAK,TEX,2023 REG,6,3,7,5,8,13,0,1,-2,2,1,1,1,0,0,0,0,0,0,0.5250401592387142,0.47495984076128583
90784,0.696969696969697,0.3448275862068966,-230,190,0.6678382571799499,0.33216174282005007,away,STL,over,8.5,0.5433789954337899,-119,0.5171177654451503,PHI,STL,2023 REG,12,12,3,1,13,15,1,0,11,-11,1,0,0,0,0,0,0,0,0,0.5171177654451503,0.4828822345548497
90784,0.696969696969697,0.3448275862068966,-230,190,0.6678382571799499,0.33216174282005007,home,PHI,under,8.5,0.504950495049505,-102,0.4828822345548497,PHI,STL,2023 REG,12,12,3,1,13,15,1,0,11,-11,1,0,0,0,0,0,0,0,0,0.5171177654451503,0.4828822345548497
90785,0.5098039215686274,0.5348837209302326,-104,-115,0.4870219861770517,0.5129780138229483,away,CWS,over,11.5,0.5283018867924528,-112,0.5031902949311281,COL,CWS,2023 REG,13,11,11,5,16,24,1,0,6,-6,1,1,1,1,1,0,0,0,0,0.5031902949311281,0.4968097050688719
90785,0.5098039215686274,0.5348837209302326,-104,-115,0.4870219861770517,0.5129780138229483,home,COL,under,11.5,0.5192307692307692,-108,0.4968097050688719,COL,CWS,2023 REG,13,11,11,5,16,24,1,0,6,-6,1,1,1,1,1,0,0,0,0,0.5031902949311281,0.4968097050688719
90786,0.5238095238095238,0.5145631067961165,-110,-106,0.5037095744446646,0.4962904255553354,away,DET,over,7.5,0.49019607843137253,104,0.46874141813588177,CLE,DET,2023 REG,4,0,8,5,5,12,0,1,-5,5,0,0,0,0,0,0,0,0,0,0.46874141813588177,0.5312585818641182
90786,0.5238095238095238,0.5145631067961165,-110,-106,0.5037095744446646,0.4962904255553354,home,CLE,under,7.5,0.5535714285714286,-124,0.5312585818641182,CLE,DET,2023 REG,4,0,8,5,5,12,0,1,-5,5,0,0,0,0,0,0,0,0,0,0.46874141813588177,0.5312585818641182
90787,0.3802281368821293,0.6610169491525424,163,-195,0.3645455946636229,0.6354544053363771,away,ATL,over,9.5,0.5283018867924528,-112,0.5044173060022736,NYM,ATL,2023 REG,7,0,11,7,7,18,0,1,-7,7,0,0,0,0,0,0,0,0,0,0.5044173060022736,0.49558269399772636
90787,0.3802281368821293,0.6610169491525424,163,-195,0.3645455946636229,0.6354544053363771,home,NYM,under,9.5,0.5169082125603864,-107,0.49558269399772636,NYM,ATL,2023 REG,7,0,11,7,7,18,0,1,-7,7,0,0,0,0,0,0,0,0,0,0.5044173060022736,0.49558269399772636
90788,0.5918367346938775,0.4444444444444444,-145,125,0.5703642001018094,0.42963579989819056,away,PHI,over,7.5,0.5370370370370371,-116,0.5131785224377817,LAD,PHI,2023 REG,17,13,2,1,14,19,1,0,12,-12,1,0,0,0,0,0,0,0,0,0.5131785224377817,0.4868214775622183
90788,0.5918367346938775,0.4444444444444444,-145,125,0.5703642001018094,0.42963579989819056,home,LAD,under,7.5,0.5073891625615764,-103,0.4868214775622183,LAD,PHI,2023 REG,17,13,2,1,14,19,1,0,12,-12,1,0,0,0,0,0,0,0,0,0.5131785224377817,0.4868214775622183
90789,0.47619047619047616,0.5652173913043479,110,-130,0.4564724440500838,0.5435275559499162,away,SEA,over,9,0.5348837209302326,-115,0.5097020142727117,ARI,SEA,2023 REG,10,2,10,5,7,20,0,1,-3,3,1,1,0,0,0,0,0,0,0,0.5097020142727117,0.49029798572728833
90789,0.47619047619047616,0.5652173913043479,110,-130,0.4564724440500838,0.5435275559499162,home,ARI,under,9,0.5121951219512195,-105,0.49029798572728833,ARI,SEA,2023 REG,10,2,10,5,7,20,0,1,-3,3,1,1,0,0,0,0,0,0,0,0.5097020142727117,0.49029798572728833
90790,0.5555555555555556,0.48780487804878053,-125,105,0.5314664257753688,0.46853357422463116,away,TOR,over,8,0.5192307692307692,-108,0.49571111079951763,TB,TOR,2023 REG,12,7,10,6,13,22,1,0,1,-1,1,1,1,1,1,1,0,0,0,0.49571111079951763,0.5042888892004824
90790,0.5555555555555556,0.48780487804878053,-125,105,0.5314664257753688,0.46853357422463116,home,TB,under,8,0.5260663507109005,-111,0.5042888892004824,TB,TOR,2023 REG,12,7,10,6,13,22,1,0,1,-1,1,1,1,1,1,1,0,0,0,0.49571111079951763,0.5042888892004824
90791,0.4672897196261683,0.5708154506437768,114,-133,0.44948356529441824,0.5505164347055818,away,MIA,over,11.5,0.5121951219512195,-105,0.48808156828023186,COL,MIA,2023 REG,7,5,11,4,9,18,1,0,1,-1,1,1,1,1,0,0,0,0,0,0.48808156828023186,0.5119184317197681
90791,0.4672897196261683,0.5708154506437768,114,-133,0.44948356529441824,0.5505164347055818,home,COL,under,11.5,0.5348837209302326,-115,0.5119184317197681,COL,MIA,2023 REG,7,5,11,4,9,18,1,0,1,-1,1,1,1,1,0,0,0,0,0,0.48808156828023186,0.5119184317197681
90792,0.5850622406639003,0.45454545454545453,-141,120,0.5618892737571823,0.43811072624281766,away,MIL,over,9,0.5238095238095238,-110,0.4988662131519274,SF,MIL,2023 REG,13,3,12,7,10,25,0,1,-4,4,1,1,1,0,0,0,0,0,0,0.4988662131519274,0.5011337868480725
90792,0.5850622406639003,0.45454545454545453,-141,120,0.5618892737571823,0.43811072624281766,home,SF,under,9,0.5238095238095238,-110,0.5011337868480725,SF,MIL,2023 REG,13,3,12,7,10,25,0,1,-4,4,1,1,1,0,0,0,0,0,0,0.4988662131519274,0.5011337868480725
90793,0.5884773662551441,0.4444444444444444,-143,125,0.5691036258022998,0.4308963741977002,away,CWS,over,8,0.5073891625615764,-103,0.4837652908580103,CLE,CWS,2023 REG,4,0,4,6,6,8,0,1,-6,6,0,0,0,0,0,0,0,0,0,0.4837652908580103,0.5162347091419897
90793,0.5884773662551441,0.4444444444444444,-143,125,0.5691036258022998,0.4308963741977002,home,CLE,under,8,0.5391705069124424,-117,0.5162347091419897,CLE,CWS,2023 REG,4,0,4,6,6,8,0,1,-6,6,0,0,0,0,0,0,0,0,0,0.4837652908580103,0.5162347091419897
90794,0.6563573883161512,0.38314176245210724,-191,161,0.6304318288771912,0.3695681711228088,away,MIA,over,9,0.5348837209302326,-115,0.5097020142727117,PHI,MIA,2023 REG,7,8,10,4,12,17,1,0,4,-4,1,1,1,1,0,0,0,0,0,0.5097020142727117,0.49029798572728833
90794,0.6563573883161512,0.38314176245210724,-191,161,0.6304318288771912,0.3695681711228088,home,PHI,under,9,0.5121951219512195,-105,0.49029798572728833,PHI,MIA,2023 REG,7,8,10,4,12,17,1,0,4,-4,1,1,1,1,0,0,0,0,0,0.5097020142727117,0.49029798572728833
90795,0.4504504504504505,0.5884773662551441,122,-143,0.4329153978803628,0.5670846021196372,away,ATL,over,9.5,0.5454545454545454,-120,0.5206611570247933,NYM,ATL,2023 REG,10,7,7,6,13,17,1,0,1,-1,1,1,1,1,1,1,0,0,0,0.5206611570247933,0.4793388429752067
90795,0.4504504504504505,0.5884773662551441,122,-143,0.4329153978803628,0.5670846021196372,home,NYM,under,9.5,0.5,100,0.4793388429752067,NYM,ATL,2023 REG,10,7,7,6,13,17,1,0,1,-1,1,1,1,1,1,1,0,0,0,0.5206611570247933,0.4793388429752067
90796,0.6491228070175439,0.3891050583657587,-185,157,0.6243082277336457,0.3756917722663543,away,BAL,over,8,0.5238095238095238,-110,0.5000596729920038,SD,BAL,2023 REG,8,5,5,2,7,13,1,0,3,-3,1,1,0,0,0,0,0,0,0,0.5000596729920038,0.4999403270079962
90796,0.6491228070175439,0.3891050583657587,-185,157,0.6243082277336457,0.3756917722663543,home,SD,under,8,0.5215311004784688,-109,0.4999403270079962,SD,BAL,2023 REG,8,5,5,2,7,13,1,0,3,-3,1,1,0,0,0,0,0,0,0,0.5000596729920038,0.4999403270079962
90797,0.6323529411764706,0.4081632653061224,-172,145,0.6067323988418897,0.3932676011581103,away,PIT,over,9,0.5073891625615764,-103,0.48484779035144243,CHC,PIT,2023 REG,12,14,5,1,15,17,1,0,13,-13,1,0,0,0,0,0,0,0,0,0.48484779035144243,0.5151522096485576
90797,0.6323529411764706,0.4081632653061224,-172,145,0.6067323988418897,0.3932676011581103,home,CHC,under,9,0.5370370370370371,-116,0.5151522096485576,CHC,PIT,2023 REG,12,14,5,1,15,17,1,0,13,-13,1,0,0,0,0,0,0,0,0,0.48484779035144243,0.5151522096485576
90798,0.5454545454545454,0.49751243781094534,-120,101,0.5220180091279142,0.4779819908720858,away,TEX,over,8.5,0.5305164319248826,-113,0.5066009958897986,ARI,TEX,2023 REG,9,6,13,3,9,22,1,0,3,-3,1,1,1,0,0,0,0,0,0,0.5066009958897986,0.49339900411020143
90798,0.5454545454545454,0.49751243781094534,-120,101,0.5220180091279142,0.4779819908720858,home,ARI,under,8.5,0.5145631067961165,-106,0.49339900411020143,ARI,TEX,2023 REG,9,6,13,3,9,22,1,0,3,-3,1,1,1,0,0,0,0,0,0,0.5066009958897986,0.49339900411020143
90799,0.425531914893617,0.6108949416342413,135,-157,0.41003112488176247,0.5899688751182375,away,BAL,over,7.5,0.5348837209302326,-115,0.5097020142727117,DET,BAL,2023 REG,5,4,11,6,10,16,0,1,-2,2,1,1,1,1,0,0,0,0,0,0.5097020142727117,0.49029798572728833
90799,0.425531914893617,0.6108949416342413,135,-157,0.41003112488176247,0.5899688751182375,home,DET,under,7.5,0.5121951219512195,-105,0.49029798572728833,DET,BAL,2023 REG,5,4,11,6,10,16,0,1,-2,2,1,1,1,1,0,0,0,0,0,0.5097020142727117,0.49029798572728833
90800,0.5652173913043479,0.47619047619047616,-130,110,0.5418129444594474,0.4581870555405526,away,PHI,over,9,0.5192307692307692,-108,0.49571111079951763,SD,PHI,2023 REG,10,8,3,0,8,13,1,0,8,-8,0,0,0,0,0,0,0,0,0,0.49571111079951763,0.5042888892004824
90800,0.5652173913043479,0.47619047619047616,-130,110,0.5418129444594474,0.4581870555405526,home,SD,under,9,0.5260663507109005,-111,0.5042888892004824,SD,PHI,2023 REG,10,8,3,0,8,13,1,0,8,-8,0,0,0,0,0,0,0,0,0,0.49571111079951763,0.5042888892004824
90801,0.5098039215686274,0.5348837209302326,-104,-115,0.4870219861770517,0.5129780138229483,away,CHC,over,9,0.5238095238095238,-110,0.4988662131519274,ARI,CHC,2023 REG,12,7,12,6,13,24,1,0,1,-1,1,1,1,1,1,1,0,0,0,0.4988662131519274,0.5011337868480725
90801,0.5098039215686274,0.5348837209302326,-104,-115,0.4870219861770517,0.5129780138229483,home,ARI,under,9,0.5238095238095238,-110,0.5011337868480725,ARI,CHC,2023 REG,12,7,12,6,13,24,1,0,1,-1,1,1,1,1,1,1,0,0,0,0.4988662131519274,0.5011337868480725
90802,0.34965034965034963,0.6894409937888198,186,-222,0.3359820477485421,0.6640179522514579,away,ATL,over,8.5,0.5370370370370371,-116,0.5118817074154765,ARI,ATL,2023 REG,6,2,11,5,7,17,0,1,-3,3,1,1,0,0,0,0,0,0,0,0.5118817074154765,0.48811829258452355
90802,0.34965034965034963,0.6894409937888198,186,-222,0.3359820477485421,0.6640179522514579,home,ARI,under,8.5,0.5098039215686274,-104,0.48811829258452355,ARI,ATL,2023 REG,6,2,11,5,7,17,0,1,-3,3,1,1,0,0,0,0,0,0,0,0.5118817074154765,0.48811829258452355
90803,0.607843137254902,0.43859649122807015,-155,128,0.5796151277848601,0.42038487221513987,away,MIN,over,7.5,0.5433789954337899,-119,0.5198077604720502,LAA,MIN,2023 REG,9,4,7,2,6,16,1,0,2,-2,1,1,0,0,0,0,0,0,0,0.5198077604720502,0.48019223952794976
90803,0.607843137254902,0.43859649122807015,-155,128,0.5796151277848601,0.42038487221513987,home,LAA,under,7.5,0.5,100,0.48019223952794976,LAA,MIN,2023 REG,9,4,7,2,6,16,1,0,2,-2,1,1,0,0,0,0,0,0,0,0.5198077604720502,0.48019223952794976
90804,0.5238095238095238,0.5215311004784688,-110,-109,0.5000596729920038,0.4999403270079962,away,STL,over,9,0.5098039215686274,-104,0.48592421718142587,SF,STL,2023 REG,13,7,8,3,10,21,1,0,4,-4,1,1,1,0,0,0,0,0,0,0.48592421718142587,0.5140757828185741
90804,0.5238095238095238,0.5215311004784688,-110,-109,0.5000596729920038,0.4999403270079962,home,SF,under,9,0.5370370370370371,-116,0.5140757828185741,SF,STL,2023 REG,13,7,8,3,10,21,1,0,4,-4,1,1,1,0,0,0,0,0,0,0.48592421718142587,0.5140757828185741
90805,0.6153846153846154,0.425531914893617,-160,135,0.5902052121364724,0.40979478786352763,away,SD,over,9,0.5283018867924528,-112,0.5031902949311281,ATL,SD,2023 REG,5,1,8,4,5,13,0,1,-3,3,1,0,0,0,0,0,0,0,0,0.5031902949311281,0.4968097050688719
90805,0.6153846153846154,0.425531914893617,-160,135,0.5902052121364724,0.40979478786352763,home,ATL,under,9,0.5192307692307692,-108,0.4968097050688719,ATL,SD,2023 REG,5,1,8,4,5,13,0,1,-3,3,1,0,0,0,0,0,0,0,0,0.5031902949311281,0.4968097050688719
90806,0.4739336492890995,0.5652173913043479,111,-130,0.4553786537471813,0.5446213462528187,away,PHI,over,9,0.5305164319248826,-113,0.5066009958897986,ARI,PHI,2023 REG,7,4,13,5,9,20,0,1,-1,1,1,1,1,1,0,0,0,0,0,0.5066009958897986,0.49339900411020143
90806,0.4739336492890995,0.5652173913043479,111,-130,0.4553786537471813,0.5446213462528187,home,ARI,under,9,0.5145631067961165,-106,0.49339900411020143,ARI,PHI,2023 REG,7,4,13,5,9,20,0,1,-1,1,1,1,1,1,0,0,0,0,0,0.5066009958897986,0.49339900411020143
90807,0.6688741721854304,0.37037037037037035,-202,170,0.6426245112706233,0.35737548872937674,away,MIA,over,8.5,0.5475113122171946,-121,0.5228602997583487,SD,MIA,2023 REG,7,6,7,2,8,14,1,0,4,-4,1,1,0,0,0,0,0,0,0,0.5228602997583487,0.4771397002416513
90807,0.6688741721854304,0.37037037037037035,-202,170,0.6426245112706233,0.35737548872937674,home,SD,under,8.5,0.49751243781094534,101,0.4771397002416513,SD,MIA,2023 REG,7,6,7,2,8,14,1,0,4,-4,1,1,0,0,0,0,0,0,0,0.5228602997583487,0.4771397002416513
90808,0.5670995670995671,0.4716981132075471,-131,112,0.5450974193929352,0.4549025806070648,away,BAL,over,8.5,0.5,100,0.4762443438914027,MIL,BAL,2023 REG,8,4,8,3,7,16,1,0,1,-1,1,1,1,0,0,0,0,0,0,0.4762443438914027,0.5237556561085973
90808,0.5670995670995671,0.4716981132075471,-131,112,0.5450974193929352,0.4549025806070648,home,MIL,under,8.5,0.5475113122171946,-121,0.5237556561085973,MIL,BAL,2023 REG,8,4,8,3,7,16,1,0,1,-1,1,1,1,0,0,0,0,0,0,0.4762443438914027,0.5237556561085973
90809,0.5283018867924528,0.5121951219512195,-112,-105,0.5069072406637203,0.4930927593362797,away,SEA,over,8.5,0.5327102803738317,-114,0.5075272610403079,TOR,SEA,2023 REG,8,3,6,2,5,14,1,0,1,-1,1,1,0,0,0,0,0,0,0,0.5075272610403079,0.4924727389596921
90809,0.5283018867924528,0.5121951219512195,-112,-105,0.5069072406637203,0.4930927593362797,home,TOR,under,8.5,0.5145631067961165,-106,0.4924727389596921,TOR,SEA,2023 REG,8,3,6,2,5,14,1,0,1,-1,1,1,0,0,0,0,0,0,0,0.5075272610403079,0.4924727389596921
90810,0.5454545454545454,0.49751243781094534,-120,101,0.5220180091279142,0.4779819908720858,away,MIA,over,8.5,0.5238095238095238,-110,0.4988662131519274,BAL,MIA,2023 REG,11,6,11,5,11,22,1,0,1,-1,1,1,1,1,1,0,0,0,0,0.4988662131519274,0.5011337868480725
90810,0.5454545454545454,0.49751243781094534,-120,101,0.5220180091279142,0.4779819908720858,home,BAL,under,8.5,0.5238095238095238,-110,0.5011337868480725,BAL,MIA,2023 REG,11,6,11,5,11,22,1,0,1,-1,1,1,1,1,1,0,0,0,0,0.4988662131519274,0.5011337868480725
90811,0.4347826086956522,0.6000000000000001,130,-150,0.4196597353497164,0.5803402646502835,away,SEA,over,9,0.5,100,0.47935779816513757,CHC,SEA,2023 REG,8,3,6,2,5,14,1,0,1,-1,1,1,0,0,0,0,0,0,0,0.47935779816513757,0.5206422018348624
90811,0.4347826086956522,0.6000000000000001,130,-150,0.4196597353497164,0.5803402646502835,home,CHC,under,9,0.5412844036697247,-118,0.5206422018348624,CHC,SEA,2023 REG,8,3,6,2,5,14,1,0,1,-1,1,1,0,0,0,0,0,0,0,0.47935779816513757,0.5206422018348624
90812,0.48780487804878053,0.5555555555555556,105,-125,0.4666534470222751,0.5333465529777248,away,MIN,over,8.5,0.5454545454545454,-120,0.5206611570247933,CLE,MIN,2023 REG,3,0,3,2,2,6,0,1,-2,2,0,0,0,0,0,0,0,0,0,0.5206611570247933,0.4793388429752067
90812,0.48780487804878053,0.5555555555555556,105,-125,0.4666534470222751,0.5333465529777248,home,CLE,under,8.5,0.5,100,0.4793388429752067,CLE,MIN,2023 REG,3,0,3,2,2,6,0,1,-2,2,0,0,0,0,0,0,0,0,0,0.5206611570247933,0.4793388429752067
90813,0.6923076923076923,0.34965034965034963,-225,186,0.663259817105971,0.33674018289402896,away,KC,over,8,0.5238095238095238,-110,0.4988662131519274,CLE,KC,2023 REG,7,1,10,4,5,17,0,1,-3,3,1,0,0,0,0,0,0,0,0,0.4988662131519274,0.5011337868480725
90813,0.6923076923076923,0.34965034965034963,-225,186,0.663259817105971,0.33674018289402896,home,CLE,under,8,0.5238095238095238,-110,0.5011337868480725,CLE,KC,2023 REG,7,1,10,4,5,17,0,1,-3,3,1,0,0,0,0,0,0,0,0,0.4988662131519274,0.5011337868480725
90814,0.607843137254902,0.4347826086956522,-155,130,0.5819333701084867,0.41806662989151333,away,CHC,over,9,0.5073891625615764,-103,0.48484779035144243,TOR,CHC,2023 REG,5,2,10,6,8,15,0,1,-4,4,1,1,0,0,0,0,0,0,0,0.48484779035144243,0.5151522096485576
90814,0.607843137254902,0.4347826086956522,-155,130,0.5819333701084867,0.41806662989151333,home,TOR,under,9,0.5370370370370371,-116,0.5151522096485576,TOR,CHC,2023 REG,5,2,10,6,8,15,0,1,-4,4,1,1,0,0,0,0,0,0,0,0.48484779035144243,0.5151522096485576
90815,0.5867768595041323,0.4484304932735426,-142,123,0.5661179996097941,0.43388200039020586,away,KC,over,8.5,0.5073891625615764,-103,0.4826927225525911,SF,KC,2023 REG,12,5,8,6,11,20,0,1,-1,1,1,1,1,1,1,0,0,0,0,0.4826927225525911,0.5173072774474089
90815,0.5867768595041323,0.4484304932735426,-142,123,0.5661179996097941,0.43388200039020586,home,SF,under,8.5,0.5412844036697247,-118,0.5173072774474089,SF,KC,2023 REG,12,5,8,6,11,20,0,1,-1,1,1,1,1,1,1,0,0,0,0,0.4826927225525911,0.5173072774474089
90816,0.6491228070175439,0.390625,-185,156,0.6233215989535241,0.3766784010464759,away,NYY,over,8.5,0.5348837209302326,-115,0.5097020142727117,TOR,NYY,2023 REG,13,6,7,0,6,20,1,0,6,-6,0,0,0,0,0,0,0,0,0,0.5097020142727117,0.49029798572728833
90816,0.6491228070175439,0.390625,-185,156,0.6233215989535241,0.3766784010464759,home,TOR,under,8.5,0.5121951219512195,-105,0.49029798572728833,TOR,NYY,2023 REG,13,6,7,0,6,20,1,0,6,-6,0,0,0,0,0,0,0,0,0,0.5097020142727117,0.49029798572728833
90817,0.5918367346938775,0.4444444444444444,-145,125,0.5703642001018094,0.42963579989819056,away,LAD,over,8.5,0.5454545454545454,-120,0.5206611570247933,LAA,LAD,2023 REG,2,0,6,2,2,8,0,1,-2,2,0,0,0,0,0,0,0,0,0,0.5206611570247933,0.4793388429752067
90817,0.5918367346938775,0.4444444444444444,-145,125,0.5703642001018094,0.42963579989819056,home,LAA,under,8.5,0.5,100,0.4793388429752067,LAA,LAD,2023 REG,2,0,6,2,2,8,0,1,-2,2,0,0,0,0,0,0,0,0,0,0.5206611570247933,0.4793388429752067
90818,0.3921568627450981,0.6453900709219857,155,-182,0.37743257503251615,0.6225674249674839,away,LAD,over,9,0.5,100,0.4762443438914027,KC,LAD,2023 REG,15,9,6,1,10,21,1,0,8,-8,1,0,0,0,0,0,0,0,0,0.4762443438914027,0.5237556561085973
90818,0.3921568627450981,0.6453900709219857,155,-182,0.37743257503251615,0.6225674249674839,home,KC,under,9,0.5475113122171946,-121,0.5237556561085973,KC,LAD,2023 REG,15,9,6,1,10,21,1,0,8,-8,1,0,0,0,0,0,0,0,0,0.4762443438914027,0.5237556561085973
90819,0.4926108374384236,0.5495495495495495,103,-122,0.4718421738975501,0.5281578261024499,away,BOS,over,7.5,0.5391705069124424,-117,0.5140669063204599,BAL,BOS,2023 REG,3,0,4,3,3,7,0,1,-3,3,0,0,0,0,0,0,0,0,0,0.5140669063204599,0.4859330936795401
90819,0.4926108374384236,0.5495495495495495,103,-122,0.4718421738975501,0.5281578261024499,home,BAL,under,7.5,0.5073891625615764,-103,0.4859330936795401,BAL,BOS,2023 REG,3,0,4,3,3,7,0,1,-3,3,0,0,0,0,0,0,0,0,0,0.5140669063204599,0.4859330936795401
90820,0.5238095238095238,0.5145631067961165,-110,-106,0.5037095744446646,0.4962904255553354,away,HOU,over,8.5,0.5192307692307692,-108,0.49340049170764233,ATL,HOU,2023 REG,8,3,11,6,9,19,0,1,-3,3,1,1,1,0,0,0,0,0,0,0.49340049170764233,0.5065995082923577
90820,0.5238095238095238,0.5145631067961165,-110,-106,0.5037095744446646,0.4962904255553354,home,ATL,under,8.5,0.5305164319248826,-113,0.5065995082923577,ATL,HOU,2023 REG,8,3,11,6,9,19,0,1,-3,3,1,1,1,0,0,0,0,0,0,0.49340049170764233,0.5065995082923577
90821,0.5391705069124424,0.504950495049505,-117,-102,0.5153817639191344,0.4846182360808656,away,CHC,over,7.5,0.5412844036697247,-118,0.5149381613977361,MIL,CHC,2023 REG,6,6,8,5,11,14,1,0,1,-1,1,1,1,1,1,0,0,0,0,0.5149381613977361,0.48506183860226393
90821,0.5391705069124424,0.504950495049505,-117,-102,0.5153817639191344,0.4846182360808656,home,MIL,under,7.5,0.5073891625615764,-103,0.48506183860226393,MIL,CHC,2023 REG,6,6,8,5,11,14,1,0,1,-1,1,1,1,1,1,0,0,0,0,0.5149381613977361,0.48506183860226393
90822,0.5967741935483871,0.4444444444444444,-148,125,0.5721759741010521,0.42782402589894786,away,BOS,over,9,0.5412844036697247,-118,0.5162581740877563,CHC,BOS,2023 REG,5,5,13,11,16,18,0,1,-6,6,1,1,1,1,1,0,0,0,0,0.5162581740877563,0.4837418259122437
90822,0.5967741935483871,0.4444444444444444,-148,125,0.5721759741010521,0.42782402589894786,home,CHC,under,9,0.504950495049505,-102,0.4837418259122437,CHC,BOS,2023 REG,5,5,13,11,16,18,0,1,-6,6,1,1,1,1,1,0,0,0,0,0.5162581740877563,0.4837418259122437
90823,0.5475113122171946,0.49019607843137253,-121,104,0.5268660892829112,0.47313391071708877,away,SEA,over,8,0.5121951219512195,-105,0.48808156828023186,NYY,SEA,2023 REG,5,2,11,10,12,16,0,1,-8,8,1,1,0,0,0,0,0,0,0,0.48808156828023186,0.5119184317197681
90823,0.5475113122171946,0.49019607843137253,-121,104,0.5268660892829112,0.47313391071708877,home,NYY,under,8,0.5348837209302326,-115,0.5119184317197681,NYY,SEA,2023 REG,5,2,11,10,12,16,0,1,-8,8,1,1,0,0,0,0,0,0,0,0.48808156828023186,0.5119184317197681
90824,0.5283018867924528,0.5145631067961165,-112,-106,0.5056562298022652,0.4943437701977348,away,BOS,over,9,0.5260663507109005,-111,0.5022370601254724,NYY,BOS,2023 REG,8,5,9,6,11,17,0,1,-1,1,1,1,1,1,1,0,0,0,0,0.5022370601254724,0.4977629398745276
90824,0.5283018867924528,0.5145631067961165,-112,-106,0.5056562298022652,0.4943437701977348,home,NYY,under,9,0.5192307692307692,-108,0.4977629398745276,NYY,BOS,2023 REG,8,5,9,6,11,17,0,1,-1,1,1,1,1,1,1,0,0,0,0,0.5022370601254724,0.4977629398745276
90825,0.4694835680751174,0.5708154506437768,113,-133,0.45056384097704505,0.549436159022955,away,LAA,over,9,0.5283018867924528,-112,0.5056562298022652,OAK,LAA,2023 REG,10,10,9,6,16,19,1,0,4,-4,1,1,1,1,1,1,0,0,0,0.5056562298022652,0.4943437701977348
90825,0.4694835680751174,0.5708154506437768,113,-133,0.45056384097704505,0.549436159022955,home,OAK,under,9,0.5145631067961165,-106,0.4943437701977348,OAK,LAA,2023 REG,10,10,9,6,16,19,1,0,4,-4,1,1,1,1,1,1,0,0,0,0.5056562298022652,0.4943437701977348
90826,0.5192307692307692,0.5238095238095238,-108,-110,0.49688292476754015,0.5031170752324599,away,TEX,over,8.5,0.5348837209302326,-115,0.5097020142727117,NYY,TEX,2023 REG,6,2,10,4,6,16,0,1,-2,2,1,1,0,0,0,0,0,0,0,0.5097020142727117,0.49029798572728833
90826,0.5192307692307692,0.5238095238095238,-108,-110,0.49688292476754015,0.5031170752324599,home,NYY,under,8.5,0.5121951219512195,-105,0.49029798572728833,NYY,TEX,2023 REG,6,2,10,4,6,16,0,1,-2,2,1,1,0,0,0,0,0,0,0,0.5097020142727117,0.49029798572728833
90827,0.5454545454545454,0.49019607843137253,-120,104,0.526008750607681,0.47399124939231896,away,HOU,over,8.5,0.5024875621890548,-101,0.4794401874631478,CLE,HOU,2023 REG,11,5,4,0,5,15,1,0,5,-5,0,0,0,0,0,0,0,0,0,0.4794401874631478,0.5205598125368522
90827,0.5454545454545454,0.49019607843137253,-120,104,0.526008750607681,0.47399124939231896,home,CLE,under,8.5,0.5433789954337899,-119,0.5205598125368522,CLE,HOU,2023 REG,11,5,4,0,5,15,1,0,5,-5,0,0,0,0,0,0,0,0,0,0.4794401874631478,0.5205598125368522
90828,0.5454545454545454,0.48780487804878053,-120,105,0.5273130417254586,0.47268695827454144,away,CIN,over,8.5,0.5098039215686274,-104,0.48375889301574193,HOU,CIN,2023 REG,7,3,13,10,13,20,0,1,-7,7,1,1,1,0,0,0,0,0,0,0.48375889301574193,0.5162411069842581
90828,0.5454545454545454,0.48780487804878053,-120,105,0.5273130417254586,0.47268695827454144,home,HOU,under,8.5,0.5412844036697247,-118,0.5162411069842581,HOU,CIN,2023 REG,7,3,13,10,13,20,0,1,-7,7,1,1,1,0,0,0,0,0,0,0.48375889301574193,0.5162411069842581
90829,0.48309178743961345,0.5555555555555556,107,-125,0.4644215734322854,0.5355784265677146,away,SF,over,8,0.5454545454545454,-120,0.5206611570247933,MIL,SF,2023 REG,7,7,7,5,12,14,1,0,2,-2,1,1,1,1,1,0,0,0,0,0.5206611570247933,0.4793388429752067
90829,0.48309178743961345,0.5555555555555556,107,-125,0.4644215734322854,0.5355784265677146,home,MIL,under,8,0.5,100,0.4793388429752067,MIL,SF,2023 REG,7,7,7,5,12,14,1,0,2,-2,1,1,1,1,1,0,0,0,0,0.5206611570247933,0.4793388429752067
90830,0.6363636363636364,0.4081632653061224,-175,145,0.6080283353010626,0.3919716646989374,away,LAA,over,7.5,0.5,100,0.4772727272727273,SEA,LAA,2023 REG,13,11,7,2,13,20,1,0,9,-9,1,1,0,0,0,0,0,0,0,0.4772727272727273,0.5227272727272727
90830,0.6363636363636364,0.4081632653061224,-175,145,0.6080283353010626,0.3919716646989374,home,SEA,under,7.5,0.5454545454545454,-120,0.5227272727272727,SEA,LAA,2023 REG,13,11,7,2,13,20,1,0,9,-9,1,1,0,0,0,0,0,0,0,0.4772727272727273,0.5227272727272727
90831,0.5780590717299579,0.46511627906976744,-137,115,0.5531011685250534,0.4468988314749466,away,CLE,over,8.5,0.5454545454545454,-120,0.5206611570247933,HOU,CLE,2023 REG,10,3,7,2,5,17,1,0,1,-1,1,1,0,0,0,0,0,0,0,0.5206611570247933,0.4793388429752067
90831,0.5780590717299579,0.46511627906976744,-137,115,0.5531011685250534,0.4468988314749466,home,HOU,under,8.5,0.5,100,0.4793388429752067,HOU,CLE,2023 REG,10,3,7,2,5,17,1,0,1,-1,1,1,0,0,0,0,0,0,0,0.5206611570247933,0.4793388429752067
90832,0.48780487804878053,0.5555555555555556,105,-125,0.4666534470222751,0.5333465529777248,away,PIT,over,11,0.5238095238095238,-110,0.4988662131519274,COL,PIT,2023 REG,5,3,18,14,17,23,0,1,-11,11,1,1,1,0,0,0,0,0,0,0.4988662131519274,0.5011337868480725
90832,0.48780487804878053,0.5555555555555556,105,-125,0.4666534470222751,0.5333465529777248,home,COL,under,11,0.5238095238095238,-110,0.5011337868480725,COL,PIT,2023 REG,5,3,18,14,17,23,0,1,-11,11,1,1,1,0,0,0,0,0,0,0.4988662131519274,0.5011337868480725
90833,0.607843137254902,0.4347826086956522,-155,130,0.5819333701084867,0.41806662989151333,away,CWS,over,8.5,0.5238095238095238,-110,0.4988662131519274,BOS,CWS,2023 REG,8,0,5,1,1,13,0,1,-1,1,0,0,0,0,0,0,0,0,0,0.4988662131519274,0.5011337868480725
90833,0.607843137254902,0.4347826086956522,-155,130,0.5819333701084867,0.41806662989151333,home,BOS,under,8.5,0.5238095238095238,-110,0.5011337868480725,BOS,CWS,2023 REG,8,0,5,1,1,13,0,1,-1,1,0,0,0,0,0,0,0,0,0,0.4988662131519274,0.5011337868480725
90834,0.635036496350365,0.4081632653061224,-174,145,0.6076030710648583,0.39239692893514166,away,DET,over,8.5,0.5454545454545454,-120,0.5206611570247933,CWS,DET,2023 REG,9,6,4,2,8,13,1,0,4,-4,1,1,0,0,0,0,0,0,0,0.5206611570247933,0.4793388429752067
90834,0.635036496350365,0.4081632653061224,-174,145,0.6076030710648583,0.39239692893514166,home,CWS,under,8.5,0.5,100,0.4793388429752067,CWS,DET,2023 REG,9,6,4,2,8,13,1,0,4,-4,1,1,0,0,0,0,0,0,0,0.5206611570247933,0.4793388429752067
90835,0.5934959349593496,0.4464285714285714,-146,124,0.5698009027128599,0.4301990972871401,away,KC,over,8.5,0.5305164319248826,-113,0.5066009958897986,DET,KC,2023 REG,2,0,5,1,1,7,0,1,-1,1,0,0,0,0,0,0,0,0,0,0.5066009958897986,0.49339900411020143
90835,0.5934959349593496,0.4464285714285714,-146,124,0.5698009027128599,0.4301990972871401,home,DET,under,8.5,0.5145631067961165,-106,0.49339900411020143,DET,KC,2023 REG,2,0,5,1,1,7,0,1,-1,1,0,0,0,0,0,0,0,0,0,0.5066009958897986,0.49339900411020143
90836,0.5121951219512195,0.5348837209302326,-105,-115,0.48808156828023186,0.5119184317197681,away,BOS,over,8.5,0.5327102803738317,-114,0.5075272610403079,CWS,BOS,2023 REG,10,5,9,4,9,19,1,0,1,-1,1,1,1,1,0,0,0,0,0,0.5075272610403079,0.4924727389596921
90836,0.5121951219512195,0.5348837209302326,-105,-115,0.48808156828023186,0.5119184317197681,home,CWS,under,8.5,0.5145631067961165,-106,0.4924727389596921,CWS,BOS,2023 REG,10,5,9,4,9,19,1,0,1,-1,1,1,1,1,0,0,0,0,0,0.5075272610403079,0.4924727389596921
90837,0.4,0.6389891696750902,150,-177,0.3844043321299639,0.6155956678700361,away,TEX,over,8.5,0.5121951219512195,-105,0.48808156828023186,DET,TEX,2023 REG,5,0,10,5,5,15,0,1,-5,5,0,0,0,0,0,0,0,0,0,0.48808156828023186,0.5119184317197681
90837,0.4,0.6389891696750902,150,-177,0.3844043321299639,0.6155956678700361,home,DET,under,8.5,0.5348837209302326,-115,0.5119184317197681,DET,TEX,2023 REG,5,0,10,5,5,15,0,1,-5,5,0,0,0,0,0,0,0,0,0,0.48808156828023186,0.5119184317197681
90838,0.6610169491525424,0.37593984962406013,-195,166,0.6365878787747881,0.36341212122521194,away,PIT,over,8.5,0.5454545454545454,-120,0.5233614270517961,STL,PIT,2023 REG,7,3,10,6,9,17,0,1,-3,3,1,1,1,0,0,0,0,0,0,0.5233614270517961,0.4766385729482039
90838,0.6610169491525424,0.37593984962406013,-195,166,0.6365878787747881,0.36341212122521194,home,STL,under,8.5,0.49504950495049505,102,0.4766385729482039,STL,PIT,2023 REG,7,3,10,6,9,17,0,1,-3,3,1,1,1,0,0,0,0,0,0,0.5233614270517961,0.4766385729482039
90839,0.574468085106383,0.46511627906976744,-135,115,0.5517281312179562,0.44827186878204384,away,PIT,over,8,0.5305164319248826,-113,0.5053568787472517,SF,PIT,2023 REG,18,14,9,4,18,27,1,0,10,-10,1,1,1,1,0,0,0,0,0,0.5053568787472517,0.49464312125274834
90839,0.574468085106383,0.46511627906976744,-135,115,0.5517281312179562,0.44827186878204384,home,SF,under,8,0.5169082125603864,-107,0.49464312125274834,SF,PIT,2023 REG,18,14,9,4,18,27,1,0,10,-10,1,1,1,1,0,0,0,0,0,0.5053568787472517,0.49464312125274834
90840,0.5884773662551441,0.4504504504504505,-143,122,0.5655692272061728,0.43443077279382725,away,WSH,over,11.5,0.5391705069124424,-117,0.5127649394825569,COL,WSH,2023 REG,10,7,8,6,13,18,1,0,1,-1,1,1,1,1,1,1,0,0,0,0.5127649394825569,0.48723506051744314
90840,0.5884773662551441,0.4504504504504505,-143,122,0.5655692272061728,0.43443077279382725,home,COL,under,11.5,0.5098039215686274,-104,0.48723506051744314,COL,WSH,2023 REG,10,7,8,6,13,18,1,0,1,-1,1,1,1,1,1,1,0,0,0,0.5127649394825569,0.48723506051744314
90841,0.5121951219512195,0.5238095238095238,-105,-110,0.4937537180249852,0.5062462819750149,away,SEA,over,7.5,0.5348837209302326,-115,0.5097020142727117,TEX,SEA,2023 REG,7,2,3,0,2,10,1,0,2,-2,0,0,0,0,0,0,0,0,0,0.5097020142727117,0.49029798572728833
90841,0.5121951219512195,0.5238095238095238,-105,-110,0.4937537180249852,0.5062462819750149,home,TEX,under,7.5,0.5121951219512195,-105,0.49029798572728833,TEX,SEA,2023 REG,7,2,3,0,2,10,1,0,2,-2,0,0,0,0,0,0,0,0,0,0.5097020142727117,0.49029798572728833
90842,0.5833333333333333,0.4629629629629629,-140,116,0.5563271604938271,0.44367283950617287,away,DET,over,8.5,0.5238095238095238,-110,0.4988662131519274,CLE,DET,2023 REG,7,4,6,1,5,13,1,0,3,-3,1,0,0,0,0,0,0,0,0,0.4988662131519274,0.5011337868480725
90842,0.5833333333333333,0.4629629629629629,-140,116,0.5563271604938271,0.44367283950617287,home,CLE,under,8.5,0.5238095238095238,-110,0.5011337868480725,CLE,DET,2023 REG,7,4,6,1,5,13,1,0,3,-3,1,0,0,0,0,0,0,0,0,0.4988662131519274,0.5011337868480725
90843,0.6923076923076923,0.34602076124567477,-225,189,0.6657726090784382,0.33422739092156184,away,KC,over,9.5,0.5169082125603864,-107,0.49239402434819424,CHC,KC,2023 REG,9,6,10,4,10,19,1,0,2,-2,1,1,1,1,0,0,0,0,0,0.49239402434819424,0.5076059756518058
90843,0.6923076923076923,0.34602076124567477,-225,189,0.6657726090784382,0.33422739092156184,home,CHC,under,9.5,0.5305164319248826,-113,0.5076059756518058,CHC,KC,2023 REG,9,6,10,4,10,19,1,0,2,-2,1,1,1,1,0,0,0,0,0,0.49239402434819424,0.5076059756518058
90844,0.5670995670995671,0.47619047619047616,-131,110,0.542549802290062,0.457450197709938,away,PIT,over,8,0.5121951219512195,-105,0.48808156828023186,PHI,PIT,2023 REG,8,7,11,6,13,19,1,0,1,-1,1,1,1,1,1,1,0,0,0,0.48808156828023186,0.5119184317197681
90844,0.5670995670995671,0.47619047619047616,-131,110,0.542549802290062,0.457450197709938,home,PHI,under,8,0.5348837209302326,-115,0.5119184317197681,PHI,PIT,2023 REG,8,7,11,6,13,19,1,0,1,-1,1,1,1,1,1,1,0,0,0,0.48808156828023186,0.5119184317197681
90845,0.504950495049505,0.5391705069124424,-102,-117,0.4826715732667395,0.5173284267332605,away,SD,over,7,0.5073891625615764,-103,0.4826927225525911,SF,SD,2023 REG,7,2,9,1,3,16,1,0,1,-1,1,0,0,0,0,0,0,0,0,0.4826927225525911,0.5173072774474089
90845,0.504950495049505,0.5391705069124424,-102,-117,0.4826715732667395,0.5173284267332605,home,SF,under,7,0.5412844036697247,-118,0.5173072774474089,SF,SD,2023 REG,7,2,9,1,3,16,1,0,1,-1,1,0,0,0,0,0,0,0,0,0.4826927225525911,0.5173072774474089
90846,0.5689655172413793,0.4716981132075471,-132,112,0.5458293137100936,0.4541706862899064,away,CWS,over,8.5,0.5433789954337899,-119,0.5171177654451503,NYM,CWS,2023 REG,10,11,12,10,21,22,1,0,1,-1,1,1,1,1,1,1,1,1,1,0.5171177654451503,0.4828822345548497
90846,0.5689655172413793,0.4716981132075471,-132,112,0.5458293137100936,0.4541706862899064,home,NYM,under,8.5,0.504950495049505,-102,0.4828822345548497,NYM,CWS,2023 REG,10,11,12,10,21,22,1,0,1,-1,1,1,1,1,1,1,1,1,1,0.5171177654451503,0.4828822345548497
90847,0.7058823529411764,0.33112582781456956,-240,202,0.679758931231238,0.320241068768762,away,COL,over,10.5,0.5145631067961165,-106,0.4913668392989033,ATL,COL,2023 REG,7,8,7,1,9,14,1,0,7,-7,1,0,0,0,0,0,0,0,0,0.4913668392989033,0.5086331607010968
90847,0.7058823529411764,0.33112582781456956,-240,202,0.679758931231238,0.320241068768762,home,ATL,under,10.5,0.5305164319248826,-113,0.5086331607010968,ATL,COL,2023 REG,7,8,7,1,9,14,1,0,7,-7,1,0,0,0,0,0,0,0,0,0.4913668392989033,0.5086331607010968
90848,0.5726495726495727,0.4672897196261683,-134,114,0.5497783539959433,0.4502216460040567,away,SF,over,7.5,0.5348837209302326,-115,0.5097020142727117,SD,SF,2023 REG,10,4,4,0,4,14,1,0,4,-4,0,0,0,0,0,0,0,0,0,0.5097020142727117,0.49029798572728833
90848,0.5726495726495727,0.4672897196261683,-134,114,0.5497783539959433,0.4502216460040567,home,SD,under,7.5,0.5121951219512195,-105,0.49029798572728833,SD,SF,2023 REG,10,4,4,0,4,14,1,0,4,-4,0,0,0,0,0,0,0,0,0,0.5097020142727117,0.49029798572728833
90849,0.6923076923076923,0.3508771929824561,-225,185,0.6624104640298972,0.33758953597010277,away,LAA,over,10,0.5238095238095238,-110,0.4988662131519274,ATL,LAA,2023 REG,4,1,10,4,5,14,0,1,-3,3,1,0,0,0,0,0,0,0,0,0.4988662131519274,0.5011337868480725
90849,0.6923076923076923,0.3508771929824561,-225,185,0.6624104640298972,0.33758953597010277,home,ATL,under,10,0.5238095238095238,-110,0.5011337868480725,ATL,LAA,2023 REG,4,1,10,4,5,14,0,1,-3,3,1,0,0,0,0,0,0,0,0,0.4988662131519274,0.5011337868480725
90850,0.6183206106870228,0.4166666666666667,-162,140,0.5966872559874133,0.40331274401258665,away,BAL,over,9,0.49504950495049505,102,0.4739797934813417,ATL,BAL,2023 REG,4,3,5,2,5,9,1,0,1,-1,1,1,0,0,0,0,0,0,0,0.4739797934813417,0.5260202065186583
90850,0.6183206106870228,0.4166666666666667,-162,140,0.5966872559874133,0.40331274401258665,home,ATL,under,9,0.5475113122171946,-121,0.5260202065186583,ATL,BAL,2023 REG,4,3,5,2,5,9,1,0,1,-1,1,1,0,0,0,0,0,0,0,0.4739797934813417,0.5260202065186583
90851,0.5121951219512195,0.5348837209302326,-105,-115,0.48808156828023186,0.5119184317197681,away,HOU,over,8,0.5348837209302326,-115,0.5097020142727117,TOR,HOU,2023 REG,5,3,6,2,5,11,1,0,1,-1,1,1,0,0,0,0,0,0,0,0.5097020142727117,0.49029798572728833
90851,0.5121951219512195,0.5348837209302326,-105,-115,0.48808156828023186,0.5119184317197681,home,TOR,under,8,0.5121951219512195,-105,0.49029798572728833,TOR,HOU,2023 REG,5,3,6,2,5,11,1,0,1,-1,1,1,0,0,0,0,0,0,0,0.5097020142727117,0.49029798572728833
90852,0.7727272727272727,0.27624309392265195,-340,262,0.7348865348614219,0.26511346513857814,away,STL,over,9,0.5238095238095238,-110,0.4988662131519274,ATL,STL,2023 REG,10,6,14,11,17,24,0,1,-5,5,1,1,1,1,1,1,0,0,0,0.4988662131519274,0.5011337868480725
90852,0.7727272727272727,0.27624309392265195,-340,262,0.7348865348614219,0.26511346513857814,home,ATL,under,9,0.5238095238095238,-110,0.5011337868480725,ATL,STL,2023 REG,10,6,14,11,17,24,0,1,-5,5,1,1,1,1,1,1,0,0,0,0.4988662131519274,0.5011337868480725
90853,0.425531914893617,0.6124031007751938,135,-158,0.4093893550345486,0.5906106449654513,away,PHI,over,9,0.5454545454545454,-120,0.5206611570247933,WSH,PHI,2023 REG,10,3,14,11,14,24,0,1,-8,8,1,1,1,0,0,0,0,0,0,0.5206611570247933,0.4793388429752067
90853,0.425531914893617,0.6124031007751938,135,-158,0.4093893550345486,0.5906106449654513,home,WSH,under,9,0.5,100,0.4793388429752067,WSH,PHI,2023 REG,10,3,14,11,14,24,0,1,-8,8,1,1,1,0,0,0,0,0,0,0.5206611570247933,0.4793388429752067
90854,0.6551724137931035,0.3846153846153846,-190,160,0.6291045458703008,0.37089545412969915,away,PIT,over,9.5,0.5,100,0.4772727272727273,LAA,PIT,2023 REG,5,0,7,3,3,12,0,1,-3,3,0,0,0,0,0,0,0,0,0,0.4772727272727273,0.5227272727272727
90854,0.6551724137931035,0.3846153846153846,-190,160,0.6291045458703008,0.37089545412969915,home,LAA,under,9.5,0.5454545454545454,-120,0.5227272727272727,LAA,PIT,2023 REG,5,0,7,3,3,12,0,1,-3,3,0,0,0,0,0,0,0,0,0,0.4772727272727273,0.5227272727272727
90855,0.5145631067961165,0.5215311004784688,-106,-109,0.4959903593635629,0.5040096406364372,away,TB,over,9.5,0.49504950495049505,102,0.47499799484898986,NYM,TB,2023 REG,8,3,6,2,5,14,1,0,1,-1,1,1,0,0,0,0,0,0,0,0.47499799484898986,0.5250020051510101
90855,0.5145631067961165,0.5215311004784688,-106,-109,0.4959903593635629,0.5040096406364372,home,NYM,under,9.5,0.5454545454545454,-120,0.5250020051510101,NYM,TB,2023 REG,8,3,6,2,5,14,1,0,1,-1,1,1,0,0,0,0,0,0,0,0.47499799484898986,0.5250020051510101
90856,0.576271186440678,0.4629629629629629,-136,116,0.553661676614851,0.446338323385149,away,NYY,over,8.5,0.5454545454545454,-120,0.5206611570247933,BOS,NYY,2023 REG,8,4,5,1,5,13,1,0,3,-3,1,0,0,0,0,0,0,0,0,0.5206611570247933,0.4793388429752067
90856,0.576271186440678,0.4629629629629629,-136,116,0.553661676614851,0.446338323385149,home,BOS,under,8.5,0.5,100,0.4793388429752067,BOS,NYY,2023 REG,8,4,5,1,5,13,1,0,3,-3,1,0,0,0,0,0,0,0,0,0.5206611570247933,0.4793388429752067
90857,0.46511627906976744,0.5670995670995671,115,-131,0.45013216457240257,0.5498678354275974,away,TB,over,9,0.5,100,0.4772727272727273,NYY,TB,2023 REG,12,7,9,8,15,21,0,1,-1,1,1,1,1,1,1,1,1,0,0,0.4772727272727273,0.5227272727272727
90857,0.46511627906976744,0.5670995670995671,115,-131,0.45013216457240257,0.5498678354275974,home,NYY,under,9,0.5454545454545454,-120,0.5227272727272727,NYY,TB,2023 REG,12,7,9,8,15,21,0,1,-1,1,1,1,1,1,1,1,1,0,0,0.4772727272727273,0.5227272727272727
90858,0.5433789954337899,0.49504950495049505,-119,102,0.5224977554989502,0.47750224450104983,away,MIL,over,9.5,0.5121951219512195,-105,0.48919479393107135,CIN,MIL,2023 REG,6,2,3,0,2,9,1,0,2,-2,0,0,0,0,0,0,0,0,0,0.48919479393107135,0.5108052060689287
90858,0.5433789954337899,0.49504950495049505,-119,102,0.5224977554989502,0.47750224450104983,home,CIN,under,9.5,0.5327102803738317,-114,0.5108052060689287,CIN,MIL,2023 REG,6,2,3,0,2,9,1,0,2,-2,0,0,0,0,0,0,0,0,0,0.48919479393107135,0.5108052060689287
90859,0.4347826086956522,0.601593625498008,130,-151,0.41896685469840866,0.5810331453015913,away,SD,over,10,0.5145631067961165,-106,0.4913668392989033,WSH,SD,2023 REG,9,5,4,3,8,13,1,0,2,-2,1,1,1,0,0,0,0,0,0,0.4913668392989033,0.5086331607010968
90859,0.4347826086956522,0.601593625498008,130,-151,0.41896685469840866,0.5810331453015913,home,WSH,under,10,0.5305164319248826,-113,0.5086331607010968,WSH,SD,2023 REG,9,5,4,3,8,13,1,0,2,-2,1,1,1,0,0,0,0,0,0,0.4913668392989033,0.5086331607010968
90860,0.5884773662551441,0.4484304932735426,-143,123,0.5667579262855877,0.43324207371441226,away,CWS,over,9.5,0.5260663507109005,-111,0.5010269332605688,CLE,CWS,2023 REG,7,4,12,7,11,19,0,1,-3,3,1,1,1,1,0,0,0,0,0,0.5010269332605688,0.4989730667394312
90860,0.5884773662551441,0.4484304932735426,-143,123,0.5667579262855877,0.43324207371441226,home,CLE,under,9.5,0.5215311004784688,-109,0.4989730667394312,CLE,CWS,2023 REG,7,4,12,7,11,19,0,1,-3,3,1,1,1,1,0,0,0,0,0,0.5010269332605688,0.4989730667394312
90861,0.6415770609318996,0.3921568627450981,-179,155,0.6199341493255103,0.3800658506744897,away,NYM,over,8,0.5391705069124424,-117,0.5127649394825569,SD,NYM,2023 REG,5,3,3,1,4,8,1,0,2,-2,1,0,0,0,0,0,0,0,0,0.5127649394825569,0.48723506051744314
90861,0.6415770609318996,0.3921568627450981,-179,155,0.6199341493255103,0.3800658506744897,home,SD,under,8,0.5098039215686274,-104,0.48723506051744314,SD,NYM,2023 REG,5,3,3,1,4,8,1,0,2,-2,1,0,0,0,0,0,0,0,0,0.5127649394825569,0.48723506051744314
90862,0.726027397260274,0.31746031746031744,-265,215,0.6944541249288857,0.3055458750711143,away,OAK,over,8.5,0.5,100,0.4772727272727273,SF,OAK,2023 REG,4,2,5,1,3,9,1,0,1,-1,1,0,0,0,0,0,0,0,0,0.4772727272727273,0.5227272727272727
90862,0.726027397260274,0.31746031746031744,-265,215,0.6944541249288857,0.3055458750711143,home,SF,under,8.5,0.5454545454545454,-120,0.5227272727272727,SF,OAK,2023 REG,4,2,5,1,3,9,1,0,1,-1,1,0,0,0,0,0,0,0,0,0.4772727272727273,0.5227272727272727
90863,0.6575342465753424,0.37735849056603776,-192,165,0.6345910769481337,0.36540892305186634,away,KC,over,8,0.5412844036697247,-118,0.5149381613977361,BAL,KC,2023 REG,8,3,7,2,5,15,1,0,1,-1,1,1,0,0,0,0,0,0,0,0.5149381613977361,0.48506183860226393
90863,0.6575342465753424,0.37735849056603776,-192,165,0.6345910769481337,0.36540892305186634,home,BAL,under,8,0.5073891625615764,-103,0.48506183860226393,BAL,KC,2023 REG,8,3,7,2,5,15,1,0,1,-1,1,1,0,0,0,0,0,0,0,0.5149381613977361,0.48506183860226393
90864,0.425531914893617,0.6153846153846154,135,-160,0.4081206254135181,0.5918793745864819,away,NYY,over,8,0.5260663507109005,-111,0.5010269332605688,PIT,NYY,2023 REG,8,3,4,2,5,12,1,0,1,-1,1,1,0,0,0,0,0,0,0,0.5010269332605688,0.4989730667394312
90864,0.425531914893617,0.6153846153846154,135,-160,0.4081206254135181,0.5918793745864819,home,PIT,under,8,0.5215311004784688,-109,0.4989730667394312,PIT,NYY,2023 REG,8,3,4,2,5,12,1,0,1,-1,1,1,0,0,0,0,0,0,0,0.5010269332605688,0.4989730667394312
90865,0.47619047619047616,0.5652173913043479,110,-130,0.4564724440500838,0.5435275559499162,away,MIL,over,9,0.5121951219512195,-105,0.48808156828023186,WSH,MIL,2023 REG,5,3,4,2,5,9,1,0,1,-1,1,1,0,0,0,0,0,0,0,0.48808156828023186,0.5119184317197681
90865,0.47619047619047616,0.5652173913043479,110,-130,0.4564724440500838,0.5435275559499162,home,WSH,under,9,0.5348837209302326,-115,0.5119184317197681,WSH,MIL,2023 REG,5,3,4,2,5,9,1,0,1,-1,1,1,0,0,0,0,0,0,0,0.48808156828023186,0.5119184317197681
90866,0.6363636363636364,0.40485829959514175,-175,147,0.6101314952989593,0.38986850470104073,away,TOR,over,8,0.5348837209302326,-115,0.5097020142727117,TB,TOR,2023 REG,5,6,8,3,9,13,1,0,3,-3,1,1,1,0,0,0,0,0,0,0.5097020142727117,0.49029798572728833
90866,0.6363636363636364,0.40485829959514175,-175,147,0.6101314952989593,0.38986850470104073,home,TB,under,8,0.5121951219512195,-105,0.49029798572728833,TB,TOR,2023 REG,5,6,8,3,9,13,1,0,3,-3,1,1,1,0,0,0,0,0,0,0.5097020142727117,0.49029798572728833
90867,0.4716981132075471,0.574468085106383,112,-135,0.44992160456890085,0.5500783954310992,away,TOR,over,9.5,0.5121951219512195,-105,0.48808156828023186,BOS,TOR,2023 REG,14,7,8,6,13,22,1,0,1,-1,1,1,1,1,1,1,0,0,0,0.48808156828023186,0.5119184317197681
90867,0.4716981132075471,0.574468085106383,112,-135,0.44992160456890085,0.5500783954310992,home,BOS,under,9.5,0.5348837209302326,-115,0.5119184317197681,BOS,TOR,2023 REG,14,7,8,6,13,22,1,0,1,-1,1,1,1,1,1,1,0,0,0,0.48808156828023186,0.5119184317197681
90868,0.4291845493562232,0.6124031007751938,133,-158,0.41133577247578673,0.5886642275242133,away,ATL,over,9.5,0.5283018867924528,-112,0.5031902949311281,PHI,ATL,2023 REG,8,8,11,10,18,19,0,1,-2,2,1,1,1,1,1,1,1,1,0,0.5031902949311281,0.4968097050688719
90868,0.4291845493562232,0.6124031007751938,133,-158,0.41133577247578673,0.5886642275242133,home,PHI,under,9.5,0.5192307692307692,-108,0.4968097050688719,PHI,ATL,2023 REG,8,8,11,10,18,19,0,1,-2,2,1,1,1,1,1,1,1,1,0,0.5031902949311281,0.4968097050688719
90869,0.46511627906976744,0.574468085106383,115,-135,0.44670494689481377,0.5532950531051862,away,CHC,over,9.5,0.5121951219512195,-105,0.48808156828023186,CIN,CHC,2023 REG,9,5,16,12,17,25,0,1,-7,7,1,1,1,1,1,0,0,0,0,0.48808156828023186,0.5119184317197681
90869,0.46511627906976744,0.574468085106383,115,-135,0.44670494689481377,0.5532950531051862,home,CIN,under,9.5,0.5348837209302326,-115,0.5119184317197681,CIN,CHC,2023 REG,9,5,16,12,17,25,0,1,-7,7,1,1,1,1,1,0,0,0,0,0.48808156828023186,0.5119184317197681
90870,0.5121951219512195,0.5305164319248826,-105,-113,0.4903184724049234,0.5096815275950766,away,ARI,over,8,0.5305164319248826,-113,0.5053568787472517,SF,ARI,2023 REG,10,7,12,6,13,22,1,0,1,-1,1,1,1,1,1,1,0,0,0,0.5053568787472517,0.49464312125274834
90870,0.5121951219512195,0.5305164319248826,-105,-113,0.4903184724049234,0.5096815275950766,home,SF,under,8,0.5169082125603864,-107,0.49464312125274834,SF,ARI,2023 REG,10,7,12,6,13,22,1,0,1,-1,1,1,1,1,1,1,0,0,0,0.5053568787472517,0.49464312125274834
90871,0.47619047619047616,0.5575221238938054,110,-126,0.46013685710272306,0.5398631428972769,away,HOU,over,9,0.5121951219512195,-105,0.48808156828023186,LAA,HOU,2023 REG,11,6,7,4,10,18,1,0,2,-2,1,1,1,1,0,0,0,0,0,0.48808156828023186,0.5119184317197681
90871,0.47619047619047616,0.5575221238938054,110,-126,0.46013685710272306,0.5398631428972769,home,LAA,under,9,0.5348837209302326,-115,0.5119184317197681,LAA,HOU,2023 REG,11,6,7,4,10,18,1,0,2,-2,1,1,1,1,0,0,0,0,0,0.48808156828023186,0.5119184317197681
90872,0.5098039215686274,0.5283018867924528,-104,-112,0.4903774310316062,0.5096225689683938,away,SF,over,10,0.5238095238095238,-110,0.4988662131519274,ARI,SF,2023 REG,12,7,11,5,12,23,1,0,2,-2,1,1,1,1,1,0,0,0,0,0.4988662131519274,0.5011337868480725
90872,0.5098039215686274,0.5283018867924528,-104,-112,0.4903774310316062,0.5096225689683938,home,ARI,under,10,0.5238095238095238,-110,0.5011337868480725,ARI,SF,2023 REG,12,7,11,5,12,23,1,0,2,-2,1,1,1,1,1,0,0,0,0,0.4988662131519274,0.5011337868480725
90873,0.6363636363636364,0.4,-175,150,0.6132231404958678,0.3867768595041322,away,LAA,over,8.5,0.5475113122171946,-121,0.5228602997583487,STL,LAA,2023 REG,10,7,16,11,18,26,0,1,-4,4,1,1,1,1,1,1,1,0,0,0.5228602997583487,0.4771397002416513
90873,0.6363636363636364,0.4,-175,150,0.6132231404958678,0.3867768595041322,home,STL,under,8.5,0.49751243781094534,101,0.4771397002416513,STL,LAA,2023 REG,10,7,16,11,18,26,0,1,-4,4,1,1,1,1,1,1,1,0,0,0.5228602997583487,0.4771397002416513
90874,0.574468085106383,0.4672897196261683,-135,114,0.550479558983428,0.44952044101657196,away,MIA,over,9,0.5121951219512195,-105,0.48808156828023186,PIT,MIA,2023 REG,6,3,3,0,3,9,1,0,3,-3,0,0,0,0,0,0,0,0,0,0.48808156828023186,0.5119184317197681
90874,0.574468085106383,0.4672897196261683,-135,114,0.550479558983428,0.44952044101657196,home,PIT,under,9,0.5348837209302326,-115,0.5119184317197681,PIT,MIA,2023 REG,6,3,3,0,3,9,1,0,3,-3,0,0,0,0,0,0,0,0,0,0.48808156828023186,0.5119184317197681
90875,0.7142857142857143,0.3278688524590164,-250,205,0.6841753094680495,0.3158246905319505,away,PIT,over,9,0.5260663507109005,-111,0.5022370601254724,LAD,PIT,2023 REG,6,6,9,4,10,15,1,0,2,-2,1,1,1,1,0,0,0,0,0,0.5022370601254724,0.4977629398745276
90875,0.7142857142857143,0.3278688524590164,-250,205,0.6841753094680495,0.3158246905319505,home,LAD,under,9,0.5192307692307692,-108,0.4977629398745276,LAD,PIT,2023 REG,6,6,9,4,10,15,1,0,2,-2,1,1,1,1,0,0,0,0,0,0.5022370601254724,0.4977629398745276
90876,0.5238095238095238,0.5145631067961165,-110,-106,0.5037095744446646,0.4962904255553354,away,PHI,over,8.5,0.5327102803738317,-114,0.508788710910954,WSH,PHI,2023 REG,7,2,10,4,6,17,0,1,-2,2,1,1,0,0,0,0,0,0,0,0.508788710910954,0.491211289089046
90876,0.5238095238095238,0.5145631067961165,-110,-106,0.5037095744446646,0.4962904255553354,home,WSH,under,8.5,0.5121951219512195,-105,0.491211289089046,WSH,PHI,2023 REG,7,2,10,4,6,17,0,1,-2,2,1,1,0,0,0,0,0,0,0,0.508788710910954,0.491211289089046
90877,0.607843137254902,0.4347826086956522,-155,130,0.5819333701084867,0.41806662989151333,away,NYM,over,8.5,0.5238095238095238,-110,0.4988662131519274,MIA,NYM,2023 REG,8,4,11,3,7,19,1,0,1,-1,1,1,1,0,0,0,0,0,0,0.4988662131519274,0.5011337868480725
90877,0.607843137254902,0.4347826086956522,-155,130,0.5819333701084867,0.41806662989151333,home,MIA,under,8.5,0.5238095238095238,-110,0.5011337868480725,MIA,NYM,2023 REG,8,4,11,3,7,19,1,0,1,-1,1,1,1,0,0,0,0,0,0,0.4988662131519274,0.5011337868480725
90878,0.2631578947368421,0.7752808988764045,280,-345,0.25304242273335614,0.7469575772666439,away,HOU,over,8.5,0.5327102803738317,-114,0.5075272610403079,OAK,HOU,2023 REG,6,3,8,6,9,14,0,1,-3,3,1,1,1,0,0,0,0,0,0,0.5075272610403079,0.4924727389596921
90878,0.2631578947368421,0.7752808988764045,280,-345,0.25304242273335614,0.7469575772666439,home,OAK,under,8.5,0.5145631067961165,-106,0.4924727389596921,OAK,HOU,2023 REG,6,3,8,6,9,14,0,1,-3,3,1,1,1,0,0,0,0,0,0,0.5075272610403079,0.4924727389596921
90879,0.5884773662551441,0.45248868778280543,-143,121,0.5643697706690257,0.4356302293309743,away,PIT,over,9.5,0.49751243781094534,101,0.47511256217505476,STL,PIT,2023 REG,8,6,8,4,10,16,1,0,2,-2,1,1,1,1,0,0,0,0,0,0.47511256217505476,0.5248874378249453
90879,0.5884773662551441,0.45248868778280543,-143,121,0.5643697706690257,0.4356302293309743,home,STL,under,9.5,0.5475113122171946,-121,0.5248874378249453,STL,PIT,2023 REG,8,6,8,4,10,16,1,0,2,-2,1,1,1,1,0,0,0,0,0,0.47511256217505476,0.5248874378249453
90880,0.5348837209302326,0.5073891625615764,-115,-103,0.5122726437136835,0.48772735628631647,away,ARI,over,12,0.5121951219512195,-105,0.48919479393107135,COL,ARI,2023 REG,8,4,16,11,15,24,0,1,-7,7,1,1,1,1,0,0,0,0,0,0.48919479393107135,0.5108052060689287
90880,0.5348837209302326,0.5073891625615764,-115,-103,0.5122726437136835,0.48772735628631647,home,COL,under,12,0.5327102803738317,-114,0.5108052060689287,COL,ARI,2023 REG,8,4,16,11,15,24,0,1,-7,7,1,1,1,1,0,0,0,0,0,0.48919479393107135,0.5108052060689287
90881,0.6721311475409836,0.37037037037037035,-205,170,0.6435645535349916,0.35643544646500835,away,KC,over,9,0.5121951219512195,-105,0.48808156828023186,CLE,KC,2023 REG,8,5,5,1,6,13,1,0,4,-4,1,0,0,0,0,0,0,0,0,0.48808156828023186,0.5119184317197681
90881,0.6721311475409836,0.37037037037037035,-205,170,0.6435645535349916,0.35643544646500835,home,CLE,under,9,0.5348837209302326,-115,0.5119184317197681,CLE,KC,2023 REG,8,5,5,1,6,13,1,0,4,-4,1,0,0,0,0,0,0,0,0,0.48808156828023186,0.5119184317197681
90882,0.5454545454545454,0.49751243781094534,-120,101,0.5220180091279142,0.4779819908720858,away,CWS,over,10,0.5348837209302326,-115,0.5097020142727117,KC,CWS,2023 REG,4,4,14,6,10,18,0,1,-2,2,1,1,1,1,0,0,0,0,0,0.5097020142727117,0.49029798572728833
90882,0.5454545454545454,0.49751243781094534,-120,101,0.5220180091279142,0.4779819908720858,home,KC,under,10,0.5121951219512195,-105,0.49029798572728833,KC,CWS,2023 REG,4,4,14,6,10,18,0,1,-2,2,1,1,1,1,0,0,0,0,0,0.5097020142727117,0.49029798572728833
90883,0.49751243781094534,0.5475113122171946,101,-121,0.47511256217505476,0.5248874378249453,away,NYM,over,9.5,0.5192307692307692,-108,0.49688292476754015,PIT,NYM,2023 REG,3,1,8,5,6,11,0,1,-4,4,1,0,0,0,0,0,0,0,0,0.49688292476754015,0.5031170752324599
90883,0.49751243781094534,0.5475113122171946,101,-121,0.47511256217505476,0.5248874378249453,home,PIT,under,9.5,0.5238095238095238,-110,0.5031170752324599,PIT,NYM,2023 REG,3,1,8,5,6,11,0,1,-4,4,1,0,0,0,0,0,0,0,0,0.49688292476754015,0.5031170752324599
90884,0.726027397260274,0.3125,-265,220,0.6980554513041847,0.30194454869581533,away,WSH,over,8.5,0.5238095238095238,-110,0.4988662131519274,HOU,WSH,2023 REG,9,6,6,1,7,15,1,0,5,-5,1,0,0,0,0,0,0,0,0,0.4988662131519274,0.5011337868480725
90884,0.726027397260274,0.3125,-265,220,0.6980554513041847,0.30194454869581533,home,HOU,under,8.5,0.5238095238095238,-110,0.5011337868480725,HOU,WSH,2023 REG,9,6,6,1,7,15,1,0,5,-5,1,0,0,0,0,0,0,0,0,0.4988662131519274,0.5011337868480725
90885,0.4166666666666667,0.6226415094339623,140,-165,0.4002882599580712,0.5997117400419287,away,MIN,over,9,0.5,100,0.4772727272727273,CWS,MIN,2023 REG,5,3,3,2,5,8,1,0,1,-1,1,1,0,0,0,0,0,0,0,0.4772727272727273,0.5227272727272727
90885,0.4166666666666667,0.6226415094339623,140,-165,0.4002882599580712,0.5997117400419287,home,CWS,under,9,0.5454545454545454,-120,0.5227272727272727,CWS,MIN,2023 REG,5,3,3,2,5,8,1,0,1,-1,1,1,0,0,0,0,0,0,0,0.4772727272727273,0.5227272727272727
90886,0.4132231404958678,0.6240601503759399,142,-166,0.39781682195379847,0.6021831780462015,away,MIA,over,10.5,0.5412844036697247,-118,0.5189377998484975,COL,MIA,2023 REG,4,2,14,10,12,18,0,1,-8,8,1,1,0,0,0,0,0,0,0,0.5189377998484975,0.4810622001515025
90886,0.4132231404958678,0.6240601503759399,142,-166,0.39781682195379847,0.6021831780462015,home,COL,under,10.5,0.5,100,0.4810622001515025,COL,MIA,2023 REG,4,2,14,10,12,18,0,1,-8,8,1,1,0,0,0,0,0,0,0,0.5189377998484975,0.4810622001515025
90887,0.6563573883161512,0.3846153846153846,-191,160,0.6294646060827378,0.3705353939172622,away,NYY,over,9,0.5348837209302326,-115,0.5097020142727117,ATL,NYY,2023 REG,15,11,11,3,14,26,1,0,8,-8,1,1,1,0,0,0,0,0,0,0.5097020142727117,0.49029798572728833
90887,0.6563573883161512,0.3846153846153846,-191,160,0.6294646060827378,0.3705353939172622,home,ATL,under,9,0.5121951219512195,-105,0.49029798572728833,ATL,NYY,2023 REG,15,11,11,3,14,26,1,0,8,-8,1,1,1,0,0,0,0,0,0,0.5097020142727117,0.49029798572728833
90888,0.6153846153846154,0.425531914893617,-160,135,0.5902052121364724,0.40979478786352763,away,BAL,over,8,0.5098039215686274,-104,0.48592421718142587,SEA,BAL,2023 REG,4,0,4,1,1,8,0,1,-1,1,0,0,0,0,0,0,0,0,0,0.48592421718142587,0.5140757828185741
90888,0.6153846153846154,0.425531914893617,-160,135,0.5902052121364724,0.40979478786352763,home,SEA,under,8,0.5370370370370371,-116,0.5140757828185741,SEA,BAL,2023 REG,4,0,4,1,1,8,0,1,-1,1,0,0,0,0,0,0,0,0,0,0.48592421718142587,0.5140757828185741
90889,0.5348837209302326,0.5121951219512195,-115,-105,0.5097020142727117,0.49029798572728833,away,TOR,over,8,0.5121951219512195,-105,0.48919479393107135,NYY,TOR,2023 REG,6,1,10,7,8,16,0,1,-6,6,1,0,0,0,0,0,0,0,0,0.48919479393107135,0.5108052060689287
90889,0.5348837209302326,0.5121951219512195,-115,-105,0.5097020142727117,0.49029798572728833,home,NYY,under,8,0.5327102803738317,-114,0.5108052060689287,NYY,TOR,2023 REG,6,1,10,7,8,16,0,1,-6,6,1,0,0,0,0,0,0,0,0,0.48919479393107135,0.5108052060689287
90890,0.6551724137931035,0.38314176245210724,-190,161,0.6300700224600344,0.3699299775399656,away,COL,over,8.5,0.5454545454545454,-120,0.5206611570247933,HOU,COL,2023 REG,13,4,3,1,5,16,1,0,3,-3,1,0,0,0,0,0,0,0,0,0.5206611570247933,0.4793388429752067
90890,0.6551724137931035,0.38314176245210724,-190,161,0.6300700224600344,0.3699299775399656,home,HOU,under,8.5,0.5,100,0.4793388429752067,HOU,COL,2023 REG,13,4,3,1,5,16,1,0,3,-3,1,0,0,0,0,0,0,0,0,0.5206611570247933,0.4793388429752067
90891,0.4166666666666667,0.6226415094339623,140,-165,0.4002882599580712,0.5997117400419287,away,MIN,over,8.5,0.5283018867924528,-112,0.5044173060022736,DET,MIN,2023 REG,8,3,2,0,3,10,1,0,3,-3,0,0,0,0,0,0,0,0,0,0.5044173060022736,0.49558269399772636
90891,0.4166666666666667,0.6226415094339623,140,-165,0.4002882599580712,0.5997117400419287,home,DET,under,8.5,0.5169082125603864,-107,0.49558269399772636,DET,MIN,2023 REG,8,3,2,0,3,10,1,0,3,-3,0,0,0,0,0,0,0,0,0,0.5044173060022736,0.49558269399772636
90892,0.7058823529411764,0.33444816053511706,-240,199,0.6774137551932046,0.32258624480679543,away,KC,over,10.5,0.5238095238095238,-110,0.5000596729920038,BOS,KC,2023 REG,8,2,7,0,2,15,1,0,2,-2,0,0,0,0,0,0,0,0,0,0.5000596729920038,0.4999403270079962
90892,0.7058823529411764,0.33444816053511706,-240,199,0.6774137551932046,0.32258624480679543,home,BOS,under,10.5,0.5215311004784688,-109,0.4999403270079962,BOS,KC,2023 REG,8,2,7,0,2,15,1,0,2,-2,0,0,0,0,0,0,0,0,0,0.5000596729920038,0.4999403270079962
90893,0.6108949416342413,0.425531914893617,-157,135,0.5886419592417365,0.41135804075826354,away,TB,over,9,0.5098039215686274,-104,0.48483656587239576,NYM,TB,2023 REG,6,5,10,8,13,16,0,1,-3,3,1,1,1,1,1,0,0,0,0,0.48483656587239576,0.5151634341276042
90893,0.6108949416342413,0.425531914893617,-157,135,0.5886419592417365,0.41135804075826354,home,NYM,under,9,0.5391705069124424,-117,0.5151634341276042,NYM,TB,2023 REG,6,5,10,8,13,16,0,1,-3,3,1,1,1,1,1,0,0,0,0,0.48483656587239576,0.5151634341276042
90894,0.6587030716723549,0.37735849056603776,-193,165,0.6349492098566218,0.36505079014337816,away,LAA,over,8.5,0.5305164319248826,-113,0.5066009958897986,TEX,LAA,2023 REG,13,12,1,0,12,14,1,0,12,-12,0,0,0,0,0,0,0,0,0,0.5066009958897986,0.49339900411020143
90894,0.6587030716723549,0.37735849056603776,-193,165,0.6349492098566218,0.36505079014337816,home,TEX,under,8.5,0.5145631067961165,-106,0.49339900411020143,TEX,LAA,2023 REG,13,12,1,0,12,14,1,0,12,-12,0,0,0,0,0,0,0,0,0,0.5066009958897986,0.49339900411020143
90895,0.5454545454545454,0.5,-120,100,0.5206611570247933,0.4793388429752067,away,OAK,over,8.5,0.5348837209302326,-115,0.5097020142727117,LAA,OAK,2023 REG,3,3,8,7,10,11,0,1,-4,4,1,1,1,0,0,0,0,0,0,0.5097020142727117,0.49029798572728833
90895,0.5454545454545454,0.5,-120,100,0.5206611570247933,0.4793388429752067,home,LAA,under,8.5,0.5121951219512195,-105,0.49029798572728833,LAA,OAK,2023 REG,3,3,8,7,10,11,0,1,-4,4,1,1,1,0,0,0,0,0,0,0.5097020142727117,0.49029798572728833
90896,0.425531914893617,0.607843137254902,135,-155,0.4113297650431834,0.5886702349568166,away,HOU,over,9.5,0.5145631067961165,-106,0.4913668392989033,PIT,HOU,2023 REG,3,0,12,7,7,15,0,1,-7,7,0,0,0,0,0,0,0,0,0,0.4913668392989033,0.5086331607010968
90896,0.425531914893617,0.607843137254902,135,-155,0.4113297650431834,0.5886702349568166,home,PIT,under,9.5,0.5305164319248826,-113,0.5086331607010968,PIT,HOU,2023 REG,3,0,12,7,7,15,0,1,-7,7,0,0,0,0,0,0,0,0,0,0.4913668392989033,0.5086331607010968
90897,0.5726495726495727,0.4716981132075471,-134,112,0.5472538892954956,0.45274611070450443,away,OAK,over,9.5,0.5305164319248826,-113,0.5041247242695369,CWS,OAK,2023 REG,9,6,4,2,8,13,1,0,4,-4,1,1,0,0,0,0,0,0,0,0.5041247242695369,0.4958752757304631
90897,0.5726495726495727,0.4716981132075471,-134,112,0.5472538892954956,0.45274611070450443,home,CWS,under,9.5,0.5192307692307692,-108,0.4958752757304631,CWS,OAK,2023 REG,9,6,4,2,8,13,1,0,4,-4,1,1,0,0,0,0,0,0,0,0.5041247242695369,0.4958752757304631
90898,0.35460992907801414,0.6825396825396826,182,-215,0.3414363079369869,0.6585636920630131,away,TB,over,9,0.5348837209302326,-115,0.5097020142727117,OAK,TB,2023 REG,6,2,5,1,3,11,1,0,1,-1,1,0,0,0,0,0,0,0,0,0.5097020142727117,0.49029798572728833
90898,0.35460992907801414,0.6825396825396826,182,-215,0.3414363079369869,0.6585636920630131,home,OAK,under,9,0.5121951219512195,-105,0.49029798572728833,OAK,TB,2023 REG,6,2,5,1,3,11,1,0,1,-1,1,0,0,0,0,0,0,0,0,0.5097020142727117,0.49029798572728833
90899,0.4444444444444444,0.5918367346938775,125,-145,0.42831947593852354,0.5716805240614764,away,ATL,over,10.5,0.5238095238095238,-110,0.4988662131519274,BOS,ATL,2023 REG,12,7,9,1,8,21,1,0,6,-6,1,0,0,0,0,0,0,0,0,0.4988662131519274,0.5011337868480725
90899,0.4444444444444444,0.5918367346938775,125,-145,0.42831947593852354,0.5716805240614764,home,BOS,under,10.5,0.5238095238095238,-110,0.5011337868480725,BOS,ATL,2023 REG,12,7,9,1,8,21,1,0,6,-6,1,0,0,0,0,0,0,0,0,0.4988662131519274,0.5011337868480725
90900,0.5412844036697247,0.5,-118,100,0.5189377998484975,0.4810622001515025,away,MIN,over,8.5,0.5260663507109005,-111,0.5010269332605688,PHI,MIN,2023 REG,5,0,10,3,3,15,0,1,-3,3,0,0,0,0,0,0,0,0,0,0.5010269332605688,0.4989730667394312
90900,0.5412844036697247,0.5,-118,100,0.5189377998484975,0.4810622001515025,home,PHI,under,8.5,0.5215311004784688,-109,0.4989730667394312,PHI,MIN,2023 REG,5,0,10,3,3,15,0,1,-3,3,0,0,0,0,0,0,0,0,0,0.5010269332605688,0.4989730667394312
90901,0.5348837209302326,0.5073891625615764,-115,-103,0.5122726437136835,0.48772735628631647,away,SD,over,8,0.5348837209302326,-115,0.5097020142727117,MIL,SD,2023 REG,10,7,7,3,10,17,1,0,4,-4,1,1,1,0,0,0,0,0,0,0.5097020142727117,0.49029798572728833
90901,0.5348837209302326,0.5073891625615764,-115,-103,0.5122726437136835,0.48772735628631647,home,MIL,under,8,0.5121951219512195,-105,0.49029798572728833,MIL,SD,2023 REG,10,7,7,3,10,17,1,0,4,-4,1,1,1,0,0,0,0,0,0,0.5097020142727117,0.49029798572728833
90902,0.5454545454545454,0.5,-120,100,0.5206611570247933,0.4793388429752067,away,TEX,over,8,0.504950495049505,-102,0.4826715732667395,CLE,TEX,2023 REG,11,2,6,1,3,17,1,0,1,-1,1,0,0,0,0,0,0,0,0,0.4826715732667395,0.5173284267332605
90902,0.5454545454545454,0.5,-120,100,0.5206611570247933,0.4793388429752067,home,CLE,under,8,0.5391705069124424,-117,0.5173284267332605,CLE,TEX,2023 REG,11,2,6,1,3,17,1,0,1,-1,1,0,0,0,0,0,0,0,0,0.4826715732667395,0.5173284267332605
90903,0.6551724137931035,0.3846153846153846,-190,160,0.6291045458703008,0.37089545412969915,away,DET,over,8.5,0.5454545454545454,-120,0.5206611570247933,MIN,DET,2023 REG,7,5,7,3,8,14,1,0,2,-2,1,1,1,0,0,0,0,0,0,0.5206611570247933,0.4793388429752067
90903,0.6551724137931035,0.3846153846153846,-190,160,0.6291045458703008,0.37089545412969915,home,MIN,under,8.5,0.5,100,0.4793388429752067,MIN,DET,2023 REG,7,5,7,3,8,14,1,0,2,-2,1,1,1,0,0,0,0,0,0,0.5206611570247933,0.4793388429752067
90904,0.7118155619596541,0.33112582781456956,-247,202,0.6812492124661865,0.3187507875338135,away,LAA,over,8,0.5348837209302326,-115,0.5097020142727117,TB,LAA,2023 REG,8,3,10,8,11,18,0,1,-5,5,1,1,1,0,0,0,0,0,0,0.5097020142727117,0.49029798572728833
90904,0.7118155619596541,0.33112582781456956,-247,202,0.6812492124661865,0.3187507875338135,home,TB,under,8,0.5121951219512195,-105,0.49029798572728833,TB,LAA,2023 REG,8,3,10,8,11,18,0,1,-5,5,1,1,1,0,0,0,0,0,0,0.5097020142727117,0.49029798572728833
90905,0.7354497354497355,0.3048780487804878,-278,228,0.7057906772063438,0.2942093227936562,away,SEA,over,9.5,0.49504950495049505,102,0.47297076509898783,TOR,SEA,2023 REG,3,1,6,0,1,9,1,0,1,-1,0,0,0,0,0,0,0,0,0,0.47297076509898783,0.5270292349010122
90905,0.7354497354497355,0.3048780487804878,-278,228,0.7057906772063438,0.2942093227936562,home,TOR,under,9.5,0.5495495495495495,-122,0.5270292349010122,TOR,SEA,2023 REG,3,1,6,0,1,9,1,0,1,-1,0,0,0,0,0,0,0,0,0,0.47297076509898783,0.5270292349010122
90906,0.5454545454545454,0.5,-120,100,0.5206611570247933,0.4793388429752067,away,TB,over,7.5,0.504950495049505,-102,0.4826715732667395,NYY,TB,2023 REG,13,7,6,2,9,19,1,0,5,-5,1,1,0,0,0,0,0,0,0,0.4826715732667395,0.5173284267332605
90906,0.5454545454545454,0.5,-120,100,0.5206611570247933,0.4793388429752067,home,NYY,under,7.5,0.5391705069124424,-117,0.5173284267332605,NYY,TB,2023 REG,13,7,6,2,9,19,1,0,5,-5,1,1,0,0,0,0,0,0,0,0.4826715732667395,0.5173284267332605
90907,0.5348837209302326,0.5121951219512195,-115,-105,0.5097020142727117,0.49029798572728833,away,WSH,over,9.5,0.5,100,0.4772727272727273,KC,WSH,2023 REG,13,10,15,12,22,28,0,1,-2,2,1,1,1,1,1,1,1,1,1,0.4772727272727273,0.5227272727272727
90907,0.5348837209302326,0.5121951219512195,-115,-105,0.5097020142727117,0.49029798572728833,home,KC,under,9.5,0.5454545454545454,-120,0.5227272727272727,KC,WSH,2023 REG,13,10,15,12,22,28,0,1,-2,2,1,1,1,1,1,1,1,1,1,0.4772727272727273,0.5227272727272727
90908,0.3802281368821293,0.6551724137931035,163,-190,0.36676785145428414,0.6332321485457159,away,SD,over,11.5,0.5145631067961165,-106,0.4913668392989033,COL,SD,2023 REG,8,5,7,4,9,15,1,0,1,-1,1,1,1,1,0,0,0,0,0,0.4913668392989033,0.5086331607010968
90908,0.3802281368821293,0.6551724137931035,163,-190,0.36676785145428414,0.6332321485457159,home,COL,under,11.5,0.5305164319248826,-113,0.5086331607010968,COL,SD,2023 REG,8,5,7,4,9,15,1,0,1,-1,1,1,1,1,0,0,0,0,0,0.4913668392989033,0.5086331607010968
90909,0.45454545454545453,0.5798319327731092,120,-138,0.4389193694006528,0.5610806305993472,away,SF,over,8.5,0.5348837209302326,-115,0.5097020142727117,ARI,SF,2023 REG,4,2,3,1,3,7,1,0,1,-1,1,0,0,0,0,0,0,0,0,0.5097020142727117,0.49029798572728833
90909,0.45454545454545453,0.5798319327731092,120,-138,0.4389193694006528,0.5610806305993472,home,ARI,under,8.5,0.5121951219512195,-105,0.49029798572728833,ARI,SF,2023 REG,4,2,3,1,3,7,1,0,1,-1,1,0,0,0,0,0,0,0,0,0.5097020142727117,0.49029798572728833
90910,0.574468085106383,0.4608294930875576,-135,117,0.5541907529524172,0.44580924704758285,away,PHI,over,7.5,0.5,100,0.4772727272727273,HOU,PHI,2023 REG,6,1,12,6,7,18,0,1,-5,5,1,0,0,0,0,0,0,0,0,0.4772727272727273,0.5227272727272727
90910,0.574468085106383,0.4608294930875576,-135,117,0.5541907529524172,0.44580924704758285,home,HOU,under,7.5,0.5454545454545454,-120,0.5227272727272727,HOU,PHI,2023 REG,6,1,12,6,7,18,0,1,-5,5,1,0,0,0,0,0,0,0,0,0.4772727272727273,0.5227272727272727
90911,0.5391705069124424,0.5,-117,100,0.5180509248444435,0.4819490751555565,away,SEA,over,9,0.5348837209302326,-115,0.5097020142727117,BAL,SEA,2023 REG,11,6,8,4,10,19,1,0,2,-2,1,1,1,1,0,0,0,0,0,0.5097020142727117,0.49029798572728833
90911,0.5391705069124424,0.5,-117,100,0.5180509248444435,0.4819490751555565,home,BAL,under,9,0.5121951219512195,-105,0.49029798572728833,BAL,SEA,2023 REG,11,6,8,4,10,19,1,0,2,-2,1,1,1,1,0,0,0,0,0,0.5097020142727117,0.49029798572728833
90912,0.613899613899614,0.425531914893617,-159,135,0.589692613597978,0.410307386402022,away,LAA,over,9.5,0.5169082125603864,-107,0.49353874091423283,NYY,LAA,2023 REG,4,2,8,5,7,12,0,1,-3,3,1,1,0,0,0,0,0,0,0,0.49353874091423283,0.5064612590857671
90912,0.613899613899614,0.425531914893617,-159,135,0.589692613597978,0.410307386402022,home,NYY,under,9.5,0.5283018867924528,-112,0.5064612590857671,NYY,LAA,2023 REG,4,2,8,5,7,12,0,1,-3,3,1,1,0,0,0,0,0,0,0,0.49353874091423283,0.5064612590857671
90913,0.7275204359673024,0.3076923076923077,-267,225,0.701902445348458,0.298097554651542,away,ARI,over,7.5,0.5412844036697247,-118,0.5149381613977361,LAD,ARI,2023 REG,8,10,5,1,11,13,1,0,9,-9,1,0,0,0,0,0,0,0,0,0.5149381613977361,0.48506183860226393
90913,0.7275204359673024,0.3076923076923077,-267,225,0.701902445348458,0.298097554651542,home,LAD,under,7.5,0.5073891625615764,-103,0.48506183860226393,LAD,ARI,2023 REG,8,10,5,1,11,13,1,0,9,-9,1,0,0,0,0,0,0,0,0,0.5149381613977361,0.48506183860226393
90914,0.6363636363636364,0.40322580645161293,-175,148,0.6111703545721141,0.3888296454278859,away,NYM,over,9.5,0.5238095238095238,-110,0.4988662131519274,BAL,NYM,2023 REG,12,7,7,3,10,19,1,0,4,-4,1,1,1,0,0,0,0,0,0,0.4988662131519274,0.5011337868480725
90914,0.6363636363636364,0.40322580645161293,-175,148,0.6111703545721141,0.3888296454278859,home,BAL,under,9.5,0.5238095238095238,-110,0.5011337868480725,BAL,NYM,2023 REG,12,7,7,3,10,19,1,0,4,-4,1,1,1,0,0,0,0,0,0,0.4988662131519274,0.5011337868480725
90915,0.425531914893617,0.607843137254902,135,-155,0.4113297650431834,0.5886702349568166,away,LAD,over,9.5,0.5121951219512195,-105,0.48808156828023186,ARI,LAD,2023 REG,17,12,11,8,20,28,1,0,4,-4,1,1,1,1,1,1,1,1,0,0.48808156828023186,0.5119184317197681
90915,0.425531914893617,0.607843137254902,135,-155,0.4113297650431834,0.5886702349568166,home,ARI,under,9.5,0.5348837209302326,-115,0.5119184317197681,ARI,LAD,2023 REG,17,12,11,8,20,28,1,0,4,-4,1,1,1,1,1,1,1,1,0,0.48808156828023186,0.5119184317197681
90916,0.574468085106383,0.46511627906976744,-135,115,0.5517281312179562,0.44827186878204384,away,HOU,over,8,0.5391705069124424,-117,0.5140669063204599,SEA,HOU,2023 REG,11,3,6,1,4,17,1,0,2,-2,1,0,0,0,0,0,0,0,0,0.5140669063204599,0.4859330936795401
90916,0.574468085106383,0.46511627906976744,-135,115,0.5517281312179562,0.44827186878204384,home,SEA,under,8,0.5073891625615764,-103,0.4859330936795401,SEA,HOU,2023 REG,11,3,6,1,4,17,1,0,2,-2,1,0,0,0,0,0,0,0,0,0.5140669063204599,0.4859330936795401
90917,0.3278688524590164,0.7142857142857143,205,-250,0.3140476830345145,0.6859523169654855,away,HOU,over,9.5,0.5192307692307692,-108,0.49455035168025013,KC,HOU,2023 REG,7,1,8,7,8,15,0,1,-6,6,1,0,0,0,0,0,0,0,0,0.49455035168025013,0.5054496483197499
90917,0.3278688524590164,0.7142857142857143,205,-250,0.3140476830345145,0.6859523169654855,home,KC,under,9.5,0.5283018867924528,-112,0.5054496483197499,KC,HOU,2023 REG,7,1,8,7,8,15,0,1,-6,6,1,0,0,0,0,0,0,0,0,0.49455035168025013,0.5054496483197499
90918,0.5454545454545454,0.5,-120,100,0.5206611570247933,0.4793388429752067,away,TB,over,9,0.5454545454545454,-120,0.5206611570247933,BAL,TB,2023 REG,9,5,5,4,9,14,1,0,1,-1,1,1,1,1,0,0,0,0,0,0.5206611570247933,0.4793388429752067
90918,0.5454545454545454,0.5,-120,100,0.5206611570247933,0.4793388429752067,home,BAL,under,9,0.5,100,0.4793388429752067,BAL,TB,2023 REG,9,5,5,4,9,14,1,0,1,-1,1,1,1,1,0,0,0,0,0,0.5206611570247933,0.4793388429752067
90919,0.607843137254902,0.4347826086956522,-155,130,0.5819333701084867,0.41806662989151333,away,PIT,over,10.5,0.5433789954337899,-119,0.5157926447422438,CIN,PIT,2023 REG,6,4,7,2,6,13,1,0,2,-2,1,1,0,0,0,0,0,0,0,0.5157926447422438,0.48420735525775616
90919,0.607843137254902,0.4347826086956522,-155,130,0.5819333701084867,0.41806662989151333,home,CIN,under,10.5,0.5073891625615764,-103,0.48420735525775616,CIN,PIT,2023 REG,6,4,7,2,6,13,1,0,2,-2,1,1,0,0,0,0,0,0,0,0.5157926447422438,0.48420735525775616
90920,0.46511627906976744,0.5726495726495727,115,-134,0.4475507666421673,0.5524492333578327,away,HOU,over,7.5,0.5433789954337899,-119,0.5184560714286826,CWS,HOU,2023 REG,7,3,9,4,7,16,0,1,-1,1,1,1,1,0,0,0,0,0,0,0.5184560714286826,0.48154392857131745
90920,0.46511627906976744,0.5726495726495727,115,-134,0.4475507666421673,0.5524492333578327,home,CWS,under,7.5,0.5024875621890548,-101,0.48154392857131745,CWS,HOU,2023 REG,7,3,9,4,7,16,0,1,-1,1,1,1,1,0,0,0,0,0,0,0.5184560714286826,0.48154392857131745
90921,0.6941896024464832,0.34602076124567477,-227,189,0.6662759860607955,0.3337240139392045,away,OAK,over,9,0.5121951219512195,-105,0.48808156828023186,STL,OAK,2023 REG,8,7,8,5,12,16,1,0,2,-2,1,1,1,1,1,0,0,0,0,0.48808156828023186,0.5119184317197681
90921,0.6941896024464832,0.34602076124567477,-227,189,0.6662759860607955,0.3337240139392045,home,STL,under,9,0.5348837209302326,-115,0.5119184317197681,STL,OAK,2023 REG,8,7,8,5,12,16,1,0,2,-2,1,1,1,1,1,0,0,0,0,0.48808156828023186,0.5119184317197681
90922,0.7118155619596541,0.3367003367003367,-247,197,0.6772811902910151,0.3227188097089849,away,KC,over,9,0.5169082125603864,-107,0.49353874091423283,TOR,KC,2023 REG,9,5,9,4,9,18,1,0,1,-1,1,1,1,1,0,0,0,0,0,0.49353874091423283,0.5064612590857671
90922,0.7118155619596541,0.3367003367003367,-247,197,0.6772811902910151,0.3227188097089849,home,TOR,under,9,0.5283018867924528,-112,0.5064612590857671,TOR,KC,2023 REG,9,5,9,4,9,18,1,0,1,-1,1,1,1,1,0,0,0,0,0,0.49353874091423283,0.5064612590857671
90923,0.4926108374384236,0.5495495495495495,103,-122,0.4718421738975501,0.5281578261024499,away,ATL,over,8,0.5121951219512195,-105,0.48808156828023186,MIA,ATL,2023 REG,17,16,9,2,18,26,1,0,14,-14,1,1,0,0,0,0,0,0,0,0.48808156828023186,0.5119184317197681
90923,0.4926108374384236,0.5495495495495495,103,-122,0.4718421738975501,0.5281578261024499,home,MIA,under,8,0.5348837209302326,-115,0.5119184317197681,MIA,ATL,2023 REG,17,16,9,2,18,26,1,0,14,-14,1,1,0,0,0,0,0,0,0,0.48808156828023186,0.5119184317197681
90924,0.5867768595041323,0.45454545454545453,-142,120,0.5625298818386723,0.43747011816132775,away,OAK,over,10,0.5121951219512195,-105,0.48808156828023186,KC,OAK,2023 REG,10,8,17,12,20,27,0,1,-4,4,1,1,1,1,1,1,1,1,0,0.48808156828023186,0.5119184317197681
90924,0.5867768595041323,0.45454545454545453,-142,120,0.5625298818386723,0.43747011816132775,home,KC,under,10,0.5348837209302326,-115,0.5119184317197681,KC,OAK,2023 REG,10,8,17,12,20,27,0,1,-4,4,1,1,1,1,1,1,1,1,0,0.48808156828023186,0.5119184317197681
90925,0.46511627906976744,0.574468085106383,115,-135,0.44670494689481377,0.5532950531051862,away,TEX,over,9,0.5121951219512195,-105,0.48808156828023186,PIT,TEX,2023 REG,11,6,7,4,10,18,1,0,2,-2,1,1,1,1,0,0,0,0,0,0.48808156828023186,0.5119184317197681
90925,0.46511627906976744,0.574468085106383,115,-135,0.44670494689481377,0.5532950531051862,home,PIT,under,9,0.5348837209302326,-115,0.5119184317197681,PIT,TEX,2023 REG,11,6,7,4,10,18,1,0,2,-2,1,1,1,1,0,0,0,0,0,0.48808156828023186,0.5119184317197681
90926,0.48309178743961345,0.5555555555555556,107,-125,0.4644215734322854,0.5355784265677146,away,TOR,over,8,0.5121951219512195,-105,0.48808156828023186,CLE,TOR,2023 REG,3,1,9,0,1,12,1,0,1,-1,0,0,0,0,0,0,0,0,0,0.48808156828023186,0.5119184317197681
90926,0.48309178743961345,0.5555555555555556,107,-125,0.4644215734322854,0.5355784265677146,home,CLE,under,8,0.5348837209302326,-115,0.5119184317197681,CLE,TOR,2023 REG,3,1,9,0,1,12,1,0,1,-1,0,0,0,0,0,0,0,0,0,0.48808156828023186,0.5119184317197681
90927,0.47619047619047616,0.5652173913043479,110,-130,0.4564724440500838,0.5435275559499162,away,MIL,over,8,0.5121951219512195,-105,0.48808156828023186,SF,MIL,2023 REG,5,6,7,4,10,12,1,0,2,-2,1,1,1,1,0,0,0,0,0,0.48808156828023186,0.5119184317197681
90927,0.47619047619047616,0.5652173913043479,110,-130,0.4564724440500838,0.5435275559499162,home,SF,under,8,0.5348837209302326,-115,0.5119184317197681,SF,MIL,2023 REG,5,6,7,4,10,12,1,0,2,-2,1,1,1,1,0,0,0,0,0,0.48808156828023186,0.5119184317197681
90928,0.6415770609318996,0.4,-179,150,0.6149021723770248,0.3850978276229752,away,CWS,over,9.5,0.5348837209302326,-115,0.5097020142727117,ATL,CWS,2023 REG,5,1,14,8,9,19,0,1,-7,7,1,0,0,0,0,0,0,0,0,0.5097020142727117,0.49029798572728833
90928,0.6415770609318996,0.4,-179,150,0.6149021723770248,0.3850978276229752,home,ATL,under,9.5,0.5121951219512195,-105,0.49029798572728833,ATL,CWS,2023 REG,5,1,14,8,9,19,0,1,-7,7,1,0,0,0,0,0,0,0,0,0.5097020142727117,0.49029798572728833
90929,0.3968253968253968,0.6389891696750902,152,-177,0.3826132672617115,0.6173867327382885,away,ATL,over,10.5,0.5238095238095238,-110,0.5000596729920038,CLE,ATL,2023 REG,7,1,19,8,9,26,0,1,-7,7,1,0,0,0,0,0,0,0,0,0.5000596729920038,0.4999403270079962
90929,0.3968253968253968,0.6389891696750902,152,-177,0.3826132672617115,0.6173867327382885,home,CLE,under,10.5,0.5215311004784688,-109,0.4999403270079962,CLE,ATL,2023 REG,7,1,19,8,9,26,0,1,-7,7,1,0,0,0,0,0,0,0,0,0.5000596729920038,0.4999403270079962
90930,0.425531914893617,0.613899613899614,135,-159,0.40875254093905067,0.5912474590609493,away,HOU,over,12.5,0.5391705069124424,-117,0.5127649394825569,COL,HOU,2023 REG,2,1,8,4,5,10,0,1,-3,3,1,0,0,0,0,0,0,0,0,0.5127649394825569,0.48723506051744314
90930,0.425531914893617,0.613899613899614,135,-159,0.40875254093905067,0.5912474590609493,home,COL,under,12.5,0.5098039215686274,-104,0.48723506051744314,COL,HOU,2023 REG,2,1,8,4,5,10,0,1,-3,3,1,0,0,0,0,0,0,0,0,0.5127649394825569,0.48723506051744314
90931,0.4,0.6402877697841727,150,-178,0.383884892086331,0.6161151079136691,away,SF,over,8.5,0.5348837209302326,-115,0.5097020142727117,OAK,SF,2023 REG,6,2,3,1,3,9,1,0,1,-1,1,0,0,0,0,0,0,0,0,0.5097020142727117,0.49029798572728833
90931,0.4,0.6402877697841727,150,-178,0.383884892086331,0.6161151079136691,home,OAK,under,8.5,0.5121951219512195,-105,0.49029798572728833,OAK,SF,2023 REG,6,2,3,1,3,9,1,0,1,-1,1,0,0,0,0,0,0,0,0,0.5097020142727117,0.49029798572728833
90932,0.5689655172413793,0.46511627906976744,-132,115,0.5495741503746924,0.45042584962530763,away,TOR,over,10,0.5238095238095238,-110,0.4988662131519274,LAA,TOR,2023 REG,13,11,13,12,23,26,0,1,-1,1,1,1,1,1,1,1,1,1,1,0.4988662131519274,0.5011337868480725
90932,0.5689655172413793,0.46511627906976744,-132,115,0.5495741503746924,0.45042584962530763,home,LAA,under,10,0.5238095238095238,-110,0.5011337868480725,LAA,TOR,2023 REG,13,11,13,12,23,26,0,1,-1,1,1,1,1,1,1,1,1,1,1,0.4988662131519274,0.5011337868480725
90933,0.5215311004784688,0.5238095238095238,-109,-110,0.4978845547971712,0.5021154452028288,away,TB,over,8.5,0.5098039215686274,-104,0.48483656587239576,SF,TB,2023 REG,9,7,3,0,7,12,1,0,7,-7,0,0,0,0,0,0,0,0,0,0.48483656587239576,0.5151634341276042
90933,0.5215311004784688,0.5238095238095238,-109,-110,0.4978845547971712,0.5021154452028288,home,SF,under,8.5,0.5391705069124424,-117,0.5151634341276042,SF,TB,2023 REG,9,7,3,0,7,12,1,0,7,-7,0,0,0,0,0,0,0,0,0,0.48483656587239576,0.5151634341276042
90934,0.607843137254902,0.4347826086956522,-155,130,0.5819333701084867,0.41806662989151333,away,WSH,over,9,0.5238095238095238,-110,0.5000596729920038,ARI,WSH,2023 REG,9,8,16,9,17,25,0,1,-1,1,1,1,1,1,1,1,1,1,0,0.5000596729920038,0.4999403270079962
90934,0.607843137254902,0.4347826086956522,-155,130,0.5819333701084867,0.41806662989151333,home,ARI,under,9,0.5215311004784688,-109,0.4999403270079962,ARI,WSH,2023 REG,9,8,16,9,17,25,0,1,-1,1,1,1,1,1,1,1,1,1,0,0.5000596729920038,0.4999403270079962
90935,0.49751243781094534,0.5454545454545454,101,-120,0.476135829221149,0.523864170778851,away,ATL,over,8.5,0.5121951219512195,-105,0.48808156828023186,PHI,ATL,2023 REG,12,6,10,7,13,22,0,1,-1,1,1,1,1,1,1,1,0,0,0,0.48808156828023186,0.5119184317197681
90935,0.49751243781094534,0.5454545454545454,101,-120,0.476135829221149,0.523864170778851,home,PHI,under,8.5,0.5348837209302326,-115,0.5119184317197681,PHI,ATL,2023 REG,12,6,10,7,13,22,0,1,-1,1,1,1,1,1,1,1,0,0,0,0.48808156828023186,0.5119184317197681
90936,0.5192307692307692,0.5238095238095238,-108,-110,0.49688292476754015,0.5031170752324599,away,BAL,over,9,0.5454545454545454,-120,0.5206611570247933,CWS,BAL,2023 REG,13,7,11,6,13,24,1,0,1,-1,1,1,1,1,1,1,0,0,0,0.5206611570247933,0.4793388429752067
90936,0.5192307692307692,0.5238095238095238,-108,-110,0.49688292476754015,0.5031170752324599,home,CWS,under,9,0.5,100,0.4793388429752067,CWS,BAL,2023 REG,13,7,11,6,13,24,1,0,1,-1,1,1,1,1,1,1,0,0,0,0.5206611570247933,0.4793388429752067
90937,0.5726495726495727,0.46511627906976744,-134,115,0.5510229738017454,0.44897702619825464,away,NYM,over,8.5,0.5454545454545454,-120,0.5206611570247933,PIT,NYM,2023 REG,8,2,3,1,3,11,1,0,1,-1,1,0,0,0,0,0,0,0,0,0.5206611570247933,0.4793388429752067
90937,0.5726495726495727,0.46511627906976744,-134,115,0.5510229738017454,0.44897702619825464,home,PIT,under,8.5,0.5,100,0.4793388429752067,PIT,NYM,2023 REG,8,2,3,1,3,11,1,0,1,-1,1,0,0,0,0,0,0,0,0,0.5206611570247933,0.4793388429752067
90938,0.48309178743961345,0.5555555555555556,107,-125,0.4644215734322854,0.5355784265677146,away,HOU,over,9,0.5215311004784688,-109,0.49670754937970685,MIA,HOU,2023 REG,8,5,8,6,11,16,0,1,-1,1,1,1,1,1,1,0,0,0,0,0.49670754937970685,0.5032924506202932
90938,0.48309178743961345,0.5555555555555556,107,-125,0.4644215734322854,0.5355784265677146,home,MIA,under,9,0.5260663507109005,-111,0.5032924506202932,MIA,HOU,2023 REG,8,5,8,6,11,16,0,1,-1,1,1,1,1,1,1,0,0,0,0,0.49670754937970685,0.5032924506202932
90939,0.6226415094339623,0.42016806722689076,-165,138,0.5959864900036198,0.4040135099963802,away,MIA,over,9,0.5238095238095238,-110,0.4988662131519274,LAD,MIA,2023 REG,6,3,5,1,4,11,1,0,2,-2,1,0,0,0,0,0,0,0,0,0.4988662131519274,0.5011337868480725
90939,0.6226415094339623,0.42016806722689076,-165,138,0.5959864900036198,0.4040135099963802,home,LAD,under,9,0.5238095238095238,-110,0.5011337868480725,LAD,MIA,2023 REG,6,3,5,1,4,11,1,0,2,-2,1,0,0,0,0,0,0,0,0,0.4988662131519274,0.5011337868480725
90940,0.6226415094339623,0.41493775933609955,-165,141,0.5992430968035465,0.4007569031964535,away,KC,over,7.5,0.49504950495049505,102,0.47297076509898783,MIA,KC,2023 REG,11,9,9,6,15,20,1,0,3,-3,1,1,1,1,1,1,0,0,0,0.47297076509898783,0.5270292349010122
90940,0.6226415094339623,0.41493775933609955,-165,141,0.5992430968035465,0.4007569031964535,home,MIA,under,7.5,0.5495495495495495,-122,0.5270292349010122,MIA,KC,2023 REG,11,9,9,6,15,20,1,0,3,-3,1,1,1,1,1,1,0,0,0,0.47297076509898783,0.5270292349010122
90941,0.646643109540636,0.3861003861003861,-183,159,0.6254697537020952,0.37453024629790477,away,PHI,over,8.5,0.5454545454545454,-120,0.5206611570247933,NYM,PHI,2023 REG,4,4,6,2,6,10,1,0,2,-2,1,1,0,0,0,0,0,0,0,0.5206611570247933,0.4793388429752067
90941,0.646643109540636,0.3861003861003861,-183,159,0.6254697537020952,0.37453024629790477,home,NYM,under,8.5,0.5,100,0.4793388429752067,NYM,PHI,2023 REG,4,4,6,2,6,10,1,0,2,-2,1,1,0,0,0,0,0,0,0,0.5206611570247933,0.4793388429752067
90942,0.4424778761061947,0.5967741935483871,126,-148,0.4251097036926629,0.5748902963073371,away,NYM,over,9,0.5454545454545454,-120,0.5233614270517961,WSH,NYM,2023 REG,10,3,11,2,5,21,1,0,1,-1,1,1,0,0,0,0,0,0,0,0.5233614270517961,0.4766385729482039
90942,0.4424778761061947,0.5967741935483871,126,-148,0.4251097036926629,0.5748902963073371,home,WSH,under,9,0.49504950495049505,102,0.4766385729482039,WSH,NYM,2023 REG,10,3,11,2,5,21,1,0,1,-1,1,1,0,0,0,0,0,0,0,0.5233614270517961,0.4766385729482039
90943,0.5391705069124424,0.5,-117,100,0.5180509248444435,0.4819490751555565,away,SD,over,10.5,0.5192307692307692,-108,0.49688292476754015,PHI,SD,2023 REG,12,9,5,4,13,17,1,0,5,-5,1,1,1,1,0,0,0,0,0,0.49688292476754015,0.5031170752324599
90943,0.5391705069124424,0.5,-117,100,0.5180509248444435,0.4819490751555565,home,PHI,under,10.5,0.5238095238095238,-110,0.5031170752324599,PHI,SD,2023 REG,12,9,5,4,13,17,1,0,5,-5,1,1,1,1,0,0,0,0,0,0.49688292476754015,0.5031170752324599
90944,0.6503496503496503,0.3846153846153846,-186,160,0.6276101520856765,0.3723898479143235,away,OAK,over,8,0.5433789954337899,-119,0.5198077604720502,CLE,OAK,2023 REG,13,7,9,6,13,22,1,0,1,-1,1,1,1,1,1,1,0,0,0,0.5198077604720502,0.48019223952794976
90944,0.6503496503496503,0.3846153846153846,-186,160,0.6276101520856765,0.3723898479143235,home,CLE,under,8,0.5,100,0.48019223952794976,CLE,OAK,2023 REG,13,7,9,6,13,22,1,0,1,-1,1,1,1,1,1,1,0,0,0,0.5198077604720502,0.48019223952794976
90945,0.5475113122171946,0.49504950495049505,-121,102,0.5242087833606768,0.4757912166393232,away,ARI,over,8,0.504950495049505,-102,0.48160416005266615,MIL,ARI,2023 REG,3,1,11,9,10,14,0,1,-8,8,1,0,0,0,0,0,0,0,0,0.48160416005266615,0.5183958399473338
90945,0.5475113122171946,0.49504950495049505,-121,102,0.5242087833606768,0.4757912166393232,home,MIL,under,8,0.5412844036697247,-118,0.5183958399473338,MIL,ARI,2023 REG,3,1,11,9,10,14,0,1,-8,8,1,0,0,0,0,0,0,0,0,0.48160416005266615,0.5183958399473338
90946,0.6226415094339623,0.4166666666666667,-165,140,0.5981666073335706,0.40183339266642937,away,STL,over,7.5,0.5238095238095238,-110,0.4988662131519274,SEA,STL,2023 REG,7,5,9,4,9,16,1,0,1,-1,1,1,1,1,0,0,0,0,0,0.4988662131519274,0.5011337868480725
90946,0.6226415094339623,0.4166666666666667,-165,140,0.5981666073335706,0.40183339266642937,home,SEA,under,7.5,0.5238095238095238,-110,0.5011337868480725,SEA,STL,2023 REG,7,5,9,4,9,16,1,0,1,-1,1,1,1,1,0,0,0,0,0,0.4988662131519274,0.5011337868480725
90947,0.5348837209302326,0.5,-115,100,0.5162249864791779,0.4837750135208221,away,SD,over,8,0.5327102803738317,-114,0.5075272610403079,CHC,SD,2023 REG,8,3,9,5,8,17,0,1,-2,2,1,1,1,0,0,0,0,0,0,0.5075272610403079,0.4924727389596921
90947,0.5348837209302326,0.5,-115,100,0.5162249864791779,0.4837750135208221,home,CHC,under,8,0.5145631067961165,-106,0.4924727389596921,CHC,SD,2023 REG,8,3,9,5,8,17,0,1,-2,2,1,1,1,0,0,0,0,0,0,0.5075272610403079,0.4924727389596921
90948,0.5024875621890548,0.5370370370370371,-101,-116,0.48262694267743644,0.5173730573225636,away,TB,over,8,0.5121951219512195,-105,0.48919479393107135,BOS,TB,2023 REG,11,7,13,9,16,24,0,1,-2,2,1,1,1,1,1,1,1,0,0,0.48919479393107135,0.5108052060689287
90948,0.5024875621890548,0.5370370370370371,-101,-116,0.48262694267743644,0.5173730573225636,home,BOS,under,8,0.5327102803738317,-114,0.5108052060689287,BOS,TB,2023 REG,11,7,13,9,16,24,0,1,-2,2,1,1,1,1,1,1,1,0,0,0.48919479393107135,0.5108052060689287
90949,0.4629629629629629,0.576271186440678,116,-136,0.4447990049057217,0.5552009950942782,away,MIA,over,9,0.5283018867924528,-112,0.5044173060022736,BOS,MIA,2023 REG,8,2,7,6,8,15,0,1,-4,4,1,1,0,0,0,0,0,0,0,0.5044173060022736,0.49558269399772636
90949,0.4629629629629629,0.576271186440678,116,-136,0.4447990049057217,0.5552009950942782,home,BOS,under,9,0.5169082125603864,-107,0.49558269399772636,BOS,MIA,2023 REG,8,2,7,6,8,15,0,1,-4,4,1,1,0,0,0,0,0,0,0,0.5044173060022736,0.49558269399772636
90950,0.6551724137931035,0.3802281368821293,-190,163,0.6319789495576061,0.36802105044239386,away,SF,over,8,0.5348837209302326,-115,0.5097020142727117,HOU,SF,2023 REG,3,0,7,2,2,10,0,1,-2,2,0,0,0,0,0,0,0,0,0,0.5097020142727117,0.49029798572728833
90950,0.6551724137931035,0.3802281368821293,-190,163,0.6319789495576061,0.36802105044239386,home,HOU,under,8,0.5121951219512195,-105,0.49029798572728833,HOU,SF,2023 REG,3,0,7,2,2,10,0,1,-2,2,0,0,0,0,0,0,0,0,0,0.5097020142727117,0.49029798572728833
90951,0.4629629629629629,0.574468085106383,116,-135,0.44563377404196935,0.5543662259580306,away,TOR,over,8,0.5098039215686274,-104,0.4870219861770517,STL,TOR,2023 REG,10,4,3,1,5,13,1,0,3,-3,1,0,0,0,0,0,0,0,0,0.4870219861770517,0.5129780138229483
90951,0.4629629629629629,0.574468085106383,116,-135,0.44563377404196935,0.5543662259580306,home,STL,under,8,0.5348837209302326,-115,0.5129780138229483,STL,TOR,2023 REG,10,4,3,1,5,13,1,0,3,-3,1,0,0,0,0,0,0,0,0,0.4870219861770517,0.5129780138229483
90952,0.45248868778280543,0.5884773662551441,121,-143,0.43395201174753417,0.5660479882524658,away,ATL,over,9.5,0.5215311004784688,-109,0.49670754937970685,MIL,ATL,2023 REG,8,4,7,3,7,15,1,0,1,-1,1,1,1,0,0,0,0,0,0,0.49670754937970685,0.5032924506202932
90952,0.45248868778280543,0.5884773662551441,121,-143,0.43395201174753417,0.5660479882524658,home,MIL,under,9.5,0.5260663507109005,-111,0.5032924506202932,MIL,ATL,2023 REG,8,4,7,3,7,15,1,0,1,-1,1,1,1,0,0,0,0,0,0,0.49670754937970685,0.5032924506202932
90953,0.34965034965034963,0.6923076923076923,186,-225,0.33497970560907625,0.6650202943909238,away,SF,over,10.5,0.5327102803738317,-114,0.508788710910954,COL,SF,2023 REG,6,3,2,2,5,8,1,0,1,-1,1,1,0,0,0,0,0,0,0,0.508788710910954,0.491211289089046
90953,0.34965034965034963,0.6923076923076923,186,-225,0.33497970560907625,0.6650202943909238,home,COL,under,10.5,0.5121951219512195,-105,0.491211289089046,COL,SF,2023 REG,6,3,2,2,5,8,1,0,1,-1,1,1,0,0,0,0,0,0,0,0.508788710910954,0.491211289089046
90954,0.45454545454545453,0.5815899581589958,120,-139,0.43812026695252254,0.5618797330474774,away,LAD,over,9.5,0.5024875621890548,-101,0.47839724939301687,TEX,LAD,2023 REG,9,3,18,16,19,27,0,1,-13,13,1,1,1,0,0,0,0,0,0,0.47839724939301687,0.5216027506069831
90954,0.45454545454545453,0.5815899581589958,120,-139,0.43812026695252254,0.5618797330474774,home,TEX,under,9.5,0.5454545454545454,-120,0.5216027506069831,TEX,LAD,2023 REG,9,3,18,16,19,27,0,1,-13,13,1,1,1,0,0,0,0,0,0,0.47839724939301687,0.5216027506069831
90955,0.5370370370370371,0.5024875621890548,-116,-101,0.5158108633785803,0.4841891366214197,away,OAK,over,12,0.5348837209302326,-115,0.5097020142727117,COL,OAK,2023 REG,12,3,13,11,14,25,0,1,-8,8,1,1,1,0,0,0,0,0,0,0.5097020142727117,0.49029798572728833
90955,0.5370370370370371,0.5024875621890548,-116,-101,0.5158108633785803,0.4841891366214197,home,COL,under,12,0.5121951219512195,-105,0.49029798572728833,COL,OAK,2023 REG,12,3,13,11,14,25,0,1,-8,8,1,1,1,0,0,0,0,0,0,0.5097020142727117,0.49029798572728833
90956,0.4484304932735426,0.5850622406639003,123,-141,0.43341133007289556,0.5665886699271044,away,NYY,over,10.5,0.5098039215686274,-104,0.48592421718142587,CIN,NYY,2023 REG,5,4,13,7,11,18,0,1,-3,3,1,1,1,1,0,0,0,0,0,0.48592421718142587,0.5140757828185741
90956,0.4484304932735426,0.5850622406639003,123,-141,0.43341133007289556,0.5665886699271044,home,CIN,under,10.5,0.5370370370370371,-116,0.5140757828185741,CIN,NYY,2023 REG,5,4,13,7,11,18,0,1,-3,3,1,1,1,1,0,0,0,0,0,0.48592421718142587,0.5140757828185741
90957,0.5145631067961165,0.5238095238095238,-106,-110,0.4948179667757384,0.5051820332242616,away,TEX,over,8.5,0.5238095238095238,-110,0.4988662131519274,SF,TEX,2023 REG,3,1,6,2,3,9,0,1,-1,1,1,0,0,0,0,0,0,0,0,0.4988662131519274,0.5011337868480725
90957,0.5145631067961165,0.5238095238095238,-106,-110,0.4948179667757384,0.5051820332242616,home,SF,under,8.5,0.5238095238095238,-110,0.5011337868480725,SF,TEX,2023 REG,3,1,6,2,3,9,0,1,-1,1,1,0,0,0,0,0,0,0,0,0.4988662131519274,0.5011337868480725
90958,0.37735849056603776,0.6610169491525424,165,-195,0.36287719255902645,0.6371228074409736,away,SD,over,12.5,0.5121951219512195,-105,0.48808156828023186,COL,SD,2023 REG,5,1,14,11,12,19,0,1,-10,10,1,0,0,0,0,0,0,0,0,0.48808156828023186,0.5119184317197681
90958,0.37735849056603776,0.6610169491525424,165,-195,0.36287719255902645,0.6371228074409736,home,COL,under,12.5,0.5348837209302326,-115,0.5119184317197681,COL,SD,2023 REG,5,1,14,11,12,19,0,1,-10,10,1,0,0,0,0,0,0,0,0,0.48808156828023186,0.5119184317197681
90959,0.607843137254902,0.4347826086956522,-155,130,0.5819333701084867,0.41806662989151333,away,CIN,over,9,0.5475113122171946,-121,0.5214983313199976,LAA,CIN,2023 REG,6,3,7,4,7,13,0,1,-1,1,1,1,1,0,0,0,0,0,0,0.5214983313199976,0.47850166868000243
90959,0.607843137254902,0.4347826086956522,-155,130,0.5819333701084867,0.41806662989151333,home,LAA,under,9,0.5,100,0.47850166868000243,LAA,CIN,2023 REG,6,3,7,4,7,13,0,1,-1,1,1,1,1,0,0,0,0,0,0,0.5214983313199976,0.47850166868000243
90960,0.5614035087719298,0.4739336492890995,-128,111,0.5415651042464397,0.45843489575356033,away,BOS,over,9,0.49504950495049505,102,0.47297076509898783,NYY,BOS,2023 REG,6,3,7,1,4,13,1,0,2,-2,1,0,0,0,0,0,0,0,0,0.47297076509898783,0.5270292349010122
90960,0.5614035087719298,0.4739336492890995,-128,111,0.5415651042464397,0.45843489575356033,home,NYY,under,9,0.5495495495495495,-122,0.5270292349010122,NYY,BOS,2023 REG,6,3,7,1,4,13,1,0,2,-2,1,0,0,0,0,0,0,0,0,0.47297076509898783,0.5270292349010122
90961,0.38759689922480617,0.6503496503496503,158,-186,0.3728889342734665,0.6271110657265335,away,CHC,over,8.5,0.5327102803738317,-114,0.5075272610403079,WSH,CHC,2023 REG,6,4,6,3,7,12,1,0,1,-1,1,1,1,0,0,0,0,0,0,0.5075272610403079,0.4924727389596921
90961,0.38759689922480617,0.6503496503496503,158,-186,0.3728889342734665,0.6271110657265335,home,WSH,under,8.5,0.5145631067961165,-106,0.4924727389596921,WSH,CHC,2023 REG,6,4,6,3,7,12,1,0,1,-1,1,1,1,0,0,0,0,0,0,0.5075272610403079,0.4924727389596921
90962,0.7101449275362319,0.3333333333333333,-245,200,0.6792690611216132,0.3207309388783868,away,MIA,over,8,0.5283018867924528,-112,0.5044173060022736,CLE,MIA,2023 REG,4,1,7,6,7,11,0,1,-5,5,1,0,0,0,0,0,0,0,0,0.5044173060022736,0.49558269399772636
90962,0.7101449275362319,0.3333333333333333,-245,200,0.6792690611216132,0.3207309388783868,home,CLE,under,8,0.5169082125603864,-107,0.49558269399772636,CLE,MIA,2023 REG,4,1,7,6,7,11,0,1,-5,5,1,0,0,0,0,0,0,0,0,0.5044173060022736,0.49558269399772636
90963,0.5348837209302326,0.5073891625615764,-115,-103,0.5122726437136835,0.48772735628631647,away,MIN,over,8.5,0.5260663507109005,-111,0.5010269332605688,BAL,MIN,2023 REG,4,1,13,8,9,17,0,1,-7,7,1,0,0,0,0,0,0,0,0,0.5010269332605688,0.4989730667394312
90963,0.5348837209302326,0.5073891625615764,-115,-103,0.5122726437136835,0.48772735628631647,home,BAL,under,8.5,0.5215311004784688,-109,0.4989730667394312,BAL,MIN,2023 REG,4,1,13,8,9,17,0,1,-7,7,1,0,0,0,0,0,0,0,0,0.5010269332605688,0.4989730667394312
90964,0.6666666666666666,0.37037037037037035,-200,170,0.6419753086419753,0.3580246913580247,away,DET,over,7.5,0.504950495049505,-102,0.48160416005266615,CLE,DET,2023 REG,7,2,9,0,2,16,1,0,2,-2,0,0,0,0,0,0,0,0,0,0.48160416005266615,0.5183958399473338
90964,0.6666666666666666,0.37037037037037035,-200,170,0.6419753086419753,0.3580246913580247,home,CLE,under,7.5,0.5412844036697247,-118,0.5183958399473338,CLE,DET,2023 REG,7,2,9,0,2,16,1,0,2,-2,0,0,0,0,0,0,0,0,0,0.48160416005266615,0.5183958399473338
90965,0.425531914893617,0.613899613899614,135,-159,0.40875254093905067,0.5912474590609493,away,SD,over,8.5,0.5327102803738317,-114,0.508788710910954,SEA,SD,2023 REG,10,6,4,1,7,14,1,0,5,-5,1,0,0,0,0,0,0,0,0,0.508788710910954,0.491211289089046
90965,0.425531914893617,0.613899613899614,135,-159,0.40875254093905067,0.5912474590609493,home,SEA,under,8.5,0.5121951219512195,-105,0.491211289089046,SEA,SD,2023 REG,10,6,4,1,7,14,1,0,5,-5,1,0,0,0,0,0,0,0,0,0.508788710910954,0.491211289089046
90966,0.4329004329004329,0.609375,131,-156,0.4145993796967823,0.5854006203032177,away,ATL,over,7.5,0.5,100,0.4762443438914027,SF,ATL,2023 REG,6,1,7,5,6,13,0,1,-4,4,1,0,0,0,0,0,0,0,0,0.4762443438914027,0.5237556561085973
90966,0.4329004329004329,0.609375,131,-156,0.4145993796967823,0.5854006203032177,home,SF,under,7.5,0.5475113122171946,-121,0.5237556561085973,SF,ATL,2023 REG,6,1,7,5,6,13,0,1,-4,4,1,0,0,0,0,0,0,0,0,0.4762443438914027,0.5237556561085973
90967,0.5934959349593496,0.4444444444444444,-146,125,0.5709784740123824,0.42902152598761756,away,SEA,over,9,0.5024875621890548,-101,0.48049269377245407,TEX,SEA,2023 REG,19,16,11,6,22,30,1,0,10,-10,1,1,1,1,1,1,0,0,0,0.48049269377245407,0.5195073062275459
90967,0.5934959349593496,0.4444444444444444,-146,125,0.5709784740123824,0.42902152598761756,home,TEX,under,9,0.5412844036697247,-118,0.5195073062275459,TEX,SEA,2023 REG,19,16,11,6,22,30,1,0,10,-10,1,1,1,1,1,1,0,0,0,0.48049269377245407,0.5195073062275459
90968,0.5555555555555556,0.4854368932038835,-125,106,0.5327819729114227,0.4672180270885773,away,STL,over,10,0.5238095238095238,-110,0.4988662131519274,CIN,STL,2023 REG,10,4,9,9,13,19,0,1,-5,5,1,1,1,1,0,0,0,0,0,0.4988662131519274,0.5011337868480725
90968,0.5555555555555556,0.4854368932038835,-125,106,0.5327819729114227,0.4672180270885773,home,CIN,under,10,0.5238095238095238,-110,0.5011337868480725,CIN,STL,2023 REG,10,4,9,9,13,19,0,1,-5,5,1,1,1,1,0,0,0,0,0,0.4988662131519274,0.5011337868480725
90969,0.7311827956989247,0.3125,-272,220,0.69924268701584,0.30075731298416,away,PIT,over,10,0.5260663507109005,-111,0.5010269332605688,ATL,PIT,2023 REG,7,5,7,2,7,14,1,0,3,-3,1,1,0,0,0,0,0,0,0,0.5010269332605688,0.4989730667394312
90969,0.7311827956989247,0.3125,-272,220,0.69924268701584,0.30075731298416,home,ATL,under,10,0.5215311004784688,-109,0.4989730667394312,ATL,PIT,2023 REG,7,5,7,2,7,14,1,0,3,-3,1,1,0,0,0,0,0,0,0,0.5010269332605688,0.4989730667394312
90970,0.47619047619047616,0.5652173913043479,110,-130,0.4564724440500838,0.5435275559499162,away,HOU,over,9,0.5169082125603864,-107,0.49353874091423283,ARI,HOU,2023 REG,5,0,6,1,1,11,0,1,-1,1,0,0,0,0,0,0,0,0,0,0.49353874091423283,0.5064612590857671
90970,0.47619047619047616,0.5652173913043479,110,-130,0.4564724440500838,0.5435275559499162,home,ARI,under,9,0.5283018867924528,-112,0.5064612590857671,ARI,HOU,2023 REG,5,0,6,1,1,11,0,1,-1,1,0,0,0,0,0,0,0,0,0,0.49353874091423283,0.5064612590857671
90971,0.5652173913043479,0.47619047619047616,-130,110,0.5418129444594474,0.4581870555405526,away,HOU,over,7.5,0.5238095238095238,-110,0.4988662131519274,MIN,HOU,2023 REG,11,3,5,2,5,16,1,0,1,-1,1,1,0,0,0,0,0,0,0,0.4988662131519274,0.5011337868480725
90971,0.5652173913043479,0.47619047619047616,-130,110,0.5418129444594474,0.4581870555405526,home,MIN,under,7.5,0.5238095238095238,-110,0.5011337868480725,MIN,HOU,2023 REG,11,3,5,2,5,16,1,0,1,-1,1,1,0,0,0,0,0,0,0,0.4988662131519274,0.5011337868480725
90972,0.4739336492890995,0.5670995670995671,111,-131,0.4544866273039494,0.5455133726960506,away,HOU,over,10,0.5238095238095238,-110,0.4988662131519274,BOS,HOU,2023 REG,7,4,12,7,11,19,0,1,-3,3,1,1,1,1,0,0,0,0,0,0.4988662131519274,0.5011337868480725
90972,0.4739336492890995,0.5670995670995671,111,-131,0.4544866273039494,0.5455133726960506,home,BOS,under,10,0.5238095238095238,-110,0.5011337868480725,BOS,HOU,2023 REG,7,4,12,7,11,19,0,1,-3,3,1,1,1,1,0,0,0,0,0,0.4988662131519274,0.5011337868480725
90973,0.5283018867924528,0.5098039215686274,-112,-104,0.5081705163375425,0.4918294836624575,away,NYM,over,8.5,0.5454545454545454,-120,0.5220180091279142,MIL,NYM,2023 REG,10,10,3,0,10,13,1,0,10,-10,0,0,0,0,0,0,0,0,0,0.5220180091279142,0.4779819908720858
90973,0.5283018867924528,0.5098039215686274,-112,-104,0.5081705163375425,0.4918294836624575,home,MIL,under,8.5,0.49751243781094534,101,0.4779819908720858,MIL,NYM,2023 REG,10,10,3,0,10,13,1,0,10,-10,0,0,0,0,0,0,0,0,0,0.5220180091279142,0.4779819908720858
90974,0.5454545454545454,0.5,-120,100,0.5206611570247933,0.4793388429752067,away,LAD,over,9.5,0.5,100,0.4772727272727273,ATL,LAD,2023 REG,5,4,12,3,7,17,1,0,1,-1,1,1,1,0,0,0,0,0,0,0.4772727272727273,0.5227272727272727
90974,0.5454545454545454,0.5,-120,100,0.5206611570247933,0.4793388429752067,home,ATL,under,9.5,0.5454545454545454,-120,0.5227272727272727,ATL,LAD,2023 REG,5,4,12,3,7,17,1,0,1,-1,1,1,1,0,0,0,0,0,0,0.4772727272727273,0.5227272727272727
90975,0.4444444444444444,0.5901639344262295,125,-144,0.4290629427241449,0.5709370572758551,away,MIN,over,7.5,0.5348837209302326,-115,0.5109810284308424,LAA,MIN,2023 REG,10,5,6,4,9,16,1,0,1,-1,1,1,1,1,0,0,0,0,0,0.5109810284308424,0.48901897156915763
90975,0.4444444444444444,0.5901639344262295,125,-144,0.4290629427241449,0.5709370572758551,home,LAA,under,7.5,0.5098039215686274,-104,0.48901897156915763,LAA,MIN,2023 REG,10,5,6,4,9,16,1,0,1,-1,1,1,1,1,0,0,0,0,0,0.5109810284308424,0.48901897156915763
90976,0.49019607843137253,0.5412844036697247,104,-118,0.47476446955828566,0.5252355304417143,away,BAL,over,9,0.5145631067961165,-106,0.49023796582517226,CWS,BAL,2023 REG,6,3,7,6,9,13,0,1,-3,3,1,1,1,0,0,0,0,0,0,0.49023796582517226,0.5097620341748277
90976,0.49019607843137253,0.5412844036697247,104,-118,0.47476446955828566,0.5252355304417143,home,CWS,under,9,0.5327102803738317,-114,0.5097620341748277,CWS,BAL,2023 REG,6,3,7,6,9,13,0,1,-3,3,1,1,1,0,0,0,0,0,0,0.49023796582517226,0.5097620341748277
90977,0.7014925373134329,0.3333333333333333,-235,200,0.6770624489492835,0.32293755105071653,away,COL,over,8,0.5305164319248826,-113,0.5066009958897986,SEA,COL,2023 REG,8,9,6,2,11,14,1,0,7,-7,1,1,0,0,0,0,0,0,0,0.5066009958897986,0.49339900411020143
90977,0.7014925373134329,0.3333333333333333,-235,200,0.6770624489492835,0.32293755105071653,home,SEA,under,8,0.5145631067961165,-106,0.49339900411020143,SEA,COL,2023 REG,8,9,6,2,11,14,1,0,7,-7,1,1,0,0,0,0,0,0,0,0.5066009958897986,0.49339900411020143
90978,0.6721311475409836,0.37037037037037035,-205,170,0.6435645535349916,0.35643544646500835,away,COL,over,9.5,0.5073891625615764,-103,0.4826927225525911,STL,COL,2023 REG,8,0,5,1,1,13,0,1,-1,1,0,0,0,0,0,0,0,0,0,0.4826927225525911,0.5173072774474089
90978,0.6721311475409836,0.37037037037037035,-205,170,0.6435645535349916,0.35643544646500835,home,STL,under,9.5,0.5412844036697247,-118,0.5173072774474089,STL,COL,2023 REG,8,0,5,1,1,13,0,1,-1,1,0,0,0,0,0,0,0,0,0,0.4826927225525911,0.5173072774474089
90979,0.4504504504504505,0.5867768595041323,122,-142,0.43368139191235017,0.5663186080876499,away,TB,over,8,0.5454545454545454,-120,0.5206611570247933,BOS,TB,2023 REG,6,1,8,4,5,14,0,1,-3,3,1,0,0,0,0,0,0,0,0,0.5206611570247933,0.4793388429752067
90979,0.4504504504504505,0.5867768595041323,122,-142,0.43368139191235017,0.5663186080876499,home,BOS,under,8,0.5,100,0.4793388429752067,BOS,TB,2023 REG,6,1,8,4,5,14,0,1,-3,3,1,0,0,0,0,0,0,0,0,0.5206611570247933,0.4793388429752067
90980,0.44052863436123346,0.5951417004048584,127,-147,0.424814830499519,0.575185169500481,away,ATL,over,9.5,0.5305164319248826,-113,0.5066009958897986,DET,ATL,2023 REG,6,5,10,6,11,16,0,1,-1,1,1,1,1,1,1,0,0,0,0,0.5066009958897986,0.49339900411020143
90980,0.44052863436123346,0.5951417004048584,127,-147,0.424814830499519,0.575185169500481,home,DET,under,9.5,0.5145631067961165,-106,0.49339900411020143,DET,ATL,2023 REG,6,5,10,6,11,16,0,1,-1,1,1,1,1,1,1,0,0,0,0,0.5066009958897986,0.49339900411020143
90981,0.5726495726495727,0.46511627906976744,-134,115,0.5510229738017454,0.44897702619825464,away,LAA,over,9,0.5475113122171946,-121,0.5214983313199976,MIL,LAA,2023 REG,8,2,9,1,3,17,1,0,1,-1,1,0,0,0,0,0,0,0,0,0.5214983313199976,0.47850166868000243
90981,0.5726495726495727,0.46511627906976744,-134,115,0.5510229738017454,0.44897702619825464,home,MIL,under,9,0.5,100,0.47850166868000243,MIL,LAA,2023 REG,8,2,9,1,3,17,1,0,1,-1,1,0,0,0,0,0,0,0,0,0.5214983313199976,0.47850166868000243
90982,0.5983935742971888,0.4444444444444444,-149,125,0.5727595791465728,0.42724042085342717,away,SF,over,11,0.5238095238095238,-110,0.4988662131519274,CHC,SF,2023 REG,11,8,10,2,10,21,1,0,6,-6,1,1,0,0,0,0,0,0,0,0.4988662131519274,0.5011337868480725
90982,0.5983935742971888,0.4444444444444444,-149,125,0.5727595791465728,0.42724042085342717,home,CHC,under,11,0.5238095238095238,-110,0.5011337868480725,CHC,SF,2023 REG,11,8,10,2,10,21,1,0,6,-6,1,1,0,0,0,0,0,0,0,0.4988662131519274,0.5011337868480725
90983,0.5073891625615764,0.5348837209302326,-103,-115,0.4859403596076043,0.5140596403923957,away,LAA,over,9,0.5192307692307692,-108,0.49571111079951763,NYM,LAA,2023 REG,7,3,9,5,8,16,0,1,-2,2,1,1,1,0,0,0,0,0,0,0.49571111079951763,0.5042888892004824
90983,0.5073891625615764,0.5348837209302326,-103,-115,0.4859403596076043,0.5140596403923957,home,NYM,under,9,0.5260663507109005,-111,0.5042888892004824,NYM,LAA,2023 REG,7,3,9,5,8,16,0,1,-2,2,1,1,1,0,0,0,0,0,0,0.49571111079951763,0.5042888892004824
90984,0.6774193548387096,0.36363636363636365,-210,175,0.6496074165168858,0.3503925834831142,away,NYY,over,9.5,0.5348837209302326,-115,0.5097020142727117,ATL,NYY,2023 REG,3,2,4,0,2,7,1,0,2,-2,0,0,0,0,0,0,0,0,0,0.5097020142727117,0.49029798572728833
90984,0.6774193548387096,0.36363636363636365,-210,175,0.6496074165168858,0.3503925834831142,home,ATL,under,9.5,0.5121951219512195,-105,0.49029798572728833,ATL,NYY,2023 REG,3,2,4,0,2,7,1,0,2,-2,0,0,0,0,0,0,0,0,0,0.5097020142727117,0.49029798572728833
90985,0.5652173913043479,0.47619047619047616,-130,110,0.5418129444594474,0.4581870555405526,away,BAL,over,9.5,0.5,100,0.4772727272727273,PHI,BAL,2023 REG,8,4,8,3,7,16,1,0,1,-1,1,1,1,0,0,0,0,0,0,0.4772727272727273,0.5227272727272727
90985,0.5652173913043479,0.47619047619047616,-130,110,0.5418129444594474,0.4581870555405526,home,PHI,under,9.5,0.5454545454545454,-120,0.5227272727272727,PHI,BAL,2023 REG,8,4,8,3,7,16,1,0,1,-1,1,1,1,0,0,0,0,0,0,0.4772727272727273,0.5227272727272727
90986,0.47619047619047616,0.5652173913043479,110,-130,0.4564724440500838,0.5435275559499162,away,CLE,over,9.5,0.5,100,0.4772727272727273,CWS,CLE,2023 REG,12,7,9,2,9,21,1,0,5,-5,1,1,0,0,0,0,0,0,0,0.4772727272727273,0.5227272727272727
90986,0.47619047619047616,0.5652173913043479,110,-130,0.4564724440500838,0.5435275559499162,home,CWS,under,9.5,0.5454545454545454,-120,0.5227272727272727,CWS,CLE,2023 REG,12,7,9,2,9,21,1,0,5,-5,1,1,0,0,0,0,0,0,0,0.4772727272727273,0.5227272727272727
90987,0.5098039215686274,0.5327102803738317,-104,-114,0.4881300146960012,0.5118699853039987,away,TOR,over,8.5,0.5348837209302326,-115,0.5097020142727117,MIN,TOR,2023 REG,5,0,7,3,3,12,0,1,-3,3,0,0,0,0,0,0,0,0,0,0.5097020142727117,0.49029798572728833
90987,0.5098039215686274,0.5327102803738317,-104,-114,0.4881300146960012,0.5118699853039987,home,MIN,under,8.5,0.5121951219512195,-105,0.49029798572728833,MIN,TOR,2023 REG,5,0,7,3,3,12,0,1,-3,3,0,0,0,0,0,0,0,0,0,0.5097020142727117,0.49029798572728833
90988,0.47619047619047616,0.5633187772925764,110,-129,0.45737654596045113,0.5426234540395489,away,MIN,over,8.5,0.5412844036697247,-118,0.5162581740877563,STL,MIN,2023 REG,10,7,4,3,10,14,1,0,4,-4,1,1,1,0,0,0,0,0,0,0.5162581740877563,0.4837418259122437
90988,0.47619047619047616,0.5633187772925764,110,-129,0.45737654596045113,0.5426234540395489,home,STL,under,8.5,0.504950495049505,-102,0.4837418259122437,STL,MIN,2023 REG,10,7,4,3,10,14,1,0,4,-4,1,1,1,0,0,0,0,0,0,0.5162581740877563,0.4837418259122437
90989,0.45454545454545453,0.5850622406639003,120,-141,0.4365419567230205,0.5634580432769796,away,CHC,over,8.5,0.5348837209302326,-115,0.5084354177277668,WSH,CHC,2023 REG,9,4,8,1,5,17,1,0,3,-3,1,0,0,0,0,0,0,0,0,0.5084354177277668,0.4915645822722332
90989,0.45454545454545453,0.5850622406639003,120,-141,0.4365419567230205,0.5634580432769796,home,WSH,under,8.5,0.5145631067961165,-106,0.4915645822722332,WSH,CHC,2023 REG,9,4,8,1,5,17,1,0,3,-3,1,0,0,0,0,0,0,0,0,0.5084354177277668,0.4915645822722332
90990,0.7422680412371133,0.29850746268656714,-288,235,0.7120016878092267,0.2879983121907733,away,OAK,over,9,0.5098039215686274,-104,0.48483656587239576,HOU,OAK,2023 REG,3,0,7,4,4,10,0,1,-4,4,0,0,0,0,0,0,0,0,0,0.48483656587239576,0.5151634341276042
90990,0.7422680412371133,0.29850746268656714,-288,235,0.7120016878092267,0.2879983121907733,home,HOU,under,9,0.5391705069124424,-117,0.5151634341276042,HOU,OAK,2023 REG,3,0,7,4,4,10,0,1,-4,4,0,0,0,0,0,0,0,0,0,0.48483656587239576,0.5151634341276042
90991,0.5238095238095238,0.5145631067961165,-110,-106,0.5037095744446646,0.4962904255553354,away,TEX,over,8.5,0.5145631067961165,-106,0.4913668392989033,LAA,TEX,2023 REG,6,1,15,10,11,21,0,1,-9,9,1,0,0,0,0,0,0,0,0,0.4913668392989033,0.5086331607010968
90991,0.5238095238095238,0.5145631067961165,-110,-106,0.5037095744446646,0.4962904255553354,home,LAA,under,8.5,0.5305164319248826,-113,0.5086331607010968,LAA,TEX,2023 REG,6,1,15,10,11,21,0,1,-9,9,1,0,0,0,0,0,0,0,0,0.4913668392989033,0.5086331607010968
90992,0.6551724137931035,0.3846153846153846,-190,160,0.6291045458703008,0.37089545412969915,away,COL,over,8.5,0.5348837209302326,-115,0.5109810284308424,SEA,COL,2023 REG,7,5,7,3,8,14,1,0,2,-2,1,1,1,0,0,0,0,0,0,0.5109810284308424,0.48901897156915763
90992,0.6551724137931035,0.3846153846153846,-190,160,0.6291045458703008,0.37089545412969915,home,SEA,under,8.5,0.5098039215686274,-104,0.48901897156915763,SEA,COL,2023 REG,7,5,7,3,8,14,1,0,2,-2,1,1,1,0,0,0,0,0,0,0.5109810284308424,0.48901897156915763
90993,0.5614035087719298,0.47846889952153115,-128,109,0.5390189988527938,0.4609810011472062,away,LAD,over,9.5,0.5073891625615764,-103,0.4837652908580103,TEX,LAD,2023 REG,4,5,13,11,16,17,0,1,-6,6,1,1,1,1,1,0,0,0,0,0.4837652908580103,0.5162347091419897
90993,0.5614035087719298,0.47846889952153115,-128,109,0.5390189988527938,0.4609810011472062,home,TEX,under,9.5,0.5391705069124424,-117,0.5162347091419897,TEX,LAD,2023 REG,4,5,13,11,16,17,0,1,-6,6,1,1,1,1,1,0,0,0,0,0.4837652908580103,0.5162347091419897
90994,0.6551724137931035,0.38314176245210724,-190,161,0.6300700224600344,0.3699299775399656,away,WSH,over,9.5,0.5238095238095238,-110,0.5000596729920038,ATL,WSH,2023 REG,6,6,9,4,10,15,1,0,2,-2,1,1,1,1,0,0,0,0,0,0.5000596729920038,0.4999403270079962
90994,0.6551724137931035,0.38314176245210724,-190,161,0.6300700224600344,0.3699299775399656,home,ATL,under,9.5,0.5215311004784688,-109,0.4999403270079962,ATL,WSH,2023 REG,6,6,9,4,10,15,1,0,2,-2,1,1,1,1,0,0,0,0,0,0.5000596729920038,0.4999403270079962
90995,0.4807692307692307,0.5535714285714286,108,-124,0.4642592983939138,0.5357407016060862,away,HOU,over,8.5,0.5305164319248826,-113,0.5053568787472517,SEA,HOU,2023 REG,12,7,9,5,12,21,1,0,2,-2,1,1,1,1,1,0,0,0,0,0.5053568787472517,0.49464312125274834
90995,0.4807692307692307,0.5535714285714286,108,-124,0.4642592983939138,0.5357407016060862,home,SEA,under,8.5,0.5169082125603864,-107,0.49464312125274834,SEA,HOU,2023 REG,12,7,9,5,12,21,1,0,2,-2,1,1,1,1,1,0,0,0,0,0.5053568787472517,0.49464312125274834
90996,0.5726495726495727,0.46511627906976744,-134,115,0.5510229738017454,0.44897702619825464,away,BAL,over,9.5,0.5,100,0.4772727272727273,TOR,BAL,2023 REG,11,5,11,6,11,22,0,1,-1,1,1,1,1,1,1,0,0,0,0,0.4772727272727273,0.5227272727272727
90996,0.5726495726495727,0.46511627906976744,-134,115,0.5510229738017454,0.44897702619825464,home,TOR,under,9.5,0.5454545454545454,-120,0.5227272727272727,TOR,BAL,2023 REG,11,5,11,6,11,22,0,1,-1,1,1,1,1,1,1,0,0,0,0,0.4772727272727273,0.5227272727272727
90997,0.46511627906976744,0.5780590717299579,115,-137,0.4450347205582673,0.5549652794417327,away,MIA,over,9,0.504950495049505,-102,0.4826715732667395,PIT,MIA,2023 REG,12,3,14,7,10,26,0,1,-4,4,1,1,1,0,0,0,0,0,0,0.4826715732667395,0.5173284267332605
90997,0.46511627906976744,0.5780590717299579,115,-137,0.4450347205582673,0.5549652794417327,home,PIT,under,9,0.5391705069124424,-117,0.5173284267332605,PIT,MIA,2023 REG,12,3,14,7,10,26,0,1,-4,4,1,1,1,0,0,0,0,0,0,0.4826715732667395,0.5173284267332605
90998,0.5633187772925764,0.47619047619047616,-129,110,0.5410624729287608,0.45893752707123925,away,STL,over,8,0.5238095238095238,-110,0.4988662131519274,SEA,STL,2023 REG,6,5,3,2,7,9,1,0,3,-3,1,1,0,0,0,0,0,0,0,0.4988662131519274,0.5011337868480725
90998,0.5633187772925764,0.47619047619047616,-129,110,0.5410624729287608,0.45893752707123925,home,SEA,under,8,0.5238095238095238,-110,0.5011337868480725,SEA,STL,2023 REG,6,5,3,2,7,9,1,0,3,-3,1,1,0,0,0,0,0,0,0,0.4988662131519274,0.5011337868480725
90999,0.6688741721854304,0.3717472118959108,-202,169,0.641703577534997,0.35829642246500304,away,NYM,over,10,0.5370370370370371,-116,0.5118817074154765,ATL,NYM,2023 REG,12,7,3,0,7,15,1,0,7,-7,0,0,0,0,0,0,0,0,0,0.5118817074154765,0.48811829258452355
90999,0.6688741721854304,0.3717472118959108,-202,169,0.641703577534997,0.35829642246500304,home,ATL,under,10,0.5098039215686274,-104,0.48811829258452355,ATL,NYM,2023 REG,12,7,3,0,7,15,1,0,7,-7,0,0,0,0,0,0,0,0,0,0.5118817074154765,0.48811829258452355
91000,0.5850622406639003,0.45454545454545453,-141,120,0.5618892737571823,0.43811072624281766,away,SF,over,8.5,0.5215311004784688,-109,0.4978845547971712,LAA,SF,2023 REG,4,4,5,1,5,9,1,0,3,-3,1,0,0,0,0,0,0,0,0,0.4978845547971712,0.5021154452028288
91000,0.5850622406639003,0.45454545454545453,-141,120,0.5618892737571823,0.43811072624281766,home,LAA,under,8.5,0.5238095238095238,-110,0.5021154452028288,LAA,SF,2023 REG,4,4,5,1,5,9,1,0,3,-3,1,0,0,0,0,0,0,0,0,0.4978845547971712,0.5021154452028288
91001,0.6666666666666666,0.37037037037037035,-200,170,0.6419753086419753,0.3580246913580247,away,DET,over,10,0.5348837209302326,-115,0.5097020142727117,BOS,DET,2023 REG,8,2,12,6,8,20,0,1,-4,4,1,1,0,0,0,0,0,0,0,0.5097020142727117,0.49029798572728833
91001,0.6666666666666666,0.37037037037037035,-200,170,0.6419753086419753,0.3580246913580247,home,BOS,under,10,0.5121951219512195,-105,0.49029798572728833,BOS,DET,2023 REG,8,2,12,6,8,20,0,1,-4,4,1,1,0,0,0,0,0,0,0,0.5097020142727117,0.49029798572728833
91002,0.5348837209302326,0.5098039215686274,-115,-104,0.5109810284308424,0.48901897156915763,away,BOS,over,9.5,0.5348837209302326,-115,0.5097020142727117,LAA,BOS,2023 REG,5,2,4,1,3,9,1,0,1,-1,1,0,0,0,0,0,0,0,0,0.5097020142727117,0.49029798572728833
91002,0.5348837209302326,0.5098039215686274,-115,-104,0.5109810284308424,0.48901897156915763,home,LAA,under,9.5,0.5121951219512195,-105,0.49029798572728833,LAA,BOS,2023 REG,5,2,4,1,3,9,1,0,1,-1,1,0,0,0,0,0,0,0,0,0.5097020142727117,0.49029798572728833
91003,0.40485829959514175,0.6323529411764706,147,-172,0.3897930199305214,0.6102069800694786,away,ATL,over,9,0.5412844036697247,-118,0.5189377998484975,TEX,ATL,2023 REG,10,0,12,12,12,22,0,1,-12,12,0,0,0,0,0,0,0,0,0,0.5189377998484975,0.4810622001515025
91003,0.40485829959514175,0.6323529411764706,147,-172,0.3897930199305214,0.6102069800694786,home,TEX,under,9,0.5,100,0.4810622001515025,TEX,ATL,2023 REG,10,0,12,12,12,22,0,1,-12,12,0,0,0,0,0,0,0,0,0,0.5189377998484975,0.4810622001515025
91004,0.5833333333333333,0.45454545454545453,-140,120,0.5612373737373737,0.4387626262626263,away,TOR,over,8.5,0.5121951219512195,-105,0.48808156828023186,NYM,TOR,2023 REG,7,4,7,6,10,14,0,1,-2,2,1,1,1,1,0,0,0,0,0,0.48808156828023186,0.5119184317197681
91004,0.5833333333333333,0.45454545454545453,-140,120,0.5612373737373737,0.4387626262626263,home,NYM,under,8.5,0.5348837209302326,-115,0.5119184317197681,NYM,TOR,2023 REG,7,4,7,6,10,14,0,1,-2,2,1,1,1,1,0,0,0,0,0,0.48808156828023186,0.5119184317197681
91005,0.4347826086956522,0.607843137254902,130,-155,0.41624967567367205,0.583750324326328,away,MIN,over,8.5,0.5391705069124424,-117,0.5127649394825569,DET,MIN,2023 REG,17,9,7,5,14,24,1,0,4,-4,1,1,1,1,1,0,0,0,0,0.5127649394825569,0.48723506051744314
91005,0.4347826086956522,0.607843137254902,130,-155,0.41624967567367205,0.583750324326328,home,DET,under,8.5,0.5098039215686274,-104,0.48723506051744314,DET,MIN,2023 REG,17,9,7,5,14,24,1,0,4,-4,1,1,1,1,1,0,0,0,0,0.5127649394825569,0.48723506051744314
91006,0.607843137254902,0.43103448275862066,-155,132,0.5842116427368785,0.41578835726312147,away,PHI,over,10,0.5391705069124424,-117,0.5140669063204599,ATL,PHI,2023 REG,11,4,7,6,10,18,0,1,-2,2,1,1,1,1,0,0,0,0,0,0.5140669063204599,0.4859330936795401
91006,0.607843137254902,0.43103448275862066,-155,132,0.5842116427368785,0.41578835726312147,home,ATL,under,10,0.5073891625615764,-103,0.4859330936795401,ATL,PHI,2023 REG,11,4,7,6,10,18,0,1,-2,2,1,1,1,1,0,0,0,0,0,0.5140669063204599,0.4859330936795401
91007,0.6774193548387096,0.3663003663003663,-210,173,0.6478027695509486,0.3521972304490514,away,CLE,over,8,0.5169082125603864,-107,0.49239402434819424,TB,CLE,2023 REG,7,9,10,8,17,17,1,0,1,-1,1,1,1,1,1,1,1,1,0,0.49239402434819424,0.5076059756518058
91007,0.6774193548387096,0.3663003663003663,-210,173,0.6478027695509486,0.3521972304490514,home,TB,under,8,0.5305164319248826,-113,0.5076059756518058,TB,CLE,2023 REG,7,9,10,8,17,17,1,0,1,-1,1,1,1,1,1,1,1,1,0,0.49239402434819424,0.5076059756518058
91008,0.37735849056603776,0.6610169491525424,165,-195,0.36287719255902645,0.6371228074409736,away,LAD,over,9,0.49504950495049505,102,0.4739797934813417,CLE,LAD,2023 REG,12,8,6,3,11,18,1,0,5,-5,1,1,1,0,0,0,0,0,0,0.4739797934813417,0.5260202065186583
91008,0.37735849056603776,0.6610169491525424,165,-195,0.36287719255902645,0.6371228074409736,home,CLE,under,9,0.5475113122171946,-121,0.5260202065186583,CLE,LAD,2023 REG,12,8,6,3,11,18,1,0,5,-5,1,1,1,0,0,0,0,0,0,0.4739797934813417,0.5260202065186583
91009,0.504950495049505,0.5348837209302326,-102,-115,0.48483618797062755,0.5151638120293724,away,PHI,over,9,0.5169082125603864,-107,0.49353874091423283,SF,PHI,2023 REG,11,7,8,4,11,19,1,0,3,-3,1,1,1,1,0,0,0,0,0,0.49353874091423283,0.5064612590857671
91009,0.504950495049505,0.5348837209302326,-102,-115,0.48483618797062755,0.5151638120293724,home,SF,under,9,0.5283018867924528,-112,0.5064612590857671,SF,PHI,2023 REG,11,7,8,4,11,19,1,0,3,-3,1,1,1,1,0,0,0,0,0,0.49353874091423283,0.5064612590857671
91010,0.5412844036697247,0.5024875621890548,-118,-101,0.5175913212324037,0.4824086787675963,away,TEX,over,7.5,0.5215311004784688,-109,0.49670754937970685,SEA,TEX,2023 REG,8,3,3,2,5,11,1,0,1,-1,1,1,0,0,0,0,0,0,0,0.49670754937970685,0.5032924506202932
91010,0.5412844036697247,0.5024875621890548,-118,-101,0.5175913212324037,0.4824086787675963,home,SEA,under,7.5,0.5260663507109005,-111,0.5032924506202932,SEA,TEX,2023 REG,8,3,3,2,5,11,1,0,1,-1,1,1,0,0,0,0,0,0,0,0.49670754937970685,0.5032924506202932
91011,0.5215311004784688,0.5145631067961165,-109,-106,0.5027068488376564,0.4972931511623436,away,TOR,over,9,0.5348837209302326,-115,0.5097020142727117,HOU,TOR,2023 REG,8,2,8,4,6,16,0,1,-2,2,1,1,0,0,0,0,0,0,0,0.5097020142727117,0.49029798572728833
91011,0.5215311004784688,0.5145631067961165,-109,-106,0.5027068488376564,0.4972931511623436,home,HOU,under,9,0.5121951219512195,-105,0.49029798572728833,HOU,TOR,2023 REG,8,2,8,4,6,16,0,1,-2,2,1,1,0,0,0,0,0,0,0,0.5097020142727117,0.49029798572728833
91012,0.5967741935483871,0.4444444444444444,-148,125,0.5721759741010521,0.42782402589894786,away,MIL,over,8.5,0.5454545454545454,-120,0.5206611570247933,NYY,MIL,2023 REG,4,2,11,9,11,15,0,1,-7,7,1,1,0,0,0,0,0,0,0,0.5206611570247933,0.4793388429752067
91012,0.5967741935483871,0.4444444444444444,-148,125,0.5721759741010521,0.42782402589894786,home,NYY,under,8.5,0.5,100,0.4793388429752067,NYY,MIL,2023 REG,4,2,11,9,11,15,0,1,-7,7,1,1,0,0,0,0,0,0,0,0.5206611570247933,0.4793388429752067
91013,0.607843137254902,0.4329004329004329,-155,131,0.583077437748718,0.416922562251282,away,NYY,over,9.5,0.5238095238095238,-110,0.4988662131519274,TOR,NYY,2023 REG,8,4,8,7,11,16,0,1,-3,3,1,1,1,1,0,0,0,0,0,0.4988662131519274,0.5011337868480725
91013,0.607843137254902,0.4329004329004329,-155,131,0.583077437748718,0.416922562251282,home,TOR,under,9.5,0.5238095238095238,-110,0.5011337868480725,TOR,NYY,2023 REG,8,4,8,7,11,16,0,1,-3,3,1,1,1,1,0,0,0,0,0,0.4988662131519274,0.5011337868480725
91014,0.6254681647940076,0.4081632653061224,-167,145,0.6044327759298813,0.3955672240701187,away,PIT,over,7,0.5327102803738317,-114,0.5075272610403079,MIA,PIT,2023 REG,9,2,5,0,2,14,1,0,2,-2,0,0,0,0,0,0,0,0,0,0.5075272610403079,0.4924727389596921
91014,0.6254681647940076,0.4081632653061224,-167,145,0.6044327759298813,0.3955672240701187,home,MIA,under,7,0.5145631067961165,-106,0.4924727389596921,MIA,PIT,2023 REG,9,2,5,0,2,14,1,0,2,-2,0,0,0,0,0,0,0,0,0,0.5075272610403079,0.4924727389596921
91015,0.607843137254902,0.43103448275862066,-155,132,0.5842116427368785,0.41578835726312147,away,MIN,over,8,0.5348837209302326,-115,0.5097020142727117,TEX,MIN,2023 REG,3,1,7,5,6,10,0,1,-4,4,1,0,0,0,0,0,0,0,0,0.5097020142727117,0.49029798572728833
91015,0.607843137254902,0.43103448275862066,-155,132,0.5842116427368785,0.41578835726312147,home,TEX,under,8,0.5121951219512195,-105,0.49029798572728833,TEX,MIN,2023 REG,3,1,7,5,6,10,0,1,-4,4,1,0,0,0,0,0,0,0,0,0.5097020142727117,0.49029798572728833
91016,0.6363636363636364,0.4016064257028112,-175,149,0.6122008695940788,0.3877991304059212,away,MIA,over,7.5,0.49504950495049505,102,0.47297076509898783,TB,MIA,2023 REG,5,1,11,7,8,16,0,1,-6,6,1,0,0,0,0,0,0,0,0,0.47297076509898783,0.5270292349010122
91016,0.6363636363636364,0.4016064257028112,-175,149,0.6122008695940788,0.3877991304059212,home,TB,under,7.5,0.5495495495495495,-122,0.5270292349010122,TB,MIA,2023 REG,5,1,11,7,8,16,0,1,-6,6,1,0,0,0,0,0,0,0,0,0.47297076509898783,0.5270292349010122
91017,0.5,0.5391705069124424,100,-117,0.4804147465437788,0.5195852534562212,away,TOR,over,8,0.5238095238095238,-110,0.4988662131519274,HOU,TOR,2023 REG,10,9,5,2,11,15,1,0,7,-7,1,1,0,0,0,0,0,0,0,0.4988662131519274,0.5011337868480725
91017,0.5,0.5391705069124424,100,-117,0.4804147465437788,0.5195852534562212,home,HOU,under,8,0.5238095238095238,-110,0.5011337868480725,HOU,TOR,2023 REG,10,9,5,2,11,15,1,0,7,-7,1,1,0,0,0,0,0,0,0,0.4988662131519274,0.5011337868480725
91018,0.4291845493562232,0.6108949416342413,133,-157,0.4119830510770539,0.5880169489229461,away,ATL,over,11.5,0.5121951219512195,-105,0.48808156828023186,CIN,ATL,2023 REG,9,11,16,10,21,25,1,0,1,-1,1,1,1,1,1,1,1,1,1,0.48808156828023186,0.5119184317197681
91018,0.4291845493562232,0.6108949416342413,133,-157,0.4119830510770539,0.5880169489229461,home,CIN,under,11.5,0.5348837209302326,-115,0.5119184317197681,CIN,ATL,2023 REG,9,11,16,10,21,25,1,0,1,-1,1,1,1,1,1,1,1,1,1,0.48808156828023186,0.5119184317197681
91019,0.6000000000000001,0.43859649122807015,-150,128,0.5768421052631579,0.42315789473684207,away,SD,over,7.5,0.5192307692307692,-108,0.49455035168025013,NYY,SD,2023 REG,12,10,5,7,17,17,1,0,3,-3,1,1,1,1,1,1,1,0,0,0.49455035168025013,0.5054496483197499
91019,0.6000000000000001,0.43859649122807015,-150,128,0.5768421052631579,0.42315789473684207,home,NYY,under,7.5,0.5283018867924528,-112,0.5054496483197499,NYY,SD,2023 REG,12,10,5,7,17,17,1,0,3,-3,1,1,1,1,1,1,1,0,0,0.49455035168025013,0.5054496483197499
91020,0.7858672376873661,0.25641025641025644,-367,290,0.7526427401845236,0.2473572598154764,away,KC,over,7.5,0.5454545454545454,-120,0.5206611570247933,TB,KC,2023 REG,10,5,9,6,11,19,0,1,-1,1,1,1,1,1,1,0,0,0,0,0.5206611570247933,0.4793388429752067
91020,0.7858672376873661,0.25641025641025644,-367,290,0.7526427401845236,0.2473572598154764,home,TB,under,7.5,0.5,100,0.4793388429752067,TB,KC,2023 REG,10,5,9,6,11,19,0,1,-1,1,1,1,1,1,1,0,0,0,0,0.5206611570247933,0.4793388429752067
91021,0.6655518394648829,0.37593984962406013,-199,166,0.637936969469232,0.36206303053076805,away,LAA,over,8.5,0.5412844036697247,-118,0.5162581740877563,TEX,LAA,2023 REG,11,7,8,3,10,19,1,0,4,-4,1,1,1,0,0,0,0,0,0,0.5162581740877563,0.4837418259122437
91021,0.6655518394648829,0.37593984962406013,-199,166,0.637936969469232,0.36206303053076805,home,TEX,under,8.5,0.504950495049505,-102,0.4837418259122437,TEX,LAA,2023 REG,11,7,8,3,10,19,1,0,4,-4,1,1,1,0,0,0,0,0,0,0.5162581740877563,0.4837418259122437
91022,0.5454545454545454,0.49751243781094534,-120,101,0.5220180091279142,0.4779819908720858,away,LAD,over,9,0.5,100,0.4772727272727273,NYM,LAD,2023 REG,3,1,11,5,6,14,0,1,-4,4,1,0,0,0,0,0,0,0,0,0.4772727272727273,0.5227272727272727
91022,0.5454545454545454,0.49751243781094534,-120,101,0.5220180091279142,0.4779819908720858,home,NYM,under,9,0.5454545454545454,-120,0.5227272727272727,NYM,LAD,2023 REG,3,1,11,5,6,14,0,1,-4,4,1,0,0,0,0,0,0,0,0,0.4772727272727273,0.5227272727272727
91023,0.7409326424870467,0.29850746268656714,-286,235,0.7117101811407941,0.2882898188592059,away,WSH,over,9,0.5327102803738317,-114,0.5075272610403079,PHI,WSH,2023 REG,10,8,11,4,12,21,1,0,4,-4,1,1,1,1,0,0,0,0,0,0.5075272610403079,0.4924727389596921
91023,0.7409326424870467,0.29850746268656714,-286,235,0.7117101811407941,0.2882898188592059,home,PHI,under,9,0.5145631067961165,-106,0.4924727389596921,PHI,WSH,2023 REG,10,8,11,4,12,21,1,0,4,-4,1,1,1,1,0,0,0,0,0,0.5075272610403079,0.4924727389596921
91024,0.5884773662551441,0.4504504504504505,-143,122,0.5655692272061728,0.43443077279382725,away,OAK,over,10,0.5121951219512195,-105,0.48808156828023186,CWS,OAK,2023 REG,11,5,9,8,13,20,0,1,-3,3,1,1,1,1,1,0,0,0,0,0.48808156828023186,0.5119184317197681
91024,0.5884773662551441,0.4504504504504505,-143,122,0.5655692272061728,0.43443077279382725,home,CWS,under,10,0.5348837209302326,-115,0.5119184317197681,CWS,OAK,2023 REG,11,5,9,8,13,20,0,1,-3,3,1,1,1,1,1,0,0,0,0,0.48808156828023186,0.5119184317197681
91025,0.696969696969697,0.3448275862068966,-230,190,0.6678382571799499,0.33216174282005007,away,COL,over,8.5,0.5305164319248826,-113,0.5053568787472517,CHC,COL,2023 REG,9,6,8,3,9,17,1,0,3,-3,1,1,1,0,0,0,0,0,0,0.5053568787472517,0.49464312125274834
91025,0.696969696969697,0.3448275862068966,-230,190,0.6678382571799499,0.33216174282005007,home,CHC,under,8.5,0.5169082125603864,-107,0.49464312125274834,CHC,COL,2023 REG,9,6,8,3,9,17,1,0,3,-3,1,1,1,0,0,0,0,0,0,0.5053568787472517,0.49464312125274834
91026,0.3278688524590164,0.7118155619596541,205,-247,0.3148575690430589,0.6851424309569412,away,ATL,over,9,0.5238095238095238,-110,0.4988662131519274,OAK,ATL,2023 REG,8,7,6,2,9,14,1,0,5,-5,1,1,0,0,0,0,0,0,0,0.4988662131519274,0.5011337868480725
91026,0.3278688524590164,0.7118155619596541,205,-247,0.3148575690430589,0.6851424309569412,home,OAK,under,9,0.5238095238095238,-110,0.5011337868480725,OAK,ATL,2023 REG,8,7,6,2,9,14,1,0,5,-5,1,1,0,0,0,0,0,0,0,0.4988662131519274,0.5011337868480725
91027,0.6124031007751938,0.425531914893617,-158,135,0.5891715795516586,0.41082842044834145,away,WSH,over,9,0.5412844036697247,-118,0.5149381613977361,CHC,WSH,2023 REG,11,8,10,3,11,21,1,0,5,-5,1,1,1,0,0,0,0,0,0,0.5149381613977361,0.48506183860226393
91027,0.6124031007751938,0.425531914893617,-158,135,0.5891715795516586,0.41082842044834145,home,CHC,under,9,0.5073891625615764,-103,0.48506183860226393,CHC,WSH,2023 REG,11,8,10,3,11,21,1,0,5,-5,1,1,1,0,0,0,0,0,0,0.5149381613977361,0.48506183860226393
91028,0.607843137254902,0.425531914893617,-155,135,0.5875563408509002,0.41244365914909975,away,MIA,over,7,0.5348837209302326,-115,0.5097020142727117,SEA,MIA,2023 REG,8,9,7,3,12,15,1,0,6,-6,1,1,1,0,0,0,0,0,0,0.5097020142727117,0.49029798572728833
91028,0.607843137254902,0.425531914893617,-155,135,0.5875563408509002,0.41244365914909975,home,SEA,under,7,0.5121951219512195,-105,0.49029798572728833,SEA,MIA,2023 REG,8,9,7,3,12,15,1,0,6,-6,1,1,1,0,0,0,0,0,0,0.5097020142727117,0.49029798572728833
91029,0.6000000000000001,0.4329004329004329,-150,131,0.5802597402597403,0.41974025974025975,away,BOS,over,8,0.5412844036697247,-118,0.5149381613977361,SD,BOS,2023 REG,5,1,8,6,7,13,0,1,-5,5,1,0,0,0,0,0,0,0,0,0.5149381613977361,0.48506183860226393
91029,0.6000000000000001,0.4329004329004329,-150,131,0.5802597402597403,0.41974025974025975,home,SD,under,8,0.5073891625615764,-103,0.48506183860226393,SD,BOS,2023 REG,5,1,8,6,7,13,0,1,-5,5,1,0,0,0,0,0,0,0,0,0.5149381613977361,0.48506183860226393
91030,0.7333333333333333,0.30303030303030304,-275,230,0.7066666666666666,0.29333333333333345,away,COL,over,8,0.5348837209302326,-115,0.5109810284308424,NYM,COL,2023 REG,5,1,5,0,1,10,1,0,1,-1,0,0,0,0,0,0,0,0,0,0.5109810284308424,0.48901897156915763
91030,0.7333333333333333,0.30303030303030304,-275,230,0.7066666666666666,0.29333333333333345,home,NYM,under,8,0.5098039215686274,-104,0.48901897156915763,NYM,COL,2023 REG,5,1,5,0,1,10,1,0,1,-1,0,0,0,0,0,0,0,0,0,0.5109810284308424,0.48901897156915763
91031,0.3508771929824561,0.6875,185,-220,0.3374115112342259,0.662588488765774,away,ARI,over,9,0.5121951219512195,-105,0.48808156828023186,OAK,ARI,2023 REG,4,2,10,5,7,14,0,1,-3,3,1,1,0,0,0,0,0,0,0,0.48808156828023186,0.5119184317197681
91031,0.3508771929824561,0.6875,185,-220,0.3374115112342259,0.662588488765774,home,OAK,under,9,0.5348837209302326,-115,0.5119184317197681,OAK,ARI,2023 REG,4,2,10,5,7,14,0,1,-3,3,1,1,0,0,0,0,0,0,0,0.48808156828023186,0.5119184317197681
91032,0.5867768595041323,0.45248868778280543,-142,121,0.563736744980392,0.43626325501960805,away,HOU,over,8,0.5145631067961165,-106,0.4913668392989033,TOR,HOU,2023 REG,5,5,4,1,6,9,1,0,4,-4,1,0,0,0,0,0,0,0,0,0.4913668392989033,0.5086331607010968
91032,0.5867768595041323,0.45248868778280543,-142,121,0.563736744980392,0.43626325501960805,home,TOR,under,8,0.5305164319248826,-113,0.5086331607010968,TOR,HOU,2023 REG,5,5,4,1,6,9,1,0,4,-4,1,0,0,0,0,0,0,0,0,0.4913668392989033,0.5086331607010968
91033,0.49504950495049505,0.5454545454545454,102,-120,0.47499799484898986,0.5250020051510101,away,CLE,over,7.5,0.5348837209302326,-115,0.5097020142727117,NYY,CLE,2023 REG,8,4,9,3,7,17,1,0,1,-1,1,1,1,0,0,0,0,0,0,0.5097020142727117,0.49029798572728833
91033,0.49504950495049505,0.5454545454545454,102,-120,0.47499799484898986,0.5250020051510101,home,NYY,under,7.5,0.5121951219512195,-105,0.49029798572728833,NYY,CLE,2023 REG,8,4,9,3,7,17,1,0,1,-1,1,1,1,0,0,0,0,0,0,0.5097020142727117,0.49029798572728833
91035,0.6402877697841727,0.4,-178,150,0.6144920035194866,0.38550799648051337,away,KC,over,8.5,0.5327102803738317,-114,0.5075272610403079,TEX,KC,2023 REG,11,11,4,2,13,15,1,0,9,-9,1,1,0,0,0,0,0,0,0,0.5075272610403079,0.4924727389596921
91035,0.6402877697841727,0.4,-178,150,0.6144920035194866,0.38550799648051337,home,TEX,under,8.5,0.5145631067961165,-106,0.4924727389596921,TEX,KC,2023 REG,11,11,4,2,13,15,1,0,9,-9,1,1,0,0,0,0,0,0,0,0.5075272610403079,0.4924727389596921
91036,0.5348837209302326,0.5121951219512195,-115,-105,0.5097020142727117,0.49029798572728833,away,TOR,over,9,0.5348837209302326,-115,0.5097020142727117,TEX,TOR,2023 REG,8,4,9,2,6,17,1,0,2,-2,1,1,0,0,0,0,0,0,0,0.5097020142727117,0.49029798572728833
91036,0.5348837209302326,0.5121951219512195,-115,-105,0.5097020142727117,0.49029798572728833,home,TEX,under,9,0.5121951219512195,-105,0.49029798572728833,TEX,TOR,2023 REG,8,4,9,2,6,17,1,0,2,-2,1,1,0,0,0,0,0,0,0,0.5097020142727117,0.49029798572728833
91037,0.6644295302013422,0.37453183520599254,-198,167,0.638542448487744,0.361457551512256,away,COL,over,8.5,0.5169082125603864,-107,0.49353874091423283,TEX,COL,2023 REG,15,11,13,5,16,28,1,0,6,-6,1,1,1,1,1,0,0,0,0,0.49353874091423283,0.5064612590857671
91037,0.6644295302013422,0.37453183520599254,-198,167,0.638542448487744,0.361457551512256,home,TEX,under,8.5,0.5283018867924528,-112,0.5064612590857671,TEX,COL,2023 REG,15,11,13,5,16,28,1,0,6,-6,1,1,1,1,1,0,0,0,0,0.49353874091423283,0.5064612590857671
91038,0.3508771929824561,0.6875,185,-220,0.3374115112342259,0.662588488765774,away,TOR,over,8.5,0.5,100,0.4783105022831051,KC,TOR,2023 REG,8,3,11,6,9,19,0,1,-3,3,1,1,1,0,0,0,0,0,0,0.4783105022831051,0.5216894977168949
91038,0.3508771929824561,0.6875,185,-220,0.3374115112342259,0.662588488765774,home,KC,under,8.5,0.5433789954337899,-119,0.5216894977168949,KC,TOR,2023 REG,8,3,11,6,9,19,0,1,-3,3,1,1,1,0,0,0,0,0,0,0.4783105022831051,0.5216894977168949
91039,0.647887323943662,0.3891050583657587,-184,157,0.6239204283629105,0.3760795716370895,away,TOR,over,8,0.5348837209302326,-115,0.5097020142727117,TB,TOR,2023 REG,12,7,8,3,10,20,1,0,4,-4,1,1,1,0,0,0,0,0,0,0.5097020142727117,0.49029798572728833
91039,0.647887323943662,0.3891050583657587,-184,157,0.6239204283629105,0.3760795716370895,home,TB,under,8,0.5121951219512195,-105,0.49029798572728833,TB,TOR,2023 REG,12,7,8,3,10,20,1,0,4,-4,1,1,1,0,0,0,0,0,0,0.5097020142727117,0.49029798572728833
91040,0.48309178743961345,0.5555555555555556,107,-125,0.4644215734322854,0.5355784265677146,away,BOS,over,9,0.5283018867924528,-112,0.5031902949311281,NYY,BOS,2023 REG,10,3,12,8,11,22,0,1,-5,5,1,1,1,0,0,0,0,0,0,0.5031902949311281,0.4968097050688719
91040,0.48309178743961345,0.5555555555555556,107,-125,0.4644215734322854,0.5355784265677146,home,NYY,under,9,0.5192307692307692,-108,0.4968097050688719,NYY,BOS,2023 REG,10,3,12,8,11,22,0,1,-5,5,1,1,1,0,0,0,0,0,0,0.5031902949311281,0.4968097050688719
91041,0.3401360544217687,0.696969696969697,194,-230,0.3275150505471205,0.6724849494528795,away,CLE,over,9,0.5192307692307692,-108,0.49455035168025013,WSH,CLE,2023 REG,13,7,9,6,13,22,1,0,1,-1,1,1,1,1,1,1,0,0,0,0.49455035168025013,0.5054496483197499
91041,0.3401360544217687,0.696969696969697,194,-230,0.3275150505471205,0.6724849494528795,home,WSH,under,9,0.5283018867924528,-112,0.5054496483197499,WSH,CLE,2023 REG,13,7,9,6,13,22,1,0,1,-1,1,1,1,1,1,1,0,0,0,0.49455035168025013,0.5054496483197499
91042,0.7076023391812866,0.33112582781456956,-242,202,0.6801981976228153,0.3198018023771847,away,OAK,over,8.5,0.5145631067961165,-106,0.49023796582517226,SEA,OAK,2023 REG,4,1,9,3,4,13,0,1,-2,2,1,0,0,0,0,0,0,0,0,0.49023796582517226,0.5097620341748277
91042,0.7076023391812866,0.33112582781456956,-242,202,0.6801981976228153,0.3198018023771847,home,SEA,under,8.5,0.5327102803738317,-114,0.5097620341748277,SEA,OAK,2023 REG,4,1,9,3,4,13,0,1,-2,2,1,0,0,0,0,0,0,0,0,0.49023796582517226,0.5097620341748277
91043,0.5535714285714286,0.48780487804878053,-124,105,0.53066668740667,0.46933331259333,away,ARI,over,8,0.5454545454545454,-120,0.5206611570247933,MIN,ARI,2023 REG,7,3,9,2,5,16,1,0,1,-1,1,1,0,0,0,0,0,0,0,0.5206611570247933,0.4793388429752067
91043,0.5535714285714286,0.48780487804878053,-124,105,0.53066668740667,0.46933331259333,home,MIN,under,8,0.5,100,0.4793388429752067,MIN,ARI,2023 REG,7,3,9,2,5,16,1,0,1,-1,1,1,0,0,0,0,0,0,0,0.5206611570247933,0.4793388429752067
91044,0.46511627906976744,0.574468085106383,115,-135,0.44670494689481377,0.5532950531051862,away,TOR,over,8,0.5238095238095238,-110,0.4988662131519274,KC,TOR,2023 REG,10,9,10,5,14,20,1,0,4,-4,1,1,1,1,1,0,0,0,0,0.4988662131519274,0.5011337868480725
91044,0.46511627906976744,0.574468085106383,115,-135,0.44670494689481377,0.5532950531051862,home,KC,under,8,0.5238095238095238,-110,0.5011337868480725,KC,TOR,2023 REG,10,9,10,5,14,20,1,0,4,-4,1,1,1,1,1,0,0,0,0,0.4988662131519274,0.5011337868480725
91045,0.48780487804878053,0.5555555555555556,105,-125,0.4666534470222751,0.5333465529777248,away,ATL,over,8,0.5348837209302326,-115,0.5109810284308424,STL,ATL,2023 REG,12,4,10,8,12,22,0,1,-4,4,1,1,1,1,0,0,0,0,0,0.5109810284308424,0.48901897156915763
91045,0.48780487804878053,0.5555555555555556,105,-125,0.4666534470222751,0.5333465529777248,home,STL,under,8,0.5098039215686274,-104,0.48901897156915763,STL,ATL,2023 REG,12,4,10,8,12,22,0,1,-4,4,1,1,1,1,0,0,0,0,0,0.5109810284308424,0.48901897156915763
91046,0.4629629629629629,0.5780590717299579,116,-137,0.4439712802347588,0.5560287197652412,away,BAL,over,8,0.5454545454545454,-120,0.5206611570247933,CLE,BAL,2023 REG,1,1,9,2,3,10,0,1,-1,1,1,0,0,0,0,0,0,0,0,0.5206611570247933,0.4793388429752067
91046,0.4629629629629629,0.5780590717299579,116,-137,0.4439712802347588,0.5560287197652412,home,CLE,under,8,0.5,100,0.4793388429752067,CLE,BAL,2023 REG,1,1,9,2,3,10,0,1,-1,1,1,0,0,0,0,0,0,0,0,0.5206611570247933,0.4793388429752067
91047,0.6363636363636364,0.4,-175,150,0.6132231404958678,0.3867768595041322,away,CIN,over,8,0.5327102803738317,-114,0.5075272610403079,STL,CIN,2023 REG,11,7,7,4,11,18,1,0,3,-3,1,1,1,1,0,0,0,0,0,0.5075272610403079,0.4924727389596921
91047,0.6363636363636364,0.4,-175,150,0.6132231404958678,0.3867768595041322,home,STL,under,8,0.5145631067961165,-106,0.4924727389596921,STL,CIN,2023 REG,11,7,7,4,11,18,1,0,3,-3,1,1,1,1,0,0,0,0,0,0.5075272610403079,0.4924727389596921
91048,0.5391705069124424,0.5024875621890548,-117,-101,0.5167097046779946,0.4832902953220054,away,OAK,over,11.5,0.5391705069124424,-117,0.5127649394825569,COL,OAK,2023 REG,6,2,5,0,2,11,1,0,2,-2,0,0,0,0,0,0,0,0,0,0.5127649394825569,0.48723506051744314
91048,0.5391705069124424,0.5024875621890548,-117,-101,0.5167097046779946,0.4832902953220054,home,COL,under,11.5,0.5098039215686274,-104,0.48723506051744314,COL,OAK,2023 REG,6,2,5,0,2,11,1,0,2,-2,0,0,0,0,0,0,0,0,0,0.5127649394825569,0.48723506051744314
91049,0.6721311475409836,0.37037037037037035,-205,170,0.6435645535349916,0.35643544646500835,away,PIT,over,9.5,0.5215311004784688,-109,0.4978845547971712,ATL,PIT,2023 REG,12,8,6,2,10,18,1,0,6,-6,1,1,0,0,0,0,0,0,0,0.4978845547971712,0.5021154452028288
91049,0.6721311475409836,0.37037037037037035,-205,170,0.6435645535349916,0.35643544646500835,home,ATL,under,9.5,0.5238095238095238,-110,0.5021154452028288,ATL,PIT,2023 REG,12,8,6,2,10,18,1,0,6,-6,1,1,0,0,0,0,0,0,0,0.4978845547971712,0.5021154452028288
91050,0.6226415094339623,0.4166666666666667,-165,140,0.5981666073335706,0.40183339266642937,away,CHC,over,8.5,0.5283018867924528,-112,0.5044173060022736,SF,CHC,2023 REG,1,0,5,4,4,6,0,1,-4,4,0,0,0,0,0,0,0,0,0,0.5044173060022736,0.49558269399772636
91050,0.6226415094339623,0.4166666666666667,-165,140,0.5981666073335706,0.40183339266642937,home,SF,under,8.5,0.5169082125603864,-107,0.49558269399772636,SF,CHC,2023 REG,1,0,5,4,4,6,0,1,-4,4,0,0,0,0,0,0,0,0,0,0.5044173060022736,0.49558269399772636
91051,0.7530864197530864,0.2857142857142857,-305,250,0.7238661353887691,0.2761338646112309,away,COL,over,8.5,0.5121951219512195,-105,0.48919479393107135,LAD,COL,2023 REG,11,6,6,1,7,17,1,0,5,-5,1,0,0,0,0,0,0,0,0,0.48919479393107135,0.5108052060689287
91051,0.7530864197530864,0.2857142857142857,-305,250,0.7238661353887691,0.2761338646112309,home,LAD,under,8.5,0.5327102803738317,-114,0.5108052060689287,LAD,COL,2023 REG,11,6,6,1,7,17,1,0,5,-5,1,0,0,0,0,0,0,0,0,0.48919479393107135,0.5108052060689287
91052,0.5454545454545454,0.49751243781094534,-120,101,0.5220180091279142,0.4779819908720858,away,TEX,over,7.5,0.5391705069124424,-117,0.5127649394825569,SEA,TEX,2023 REG,4,1,4,0,1,8,1,0,1,-1,0,0,0,0,0,0,0,0,0,0.5127649394825569,0.48723506051744314
91052,0.5454545454545454,0.49751243781094534,-120,101,0.5220180091279142,0.4779819908720858,home,SEA,under,7.5,0.5098039215686274,-104,0.48723506051744314,SEA,TEX,2023 REG,4,1,4,0,1,8,1,0,1,-1,0,0,0,0,0,0,0,0,0,0.5127649394825569,0.48723506051744314
91053,0.7382198952879581,0.30303030303030304,-282,230,0.7077681782048438,0.29223182179515617,away,COL,over,8.5,0.5283018867924528,-112,0.5044173060022736,TB,COL,2023 REG,8,5,8,3,8,16,1,0,2,-2,1,1,1,0,0,0,0,0,0,0.5044173060022736,0.49558269399772636
91053,0.7382198952879581,0.30303030303030304,-282,230,0.7077681782048438,0.29223182179515617,home,TB,under,8.5,0.5169082125603864,-107,0.49558269399772636,TB,COL,2023 REG,8,5,8,3,8,16,1,0,2,-2,1,1,1,0,0,0,0,0,0,0.5044173060022736,0.49558269399772636
91054,0.696969696969697,0.3389830508474576,-230,195,0.6719117212183469,0.32808827878165314,away,COL,over,9,0.5238095238095238,-110,0.5012646084074657,BOS,COL,2023 REG,9,3,6,4,7,15,0,1,-1,1,1,1,1,0,0,0,0,0,0,0.5012646084074657,0.4987353915925343
91054,0.696969696969697,0.3389830508474576,-230,195,0.6719117212183469,0.32808827878165314,home,BOS,under,9,0.5192307692307692,-108,0.4987353915925343,BOS,COL,2023 REG,9,3,6,4,7,15,0,1,-1,1,1,1,1,0,0,0,0,0,0,0.5012646084074657,0.4987353915925343
91055,0.43103448275862066,0.6047430830039526,132,-153,0.4156131182057874,0.5843868817942126,away,SD,over,8,0.5433789954337899,-119,0.5198077604720502,WSH,SD,2023 REG,9,4,12,7,11,21,0,1,-3,3,1,1,1,1,0,0,0,0,0,0.5198077604720502,0.48019223952794976
91055,0.43103448275862066,0.6047430830039526,132,-153,0.4156131182057874,0.5843868817942126,home,WSH,under,8,0.5,100,0.48019223952794976,WSH,SD,2023 REG,9,4,12,7,11,21,0,1,-3,3,1,1,1,1,0,0,0,0,0,0.5198077604720502,0.48019223952794976
91056,0.6666666666666666,0.3717472118959108,-200,169,0.641057414291615,0.358942585708385,away,KC,over,10,0.5238095238095238,-110,0.5000596729920038,CLE,KC,2023 REG,9,8,12,3,11,21,1,0,5,-5,1,1,1,0,0,0,0,0,0,0.5000596729920038,0.4999403270079962
91056,0.6666666666666666,0.3717472118959108,-200,169,0.641057414291615,0.358942585708385,home,CLE,under,10,0.5215311004784688,-109,0.4999403270079962,CLE,KC,2023 REG,9,8,12,3,11,21,1,0,5,-5,1,1,1,0,0,0,0,0,0,0.5000596729920038,0.4999403270079962
91057,0.75,0.2898550724637681,-300,245,0.720108695652174,0.27989130434782605,away,COL,over,8,0.5348837209302326,-115,0.5097020142727117,SEA,COL,2023 REG,4,1,3,0,1,7,1,0,1,-1,0,0,0,0,0,0,0,0,0,0.5097020142727117,0.49029798572728833
91057,0.75,0.2898550724637681,-300,245,0.720108695652174,0.27989130434782605,home,SEA,under,8,0.5121951219512195,-105,0.49029798572728833,SEA,COL,2023 REG,4,1,3,0,1,7,1,0,1,-1,0,0,0,0,0,0,0,0,0,0.5097020142727117,0.49029798572728833
91058,0.4716981132075471,0.5689655172413793,112,-132,0.45251715544861953,0.5474828445513804,away,PHI,over,9,0.5,100,0.4772727272727273,CLE,PHI,2023 REG,9,5,8,8,13,17,0,1,-3,3,1,1,1,1,1,0,0,0,0,0.4772727272727273,0.5227272727272727
91058,0.4716981132075471,0.5689655172413793,112,-132,0.45251715544861953,0.5474828445513804,home,CLE,under,9,0.5454545454545454,-120,0.5227272727272727,CLE,PHI,2023 REG,9,5,8,8,13,17,0,1,-3,3,1,1,1,1,1,0,0,0,0,0.4772727272727273,0.5227272727272727
91059,0.49751243781094534,0.5475113122171946,101,-121,0.47511256217505476,0.5248874378249453,away,DET,over,9,0.5238095238095238,-110,0.4988662131519274,LAA,DET,2023 REG,6,3,7,5,8,13,0,1,-2,2,1,1,1,0,0,0,0,0,0,0.4988662131519274,0.5011337868480725
91059,0.49751243781094534,0.5475113122171946,101,-121,0.47511256217505476,0.5248874378249453,home,LAA,under,9,0.5238095238095238,-110,0.5011337868480725,LAA,DET,2023 REG,6,3,7,5,8,13,0,1,-2,2,1,1,1,0,0,0,0,0,0,0.4988662131519274,0.5011337868480725
91060,0.4347826086956522,0.6000000000000001,130,-150,0.4196597353497164,0.5803402646502835,away,BAL,over,9,0.5121951219512195,-105,0.48808156828023186,KC,BAL,2023 REG,13,6,6,0,6,19,1,0,6,-6,0,0,0,0,0,0,0,0,0,0.48808156828023186,0.5119184317197681
91060,0.4347826086956522,0.6000000000000001,130,-150,0.4196597353497164,0.5803402646502835,home,KC,under,9,0.5348837209302326,-115,0.5119184317197681,KC,BAL,2023 REG,13,6,6,0,6,19,1,0,6,-6,0,0,0,0,0,0,0,0,0,0.48808156828023186,0.5119184317197681
91061,0.5073891625615764,0.5348837209302326,-103,-115,0.4859403596076043,0.5140596403923957,away,SF,over,8.5,0.5121951219512195,-105,0.48808156828023186,LAA,SF,2023 REG,9,3,11,8,11,20,0,1,-5,5,1,1,1,0,0,0,0,0,0,0.48808156828023186,0.5119184317197681
91061,0.5073891625615764,0.5348837209302326,-103,-115,0.4859403596076043,0.5140596403923957,home,LAA,under,8.5,0.5348837209302326,-115,0.5119184317197681,LAA,SF,2023 REG,9,3,11,8,11,20,0,1,-5,5,1,1,1,0,0,0,0,0,0,0.48808156828023186,0.5119184317197681
91062,0.46511627906976744,0.574468085106383,115,-135,0.44670494689481377,0.5532950531051862,away,CLE,over,9,0.5073891625615764,-103,0.4859403596076043,DET,CLE,2023 REG,14,4,8,3,7,22,1,0,1,-1,1,1,1,0,0,0,0,0,0,0.4859403596076043,0.5140596403923957
91062,0.46511627906976744,0.574468085106383,115,-135,0.44670494689481377,0.5532950531051862,home,DET,under,9,0.5348837209302326,-115,0.5140596403923957,DET,CLE,2023 REG,14,4,8,3,7,22,1,0,1,-1,1,1,1,0,0,0,0,0,0,0.4859403596076043,0.5140596403923957
91063,0.6000000000000001,0.4366812227074236,-150,129,0.5779912663755458,0.42200873362445424,away,COL,over,9.5,0.5121951219512195,-105,0.48808156828023186,WSH,COL,2023 REG,5,5,6,4,9,11,1,0,1,-1,1,1,1,1,0,0,0,0,0,0.48808156828023186,0.5119184317197681
91063,0.6000000000000001,0.4366812227074236,-150,129,0.5779912663755458,0.42200873362445424,home,WSH,under,9.5,0.5348837209302326,-115,0.5119184317197681,WSH,COL,2023 REG,5,5,6,4,9,11,1,0,1,-1,1,1,1,1,0,0,0,0,0,0.48808156828023186,0.5119184317197681
91064,0.5024875621890548,0.5348837209302326,-101,-115,0.48370895723856705,0.5162910427614329,away,TOR,over,8.5,0.5454545454545454,-120,0.5206611570247933,BAL,TOR,2023 REG,6,1,9,3,4,15,0,1,-2,2,1,0,0,0,0,0,0,0,0,0.5206611570247933,0.4793388429752067
91064,0.5024875621890548,0.5348837209302326,-101,-115,0.48370895723856705,0.5162910427614329,home,BAL,under,8.5,0.5,100,0.4793388429752067,BAL,TOR,2023 REG,6,1,9,3,4,15,0,1,-2,2,1,0,0,0,0,0,0,0,0,0.5206611570247933,0.4793388429752067
91065,0.5283018867924528,0.5098039215686274,-112,-104,0.5081705163375425,0.4918294836624575,away,NYM,over,8.5,0.5454545454545454,-120,0.5206611570247933,SF,NYM,2023 REG,5,0,13,7,7,18,0,1,-7,7,0,0,0,0,0,0,0,0,0,0.5206611570247933,0.4793388429752067
91065,0.5283018867924528,0.5098039215686274,-112,-104,0.5081705163375425,0.4918294836624575,home,SF,under,8.5,0.5,100,0.4793388429752067,SF,NYM,2023 REG,5,0,13,7,7,18,0,1,-7,7,0,0,0,0,0,0,0,0,0,0.5206611570247933,0.4793388429752067
91066,0.4166666666666667,0.6226415094339623,140,-165,0.4002882599580712,0.5997117400419287,away,SD,over,8,0.5348837209302326,-115,0.5097020142727117,PIT,SD,2023 REG,9,7,7,1,8,16,1,0,6,-6,1,0,0,0,0,0,0,0,0,0.5097020142727117,0.49029798572728833
91066,0.4166666666666667,0.6226415094339623,140,-165,0.4002882599580712,0.5997117400419287,home,PIT,under,8,0.5121951219512195,-105,0.49029798572728833,PIT,SD,2023 REG,9,7,7,1,8,16,1,0,6,-6,1,0,0,0,0,0,0,0,0,0.5097020142727117,0.49029798572728833
91067,0.5121951219512195,0.5283018867924528,-105,-112,0.49145275161909474,0.5085472483809053,away,TOR,over,7.5,0.5238095238095238,-110,0.4988662131519274,STL,TOR,2023 REG,15,9,19,10,19,34,0,1,-1,1,1,1,1,1,1,1,1,1,1,0.4988662131519274,0.5011337868480725
91067,0.5121951219512195,0.5283018867924528,-105,-112,0.49145275161909474,0.5085472483809053,home,STL,under,7.5,0.5238095238095238,-110,0.5011337868480725,STL,TOR,2023 REG,15,9,19,10,19,34,0,1,-1,1,1,1,1,1,1,1,1,1,1,0.4988662131519274,0.5011337868480725
91068,0.5454545454545454,0.49504950495049505,-120,102,0.5233614270517961,0.4766385729482039,away,SEA,over,10.5,0.5305164319248826,-113,0.5066009958897986,CHC,SEA,2023 REG,18,14,11,9,23,29,1,0,5,-5,1,1,1,1,1,1,1,1,1,0.5066009958897986,0.49339900411020143
91068,0.5454545454545454,0.49504950495049505,-120,102,0.5233614270517961,0.4766385729482039,home,CHC,under,10.5,0.5145631067961165,-106,0.49339900411020143,CHC,SEA,2023 REG,18,14,11,9,23,29,1,0,5,-5,1,1,1,1,1,1,1,1,1,0.5066009958897986,0.49339900411020143
91069,0.5,0.5454545454545454,100,-120,0.4772727272727273,0.5227272727272727,away,TB,over,8.5,0.5412844036697247,-118,0.5149381613977361,CLE,TB,2023 REG,13,7,10,6,13,23,1,0,1,-1,1,1,1,1,1,1,0,0,0,0.5149381613977361,0.48506183860226393
91069,0.5,0.5454545454545454,100,-120,0.4772727272727273,0.5227272727272727,home,CLE,under,8.5,0.5073891625615764,-103,0.48506183860226393,CLE,TB,2023 REG,13,7,10,6,13,23,1,0,1,-1,1,1,1,1,1,1,0,0,0,0.5149381613977361,0.48506183860226393
91070,0.6774193548387096,0.37037037037037035,-210,170,0.6450456700196554,0.3549543299803446,away,CIN,over,8.5,0.5348837209302326,-115,0.5097020142727117,PHI,CIN,2023 REG,7,4,6,6,10,13,0,1,-2,2,1,1,1,1,0,0,0,0,0,0.5097020142727117,0.49029798572728833
91070,0.6774193548387096,0.37037037037037035,-210,170,0.6450456700196554,0.3549543299803446,home,PHI,under,8.5,0.5121951219512195,-105,0.49029798572728833,PHI,CIN,2023 REG,7,4,6,6,10,13,0,1,-2,2,1,1,1,1,0,0,0,0,0,0.5097020142727117,0.49029798572728833
91071,0.47619047619047616,0.5652173913043479,110,-130,0.4564724440500838,0.5435275559499162,away,CWS,over,8.5,0.5238095238095238,-110,0.5012646084074657,PIT,CWS,2023 REG,19,13,11,9,22,30,1,0,4,-4,1,1,1,1,1,1,1,1,1,0.5012646084074657,0.4987353915925343
91071,0.47619047619047616,0.5652173913043479,110,-130,0.4564724440500838,0.5435275559499162,home,PIT,under,8.5,0.5192307692307692,-108,0.4987353915925343,PIT,CWS,2023 REG,19,13,11,9,22,30,1,0,4,-4,1,1,1,1,1,1,1,1,1,0.5012646084074657,0.4987353915925343
91072,0.5348837209302326,0.5,-115,100,0.5162249864791779,0.4837750135208221,away,CWS,over,8.5,0.5495495495495495,-122,0.5250401592387142,CIN,CWS,2023 REG,8,4,7,5,9,15,0,1,-1,1,1,1,1,1,0,0,0,0,0,0.5250401592387142,0.47495984076128583
91072,0.5348837209302326,0.5,-115,100,0.5162249864791779,0.4837750135208221,home,CIN,under,8.5,0.49504950495049505,102,0.47495984076128583,CIN,CWS,2023 REG,8,4,7,5,9,15,0,1,-1,1,1,1,1,1,0,0,0,0,0,0.5250401592387142,0.47495984076128583
91073,0.41493775933609955,0.6254681647940076,141,-167,0.39817181571364846,0.6018281842863515,away,SD,over,9,0.5215311004784688,-109,0.49670754937970685,ARI,SD,2023 REG,5,5,14,10,15,19,0,1,-5,5,1,1,1,1,1,0,0,0,0,0.49670754937970685,0.5032924506202932
91073,0.41493775933609955,0.6254681647940076,141,-167,0.39817181571364846,0.6018281842863515,home,ARI,under,9,0.5260663507109005,-111,0.5032924506202932,ARI,SD,2023 REG,5,5,14,10,15,19,0,1,-5,5,1,1,1,1,1,0,0,0,0,0.49670754937970685,0.5032924506202932
91074,0.5726495726495727,0.46511627906976744,-134,115,0.5510229738017454,0.44897702619825464,away,TOR,over,8.5,0.5215311004784688,-109,0.4978845547971712,NYY,TOR,2023 REG,5,1,8,6,7,13,0,1,-5,5,1,0,0,0,0,0,0,0,0,0.4978845547971712,0.5021154452028288
91074,0.5726495726495727,0.46511627906976744,-134,115,0.5510229738017454,0.44897702619825464,home,NYY,under,8.5,0.5238095238095238,-110,0.5021154452028288,NYY,TOR,2023 REG,5,1,8,6,7,13,0,1,-5,5,1,0,0,0,0,0,0,0,0,0.4978845547971712,0.5021154452028288
91075,0.5833333333333333,0.4629629629629629,-140,116,0.5563271604938271,0.44367283950617287,away,SF,over,8,0.5412844036697247,-118,0.5189377998484975,NYY,SF,2023 REG,7,6,3,0,6,10,1,0,6,-6,0,0,0,0,0,0,0,0,0,0.5189377998484975,0.4810622001515025
91075,0.5833333333333333,0.4629629629629629,-140,116,0.5563271604938271,0.44367283950617287,home,NYY,under,8,0.5,100,0.4810622001515025,NYY,SF,2023 REG,7,6,3,0,6,10,1,0,6,-6,0,0,0,0,0,0,0,0,0,0.5189377998484975,0.4810622001515025
91076,0.5121951219512195,0.5260663507109005,-105,-111,0.4925977822950117,0.5074022177049883,away,NYY,over,9,0.5098039215686274,-104,0.48592421718142587,LAD,NYY,2023 REG,7,3,6,6,9,13,0,1,-3,3,1,1,1,0,0,0,0,0,0,0.48592421718142587,0.5140757828185741
91076,0.5121951219512195,0.5260663507109005,-105,-111,0.4925977822950117,0.5074022177049883,home,LAD,under,9,0.5370370370370371,-116,0.5140757828185741,LAD,NYY,2023 REG,7,3,6,6,9,13,0,1,-3,3,1,1,1,0,0,0,0,0,0,0.48592421718142587,0.5140757828185741
91077,0.425531914893617,0.6168582375478928,135,-161,0.407493552152549,0.592506447847451,away,MIN,over,13,0.5073891625615764,-103,0.48484779035144243,COL,MIN,2023 REG,4,3,9,2,5,13,1,0,1,-1,1,1,0,0,0,0,0,0,0,0.48484779035144243,0.5151522096485576
91077,0.425531914893617,0.6168582375478928,135,-161,0.407493552152549,0.592506447847451,home,COL,under,13,0.5370370370370371,-116,0.5151522096485576,COL,MIN,2023 REG,4,3,9,2,5,13,1,0,1,-1,1,1,0,0,0,0,0,0,0,0.48484779035144243,0.5151522096485576
91078,0.6875,0.35714285714285715,-220,180,0.6568080357142857,0.3431919642857143,away,BAL,over,8.5,0.5098039215686274,-104,0.4870219861770517,ATL,BAL,2023 REG,11,4,12,9,13,23,0,1,-5,5,1,1,1,1,0,0,0,0,0,0.4870219861770517,0.5129780138229483
91078,0.6875,0.35714285714285715,-220,180,0.6568080357142857,0.3431919642857143,home,ATL,under,8.5,0.5348837209302326,-115,0.5129780138229483,ATL,BAL,2023 REG,11,4,12,9,13,23,0,1,-5,5,1,1,1,1,0,0,0,0,0,0.4870219861770517,0.5129780138229483
91079,0.5121951219512195,0.5305164319248826,-105,-113,0.4903184724049234,0.5096815275950766,away,CIN,over,9.5,0.5,100,0.4772727272727273,KC,CIN,2023 REG,15,4,7,7,11,22,0,1,-3,3,1,1,1,1,0,0,0,0,0,0.4772727272727273,0.5227272727272727
91079,0.5121951219512195,0.5305164319248826,-105,-113,0.4903184724049234,0.5096815275950766,home,KC,under,9.5,0.5454545454545454,-120,0.5227272727272727,KC,CIN,2023 REG,15,4,7,7,11,22,0,1,-3,3,1,1,1,1,0,0,0,0,0,0.4772727272727273,0.5227272727272727
91080,0.5412844036697247,0.5,-118,100,0.5189377998484975,0.4810622001515025,away,CIN,over,9.5,0.5238095238095238,-110,0.4988662131519274,MIL,CIN,2023 REG,7,3,6,2,5,13,1,0,1,-1,1,1,0,0,0,0,0,0,0,0.4988662131519274,0.5011337868480725
91080,0.5412844036697247,0.5,-118,100,0.5189377998484975,0.4810622001515025,home,MIL,under,9.5,0.5238095238095238,-110,0.5011337868480725,MIL,CIN,2023 REG,7,3,6,2,5,13,1,0,1,-1,1,1,0,0,0,0,0,0,0,0.4988662131519274,0.5011337868480725
91081,0.6551724137931035,0.3921568627450981,-190,155,0.6241635774404887,0.37583642255951133,away,CWS,over,8,0.5121951219512195,-105,0.48808156828023186,TB,CWS,2023 REG,5,4,3,1,5,8,1,0,3,-3,1,0,0,0,0,0,0,0,0,0.48808156828023186,0.5119184317197681
91081,0.6551724137931035,0.3921568627450981,-190,155,0.6241635774404887,0.37583642255951133,home,TB,under,8,0.5348837209302326,-115,0.5119184317197681,TB,CWS,2023 REG,5,4,3,1,5,8,1,0,3,-3,1,0,0,0,0,0,0,0,0,0.48808156828023186,0.5119184317197681
91082,0.6428571428571428,0.4,-180,150,0.6153061224489796,0.38469387755102036,away,LAA,over,9,0.5098039215686274,-104,0.48592421718142587,TEX,LAA,2023 REG,3,0,8,2,2,11,0,1,-2,2,0,0,0,0,0,0,0,0,0,0.48592421718142587,0.5140757828185741
91082,0.6428571428571428,0.4,-180,150,0.6153061224489796,0.38469387755102036,home,TEX,under,9,0.5370370370370371,-116,0.5140757828185741,TEX,LAA,2023 REG,3,0,8,2,2,11,0,1,-2,2,0,0,0,0,0,0,0,0,0,0.48592421718142587,0.5140757828185741
91083,0.5169082125603864,0.5238095238095238,-107,-110,0.49586088023391106,0.5041391197660889,away,TB,over,8.5,0.5454545454545454,-120,0.5206611570247933,HOU,TB,2023 REG,8,3,6,4,7,14,0,1,-1,1,1,1,1,0,0,0,0,0,0,0.5206611570247933,0.4793388429752067
91083,0.5169082125603864,0.5238095238095238,-107,-110,0.49586088023391106,0.5041391197660889,home,HOU,under,8.5,0.5,100,0.4793388429752067,HOU,TB,2023 REG,8,3,6,4,7,14,0,1,-1,1,1,1,1,0,0,0,0,0,0,0.5206611570247933,0.4793388429752067
91084,0.5433789954337899,0.5024875621890548,-119,-101,0.5184560714286826,0.48154392857131745,away,ARI,over,7,0.5535714285714286,-124,0.528006245601689,NYM,ARI,2023 REG,10,11,4,1,12,14,1,0,10,-10,1,0,0,0,0,0,0,0,0,0.528006245601689,0.47199375439831104
91084,0.5433789954337899,0.5024875621890548,-119,-101,0.5184560714286826,0.48154392857131745,home,NYM,under,7,0.4926108374384236,103,0.47199375439831104,NYM,ARI,2023 REG,10,11,4,1,12,14,1,0,10,-10,1,0,0,0,0,0,0,0,0,0.528006245601689,0.47199375439831104
91085,0.6240601503759399,0.41493775933609955,-166,141,0.5997231089766972,0.40027689102330277,away,BAL,over,8.5,0.5348837209302326,-115,0.5097020142727117,MIN,BAL,2023 REG,5,1,5,3,4,10,0,1,-2,2,1,0,0,0,0,0,0,0,0,0.5097020142727117,0.49029798572728833
91085,0.6240601503759399,0.41493775933609955,-166,141,0.5997231089766972,0.40027689102330277,home,MIN,under,8.5,0.5121951219512195,-105,0.49029798572728833,MIN,BAL,2023 REG,5,1,5,3,4,10,0,1,-2,2,1,0,0,0,0,0,0,0,0,0.5097020142727117,0.49029798572728833
91086,0.6296296296296295,0.4081632653061224,-170,145,0.6058341031886005,0.39416589681139946,away,DET,over,7.5,0.5348837209302326,-115,0.5097020142727117,BAL,DET,2023 REG,3,2,7,1,3,10,1,0,1,-1,1,0,0,0,0,0,0,0,0,0.5097020142727117,0.49029798572728833
91086,0.6296296296296295,0.4081632653061224,-170,145,0.6058341031886005,0.39416589681139946,home,BAL,under,7.5,0.5121951219512195,-105,0.49029798572728833,BAL,DET,2023 REG,3,2,7,1,3,10,1,0,1,-1,1,0,0,0,0,0,0,0,0,0.5097020142727117,0.49029798572728833
91087,0.7142857142857143,0.3225806451612903,-250,210,0.6879526003949967,0.3120473996050033,away,PIT,over,8,0.5215311004784688,-109,0.4978845547971712,PHI,PIT,2023 REG,5,2,11,3,5,16,0,1,-1,1,1,1,0,0,0,0,0,0,0,0.4978845547971712,0.5021154452028288
91087,0.7142857142857143,0.3225806451612903,-250,210,0.6879526003949967,0.3120473996050033,home,PHI,under,8,0.5238095238095238,-110,0.5021154452028288,PHI,PIT,2023 REG,5,2,11,3,5,16,0,1,-1,1,1,1,0,0,0,0,0,0,0,0.4978845547971712,0.5021154452028288
91088,0.5901639344262295,0.4444444444444444,-144,125,0.569739317387799,0.43026068261220096,away,TOR,over,8.5,0.5238095238095238,-110,0.4988662131519274,TEX,TOR,2023 REG,15,11,9,7,18,24,1,0,4,-4,1,1,1,1,1,1,1,0,0,0.4988662131519274,0.5011337868480725
91088,0.5901639344262295,0.4444444444444444,-144,125,0.569739317387799,0.43026068261220096,home,TEX,under,8.5,0.5238095238095238,-110,0.5011337868480725,TEX,TOR,2023 REG,15,11,9,7,18,24,1,0,4,-4,1,1,1,1,1,1,1,0,0,0.4988662131519274,0.5011337868480725
91089,0.43859649122807015,0.5983935742971888,128,-149,0.4223727782783952,0.5776272217216047,away,TOR,over,9,0.5,100,0.4772727272727273,TEX,TOR,2023 REG,6,1,3,2,3,9,0,1,-1,1,1,0,0,0,0,0,0,0,0,0.4772727272727273,0.5227272727272727
91089,0.43859649122807015,0.5983935742971888,128,-149,0.4223727782783952,0.5776272217216047,home,TEX,under,9,0.5454545454545454,-120,0.5227272727272727,TEX,TOR,2023 REG,6,1,3,2,3,9,0,1,-1,1,1,0,0,0,0,0,0,0,0,0.4772727272727273,0.5227272727272727
91090,0.5726495726495727,0.46511627906976744,-134,115,0.5510229738017454,0.44897702619825464,away,TB,over,9,0.5454545454545454,-120,0.5206611570247933,HOU,TB,2023 REG,10,2,12,8,10,22,0,1,-6,6,1,1,0,0,0,0,0,0,0,0.5206611570247933,0.4793388429752067
91090,0.5726495726495727,0.46511627906976744,-134,115,0.5510229738017454,0.44897702619825464,home,HOU,under,9,0.5,100,0.4793388429752067,HOU,TB,2023 REG,10,2,12,8,10,22,0,1,-6,6,1,1,0,0,0,0,0,0,0,0.5206611570247933,0.4793388429752067
91091,0.46511627906976744,0.574468085106383,115,-135,0.44670494689481377,0.5532950531051862,away,LAD,over,8.5,0.5238095238095238,-110,0.5000596729920038,LAA,LAD,2023 REG,5,0,6,2,2,11,0,1,-2,2,0,0,0,0,0,0,0,0,0,0.5000596729920038,0.4999403270079962
91091,0.46511627906976744,0.574468085106383,115,-135,0.44670494689481377,0.5532950531051862,home,LAA,under,8.5,0.5215311004784688,-109,0.4999403270079962,LAA,LAD,2023 REG,5,0,6,2,2,11,0,1,-2,2,0,0,0,0,0,0,0,0,0,0.5000596729920038,0.4999403270079962
91092,0.40322580645161293,0.6363636363636364,148,-175,0.387262321445464,0.612737678554536,away,DET,over,8,0.5327102803738317,-114,0.5075272610403079,KC,DET,2023 REG,13,11,11,10,21,24,1,0,1,-1,1,1,1,1,1,1,1,1,1,0.5075272610403079,0.4924727389596921
91092,0.40322580645161293,0.6363636363636364,148,-175,0.387262321445464,0.612737678554536,home,KC,under,8,0.5145631067961165,-106,0.4924727389596921,KC,DET,2023 REG,13,11,11,10,21,24,1,0,1,-1,1,1,1,1,1,1,1,1,1,0.5075272610403079,0.4924727389596921
91093,0.4166666666666667,0.6226415094339623,140,-165,0.4002882599580712,0.5997117400419287,away,SF,over,9.5,0.5348837209302326,-115,0.5097020142727117,WSH,SF,2023 REG,7,5,5,3,8,12,1,0,2,-2,1,1,1,0,0,0,0,0,0,0.5097020142727117,0.49029798572728833
91093,0.4166666666666667,0.6226415094339623,140,-165,0.4002882599580712,0.5997117400419287,home,WSH,under,9.5,0.5121951219512195,-105,0.49029798572728833,WSH,SF,2023 REG,7,5,5,3,8,12,1,0,2,-2,1,1,1,0,0,0,0,0,0,0.5097020142727117,0.49029798572728833
91094,0.6183206106870228,0.4184100418410042,-162,139,0.5956092911849603,0.4043907088150397,away,CLE,over,8.5,0.5145631067961165,-106,0.49023796582517226,TOR,CLE,2023 REG,6,2,8,5,7,14,0,1,-3,3,1,1,0,0,0,0,0,0,0,0.49023796582517226,0.5097620341748277
91094,0.6183206106870228,0.4184100418410042,-162,139,0.5956092911849603,0.4043907088150397,home,TOR,under,8.5,0.5327102803738317,-114,0.5097620341748277,TOR,CLE,2023 REG,6,2,8,5,7,14,0,1,-3,3,1,1,0,0,0,0,0,0,0,0.49023796582517226,0.5097620341748277
91095,0.5983935742971888,0.4424778761061947,-149,126,0.5739363610035978,0.4260636389964022,away,LAA,over,7.5,0.5073891625615764,-103,0.4826927225525911,SD,LAA,2023 REG,11,8,6,5,13,17,1,0,3,-3,1,1,1,1,1,0,0,0,0,0.4826927225525911,0.5173072774474089
91095,0.5983935742971888,0.4424778761061947,-149,126,0.5739363610035978,0.4260636389964022,home,SD,under,7.5,0.5412844036697247,-118,0.5173072774474089,SD,LAA,2023 REG,11,8,6,5,13,17,1,0,3,-3,1,1,1,1,1,0,0,0,0,0.4826927225525911,0.5173072774474089
91096,0.6389891696750902,0.4016064257028112,-177,149,0.6130490238920991,0.38695097610790086,away,PIT,over,8.5,0.5327102803738317,-114,0.508788710910954,MIN,PIT,2023 REG,11,4,8,7,11,19,0,1,-3,3,1,1,1,1,0,0,0,0,0,0.508788710910954,0.491211289089046
91096,0.6389891696750902,0.4016064257028112,-177,149,0.6130490238920991,0.38695097610790086,home,MIN,under,8.5,0.5121951219512195,-105,0.491211289089046,MIN,PIT,2023 REG,11,4,8,7,11,19,0,1,-3,3,1,1,1,1,0,0,0,0,0,0.508788710910954,0.491211289089046
91097,0.5192307692307692,0.5238095238095238,-108,-110,0.49688292476754015,0.5031170752324599,away,TOR,over,9,0.5,100,0.4772727272727273,BAL,TOR,2023 REG,10,5,6,3,8,16,1,0,2,-2,1,1,1,0,0,0,0,0,0,0.4772727272727273,0.5227272727272727
91097,0.5192307692307692,0.5238095238095238,-108,-110,0.49688292476754015,0.5031170752324599,home,BAL,under,9,0.5454545454545454,-120,0.5227272727272727,BAL,TOR,2023 REG,10,5,6,3,8,16,1,0,2,-2,1,1,1,0,0,0,0,0,0,0.4772727272727273,0.5227272727272727
91098,0.4347826086956522,0.6031746031746031,130,-152,0.418279473099889,0.581720526900111,away,LAA,over,13,0.5,100,0.4772727272727273,COL,LAA,2023 REG,5,4,8,3,7,13,1,0,1,-1,1,1,1,0,0,0,0,0,0,0.4772727272727273,0.5227272727272727
91098,0.4347826086956522,0.6031746031746031,130,-152,0.418279473099889,0.581720526900111,home,COL,under,13,0.5454545454545454,-120,0.5227272727272727,COL,LAA,2023 REG,5,4,8,3,7,13,1,0,1,-1,1,1,1,0,0,0,0,0,0,0.4772727272727273,0.5227272727272727
91099,0.5555555555555556,0.48780487804878053,-125,105,0.5314664257753688,0.46853357422463116,away,NYM,over,10.5,0.5121951219512195,-105,0.48808156828023186,STL,NYM,2023 REG,15,7,7,3,10,22,1,0,4,-4,1,1,1,0,0,0,0,0,0,0.48808156828023186,0.5119184317197681
91099,0.5555555555555556,0.48780487804878053,-125,105,0.5314664257753688,0.46853357422463116,home,STL,under,10.5,0.5348837209302326,-115,0.5119184317197681,STL,NYM,2023 REG,15,7,7,3,10,22,1,0,4,-4,1,1,1,0,0,0,0,0,0,0.48808156828023186,0.5119184317197681
91100,0.5652173913043479,0.47619047619047616,-130,110,0.5418129444594474,0.4581870555405526,away,PHI,over,8.5,0.5238095238095238,-110,0.5000596729920038,TEX,PHI,2023 REG,8,2,9,1,3,17,1,0,1,-1,1,0,0,0,0,0,0,0,0,0.5000596729920038,0.4999403270079962
91100,0.5652173913043479,0.47619047619047616,-130,110,0.5418129444594474,0.4581870555405526,home,TEX,under,8.5,0.5215311004784688,-109,0.4999403270079962,TEX,PHI,2023 REG,8,2,9,1,3,17,1,0,1,-1,1,0,0,0,0,0,0,0,0,0.5000596729920038,0.4999403270079962
91101,0.6000000000000001,0.43859649122807015,-150,128,0.5768421052631579,0.42315789473684207,away,BOS,over,9,0.5348837209302326,-115,0.5097020142727117,MIN,BOS,2023 REG,10,6,3,0,6,13,1,0,6,-6,0,0,0,0,0,0,0,0,0,0.5097020142727117,0.49029798572728833
91101,0.6000000000000001,0.43859649122807015,-150,128,0.5768421052631579,0.42315789473684207,home,MIN,under,9,0.5121951219512195,-105,0.49029798572728833,MIN,BOS,2023 REG,10,6,3,0,6,13,1,0,6,-6,0,0,0,0,0,0,0,0,0,0.5097020142727117,0.49029798572728833
91102,0.5454545454545454,0.49019607843137253,-120,104,0.526008750607681,0.47399124939231896,away,TEX,over,7,0.5535714285714286,-124,0.5293429871948779,CHC,TEX,2023 REG,14,10,7,3,13,21,1,0,7,-7,1,1,1,0,0,0,0,0,0,0.5293429871948779,0.47065701280512207
91102,0.5454545454545454,0.49019607843137253,-120,104,0.526008750607681,0.47399124939231896,home,CHC,under,7,0.49019607843137253,104,0.47065701280512207,CHC,TEX,2023 REG,14,10,7,3,13,21,1,0,7,-7,1,1,1,0,0,0,0,0,0,0.5293429871948779,0.47065701280512207
91103,0.4854368932038835,0.5535714285714286,106,-124,0.4665008146721786,0.5334991853278215,away,SD,over,8.5,0.5238095238095238,-110,0.5012646084074657,SF,SD,2023 REG,3,0,11,10,10,14,0,1,-10,10,0,0,0,0,0,0,0,0,0,0.5012646084074657,0.4987353915925343
91103,0.4854368932038835,0.5535714285714286,106,-124,0.4665008146721786,0.5334991853278215,home,SF,under,8.5,0.5192307692307692,-108,0.4987353915925343,SF,SD,2023 REG,3,0,11,10,10,14,0,1,-10,10,0,0,0,0,0,0,0,0,0,0.5012646084074657,0.4987353915925343
91104,0.6363636363636364,0.4016064257028112,-175,149,0.6122008695940788,0.3877991304059212,away,LAA,over,8,0.5283018867924528,-112,0.5031902949311281,SD,LAA,2023 REG,5,5,6,3,8,11,1,0,2,-2,1,1,1,0,0,0,0,0,0,0.5031902949311281,0.4968097050688719
91104,0.6363636363636364,0.4016064257028112,-175,149,0.6122008695940788,0.3877991304059212,home,SD,under,8,0.5192307692307692,-108,0.4968097050688719,SD,LAA,2023 REG,5,5,6,3,8,11,1,0,2,-2,1,1,1,0,0,0,0,0,0,0.5031902949311281,0.4968097050688719
91105,0.5412844036697247,0.5,-118,100,0.5189377998484975,0.4810622001515025,away,DET,over,9.5,0.5238095238095238,-110,0.4988662131519274,WSH,DET,2023 REG,9,5,6,2,7,15,1,0,3,-3,1,1,0,0,0,0,0,0,0,0.4988662131519274,0.5011337868480725
91105,0.5412844036697247,0.5,-118,100,0.5189377998484975,0.4810622001515025,home,WSH,under,9.5,0.5238095238095238,-110,0.5011337868480725,WSH,DET,2023 REG,9,5,6,2,7,15,1,0,3,-3,1,1,0,0,0,0,0,0,0,0.4988662131519274,0.5011337868480725
91106,0.5689655172413793,0.4716981132075471,-132,112,0.5458293137100936,0.4541706862899064,away,TB,over,8,0.5098039215686274,-104,0.48592421718142587,BAL,TB,2023 REG,4,3,7,4,7,11,0,1,-1,1,1,1,1,0,0,0,0,0,0,0.48592421718142587,0.5140757828185741
91106,0.5689655172413793,0.4716981132075471,-132,112,0.5458293137100936,0.4541706862899064,home,BAL,under,8,0.5370370370370371,-116,0.5140757828185741,BAL,TB,2023 REG,4,3,7,4,7,11,0,1,-1,1,1,1,1,0,0,0,0,0,0,0.48592421718142587,0.5140757828185741
91107,0.6226415094339623,0.41493775933609955,-165,141,0.5992430968035465,0.4007569031964535,away,DET,over,8.5,0.5348837209302326,-115,0.5097020142727117,CWS,DET,2023 REG,4,2,3,1,3,7,1,0,1,-1,1,0,0,0,0,0,0,0,0,0.5097020142727117,0.49029798572728833
91107,0.6226415094339623,0.41493775933609955,-165,141,0.5992430968035465,0.4007569031964535,home,CWS,under,8.5,0.5121951219512195,-105,0.49029798572728833,CWS,DET,2023 REG,4,2,3,1,3,7,1,0,1,-1,1,0,0,0,0,0,0,0,0,0.5097020142727117,0.49029798572728833
91108,0.49019607843137253,0.5495495495495495,104,-122,0.4707129274603323,0.5292870725396677,away,NYY,over,7,0.5348837209302326,-115,0.5097020142727117,MIA,NYY,2023 REG,11,8,6,7,15,17,1,0,1,-1,1,1,1,1,1,1,1,0,0,0.5097020142727117,0.49029798572728833
91108,0.49019607843137253,0.5495495495495495,104,-122,0.4707129274603323,0.5292870725396677,home,MIA,under,7,0.5121951219512195,-105,0.49029798572728833,MIA,NYY,2023 REG,11,8,6,7,15,17,1,0,1,-1,1,1,1,1,1,1,1,0,0,0.5097020142727117,0.49029798572728833
91109,0.425531914893617,0.613899613899614,135,-159,0.40875254093905067,0.5912474590609493,away,MIL,over,12,0.5192307692307692,-108,0.49571111079951763,COL,MIL,2023 REG,11,9,13,6,15,24,1,0,3,-3,1,1,1,1,1,1,0,0,0,0.49571111079951763,0.5042888892004824
91109,0.425531914893617,0.613899613899614,135,-159,0.40875254093905067,0.5912474590609493,home,COL,under,12,0.5260663507109005,-111,0.5042888892004824,COL,MIL,2023 REG,11,9,13,6,15,24,1,0,3,-3,1,1,1,1,1,1,0,0,0,0.49571111079951763,0.5042888892004824
91110,0.609375,0.4291845493562232,-156,133,0.5858777746110515,0.4141222253889485,away,STL,over,8.5,0.5348837209302326,-115,0.5097020142727117,ARI,STL,2023 REG,15,7,15,11,18,30,0,1,-4,4,1,1,1,1,1,1,1,0,0,0.5097020142727117,0.49029798572728833
91110,0.609375,0.4291845493562232,-156,133,0.5858777746110515,0.4141222253889485,home,ARI,under,8.5,0.5121951219512195,-105,0.49029798572728833,ARI,STL,2023 REG,15,7,15,11,18,30,0,1,-4,4,1,1,1,1,1,1,1,0,0,0.5097020142727117,0.49029798572728833
91111,0.5652173913043479,0.4716981132075471,-130,112,0.5443521061454507,0.4556478938545493,away,SD,over,7.5,0.5238095238095238,-110,0.5012646084074657,NYM,SD,2023 REG,7,5,2,0,5,9,1,0,5,-5,0,0,0,0,0,0,0,0,0,0.5012646084074657,0.4987353915925343
91111,0.5652173913043479,0.4716981132075471,-130,112,0.5443521061454507,0.4556478938545493,home,NYM,under,7.5,0.5192307692307692,-108,0.4987353915925343,NYM,SD,2023 REG,7,5,2,0,5,9,1,0,5,-5,0,0,0,0,0,0,0,0,0,0.5012646084074657,0.4987353915925343
91112,0.6774193548387096,0.36764705882352944,-210,172,0.6468904939707413,0.3531095060292587,away,LAA,over,8,0.5305164319248826,-113,0.5053568787472517,SEA,LAA,2023 REG,11,8,4,0,8,15,1,0,8,-8,0,0,0,0,0,0,0,0,0,0.5053568787472517,0.49464312125274834
91112,0.6774193548387096,0.36764705882352944,-210,172,0.6468904939707413,0.3531095060292587,home,SEA,under,8,0.5169082125603864,-107,0.49464312125274834,SEA,LAA,2023 REG,11,8,4,0,8,15,1,0,8,-8,0,0,0,0,0,0,0,0,0,0.5053568787472517,0.49464312125274834
91113,0.4329004329004329,0.6031746031746031,131,-152,0.41728353416665104,0.582716465833349,away,MIA,over,9,0.5121951219512195,-105,0.48808156828023186,WSH,MIA,2023 REG,8,2,12,4,6,20,0,1,-2,2,1,1,0,0,0,0,0,0,0,0.48808156828023186,0.5119184317197681
91113,0.4329004329004329,0.6031746031746031,131,-152,0.41728353416665104,0.582716465833349,home,WSH,under,9,0.5348837209302326,-115,0.5119184317197681,WSH,MIA,2023 REG,8,2,12,4,6,20,0,1,-2,2,1,1,0,0,0,0,0,0,0,0.48808156828023186,0.5119184317197681
91114,0.4484304932735426,0.5918367346938775,123,-145,0.43037344037335423,0.5696265596266458,away,SF,over,9.5,0.5121951219512195,-105,0.48919479393107135,ARI,SF,2023 REG,9,2,8,6,8,17,0,1,-4,4,1,1,0,0,0,0,0,0,0,0.48919479393107135,0.5108052060689287
91114,0.4484304932735426,0.5918367346938775,123,-145,0.43037344037335423,0.5696265596266458,home,ARI,under,9.5,0.5327102803738317,-114,0.5108052060689287,ARI,SF,2023 REG,9,2,8,6,8,17,0,1,-4,4,1,1,0,0,0,0,0,0,0,0.48919479393107135,0.5108052060689287
91115,0.5726495726495727,0.46511627906976744,-134,115,0.5510229738017454,0.44897702619825464,away,BOS,over,8,0.5454545454545454,-120,0.5206611570247933,BAL,BOS,2023 REG,7,5,14,2,7,21,1,0,3,-3,1,1,0,0,0,0,0,0,0,0.5206611570247933,0.4793388429752067
91115,0.5726495726495727,0.46511627906976744,-134,115,0.5510229738017454,0.44897702619825464,home,BAL,under,8,0.5,100,0.4793388429752067,BAL,BOS,2023 REG,7,5,14,2,7,21,1,0,3,-3,1,1,0,0,0,0,0,0,0,0.5206611570247933,0.4793388429752067
91116,0.6875,0.35460992907801414,-220,182,0.6585494237588654,0.3414505762411346,away,OAK,over,9,0.5238095238095238,-110,0.4988662131519274,SEA,OAK,2023 REG,5,3,5,2,5,10,1,0,1,-1,1,1,0,0,0,0,0,0,0,0.4988662131519274,0.5011337868480725
91116,0.6875,0.35460992907801414,-220,182,0.6585494237588654,0.3414505762411346,home,SEA,under,9,0.5238095238095238,-110,0.5011337868480725,SEA,OAK,2023 REG,5,3,5,2,5,10,1,0,1,-1,1,1,0,0,0,0,0,0,0,0.4988662131519274,0.5011337868480725
91117,0.6363636363636364,0.4,-175,150,0.6132231404958678,0.3867768595041322,away,TOR,over,7,0.5454545454545454,-120,0.5206611570247933,NYY,TOR,2023 REG,7,3,7,2,5,14,1,0,1,-1,1,1,0,0,0,0,0,0,0,0.5206611570247933,0.4793388429752067
91117,0.6363636363636364,0.4,-175,150,0.6132231404958678,0.3867768595041322,home,NYY,under,7,0.5,100,0.4793388429752067,NYY,TOR,2023 REG,7,3,7,2,5,14,1,0,1,-1,1,1,0,0,0,0,0,0,0,0.5206611570247933,0.4793388429752067
91118,0.6794871794871794,0.35842293906810035,-212,179,0.6537277399560278,0.34627226004397216,away,ARI,over,9,0.5121951219512195,-105,0.48808156828023186,ATL,ARI,2023 REG,8,7,6,5,12,14,1,0,2,-2,1,1,1,1,1,0,0,0,0,0.48808156828023186,0.5119184317197681
91118,0.6794871794871794,0.35842293906810035,-212,179,0.6537277399560278,0.34627226004397216,home,ATL,under,9,0.5348837209302326,-115,0.5119184317197681,ATL,ARI,2023 REG,8,7,6,5,12,14,1,0,2,-2,1,1,1,1,1,0,0,0,0,0.48808156828023186,0.5119184317197681
91119,0.6363636363636364,0.4081632653061224,-175,145,0.6080283353010626,0.3919716646989374,away,MIL,over,8,0.5238095238095238,-110,0.4988662131519274,SD,MIL,2023 REG,5,0,4,1,1,9,0,1,-1,1,0,0,0,0,0,0,0,0,0,0.4988662131519274,0.5011337868480725
91119,0.6363636363636364,0.4081632653061224,-175,145,0.6080283353010626,0.3919716646989374,home,SD,under,8,0.5238095238095238,-110,0.5011337868480725,SD,MIL,2023 REG,5,0,4,1,1,9,0,1,-1,1,0,0,0,0,0,0,0,0,0,0.4988662131519274,0.5011337868480725
91120,0.6453900709219857,0.3921568627450981,-182,155,0.6211576527396834,0.3788423472603166,away,TEX,over,9,0.5348837209302326,-115,0.5097020142727117,SD,TEX,2023 REG,9,4,4,0,4,13,1,0,4,-4,0,0,0,0,0,0,0,0,0,0.5097020142727117,0.49029798572728833
91120,0.6453900709219857,0.3921568627450981,-182,155,0.6211576527396834,0.3788423472603166,home,SD,under,9,0.5121951219512195,-105,0.49029798572728833,SD,TEX,2023 REG,9,4,4,0,4,13,1,0,4,-4,0,0,0,0,0,0,0,0,0,0.5097020142727117,0.49029798572728833
91121,0.4347826086956522,0.607843137254902,130,-155,0.41624967567367205,0.583750324326328,away,LAD,over,9.5,0.5215311004784688,-109,0.49670754937970685,WSH,LAD,2023 REG,6,5,10,8,13,16,0,1,-3,3,1,1,1,1,1,0,0,0,0,0.49670754937970685,0.5032924506202932
91121,0.4347826086956522,0.607843137254902,130,-155,0.41624967567367205,0.583750324326328,home,WSH,under,9.5,0.5260663507109005,-111,0.5032924506202932,WSH,LAD,2023 REG,6,5,10,8,13,16,0,1,-3,3,1,1,1,1,1,0,0,0,0,0.49670754937970685,0.5032924506202932
91122,0.5633187772925764,0.47619047619047616,-129,110,0.5410624729287608,0.45893752707123925,away,CIN,over,9,0.5348837209302326,-115,0.5097020142727117,MIL,CIN,2023 REG,7,1,4,0,1,11,1,0,1,-1,0,0,0,0,0,0,0,0,0,0.5097020142727117,0.49029798572728833
91122,0.5633187772925764,0.47619047619047616,-129,110,0.5410624729287608,0.45893752707123925,home,MIL,under,9,0.5121951219512195,-105,0.49029798572728833,MIL,CIN,2023 REG,7,1,4,0,1,11,1,0,1,-1,0,0,0,0,0,0,0,0,0,0.5097020142727117,0.49029798572728833
91123,0.49504950495049505,0.5495495495495495,102,-122,0.47297076509898783,0.5270292349010122,away,SEA,over,10,0.5121951219512195,-105,0.48808156828023186,BOS,SEA,2023 REG,9,1,15,10,11,24,0,1,-9,9,1,0,0,0,0,0,0,0,0,0.48808156828023186,0.5119184317197681
91123,0.49504950495049505,0.5495495495495495,102,-122,0.47297076509898783,0.5270292349010122,home,BOS,under,10,0.5348837209302326,-115,0.5119184317197681,BOS,SEA,2023 REG,9,1,15,10,11,24,0,1,-9,9,1,0,0,0,0,0,0,0,0,0.48808156828023186,0.5119184317197681
91124,0.7311827956989247,0.3125,-272,220,0.69924268701584,0.30075731298416,away,LAA,over,8,0.5348837209302326,-115,0.5097020142727117,MIN,LAA,2023 REG,7,8,9,6,14,16,1,0,2,-2,1,1,1,1,1,1,0,0,0,0.5097020142727117,0.49029798572728833
91124,0.7311827956989247,0.3125,-272,220,0.69924268701584,0.30075731298416,home,MIN,under,8,0.5121951219512195,-105,0.49029798572728833,MIN,LAA,2023 REG,7,8,9,6,14,16,1,0,2,-2,1,1,1,1,1,1,0,0,0,0.5097020142727117,0.49029798572728833
91125,0.30303030303030304,0.7361477572559366,230,-279,0.2911581635496243,0.7088418364503757,away,LAD,over,11.5,0.5098039215686274,-104,0.48483656587239576,COL,LAD,2023 REG,3,0,8,5,5,11,0,1,-5,5,0,0,0,0,0,0,0,0,0,0.48483656587239576,0.5151634341276042
91125,0.30303030303030304,0.7361477572559366,230,-279,0.2911581635496243,0.7088418364503757,home,COL,under,11.5,0.5391705069124424,-117,0.5151634341276042,COL,LAD,2023 REG,3,0,8,5,5,11,0,1,-5,5,0,0,0,0,0,0,0,0,0,0.48483656587239576,0.5151634341276042
91126,0.5283018867924528,0.5169082125603864,-112,-107,0.5044173060022736,0.49558269399772636,away,MIL,over,8.5,0.5412844036697247,-118,0.5149381613977361,STL,MIL,2023 REG,6,0,10,6,6,16,0,1,-6,6,0,0,0,0,0,0,0,0,0,0.5149381613977361,0.48506183860226393
91126,0.5283018867924528,0.5169082125603864,-112,-107,0.5044173060022736,0.49558269399772636,home,STL,under,8.5,0.5073891625615764,-103,0.48506183860226393,STL,MIL,2023 REG,6,0,10,6,6,16,0,1,-6,6,0,0,0,0,0,0,0,0,0,0.5149381613977361,0.48506183860226393
91127,0.4504504504504505,0.5918367346938775,122,-145,0.43140216885390636,0.5685978311460936,away,TOR,over,10,0.5412844036697247,-118,0.5149381613977361,CIN,TOR,2023 REG,4,1,3,0,1,7,1,0,1,-1,0,0,0,0,0,0,0,0,0,0.5149381613977361,0.48506183860226393
91127,0.4504504504504505,0.5918367346938775,122,-145,0.43140216885390636,0.5685978311460936,home,CIN,under,10,0.5073891625615764,-103,0.48506183860226393,CIN,TOR,2023 REG,4,1,3,0,1,7,1,0,1,-1,0,0,0,0,0,0,0,0,0,0.5149381613977361,0.48506183860226393
91128,0.5652173913043479,0.47619047619047616,-130,110,0.5418129444594474,0.4581870555405526,away,ARI,over,9,0.5192307692307692,-108,0.49571111079951763,SF,ARI,2023 REG,6,2,10,5,7,16,0,1,-3,3,1,1,0,0,0,0,0,0,0,0.49571111079951763,0.5042888892004824
91128,0.5652173913043479,0.47619047619047616,-130,110,0.5418129444594474,0.4581870555405526,home,SF,under,9,0.5260663507109005,-111,0.5042888892004824,SF,ARI,2023 REG,6,2,10,5,7,16,0,1,-3,3,1,1,0,0,0,0,0,0,0,0.49571111079951763,0.5042888892004824
91129,0.6108949416342413,0.425531914893617,-157,135,0.5886419592417365,0.41135804075826354,away,CWS,over,8,0.5305164319248826,-113,0.5066009958897986,MIN,CWS,2023 REG,9,9,8,4,13,17,1,0,5,-5,1,1,1,1,0,0,0,0,0,0.5066009958897986,0.49339900411020143
91129,0.6108949416342413,0.425531914893617,-157,135,0.5886419592417365,0.41135804075826354,home,MIN,under,8,0.5145631067961165,-106,0.49339900411020143,MIN,CWS,2023 REG,9,9,8,4,13,17,1,0,5,-5,1,1,1,1,0,0,0,0,0,0.5066009958897986,0.49339900411020143
91130,0.4,0.6389891696750902,150,-177,0.3844043321299639,0.6155956678700361,away,LAD,over,8,0.5192307692307692,-108,0.49455035168025013,SF,LAD,2023 REG,5,2,8,1,3,13,1,0,1,-1,1,0,0,0,0,0,0,0,0,0.49455035168025013,0.5054496483197499
91130,0.4,0.6389891696750902,150,-177,0.3844043321299639,0.6155956678700361,home,SF,under,8,0.5283018867924528,-112,0.5054496483197499,SF,LAD,2023 REG,5,2,8,1,3,13,1,0,1,-1,1,0,0,0,0,0,0,0,0,0.49455035168025013,0.5054496483197499
91131,0.6875,0.3508771929824561,-220,185,0.6611156798245614,0.33888432017543857,away,CIN,over,9.5,0.5238095238095238,-110,0.4988662131519274,LAD,CIN,2023 REG,12,5,8,6,11,20,0,1,-1,1,1,1,1,1,1,0,0,0,0,0.4988662131519274,0.5011337868480725
91131,0.6875,0.3508771929824561,-220,185,0.6611156798245614,0.33888432017543857,home,LAD,under,9.5,0.5238095238095238,-110,0.5011337868480725,LAD,CIN,2023 REG,12,5,8,6,11,20,0,1,-1,1,1,1,1,1,1,0,0,0,0,0.4988662131519274,0.5011337868480725
91132,0.4739336492890995,0.5670995670995671,111,-131,0.4544866273039494,0.5455133726960506,away,STL,over,9.5,0.5121951219512195,-105,0.48808156828023186,CIN,STL,2023 REG,7,1,6,2,3,13,0,1,-1,1,1,0,0,0,0,0,0,0,0,0.48808156828023186,0.5119184317197681
91132,0.4739336492890995,0.5670995670995671,111,-131,0.4544866273039494,0.5455133726960506,home,CIN,under,9.5,0.5348837209302326,-115,0.5119184317197681,CIN,STL,2023 REG,7,1,6,2,3,13,0,1,-1,1,1,0,0,0,0,0,0,0,0,0.48808156828023186,0.5119184317197681
91133,0.6587030716723549,0.37878787878787884,-193,164,0.6340076674442828,0.36599233255571717,away,LAA,over,9,0.5370370370370371,-116,0.5118817074154765,TOR,LAA,2023 REG,8,2,8,3,5,16,0,1,-1,1,1,1,0,0,0,0,0,0,0,0.5118817074154765,0.48811829258452355
91133,0.6587030716723549,0.37878787878787884,-193,164,0.6340076674442828,0.36599233255571717,home,TOR,under,9,0.5098039215686274,-104,0.48811829258452355,TOR,LAA,2023 REG,8,2,8,3,5,16,0,1,-1,1,1,1,0,0,0,0,0,0,0,0.5118817074154765,0.48811829258452355
91134,0.7333333333333333,0.3125,-275,220,0.6997222222222221,0.30027777777777787,away,PIT,over,9.5,0.5098039215686274,-104,0.48592421718142587,LAD,PIT,2023 REG,11,7,12,9,16,23,0,1,-2,2,1,1,1,1,1,1,1,0,0,0.48592421718142587,0.5140757828185741
91134,0.7333333333333333,0.3125,-275,220,0.6997222222222221,0.30027777777777787,home,LAD,under,9.5,0.5370370370370371,-116,0.5140757828185741,LAD,PIT,2023 REG,11,7,12,9,16,23,0,1,-2,2,1,1,1,1,1,1,1,0,0,0.48592421718142587,0.5140757828185741
91135,0.49751243781094534,0.5454545454545454,101,-120,0.476135829221149,0.523864170778851,away,SD,over,7.5,0.5238095238095238,-110,0.4988662131519274,MIA,SD,2023 REG,4,1,11,10,11,15,0,1,-9,9,1,0,0,0,0,0,0,0,0,0.4988662131519274,0.5011337868480725
91135,0.49751243781094534,0.5454545454545454,101,-120,0.476135829221149,0.523864170778851,home,MIA,under,7.5,0.5238095238095238,-110,0.5011337868480725,MIA,SD,2023 REG,4,1,11,10,11,15,0,1,-9,9,1,0,0,0,0,0,0,0,0,0.4988662131519274,0.5011337868480725
91136,0.6197718631178707,0.4184100418410042,-163,139,0.5961077927441193,0.4038922072558807,away,MIA,over,7.5,0.5121951219512195,-105,0.48808156828023186,MIL,MIA,2023 REG,5,3,2,1,4,7,1,0,2,-2,1,0,0,0,0,0,0,0,0,0.48808156828023186,0.5119184317197681
91136,0.6197718631178707,0.4184100418410042,-163,139,0.5961077927441193,0.4038922072558807,home,MIL,under,7.5,0.5348837209302326,-115,0.5119184317197681,MIL,MIA,2023 REG,5,3,2,1,4,7,1,0,2,-2,1,0,0,0,0,0,0,0,0,0.48808156828023186,0.5119184317197681
91137,0.5967741935483871,0.4444444444444444,-148,125,0.5721759741010521,0.42782402589894786,away,PIT,over,8.5,0.5145631067961165,-106,0.49023796582517226,NYM,PIT,2023 REG,7,4,9,7,11,16,0,1,-3,3,1,1,1,1,0,0,0,0,0,0.49023796582517226,0.5097620341748277
91137,0.5967741935483871,0.4444444444444444,-148,125,0.5721759741010521,0.42782402589894786,home,NYM,under,8.5,0.5327102803738317,-114,0.5097620341748277,NYM,PIT,2023 REG,7,4,9,7,11,16,0,1,-3,3,1,1,1,1,0,0,0,0,0,0.49023796582517226,0.5097620341748277
91139,0.576271186440678,0.4629629629629629,-136,116,0.553661676614851,0.446338323385149,away,MIA,over,9.5,0.5348837209302326,-115,0.5097020142727117,BOS,MIA,2023 REG,9,1,19,10,11,28,0,1,-9,9,1,0,0,0,0,0,0,0,0,0.5097020142727117,0.49029798572728833
91139,0.576271186440678,0.4629629629629629,-136,116,0.553661676614851,0.446338323385149,home,BOS,under,9.5,0.5121951219512195,-105,0.49029798572728833,BOS,MIA,2023 REG,9,1,19,10,11,28,0,1,-9,9,1,0,0,0,0,0,0,0,0,0.5097020142727117,0.49029798572728833
91140,0.5850622406639003,0.45454545454545453,-141,120,0.5618892737571823,0.43811072624281766,away,NYY,over,8.5,0.5348837209302326,-115,0.5097020142727117,HOU,NYY,2023 REG,7,1,8,6,7,15,0,1,-5,5,1,0,0,0,0,0,0,0,0,0.5097020142727117,0.49029798572728833
91140,0.5850622406639003,0.45454545454545453,-141,120,0.5618892737571823,0.43811072624281766,home,HOU,under,8.5,0.5121951219512195,-105,0.49029798572728833,HOU,NYY,2023 REG,7,1,8,6,7,15,0,1,-5,5,1,0,0,0,0,0,0,0,0,0.5097020142727117,0.49029798572728833
91141,0.37735849056603776,0.6632996632996633,165,-197,0.36201579099407505,0.6379842090059249,away,HOU,over,8.5,0.5238095238095238,-110,0.5000596729920038,OAK,HOU,2023 REG,6,4,6,1,5,12,1,0,3,-3,1,0,0,0,0,0,0,0,0,0.5000596729920038,0.4999403270079962
91141,0.37735849056603776,0.6632996632996633,165,-197,0.36201579099407505,0.6379842090059249,home,OAK,under,8.5,0.5215311004784688,-109,0.4999403270079962,OAK,HOU,2023 REG,6,4,6,1,5,12,1,0,3,-3,1,0,0,0,0,0,0,0,0,0.5000596729920038,0.4999403270079962
91142,0.7674418604651163,0.273972602739726,-330,265,0.735658667773028,0.264341332226972,away,OAK,over,8.5,0.5238095238095238,-110,0.5012646084074657,LAA,OAK,2023 REG,10,8,7,7,15,17,1,0,1,-1,1,1,1,1,1,1,1,0,0,0.5012646084074657,0.4987353915925343
91142,0.7674418604651163,0.273972602739726,-330,265,0.735658667773028,0.264341332226972,home,LAA,under,8.5,0.5192307692307692,-108,0.4987353915925343,LAA,OAK,2023 REG,10,8,7,7,15,17,1,0,1,-1,1,1,1,1,1,1,1,0,0,0.5012646084074657,0.4987353915925343
91143,0.3846153846153846,0.6587030716723549,160,-193,0.36795443988933096,0.632045560110669,away,BAL,over,8.5,0.5121951219512195,-105,0.48808156828023186,OAK,BAL,2023 REG,4,1,17,12,13,21,0,1,-11,11,1,0,0,0,0,0,0,0,0,0.48808156828023186,0.5119184317197681
91143,0.3846153846153846,0.6587030716723549,160,-193,0.36795443988933096,0.632045560110669,home,OAK,under,8.5,0.5348837209302326,-115,0.5119184317197681,OAK,BAL,2023 REG,4,1,17,12,13,21,0,1,-11,11,1,0,0,0,0,0,0,0,0,0.48808156828023186,0.5119184317197681
91144,0.4166666666666667,0.6226415094339623,140,-165,0.4002882599580712,0.5997117400419287,away,PIT,over,8.5,0.5121951219512195,-105,0.48808156828023186,WSH,PIT,2023 REG,15,7,6,2,9,21,1,0,5,-5,1,1,0,0,0,0,0,0,0,0.48808156828023186,0.5119184317197681
91144,0.4166666666666667,0.6226415094339623,140,-165,0.4002882599580712,0.5997117400419287,home,WSH,under,8.5,0.5348837209302326,-115,0.5119184317197681,WSH,PIT,2023 REG,15,7,6,2,9,21,1,0,5,-5,1,1,0,0,0,0,0,0,0,0.48808156828023186,0.5119184317197681
91145,0.6453900709219857,0.3921568627450981,-182,155,0.6211576527396834,0.3788423472603166,away,MIN,over,8.5,0.5348837209302326,-115,0.5097020142727117,NYY,MIN,2023 REG,8,3,7,4,7,15,0,1,-1,1,1,1,1,0,0,0,0,0,0,0.5097020142727117,0.49029798572728833
91145,0.6453900709219857,0.3921568627450981,-182,155,0.6211576527396834,0.3788423472603166,home,NYY,under,8.5,0.5121951219512195,-105,0.49029798572728833,NYY,MIN,2023 REG,8,3,7,4,7,15,0,1,-1,1,1,1,1,0,0,0,0,0,0,0.5097020142727117,0.49029798572728833
91146,0.49504950495049505,0.5412844036697247,102,-118,0.47706242147513866,0.5229375785248613,away,MIN,over,7,0.5412844036697247,-118,0.5189377998484975,MIA,MIN,2023 REG,7,5,6,2,7,13,1,0,3,-3,1,1,0,0,0,0,0,0,0,0.5189377998484975,0.4810622001515025
91146,0.49504950495049505,0.5412844036697247,102,-118,0.47706242147513866,0.5229375785248613,home,MIA,under,7,0.5,100,0.4810622001515025,MIA,MIN,2023 REG,7,5,6,2,7,13,1,0,3,-3,1,1,0,0,0,0,0,0,0,0.5189377998484975,0.4810622001515025
91147,0.5726495726495727,0.4629629629629629,-134,116,0.5522560693500865,0.44774393064991347,away,LAA,over,8,0.5454545454545454,-120,0.5206611570247933,TEX,LAA,2023 REG,6,3,8,5,8,14,0,1,-2,2,1,1,1,0,0,0,0,0,0,0.5206611570247933,0.4793388429752067
91147,0.5726495726495727,0.4629629629629629,-134,116,0.5522560693500865,0.44774393064991347,home,TEX,under,8,0.5,100,0.4793388429752067,TEX,LAA,2023 REG,6,3,8,5,8,14,0,1,-2,2,1,1,1,0,0,0,0,0,0,0.5206611570247933,0.4793388429752067
91148,0.6491228070175439,0.3921568627450981,-185,155,0.6223272319084604,0.3776727680915396,away,CLE,over,7.5,0.5348837209302326,-115,0.5097020142727117,HOU,CLE,2023 REG,6,2,0,0,2,6,1,0,2,-2,0,0,0,0,0,0,0,0,0,0.5097020142727117,0.49029798572728833
91148,0.6491228070175439,0.3921568627450981,-185,155,0.6223272319084604,0.3776727680915396,home,HOU,under,7.5,0.5121951219512195,-105,0.49029798572728833,HOU,CLE,2023 REG,6,2,0,0,2,6,1,0,2,-2,0,0,0,0,0,0,0,0,0,0.5097020142727117,0.49029798572728833
91149,0.5652173913043479,0.47619047619047616,-130,110,0.5418129444594474,0.4581870555405526,away,WSH,over,7.5,0.5348837209302326,-115,0.5109810284308424,MIA,WSH,2023 REG,8,4,9,3,7,17,1,0,1,-1,1,1,1,0,0,0,0,0,0,0.5109810284308424,0.48901897156915763
91149,0.5652173913043479,0.47619047619047616,-130,110,0.5418129444594474,0.4581870555405526,home,MIA,under,7.5,0.5098039215686274,-104,0.48901897156915763,MIA,WSH,2023 REG,8,4,9,3,7,17,1,0,1,-1,1,1,1,0,0,0,0,0,0,0.5109810284308424,0.48901897156915763
91150,0.6226415094339623,0.41152263374485604,-165,143,0.6013694957565848,0.3986305042434152,away,CLE,over,7.5,0.5348837209302326,-115,0.5097020142727117,SD,CLE,2023 REG,8,6,9,3,9,17,1,0,3,-3,1,1,1,0,0,0,0,0,0,0.5097020142727117,0.49029798572728833
91150,0.6226415094339623,0.41152263374485604,-165,143,0.6013694957565848,0.3986305042434152,home,SD,under,7.5,0.5121951219512195,-105,0.49029798572728833,SD,CLE,2023 REG,8,6,9,3,9,17,1,0,3,-3,1,1,1,0,0,0,0,0,0,0.5097020142727117,0.49029798572728833
91151,0.4484304932735426,0.5918367346938775,123,-145,0.43037344037335423,0.5696265596266458,away,TEX,over,9.5,0.5283018867924528,-112,0.5044173060022736,BOS,TEX,2023 REG,13,10,12,6,16,25,1,0,4,-4,1,1,1,1,1,1,0,0,0,0.5044173060022736,0.49558269399772636
91151,0.4484304932735426,0.5918367346938775,123,-145,0.43037344037335423,0.5696265596266458,home,BOS,under,9.5,0.5169082125603864,-107,0.49558269399772636,BOS,TEX,2023 REG,13,10,12,6,16,25,1,0,4,-4,1,1,1,1,1,1,0,0,0,0.5044173060022736,0.49558269399772636
91152,0.6363636363636364,0.40322580645161293,-175,148,0.6111703545721141,0.3888296454278859,away,MIA,over,7.5,0.5348837209302326,-115,0.5097020142727117,NYM,MIA,2023 REG,8,5,5,2,7,13,1,0,3,-3,1,1,0,0,0,0,0,0,0,0.5097020142727117,0.49029798572728833
91152,0.6363636363636364,0.40322580645161293,-175,148,0.6111703545721141,0.3888296454278859,home,NYM,under,7.5,0.5121951219512195,-105,0.49029798572728833,NYM,MIA,2023 REG,8,5,5,2,7,13,1,0,3,-3,1,1,0,0,0,0,0,0,0,0.5097020142727117,0.49029798572728833
91153,0.5967741935483871,0.4444444444444444,-148,125,0.5721759741010521,0.42782402589894786,away,WSH,over,9,0.5370370370370371,-116,0.5118817074154765,PIT,WSH,2023 REG,11,5,6,1,6,17,1,0,4,-4,1,0,0,0,0,0,0,0,0,0.5118817074154765,0.48811829258452355
91153,0.5967741935483871,0.4444444444444444,-148,125,0.5721759741010521,0.42782402589894786,home,PIT,under,9,0.5098039215686274,-104,0.48811829258452355,PIT,WSH,2023 REG,11,5,6,1,6,17,1,0,4,-4,1,0,0,0,0,0,0,0,0,0.5118817074154765,0.48811829258452355
91154,0.5833333333333333,0.4504504504504505,-140,122,0.5636261261261261,0.43637387387387394,away,PIT,over,11.5,0.5348837209302326,-115,0.5097020142727117,COL,PIT,2023 REG,10,3,16,14,17,26,0,1,-11,11,1,1,1,0,0,0,0,0,0,0.5097020142727117,0.49029798572728833
91154,0.5833333333333333,0.4504504504504505,-140,122,0.5636261261261261,0.43637387387387394,home,COL,under,11.5,0.5121951219512195,-105,0.49029798572728833,COL,PIT,2023 REG,10,3,16,14,17,26,0,1,-11,11,1,1,1,0,0,0,0,0,0,0.5097020142727117,0.49029798572728833
91155,0.48309178743961345,0.5555555555555556,107,-125,0.4644215734322854,0.5355784265677146,away,PIT,over,9.5,0.5238095238095238,-110,0.5000596729920038,KC,PIT,2023 REG,4,1,6,4,5,10,0,1,-3,3,1,0,0,0,0,0,0,0,0,0.5000596729920038,0.4999403270079962
91155,0.48309178743961345,0.5555555555555556,107,-125,0.4644215734322854,0.5355784265677146,home,KC,under,9.5,0.5215311004784688,-109,0.4999403270079962,KC,PIT,2023 REG,4,1,6,4,5,10,0,1,-3,3,1,0,0,0,0,0,0,0,0,0.5000596729920038,0.4999403270079962
91156,0.4347826086956522,0.6031746031746031,130,-152,0.418279473099889,0.581720526900111,away,NYM,over,8,0.5370370370370371,-116,0.5131785224377817,MIL,NYM,2023 REG,13,9,8,0,9,21,1,0,9,-9,0,0,0,0,0,0,0,0,0,0.5131785224377817,0.4868214775622183
91156,0.4347826086956522,0.6031746031746031,130,-152,0.418279473099889,0.581720526900111,home,MIL,under,8,0.5073891625615764,-103,0.4868214775622183,MIL,NYM,2023 REG,13,9,8,0,9,21,1,0,9,-9,0,0,0,0,0,0,0,0,0,0.5131785224377817,0.4868214775622183
91157,0.35714285714285715,0.6875,180,-220,0.3411989795918367,0.6588010204081634,away,HOU,over,8.5,0.5305164319248826,-113,0.5053568787472517,OAK,HOU,2023 REG,6,1,5,3,4,11,0,1,-2,2,1,0,0,0,0,0,0,0,0,0.5053568787472517,0.49464312125274834
91157,0.35714285714285715,0.6875,180,-220,0.3411989795918367,0.6588010204081634,home,OAK,under,8.5,0.5169082125603864,-107,0.49464312125274834,OAK,HOU,2023 REG,6,1,5,3,4,11,0,1,-2,2,1,0,0,0,0,0,0,0,0,0.5053568787472517,0.49464312125274834
91158,0.7222222222222222,0.31746031746031744,-260,215,0.693562610229277,0.306437389770723,away,KC,over,9.5,0.5024875621890548,-101,0.47839724939301687,PHI,KC,2023 REG,9,5,11,7,12,20,0,1,-2,2,1,1,1,1,1,0,0,0,0,0.47839724939301687,0.5216027506069831
91158,0.7222222222222222,0.31746031746031744,-260,215,0.693562610229277,0.306437389770723,home,PHI,under,9.5,0.5454545454545454,-120,0.5216027506069831,PHI,KC,2023 REG,9,5,11,7,12,20,0,1,-2,2,1,1,1,1,1,0,0,0,0,0.47839724939301687,0.5216027506069831
91159,0.6503496503496503,0.38167938931297707,-186,162,0.6295195756040255,0.3704804243959745,away,PIT,over,8,0.5412844036697247,-118,0.5149381613977361,TB,PIT,2023 REG,5,3,4,2,5,9,1,0,1,-1,1,1,0,0,0,0,0,0,0,0.5149381613977361,0.48506183860226393
91159,0.6503496503496503,0.38167938931297707,-186,162,0.6295195756040255,0.3704804243959745,home,TB,under,8,0.5073891625615764,-103,0.48506183860226393,TB,PIT,2023 REG,5,3,4,2,5,9,1,0,1,-1,1,1,0,0,0,0,0,0,0,0.5149381613977361,0.48506183860226393
91160,0.5073891625615764,0.5370370370370371,-103,-116,0.48484779035144243,0.5151522096485576,away,BAL,over,9,0.5348837209302326,-115,0.5097020142727117,HOU,BAL,2023 REG,5,2,6,1,3,11,1,0,1,-1,1,0,0,0,0,0,0,0,0,0.5097020142727117,0.49029798572728833
91160,0.5073891625615764,0.5370370370370371,-103,-116,0.48484779035144243,0.5151522096485576,home,HOU,under,9,0.5121951219512195,-105,0.49029798572728833,HOU,BAL,2023 REG,5,2,6,1,3,11,1,0,1,-1,1,0,0,0,0,0,0,0,0,0.5097020142727117,0.49029798572728833
91161,0.3472222222222222,0.6923076923076923,188,-225,0.3334965574548908,0.6665034425451092,away,NYM,over,8.5,0.5169082125603864,-107,0.49239402434819424,DET,NYM,2023 REG,12,8,5,1,9,17,1,0,7,-7,1,0,0,0,0,0,0,0,0,0.49239402434819424,0.5076059756518058
91161,0.3472222222222222,0.6923076923076923,188,-225,0.3334965574548908,0.6665034425451092,home,DET,under,8.5,0.5305164319248826,-113,0.5076059756518058,DET,NYM,2023 REG,12,8,5,1,9,17,1,0,7,-7,1,0,0,0,0,0,0,0,0,0.49239402434819424,0.5076059756518058
91162,0.5370370370370371,0.504950495049505,-116,-102,0.514488177212783,0.48551182278721705,away,SEA,over,7.5,0.49019607843137253,104,0.46874141813588177,HOU,SEA,2023 REG,5,1,13,10,11,18,0,1,-9,9,1,0,0,0,0,0,0,0,0,0.46874141813588177,0.5312585818641182
91162,0.5370370370370371,0.504950495049505,-116,-102,0.514488177212783,0.48551182278721705,home,HOU,under,7.5,0.5535714285714286,-124,0.5312585818641182,HOU,SEA,2023 REG,5,1,13,10,11,18,0,1,-9,9,1,0,0,0,0,0,0,0,0,0.46874141813588177,0.5312585818641182
91163,0.3076923076923077,0.726027397260274,225,-265,0.2973170138607441,0.7026829861392558,away,TB,over,9.5,0.5391705069124424,-117,0.5140669063204599,CIN,TB,2023 REG,5,0,12,8,8,17,0,1,-8,8,0,0,0,0,0,0,0,0,0,0.5140669063204599,0.4859330936795401
91163,0.3076923076923077,0.726027397260274,225,-265,0.2973170138607441,0.7026829861392558,home,CIN,under,9.5,0.5073891625615764,-103,0.4859330936795401,CIN,TB,2023 REG,5,0,12,8,8,17,0,1,-8,8,0,0,0,0,0,0,0,0,0,0.5140669063204599,0.4859330936795401
91164,0.49504950495049505,0.5475113122171946,102,-121,0.4739797934813417,0.5260202065186583,away,NYM,over,9,0.5454545454545454,-120,0.5206611570247933,WSH,NYM,2023 REG,4,2,10,3,5,14,0,1,-1,1,1,1,0,0,0,0,0,0,0,0.5206611570247933,0.4793388429752067
91164,0.49504950495049505,0.5475113122171946,102,-121,0.4739797934813417,0.5260202065186583,home,WSH,under,9,0.5,100,0.4793388429752067,WSH,NYM,2023 REG,4,2,10,3,5,14,0,1,-1,1,1,1,0,0,0,0,0,0,0,0.5206611570247933,0.4793388429752067
91165,0.574468085106383,0.46511627906976744,-135,115,0.5517281312179562,0.44827186878204384,away,NYM,over,11,0.5,100,0.4772727272727273,BOS,NYM,2023 REG,15,6,6,1,7,21,1,0,5,-5,1,0,0,0,0,0,0,0,0,0.4772727272727273,0.5227272727272727
91165,0.574468085106383,0.46511627906976744,-135,115,0.5517281312179562,0.44827186878204384,home,BOS,under,11,0.5454545454545454,-120,0.5227272727272727,BOS,NYM,2023 REG,15,6,6,1,7,21,1,0,5,-5,1,0,0,0,0,0,0,0,0,0.4772727272727273,0.5227272727272727
91166,0.6183206106870228,0.4166666666666667,-162,140,0.5966872559874133,0.40331274401258665,away,PHI,over,8.5,0.5238095238095238,-110,0.4988662131519274,NYY,PHI,2023 REG,4,1,10,4,5,14,0,1,-3,3,1,0,0,0,0,0,0,0,0,0.4988662131519274,0.5011337868480725
91166,0.6183206106870228,0.4166666666666667,-162,140,0.5966872559874133,0.40331274401258665,home,NYY,under,8.5,0.5238095238095238,-110,0.5011337868480725,NYY,PHI,2023 REG,4,1,10,4,5,14,0,1,-3,3,1,0,0,0,0,0,0,0,0,0.4988662131519274,0.5011337868480725
91167,0.7530864197530864,0.2777777777777778,-305,260,0.7298430117360157,0.27015698826398427,away,COL,over,8.5,0.5238095238095238,-110,0.4988662131519274,PHI,COL,2023 REG,8,9,7,3,12,15,1,0,6,-6,1,1,1,0,0,0,0,0,0,0.4988662131519274,0.5011337868480725
91167,0.7530864197530864,0.2777777777777778,-305,260,0.7298430117360157,0.27015698826398427,home,PHI,under,8.5,0.5238095238095238,-110,0.5011337868480725,PHI,COL,2023 REG,8,9,7,3,12,15,1,0,6,-6,1,1,1,0,0,0,0,0,0,0.4988662131519274,0.5011337868480725
91168,0.48780487804878053,0.5555555555555556,105,-125,0.4666534470222751,0.5333465529777248,away,SEA,over,8,0.5391705069124424,-117,0.5140669063204599,TB,SEA,2023 REG,4,0,5,1,1,9,0,1,-1,1,0,0,0,0,0,0,0,0,0,0.5140669063204599,0.4859330936795401
91168,0.48780487804878053,0.5555555555555556,105,-125,0.4666534470222751,0.5333465529777248,home,TB,under,8,0.5073891625615764,-103,0.4859330936795401,TB,SEA,2023 REG,4,0,5,1,1,9,0,1,-1,1,0,0,0,0,0,0,0,0,0,0.5140669063204599,0.4859330936795401
91169,0.4347826086956522,0.6031746031746031,130,-152,0.418279473099889,0.581720526900111,away,TB,over,8.5,0.5098039215686274,-104,0.48483656587239576,DET,TB,2023 REG,12,4,7,2,6,19,1,0,2,-2,1,1,0,0,0,0,0,0,0,0.48483656587239576,0.5151634341276042
91169,0.4347826086956522,0.6031746031746031,130,-152,0.418279473099889,0.581720526900111,home,DET,under,8.5,0.5391705069124424,-117,0.5151634341276042,DET,TB,2023 REG,12,4,7,2,6,19,1,0,2,-2,1,1,0,0,0,0,0,0,0,0.48483656587239576,0.5151634341276042
91170,0.37453183520599254,0.6677740863787376,167,-201,0.35868692075478276,0.6413130792452173,away,SD,over,9.5,0.5,100,0.4772727272727273,CWS,SD,2023 REG,7,1,7,2,3,14,0,1,-1,1,1,0,0,0,0,0,0,0,0,0.4772727272727273,0.5227272727272727
91170,0.37453183520599254,0.6677740863787376,167,-201,0.35868692075478276,0.6413130792452173,home,CWS,under,9.5,0.5454545454545454,-120,0.5227272727272727,CWS,SD,2023 REG,7,1,7,2,3,14,0,1,-1,1,1,0,0,0,0,0,0,0,0,0.4772727272727273,0.5227272727272727
91171,0.4424778761061947,0.5967741935483871,126,-148,0.4251097036926629,0.5748902963073371,away,TB,over,9,0.5348837209302326,-115,0.5097020142727117,DET,TB,2023 REG,3,0,13,8,8,16,0,1,-8,8,0,0,0,0,0,0,0,0,0,0.5097020142727117,0.49029798572728833
91171,0.4424778761061947,0.5967741935483871,126,-148,0.4251097036926629,0.5748902963073371,home,DET,under,9,0.5121951219512195,-105,0.49029798572728833,DET,TB,2023 REG,3,0,13,8,8,16,0,1,-8,8,0,0,0,0,0,0,0,0,0,0.5097020142727117,0.49029798572728833
91172,0.5515695067264574,0.49019607843137253,-123,104,0.5285328835228112,0.47146711647718875,away,MIL,over,9,0.5454545454545454,-120,0.5193043049216726,CIN,MIL,2023 REG,1,0,7,3,3,8,0,1,-3,3,0,0,0,0,0,0,0,0,0,0.5193043049216726,0.48069569507832743
91172,0.5515695067264574,0.49019607843137253,-123,104,0.5285328835228112,0.47146711647718875,home,CIN,under,9,0.5024875621890548,-101,0.48069569507832743,CIN,MIL,2023 REG,1,0,7,3,3,8,0,1,-3,3,0,0,0,0,0,0,0,0,0,0.5193043049216726,0.48069569507832743
91173,0.574468085106383,0.46511627906976744,-135,115,0.5517281312179562,0.44827186878204384,away,STL,over,10.5,0.5238095238095238,-110,0.4988662131519274,BOS,STL,2023 REG,10,3,4,4,7,14,0,1,-1,1,1,1,1,0,0,0,0,0,0,0.4988662131519274,0.5011337868480725
91173,0.574468085106383,0.46511627906976744,-135,115,0.5517281312179562,0.44827186878204384,home,BOS,under,10.5,0.5238095238095238,-110,0.5011337868480725,BOS,STL,2023 REG,10,3,4,4,7,14,0,1,-1,1,1,1,1,0,0,0,0,0,0,0.4988662131519274,0.5011337868480725
91174,0.5412844036697247,0.504950495049505,-118,-102,0.5162581740877563,0.4837418259122437,away,NYM,over,9.5,0.5283018867924528,-112,0.5031902949311281,KC,NYM,2023 REG,13,9,5,2,11,18,1,0,7,-7,1,1,0,0,0,0,0,0,0,0.5031902949311281,0.4968097050688719
91174,0.5412844036697247,0.504950495049505,-118,-102,0.5162581740877563,0.4837418259122437,home,KC,under,9.5,0.5192307692307692,-108,0.4968097050688719,KC,NYM,2023 REG,13,9,5,2,11,18,1,0,7,-7,1,1,0,0,0,0,0,0,0,0.5031902949311281,0.4968097050688719
91175,0.6825396825396826,0.35714285714285715,-215,180,0.6554547745023935,0.34454522549760647,away,PIT,over,7.5,0.5348837209302326,-115,0.5097020142727117,MIL,PIT,2023 REG,4,1,6,4,5,10,0,1,-3,3,1,0,0,0,0,0,0,0,0,0.5097020142727117,0.49029798572728833
91175,0.6825396825396826,0.35714285714285715,-215,180,0.6554547745023935,0.34454522549760647,home,MIL,under,7.5,0.5121951219512195,-105,0.49029798572728833,MIL,PIT,2023 REG,4,1,6,4,5,10,0,1,-3,3,1,0,0,0,0,0,0,0,0,0.5097020142727117,0.49029798572728833
91176,0.726027397260274,0.3125,-265,220,0.6980554513041847,0.30194454869581533,away,WSH,over,9,0.5370370370370371,-116,0.5118817074154765,PHI,WSH,2023 REG,10,4,8,5,9,18,0,1,-1,1,1,1,1,1,0,0,0,0,0,0.5118817074154765,0.48811829258452355
91176,0.726027397260274,0.3125,-265,220,0.6980554513041847,0.30194454869581533,home,PHI,under,9,0.5098039215686274,-104,0.48811829258452355,PHI,WSH,2023 REG,10,4,8,5,9,18,0,1,-1,1,1,1,1,1,0,0,0,0,0,0.5118817074154765,0.48811829258452355
91177,0.6515679442508712,0.3861003861003861,-187,159,0.6270244676805398,0.37297553231946023,away,ARI,over,7.5,0.5283018867924528,-112,0.5044173060022736,LAD,ARI,2023 REG,16,9,6,1,10,22,1,0,8,-8,1,0,0,0,0,0,0,0,0,0.5044173060022736,0.49558269399772636
91177,0.6515679442508712,0.3861003861003861,-187,159,0.6270244676805398,0.37297553231946023,home,LAD,under,7.5,0.5169082125603864,-107,0.49558269399772636,LAD,ARI,2023 REG,16,9,6,1,10,22,1,0,8,-8,1,0,0,0,0,0,0,0,0,0.5044173060022736,0.49558269399772636
91178,0.7333333333333333,0.3105590062111801,-275,222,0.7011456176673567,0.2988543823326433,away,WSH,over,8,0.5238095238095238,-110,0.5000596729920038,MIL,WSH,2023 REG,14,9,9,5,14,23,1,0,4,-4,1,1,1,1,1,0,0,0,0,0.5000596729920038,0.4999403270079962
91178,0.7333333333333333,0.3105590062111801,-275,222,0.7011456176673567,0.2988543823326433,home,MIL,under,8,0.5215311004784688,-109,0.4999403270079962,MIL,WSH,2023 REG,14,9,9,5,14,23,1,0,4,-4,1,1,1,1,1,0,0,0,0,0.5000596729920038,0.4999403270079962
91179,0.5454545454545454,0.5,-120,100,0.5206611570247933,0.4793388429752067,away,BAL,over,9.5,0.5238095238095238,-110,0.4988662131519274,PHI,BAL,2023 REG,7,2,5,3,5,12,0,1,-1,1,1,1,0,0,0,0,0,0,0,0.4988662131519274,0.5011337868480725
91179,0.5454545454545454,0.5,-120,100,0.5206611570247933,0.4793388429752067,home,PHI,under,9.5,0.5238095238095238,-110,0.5011337868480725,PHI,BAL,2023 REG,7,2,5,3,5,12,0,1,-1,1,1,1,0,0,0,0,0,0,0,0.4988662131519274,0.5011337868480725
91180,0.4716981132075471,0.5652173913043479,112,-130,0.4542851393811816,0.5457148606188185,away,TB,over,8,0.5327102803738317,-114,0.5075272610403079,BAL,TB,2023 REG,7,4,8,2,6,15,1,0,2,-2,1,1,0,0,0,0,0,0,0,0.5075272610403079,0.4924727389596921
91180,0.4716981132075471,0.5652173913043479,112,-130,0.4542851393811816,0.5457148606188185,home,BAL,under,8,0.5145631067961165,-106,0.4924727389596921,BAL,TB,2023 REG,7,4,8,2,6,15,1,0,2,-2,1,1,0,0,0,0,0,0,0,0.5075272610403079,0.4924727389596921
91181,0.6047430830039526,0.4347826086956522,-153,130,0.5808401943476698,0.41915980565233024,away,BAL,over,9,0.5,100,0.4772727272727273,MIN,BAL,2023 REG,4,2,17,15,17,21,0,1,-13,13,1,1,0,0,0,0,0,0,0,0.4772727272727273,0.5227272727272727
91181,0.6047430830039526,0.4347826086956522,-153,130,0.5808401943476698,0.41915980565233024,home,MIN,under,9,0.5454545454545454,-120,0.5227272727272727,MIN,BAL,2023 REG,4,2,17,15,17,21,0,1,-13,13,1,1,0,0,0,0,0,0,0,0.4772727272727273,0.5227272727272727
91182,0.5633187772925764,0.47619047619047616,-129,110,0.5410624729287608,0.45893752707123925,away,PHI,over,9,0.5073891625615764,-103,0.48057683780462784,ATL,PHI,2023 REG,4,1,9,2,3,13,0,1,-1,1,1,0,0,0,0,0,0,0,0,0.48057683780462784,0.5194231621953722
91182,0.5633187772925764,0.47619047619047616,-129,110,0.5410624729287608,0.45893752707123925,home,ATL,under,9,0.5454545454545454,-120,0.5194231621953722,ATL,PHI,2023 REG,4,1,9,2,3,13,0,1,-1,1,1,0,0,0,0,0,0,0,0,0.48057683780462784,0.5194231621953722
91183,0.47846889952153115,0.5594713656387665,109,-127,0.4603156626027285,0.5396843373972715,away,TB,over,7.5,0.5169082125603864,-107,0.49353874091423283,MIA,TB,2023 REG,4,0,5,3,3,9,0,1,-3,3,0,0,0,0,0,0,0,0,0,0.49353874091423283,0.5064612590857671
91183,0.47846889952153115,0.5594713656387665,109,-127,0.4603156626027285,0.5396843373972715,home,MIA,under,7.5,0.5283018867924528,-112,0.5064612590857671,MIA,TB,2023 REG,4,0,5,3,3,9,0,1,-3,3,0,0,0,0,0,0,0,0,0,0.49353874091423283,0.5064612590857671
91184,0.4,0.6453900709219857,150,-182,0.38184397163120565,0.6181560283687944,away,CLE,over,9.5,0.5098039215686274,-104,0.48483656587239576,WSH,CLE,2023 REG,11,4,11,6,10,22,0,1,-2,2,1,1,1,1,0,0,0,0,0,0.48483656587239576,0.5151634341276042
91184,0.4,0.6453900709219857,150,-182,0.38184397163120565,0.6181560283687944,home,WSH,under,9.5,0.5391705069124424,-117,0.5151634341276042,WSH,CLE,2023 REG,11,4,11,6,10,22,0,1,-2,2,1,1,1,1,0,0,0,0,0,0.48483656587239576,0.5151634341276042
91185,0.4065040650406504,0.6363636363636364,146,-175,0.389078170160859,0.610921829839141,away,SF,over,12,0.5145631067961165,-106,0.49023796582517226,COL,SF,2023 REG,9,9,7,5,14,16,1,0,4,-4,1,1,1,1,1,0,0,0,0,0.49023796582517226,0.5097620341748277
91185,0.4065040650406504,0.6363636363636364,146,-175,0.389078170160859,0.610921829839141,home,COL,under,12,0.5327102803738317,-114,0.5097620341748277,COL,SF,2023 REG,9,9,7,5,14,16,1,0,4,-4,1,1,1,1,1,0,0,0,0,0.49023796582517226,0.5097620341748277
91186,0.3861003861003861,0.6515679442508712,159,-187,0.3715566292080088,0.6284433707919912,away,MIN,over,7.5,0.5238095238095238,-110,0.5000596729920038,OAK,MIN,2023 REG,7,4,6,5,9,13,0,1,-1,1,1,1,1,1,0,0,0,0,0,0.5000596729920038,0.4999403270079962
91186,0.3861003861003861,0.6515679442508712,159,-187,0.3715566292080088,0.6284433707919912,home,OAK,under,7.5,0.5215311004784688,-109,0.4999403270079962,OAK,MIN,2023 REG,7,4,6,5,9,13,0,1,-1,1,1,1,1,1,0,0,0,0,0,0.5000596729920038,0.4999403270079962
91187,0.6428571428571428,0.3921568627450981,-180,155,0.6203481392557023,0.3796518607442977,away,CHC,over,8,0.5145631067961165,-106,0.4913668392989033,SD,CHC,2023 REG,10,6,2,0,6,12,1,0,6,-6,0,0,0,0,0,0,0,0,0,0.4913668392989033,0.5086331607010968
91187,0.6428571428571428,0.3921568627450981,-180,155,0.6203481392557023,0.3796518607442977,home,SD,under,8,0.5305164319248826,-113,0.5086331607010968,SD,CHC,2023 REG,10,6,2,0,6,12,1,0,6,-6,0,0,0,0,0,0,0,0,0,0.4913668392989033,0.5086331607010968
91188,0.5454545454545454,0.49504950495049505,-120,102,0.5233614270517961,0.4766385729482039,away,NYY,over,9,0.5145631067961165,-106,0.49023796582517226,BOS,NYY,2023 REG,10,5,6,0,5,16,1,0,5,-5,0,0,0,0,0,0,0,0,0,0.49023796582517226,0.5097620341748277
91188,0.5454545454545454,0.49504950495049505,-120,102,0.5233614270517961,0.4766385729482039,home,BOS,under,9,0.5327102803738317,-114,0.5097620341748277,BOS,NYY,2023 REG,10,5,6,0,5,16,1,0,5,-5,0,0,0,0,0,0,0,0,0,0.49023796582517226,0.5097620341748277
91189,0.5098039215686274,0.5348837209302326,-104,-115,0.4870219861770517,0.5129780138229483,away,PHI,over,9.5,0.5238095238095238,-110,0.5000596729920038,CIN,PHI,2023 REG,14,13,5,0,13,19,1,0,13,-13,0,0,0,0,0,0,0,0,0,0.5000596729920038,0.4999403270079962
91189,0.5098039215686274,0.5348837209302326,-104,-115,0.4870219861770517,0.5129780138229483,home,CIN,under,9.5,0.5215311004784688,-109,0.4999403270079962,CIN,PHI,2023 REG,14,13,5,0,13,19,1,0,13,-13,0,0,0,0,0,0,0,0,0,0.5000596729920038,0.4999403270079962
91190,0.5073891625615764,0.5348837209302326,-103,-115,0.4859403596076043,0.5140596403923957,away,MIN,over,7.5,0.5327102803738317,-114,0.5075272610403079,DET,MIN,2023 REG,11,6,6,0,6,17,1,0,6,-6,0,0,0,0,0,0,0,0,0,0.5075272610403079,0.4924727389596921
91190,0.5073891625615764,0.5348837209302326,-103,-115,0.4859403596076043,0.5140596403923957,home,DET,under,7.5,0.5145631067961165,-106,0.4924727389596921,DET,MIN,2023 REG,11,6,6,0,6,17,1,0,6,-6,0,0,0,0,0,0,0,0,0,0.5075272610403079,0.4924727389596921
91191,0.5327102803738317,0.5098039215686274,-114,-104,0.5100625279371946,0.48993747206280536,away,SF,over,9.5,0.5073891625615764,-103,0.4837652908580103,CIN,SF,2023 REG,12,5,2,1,6,14,1,0,4,-4,1,0,0,0,0,0,0,0,0,0.4837652908580103,0.5162347091419897
91191,0.5327102803738317,0.5098039215686274,-114,-104,0.5100625279371946,0.48993747206280536,home,CIN,under,9.5,0.5391705069124424,-117,0.5162347091419897,CIN,SF,2023 REG,12,5,2,1,6,14,1,0,4,-4,1,0,0,0,0,0,0,0,0,0.4837652908580103,0.5162347091419897
91192,0.6774193548387096,0.36363636363636365,-210,175,0.6496074165168858,0.3503925834831142,away,PIT,over,8.5,0.5215311004784688,-109,0.4978845547971712,LAD,PIT,2023 REG,7,5,4,2,7,11,1,0,3,-3,1,1,0,0,0,0,0,0,0,0.4978845547971712,0.5021154452028288
91192,0.6774193548387096,0.36363636363636365,-210,175,0.6496074165168858,0.3503925834831142,home,LAD,under,8.5,0.5238095238095238,-110,0.5021154452028288,LAD,PIT,2023 REG,7,5,4,2,7,11,1,0,3,-3,1,1,0,0,0,0,0,0,0,0.4978845547971712,0.5021154452028288
91193,0.5652173913043479,0.4716981132075471,-130,112,0.5443521061454507,0.4556478938545493,away,MIN,over,8.5,0.5475113122171946,-121,0.5214983313199976,LAA,MIN,2023 REG,8,2,12,6,8,20,0,1,-4,4,1,1,0,0,0,0,0,0,0,0.5214983313199976,0.47850166868000243
91193,0.5652173913043479,0.4716981132075471,-130,112,0.5443521061454507,0.4556478938545493,home,LAA,under,8.5,0.5,100,0.47850166868000243,LAA,MIN,2023 REG,8,2,12,6,8,20,0,1,-4,4,1,1,0,0,0,0,0,0,0,0.5214983313199976,0.47850166868000243
91194,0.6825396825396826,0.35714285714285715,-215,180,0.6554547745023935,0.34454522549760647,away,COL,over,7,0.5391705069124424,-117,0.5127649394825569,SD,COL,2023 REG,7,2,17,7,9,24,0,1,-5,5,1,1,0,0,0,0,0,0,0,0.5127649394825569,0.48723506051744314
91194,0.6825396825396826,0.35714285714285715,-215,180,0.6554547745023935,0.34454522549760647,home,SD,under,7,0.5098039215686274,-104,0.48723506051744314,SD,COL,2023 REG,7,2,17,7,9,24,0,1,-5,5,1,1,0,0,0,0,0,0,0,0.5127649394825569,0.48723506051744314
91195,0.5535714285714286,0.4854368932038835,-124,106,0.5319775361600951,0.46802246383990487,away,MIN,over,7.5,0.5121951219512195,-105,0.48919479393107135,SEA,MIN,2023 REG,8,5,5,0,5,13,1,0,5,-5,0,0,0,0,0,0,0,0,0,0.48919479393107135,0.5108052060689287
91195,0.5535714285714286,0.4854368932038835,-124,106,0.5319775361600951,0.46802246383990487,home,SEA,under,7.5,0.5327102803738317,-114,0.5108052060689287,SEA,MIN,2023 REG,8,5,5,0,5,13,1,0,5,-5,0,0,0,0,0,0,0,0,0,0.48919479393107135,0.5108052060689287
91196,0.6774193548387096,0.35714285714285715,-210,180,0.6540062434963579,0.34599375650364206,away,WSH,over,8,0.5391705069124424,-117,0.5140669063204599,NYM,WSH,2023 REG,4,1,8,4,5,12,0,1,-3,3,1,0,0,0,0,0,0,0,0,0.5140669063204599,0.4859330936795401
91196,0.6774193548387096,0.35714285714285715,-210,180,0.6540062434963579,0.34599375650364206,home,NYM,under,8,0.5073891625615764,-103,0.4859330936795401,NYM,WSH,2023 REG,4,1,8,4,5,12,0,1,-3,3,1,0,0,0,0,0,0,0,0,0.5140669063204599,0.4859330936795401
91197,0.5073891625615764,0.5348837209302326,-103,-115,0.4859403596076043,0.5140596403923957,away,NYM,over,8.5,0.504950495049505,-102,0.47949844489399435,NYY,NYM,2023 REG,5,3,12,9,12,17,0,1,-6,6,1,1,1,0,0,0,0,0,0,0.47949844489399435,0.5205015551060057
91197,0.5073891625615764,0.5348837209302326,-103,-115,0.4859403596076043,0.5140596403923957,home,NYY,under,8.5,0.5454545454545454,-120,0.5205015551060057,NYY,NYM,2023 REG,5,3,12,9,12,17,0,1,-6,6,1,1,1,0,0,0,0,0,0,0.47949844489399435,0.5205015551060057
91198,0.5815899581589958,0.4587155963302753,-139,118,0.5581486524100054,0.44185134758999456,away,SF,over,8,0.5348837209302326,-115,0.5097020142727117,SD,SF,2023 REG,13,7,9,3,10,22,1,0,4,-4,1,1,1,0,0,0,0,0,0,0.5097020142727117,0.49029798572728833
91198,0.5815899581589958,0.4587155963302753,-139,118,0.5581486524100054,0.44185134758999456,home,SD,under,8,0.5121951219512195,-105,0.49029798572728833,SD,SF,2023 REG,13,7,9,3,10,22,1,0,4,-4,1,1,1,0,0,0,0,0,0,0.5097020142727117,0.49029798572728833
91199,0.5348837209302326,0.5073891625615764,-115,-103,0.5122726437136835,0.48772735628631647,away,ARI,over,11,0.5348837209302326,-115,0.5097020142727117,CIN,ARI,2023 REG,9,9,7,6,15,16,1,0,3,-3,1,1,1,1,1,1,0,0,0,0.5097020142727117,0.49029798572728833
91199,0.5348837209302326,0.5073891625615764,-115,-103,0.5122726437136835,0.48772735628631647,home,CIN,under,11,0.5121951219512195,-105,0.49029798572728833,CIN,ARI,2023 REG,9,9,7,6,15,16,1,0,3,-3,1,1,1,1,1,1,0,0,0,0.5097020142727117,0.49029798572728833
91200,0.6666666666666666,0.37037037037037035,-200,170,0.6419753086419753,0.3580246913580247,away,WSH,over,8,0.5283018867924528,-112,0.5044173060022736,HOU,WSH,2023 REG,7,1,11,4,5,18,0,1,-3,3,1,0,0,0,0,0,0,0,0,0.5044173060022736,0.49558269399772636
91200,0.6666666666666666,0.37037037037037035,-200,170,0.6419753086419753,0.3580246913580247,home,HOU,under,8,0.5169082125603864,-107,0.49558269399772636,HOU,WSH,2023 REG,7,1,11,4,5,18,0,1,-3,3,1,0,0,0,0,0,0,0,0,0.5044173060022736,0.49558269399772636
91201,0.7590361445783133,0.28169014084507044,-315,255,0.7281234219075522,0.2718765780924478,away,OAK,over,8.5,0.5348837209302326,-115,0.5097020142727117,HOU,OAK,2023 REG,6,2,10,6,8,16,0,1,-4,4,1,1,0,0,0,0,0,0,0,0.5097020142727117,0.49029798572728833
91201,0.7590361445783133,0.28169014084507044,-315,255,0.7281234219075522,0.2718765780924478,home,HOU,under,8.5,0.5121951219512195,-105,0.49029798572728833,HOU,OAK,2023 REG,6,2,10,6,8,16,0,1,-4,4,1,1,0,0,0,0,0,0,0,0.5097020142727117,0.49029798572728833
91202,0.726027397260274,0.31746031746031744,-265,215,0.6944541249288857,0.3055458750711143,away,OAK,over,8.5,0.5454545454545454,-120,0.5220180091279142,TEX,OAK,2023 REG,18,18,7,3,21,25,1,0,15,-15,1,1,1,0,0,0,0,0,0,0.5220180091279142,0.4779819908720858
91202,0.726027397260274,0.31746031746031744,-265,215,0.6944541249288857,0.3055458750711143,home,TEX,under,8.5,0.49751243781094534,101,0.4779819908720858,TEX,OAK,2023 REG,18,18,7,3,21,25,1,0,15,-15,1,1,1,0,0,0,0,0,0,0.5220180091279142,0.4779819908720858
91203,0.4694835680751174,0.574468085106383,113,-135,0.44884898911666654,0.5511510108833335,away,SD,over,8,0.5073891625615764,-103,0.4837652908580103,SF,SD,2023 REG,3,0,7,4,4,10,0,1,-4,4,0,0,0,0,0,0,0,0,0,0.4837652908580103,0.5162347091419897
91203,0.4694835680751174,0.574468085106383,113,-135,0.44884898911666654,0.5511510108833335,home,SF,under,8,0.5391705069124424,-117,0.5162347091419897,SF,SD,2023 REG,3,0,7,4,4,10,0,1,-4,4,0,0,0,0,0,0,0,0,0,0.4837652908580103,0.5162347091419897
91204,0.4166666666666667,0.6226415094339623,140,-165,0.4002882599580712,0.5997117400419287,away,TEX,over,9,0.5215311004784688,-109,0.4978845547971712,ARI,TEX,2023 REG,7,4,5,3,7,12,1,0,1,-1,1,1,1,0,0,0,0,0,0,0.4978845547971712,0.5021154452028288
91204,0.4166666666666667,0.6226415094339623,140,-165,0.4002882599580712,0.5997117400419287,home,ARI,under,9,0.5238095238095238,-110,0.5021154452028288,ARI,TEX,2023 REG,7,4,5,3,7,12,1,0,1,-1,1,1,1,0,0,0,0,0,0,0.4978845547971712,0.5021154452028288
91205,0.47619047619047616,0.5652173913043479,110,-130,0.4564724440500838,0.5435275559499162,away,DET,over,7.5,0.5121951219512195,-105,0.48808156828023186,LAA,DET,2023 REG,6,2,15,11,13,21,0,1,-9,9,1,1,0,0,0,0,0,0,0,0.48808156828023186,0.5119184317197681
91205,0.47619047619047616,0.5652173913043479,110,-130,0.4564724440500838,0.5435275559499162,home,LAA,under,7.5,0.5348837209302326,-115,0.5119184317197681,LAA,DET,2023 REG,6,2,15,11,13,21,0,1,-9,9,1,1,0,0,0,0,0,0,0,0.48808156828023186,0.5119184317197681
91206,0.425531914893617,0.6108949416342413,135,-157,0.41003112488176247,0.5899688751182375,away,STL,over,9,0.5121951219512195,-105,0.48808156828023186,WSH,STL,2023 REG,10,3,7,0,3,17,1,0,3,-3,0,0,0,0,0,0,0,0,0,0.48808156828023186,0.5119184317197681
91206,0.425531914893617,0.6108949416342413,135,-157,0.41003112488176247,0.5899688751182375,home,WSH,under,9,0.5348837209302326,-115,0.5119184317197681,WSH,STL,2023 REG,10,3,7,0,3,17,1,0,3,-3,0,0,0,0,0,0,0,0,0,0.48808156828023186,0.5119184317197681
91207,0.5901639344262295,0.4504504504504505,-144,122,0.5661947892531068,0.43380521074689316,away,MIN,over,8,0.5327102803738317,-114,0.5075272610403079,MIL,MIN,2023 REG,11,8,10,7,15,21,1,0,1,-1,1,1,1,1,1,1,1,0,0,0.5075272610403079,0.4924727389596921
91207,0.5901639344262295,0.4504504504504505,-144,122,0.5661947892531068,0.43380521074689316,home,MIL,under,8,0.5145631067961165,-106,0.4924727389596921,MIL,MIN,2023 REG,11,8,10,7,15,21,1,0,1,-1,1,1,1,1,1,1,1,0,0,0.5075272610403079,0.4924727389596921
91208,0.40322580645161293,0.6363636363636364,148,-175,0.387262321445464,0.612737678554536,away,TOR,over,10.5,0.5098039215686274,-104,0.4870219861770517,KC,TOR,2023 REG,4,1,11,4,5,15,0,1,-3,3,1,0,0,0,0,0,0,0,0,0.4870219861770517,0.5129780138229483
91208,0.40322580645161293,0.6363636363636364,148,-175,0.387262321445464,0.612737678554536,home,KC,under,10.5,0.5348837209302326,-115,0.5129780138229483,KC,TOR,2023 REG,4,1,11,4,5,15,0,1,-3,3,1,0,0,0,0,0,0,0,0,0.4870219861770517,0.5129780138229483
91209,0.5670995670995671,0.4739336492890995,-131,111,0.5438296478488513,0.45617035215114865,away,TOR,over,10,0.5121951219512195,-105,0.48808156828023186,LAD,TOR,2023 REG,8,1,11,8,9,19,0,1,-7,7,1,0,0,0,0,0,0,0,0,0.48808156828023186,0.5119184317197681
91209,0.5670995670995671,0.4739336492890995,-131,111,0.5438296478488513,0.45617035215114865,home,LAD,under,10,0.5348837209302326,-115,0.5119184317197681,LAD,TOR,2023 REG,8,1,11,8,9,19,0,1,-7,7,1,0,0,0,0,0,0,0,0,0.48808156828023186,0.5119184317197681
91210,0.6254681647940076,0.41152263374485604,-167,143,0.6023315979176397,0.3976684020823603,away,STL,over,8.5,0.5391705069124424,-117,0.5127649394825569,TB,STL,2023 REG,12,4,6,2,6,18,1,0,2,-2,1,1,0,0,0,0,0,0,0,0.5127649394825569,0.48723506051744314
91210,0.6254681647940076,0.41152263374485604,-167,143,0.6023315979176397,0.3976684020823603,home,TB,under,8.5,0.5098039215686274,-104,0.48723506051744314,TB,STL,2023 REG,12,4,6,2,6,18,1,0,2,-2,1,1,0,0,0,0,0,0,0,0.5127649394825569,0.48723506051744314
91211,0.36764705882352944,0.6688741721854304,172,-202,0.3542201356584706,0.6457798643415293,away,TOR,over,12,0.5260663507109005,-111,0.5010269332605688,COL,TOR,2023 REG,11,9,17,13,22,28,0,1,-4,4,1,1,1,1,1,1,1,1,1,0.5010269332605688,0.4989730667394312
91211,0.36764705882352944,0.6688741721854304,172,-202,0.3542201356584706,0.6457798643415293,home,COL,under,12,0.5215311004784688,-109,0.4989730667394312,COL,TOR,2023 REG,11,9,17,13,22,28,0,1,-4,4,1,1,1,1,1,1,1,1,1,0.5010269332605688,0.4989730667394312
91212,0.7118155619596541,0.3367003367003367,-247,197,0.6772811902910151,0.3227188097089849,away,COL,over,8.5,0.5454545454545454,-120,0.5166307047184789,CHC,COL,2023 REG,7,6,6,0,6,13,1,0,6,-6,0,0,0,0,0,0,0,0,0,0.5166307047184789,0.48336929528152106
91212,0.7118155619596541,0.3367003367003367,-247,197,0.6772811902910151,0.3227188097089849,home,CHC,under,8.5,0.5073891625615764,-103,0.48336929528152106,CHC,COL,2023 REG,7,6,6,0,6,13,1,0,6,-6,0,0,0,0,0,0,0,0,0,0.5166307047184789,0.48336929528152106
91213,0.5121951219512195,0.5305164319248826,-105,-113,0.4903184724049234,0.5096815275950766,away,BOS,over,9,0.5348837209302326,-115,0.5097020142727117,ARI,BOS,2023 REG,3,1,6,2,3,9,0,1,-1,1,1,0,0,0,0,0,0,0,0,0.5097020142727117,0.49029798572728833
91213,0.5121951219512195,0.5305164319248826,-105,-113,0.4903184724049234,0.5096815275950766,home,ARI,under,9,0.5121951219512195,-105,0.49029798572728833,ARI,BOS,2023 REG,3,1,6,2,3,9,0,1,-1,1,1,0,0,0,0,0,0,0,0,0.5097020142727117,0.49029798572728833
91214,0.5121951219512195,0.5305164319248826,-105,-113,0.4903184724049234,0.5096815275950766,away,DET,over,7.5,0.5348837209302326,-115,0.5097020142727117,CLE,DET,2023 REG,4,1,8,4,5,12,0,1,-3,3,1,0,0,0,0,0,0,0,0,0.5097020142727117,0.49029798572728833
91214,0.5121951219512195,0.5305164319248826,-105,-113,0.4903184724049234,0.5096815275950766,home,CLE,under,7.5,0.5121951219512195,-105,0.49029798572728833,CLE,DET,2023 REG,4,1,8,4,5,12,0,1,-3,3,1,0,0,0,0,0,0,0,0,0.5097020142727117,0.49029798572728833
91215,0.5850622406639003,0.4608294930875576,-141,117,0.5582127200873213,0.44178727991267874,away,STL,over,9.5,0.5348837209302326,-115,0.5097020142727117,CIN,STL,2023 REG,10,7,1,1,8,11,1,0,6,-6,1,0,0,0,0,0,0,0,0,0.5097020142727117,0.49029798572728833
91215,0.5850622406639003,0.4608294930875576,-141,117,0.5582127200873213,0.44178727991267874,home,CIN,under,9.5,0.5121951219512195,-105,0.49029798572728833,CIN,STL,2023 REG,10,7,1,1,8,11,1,0,6,-6,1,0,0,0,0,0,0,0,0,0.5097020142727117,0.49029798572728833
91216,0.43859649122807015,0.6000000000000001,128,-150,0.4216682056017235,0.5783317943982764,away,ATL,over,9,0.5121951219512195,-105,0.48808156828023186,CLE,ATL,2023 REG,8,2,7,4,6,15,0,1,-2,2,1,1,0,0,0,0,0,0,0,0.48808156828023186,0.5119184317197681
91216,0.43859649122807015,0.6000000000000001,128,-150,0.4216682056017235,0.5783317943982764,home,CLE,under,9,0.5348837209302326,-115,0.5119184317197681,CLE,ATL,2023 REG,8,2,7,4,6,15,0,1,-2,2,1,1,0,0,0,0,0,0,0,0.48808156828023186,0.5119184317197681
91217,0.4716981132075471,0.5652173913043479,112,-130,0.4542851393811816,0.5457148606188185,away,TB,over,7.5,0.5327102803738317,-114,0.508788710910954,SEA,TB,2023 REG,6,4,16,15,19,22,0,1,-11,11,1,1,1,1,0,0,0,0,0,0.508788710910954,0.491211289089046
91217,0.4716981132075471,0.5652173913043479,112,-130,0.4542851393811816,0.5457148606188185,home,SEA,under,7.5,0.5121951219512195,-105,0.491211289089046,SEA,TB,2023 REG,6,4,16,15,19,22,0,1,-11,11,1,1,1,1,0,0,0,0,0,0.508788710910954,0.491211289089046
91218,0.49019607843137253,0.5475113122171946,104,-121,0.47171206340756505,0.5282879365924349,away,BOS,over,8.5,0.5121951219512195,-105,0.48808156828023186,CWS,BOS,2023 REG,8,1,4,3,4,12,0,1,-2,2,1,0,0,0,0,0,0,0,0,0.48808156828023186,0.5119184317197681
91218,0.49019607843137253,0.5475113122171946,104,-121,0.47171206340756505,0.5282879365924349,home,CWS,under,8.5,0.5348837209302326,-115,0.5119184317197681,CWS,BOS,2023 REG,8,1,4,3,4,12,0,1,-2,2,1,0,0,0,0,0,0,0,0,0.48808156828023186,0.5119184317197681
91219,0.7058823529411764,0.3333333333333333,-240,200,0.6782006920415226,0.32179930795847744,away,KC,over,8.5,0.5024875621890548,-101,0.4815549006007403,MIN,KC,2023 REG,10,2,6,3,5,16,0,1,-1,1,1,1,0,0,0,0,0,0,0,0.4815549006007403,0.5184450993992598
91219,0.7058823529411764,0.3333333333333333,-240,200,0.6782006920415226,0.32179930795847744,home,MIN,under,8.5,0.5391705069124424,-117,0.5184450993992598,MIN,KC,2023 REG,10,2,6,3,5,16,0,1,-1,1,1,1,0,0,0,0,0,0,0,0.4815549006007403,0.5184450993992598
91220,0.5348837209302326,0.5098039215686274,-115,-104,0.5109810284308424,0.48901897156915763,away,LAD,over,8.5,0.5454545454545454,-120,0.5206611570247933,NYM,LAD,2023 REG,6,2,4,1,3,10,1,0,1,-1,1,0,0,0,0,0,0,0,0,0.5206611570247933,0.4793388429752067
91220,0.5348837209302326,0.5098039215686274,-115,-104,0.5109810284308424,0.48901897156915763,home,NYM,under,8.5,0.5,100,0.4793388429752067,NYM,LAD,2023 REG,6,2,4,1,3,10,1,0,1,-1,1,0,0,0,0,0,0,0,0,0.5206611570247933,0.4793388429752067
91221,0.607843137254902,0.4329004329004329,-155,131,0.583077437748718,0.416922562251282,away,CWS,over,8.5,0.5348837209302326,-115,0.5097020142727117,MIN,CWS,2023 REG,13,5,11,4,9,24,1,0,1,-1,1,1,1,1,0,0,0,0,0,0.5097020142727117,0.49029798572728833
91221,0.607843137254902,0.4329004329004329,-155,131,0.583077437748718,0.416922562251282,home,MIN,under,8.5,0.5121951219512195,-105,0.49029798572728833,MIN,CWS,2023 REG,13,5,11,4,9,24,1,0,1,-1,1,1,1,1,0,0,0,0,0,0.5097020142727117,0.49029798572728833
91222,0.5348837209302326,0.5098039215686274,-115,-104,0.5109810284308424,0.48901897156915763,away,NYY,over,8.5,0.5121951219512195,-105,0.48808156828023186,DET,NYY,2023 REG,7,1,7,4,5,14,0,1,-3,3,1,0,0,0,0,0,0,0,0,0.48808156828023186,0.5119184317197681
91222,0.5348837209302326,0.5098039215686274,-115,-104,0.5109810284308424,0.48901897156915763,home,DET,under,8.5,0.5348837209302326,-115,0.5119184317197681,DET,NYY,2023 REG,7,1,7,4,5,14,0,1,-3,3,1,0,0,0,0,0,0,0,0,0.48808156828023186,0.5119184317197681
91223,0.6503496503496503,0.3921568627450981,-186,155,0.6227055544208978,0.3772944455791022,away,MIA,over,10,0.5145631067961165,-106,0.49023796582517226,ATL,MIA,2023 REG,14,16,8,4,20,22,1,0,12,-12,1,1,1,1,0,0,0,0,0,0.49023796582517226,0.5097620341748277
91223,0.6503496503496503,0.3921568627450981,-186,155,0.6227055544208978,0.3772944455791022,home,ATL,under,10,0.5327102803738317,-114,0.5097620341748277,ATL,MIA,2023 REG,14,16,8,4,20,22,1,0,12,-12,1,1,1,1,0,0,0,0,0,0.49023796582517226,0.5097620341748277
91224,0.6376811594202898,0.3968253968253968,-176,152,0.615676978625939,0.38432302137406105,away,WSH,over,9.5,0.5,100,0.4772727272727273,STL,WSH,2023 REG,13,8,4,4,12,17,1,0,4,-4,1,1,1,1,0,0,0,0,0,0.4772727272727273,0.5227272727272727
91224,0.6376811594202898,0.3968253968253968,-176,152,0.615676978625939,0.38432302137406105,home,STL,under,9.5,0.5454545454545454,-120,0.5227272727272727,STL,WSH,2023 REG,13,8,4,4,12,17,1,0,4,-4,1,1,1,1,0,0,0,0,0,0.4772727272727273,0.5227272727272727
91225,0.5867768595041323,0.45454545454545453,-142,120,0.5625298818386723,0.43747011816132775,away,CHC,over,9.5,0.5192307692307692,-108,0.49455035168025013,ATL,CHC,2023 REG,6,5,6,3,8,12,1,0,2,-2,1,1,1,0,0,0,0,0,0,0.49455035168025013,0.5054496483197499
91225,0.5867768595041323,0.45454545454545453,-142,120,0.5625298818386723,0.43747011816132775,home,ATL,under,9.5,0.5283018867924528,-112,0.5054496483197499,ATL,CHC,2023 REG,6,5,6,3,8,12,1,0,2,-2,1,1,1,0,0,0,0,0,0,0.49455035168025013,0.5054496483197499
91226,0.5614035087719298,0.47619047619047616,-128,110,0.5402981137053159,0.4597018862946841,away,STL,over,9.5,0.5238095238095238,-110,0.4988662131519274,NYM,STL,2023 REG,6,7,8,8,15,14,0,1,-1,1,1,1,1,1,1,1,1,0,0,0.4988662131519274,0.5011337868480725
91226,0.5614035087719298,0.47619047619047616,-128,110,0.5402981137053159,0.4597018862946841,home,NYM,under,9.5,0.5238095238095238,-110,0.5011337868480725,NYM,STL,2023 REG,6,7,8,8,15,14,0,1,-1,1,1,1,1,1,1,1,1,0,0,0.4988662131519274,0.5011337868480725
91227,0.4672897196261683,0.5652173913043479,114,-130,0.45209948087359064,0.5479005191264094,away,CLE,over,8,0.5327102803738317,-114,0.508788710910954,OAK,CLE,2023 REG,4,4,9,6,10,13,0,1,-2,2,1,1,1,1,0,0,0,0,0,0.508788710910954,0.491211289089046
91227,0.4672897196261683,0.5652173913043479,114,-130,0.45209948087359064,0.5479005191264094,home,OAK,under,8,0.5121951219512195,-105,0.491211289089046,OAK,CLE,2023 REG,4,4,9,6,10,13,0,1,-2,2,1,1,1,1,0,0,0,0,0,0.508788710910954,0.491211289089046
91228,0.5145631067961165,0.5238095238095238,-106,-110,0.4948179667757384,0.5051820332242616,away,HOU,over,8,0.5121951219512195,-105,0.48808156828023186,CLE,HOU,2023 REG,14,10,15,9,19,29,1,0,1,-1,1,1,1,1,1,1,1,1,1,0.48808156828023186,0.5119184317197681
91228,0.5145631067961165,0.5238095238095238,-106,-110,0.4948179667757384,0.5051820332242616,home,CLE,under,8,0.5348837209302326,-115,0.5119184317197681,CLE,HOU,2023 REG,14,10,15,9,19,29,1,0,1,-1,1,1,1,1,1,1,1,1,1,0.48808156828023186,0.5119184317197681
91229,0.4672897196261683,0.5726495726495727,114,-134,0.44862649893656975,0.5513735010634302,away,MIA,over,10.5,0.5121951219512195,-105,0.48808156828023186,CIN,MIA,2023 REG,6,5,5,2,7,11,1,0,3,-3,1,1,0,0,0,0,0,0,0,0.48808156828023186,0.5119184317197681
91229,0.4672897196261683,0.5726495726495727,114,-134,0.44862649893656975,0.5513735010634302,home,CIN,under,10.5,0.5348837209302326,-115,0.5119184317197681,CIN,MIA,2023 REG,6,5,5,2,7,11,1,0,3,-3,1,1,0,0,0,0,0,0,0,0.48808156828023186,0.5119184317197681
91230,0.6363636363636364,0.4016064257028112,-175,149,0.6122008695940788,0.3877991304059212,away,MIA,over,8.5,0.5391705069124424,-117,0.5127649394825569,BAL,MIA,2023 REG,5,5,8,4,9,13,1,0,1,-1,1,1,1,1,0,0,0,0,0,0.5127649394825569,0.48723506051744314
91230,0.6363636363636364,0.4016064257028112,-175,149,0.6122008695940788,0.3877991304059212,home,BAL,under,8.5,0.5098039215686274,-104,0.48723506051744314,BAL,MIA,2023 REG,5,5,8,4,9,13,1,0,1,-1,1,1,1,1,0,0,0,0,0,0.5127649394825569,0.48723506051744314
91231,0.6491228070175439,0.38759689922480617,-185,158,0.6252872082286499,0.3747127917713501,away,MIA,over,9,0.5215311004784688,-109,0.49907282342437215,CHC,MIA,2023 REG,10,4,6,2,6,16,1,0,2,-2,1,1,0,0,0,0,0,0,0,0.49907282342437215,0.5009271765756278
91231,0.6491228070175439,0.38759689922480617,-185,158,0.6252872082286499,0.3747127917713501,home,CHC,under,9,0.5215311004784688,-109,0.5009271765756278,CHC,MIA,2023 REG,10,4,6,2,6,16,1,0,2,-2,1,1,0,0,0,0,0,0,0,0.49907282342437215,0.5009271765756278
91232,0.47846889952153115,0.5614035087719298,109,-128,0.45939119220408575,0.5406088077959142,away,CHC,over,9,0.5454545454545454,-120,0.5179608869977906,PIT,CHC,2023 REG,5,0,10,8,8,15,0,1,-8,8,0,0,0,0,0,0,0,0,0,0.5179608869977906,0.48203911300220936
91232,0.47846889952153115,0.5614035087719298,109,-128,0.45939119220408575,0.5406088077959142,home,PIT,under,9,0.504950495049505,-102,0.48203911300220936,PIT,CHC,2023 REG,5,0,10,8,8,15,0,1,-8,8,0,0,0,0,0,0,0,0,0,0.5179608869977906,0.48203911300220936
91233,0.5283018867924528,0.5121951219512195,-112,-105,0.5069072406637203,0.4930927593362797,away,SEA,over,8,0.5238095238095238,-110,0.4988662131519274,MIN,SEA,2023 REG,8,4,9,3,7,17,1,0,1,-1,1,1,1,0,0,0,0,0,0,0.4988662131519274,0.5011337868480725
91233,0.5283018867924528,0.5121951219512195,-112,-105,0.5069072406637203,0.4930927593362797,home,MIN,under,8,0.5238095238095238,-110,0.5011337868480725,MIN,SEA,2023 REG,8,4,9,3,7,17,1,0,1,-1,1,1,1,0,0,0,0,0,0,0.4988662131519274,0.5011337868480725
91234,0.6923076923076923,0.3508771929824561,-225,185,0.6624104640298972,0.33758953597010277,away,KC,over,9.5,0.5098039215686274,-104,0.48483656587239576,PHI,KC,2023 REG,13,9,6,6,15,19,1,0,3,-3,1,1,1,1,1,1,0,0,0,0.48483656587239576,0.5151634341276042
91234,0.6923076923076923,0.3508771929824561,-225,185,0.6624104640298972,0.33758953597010277,home,PHI,under,9.5,0.5391705069124424,-117,0.5151634341276042,PHI,KC,2023 REG,13,9,6,6,15,19,1,0,3,-3,1,1,1,1,1,1,0,0,0,0.48483656587239576,0.5151634341276042
91235,0.7435897435897436,0.29411764705882354,-290,240,0.7155509146459372,0.28444908535406277,away,OAK,over,8.5,0.5454545454545454,-120,0.5206611570247933,LAD,OAK,2023 REG,14,8,5,2,10,19,1,0,6,-6,1,1,0,0,0,0,0,0,0,0.5206611570247933,0.4793388429752067
91235,0.7435897435897436,0.29411764705882354,-290,240,0.7155509146459372,0.28444908535406277,home,LAD,under,8.5,0.5,100,0.4793388429752067,LAD,OAK,2023 REG,14,8,5,2,10,19,1,0,6,-6,1,1,0,0,0,0,0,0,0,0.5206611570247933,0.4793388429752067
91236,0.4504504504504505,0.5884773662551441,122,-143,0.4329153978803628,0.5670846021196372,away,PIT,over,9.5,0.5260663507109005,-111,0.49982833141342614,WSH,PIT,2023 REG,8,3,10,6,9,18,0,1,-3,3,1,1,1,0,0,0,0,0,0,0.49982833141342614,0.5001716685865738
91236,0.4504504504504505,0.5884773662551441,122,-143,0.4329153978803628,0.5670846021196372,home,WSH,under,9.5,0.5238095238095238,-110,0.5001716685865738,WSH,PIT,2023 REG,8,3,10,6,9,18,0,1,-3,3,1,1,1,0,0,0,0,0,0,0.49982833141342614,0.5001716685865738
91237,0.47619047619047616,0.5652173913043479,110,-130,0.4564724440500838,0.5435275559499162,away,HOU,over,9.5,0.5073891625615764,-103,0.4837652908580103,MIL,HOU,2023 REG,9,6,5,0,6,14,1,0,6,-6,0,0,0,0,0,0,0,0,0,0.4837652908580103,0.5162347091419897
91237,0.47619047619047616,0.5652173913043479,110,-130,0.4564724440500838,0.5435275559499162,home,MIL,under,9.5,0.5391705069124424,-117,0.5162347091419897,MIL,HOU,2023 REG,9,6,5,0,6,14,1,0,6,-6,0,0,0,0,0,0,0,0,0,0.4837652908580103,0.5162347091419897
91238,0.607843137254902,0.43103448275862066,-155,132,0.5842116427368785,0.41578835726312147,away,MIN,over,7,0.5169082125603864,-107,0.49239402434819424,MIA,MIN,2023 REG,3,1,3,0,1,6,1,0,1,-1,0,0,0,0,0,0,0,0,0,0.49239402434819424,0.5076059756518058
91238,0.607843137254902,0.43103448275862066,-155,132,0.5842116427368785,0.41578835726312147,home,MIA,under,7,0.5305164319248826,-113,0.5076059756518058,MIA,MIN,2023 REG,3,1,3,0,1,6,1,0,1,-1,0,0,0,0,0,0,0,0,0,0.49239402434819424,0.5076059756518058
91239,0.607843137254902,0.4291845493562232,-155,133,0.5853361120599043,0.4146638879400957,away,CWS,over,8,0.504950495049505,-102,0.47949844489399435,HOU,CWS,2023 REG,7,6,11,3,9,18,1,0,3,-3,1,1,1,0,0,0,0,0,0,0.47949844489399435,0.5205015551060057
91239,0.607843137254902,0.4291845493562232,-155,133,0.5853361120599043,0.4146638879400957,home,HOU,under,8,0.5454545454545454,-120,0.5205015551060057,HOU,CWS,2023 REG,7,6,11,3,9,18,1,0,3,-3,1,1,1,0,0,0,0,0,0,0.47949844489399435,0.5205015551060057
91240,0.6563573883161512,0.38167938931297707,-191,162,0.6313916682915345,0.3686083317084655,away,CWS,over,8.5,0.5305164319248826,-113,0.5053568787472517,DET,CWS,2023 REG,6,3,4,1,4,10,1,0,2,-2,1,0,0,0,0,0,0,0,0,0.5053568787472517,0.49464312125274834
91240,0.6563573883161512,0.38167938931297707,-191,162,0.6313916682915345,0.3686083317084655,home,DET,under,8.5,0.5169082125603864,-107,0.49464312125274834,DET,CWS,2023 REG,6,3,4,1,4,10,1,0,2,-2,1,0,0,0,0,0,0,0,0,0.5053568787472517,0.49464312125274834
91241,0.5215311004784688,0.5145631067961165,-109,-106,0.5027068488376564,0.4972931511623436,away,LAD,over,11,0.5412844036697247,-118,0.5149381613977361,CHC,LAD,2023 REG,6,2,9,6,8,15,0,1,-4,4,1,1,0,0,0,0,0,0,0,0.5149381613977361,0.48506183860226393
91241,0.5215311004784688,0.5145631067961165,-109,-106,0.5027068488376564,0.4972931511623436,home,CHC,under,11,0.5073891625615764,-103,0.48506183860226393,CHC,LAD,2023 REG,6,2,9,6,8,15,0,1,-4,4,1,1,0,0,0,0,0,0,0,0.5149381613977361,0.48506183860226393
91242,0.7032640949554896,0.3333333333333333,-237,200,0.6775264376722522,0.3224735623277478,away,DET,over,7.5,0.5454545454545454,-120,0.5206611570247933,PHI,DET,2023 REG,6,3,5,2,5,11,1,0,1,-1,1,1,0,0,0,0,0,0,0,0.5206611570247933,0.4793388429752067
91242,0.7032640949554896,0.3333333333333333,-237,200,0.6775264376722522,0.3224735623277478,home,PHI,under,7.5,0.5,100,0.4793388429752067,PHI,DET,2023 REG,6,3,5,2,5,11,1,0,1,-1,1,1,0,0,0,0,0,0,0,0.5206611570247933,0.4793388429752067
91243,0.46511627906976744,0.574468085106383,115,-135,0.44670494689481377,0.5532950531051862,away,ARI,over,8,0.5215311004784688,-109,0.4978845547971712,DET,ARI,2023 REG,11,6,11,11,17,22,0,1,-5,5,1,1,1,1,1,1,0,0,0,0.4978845547971712,0.5021154452028288
91243,0.46511627906976744,0.574468085106383,115,-135,0.44670494689481377,0.5532950531051862,home,DET,under,8,0.5238095238095238,-110,0.5021154452028288,DET,ARI,2023 REG,11,6,11,11,17,22,0,1,-5,5,1,1,1,1,1,1,0,0,0,0.4978845547971712,0.5021154452028288
91244,0.7159090909090909,0.3225806451612903,-252,210,0.6883539389496134,0.3116460610503866,away,DET,over,8,0.5169082125603864,-107,0.49353874091423283,MIN,DET,2023 REG,7,1,9,7,8,16,0,1,-6,6,1,0,0,0,0,0,0,0,0,0.49353874091423283,0.5064612590857671
91244,0.7159090909090909,0.3225806451612903,-252,210,0.6883539389496134,0.3116460610503866,home,MIN,under,8,0.5283018867924528,-112,0.5064612590857671,MIN,DET,2023 REG,7,1,9,7,8,16,0,1,-6,6,1,0,0,0,0,0,0,0,0,0.49353874091423283,0.5064612590857671
91245,0.37037037037037035,0.6666666666666666,170,-200,0.35665294924554186,0.6433470507544581,away,LAD,over,11.5,0.5283018867924528,-112,0.5031902949311281,COL,LAD,2023 REG,9,3,18,14,17,27,0,1,-11,11,1,1,1,0,0,0,0,0,0,0.5031902949311281,0.4968097050688719
91245,0.37037037037037035,0.6666666666666666,170,-200,0.35665294924554186,0.6433470507544581,home,COL,under,11.5,0.5192307692307692,-108,0.4968097050688719,COL,LAD,2023 REG,9,3,18,14,17,27,0,1,-11,11,1,1,1,0,0,0,0,0,0,0.5031902949311281,0.4968097050688719
91246,0.6183206106870228,0.425531914893617,-162,135,0.5912056902898333,0.4087943097101667,away,CIN,over,11,0.5192307692307692,-108,0.49455035168025013,CHC,CIN,2023 REG,16,16,9,6,22,25,1,0,10,-10,1,1,1,1,1,1,0,0,0,0.49455035168025013,0.5054496483197499
91246,0.6183206106870228,0.425531914893617,-162,135,0.5912056902898333,0.4087943097101667,home,CHC,under,11,0.5283018867924528,-112,0.5054496483197499,CHC,CIN,2023 REG,16,16,9,6,22,25,1,0,10,-10,1,1,1,1,1,1,0,0,0,0.49455035168025013,0.5054496483197499
91247,0.47846889952153115,0.5614035087719298,109,-128,0.45939119220408575,0.5406088077959142,away,CLE,over,9,0.5454545454545454,-120,0.5206611570247933,PIT,CLE,2023 REG,4,0,12,11,11,16,0,1,-11,11,0,0,0,0,0,0,0,0,0,0.5206611570247933,0.4793388429752067
91247,0.47846889952153115,0.5614035087719298,109,-128,0.45939119220408575,0.5406088077959142,home,PIT,under,9,0.5,100,0.4793388429752067,PIT,CLE,2023 REG,4,0,12,11,11,16,0,1,-11,11,0,0,0,0,0,0,0,0,0,0.5206611570247933,0.4793388429752067
91248,0.5145631067961165,0.5283018867924528,-106,-112,0.4925063625223866,0.5074936374776133,away,MIN,over,8,0.5370370370370371,-116,0.5131785224377817,MIL,MIN,2023 REG,8,7,7,3,10,15,1,0,4,-4,1,1,1,0,0,0,0,0,0,0.5131785224377817,0.4868214775622183
91248,0.5145631067961165,0.5283018867924528,-106,-112,0.4925063625223866,0.5074936374776133,home,MIL,under,8,0.5073891625615764,-103,0.4868214775622183,MIL,MIN,2023 REG,8,7,7,3,10,15,1,0,4,-4,1,1,1,0,0,0,0,0,0,0.5131785224377817,0.4868214775622183
91249,0.696969696969697,0.3424657534246575,-230,192,0.6694843830584802,0.33051561694151976,away,WSH,over,8,0.5433789954337899,-119,0.5198077604720502,NYM,WSH,2023 REG,16,9,8,8,17,24,1,0,1,-1,1,1,1,1,1,1,1,1,0,0.5198077604720502,0.48019223952794976
91249,0.696969696969697,0.3424657534246575,-230,192,0.6694843830584802,0.33051561694151976,home,NYM,under,8,0.5,100,0.48019223952794976,NYM,WSH,2023 REG,16,9,8,8,17,24,1,0,1,-1,1,1,1,1,1,1,1,1,0,0.5198077604720502,0.48019223952794976
91250,0.6000000000000001,0.4347826086956522,-150,130,0.5791304347826086,0.4208695652173914,away,LAA,over,8.5,0.5412844036697247,-118,0.5149381613977361,STL,LAA,2023 REG,4,1,8,5,6,12,0,1,-4,4,1,0,0,0,0,0,0,0,0,0.5149381613977361,0.48506183860226393
91250,0.6000000000000001,0.4347826086956522,-150,130,0.5791304347826086,0.4208695652173914,home,STL,under,8.5,0.5073891625615764,-103,0.48506183860226393,STL,LAA,2023 REG,4,1,8,5,6,12,0,1,-4,4,1,0,0,0,0,0,0,0,0,0.5149381613977361,0.48506183860226393
91251,0.48780487804878053,0.5515695067264574,105,-123,0.4685978610852498,0.5314021389147502,away,TB,over,9,0.5145631067961165,-106,0.49023796582517226,BOS,TB,2023 REG,6,2,7,6,8,13,0,1,-4,4,1,1,0,0,0,0,0,0,0,0.49023796582517226,0.5097620341748277
91251,0.48780487804878053,0.5515695067264574,105,-123,0.4685978610852498,0.5314021389147502,home,BOS,under,9,0.5327102803738317,-114,0.5097620341748277,BOS,TB,2023 REG,6,2,7,6,8,13,0,1,-4,4,1,1,0,0,0,0,0,0,0,0.49023796582517226,0.5097620341748277
91252,0.6503496503496503,0.3921568627450981,-186,155,0.6227055544208978,0.3772944455791022,away,SEA,over,8.5,0.5348837209302326,-115,0.5097020142727117,HOU,SEA,2023 REG,12,6,15,7,13,27,0,1,-1,1,1,1,1,1,1,1,0,0,0,0.5097020142727117,0.49029798572728833
91252,0.6503496503496503,0.3921568627450981,-186,155,0.6227055544208978,0.3772944455791022,home,HOU,under,8.5,0.5121951219512195,-105,0.49029798572728833,HOU,SEA,2023 REG,12,6,15,7,13,27,0,1,-1,1,1,1,1,1,1,1,0,0,0,0.5097020142727117,0.49029798572728833
91253,0.576271186440678,0.4629629629629629,-136,116,0.553661676614851,0.446338323385149,away,CWS,over,9.5,0.5073891625615764,-103,0.4826927225525911,CIN,CWS,2023 REG,8,5,8,3,8,16,1,0,2,-2,1,1,1,0,0,0,0,0,0,0.4826927225525911,0.5173072774474089
91253,0.576271186440678,0.4629629629629629,-136,116,0.553661676614851,0.446338323385149,home,CIN,under,9.5,0.5412844036697247,-118,0.5173072774474089,CIN,CWS,2023 REG,8,5,8,3,8,16,1,0,2,-2,1,1,1,0,0,0,0,0,0,0.4826927225525911,0.5173072774474089
91254,0.6774193548387096,0.3663003663003663,-210,173,0.6478027695509486,0.3521972304490514,away,LAA,over,7.5,0.5348837209302326,-115,0.5097020142727117,MIN,LAA,2023 REG,5,0,7,1,1,12,0,1,-1,1,0,0,0,0,0,0,0,0,0,0.5097020142727117,0.49029798572728833
91254,0.6774193548387096,0.3663003663003663,-210,173,0.6478027695509486,0.3521972304490514,home,MIN,under,7.5,0.5121951219512195,-105,0.49029798572728833,MIN,LAA,2023 REG,5,0,7,1,1,12,0,1,-1,1,0,0,0,0,0,0,0,0,0,0.5097020142727117,0.49029798572728833
91255,0.5780590717299579,0.4608294930875576,-137,117,0.5555791840506346,0.44442081594936544,away,WSH,over,9.5,0.5098039215686274,-104,0.48483656587239576,CHC,WSH,2023 REG,9,5,11,7,12,20,0,1,-2,2,1,1,1,1,1,0,0,0,0,0.48483656587239576,0.5151634341276042
91255,0.5780590717299579,0.4608294930875576,-137,117,0.5555791840506346,0.44442081594936544,home,CHC,under,9.5,0.5391705069124424,-117,0.5151634341276042,CHC,WSH,2023 REG,9,5,11,7,12,20,0,1,-2,2,1,1,1,1,1,0,0,0,0,0.48483656587239576,0.5151634341276042
91256,0.6666666666666666,0.37735849056603776,-200,165,0.6373165618448637,0.36268343815513626,away,LAA,over,8.5,0.5192307692307692,-108,0.49455035168025013,SD,LAA,2023 REG,12,10,14,3,13,26,1,0,7,-7,1,1,1,0,0,0,0,0,0,0.49455035168025013,0.5054496483197499
91256,0.6666666666666666,0.37735849056603776,-200,165,0.6373165618448637,0.36268343815513626,home,SD,under,8.5,0.5283018867924528,-112,0.5054496483197499,SD,LAA,2023 REG,12,10,14,3,13,26,1,0,7,-7,1,1,1,0,0,0,0,0,0,0.49455035168025013,0.5054496483197499
91257,0.5833333333333333,0.4566210045662101,-140,119,0.5600266362252664,0.4399733637747336,away,CWS,over,9,0.5475113122171946,-121,0.5228602997583487,LAA,CWS,2023 REG,11,7,9,9,16,20,0,1,-2,2,1,1,1,1,1,1,1,0,0,0.5228602997583487,0.4771397002416513
91257,0.5833333333333333,0.4566210045662101,-140,119,0.5600266362252664,0.4399733637747336,home,LAA,under,9,0.49751243781094534,101,0.4771397002416513,LAA,CWS,2023 REG,11,7,9,9,16,20,0,1,-2,2,1,1,1,1,1,1,1,0,0,0.5228602997583487,0.4771397002416513
91258,0.5652173913043479,0.47619047619047616,-130,110,0.5418129444594474,0.4581870555405526,away,KC,over,8.5,0.5238095238095238,-110,0.5000596729920038,OAK,KC,2023 REG,10,6,6,4,10,16,1,0,2,-2,1,1,1,1,0,0,0,0,0,0.5000596729920038,0.4999403270079962
91258,0.5652173913043479,0.47619047619047616,-130,110,0.5418129444594474,0.4581870555405526,home,OAK,under,8.5,0.5215311004784688,-109,0.4999403270079962,OAK,KC,2023 REG,10,6,6,4,10,16,1,0,2,-2,1,1,1,1,0,0,0,0,0,0.5000596729920038,0.4999403270079962
91259,0.5073891625615764,0.5348837209302326,-103,-115,0.4859403596076043,0.5140596403923957,away,LAD,over,7.5,0.5327102803738317,-114,0.508788710910954,SD,LAD,2023 REG,8,5,4,2,7,12,1,0,3,-3,1,1,0,0,0,0,0,0,0,0.508788710910954,0.491211289089046
91259,0.5073891625615764,0.5348837209302326,-103,-115,0.4859403596076043,0.5140596403923957,home,SD,under,7.5,0.5121951219512195,-105,0.491211289089046,SD,LAD,2023 REG,8,5,4,2,7,12,1,0,3,-3,1,1,0,0,0,0,0,0,0,0.508788710910954,0.491211289089046
91260,0.4166666666666667,0.6240601503759399,140,-166,0.39969715956558066,0.6003028404344193,away,CLE,over,8.5,0.5260663507109005,-111,0.5010269332605688,LAA,CLE,2023 REG,3,2,8,1,3,11,1,0,1,-1,1,0,0,0,0,0,0,0,0,0.5010269332605688,0.4989730667394312
91260,0.4166666666666667,0.6240601503759399,140,-166,0.39969715956558066,0.6003028404344193,home,LAA,under,8.5,0.5215311004784688,-109,0.4989730667394312,LAA,CLE,2023 REG,3,2,8,1,3,11,1,0,1,-1,1,0,0,0,0,0,0,0,0,0.5010269332605688,0.4989730667394312
91261,0.5348837209302326,0.5,-115,100,0.5162249864791779,0.4837750135208221,away,STL,over,8,0.5073891625615764,-103,0.4837652908580103,CLE,STL,2023 REG,7,4,8,3,7,15,1,0,1,-1,1,1,1,0,0,0,0,0,0,0.4837652908580103,0.5162347091419897
91261,0.5348837209302326,0.5,-115,100,0.5162249864791779,0.4837750135208221,home,CLE,under,8,0.5391705069124424,-117,0.5162347091419897,CLE,STL,2023 REG,7,4,8,3,7,15,1,0,1,-1,1,1,1,0,0,0,0,0,0,0.4837652908580103,0.5162347091419897
91262,0.5475113122171946,0.48780487804878053,-121,105,0.5281752985421585,0.4718247014578415,away,LAD,over,8.5,0.5238095238095238,-110,0.4988662131519274,MIL,LAD,2023 REG,8,9,6,3,12,14,1,0,6,-6,1,1,1,0,0,0,0,0,0,0.4988662131519274,0.5011337868480725
91262,0.5475113122171946,0.48780487804878053,-121,105,0.5281752985421585,0.4718247014578415,home,MIL,under,8.5,0.5238095238095238,-110,0.5011337868480725,MIL,LAD,2023 REG,8,9,6,3,12,14,1,0,6,-6,1,1,1,0,0,0,0,0,0,0.4988662131519274,0.5011337868480725
91263,0.574468085106383,0.46511627906976744,-135,115,0.5517281312179562,0.44827186878204384,away,LAD,over,9,0.5454545454545454,-120,0.5206611570247933,SD,LAD,2023 REG,11,7,14,13,20,25,0,1,-6,6,1,1,1,1,1,1,1,0,0,0.5206611570247933,0.4793388429752067
91263,0.574468085106383,0.46511627906976744,-135,115,0.5517281312179562,0.44827186878204384,home,SD,under,9,0.5,100,0.4793388429752067,SD,LAD,2023 REG,11,7,14,13,20,25,0,1,-6,6,1,1,1,1,1,1,1,0,0,0.5206611570247933,0.4793388429752067
91264,0.7142857142857143,0.3278688524590164,-250,205,0.6841753094680495,0.3158246905319505,away,OAK,over,9.5,0.5169082125603864,-107,0.49239402434819424,NYY,OAK,2023 REG,10,11,8,3,14,18,1,0,8,-8,1,1,1,0,0,0,0,0,0,0.49239402434819424,0.5076059756518058
91264,0.7142857142857143,0.3278688524590164,-250,205,0.6841753094680495,0.3158246905319505,home,NYY,under,9.5,0.5305164319248826,-113,0.5076059756518058,NYY,OAK,2023 REG,10,11,8,3,14,18,1,0,8,-8,1,1,1,0,0,0,0,0,0,0.49239402434819424,0.5076059756518058
91265,0.6774193548387096,0.36363636363636365,-210,175,0.6496074165168858,0.3503925834831142,away,WSH,over,8,0.5121951219512195,-105,0.48808156828023186,MIA,WSH,2023 REG,7,2,5,3,5,12,0,1,-1,1,1,1,0,0,0,0,0,0,0,0.48808156828023186,0.5119184317197681
91265,0.6774193548387096,0.36363636363636365,-210,175,0.6496074165168858,0.3503925834831142,home,MIA,under,8,0.5348837209302326,-115,0.5119184317197681,MIA,WSH,2023 REG,7,2,5,3,5,12,0,1,-1,1,1,1,0,0,0,0,0,0,0,0.48808156828023186,0.5119184317197681
91266,0.7183098591549296,0.3225806451612903,-255,210,0.6889378067587716,0.3110621932412284,away,KC,over,7.5,0.5,100,0.4772727272727273,TB,KC,2023 REG,17,11,11,3,14,28,1,0,8,-8,1,1,1,0,0,0,0,0,0,0.4772727272727273,0.5227272727272727
91266,0.7183098591549296,0.3225806451612903,-255,210,0.6889378067587716,0.3110621932412284,home,TB,under,7.5,0.5454545454545454,-120,0.5227272727272727,TB,KC,2023 REG,17,11,11,3,14,28,1,0,8,-8,1,1,1,0,0,0,0,0,0,0.4772727272727273,0.5227272727272727
91267,0.4098360655737705,0.6226415094339623,144,-165,0.39652558401322424,0.6034744159867758,away,TEX,over,8.5,0.5454545454545454,-120,0.5206611570247933,OAK,TEX,2023 REG,14,9,12,7,16,26,1,0,2,-2,1,1,1,1,1,1,1,0,0,0.5206611570247933,0.4793388429752067
91267,0.4098360655737705,0.6226415094339623,144,-165,0.39652558401322424,0.6034744159867758,home,OAK,under,8.5,0.5,100,0.4793388429752067,OAK,TEX,2023 REG,14,9,12,7,16,26,1,0,2,-2,1,1,1,1,1,1,1,0,0,0.5206611570247933,0.4793388429752067
91268,0.5348837209302326,0.5098039215686274,-115,-104,0.5109810284308424,0.48901897156915763,away,CIN,over,8,0.5348837209302326,-115,0.5097020142727117,STL,CIN,2023 REG,7,3,10,4,7,17,0,1,-1,1,1,1,1,0,0,0,0,0,0,0.5097020142727117,0.49029798572728833
91268,0.5348837209302326,0.5098039215686274,-115,-104,0.5109810284308424,0.48901897156915763,home,STL,under,8,0.5121951219512195,-105,0.49029798572728833,STL,CIN,2023 REG,7,3,10,4,7,17,0,1,-1,1,1,1,1,0,0,0,0,0,0,0.5097020142727117,0.49029798572728833
91269,0.6363636363636364,0.4081632653061224,-175,145,0.6080283353010626,0.3919716646989374,away,COL,over,8.5,0.5454545454545454,-120,0.5206611570247933,PIT,COL,2023 REG,4,1,11,10,11,15,0,1,-9,9,1,0,0,0,0,0,0,0,0,0.5206611570247933,0.4793388429752067
91269,0.6363636363636364,0.4081632653061224,-175,145,0.6080283353010626,0.3919716646989374,home,PIT,under,8.5,0.5,100,0.4793388429752067,PIT,COL,2023 REG,4,1,11,10,11,15,0,1,-9,9,1,0,0,0,0,0,0,0,0,0.5206611570247933,0.4793388429752067
91270,0.4,0.6428571428571428,150,-180,0.38285714285714295,0.617142857142857,away,NYY,over,8,0.5098039215686274,-104,0.4870219861770517,TEX,NYY,2023 REG,6,2,8,4,6,14,0,1,-2,2,1,1,0,0,0,0,0,0,0,0.4870219861770517,0.5129780138229483
91270,0.4,0.6428571428571428,150,-180,0.38285714285714295,0.617142857142857,home,TEX,under,8,0.5348837209302326,-115,0.5129780138229483,TEX,NYY,2023 REG,6,2,8,4,6,14,0,1,-2,2,1,1,0,0,0,0,0,0,0,0.4870219861770517,0.5129780138229483
91271,0.6226415094339623,0.41152263374485604,-165,143,0.6013694957565848,0.3986305042434152,away,MIN,over,7.5,0.5,100,0.47935779816513757,TB,MIN,2023 REG,7,7,4,0,7,11,1,0,7,-7,0,0,0,0,0,0,0,0,0,0.47935779816513757,0.5206422018348624
91271,0.6226415094339623,0.41152263374485604,-165,143,0.6013694957565848,0.3986305042434152,home,TB,under,7.5,0.5412844036697247,-118,0.5206422018348624,TB,MIN,2023 REG,7,7,4,0,7,11,1,0,7,-7,0,0,0,0,0,0,0,0,0,0.47935779816513757,0.5206422018348624
91272,0.4587155963302753,0.5815899581589958,118,-139,0.4402268098673069,0.5597731901326931,away,TOR,over,8.5,0.5348837209302326,-115,0.5097020142727117,NYY,TOR,2023 REG,6,1,6,5,6,12,0,1,-4,4,1,0,0,0,0,0,0,0,0,0.5097020142727117,0.49029798572728833
91272,0.4587155963302753,0.5815899581589958,118,-139,0.4402268098673069,0.5597731901326931,home,NYY,under,8.5,0.5121951219512195,-105,0.49029798572728833,NYY,TOR,2023 REG,6,1,6,5,6,12,0,1,-4,4,1,0,0,0,0,0,0,0,0,0.5097020142727117,0.49029798572728833
91273,0.5815899581589958,0.4587155963302753,-139,118,0.5581486524100054,0.44185134758999456,away,LAA,over,8.5,0.5121951219512195,-105,0.48919479393107135,NYM,LAA,2023 REG,4,1,6,3,4,10,0,1,-2,2,1,0,0,0,0,0,0,0,0,0.48919479393107135,0.5108052060689287
91273,0.5815899581589958,0.4587155963302753,-139,118,0.5581486524100054,0.44185134758999456,home,NYM,under,8.5,0.5327102803738317,-114,0.5108052060689287,NYM,LAA,2023 REG,4,1,6,3,4,10,0,1,-2,2,1,0,0,0,0,0,0,0,0,0.48919479393107135,0.5108052060689287
91274,0.41493775933609955,0.6226415094339623,141,-165,0.39934470175516107,0.600655298244839,away,MIL,over,10,0.5348837209302326,-115,0.5097020142727117,CIN,MIL,2023 REG,3,4,7,5,9,10,0,1,-1,1,1,1,1,1,0,0,0,0,0,0.5097020142727117,0.49029798572728833
91274,0.41493775933609955,0.6226415094339623,141,-165,0.39934470175516107,0.600655298244839,home,CIN,under,10,0.5121951219512195,-105,0.49029798572728833,CIN,MIL,2023 REG,3,4,7,5,9,10,0,1,-1,1,1,1,1,1,0,0,0,0,0,0.5097020142727117,0.49029798572728833
91275,0.6666666666666666,0.37037037037037035,-200,170,0.6419753086419753,0.3580246913580247,away,DET,over,7.5,0.5348837209302326,-115,0.5097020142727117,CLE,DET,2023 REG,7,2,13,6,8,20,0,1,-4,4,1,1,0,0,0,0,0,0,0,0.5097020142727117,0.49029798572728833
91275,0.6666666666666666,0.37037037037037035,-200,170,0.6419753086419753,0.3580246913580247,home,CLE,under,7.5,0.5121951219512195,-105,0.49029798572728833,CLE,DET,2023 REG,7,2,13,6,8,20,0,1,-4,4,1,1,0,0,0,0,0,0,0,0.5097020142727117,0.49029798572728833
91276,0.7402597402597403,0.29850746268656714,-285,235,0.7115619406761102,0.2884380593238898,away,PIT,over,8.5,0.5073891625615764,-103,0.4826927225525911,SD,PIT,2023 REG,11,5,3,1,6,14,1,0,4,-4,1,0,0,0,0,0,0,0,0,0.4826927225525911,0.5173072774474089
91276,0.7402597402597403,0.29850746268656714,-285,235,0.7115619406761102,0.2884380593238898,home,SD,under,8.5,0.5412844036697247,-118,0.5173072774474089,SD,PIT,2023 REG,11,5,3,1,6,14,1,0,4,-4,1,0,0,0,0,0,0,0,0,0.4826927225525911,0.5173072774474089
91277,0.5918367346938775,0.4484304932735426,-145,123,0.5680051099784656,0.43199489002153435,away,CHC,over,9.5,0.5,100,0.4772727272727273,ATL,CHC,2023 REG,8,7,13,6,13,21,1,0,1,-1,1,1,1,1,1,1,0,0,0,0.4772727272727273,0.5227272727272727
91277,0.5918367346938775,0.4484304932735426,-145,123,0.5680051099784656,0.43199489002153435,home,ATL,under,9.5,0.5454545454545454,-120,0.5227272727272727,ATL,CHC,2023 REG,8,7,13,6,13,21,1,0,1,-1,1,1,1,1,1,1,0,0,0,0.4772727272727273,0.5227272727272727
91278,0.5454545454545454,0.49504950495049505,-120,102,0.5233614270517961,0.4766385729482039,away,MIN,over,9,0.5283018867924528,-112,0.5031902949311281,BOS,MIN,2023 REG,14,11,10,5,16,24,1,0,6,-6,1,1,1,1,1,0,0,0,0,0.5031902949311281,0.4968097050688719
91278,0.5454545454545454,0.49504950495049505,-120,102,0.5233614270517961,0.4766385729482039,home,BOS,under,9,0.5192307692307692,-108,0.4968097050688719,BOS,MIN,2023 REG,14,11,10,5,16,24,1,0,6,-6,1,1,1,1,1,0,0,0,0,0.5031902949311281,0.4968097050688719
91279,0.33557046979865773,0.7058823529411764,198,-240,0.32166012659737114,0.6783398734026289,away,LAD,over,9,0.5348837209302326,-115,0.5097020142727117,KC,LAD,2023 REG,7,6,9,4,10,16,1,0,2,-2,1,1,1,1,0,0,0,0,0,0.5097020142727117,0.49029798572728833
91279,0.33557046979865773,0.7058823529411764,198,-240,0.32166012659737114,0.6783398734026289,home,KC,under,9,0.5121951219512195,-105,0.49029798572728833,KC,LAD,2023 REG,7,6,9,4,10,16,1,0,2,-2,1,1,1,1,0,0,0,0,0,0.5097020142727117,0.49029798572728833
91280,0.6323529411764706,0.4065040650406504,-172,146,0.6077815990097617,0.3922184009902383,away,PIT,over,8.5,0.5391705069124424,-117,0.5140669063204599,MIL,PIT,2023 REG,6,5,4,2,7,10,1,0,3,-3,1,1,0,0,0,0,0,0,0,0.5140669063204599,0.4859330936795401
91280,0.6323529411764706,0.4065040650406504,-172,146,0.6077815990097617,0.3922184009902383,home,MIL,under,8.5,0.5073891625615764,-103,0.4859330936795401,MIL,PIT,2023 REG,6,5,4,2,7,10,1,0,3,-3,1,1,0,0,0,0,0,0,0,0.5140669063204599,0.4859330936795401
91281,0.7050147492625369,0.3389830508474576,-239,195,0.6739956512498859,0.3260043487501141,away,CLE,over,8.5,0.5348837209302326,-115,0.5097020142727117,TOR,CLE,2023 REG,8,7,13,10,17,21,0,1,-3,3,1,1,1,1,1,1,1,0,0,0.5097020142727117,0.49029798572728833
91281,0.7050147492625369,0.3389830508474576,-239,195,0.6739956512498859,0.3260043487501141,home,TOR,under,8.5,0.5121951219512195,-105,0.49029798572728833,TOR,CLE,2023 REG,8,7,13,10,17,21,0,1,-3,3,1,1,1,1,1,1,1,0,0,0.5097020142727117,0.49029798572728833
91282,0.7142857142857143,0.3278688524590164,-250,205,0.6841753094680495,0.3158246905319505,away,CWS,over,9,0.5283018867924528,-112,0.5044173060022736,BAL,CWS,2023 REG,14,9,10,3,12,24,1,0,6,-6,1,1,1,0,0,0,0,0,0,0.5044173060022736,0.49558269399772636
91282,0.7142857142857143,0.3278688524590164,-250,205,0.6841753094680495,0.3158246905319505,home,BAL,under,9,0.5169082125603864,-107,0.49558269399772636,BAL,CWS,2023 REG,14,9,10,3,12,24,1,0,6,-6,1,1,1,0,0,0,0,0,0,0.5044173060022736,0.49558269399772636
91283,0.4716981132075471,0.5689655172413793,112,-132,0.45251715544861953,0.5474828445513804,away,CHC,over,9,0.5412844036697247,-118,0.5136310900085983,PIT,CHC,2023 REG,4,1,12,10,11,16,0,1,-9,9,1,0,0,0,0,0,0,0,0,0.5136310900085983,0.4863689099914017
91283,0.4716981132075471,0.5689655172413793,112,-132,0.45251715544861953,0.5474828445513804,home,PIT,under,9,0.5098039215686274,-104,0.4863689099914017,PIT,CHC,2023 REG,4,1,12,10,11,16,0,1,-9,9,1,0,0,0,0,0,0,0,0,0.5136310900085983,0.4863689099914017
91284,0.5780590717299579,0.4608294930875576,-137,117,0.5555791840506346,0.44442081594936544,away,SEA,over,9.5,0.5,100,0.4783105022831051,LAA,SEA,2023 REG,6,2,16,6,8,22,0,1,-4,4,1,1,0,0,0,0,0,0,0,0.4783105022831051,0.5216894977168949
91284,0.5780590717299579,0.4608294930875576,-137,117,0.5555791840506346,0.44442081594936544,home,LAA,under,9.5,0.5433789954337899,-119,0.5216894977168949,LAA,SEA,2023 REG,6,2,16,6,8,22,0,1,-4,4,1,1,0,0,0,0,0,0,0,0.4783105022831051,0.5216894977168949
91285,0.3076923076923077,0.7333333333333333,225,-275,0.29506903353057207,0.7049309664694279,away,TB,over,9,0.5391705069124424,-117,0.5127649394825569,KC,TB,2023 REG,7,1,8,6,7,15,0,1,-5,5,1,0,0,0,0,0,0,0,0,0.5127649394825569,0.48723506051744314
91285,0.3076923076923077,0.7333333333333333,225,-275,0.29506903353057207,0.7049309664694279,home,KC,under,9,0.5098039215686274,-104,0.48723506051744314,KC,TB,2023 REG,7,1,8,6,7,15,0,1,-5,5,1,0,0,0,0,0,0,0,0,0.5127649394825569,0.48723506051744314
91286,0.5815899581589958,0.45454545454545453,-139,120,0.5605739649961564,0.4394260350038436,away,CLE,over,8,0.5348837209302326,-115,0.5097020142727117,MIN,CLE,2023 REG,10,7,9,6,13,19,1,0,1,-1,1,1,1,1,1,1,0,0,0,0.5097020142727117,0.49029798572728833
91286,0.5815899581589958,0.45454545454545453,-139,120,0.5605739649961564,0.4394260350038436,home,MIN,under,8,0.5121951219512195,-105,0.49029798572728833,MIN,CLE,2023 REG,10,7,9,6,13,19,1,0,1,-1,1,1,1,1,1,1,0,0,0,0.5097020142727117,0.49029798572728833
91287,0.3436426116838488,0.6987951807228916,191,-232,0.32905917786709954,0.6709408221329005,away,PHI,over,9,0.5145631067961165,-106,0.4925063625223866,WSH,PHI,2023 REG,9,4,6,3,7,15,1,0,1,-1,1,1,1,0,0,0,0,0,0,0.4925063625223866,0.5074936374776133
91287,0.3436426116838488,0.6987951807228916,191,-232,0.32905917786709954,0.6709408221329005,home,WSH,under,9,0.5283018867924528,-112,0.5074936374776133,WSH,PHI,2023 REG,9,4,6,3,7,15,1,0,1,-1,1,1,1,0,0,0,0,0,0,0.4925063625223866,0.5074936374776133
91288,0.6551724137931035,0.38759689922480617,-190,158,0.6271511397468869,0.37284886025311315,away,COL,over,7.5,0.5121951219512195,-105,0.48808156828023186,CLE,COL,2023 REG,10,4,7,1,5,17,1,0,3,-3,1,0,0,0,0,0,0,0,0,0.48808156828023186,0.5119184317197681
91288,0.6551724137931035,0.38759689922480617,-190,158,0.6271511397468869,0.37284886025311315,home,CLE,under,7.5,0.5348837209302326,-115,0.5119184317197681,CLE,COL,2023 REG,10,4,7,1,5,17,1,0,3,-3,1,0,0,0,0,0,0,0,0,0.48808156828023186,0.5119184317197681
91289,0.5121951219512195,0.5238095238095238,-105,-110,0.4937537180249852,0.5062462819750149,away,LAD,over,9,0.5348837209302326,-115,0.5097020142727117,PHI,LAD,2023 REG,8,5,7,4,9,15,1,0,1,-1,1,1,1,1,0,0,0,0,0,0.5097020142727117,0.49029798572728833
91289,0.5121951219512195,0.5238095238095238,-105,-110,0.4937537180249852,0.5062462819750149,home,PHI,under,9,0.5121951219512195,-105,0.49029798572728833,PHI,LAD,2023 REG,8,5,7,4,9,15,1,0,1,-1,1,1,1,1,0,0,0,0,0,0.5097020142727117,0.49029798572728833
91290,0.5098039215686274,0.5283018867924528,-104,-112,0.4903774310316062,0.5096225689683938,away,BOS,over,9.5,0.5,100,0.4762443438914027,LAA,BOS,2023 REG,7,7,8,3,10,15,1,0,4,-4,1,1,1,0,0,0,0,0,0,0.4762443438914027,0.5237556561085973
91290,0.5098039215686274,0.5283018867924528,-104,-112,0.4903774310316062,0.5096225689683938,home,LAA,under,9.5,0.5475113122171946,-121,0.5237556561085973,LAA,BOS,2023 REG,7,7,8,3,10,15,1,0,4,-4,1,1,1,0,0,0,0,0,0,0.4762443438914027,0.5237556561085973
91291,0.3448275862068966,0.6941896024464832,190,-227,0.3313733832229725,0.6686266167770275,away,TOR,over,8,0.5238095238095238,-110,0.4988662131519274,DET,TOR,2023 REG,5,2,0,0,2,5,1,0,2,-2,0,0,0,0,0,0,0,0,0,0.4988662131519274,0.5011337868480725
91291,0.3448275862068966,0.6941896024464832,190,-227,0.3313733832229725,0.6686266167770275,home,DET,under,8,0.5238095238095238,-110,0.5011337868480725,DET,TOR,2023 REG,5,2,0,0,2,5,1,0,2,-2,0,0,0,0,0,0,0,0,0,0.4988662131519274,0.5011337868480725
91292,0.5098039215686274,0.5348837209302326,-104,-115,0.4870219861770517,0.5129780138229483,away,CHC,over,9,0.5348837209302326,-115,0.5097020142727117,NYM,CHC,2023 REG,8,4,7,3,7,15,1,0,1,-1,1,1,1,0,0,0,0,0,0,0.5097020142727117,0.49029798572728833
91292,0.5098039215686274,0.5348837209302326,-104,-115,0.4870219861770517,0.5129780138229483,home,NYM,under,9,0.5121951219512195,-105,0.49029798572728833,NYM,CHC,2023 REG,8,4,7,3,7,15,1,0,1,-1,1,1,1,0,0,0,0,0,0,0.5097020142727117,0.49029798572728833
91293,0.607843137254902,0.4291845493562232,-155,133,0.5853361120599043,0.4146638879400957,away,LAA,over,8.5,0.5121951219512195,-105,0.48808156828023186,NYY,LAA,2023 REG,9,9,7,3,12,16,1,0,6,-6,1,1,1,0,0,0,0,0,0,0.48808156828023186,0.5119184317197681
91293,0.607843137254902,0.4291845493562232,-155,133,0.5853361120599043,0.4146638879400957,home,NYY,under,8.5,0.5348837209302326,-115,0.5119184317197681,NYY,LAA,2023 REG,9,9,7,3,12,16,1,0,6,-6,1,1,1,0,0,0,0,0,0,0.48808156828023186,0.5119184317197681
91294,0.49751243781094534,0.5433789954337899,101,-119,0.4771684411717736,0.5228315588282264,away,ARI,over,10,0.5121951219512195,-105,0.48808156828023186,WSH,ARI,2023 REG,7,2,15,6,8,22,0,1,-4,4,1,1,0,0,0,0,0,0,0,0.48808156828023186,0.5119184317197681
91294,0.49751243781094534,0.5433789954337899,101,-119,0.4771684411717736,0.5228315588282264,home,WSH,under,10,0.5348837209302326,-115,0.5119184317197681,WSH,ARI,2023 REG,7,2,15,6,8,22,0,1,-4,4,1,1,0,0,0,0,0,0,0,0.48808156828023186,0.5119184317197681
91295,0.425531914893617,0.613899613899614,135,-159,0.40875254093905067,0.5912474590609493,away,NYY,over,9,0.5260663507109005,-111,0.5010269332605688,CWS,NYY,2023 REG,6,1,13,7,8,19,0,1,-6,6,1,0,0,0,0,0,0,0,0,0.5010269332605688,0.4989730667394312
91295,0.425531914893617,0.613899613899614,135,-159,0.40875254093905067,0.5912474590609493,home,CWS,under,9,0.5215311004784688,-109,0.4989730667394312,CWS,NYY,2023 REG,6,1,13,7,8,19,0,1,-6,6,1,0,0,0,0,0,0,0,0,0.5010269332605688,0.4989730667394312
91296,0.6124031007751938,0.4291845493562232,-158,133,0.5869346948807601,0.4130653051192399,away,DET,over,8,0.5121951219512195,-105,0.48808156828023186,TEX,DET,2023 REG,12,5,11,8,13,23,0,1,-3,3,1,1,1,1,1,0,0,0,0,0.48808156828023186,0.5119184317197681
91296,0.6124031007751938,0.4291845493562232,-158,133,0.5869346948807601,0.4130653051192399,home,TEX,under,8,0.5348837209302326,-115,0.5119184317197681,TEX,DET,2023 REG,12,5,11,8,13,23,0,1,-3,3,1,1,1,1,1,0,0,0,0,0.48808156828023186,0.5119184317197681
91297,0.5305164319248826,0.5121951219512195,-113,-105,0.5078572507605655,0.49214274923943446,away,SF,over,8.5,0.5215311004784688,-109,0.4978845547971712,MIA,SF,2023 REG,9,4,7,2,6,16,1,0,2,-2,1,1,0,0,0,0,0,0,0,0.4978845547971712,0.5021154452028288
91297,0.5305164319248826,0.5121951219512195,-113,-105,0.5078572507605655,0.49214274923943446,home,MIA,under,8.5,0.5238095238095238,-110,0.5021154452028288,MIA,SF,2023 REG,9,4,7,2,6,16,1,0,2,-2,1,1,0,0,0,0,0,0,0,0.4978845547971712,0.5021154452028288
91298,0.6254681647940076,0.41152263374485604,-167,143,0.6023315979176397,0.3976684020823603,away,LAD,over,9,0.5024875621890548,-101,0.47839724939301687,SD,LAD,2023 REG,11,8,6,3,11,17,1,0,5,-5,1,1,1,0,0,0,0,0,0,0.47839724939301687,0.5216027506069831
91298,0.6254681647940076,0.41152263374485604,-167,143,0.6023315979176397,0.3976684020823603,home,SD,under,9,0.5454545454545454,-120,0.5216027506069831,SD,LAD,2023 REG,11,8,6,3,11,17,1,0,5,-5,1,1,1,0,0,0,0,0,0,0.47839724939301687,0.5216027506069831
91299,0.5535714285714286,0.48780487804878053,-124,105,0.53066668740667,0.46933331259333,away,PHI,over,9,0.5098039215686274,-104,0.48483656587239576,LAD,PHI,2023 REG,11,10,10,6,16,21,1,0,4,-4,1,1,1,1,1,1,0,0,0,0.48483656587239576,0.5151634341276042
91299,0.5535714285714286,0.48780487804878053,-124,105,0.53066668740667,0.46933331259333,home,LAD,under,9,0.5391705069124424,-117,0.5151634341276042,LAD,PHI,2023 REG,11,10,10,6,16,21,1,0,4,-4,1,1,1,1,1,1,0,0,0,0.48483656587239576,0.5151634341276042
91300,0.6774193548387096,0.36363636363636365,-210,175,0.6496074165168858,0.3503925834831142,away,MIN,over,7.5,0.5238095238095238,-110,0.4988662131519274,TOR,MIN,2023 REG,12,7,10,6,13,22,1,0,1,-1,1,1,1,1,1,1,0,0,0,0.4988662131519274,0.5011337868480725
91300,0.6774193548387096,0.36363636363636365,-210,175,0.6496074165168858,0.3503925834831142,home,TOR,under,7.5,0.5238095238095238,-110,0.5011337868480725,TOR,MIN,2023 REG,12,7,10,6,13,22,1,0,1,-1,1,1,1,1,1,1,0,0,0,0.4988662131519274,0.5011337868480725
91301,0.43859649122807015,0.6031746031746031,128,-152,0.4202758357883012,0.5797241642116988,away,CLE,over,9,0.504950495049505,-102,0.4826715732667395,KC,CLE,2023 REG,10,6,8,2,8,18,1,0,4,-4,1,1,0,0,0,0,0,0,0,0.4826715732667395,0.5173284267332605
91301,0.43859649122807015,0.6031746031746031,128,-152,0.4202758357883012,0.5797241642116988,home,KC,under,9,0.5391705069124424,-117,0.5173284267332605,KC,CLE,2023 REG,10,6,8,2,8,18,1,0,4,-4,1,1,0,0,0,0,0,0,0,0.4826715732667395,0.5173284267332605
91302,0.4444444444444444,0.5918367346938775,125,-145,0.42831947593852354,0.5716805240614764,away,MIN,over,7.5,0.5348837209302326,-115,0.5097020142727117,CWS,MIN,2023 REG,7,3,5,7,10,12,0,1,-4,4,1,1,1,0,0,0,0,0,0,0.5097020142727117,0.49029798572728833
91302,0.4444444444444444,0.5918367346938775,125,-145,0.42831947593852354,0.5716805240614764,home,CWS,under,7.5,0.5121951219512195,-105,0.49029798572728833,CWS,MIN,2023 REG,7,3,5,7,10,12,0,1,-4,4,1,1,1,0,0,0,0,0,0,0.5097020142727117,0.49029798572728833
91303,0.5327102803738317,0.5098039215686274,-114,-104,0.5100625279371946,0.48993747206280536,away,BAL,over,8.5,0.5121951219512195,-105,0.48808156828023186,SD,BAL,2023 REG,13,10,11,3,13,24,1,0,7,-7,1,1,1,0,0,0,0,0,0,0.48808156828023186,0.5119184317197681
91303,0.5327102803738317,0.5098039215686274,-114,-104,0.5100625279371946,0.48993747206280536,home,SD,under,8.5,0.5348837209302326,-115,0.5119184317197681,SD,BAL,2023 REG,13,10,11,3,13,24,1,0,7,-7,1,1,1,0,0,0,0,0,0,0.48808156828023186,0.5119184317197681
91304,0.3125,0.7311827956989247,220,-272,0.298849126344086,0.701150873655914,away,TEX,over,8.5,0.5283018867924528,-112,0.5031902949311281,OAK,TEX,2023 REG,7,2,4,0,2,11,1,0,2,-2,0,0,0,0,0,0,0,0,0,0.5031902949311281,0.4968097050688719
91304,0.3125,0.7311827956989247,220,-272,0.298849126344086,0.701150873655914,home,OAK,under,8.5,0.5192307692307692,-108,0.4968097050688719,OAK,TEX,2023 REG,7,2,4,0,2,11,1,0,2,-2,0,0,0,0,0,0,0,0,0,0.5031902949311281,0.4968097050688719
91305,0.5614035087719298,0.47619047619047616,-128,110,0.5402981137053159,0.4597018862946841,away,LAA,over,7.5,0.5073891625615764,-103,0.48484779035144243,HOU,LAA,2023 REG,10,6,9,2,8,19,1,0,4,-4,1,1,0,0,0,0,0,0,0,0.48484779035144243,0.5151522096485576
91305,0.5614035087719298,0.47619047619047616,-128,110,0.5402981137053159,0.4597018862946841,home,HOU,under,7.5,0.5370370370370371,-116,0.5151522096485576,HOU,LAA,2023 REG,10,6,9,2,8,19,1,0,4,-4,1,1,0,0,0,0,0,0,0,0.48484779035144243,0.5151522096485576
91306,0.5121951219512195,0.5260663507109005,-105,-111,0.4925977822950117,0.5074022177049883,away,CIN,over,10,0.5169082125603864,-107,0.49353874091423283,KC,CIN,2023 REG,8,4,5,5,9,13,0,1,-1,1,1,1,1,1,0,0,0,0,0,0.49353874091423283,0.5064612590857671
91306,0.5121951219512195,0.5260663507109005,-105,-111,0.4925977822950117,0.5074022177049883,home,KC,under,10,0.5283018867924528,-112,0.5064612590857671,KC,CIN,2023 REG,8,4,5,5,9,13,0,1,-1,1,1,1,1,1,0,0,0,0,0,0.49353874091423283,0.5064612590857671
91307,0.4329004329004329,0.607843137254902,131,-155,0.41526252374227923,0.5847374762577208,away,HOU,over,8.5,0.5454545454545454,-120,0.5206611570247933,CWS,HOU,2023 REG,3,1,8,5,6,11,0,1,-4,4,1,0,0,0,0,0,0,0,0,0.5206611570247933,0.4793388429752067
91307,0.4329004329004329,0.607843137254902,131,-155,0.41526252374227923,0.5847374762577208,home,CWS,under,8.5,0.5,100,0.4793388429752067,CWS,HOU,2023 REG,3,1,8,5,6,11,0,1,-4,4,1,0,0,0,0,0,0,0,0,0.5206611570247933,0.4793388429752067
91308,0.4504504504504505,0.5884773662551441,122,-143,0.4329153978803628,0.5670846021196372,away,BAL,over,9,0.5,100,0.4772727272727273,WSH,BAL,2023 REG,6,0,4,4,4,10,0,1,-4,4,0,0,0,0,0,0,0,0,0,0.4772727272727273,0.5227272727272727
91308,0.4504504504504505,0.5884773662551441,122,-143,0.4329153978803628,0.5670846021196372,home,WSH,under,9,0.5454545454545454,-120,0.5227272727272727,WSH,BAL,2023 REG,6,0,4,4,4,10,0,1,-4,4,0,0,0,0,0,0,0,0,0,0.4772727272727273,0.5227272727272727
91309,0.5215311004784688,0.5215311004784688,-109,-109,0.49907282342437215,0.5009271765756278,away,ATL,over,9,0.5454545454545454,-120,0.5206611570247933,LAD,ATL,2023 REG,11,3,5,1,4,16,1,0,2,-2,1,0,0,0,0,0,0,0,0,0.5206611570247933,0.4793388429752067
91309,0.5215311004784688,0.5215311004784688,-109,-109,0.49907282342437215,0.5009271765756278,home,LAD,under,9,0.5,100,0.4793388429752067,LAD,ATL,2023 REG,11,3,5,1,4,16,1,0,2,-2,1,0,0,0,0,0,0,0,0,0.5206611570247933,0.4793388429752067
91310,0.5348837209302326,0.5121951219512195,-115,-105,0.5097020142727117,0.49029798572728833,away,NYM,over,9.5,0.5305164319248826,-113,0.5053568787472517,PHI,NYM,2023 REG,8,5,3,1,6,11,1,0,4,-4,1,0,0,0,0,0,0,0,0,0.5053568787472517,0.49464312125274834
91310,0.5348837209302326,0.5121951219512195,-115,-105,0.5097020142727117,0.49029798572728833,home,PHI,under,9.5,0.5169082125603864,-107,0.49464312125274834,PHI,NYM,2023 REG,8,5,3,1,6,11,1,0,4,-4,1,0,0,0,0,0,0,0,0,0.5053568787472517,0.49464312125274834
91311,0.6551724137931035,0.38167938931297707,-190,162,0.6310281289994645,0.3689718710005355,away,NYM,over,8.5,0.504950495049505,-102,0.4826715732667395,ATL,NYM,2023 REG,19,13,14,10,23,33,1,0,3,-3,1,1,1,1,1,1,1,1,1,0.4826715732667395,0.5173284267332605
91311,0.6551724137931035,0.38167938931297707,-190,162,0.6310281289994645,0.3689718710005355,home,ATL,under,8.5,0.5391705069124424,-117,0.5173284267332605,ATL,NYM,2023 REG,19,13,14,10,23,33,1,0,3,-3,1,1,1,1,1,1,1,1,1,0.4826715732667395,0.5173284267332605
91312,0.3076923076923077,0.7275204359673024,225,-267,0.2968576173355046,0.7031423826644954,away,TB,over,8.5,0.5215311004784688,-109,0.4978845547971712,WSH,TB,2023 REG,6,2,11,7,9,17,0,1,-5,5,1,1,0,0,0,0,0,0,0,0.4978845547971712,0.5021154452028288
91312,0.3076923076923077,0.7275204359673024,225,-267,0.2968576173355046,0.7031423826644954,home,WSH,under,8.5,0.5238095238095238,-110,0.5021154452028288,WSH,TB,2023 REG,6,2,11,7,9,17,0,1,-5,5,1,1,0,0,0,0,0,0,0,0.4978845547971712,0.5021154452028288
91313,0.6108949416342413,0.425531914893617,-157,135,0.5886419592417365,0.41135804075826354,away,KC,over,10,0.5238095238095238,-110,0.5000596729920038,ARI,KC,2023 REG,7,5,10,4,9,17,1,0,1,-1,1,1,1,1,0,0,0,0,0,0.5000596729920038,0.4999403270079962
91313,0.6108949416342413,0.425531914893617,-157,135,0.5886419592417365,0.41135804075826354,home,ARI,under,10,0.5215311004784688,-109,0.4999403270079962,ARI,KC,2023 REG,7,5,10,4,9,17,1,0,1,-1,1,1,1,1,0,0,0,0,0,0.5000596729920038,0.4999403270079962
91314,0.43103448275862066,0.607843137254902,132,-155,0.4142768879252058,0.5857231120747942,away,LAA,over,7.5,0.5391705069124424,-117,0.5140669063204599,OAK,LAA,2023 REG,5,0,11,6,6,16,0,1,-6,6,0,0,0,0,0,0,0,0,0,0.5140669063204599,0.4859330936795401
91314,0.43103448275862066,0.607843137254902,132,-155,0.4142768879252058,0.5857231120747942,home,OAK,under,7.5,0.5073891625615764,-103,0.4859330936795401,OAK,LAA,2023 REG,5,0,11,6,6,16,0,1,-6,6,0,0,0,0,0,0,0,0,0,0.5140669063204599,0.4859330936795401
91315,0.7333333333333333,0.3076923076923077,-275,225,0.7032478632478633,0.29675213675213674,away,COL,over,8,0.5412844036697247,-118,0.5136310900085983,SD,COL,2023 REG,15,11,13,9,20,28,1,0,2,-2,1,1,1,1,1,1,1,1,1,0.5136310900085983,0.4863689099914017
91315,0.7333333333333333,0.3076923076923077,-275,225,0.7032478632478633,0.29675213675213674,home,SD,under,8,0.5098039215686274,-104,0.4863689099914017,SD,COL,2023 REG,15,11,13,9,20,28,1,0,2,-2,1,1,1,1,1,1,1,1,1,0.5136310900085983,0.4863689099914017
91316,0.5327102803738317,0.5098039215686274,-114,-104,0.5100625279371946,0.48993747206280536,away,MIA,over,7.5,0.5073891625615764,-103,0.4837652908580103,SEA,MIA,2023 REG,10,8,1,1,9,11,1,0,7,-7,1,0,0,0,0,0,0,0,0,0.4837652908580103,0.5162347091419897
91316,0.5327102803738317,0.5098039215686274,-114,-104,0.5100625279371946,0.48993747206280536,home,SEA,under,7.5,0.5391705069124424,-117,0.5162347091419897,SEA,MIA,2023 REG,10,8,1,1,9,11,1,0,7,-7,1,0,0,0,0,0,0,0,0,0.4837652908580103,0.5162347091419897
91317,0.607843137254902,0.43103448275862066,-155,132,0.5842116427368785,0.41578835726312147,away,MIL,over,8,0.5215311004784688,-109,0.49670754937970685,LAD,MIL,2023 REG,4,1,5,0,1,9,1,0,1,-1,0,0,0,0,0,0,0,0,0,0.49670754937970685,0.5032924506202932
91317,0.607843137254902,0.43103448275862066,-155,132,0.5842116427368785,0.41578835726312147,home,LAD,under,8,0.5260663507109005,-111,0.5032924506202932,LAD,MIL,2023 REG,4,1,5,0,1,9,1,0,1,-1,0,0,0,0,0,0,0,0,0,0.49670754937970685,0.5032924506202932
91318,0.44052863436123346,0.5951417004048584,127,-147,0.424814830499519,0.575185169500481,away,TOR,over,7.5,0.5348837209302326,-115,0.5097020142727117,MIN,TOR,2023 REG,5,1,8,3,4,13,0,1,-2,2,1,0,0,0,0,0,0,0,0,0.5097020142727117,0.49029798572728833
91318,0.44052863436123346,0.5951417004048584,127,-147,0.424814830499519,0.575185169500481,home,MIN,under,7.5,0.5121951219512195,-105,0.49029798572728833,MIN,TOR,2023 REG,5,1,8,3,4,13,0,1,-2,2,1,0,0,0,0,0,0,0,0,0.5097020142727117,0.49029798572728833
91319,0.5780590717299579,0.4566210045662101,-137,119,0.558011939018671,0.44198806098132903,away,HOU,over,8,0.5238095238095238,-110,0.4988662131519274,CLE,HOU,2023 REG,10,4,10,6,10,20,0,1,-2,2,1,1,1,1,0,0,0,0,0,0.4988662131519274,0.5011337868480725
91319,0.5780590717299579,0.4566210045662101,-137,119,0.558011939018671,0.44198806098132903,home,CLE,under,8,0.5238095238095238,-110,0.5011337868480725,CLE,HOU,2023 REG,10,4,10,6,10,20,0,1,-2,2,1,1,1,1,0,0,0,0,0,0.4988662131519274,0.5011337868480725
91320,0.47846889952153115,0.5614035087719298,109,-128,0.45939119220408575,0.5406088077959142,away,NYM,over,11,0.504950495049505,-102,0.47949844489399435,WSH,NYM,2023 REG,9,3,8,2,5,17,1,0,1,-1,1,1,0,0,0,0,0,0,0,0.47949844489399435,0.5205015551060057
91320,0.47846889952153115,0.5614035087719298,109,-128,0.45939119220408575,0.5406088077959142,home,WSH,under,11,0.5454545454545454,-120,0.5205015551060057,WSH,NYM,2023 REG,9,3,8,2,5,17,1,0,1,-1,1,1,0,0,0,0,0,0,0,0.47949844489399435,0.5205015551060057
91321,0.7685185185185185,0.27624309392265195,-332,262,0.7341183904387301,0.26588160956126994,away,KC,over,8,0.5348837209302326,-115,0.5097020142727117,SEA,KC,2023 REG,6,3,5,2,5,11,1,0,1,-1,1,1,0,0,0,0,0,0,0,0.5097020142727117,0.49029798572728833
91321,0.7685185185185185,0.27624309392265195,-332,262,0.7341183904387301,0.26588160956126994,home,SEA,under,8,0.5121951219512195,-105,0.49029798572728833,SEA,KC,2023 REG,6,3,5,2,5,11,1,0,1,-1,1,1,0,0,0,0,0,0,0,0.5097020142727117,0.49029798572728833
91322,0.4444444444444444,0.5983935742971888,125,-149,0.4254053250037185,0.5745946749962815,away,CWS,over,8,0.5260663507109005,-111,0.5022370601254724,DET,CWS,2023 REG,10,7,4,2,9,14,1,0,5,-5,1,1,0,0,0,0,0,0,0,0.5022370601254724,0.4977629398745276
91322,0.4444444444444444,0.5983935742971888,125,-149,0.4254053250037185,0.5745946749962815,home,DET,under,8,0.5192307692307692,-108,0.4977629398745276,DET,CWS,2023 REG,10,7,4,2,9,14,1,0,5,-5,1,1,0,0,0,0,0,0,0,0.5022370601254724,0.4977629398745276
91323,0.5348837209302326,0.5073891625615764,-115,-103,0.5122726437136835,0.48772735628631647,away,HOU,over,8.5,0.5454545454545454,-120,0.5206611570247933,ATL,HOU,2023 REG,7,4,11,6,10,18,0,1,-2,2,1,1,1,1,0,0,0,0,0,0.5206611570247933,0.4793388429752067
91323,0.5348837209302326,0.5073891625615764,-115,-103,0.5122726437136835,0.48772735628631647,home,ATL,under,8.5,0.5,100,0.4793388429752067,ATL,HOU,2023 REG,7,4,11,6,10,18,0,1,-2,2,1,1,1,1,0,0,0,0,0,0.5206611570247933,0.4793388429752067
91324,0.48780487804878053,0.5475113122171946,105,-121,0.470577468162939,0.529422531837061,away,TB,over,8,0.5098039215686274,-104,0.48592421718142587,CHC,TB,2023 REG,3,1,1,0,1,4,1,0,1,-1,0,0,0,0,0,0,0,0,0,0.48592421718142587,0.5140757828185741
91324,0.48780487804878053,0.5475113122171946,105,-121,0.470577468162939,0.529422531837061,home,CHC,under,8,0.5370370370370371,-116,0.5140757828185741,CHC,TB,2023 REG,3,1,1,0,1,4,1,0,1,-1,0,0,0,0,0,0,0,0,0,0.48592421718142587,0.5140757828185741
91325,0.5934959349593496,0.4444444444444444,-146,125,0.5709784740123824,0.42902152598761756,away,PIT,over,8.5,0.5238095238095238,-110,0.4988662131519274,CIN,PIT,2023 REG,6,6,7,2,8,13,1,0,4,-4,1,1,0,0,0,0,0,0,0,0.4988662131519274,0.5011337868480725
91325,0.5934959349593496,0.4444444444444444,-146,125,0.5709784740123824,0.42902152598761756,home,CIN,under,8.5,0.5238095238095238,-110,0.5011337868480725,CIN,PIT,2023 REG,6,6,7,2,8,13,1,0,4,-4,1,1,0,0,0,0,0,0,0,0.4988662131519274,0.5011337868480725
91326,0.5327102803738317,0.5098039215686274,-114,-104,0.5100625279371946,0.48993747206280536,away,BAL,over,8.5,0.5238095238095238,-110,0.5012646084074657,TOR,BAL,2023 REG,5,3,15,13,16,20,0,1,-10,10,1,1,1,0,0,0,0,0,0,0.5012646084074657,0.4987353915925343
91326,0.5327102803738317,0.5098039215686274,-114,-104,0.5100625279371946,0.48993747206280536,home,TOR,under,8.5,0.5192307692307692,-108,0.4987353915925343,TOR,BAL,2023 REG,5,3,15,13,16,20,0,1,-10,10,1,1,1,0,0,0,0,0,0,0.5012646084074657,0.4987353915925343
91327,0.43859649122807015,0.6000000000000001,128,-150,0.4216682056017235,0.5783317943982764,away,SF,over,9,0.5,100,0.4783105022831051,DET,SF,2023 REG,10,7,11,5,12,21,1,0,2,-2,1,1,1,1,1,0,0,0,0,0.4783105022831051,0.5216894977168949
91327,0.43859649122807015,0.6000000000000001,128,-150,0.4216682056017235,0.5783317943982764,home,DET,under,9,0.5433789954337899,-119,0.5216894977168949,DET,SF,2023 REG,10,7,11,5,12,21,1,0,2,-2,1,1,1,1,1,0,0,0,0,0.4783105022831051,0.5216894977168949
91328,0.7967479674796748,0.24390243902439027,-392,310,0.7643598387203383,0.2356401612796617,away,COL,over,8.5,0.5121951219512195,-105,0.48808156828023186,LAD,COL,2023 REG,5,2,4,1,3,9,1,0,1,-1,1,0,0,0,0,0,0,0,0,0.48808156828023186,0.5119184317197681
91328,0.7967479674796748,0.24390243902439027,-392,310,0.7643598387203383,0.2356401612796617,home,LAD,under,8.5,0.5348837209302326,-115,0.5119184317197681,LAD,COL,2023 REG,5,2,4,1,3,9,1,0,1,-1,1,0,0,0,0,0,0,0,0,0.48808156828023186,0.5119184317197681
91329,0.5098039215686274,0.5348837209302326,-104,-115,0.4870219861770517,0.5129780138229483,away,BOS,over,9.5,0.5073891625615764,-103,0.4826927225525911,LAA,BOS,2023 REG,9,4,2,0,4,11,1,0,4,-4,0,0,0,0,0,0,0,0,0,0.4826927225525911,0.5173072774474089
91329,0.5098039215686274,0.5348837209302326,-104,-115,0.4870219861770517,0.5129780138229483,home,LAA,under,9.5,0.5412844036697247,-118,0.5173072774474089,LAA,BOS,2023 REG,9,4,2,0,4,11,1,0,4,-4,0,0,0,0,0,0,0,0,0,0.4826927225525911,0.5173072774474089
91330,0.45454545454545453,0.5815899581589958,120,-139,0.43812026695252254,0.5618797330474774,away,TOR,over,8.5,0.5238095238095238,-110,0.5000596729920038,PIT,TOR,2023 REG,5,2,14,8,10,19,0,1,-6,6,1,1,0,0,0,0,0,0,0,0.5000596729920038,0.4999403270079962
91330,0.45454545454545453,0.5815899581589958,120,-139,0.43812026695252254,0.5618797330474774,home,PIT,under,8.5,0.5215311004784688,-109,0.4999403270079962,PIT,TOR,2023 REG,5,2,14,8,10,19,0,1,-6,6,1,1,0,0,0,0,0,0,0,0.5000596729920038,0.4999403270079962
91331,0.5555555555555556,0.4854368932038835,-125,106,0.5327819729114227,0.4672180270885773,away,BOS,over,7.5,0.5283018867924528,-112,0.5031902949311281,SEA,BOS,2023 REG,8,6,9,2,8,17,1,0,4,-4,1,1,0,0,0,0,0,0,0,0.5031902949311281,0.4968097050688719
91331,0.5555555555555556,0.4854368932038835,-125,106,0.5327819729114227,0.4672180270885773,home,SEA,under,7.5,0.5192307692307692,-108,0.4968097050688719,SEA,BOS,2023 REG,8,6,9,2,8,17,1,0,4,-4,1,1,0,0,0,0,0,0,0,0.5031902949311281,0.4968097050688719
91332,0.5918367346938775,0.4504504504504505,-145,122,0.566809625118663,0.43319037488133705,away,SF,over,8.5,0.5238095238095238,-110,0.4988662131519274,NYY,SF,2023 REG,10,5,12,7,12,22,0,1,-2,2,1,1,1,1,1,0,0,0,0,0.4988662131519274,0.5011337868480725
91332,0.5918367346938775,0.4504504504504505,-145,122,0.566809625118663,0.43319037488133705,home,NYY,under,8.5,0.5238095238095238,-110,0.5011337868480725,NYY,SF,2023 REG,10,5,12,7,12,22,0,1,-2,2,1,1,1,1,1,0,0,0,0,0.4988662131519274,0.5011337868480725
91333,0.5951417004048584,0.4444444444444444,-147,125,0.5715823348467713,0.42841766515322866,away,CIN,over,6.5,0.5348837209302326,-115,0.5109810284308424,CHC,CIN,2023 REG,2,0,19,9,9,21,0,1,-9,9,0,0,0,0,0,0,0,0,0,0.5109810284308424,0.48901897156915763
91333,0.5951417004048584,0.4444444444444444,-147,125,0.5715823348467713,0.42841766515322866,home,CHC,under,6.5,0.5098039215686274,-104,0.48901897156915763,CHC,CIN,2023 REG,2,0,19,9,9,21,0,1,-9,9,0,0,0,0,0,0,0,0,0,0.5109810284308424,0.48901897156915763
91335,0.626865671641791,0.4098360655737705,-168,144,0.6038586124917376,0.39614138750826244,away,ARI,over,8.5,0.5169082125603864,-107,0.49353874091423283,CHC,ARI,2023 REG,5,2,10,6,8,15,0,1,-4,4,1,1,0,0,0,0,0,0,0,0.49353874091423283,0.5064612590857671
91335,0.626865671641791,0.4098360655737705,-168,144,0.6038586124917376,0.39614138750826244,home,CHC,under,8.5,0.5283018867924528,-112,0.5064612590857671,CHC,ARI,2023 REG,5,2,10,6,8,15,0,1,-4,4,1,1,0,0,0,0,0,0,0,0.49353874091423283,0.5064612590857671
91336,0.4854368932038835,0.5535714285714286,106,-124,0.4665008146721786,0.5334991853278215,away,PHI,over,8,0.5348837209302326,-115,0.5097020142727117,CLE,PHI,2023 REG,5,1,2,0,1,7,1,0,1,-1,0,0,0,0,0,0,0,0,0,0.5097020142727117,0.49029798572728833
91336,0.4854368932038835,0.5535714285714286,106,-124,0.4665008146721786,0.5334991853278215,home,CLE,under,8,0.5121951219512195,-105,0.49029798572728833,CLE,PHI,2023 REG,5,1,2,0,1,7,1,0,1,-1,0,0,0,0,0,0,0,0,0,0.5097020142727117,0.49029798572728833
91337,0.425531914893617,0.6108949416342413,135,-157,0.41003112488176247,0.5899688751182375,away,TOR,over,8,0.5215311004784688,-109,0.49907282342437215,MIA,TOR,2023 REG,19,11,7,0,11,26,1,0,11,-11,0,0,0,0,0,0,0,0,0,0.49907282342437215,0.5009271765756278
91337,0.425531914893617,0.6108949416342413,135,-157,0.41003112488176247,0.5899688751182375,home,MIA,under,8,0.5215311004784688,-109,0.5009271765756278,MIA,TOR,2023 REG,19,11,7,0,11,26,1,0,11,-11,0,0,0,0,0,0,0,0,0,0.49907282342437215,0.5009271765756278
91338,0.5833333333333333,0.45454545454545453,-140,120,0.5612373737373737,0.4387626262626263,away,LAA,over,7,0.5495495495495495,-122,0.5263803278714742,SEA,LAA,2023 REG,5,3,11,7,10,16,0,1,-4,4,1,1,1,0,0,0,0,0,0,0.5263803278714742,0.47361967212852585
91338,0.5833333333333333,0.45454545454545453,-140,120,0.5612373737373737,0.4387626262626263,home,SEA,under,7,0.4926108374384236,103,0.47361967212852585,SEA,LAA,2023 REG,5,3,11,7,10,16,0,1,-4,4,1,1,1,0,0,0,0,0,0,0.5263803278714742,0.47361967212852585
91339,0.5305164319248826,0.5098039215686274,-113,-104,0.5091258218555558,0.49087417814444423,away,TEX,over,9.5,0.5073891625615764,-103,0.4826927225525911,KC,TEX,2023 REG,9,3,13,12,15,22,0,1,-9,9,1,1,1,0,0,0,0,0,0,0.4826927225525911,0.5173072774474089
91339,0.5305164319248826,0.5098039215686274,-113,-104,0.5091258218555558,0.49087417814444423,home,KC,under,9.5,0.5412844036697247,-118,0.5173072774474089,KC,TEX,2023 REG,9,3,13,12,15,22,0,1,-9,9,1,1,1,0,0,0,0,0,0,0.4826927225525911,0.5173072774474089
91340,0.4926108374384236,0.5495495495495495,103,-122,0.4718421738975501,0.5281578261024499,away,PHI,over,8.5,0.504950495049505,-102,0.4826715732667395,CLE,PHI,2023 REG,13,6,8,5,11,21,1,0,1,-1,1,1,1,1,1,0,0,0,0,0.4826715732667395,0.5173284267332605
91340,0.4926108374384236,0.5495495495495495,103,-122,0.4718421738975501,0.5281578261024499,home,CLE,under,8.5,0.5391705069124424,-117,0.5173284267332605,CLE,PHI,2023 REG,13,6,8,5,11,21,1,0,1,-1,1,1,1,1,1,0,0,0,0,0.4826715732667395,0.5173284267332605
91341,0.6721311475409836,0.36363636363636365,-205,175,0.6480906892086682,0.3519093107913318,away,CWS,over,9,0.5121951219512195,-105,0.48808156828023186,NYM,CWS,2023 REG,5,5,3,1,6,8,1,0,4,-4,1,0,0,0,0,0,0,0,0,0.48808156828023186,0.5119184317197681
91341,0.6721311475409836,0.36363636363636365,-205,175,0.6480906892086682,0.3519093107913318,home,NYM,under,9,0.5348837209302326,-115,0.5119184317197681,NYM,CWS,2023 REG,5,5,3,1,6,8,1,0,4,-4,1,0,0,0,0,0,0,0,0,0.48808156828023186,0.5119184317197681
91342,0.6254681647940076,0.4098360655737705,-167,144,0.6033864926164085,0.39661350738359147,away,DET,over,9,0.504950495049505,-102,0.48054649490447493,NYY,DET,2023 REG,11,4,6,3,7,17,1,0,1,-1,1,1,1,0,0,0,0,0,0,0.48054649490447493,0.5194535050955251
91342,0.6254681647940076,0.4098360655737705,-167,144,0.6033864926164085,0.39661350738359147,home,NYY,under,9,0.5433789954337899,-119,0.5194535050955251,NYY,DET,2023 REG,11,4,6,3,7,17,1,0,1,-1,1,1,1,0,0,0,0,0,0,0.48054649490447493,0.5194535050955251
91343,0.5918367346938775,0.4484304932735426,-145,123,0.5680051099784656,0.43199489002153435,away,HOU,over,8.5,0.5454545454545454,-120,0.5206611570247933,LAD,HOU,2023 REG,9,3,3,2,5,12,1,0,1,-1,1,1,0,0,0,0,0,0,0,0.5206611570247933,0.4793388429752067
91343,0.5918367346938775,0.4484304932735426,-145,123,0.5680051099784656,0.43199489002153435,home,LAD,under,8.5,0.5,100,0.4793388429752067,LAD,HOU,2023 REG,9,3,3,2,5,12,1,0,1,-1,1,1,0,0,0,0,0,0,0,0.5206611570247933,0.4793388429752067
91344,0.45454545454545453,0.5850622406639003,120,-141,0.4365419567230205,0.5634580432769796,away,TOR,over,9.5,0.5024875621890548,-101,0.4794401874631478,CLE,TOR,2023 REG,5,4,10,3,7,15,1,0,1,-1,1,1,1,0,0,0,0,0,0,0.4794401874631478,0.5205598125368522
91344,0.45454545454545453,0.5850622406639003,120,-141,0.4365419567230205,0.5634580432769796,home,CLE,under,9.5,0.5433789954337899,-119,0.5205598125368522,CLE,TOR,2023 REG,5,4,10,3,7,15,1,0,1,-1,1,1,1,0,0,0,0,0,0,0.4794401874631478,0.5205598125368522
91345,0.4504504504504505,0.5901639344262295,122,-144,0.43215568248798203,0.567844317512018,away,HOU,over,8.5,0.5260663507109005,-111,0.5010269332605688,NYY,HOU,2023 REG,9,3,2,1,4,11,1,0,2,-2,1,0,0,0,0,0,0,0,0,0.5010269332605688,0.4989730667394312
91345,0.4504504504504505,0.5901639344262295,122,-144,0.43215568248798203,0.567844317512018,home,NYY,under,8.5,0.5215311004784688,-109,0.4989730667394312,NYY,HOU,2023 REG,9,3,2,1,4,11,1,0,2,-2,1,0,0,0,0,0,0,0,0,0.5010269332605688,0.4989730667394312
91346,0.6610169491525424,0.37735849056603776,-195,165,0.6356501330673793,0.3643498669326207,away,CWS,over,9.5,0.5370370370370371,-116,0.5118817074154765,TOR,CWS,2023 REG,11,8,4,0,8,15,1,0,8,-8,0,0,0,0,0,0,0,0,0,0.5118817074154765,0.48811829258452355
91346,0.6610169491525424,0.37735849056603776,-195,165,0.6356501330673793,0.3643498669326207,home,TOR,under,9.5,0.5098039215686274,-104,0.48811829258452355,TOR,CWS,2023 REG,11,8,4,0,8,15,1,0,8,-8,0,0,0,0,0,0,0,0,0,0.5118817074154765,0.48811829258452355
91347,0.5884773662551441,0.4484304932735426,-143,123,0.5667579262855877,0.43324207371441226,away,BOS,over,9,0.5169082125603864,-107,0.49239402434819424,HOU,BOS,2023 REG,10,1,25,17,18,35,0,1,-16,16,1,0,0,0,0,0,0,0,0,0.49239402434819424,0.5076059756518058
91347,0.5884773662551441,0.4484304932735426,-143,123,0.5667579262855877,0.43324207371441226,home,HOU,under,9,0.5305164319248826,-113,0.5076059756518058,HOU,BOS,2023 REG,10,1,25,17,18,35,0,1,-16,16,1,0,0,0,0,0,0,0,0,0.49239402434819424,0.5076059756518058
91348,0.37037037037037035,0.6666666666666666,170,-200,0.35665294924554186,0.6433470507544581,away,CHC,over,8,0.5098039215686274,-104,0.48592421718142587,WSH,CHC,2023 REG,8,2,6,1,3,14,1,0,1,-1,1,0,0,0,0,0,0,0,0,0.48592421718142587,0.5140757828185741
91348,0.37037037037037035,0.6666666666666666,170,-200,0.35665294924554186,0.6433470507544581,home,WSH,under,8,0.5370370370370371,-116,0.5140757828185741,WSH,CHC,2023 REG,8,2,6,1,3,14,1,0,1,-1,1,0,0,0,0,0,0,0,0,0.48592421718142587,0.5140757828185741
91349,0.3846153846153846,0.6551724137931035,160,-190,0.3693123852275045,0.6306876147724956,away,TB,over,8.5,0.5215311004784688,-109,0.49907282342437215,BAL,TB,2023 REG,7,0,7,3,3,14,0,1,-3,3,0,0,0,0,0,0,0,0,0,0.49907282342437215,0.5009271765756278
91349,0.3846153846153846,0.6551724137931035,160,-190,0.3693123852275045,0.6306876147724956,home,BAL,under,8.5,0.5215311004784688,-109,0.5009271765756278,BAL,TB,2023 REG,7,0,7,3,3,14,0,1,-3,3,0,0,0,0,0,0,0,0,0,0.49907282342437215,0.5009271765756278
91350,0.5708154506437768,0.46511627906976744,-133,115,0.5503050641549297,0.44969493584507025,away,CWS,over,7,0.5454545454545454,-120,0.5206611570247933,SEA,CWS,2023 REG,9,3,5,2,5,14,1,0,1,-1,1,1,0,0,0,0,0,0,0,0.5206611570247933,0.4793388429752067
91350,0.5708154506437768,0.46511627906976744,-133,115,0.5503050641549297,0.44969493584507025,home,SEA,under,7,0.5,100,0.4793388429752067,SEA,CWS,2023 REG,9,3,5,2,5,14,1,0,1,-1,1,1,0,0,0,0,0,0,0,0.5206611570247933,0.4793388429752067
91351,0.5652173913043479,0.4672897196261683,-130,114,0.5468438068653605,0.4531561931346395,away,TOR,over,9,0.5454545454545454,-120,0.5206611570247933,LAA,TOR,2023 REG,10,9,10,5,14,20,1,0,4,-4,1,1,1,1,1,0,0,0,0,0.5206611570247933,0.4793388429752067
91351,0.5652173913043479,0.4672897196261683,-130,114,0.5468438068653605,0.4531561931346395,home,LAA,under,9,0.5,100,0.4793388429752067,LAA,TOR,2023 REG,10,9,10,5,14,20,1,0,4,-4,1,1,1,1,1,0,0,0,0,0.5206611570247933,0.4793388429752067
91352,0.696969696969697,0.3436426116838488,-230,191,0.6686641485141954,0.3313358514858046,away,COL,over,9.5,0.5305164319248826,-113,0.5066009958897986,BOS,COL,2023 REG,10,6,7,3,9,17,1,0,3,-3,1,1,1,0,0,0,0,0,0,0.5066009958897986,0.49339900411020143
91352,0.696969696969697,0.3436426116838488,-230,191,0.6686641485141954,0.3313358514858046,home,BOS,under,9.5,0.5145631067961165,-106,0.49339900411020143,BOS,COL,2023 REG,10,6,7,3,9,17,1,0,3,-3,1,1,1,0,0,0,0,0,0,0.5066009958897986,0.49339900411020143
91353,0.5495495495495495,0.49504950495049505,-122,102,0.5250401592387142,0.47495984076128583,away,CIN,over,9.5,0.5145631067961165,-106,0.49023796582517226,ARI,CIN,2023 REG,8,7,13,8,15,21,0,1,-1,1,1,1,1,1,1,1,1,0,0,0.49023796582517226,0.5097620341748277
91353,0.5495495495495495,0.49504950495049505,-122,102,0.5250401592387142,0.47495984076128583,home,ARI,under,9.5,0.5327102803738317,-114,0.5097620341748277,ARI,CIN,2023 REG,8,7,13,8,15,21,0,1,-1,1,1,1,1,1,1,1,1,0,0,0.49023796582517226,0.5097620341748277
91354,0.5348837209302326,0.5098039215686274,-115,-104,0.5109810284308424,0.48901897156915763,away,LAA,over,8.5,0.5260663507109005,-111,0.5010269332605688,NYM,LAA,2023 REG,9,3,4,2,5,13,1,0,1,-1,1,1,0,0,0,0,0,0,0,0.5010269332605688,0.4989730667394312
91354,0.5348837209302326,0.5098039215686274,-115,-104,0.5109810284308424,0.48901897156915763,home,NYM,under,8.5,0.5215311004784688,-109,0.4989730667394312,NYM,LAA,2023 REG,9,3,4,2,5,13,1,0,1,-1,1,1,0,0,0,0,0,0,0,0.5010269332605688,0.4989730667394312
91355,0.5884773662551441,0.4566210045662101,-143,119,0.5619379957717958,0.4380620042282042,away,BAL,over,8.5,0.5,100,0.4772727272727273,SD,BAL,2023 REG,4,1,9,4,5,13,0,1,-3,3,1,0,0,0,0,0,0,0,0,0.4772727272727273,0.5227272727272727
91355,0.5884773662551441,0.4566210045662101,-143,119,0.5619379957717958,0.4380620042282042,home,SD,under,8.5,0.5454545454545454,-120,0.5227272727272727,SD,BAL,2023 REG,4,1,9,4,5,13,0,1,-3,3,1,0,0,0,0,0,0,0,0,0.4772727272727273,0.5227272727272727
91356,0.7389033942558746,0.30303030303030304,-283,230,0.7079184429974196,0.2920815570025804,away,OAK,over,9,0.5121951219512195,-105,0.48808156828023186,TOR,OAK,2023 REG,12,7,8,3,10,20,1,0,4,-4,1,1,1,0,0,0,0,0,0,0.48808156828023186,0.5119184317197681
91356,0.7389033942558746,0.30303030303030304,-283,230,0.7079184429974196,0.2920815570025804,home,TOR,under,9,0.5348837209302326,-115,0.5119184317197681,TOR,OAK,2023 REG,12,7,8,3,10,20,1,0,4,-4,1,1,1,0,0,0,0,0,0,0.48808156828023186,0.5119184317197681
91357,0.4166666666666667,0.6226415094339623,140,-165,0.4002882599580712,0.5997117400419287,away,TOR,over,9,0.5192307692307692,-108,0.49455035168025013,PIT,TOR,2023 REG,4,0,8,4,4,12,0,1,-4,4,0,0,0,0,0,0,0,0,0,0.49455035168025013,0.5054496483197499
91357,0.4166666666666667,0.6226415094339623,140,-165,0.4002882599580712,0.5997117400419287,home,PIT,under,9,0.5283018867924528,-112,0.5054496483197499,PIT,TOR,2023 REG,4,0,8,4,4,12,0,1,-4,4,0,0,0,0,0,0,0,0,0,0.49455035168025013,0.5054496483197499
91358,0.4132231404958678,0.6226415094339623,142,-165,0.3984030372190785,0.6015969627809215,away,ATL,over,10,0.5238095238095238,-110,0.4988662131519274,BOS,ATL,2023 REG,8,5,6,3,8,14,1,0,2,-2,1,1,1,0,0,0,0,0,0,0.4988662131519274,0.5011337868480725
91358,0.4132231404958678,0.6226415094339623,142,-165,0.3984030372190785,0.6015969627809215,home,BOS,under,10,0.5238095238095238,-110,0.5011337868480725,BOS,ATL,2023 REG,8,5,6,3,8,14,1,0,2,-2,1,1,1,0,0,0,0,0,0,0.4988662131519274,0.5011337868480725
91359,0.5555555555555556,0.4807692307692307,-125,108,0.5353751187084521,0.4646248812915479,away,CLE,over,8.5,0.5121951219512195,-105,0.48808156828023186,NYY,CLE,2023 REG,6,2,5,3,5,11,0,1,-1,1,1,1,0,0,0,0,0,0,0,0.48808156828023186,0.5119184317197681
91359,0.5555555555555556,0.4807692307692307,-125,108,0.5353751187084521,0.4646248812915479,home,NYY,under,8.5,0.5348837209302326,-115,0.5119184317197681,NYY,CLE,2023 REG,6,2,5,3,5,11,0,1,-1,1,1,1,0,0,0,0,0,0,0,0.48808156828023186,0.5119184317197681
91360,0.7159090909090909,0.32573289902280134,-252,207,0.6860972117533044,0.3139027882466956,away,COL,over,9,0.5121951219512195,-105,0.48808156828023186,CHC,COL,2023 REG,7,4,5,3,7,12,1,0,1,-1,1,1,1,0,0,0,0,0,0,0.48808156828023186,0.5119184317197681
91360,0.7159090909090909,0.32573289902280134,-252,207,0.6860972117533044,0.3139027882466956,home,CHC,under,9,0.5348837209302326,-115,0.5119184317197681,CHC,COL,2023 REG,7,4,5,3,7,12,1,0,1,-1,1,1,1,0,0,0,0,0,0,0.48808156828023186,0.5119184317197681
91361,0.6551724137931035,0.3846153846153846,-190,160,0.6291045458703008,0.37089545412969915,away,MIL,over,8.5,0.5121951219512195,-105,0.48808156828023186,NYM,MIL,2023 REG,9,2,9,3,5,18,0,1,-1,1,1,1,0,0,0,0,0,0,0,0.48808156828023186,0.5119184317197681
91361,0.6551724137931035,0.3846153846153846,-190,160,0.6291045458703008,0.37089545412969915,home,NYM,under,8.5,0.5348837209302326,-115,0.5119184317197681,NYM,MIL,2023 REG,9,2,9,3,5,18,0,1,-1,1,1,1,0,0,0,0,0,0,0,0.48808156828023186,0.5119184317197681
91362,0.6415770609318996,0.3968253968253968,-179,152,0.616938924951412,0.383061075048588,away,NYY,over,7,0.5454545454545454,-120,0.5206611570247933,TB,NYY,2023 REG,7,3,2,0,3,9,1,0,3,-3,0,0,0,0,0,0,0,0,0,0.5206611570247933,0.4793388429752067
91362,0.6415770609318996,0.3968253968253968,-179,152,0.616938924951412,0.383061075048588,home,TB,under,7,0.5,100,0.4793388429752067,TB,NYY,2023 REG,7,3,2,0,3,9,1,0,3,-3,0,0,0,0,0,0,0,0,0,0.5206611570247933,0.4793388429752067
91363,0.43859649122807015,0.5967741935483871,128,-148,0.4230830329927819,0.5769169670072181,away,TOR,over,9.5,0.5145631067961165,-106,0.4913668392989033,BOS,TOR,2023 REG,15,8,7,3,11,22,1,0,5,-5,1,1,1,0,0,0,0,0,0,0.4913668392989033,0.5086331607010968
91363,0.43859649122807015,0.5967741935483871,128,-148,0.4230830329927819,0.5769169670072181,home,BOS,under,9.5,0.5305164319248826,-113,0.5086331607010968,BOS,TOR,2023 REG,15,8,7,3,11,22,1,0,5,-5,1,1,1,0,0,0,0,0,0,0.4913668392989033,0.5086331607010968
91364,0.373134328358209,0.6666666666666666,168,-200,0.3582832108116136,0.6417167891883864,away,NYM,over,10.5,0.5098039215686274,-104,0.48483656587239576,CIN,NYM,2023 REG,10,5,6,0,5,16,1,0,5,-5,0,0,0,0,0,0,0,0,0,0.48483656587239576,0.5151634341276042
91364,0.373134328358209,0.6666666666666666,168,-200,0.3582832108116136,0.6417167891883864,home,CIN,under,10.5,0.5391705069124424,-117,0.5151634341276042,CIN,NYM,2023 REG,10,5,6,0,5,16,1,0,5,-5,0,0,0,0,0,0,0,0,0,0.48483656587239576,0.5151634341276042
91365,0.5833333333333333,0.45454545454545453,-140,120,0.5612373737373737,0.4387626262626263,away,MIA,over,7,0.5370370370370371,-116,0.5118817074154765,MIL,MIA,2023 REG,17,12,6,0,12,23,1,0,12,-12,0,0,0,0,0,0,0,0,0,0.5118817074154765,0.48811829258452355
91365,0.5833333333333333,0.45454545454545453,-140,120,0.5612373737373737,0.4387626262626263,home,MIL,under,7,0.5098039215686274,-104,0.48811829258452355,MIL,MIA,2023 REG,17,12,6,0,12,23,1,0,12,-12,0,0,0,0,0,0,0,0,0,0.5118817074154765,0.48811829258452355
91366,0.5098039215686274,0.5327102803738317,-104,-114,0.4881300146960012,0.5118699853039987,away,TOR,over,9.5,0.5,100,0.4772727272727273,CIN,TOR,2023 REG,7,3,12,10,13,19,0,1,-7,7,1,1,1,0,0,0,0,0,0,0.4772727272727273,0.5227272727272727
91366,0.5098039215686274,0.5327102803738317,-104,-114,0.4881300146960012,0.5118699853039987,home,CIN,under,9.5,0.5454545454545454,-120,0.5227272727272727,CIN,TOR,2023 REG,7,3,12,10,13,19,0,1,-7,7,1,1,1,0,0,0,0,0,0,0.4772727272727273,0.5227272727272727
91367,0.6794871794871794,0.36101083032490977,-212,177,0.6519693010251187,0.34803069897488126,away,KC,over,7.5,0.5348837209302326,-115,0.4975662520281233,DET,KC,2023 REG,8,8,4,0,8,12,1,0,8,-8,0,0,0,0,0,0,0,0,0,0.4975662520281233,0.5024337479718767
91367,0.6794871794871794,0.36101083032490977,-212,177,0.6519693010251187,0.34803069897488126,home,DET,under,7.5,0.5348837209302326,-115,0.5024337479718767,DET,KC,2023 REG,8,8,4,0,8,12,1,0,8,-8,0,0,0,0,0,0,0,0,0,0.4975662520281233,0.5024337479718767
91368,0.6226415094339623,0.41152263374485604,-165,143,0.6013694957565848,0.3986305042434152,away,ARI,over,8.5,0.5238095238095238,-110,0.4988662131519274,MIN,ARI,2023 REG,17,12,2,1,13,19,1,0,11,-11,1,0,0,0,0,0,0,0,0,0.4988662131519274,0.5011337868480725
91368,0.6226415094339623,0.41152263374485604,-165,143,0.6013694957565848,0.3986305042434152,home,MIN,under,8.5,0.5238095238095238,-110,0.5011337868480725,MIN,ARI,2023 REG,17,12,2,1,13,19,1,0,11,-11,1,0,0,0,0,0,0,0,0,0.4988662131519274,0.5011337868480725
91369,0.5726495726495727,0.47619047619047616,-134,110,0.5446813395531345,0.45531866044686553,away,PIT,over,9,0.49751243781094534,101,0.47511256217505476,CIN,PIT,2023 REG,9,3,6,1,4,15,1,0,2,-2,1,0,0,0,0,0,0,0,0,0.47511256217505476,0.5248874378249453
91369,0.5726495726495727,0.47619047619047616,-134,110,0.5446813395531345,0.45531866044686553,home,CIN,under,9,0.5475113122171946,-121,0.5248874378249453,CIN,PIT,2023 REG,9,3,6,1,4,15,1,0,2,-2,1,0,0,0,0,0,0,0,0,0.47511256217505476,0.5248874378249453
91370,0.5689655172413793,0.4694835680751174,-132,113,0.5470893135268209,0.4529106864731791,away,SF,over,8.5,0.5454545454545454,-120,0.5206611570247933,LAD,SF,2023 REG,10,5,8,7,12,18,0,1,-2,2,1,1,1,1,1,0,0,0,0,0.5206611570247933,0.4793388429752067
91370,0.5689655172413793,0.4694835680751174,-132,113,0.5470893135268209,0.4529106864731791,home,LAD,under,8.5,0.5,100,0.4793388429752067,LAD,SF,2023 REG,10,5,8,7,12,18,0,1,-2,2,1,1,1,1,1,0,0,0,0,0.5206611570247933,0.4793388429752067
91371,0.5901639344262295,0.4464285714285714,-144,124,0.5685683572004454,0.4314316427995546,away,NYY,over,8,0.5098039215686274,-104,0.4870219861770517,LAD,NYY,2023 REG,13,8,5,4,12,18,1,0,4,-4,1,1,1,1,0,0,0,0,0,0.4870219861770517,0.5129780138229483
91371,0.5901639344262295,0.4464285714285714,-144,124,0.5685683572004454,0.4314316427995546,home,LAD,under,8,0.5348837209302326,-115,0.5129780138229483,LAD,NYY,2023 REG,13,8,5,4,12,18,1,0,4,-4,1,1,1,1,0,0,0,0,0,0.4870219861770517,0.5129780138229483
91372,0.4444444444444444,0.5884773662551441,125,-143,0.4298125285779606,0.5701874714220394,away,ATL,over,8.5,0.5145631067961165,-106,0.49023796582517226,SD,ATL,2023 REG,6,0,7,2,2,13,0,1,-2,2,0,0,0,0,0,0,0,0,0,0.49023796582517226,0.5097620341748277
91372,0.4444444444444444,0.5884773662551441,125,-143,0.4298125285779606,0.5701874714220394,home,SD,under,8.5,0.5327102803738317,-114,0.5097620341748277,SD,ATL,2023 REG,6,0,7,2,2,13,0,1,-2,2,0,0,0,0,0,0,0,0,0,0.49023796582517226,0.5097620341748277
91373,0.5535714285714286,0.48780487804878053,-124,105,0.53066668740667,0.46933331259333,away,DET,over,11.5,0.5283018867924528,-112,0.5044173060022736,COL,DET,2023 REG,14,9,12,14,23,26,0,1,-5,5,1,1,1,1,1,1,1,1,1,0.5044173060022736,0.49558269399772636
91373,0.5535714285714286,0.48780487804878053,-124,105,0.53066668740667,0.46933331259333,home,COL,under,11.5,0.5169082125603864,-107,0.49558269399772636,COL,DET,2023 REG,14,9,12,14,23,26,0,1,-5,5,1,1,1,1,1,1,1,1,1,0.5044173060022736,0.49558269399772636
91374,0.7375328083989502,0.29850746268656714,-281,235,0.7109519260497891,0.2890480739502109,away,KC,over,8.5,0.5348837209302326,-115,0.5097020142727117,SD,KC,2023 REG,8,3,9,4,7,17,0,1,-1,1,1,1,1,0,0,0,0,0,0,0.5097020142727117,0.49029798572728833
91374,0.7375328083989502,0.29850746268656714,-281,235,0.7109519260497891,0.2890480739502109,home,SD,under,8.5,0.5121951219512195,-105,0.49029798572728833,SD,KC,2023 REG,8,3,9,4,7,17,0,1,-1,1,1,1,1,0,0,0,0,0,0,0.5097020142727117,0.49029798572728833
91375,0.5934959349593496,0.4444444444444444,-146,125,0.5709784740123824,0.42902152598761756,away,PHI,over,8.5,0.5073891625615764,-103,0.4837652908580103,NYM,PHI,2023 REG,6,2,2,0,2,8,1,0,2,-2,0,0,0,0,0,0,0,0,0,0.4837652908580103,0.5162347091419897
91375,0.5934959349593496,0.4444444444444444,-146,125,0.5709784740123824,0.42902152598761756,home,NYM,under,8.5,0.5391705069124424,-117,0.5162347091419897,NYM,PHI,2023 REG,6,2,2,0,2,8,1,0,2,-2,0,0,0,0,0,0,0,0,0,0.4837652908580103,0.5162347091419897
91376,0.6666666666666666,0.37037037037037035,-200,170,0.6419753086419753,0.3580246913580247,away,COL,over,9.5,0.5238095238095238,-110,0.4988662131519274,ARI,COL,2023 REG,11,7,13,5,12,24,1,0,2,-2,1,1,1,1,1,0,0,0,0,0.4988662131519274,0.5011337868480725
91376,0.6666666666666666,0.37037037037037035,-200,170,0.6419753086419753,0.3580246913580247,home,ARI,under,9.5,0.5238095238095238,-110,0.5011337868480725,ARI,COL,2023 REG,11,7,13,5,12,24,1,0,2,-2,1,1,1,1,1,0,0,0,0,0.4988662131519274,0.5011337868480725
91377,0.425531914893617,0.607843137254902,135,-155,0.4113297650431834,0.5886702349568166,away,ARI,over,9.5,0.5121951219512195,-105,0.48808156828023186,OAK,ARI,2023 REG,12,9,15,8,17,27,1,0,1,-1,1,1,1,1,1,1,1,1,0,0.48808156828023186,0.5119184317197681
91377,0.425531914893617,0.607843137254902,135,-155,0.4113297650431834,0.5886702349568166,home,OAK,under,9.5,0.5348837209302326,-115,0.5119184317197681,OAK,ARI,2023 REG,12,9,15,8,17,27,1,0,1,-1,1,1,1,1,1,1,1,1,0,0.48808156828023186,0.5119184317197681
91378,0.5555555555555556,0.47619047619047616,-125,110,0.5379188712522047,0.4620811287477953,away,HOU,over,8,0.5121951219512195,-105,0.48808156828023186,ATL,HOU,2023 REG,3,2,9,5,7,12,0,1,-3,3,1,1,0,0,0,0,0,0,0,0.48808156828023186,0.5119184317197681
91378,0.5555555555555556,0.47619047619047616,-125,110,0.5379188712522047,0.4620811287477953,home,ATL,under,8,0.5348837209302326,-115,0.5119184317197681,ATL,HOU,2023 REG,3,2,9,5,7,12,0,1,-3,3,1,1,0,0,0,0,0,0,0,0.48808156828023186,0.5119184317197681
91379,0.5901639344262295,0.4484304932735426,-144,123,0.5673868951280033,0.43261310487199667,away,LAA,over,9.5,0.5169082125603864,-107,0.49353874091423283,TEX,LAA,2023 REG,9,6,7,3,9,16,1,0,3,-3,1,1,1,0,0,0,0,0,0,0.49353874091423283,0.5064612590857671
91379,0.5901639344262295,0.4484304932735426,-144,123,0.5673868951280033,0.43261310487199667,home,TEX,under,9.5,0.5283018867924528,-112,0.5064612590857671,TEX,LAA,2023 REG,9,6,7,3,9,16,1,0,3,-3,1,1,1,0,0,0,0,0,0,0.49353874091423283,0.5064612590857671
91380,0.4608294930875576,0.5798319327731092,117,-138,0.4420915088199692,0.5579084911800307,away,NYM,over,9,0.5454545454545454,-120,0.5206611570247933,WSH,NYM,2023 REG,7,5,11,11,16,18,0,1,-6,6,1,1,1,1,1,0,0,0,0,0.5206611570247933,0.4793388429752067
91380,0.4608294930875576,0.5798319327731092,117,-138,0.4420915088199692,0.5579084911800307,home,WSH,under,9,0.5,100,0.4793388429752067,WSH,NYM,2023 REG,7,5,11,11,16,18,0,1,-6,6,1,1,1,1,1,0,0,0,0,0.5206611570247933,0.4793388429752067
91381,0.4347826086956522,0.6000000000000001,130,-150,0.4196597353497164,0.5803402646502835,away,CWS,over,9.5,0.5121951219512195,-105,0.48808156828023186,KC,CWS,2023 REG,14,9,6,1,10,20,1,0,8,-8,1,0,0,0,0,0,0,0,0,0.48808156828023186,0.5119184317197681
91381,0.4347826086956522,0.6000000000000001,130,-150,0.4196597353497164,0.5803402646502835,home,KC,under,9.5,0.5348837209302326,-115,0.5119184317197681,KC,CWS,2023 REG,14,9,6,1,10,20,1,0,8,-8,1,0,0,0,0,0,0,0,0,0.48808156828023186,0.5119184317197681
91382,0.37878787878787884,0.6632996632996633,164,-197,0.36284562799714315,0.6371543720028569,away,SEA,over,8.5,0.5073891625615764,-103,0.48484779035144243,CWS,SEA,2023 REG,8,2,15,14,16,23,0,1,-12,12,1,1,0,0,0,0,0,0,0,0.48484779035144243,0.5151522096485576
91382,0.37878787878787884,0.6632996632996633,164,-197,0.36284562799714315,0.6371543720028569,home,CWS,under,8.5,0.5370370370370371,-116,0.5151522096485576,CWS,SEA,2023 REG,8,2,15,14,16,23,0,1,-12,12,1,1,0,0,0,0,0,0,0,0.48484779035144243,0.5151522096485576
91383,0.5901639344262295,0.4504504504504505,-144,122,0.5661947892531068,0.43380521074689316,away,LAA,over,9,0.5121951219512195,-105,0.48808156828023186,HOU,LAA,2023 REG,5,1,6,2,3,11,0,1,-1,1,1,0,0,0,0,0,0,0,0,0.48808156828023186,0.5119184317197681
91383,0.5901639344262295,0.4504504504504505,-144,122,0.5661947892531068,0.43380521074689316,home,HOU,under,9,0.5348837209302326,-115,0.5119184317197681,HOU,LAA,2023 REG,5,1,6,2,3,11,0,1,-1,1,1,0,0,0,0,0,0,0,0,0.48808156828023186,0.5119184317197681
91384,0.5967741935483871,0.4444444444444444,-148,125,0.5721759741010521,0.42782402589894786,away,MIN,over,8.5,0.5305164319248826,-113,0.5053568787472517,BAL,MIN,2023 REG,3,0,7,1,1,10,0,1,-1,1,0,0,0,0,0,0,0,0,0,0.5053568787472517,0.49464312125274834
91384,0.5967741935483871,0.4444444444444444,-148,125,0.5721759741010521,0.42782402589894786,home,BAL,under,8.5,0.5169082125603864,-107,0.49464312125274834,BAL,MIN,2023 REG,3,0,7,1,1,10,0,1,-1,1,0,0,0,0,0,0,0,0,0,0.5053568787472517,0.49464312125274834
91385,0.5652173913043479,0.47619047619047616,-130,110,0.5418129444594474,0.4581870555405526,away,NYM,over,8,0.5098039215686274,-104,0.48592421718142587,SD,NYM,2023 REG,9,6,5,2,8,14,1,0,4,-4,1,1,0,0,0,0,0,0,0,0.48592421718142587,0.5140757828185741
91385,0.5652173913043479,0.47619047619047616,-130,110,0.5418129444594474,0.4581870555405526,home,SD,under,8,0.5370370370370371,-116,0.5140757828185741,SD,NYM,2023 REG,9,6,5,2,8,14,1,0,4,-4,1,1,0,0,0,0,0,0,0,0.48592421718142587,0.5140757828185741
91386,0.5495495495495495,0.49019607843137253,-122,104,0.5277073575960698,0.4722926424039302,away,MIA,over,7.5,0.5,100,0.4772727272727273,SF,MIA,2023 REG,5,4,6,3,7,11,1,0,1,-1,1,1,1,0,0,0,0,0,0,0.4772727272727273,0.5227272727272727
91386,0.5495495495495495,0.49019607843137253,-122,104,0.5277073575960698,0.4722926424039302,home,SF,under,7.5,0.5454545454545454,-120,0.5227272727272727,SF,MIA,2023 REG,5,4,6,3,7,11,1,0,1,-1,1,1,1,0,0,0,0,0,0,0.4772727272727273,0.5227272727272727
91387,0.5515695067264574,0.49019607843137253,-123,104,0.5285328835228112,0.47146711647718875,away,TEX,over,8.5,0.5495495495495495,-122,0.5236866555946829,MIN,TEX,2023 REG,12,12,8,2,14,20,1,0,10,-10,1,1,0,0,0,0,0,0,0,0.5236866555946829,0.47631334440531714
91387,0.5515695067264574,0.49019607843137253,-123,104,0.5285328835228112,0.47146711647718875,home,MIN,under,8.5,0.49751243781094534,101,0.47631334440531714,MIN,TEX,2023 REG,12,12,8,2,14,20,1,0,10,-10,1,1,0,0,0,0,0,0,0,0.5236866555946829,0.47631334440531714
91388,0.5967741935483871,0.4444444444444444,-148,125,0.5721759741010521,0.42782402589894786,away,WSH,over,8.5,0.5454545454545454,-120,0.5206611570247933,PIT,WSH,2023 REG,7,2,9,6,8,16,0,1,-4,4,1,1,0,0,0,0,0,0,0,0.5206611570247933,0.4793388429752067
91388,0.5967741935483871,0.4444444444444444,-148,125,0.5721759741010521,0.42782402589894786,home,PIT,under,8.5,0.5,100,0.4793388429752067,PIT,WSH,2023 REG,7,2,9,6,8,16,0,1,-4,4,1,1,0,0,0,0,0,0,0,0.5206611570247933,0.4793388429752067
91389,0.5652173913043479,0.47619047619047616,-130,110,0.5418129444594474,0.4581870555405526,away,MIA,over,9,0.5454545454545454,-120,0.5193043049216726,LAA,MIA,2023 REG,5,0,9,2,2,14,0,1,-2,2,0,0,0,0,0,0,0,0,0,0.5193043049216726,0.48069569507832743
91389,0.5652173913043479,0.47619047619047616,-130,110,0.5418129444594474,0.4581870555405526,home,LAA,under,9,0.5024875621890548,-101,0.48069569507832743,LAA,MIA,2023 REG,5,0,9,2,2,14,0,1,-2,2,0,0,0,0,0,0,0,0,0,0.5193043049216726,0.48069569507832743
91390,0.5348837209302326,0.5121951219512195,-115,-105,0.5097020142727117,0.49029798572728833,away,SEA,over,7.5,0.5454545454545454,-120,0.5140092723241282,SD,SEA,2023 REG,17,10,4,3,13,21,1,0,7,-7,1,1,1,0,0,0,0,0,0,0.5140092723241282,0.4859907276758718
91390,0.5348837209302326,0.5121951219512195,-115,-105,0.5097020142727117,0.49029798572728833,home,SD,under,7.5,0.5121951219512195,-105,0.4859907276758718,SD,SEA,2023 REG,17,10,4,3,13,21,1,0,7,-7,1,1,1,0,0,0,0,0,0,0.5140092723241282,0.4859907276758718
91391,0.5815899581589958,0.4587155963302753,-139,118,0.5581486524100054,0.44185134758999456,away,NYY,over,9,0.5121951219512195,-105,0.48808156828023186,LAA,NYY,2023 REG,9,4,8,3,7,17,1,0,1,-1,1,1,1,0,0,0,0,0,0,0.48808156828023186,0.5119184317197681
91391,0.5815899581589958,0.4587155963302753,-139,118,0.5581486524100054,0.44185134758999456,home,LAA,under,9,0.5348837209302326,-115,0.5119184317197681,LAA,NYY,2023 REG,9,4,8,3,7,17,1,0,1,-1,1,1,1,0,0,0,0,0,0,0.48808156828023186,0.5119184317197681
91392,0.574468085106383,0.4629629629629629,-135,116,0.5529651425984609,0.44703485740153914,away,MIL,over,8,0.5192307692307692,-108,0.49455035168025013,CLE,MIL,2023 REG,6,1,10,7,8,16,0,1,-6,6,1,0,0,0,0,0,0,0,0,0.49455035168025013,0.5054496483197499
91392,0.574468085106383,0.4629629629629629,-135,116,0.5529651425984609,0.44703485740153914,home,CLE,under,8,0.5283018867924528,-112,0.5054496483197499,CLE,MIL,2023 REG,6,1,10,7,8,16,0,1,-6,6,1,0,0,0,0,0,0,0,0,0.49455035168025013,0.5054496483197499
91393,0.6721311475409836,0.37037037037037035,-205,170,0.6435645535349916,0.35643544646500835,away,OAK,over,8.5,0.5121951219512195,-105,0.48808156828023186,BAL,OAK,2023 REG,12,12,12,8,20,24,1,0,4,-4,1,1,1,1,1,1,1,1,0,0.48808156828023186,0.5119184317197681
91393,0.6721311475409836,0.37037037037037035,-205,170,0.6435645535349916,0.35643544646500835,home,BAL,under,8.5,0.5348837209302326,-115,0.5119184317197681,BAL,OAK,2023 REG,12,12,12,8,20,24,1,0,4,-4,1,1,1,1,1,1,1,1,0,0.48808156828023186,0.5119184317197681
91394,0.6774193548387096,0.36363636363636365,-210,175,0.6496074165168858,0.3503925834831142,away,DET,over,7.5,0.5169082125603864,-107,0.49353874091423283,SEA,DET,2023 REG,3,0,9,6,6,12,0,1,-6,6,0,0,0,0,0,0,0,0,0,0.49353874091423283,0.5064612590857671
91394,0.6774193548387096,0.36363636363636365,-210,175,0.6496074165168858,0.3503925834831142,home,SEA,under,7.5,0.5283018867924528,-112,0.5064612590857671,SEA,DET,2023 REG,3,0,9,6,6,12,0,1,-6,6,0,0,0,0,0,0,0,0,0,0.49353874091423283,0.5064612590857671
91395,0.607843137254902,0.4347826086956522,-155,130,0.5819333701084867,0.41806662989151333,away,SF,over,19.5,0.5192307692307692,-108,0.49455035168025013,SD,SF,2023 REG,10,6,9,4,10,19,1,0,2,-2,1,1,1,1,0,0,0,0,0,0.49455035168025013,0.5054496483197499
91395,0.607843137254902,0.4347826086956522,-155,130,0.5819333701084867,0.41806662989151333,home,SD,under,19.5,0.5283018867924528,-112,0.5054496483197499,SD,SF,2023 REG,10,6,9,4,10,19,1,0,2,-2,1,1,1,1,0,0,0,0,0,0.49455035168025013,0.5054496483197499
91396,0.4807692307692307,0.5555555555555556,108,-125,0.4633053911900066,0.5366946088099934,away,CLE,over,9,0.5073891625615764,-103,0.4837652908580103,BOS,CLE,2023 REG,8,2,8,5,7,16,0,1,-3,3,1,1,0,0,0,0,0,0,0,0.4837652908580103,0.5162347091419897
91396,0.4807692307692307,0.5555555555555556,108,-125,0.4633053911900066,0.5366946088099934,home,BOS,under,9,0.5391705069124424,-117,0.5162347091419897,BOS,CLE,2023 REG,8,2,8,5,7,16,0,1,-3,3,1,1,0,0,0,0,0,0,0,0.4837652908580103,0.5162347091419897
91397,0.6721311475409836,0.36900369003690037,-205,171,0.6444831419558484,0.35551685804415156,away,BAL,over,8.5,0.5370370370370371,-116,0.5118817074154765,TOR,BAL,2023 REG,12,3,13,8,11,25,0,1,-5,5,1,1,1,0,0,0,0,0,0,0.5118817074154765,0.48811829258452355
91397,0.6721311475409836,0.36900369003690037,-205,171,0.6444831419558484,0.35551685804415156,home,TOR,under,8.5,0.5098039215686274,-104,0.48811829258452355,TOR,BAL,2023 REG,12,3,13,8,11,25,0,1,-5,5,1,1,1,0,0,0,0,0,0,0.5118817074154765,0.48811829258452355
91398,0.5495495495495495,0.4926108374384236,-122,103,0.5263803278714742,0.47361967212852585,away,SD,over,9,0.5348837209302326,-115,0.5097020142727117,HOU,SD,2023 REG,11,7,9,5,12,20,1,0,2,-2,1,1,1,1,1,0,0,0,0,0.5097020142727117,0.49029798572728833
91398,0.5495495495495495,0.4926108374384236,-122,103,0.5263803278714742,0.47361967212852585,home,HOU,under,9,0.5121951219512195,-105,0.49029798572728833,HOU,SD,2023 REG,11,7,9,5,12,20,1,0,2,-2,1,1,1,1,1,0,0,0,0,0.5097020142727117,0.49029798572728833
91399,0.5,0.5454545454545454,100,-120,0.4772727272727273,0.5227272727272727,away,MIN,over,9,0.5192307692307692,-108,0.49571111079951763,BAL,MIN,2023 REG,5,2,6,1,3,11,1,0,1,-1,1,0,0,0,0,0,0,0,0,0.49571111079951763,0.5042888892004824
91399,0.5,0.5454545454545454,100,-120,0.4772727272727273,0.5227272727272727,home,BAL,under,9,0.5260663507109005,-111,0.5042888892004824,BAL,MIN,2023 REG,5,2,6,1,3,11,1,0,1,-1,1,0,0,0,0,0,0,0,0,0.49571111079951763,0.5042888892004824
91400,0.6389891696750902,0.4,-177,150,0.614075512518083,0.385924487481917,away,SF,over,6.5,0.5412844036697247,-118,0.5149381613977361,NYY,SF,2023 REG,8,5,4,0,5,12,1,0,5,-5,0,0,0,0,0,0,0,0,0,0.5149381613977361,0.48506183860226393
91400,0.6389891696750902,0.4,-177,150,0.614075512518083,0.385924487481917,home,NYY,under,6.5,0.5073891625615764,-103,0.48506183860226393,NYY,SF,2023 REG,8,5,4,0,5,12,1,0,5,-5,0,0,0,0,0,0,0,0,0,0.5149381613977361,0.48506183860226393
91401,0.47619047619047616,0.5652173913043479,110,-130,0.4564724440500838,0.5435275559499162,away,MIL,over,9,0.5,100,0.4772727272727273,STL,MIL,2023 REG,8,3,9,7,10,17,0,1,-4,4,1,1,1,0,0,0,0,0,0,0.4772727272727273,0.5227272727272727
91401,0.47619047619047616,0.5652173913043479,110,-130,0.4564724440500838,0.5435275559499162,home,STL,under,9,0.5454545454545454,-120,0.5227272727272727,STL,MIL,2023 REG,8,3,9,7,10,17,0,1,-4,4,1,1,1,0,0,0,0,0,0,0.4772727272727273,0.5227272727272727
91402,0.647887323943662,0.38759689922480617,-184,158,0.6248975455528234,0.3751024544471766,away,DET,over,7,0.5535714285714286,-124,0.5293429871948779,TB,DET,2023 REG,13,12,6,2,14,19,1,0,10,-10,1,1,0,0,0,0,0,0,0,0.5293429871948779,0.47065701280512207
91402,0.647887323943662,0.38759689922480617,-184,158,0.6248975455528234,0.3751024544471766,home,TB,under,7,0.49019607843137253,104,0.47065701280512207,TB,DET,2023 REG,13,12,6,2,14,19,1,0,10,-10,1,1,0,0,0,0,0,0,0,0.5293429871948779,0.47065701280512207
91403,0.4504504504504505,0.5918367346938775,122,-145,0.43140216885390636,0.5685978311460936,away,PHI,over,9,0.5454545454545454,-120,0.5206611570247933,MIL,PHI,2023 REG,12,7,7,5,12,19,1,0,2,-2,1,1,1,1,1,0,0,0,0,0.5206611570247933,0.4793388429752067
91403,0.4504504504504505,0.5918367346938775,122,-145,0.43140216885390636,0.5685978311460936,home,MIL,under,9,0.5,100,0.4793388429752067,MIL,PHI,2023 REG,12,7,7,5,12,19,1,0,2,-2,1,1,1,1,1,0,0,0,0,0.5206611570247933,0.4793388429752067
91404,0.5238095238095238,0.5215311004784688,-110,-109,0.5000596729920038,0.4999403270079962,away,ATL,over,9.5,0.5348837209302326,-115,0.5097020142727117,TEX,ATL,2023 REG,10,7,8,4,11,18,1,0,3,-3,1,1,1,1,0,0,0,0,0,0.5097020142727117,0.49029798572728833
91404,0.5238095238095238,0.5215311004784688,-110,-109,0.5000596729920038,0.4999403270079962,home,TEX,under,9.5,0.5121951219512195,-105,0.49029798572728833,TEX,ATL,2023 REG,10,7,8,4,11,18,1,0,3,-3,1,1,1,1,0,0,0,0,0,0.5097020142727117,0.49029798572728833
91405,0.6254681647940076,0.41152263374485604,-167,143,0.6023315979176397,0.3976684020823603,away,WSH,over,9,0.5412844036697247,-118,0.5149381613977361,CHC,WSH,2023 REG,20,17,9,3,20,29,1,0,14,-14,1,1,1,0,0,0,0,0,0,0.5149381613977361,0.48506183860226393
91405,0.6254681647940076,0.41152263374485604,-167,143,0.6023315979176397,0.3976684020823603,home,CHC,under,9,0.5073891625615764,-103,0.48506183860226393,CHC,WSH,2023 REG,20,17,9,3,20,29,1,0,14,-14,1,1,1,0,0,0,0,0,0,0.5149381613977361,0.48506183860226393
91406,0.36363636363636365,0.6774193548387096,175,-210,0.3487070114636097,0.6512929885363903,away,TB,over,9.5,0.5348837209302326,-115,0.5097020142727117,KC,TB,2023 REG,7,2,11,4,6,18,0,1,-2,2,1,1,0,0,0,0,0,0,0,0.5097020142727117,0.49029798572728833
91406,0.36363636363636365,0.6774193548387096,175,-210,0.3487070114636097,0.6512929885363903,home,KC,under,9.5,0.5121951219512195,-105,0.49029798572728833,KC,TB,2023 REG,7,2,11,4,6,18,0,1,-2,2,1,1,0,0,0,0,0,0,0,0.5097020142727117,0.49029798572728833
91407,0.6825396825396826,0.35714285714285715,-215,180,0.6554547745023935,0.34454522549760647,away,SEA,over,9,0.5495495495495495,-122,0.5263803278714742,TOR,SEA,2023 REG,14,8,7,10,18,21,0,1,-2,2,1,1,1,1,1,1,1,1,0,0.5263803278714742,0.47361967212852585
91407,0.6825396825396826,0.35714285714285715,-215,180,0.6554547745023935,0.34454522549760647,home,TOR,under,9,0.4926108374384236,103,0.47361967212852585,TOR,SEA,2023 REG,14,8,7,10,18,21,0,1,-2,2,1,1,1,1,1,1,1,1,0,0.5263803278714742,0.47361967212852585
91408,0.6688741721854304,0.37037037037037035,-202,170,0.6426245112706233,0.35737548872937674,away,KC,over,8.5,0.504950495049505,-102,0.4826715732667395,SD,KC,2023 REG,8,4,8,5,9,16,0,1,-1,1,1,1,1,1,0,0,0,0,0,0.4826715732667395,0.5173284267332605
91408,0.6688741721854304,0.37037037037037035,-202,170,0.6426245112706233,0.35737548872937674,home,SD,under,8.5,0.5391705069124424,-117,0.5173284267332605,SD,KC,2023 REG,8,4,8,5,9,16,0,1,-1,1,1,1,1,1,0,0,0,0,0,0.4826715732667395,0.5173284267332605
91409,0.6336996336996338,0.40485829959514175,-173,147,0.6092654854945195,0.39073451450548047,away,CLE,over,9.5,0.5192307692307692,-108,0.49455035168025013,CIN,CLE,2023 REG,11,7,9,2,9,20,1,0,5,-5,1,1,0,0,0,0,0,0,0,0.49455035168025013,0.5054496483197499
91409,0.6336996336996338,0.40485829959514175,-173,147,0.6092654854945195,0.39073451450548047,home,CIN,under,9.5,0.5283018867924528,-112,0.5054496483197499,CIN,CLE,2023 REG,11,7,9,2,9,20,1,0,5,-5,1,1,0,0,0,0,0,0,0,0.49455035168025013,0.5054496483197499
91410,0.7572815533980582,0.2857142857142857,-312,250,0.7247215975654094,0.27527840243459056,away,COL,over,8.5,0.5348837209302326,-115,0.5109810284308424,BAL,COL,2023 REG,6,5,8,4,9,14,1,0,1,-1,1,1,1,1,0,0,0,0,0,0.5109810284308424,0.48901897156915763
91410,0.7572815533980582,0.2857142857142857,-312,250,0.7247215975654094,0.27527840243459056,home,BAL,under,8.5,0.5098039215686274,-104,0.48901897156915763,BAL,COL,2023 REG,6,5,8,4,9,14,1,0,1,-1,1,1,1,1,0,0,0,0,0,0.5109810284308424,0.48901897156915763
91411,0.4587155963302753,0.574468085106383,118,-135,0.4434937241116247,0.5565062758883753,away,LAA,over,8,0.5238095238095238,-110,0.5024811857109994,BOS,LAA,2023 REG,8,4,9,5,9,17,0,1,-1,1,1,1,1,1,0,0,0,0,0,0.5024811857109994,0.4975188142890006
91411,0.4587155963302753,0.574468085106383,118,-135,0.4434937241116247,0.5565062758883753,home,BOS,under,8,0.5169082125603864,-107,0.4975188142890006,BOS,LAA,2023 REG,8,4,9,5,9,17,0,1,-1,1,1,1,1,1,0,0,0,0,0,0.5024811857109994,0.4975188142890006
91412,0.5098039215686274,0.5327102803738317,-104,-114,0.4881300146960012,0.5118699853039987,away,PHI,over,7.5,0.5215311004784688,-109,0.4978845547971712,SF,PHI,2023 REG,10,4,10,3,7,20,1,0,1,-1,1,1,1,0,0,0,0,0,0,0.4978845547971712,0.5021154452028288
91412,0.5098039215686274,0.5327102803738317,-104,-114,0.4881300146960012,0.5118699853039987,home,SF,under,7.5,0.5238095238095238,-110,0.5021154452028288,SF,PHI,2023 REG,10,4,10,3,7,20,1,0,1,-1,1,1,1,0,0,0,0,0,0,0.4978845547971712,0.5021154452028288
91413,0.5,0.5454545454545454,100,-120,0.4772727272727273,0.5227272727272727,away,STL,over,9,0.5305164319248826,-113,0.5053568787472517,CHC,STL,2023 REG,7,7,9,2,9,16,1,0,5,-5,1,1,0,0,0,0,0,0,0,0.5053568787472517,0.49464312125274834
91413,0.5,0.5454545454545454,100,-120,0.4772727272727273,0.5227272727272727,home,CHC,under,9,0.5169082125603864,-107,0.49464312125274834,CHC,STL,2023 REG,7,7,9,2,9,16,1,0,5,-5,1,1,0,0,0,0,0,0,0,0.5053568787472517,0.49464312125274834
91414,0.6254681647940076,0.41152263374485604,-167,143,0.6023315979176397,0.3976684020823603,away,SEA,over,8.5,0.5098039215686274,-104,0.48483656587239576,LAA,SEA,2023 REG,6,3,8,5,8,14,0,1,-2,2,1,1,1,0,0,0,0,0,0,0.48483656587239576,0.5151634341276042
91414,0.6254681647940076,0.41152263374485604,-167,143,0.6023315979176397,0.3976684020823603,home,LAA,under,8.5,0.5391705069124424,-117,0.5151634341276042,LAA,SEA,2023 REG,6,3,8,5,8,14,0,1,-2,2,1,1,1,0,0,0,0,0,0,0.48483656587239576,0.5151634341276042
91415,0.4464285714285714,0.5901639344262295,124,-144,0.430092631314821,0.569907368685179,away,STL,over,8.5,0.5305164319248826,-113,0.5066009958897986,PIT,STL,2023 REG,10,2,5,1,3,15,1,0,1,-1,1,0,0,0,0,0,0,0,0,0.5066009958897986,0.49339900411020143
91415,0.4464285714285714,0.5901639344262295,124,-144,0.430092631314821,0.569907368685179,home,PIT,under,8.5,0.5145631067961165,-106,0.49339900411020143,PIT,STL,2023 REG,10,2,5,1,3,15,1,0,1,-1,1,0,0,0,0,0,0,0,0,0.5066009958897986,0.49339900411020143
91416,0.40322580645161293,0.6376811594202898,148,-176,0.38673106214842634,0.6132689378515737,away,HOU,over,9,0.5145631067961165,-106,0.49023796582517226,DET,HOU,2023 REG,5,4,1,1,5,6,1,0,3,-3,1,0,0,0,0,0,0,0,0,0.49023796582517226,0.5097620341748277
91416,0.40322580645161293,0.6376811594202898,148,-176,0.38673106214842634,0.6132689378515737,home,DET,under,9,0.5327102803738317,-114,0.5097620341748277,DET,HOU,2023 REG,5,4,1,1,5,6,1,0,3,-3,1,0,0,0,0,0,0,0,0,0.49023796582517226,0.5097620341748277
91417,0.6587030716723549,0.3861003861003861,-193,159,0.6291908964159078,0.37080910358409225,away,PIT,over,7.5,0.5348837209302326,-115,0.5097020142727117,CHC,PIT,2023 REG,12,7,15,13,20,27,0,1,-6,6,1,1,1,1,1,1,1,0,0,0.5097020142727117,0.49029798572728833
91417,0.6587030716723549,0.3861003861003861,-193,159,0.6291908964159078,0.37080910358409225,home,CHC,under,7.5,0.5121951219512195,-105,0.49029798572728833,CHC,PIT,2023 REG,12,7,15,13,20,27,0,1,-6,6,1,1,1,1,1,1,1,0,0,0.5097020142727117,0.49029798572728833
91418,0.5726495726495727,0.4672897196261683,-134,114,0.5497783539959433,0.4502216460040567,away,SEA,over,9,0.5305164319248826,-113,0.5066009958897986,TEX,SEA,2023 REG,8,9,13,8,17,21,1,0,1,-1,1,1,1,1,1,1,1,1,0,0.5066009958897986,0.49339900411020143
91418,0.5726495726495727,0.4672897196261683,-134,114,0.5497783539959433,0.4502216460040567,home,TEX,under,9,0.5145631067961165,-106,0.49339900411020143,TEX,SEA,2023 REG,8,9,13,8,17,21,1,0,1,-1,1,1,1,1,1,1,1,1,0,0.5066009958897986,0.49339900411020143
91419,0.5555555555555556,0.48309178743961345,-125,107,0.5340848094471283,0.46591519055287167,away,CIN,over,8.5,0.5145631067961165,-106,0.49023796582517226,CHC,CIN,2023 REG,8,5,8,6,11,16,0,1,-1,1,1,1,1,1,1,0,0,0,0,0.49023796582517226,0.5097620341748277
91419,0.5555555555555556,0.48309178743961345,-125,107,0.5340848094471283,0.46591519055287167,home,CHC,under,8.5,0.5327102803738317,-114,0.5097620341748277,CHC,CIN,2023 REG,8,5,8,6,11,16,0,1,-1,1,1,1,1,1,1,0,0,0,0,0.49023796582517226,0.5097620341748277
91420,0.5726495726495727,0.46511627906976744,-134,115,0.5510229738017454,0.44897702619825464,away,CHC,over,8.5,0.5454545454545454,-120,0.5206611570247933,PHI,CHC,2023 REG,3,1,13,10,11,16,0,1,-9,9,1,0,0,0,0,0,0,0,0,0.5206611570247933,0.4793388429752067
91420,0.5726495726495727,0.46511627906976744,-134,115,0.5510229738017454,0.44897702619825464,home,PHI,under,8.5,0.5,100,0.4793388429752067,PHI,CHC,2023 REG,3,1,13,10,11,16,0,1,-9,9,1,0,0,0,0,0,0,0,0,0.5206611570247933,0.4793388429752067
91421,0.6428571428571428,0.3921568627450981,-180,155,0.6203481392557023,0.3796518607442977,away,DET,over,8,0.5098039215686274,-104,0.48483656587239576,BAL,DET,2023 REG,6,5,2,1,6,8,1,0,4,-4,1,0,0,0,0,0,0,0,0,0.48483656587239576,0.5151634341276042
91421,0.6428571428571428,0.3921568627450981,-180,155,0.6203481392557023,0.3796518607442977,home,BAL,under,8,0.5391705069124424,-117,0.5151634341276042,BAL,DET,2023 REG,6,5,2,1,6,8,1,0,4,-4,1,0,0,0,0,0,0,0,0,0.48483656587239576,0.5151634341276042
91422,0.5,0.5454545454545454,100,-120,0.4772727272727273,0.5227272727272727,away,LAA,over,9.5,0.5348837209302326,-115,0.5097020142727117,BOS,LAA,2023 REG,11,9,9,7,16,20,1,0,2,-2,1,1,1,1,1,1,1,0,0,0.5097020142727117,0.49029798572728833
91422,0.5,0.5454545454545454,100,-120,0.4772727272727273,0.5227272727272727,home,BOS,under,9.5,0.5121951219512195,-105,0.49029798572728833,BOS,LAA,2023 REG,11,9,9,7,16,20,1,0,2,-2,1,1,1,1,1,1,1,0,0,0.5097020142727117,0.49029798572728833
91423,0.6666666666666666,0.37037037037037035,-200,170,0.6419753086419753,0.3580246913580247,away,MIN,over,7.5,0.5412844036697247,-118,0.5149381613977361,LAD,MIN,2023 REG,8,1,11,5,6,19,0,1,-4,4,1,0,0,0,0,0,0,0,0,0.5149381613977361,0.48506183860226393
91423,0.6666666666666666,0.37037037037037035,-200,170,0.6419753086419753,0.3580246913580247,home,LAD,under,7.5,0.5073891625615764,-103,0.48506183860226393,LAD,MIN,2023 REG,8,1,11,5,6,19,0,1,-4,4,1,0,0,0,0,0,0,0,0,0.5149381613977361,0.48506183860226393
91424,0.6539792387543253,0.3861003861003861,-189,159,0.6277679962022821,0.3722320037977179,away,DET,over,8,0.5121951219512195,-105,0.48919479393107135,LAD,DET,2023 REG,9,8,6,3,11,15,1,0,5,-5,1,1,1,0,0,0,0,0,0,0.48919479393107135,0.5108052060689287
91424,0.6539792387543253,0.3861003861003861,-189,159,0.6277679962022821,0.3722320037977179,home,LAD,under,8,0.5327102803738317,-114,0.5108052060689287,LAD,DET,2023 REG,9,8,6,3,11,15,1,0,5,-5,1,1,1,0,0,0,0,0,0,0.48919479393107135,0.5108052060689287
91425,0.38314176245210724,0.6563573883161512,161,-191,0.3680079882113952,0.6319920117886049,away,TOR,over,7.5,0.5283018867924528,-112,0.5044173060022736,OAK,TOR,2023 REG,7,1,10,7,8,17,0,1,-6,6,1,0,0,0,0,0,0,0,0,0.5044173060022736,0.49558269399772636
91425,0.38314176245210724,0.6563573883161512,161,-191,0.3680079882113952,0.6319920117886049,home,OAK,under,7.5,0.5169082125603864,-107,0.49558269399772636,OAK,TOR,2023 REG,7,1,10,7,8,17,0,1,-6,6,1,0,0,0,0,0,0,0,0,0.5044173060022736,0.49558269399772636
91426,0.43859649122807015,0.601593625498008,128,-151,0.42096924704996574,0.5790307529500343,away,CLE,over,9,0.5098039215686274,-104,0.48592421718142587,KC,CLE,2023 REG,6,4,13,3,7,19,1,0,1,-1,1,1,1,0,0,0,0,0,0,0.48592421718142587,0.5140757828185741
91426,0.43859649122807015,0.601593625498008,128,-151,0.42096924704996574,0.5790307529500343,home,KC,under,9,0.5370370370370371,-116,0.5140757828185741,KC,CLE,2023 REG,6,4,13,3,7,19,1,0,1,-1,1,1,1,0,0,0,0,0,0,0.48592421718142587,0.5140757828185741
91427,0.46511627906976744,0.574468085106383,115,-135,0.44670494689481377,0.5532950531051862,away,DET,over,9,0.5348837209302326,-115,0.5097020142727117,KC,DET,2023 REG,4,0,6,3,3,10,0,1,-3,3,0,0,0,0,0,0,0,0,0,0.5097020142727117,0.49029798572728833
91427,0.46511627906976744,0.574468085106383,115,-135,0.44670494689481377,0.5532950531051862,home,KC,under,9,0.5121951219512195,-105,0.49029798572728833,KC,DET,2023 REG,4,0,6,3,3,10,0,1,-3,3,0,0,0,0,0,0,0,0,0,0.5097020142727117,0.49029798572728833
91428,0.4,0.6428571428571428,150,-180,0.38285714285714295,0.617142857142857,away,TEX,over,10,0.5348837209302326,-115,0.5097020142727117,WSH,TEX,2023 REG,6,2,10,7,9,16,0,1,-5,5,1,1,0,0,0,0,0,0,0,0.5097020142727117,0.49029798572728833
91428,0.4,0.6428571428571428,150,-180,0.38285714285714295,0.617142857142857,home,WSH,under,10,0.5121951219512195,-105,0.49029798572728833,WSH,TEX,2023 REG,6,2,10,7,9,16,0,1,-5,5,1,1,0,0,0,0,0,0,0,0.5097020142727117,0.49029798572728833
91429,0.5867768595041323,0.45248868778280543,-142,121,0.563736744980392,0.43626325501960805,away,SEA,over,8.5,0.5098039215686274,-104,0.48592421718142587,HOU,SEA,2023 REG,4,0,9,2,2,13,0,1,-2,2,0,0,0,0,0,0,0,0,0,0.48592421718142587,0.5140757828185741
91429,0.5867768595041323,0.45248868778280543,-142,121,0.563736744980392,0.43626325501960805,home,HOU,under,8.5,0.5370370370370371,-116,0.5140757828185741,HOU,SEA,2023 REG,4,0,9,2,2,13,0,1,-2,2,0,0,0,0,0,0,0,0,0,0.48592421718142587,0.5140757828185741
91430,0.7354497354497355,0.29850746268656714,-278,235,0.7104759230637776,0.2895240769362224,away,WSH,over,8.5,0.5121951219512195,-105,0.48919479393107135,SD,WSH,2023 REG,15,13,10,3,16,25,1,0,10,-10,1,1,1,0,0,0,0,0,0,0.48919479393107135,0.5108052060689287
91430,0.7354497354497355,0.29850746268656714,-278,235,0.7104759230637776,0.2895240769362224,home,SD,under,8.5,0.5327102803738317,-114,0.5108052060689287,SD,WSH,2023 REG,15,13,10,3,16,25,1,0,10,-10,1,1,1,0,0,0,0,0,0,0.48919479393107135,0.5108052060689287
91431,0.4347826086956522,0.607843137254902,130,-155,0.41624967567367205,0.583750324326328,away,ATL,over,9.5,0.5192307692307692,-108,0.49455035168025013,CHC,ATL,2023 REG,10,8,10,6,14,20,1,0,2,-2,1,1,1,1,1,1,0,0,0,0.49455035168025013,0.5054496483197499
91431,0.4347826086956522,0.607843137254902,130,-155,0.41624967567367205,0.583750324326328,home,CHC,under,9.5,0.5283018867924528,-112,0.5054496483197499,CHC,ATL,2023 REG,10,8,10,6,14,20,1,0,2,-2,1,1,1,1,1,1,0,0,0,0.49455035168025013,0.5054496483197499
91432,0.5238095238095238,0.5215311004784688,-110,-109,0.5000596729920038,0.4999403270079962,away,ATL,over,8.5,0.5238095238095238,-110,0.4988662131519274,TB,ATL,2023 REG,6,1,2,2,3,8,0,1,-1,1,1,0,0,0,0,0,0,0,0,0.4988662131519274,0.5011337868480725
91432,0.5238095238095238,0.5215311004784688,-110,-109,0.5000596729920038,0.4999403270079962,home,TB,under,8.5,0.5238095238095238,-110,0.5011337868480725,TB,ATL,2023 REG,6,1,2,2,3,8,0,1,-1,1,1,0,0,0,0,0,0,0,0,0.4988662131519274,0.5011337868480725
91433,0.4807692307692307,0.5594713656387665,108,-127,0.46142279018846283,0.5385772098115371,away,TEX,over,9,0.5,100,0.4772727272727273,DET,TEX,2023 REG,8,6,13,10,16,21,0,1,-4,4,1,1,1,1,1,1,0,0,0,0.4772727272727273,0.5227272727272727
91433,0.4807692307692307,0.5594713656387665,108,-127,0.46142279018846283,0.5385772098115371,home,DET,under,9,0.5454545454545454,-120,0.5227272727272727,DET,TEX,2023 REG,8,6,13,10,16,21,0,1,-4,4,1,1,1,1,1,1,0,0,0,0.4772727272727273,0.5227272727272727
91434,0.6441281138790036,0.39370078740157477,-181,154,0.6197614550470296,0.3802385449529704,away,STL,over,9,0.5121951219512195,-105,0.48919479393107135,SD,STL,2023 REG,11,4,8,2,6,19,1,0,2,-2,1,1,0,0,0,0,0,0,0,0.48919479393107135,0.5108052060689287
91434,0.6441281138790036,0.39370078740157477,-181,154,0.6197614550470296,0.3802385449529704,home,SD,under,9,0.5327102803738317,-114,0.5108052060689287,SD,STL,2023 REG,11,4,8,2,6,19,1,0,2,-2,1,1,0,0,0,0,0,0,0,0.48919479393107135,0.5108052060689287
91435,0.5633187772925764,0.4739336492890995,-129,111,0.5423337858994053,0.4576662141005947,away,LAD,over,9.5,0.5098039215686274,-104,0.48483656587239576,TB,LAD,2023 REG,16,11,12,10,21,28,1,0,1,-1,1,1,1,1,1,1,1,1,1,0.48483656587239576,0.5151634341276042
91435,0.5633187772925764,0.4739336492890995,-129,111,0.5423337858994053,0.4576662141005947,home,TB,under,9.5,0.5391705069124424,-117,0.5151634341276042,TB,LAD,2023 REG,16,11,12,10,21,28,1,0,1,-1,1,1,1,1,1,1,1,1,1,0.48483656587239576,0.5151634341276042
91436,0.7032640949554896,0.3367003367003367,-237,197,0.6751585450966444,0.3248414549033556,away,COL,over,9,0.5098039215686274,-104,0.48375889301574193,BAL,COL,2023 REG,10,5,7,4,9,17,1,0,1,-1,1,1,1,1,0,0,0,0,0,0.48375889301574193,0.5162411069842581
91436,0.7032640949554896,0.3367003367003367,-237,197,0.6751585450966444,0.3248414549033556,home,BAL,under,9,0.5412844036697247,-118,0.5162411069842581,BAL,COL,2023 REG,10,5,7,4,9,17,1,0,1,-1,1,1,1,1,0,0,0,0,0,0.48375889301574193,0.5162411069842581
91437,0.5967741935483871,0.4424778761061947,-148,126,0.5733495713351688,0.42665042866483116,away,CIN,over,8,0.5121951219512195,-105,0.48808156828023186,PHI,CIN,2023 REG,6,3,8,2,5,14,1,0,1,-1,1,1,0,0,0,0,0,0,0,0.48808156828023186,0.5119184317197681
91437,0.5967741935483871,0.4424778761061947,-148,126,0.5733495713351688,0.42665042866483116,home,PHI,under,8,0.5348837209302326,-115,0.5119184317197681,PHI,CIN,2023 REG,6,3,8,2,5,14,1,0,1,-1,1,1,0,0,0,0,0,0,0,0.48808156828023186,0.5119184317197681
91438,0.6212121212121212,0.42016806722689076,-164,138,0.5955062465757653,0.40449375342423466,away,CLE,over,7,0.5145631067961165,-106,0.49023796582517226,NYY,CLE,2023 REG,9,4,6,2,6,15,1,0,2,-2,1,1,0,0,0,0,0,0,0,0.49023796582517226,0.5097620341748277
91438,0.6212121212121212,0.42016806722689076,-164,138,0.5955062465757653,0.40449375342423466,home,NYY,under,7,0.5327102803738317,-114,0.5097620341748277,NYY,CLE,2023 REG,9,4,6,2,6,15,1,0,2,-2,1,1,0,0,0,0,0,0,0,0.49023796582517226,0.5097620341748277
91439,0.5575221238938054,0.48309178743961345,-126,107,0.534878969787563,0.465121030212437,away,ATL,over,9.5,0.49504950495049505,102,0.47297076509898783,TOR,ATL,2023 REG,9,5,7,2,7,16,1,0,3,-3,1,1,0,0,0,0,0,0,0,0.47297076509898783,0.5270292349010122
91439,0.5575221238938054,0.48309178743961345,-126,107,0.534878969787563,0.465121030212437,home,TOR,under,9.5,0.5495495495495495,-122,0.5270292349010122,TOR,ATL,2023 REG,9,5,7,2,7,16,1,0,3,-3,1,1,0,0,0,0,0,0,0,0.47297076509898783,0.5270292349010122
91440,0.5238095238095238,0.5215311004784688,-110,-109,0.5000596729920038,0.4999403270079962,away,STL,over,8,0.5348837209302326,-115,0.5097020142727117,SF,STL,2023 REG,8,4,6,0,4,14,1,0,4,-4,0,0,0,0,0,0,0,0,0,0.5097020142727117,0.49029798572728833
91440,0.5238095238095238,0.5215311004784688,-110,-109,0.5000596729920038,0.4999403270079962,home,SF,under,8,0.5121951219512195,-105,0.49029798572728833,SF,STL,2023 REG,8,4,6,0,4,14,1,0,4,-4,0,0,0,0,0,0,0,0,0,0.5097020142727117,0.49029798572728833
91441,0.48780487804878053,0.5495495495495495,105,-122,0.4695832060495952,0.5304167939504048,away,CWS,over,8.5,0.5238095238095238,-110,0.5000596729920038,OAK,CWS,2023 REG,10,7,12,8,15,22,0,1,-1,1,1,1,1,1,1,1,1,0,0,0.5000596729920038,0.4999403270079962
91441,0.48780487804878053,0.5495495495495495,105,-122,0.4695832060495952,0.5304167939504048,home,OAK,under,8.5,0.5215311004784688,-109,0.4999403270079962,OAK,CWS,2023 REG,10,7,12,8,15,22,0,1,-1,1,1,1,1,1,1,1,1,0,0,0.5000596729920038,0.4999403270079962
91442,0.5238095238095238,0.5238095238095238,-110,-110,0.4988662131519274,0.5011337868480725,away,TEX,over,8.5,0.5073891625615764,-103,0.4826927225525911,CHC,TEX,2023 REG,7,2,10,8,10,17,0,1,-6,6,1,1,0,0,0,0,0,0,0,0.4826927225525911,0.5173072774474089
91442,0.5238095238095238,0.5238095238095238,-110,-110,0.4988662131519274,0.5011337868480725,home,CHC,under,8.5,0.5412844036697247,-118,0.5173072774474089,CHC,TEX,2023 REG,7,2,10,8,10,17,0,1,-6,6,1,1,0,0,0,0,0,0,0,0.4826927225525911,0.5173072774474089
91443,0.6875,0.35211267605633806,-220,184,0.6602662852112676,0.3397337147887324,away,COL,over,8.5,0.5433789954337899,-119,0.5171177654451503,NYM,COL,2023 REG,7,2,9,5,7,16,0,1,-3,3,1,1,0,0,0,0,0,0,0,0.5171177654451503,0.4828822345548497
91443,0.6875,0.35211267605633806,-220,184,0.6602662852112676,0.3397337147887324,home,NYM,under,8.5,0.504950495049505,-102,0.4828822345548497,NYM,COL,2023 REG,7,2,9,5,7,16,0,1,-3,3,1,1,0,0,0,0,0,0,0,0.5171177654451503,0.4828822345548497
91444,0.5918367346938775,0.4464285714285714,-145,124,0.5691899208663057,0.4308100791336943,away,HOU,over,9.5,0.5073891625615764,-103,0.4826927225525911,TEX,HOU,2023 REG,7,3,10,5,8,17,0,1,-2,2,1,1,1,0,0,0,0,0,0,0.4826927225525911,0.5173072774474089
91444,0.5918367346938775,0.4464285714285714,-145,124,0.5691899208663057,0.4308100791336943,home,TEX,under,9.5,0.5412844036697247,-118,0.5173072774474089,TEX,HOU,2023 REG,7,3,10,5,8,17,0,1,-2,2,1,1,1,0,0,0,0,0,0,0.4826927225525911,0.5173072774474089
91445,0.6923076923076923,0.3448275862068966,-225,190,0.6665986533360538,0.33340134666394616,away,MIL,over,8,0.5121951219512195,-105,0.48808156828023186,TB,MIL,2023 REG,5,1,8,0,1,13,1,0,1,-1,0,0,0,0,0,0,0,0,0,0.48808156828023186,0.5119184317197681
91445,0.6923076923076923,0.3448275862068966,-225,190,0.6665986533360538,0.33340134666394616,home,TB,under,8,0.5348837209302326,-115,0.5119184317197681,TB,MIL,2023 REG,5,1,8,0,1,13,1,0,1,-1,0,0,0,0,0,0,0,0,0,0.48808156828023186,0.5119184317197681
91446,0.4629629629629629,0.576271186440678,116,-136,0.4447990049057217,0.5552009950942782,away,SF,over,9,0.5073891625615764,-103,0.4837652908580103,NYM,SF,2023 REG,9,4,8,5,9,17,0,1,-1,1,1,1,1,1,0,0,0,0,0,0.4837652908580103,0.5162347091419897
91446,0.4629629629629629,0.576271186440678,116,-136,0.4447990049057217,0.5552009950942782,home,NYM,under,9,0.5391705069124424,-117,0.5162347091419897,NYM,SF,2023 REG,9,4,8,5,9,17,0,1,-1,1,1,1,1,1,0,0,0,0,0,0.4837652908580103,0.5162347091419897
91447,0.48780487804878053,0.5555555555555556,105,-125,0.4666534470222751,0.5333465529777248,away,CHC,over,9,0.5,100,0.4772727272727273,DET,CHC,2023 REG,9,8,8,6,14,17,1,0,2,-2,1,1,1,1,1,1,0,0,0,0.4772727272727273,0.5227272727272727
91447,0.48780487804878053,0.5555555555555556,105,-125,0.4666534470222751,0.5333465529777248,home,DET,under,9,0.5454545454545454,-120,0.5227272727272727,DET,CHC,2023 REG,9,8,8,6,14,17,1,0,2,-2,1,1,1,1,1,1,0,0,0,0.4772727272727273,0.5227272727272727
91448,0.6062992125984252,0.4347826086956522,-154,130,0.581391336695717,0.41860866330428304,away,MIN,over,7.5,0.5098039215686274,-104,0.4870219861770517,SEA,MIN,2023 REG,5,3,9,6,9,14,0,1,-3,3,1,1,1,0,0,0,0,0,0,0.4870219861770517,0.5129780138229483
91448,0.6062992125984252,0.4347826086956522,-154,130,0.581391336695717,0.41860866330428304,home,SEA,under,7.5,0.5348837209302326,-115,0.5129780138229483,SEA,MIN,2023 REG,5,3,9,6,9,14,0,1,-3,3,1,1,1,0,0,0,0,0,0,0.4870219861770517,0.5129780138229483
91449,0.6240601503759399,0.41493775933609955,-166,141,0.5997231089766972,0.40027689102330277,away,CHC,over,8,0.5433789954337899,-119,0.5171177654451503,NYY,CHC,2023 REG,2,0,7,3,3,9,0,1,-3,3,0,0,0,0,0,0,0,0,0,0.5171177654451503,0.4828822345548497
91449,0.6240601503759399,0.41493775933609955,-166,141,0.5997231089766972,0.40027689102330277,home,NYY,under,8,0.504950495049505,-102,0.4828822345548497,NYY,CHC,2023 REG,2,0,7,3,3,9,0,1,-3,3,0,0,0,0,0,0,0,0,0,0.5171177654451503,0.4828822345548497
91450,0.5633187772925764,0.47619047619047616,-129,110,0.5410624729287608,0.45893752707123925,away,ATL,over,9,0.5348837209302326,-115,0.5097020142727117,STL,ATL,2023 REG,6,2,10,5,7,16,0,1,-3,3,1,1,0,0,0,0,0,0,0,0.5097020142727117,0.49029798572728833
91450,0.5633187772925764,0.47619047619047616,-129,110,0.5410624729287608,0.45893752707123925,home,STL,under,9,0.5121951219512195,-105,0.49029798572728833,STL,ATL,2023 REG,6,2,10,5,7,16,0,1,-3,3,1,1,0,0,0,0,0,0,0,0.5097020142727117,0.49029798572728833
91451,0.5555555555555556,0.48780487804878053,-125,105,0.5314664257753688,0.46853357422463116,away,CWS,over,8.5,0.5412844036697247,-118,0.5149381613977361,CLE,CWS,2023 REG,4,3,3,0,3,7,1,0,3,-3,0,0,0,0,0,0,0,0,0,0.5149381613977361,0.48506183860226393
91451,0.5555555555555556,0.48780487804878053,-125,105,0.5314664257753688,0.46853357422463116,home,CLE,under,8.5,0.5073891625615764,-103,0.48506183860226393,CLE,CWS,2023 REG,4,3,3,0,3,7,1,0,3,-3,0,0,0,0,0,0,0,0,0,0.5149381613977361,0.48506183860226393
91452,0.37453183520599254,0.6666666666666666,167,-200,0.359101684691888,0.640898315308112,away,NYM,over,9,0.5238095238095238,-110,0.4988662131519274,WSH,NYM,2023 REG,7,2,10,8,10,17,0,1,-6,6,1,1,0,0,0,0,0,0,0,0.4988662131519274,0.5011337868480725
91452,0.37453183520599254,0.6666666666666666,167,-200,0.359101684691888,0.640898315308112,home,WSH,under,9,0.5238095238095238,-110,0.5011337868480725,WSH,NYM,2023 REG,7,2,10,8,10,17,0,1,-6,6,1,1,0,0,0,0,0,0,0,0.4988662131519274,0.5011337868480725
91453,0.6197718631178707,0.4184100418410042,-163,139,0.5961077927441193,0.4038922072558807,away,BOS,over,8,0.5412844036697247,-118,0.5149381613977361,TB,BOS,2023 REG,6,8,11,6,14,17,1,0,2,-2,1,1,1,1,1,1,0,0,0,0.5149381613977361,0.48506183860226393
91453,0.6197718631178707,0.4184100418410042,-163,139,0.5961077927441193,0.4038922072558807,home,TB,under,8,0.5073891625615764,-103,0.48506183860226393,TB,BOS,2023 REG,6,8,11,6,14,17,1,0,2,-2,1,1,1,1,1,1,0,0,0,0.5149381613977361,0.48506183860226393
91454,0.5305164319248826,0.5121951219512195,-113,-105,0.5078572507605655,0.49214274923943446,away,TOR,over,8,0.5283018867924528,-112,0.5031902949311281,TB,TOR,2023 REG,13,5,11,9,14,24,0,1,-4,4,1,1,1,1,1,0,0,0,0,0.5031902949311281,0.4968097050688719
91454,0.5305164319248826,0.5121951219512195,-113,-105,0.5078572507605655,0.49214274923943446,home,TB,under,8,0.5192307692307692,-108,0.4968097050688719,TB,TOR,2023 REG,13,5,11,9,14,24,0,1,-4,4,1,1,1,1,1,0,0,0,0,0.5031902949311281,0.4968097050688719
91455,0.6047430830039526,0.4347826086956522,-153,130,0.5808401943476698,0.41915980565233024,away,SF,over,7.5,0.5073891625615764,-103,0.4837652908580103,MIN,SF,2023 REG,7,7,10,1,8,17,1,0,6,-6,1,0,0,0,0,0,0,0,0,0.4837652908580103,0.5162347091419897
91455,0.6047430830039526,0.4347826086956522,-153,130,0.5808401943476698,0.41915980565233024,home,MIN,under,7.5,0.5391705069124424,-117,0.5162347091419897,MIN,SF,2023 REG,7,7,10,1,8,17,1,0,6,-6,1,0,0,0,0,0,0,0,0,0.4837652908580103,0.5162347091419897
91456,0.7802197802197802,0.2617801047120419,-355,282,0.7474506392290179,0.2525493607709821,away,WSH,over,9,0.5121951219512195,-105,0.48808156828023186,ATL,WSH,2023 REG,11,5,10,3,8,21,1,0,2,-2,1,1,1,0,0,0,0,0,0,0.48808156828023186,0.5119184317197681
91456,0.7802197802197802,0.2617801047120419,-355,282,0.7474506392290179,0.2525493607709821,home,ATL,under,9,0.5348837209302326,-115,0.5119184317197681,ATL,WSH,2023 REG,11,5,10,3,8,21,1,0,2,-2,1,1,1,0,0,0,0,0,0,0.48808156828023186,0.5119184317197681
91457,0.5555555555555556,0.4807692307692307,-125,108,0.5353751187084521,0.4646248812915479,away,PIT,over,8.5,0.5412844036697247,-118,0.5149381613977361,DET,PIT,2023 REG,10,4,5,0,4,15,1,0,4,-4,0,0,0,0,0,0,0,0,0,0.5149381613977361,0.48506183860226393
91457,0.5555555555555556,0.4807692307692307,-125,108,0.5353751187084521,0.4646248812915479,home,DET,under,8.5,0.5073891625615764,-103,0.48506183860226393,DET,PIT,2023 REG,10,4,5,0,4,15,1,0,4,-4,0,0,0,0,0,0,0,0,0,0.5149381613977361,0.48506183860226393
91458,0.4444444444444444,0.5918367346938775,125,-145,0.42831947593852354,0.5716805240614764,away,LAD,over,8.5,0.5454545454545454,-120,0.5206611570247933,PIT,LAD,2023 REG,12,8,4,1,9,16,1,0,7,-7,1,0,0,0,0,0,0,0,0,0.5206611570247933,0.4793388429752067
91458,0.4444444444444444,0.5918367346938775,125,-145,0.42831947593852354,0.5716805240614764,home,PIT,under,8.5,0.5,100,0.4793388429752067,PIT,LAD,2023 REG,12,8,4,1,9,16,1,0,7,-7,1,0,0,0,0,0,0,0,0,0.5206611570247933,0.4793388429752067
91459,0.45454545454545453,0.5867768595041323,120,-142,0.43576258452291505,0.564237415477085,away,SF,over,10,0.5238095238095238,-110,0.4988662131519274,PIT,SF,2023 REG,8,4,9,8,12,17,0,1,-4,4,1,1,1,1,0,0,0,0,0,0.4988662131519274,0.5011337868480725
91459,0.45454545454545453,0.5867768595041323,120,-142,0.43576258452291505,0.564237415477085,home,PIT,under,10,0.5238095238095238,-110,0.5011337868480725,PIT,SF,2023 REG,8,4,9,8,12,17,0,1,-4,4,1,1,1,1,0,0,0,0,0,0.4988662131519274,0.5011337868480725
91460,0.41493775933609955,0.6226415094339623,141,-165,0.39934470175516107,0.600655298244839,away,CWS,over,9,0.49751243781094534,101,0.4740985137509976,OAK,CWS,2023 REG,10,7,10,4,11,20,1,0,3,-3,1,1,1,1,0,0,0,0,0,0.4740985137509976,0.5259014862490023
91460,0.41493775933609955,0.6226415094339623,141,-165,0.39934470175516107,0.600655298244839,home,OAK,under,9,0.5495495495495495,-122,0.5259014862490023,OAK,CWS,2023 REG,10,7,10,4,11,20,1,0,3,-3,1,1,1,1,0,0,0,0,0,0.4740985137509976,0.5259014862490023
91461,0.37878787878787884,0.6621621621621622,164,-196,0.36327649964013603,0.6367235003598639,away,CLE,over,6.5,0.5454545454545454,-120,0.5206611570247933,OAK,CLE,2023 REG,6,4,8,3,7,14,1,0,1,-1,1,1,1,0,0,0,0,0,0,0.5206611570247933,0.4793388429752067
91461,0.37878787878787884,0.6621621621621622,164,-196,0.36327649964013603,0.6367235003598639,home,OAK,under,6.5,0.5,100,0.4793388429752067,OAK,CLE,2023 REG,6,4,8,3,7,14,1,0,1,-1,1,1,1,0,0,0,0,0,0,0.5206611570247933,0.4793388429752067
91463,0.6226415094339623,0.41152263374485604,-165,143,0.6013694957565848,0.3986305042434152,away,TEX,over,8.5,0.5412844036697247,-118,0.5189377998484975,HOU,TEX,2023 REG,6,2,11,6,8,17,0,1,-4,4,1,1,0,0,0,0,0,0,0,0.5189377998484975,0.4810622001515025
91463,0.6226415094339623,0.41152263374485604,-165,143,0.6013694957565848,0.3986305042434152,home,HOU,under,8.5,0.5,100,0.4810622001515025,HOU,TEX,2023 REG,6,2,11,6,8,17,0,1,-4,4,1,1,0,0,0,0,0,0,0,0.5189377998484975,0.4810622001515025
91464,0.48780487804878053,0.5475113122171946,105,-121,0.470577468162939,0.529422531837061,away,TEX,over,9,0.5215311004784688,-109,0.4978845547971712,KC,TEX,2023 REG,8,2,12,12,14,20,0,1,-10,10,1,1,0,0,0,0,0,0,0,0.4978845547971712,0.5021154452028288
91464,0.48780487804878053,0.5475113122171946,105,-121,0.470577468162939,0.529422531837061,home,KC,under,9,0.5238095238095238,-110,0.5021154452028288,KC,TEX,2023 REG,8,2,12,12,14,20,0,1,-10,10,1,1,0,0,0,0,0,0,0,0.4978845547971712,0.5021154452028288
91465,0.5238095238095238,0.5169082125603864,-110,-107,0.5024811857109994,0.4975188142890006,away,MIN,over,7,0.5495495495495495,-122,0.5263803278714742,CLE,MIN,2023 REG,5,4,8,3,7,13,1,0,1,-1,1,1,1,0,0,0,0,0,0,0.5263803278714742,0.47361967212852585
91465,0.5238095238095238,0.5169082125603864,-110,-107,0.5024811857109994,0.4975188142890006,home,CLE,under,7,0.4926108374384236,103,0.47361967212852585,CLE,MIN,2023 REG,5,4,8,3,7,13,1,0,1,-1,1,1,1,0,0,0,0,0,0,0.5263803278714742,0.47361967212852585
91466,0.5169082125603864,0.5192307692307692,-107,-108,0.4982276760789678,0.5017723239210322,away,TOR,over,9,0.5121951219512195,-105,0.48808156828023186,HOU,TOR,2023 REG,8,8,4,1,9,12,1,0,7,-7,1,0,0,0,0,0,0,0,0,0.48808156828023186,0.5119184317197681
91466,0.5169082125603864,0.5192307692307692,-107,-108,0.4982276760789678,0.5017723239210322,home,HOU,under,9,0.5348837209302326,-115,0.5119184317197681,HOU,TOR,2023 REG,8,8,4,1,9,12,1,0,7,-7,1,0,0,0,0,0,0,0,0,0.48808156828023186,0.5119184317197681
91467,0.3846153846153846,0.6503496503496503,160,-186,0.3711672942442173,0.6288327057557828,away,LAD,over,10.5,0.5238095238095238,-110,0.4988662131519274,CIN,LAD,2023 REG,14,9,8,8,17,22,1,0,1,-1,1,1,1,1,1,1,1,1,0,0.4988662131519274,0.5011337868480725
91467,0.3846153846153846,0.6503496503496503,160,-186,0.3711672942442173,0.6288327057557828,home,CIN,under,10.5,0.5238095238095238,-110,0.5011337868480725,CIN,LAD,2023 REG,14,9,8,8,17,22,1,0,1,-1,1,1,1,1,1,1,1,1,0,0.4988662131519274,0.5011337868480725
91468,0.5098039215686274,0.5327102803738317,-104,-114,0.4881300146960012,0.5118699853039987,away,CWS,over,8,0.5238095238095238,-110,0.4988662131519274,DET,CWS,2023 REG,6,6,8,5,11,14,1,0,1,-1,1,1,1,1,1,0,0,0,0,0.4988662131519274,0.5011337868480725
91468,0.5098039215686274,0.5327102803738317,-104,-114,0.4881300146960012,0.5118699853039987,home,DET,under,8,0.5238095238095238,-110,0.5011337868480725,DET,CWS,2023 REG,6,6,8,5,11,14,1,0,1,-1,1,1,1,1,1,0,0,0,0,0.4988662131519274,0.5011337868480725
91469,0.4444444444444444,0.5884773662551441,125,-143,0.4298125285779606,0.5701874714220394,away,STL,over,9,0.5391705069124424,-117,0.5140669063204599,PIT,STL,2023 REG,8,4,6,3,7,14,1,0,1,-1,1,1,1,0,0,0,0,0,0,0.5140669063204599,0.4859330936795401
91469,0.4444444444444444,0.5884773662551441,125,-143,0.4298125285779606,0.5701874714220394,home,PIT,under,9,0.5073891625615764,-103,0.4859330936795401,PIT,STL,2023 REG,8,4,6,3,7,14,1,0,1,-1,1,1,1,0,0,0,0,0,0,0.5140669063204599,0.4859330936795401
91470,0.6363636363636364,0.4081632653061224,-175,145,0.6080283353010626,0.3919716646989374,away,BOS,over,8,0.504950495049505,-102,0.4826715732667395,MIL,BOS,2023 REG,6,5,13,12,17,19,0,1,-7,7,1,1,1,1,1,0,0,0,0,0.4826715732667395,0.5173284267332605
91470,0.6363636363636364,0.4081632653061224,-175,145,0.6080283353010626,0.3919716646989374,home,MIL,under,8,0.5391705069124424,-117,0.5173284267332605,MIL,BOS,2023 REG,6,5,13,12,17,19,0,1,-7,7,1,1,1,1,1,0,0,0,0,0.4826715732667395,0.5173284267332605
91471,0.5192307692307692,0.5192307692307692,-108,-108,0.4992603550295858,0.5007396449704142,away,ATL,over,9,0.5,100,0.4772727272727273,NYM,ATL,2023 REG,9,5,6,3,8,15,1,0,2,-2,1,1,1,0,0,0,0,0,0,0.4772727272727273,0.5227272727272727
91471,0.5192307692307692,0.5192307692307692,-108,-108,0.4992603550295858,0.5007396449704142,home,NYM,under,9,0.5454545454545454,-120,0.5227272727272727,NYM,ATL,2023 REG,9,5,6,3,8,15,1,0,2,-2,1,1,1,0,0,0,0,0,0,0.4772727272727273,0.5227272727272727
91472,0.6226415094339623,0.4166666666666667,-165,140,0.5981666073335706,0.40183339266642937,away,PHI,over,6.5,0.5238095238095238,-110,0.4988662131519274,NYY,PHI,2023 REG,9,4,5,2,6,14,1,0,2,-2,1,1,0,0,0,0,0,0,0,0.4988662131519274,0.5011337868480725
91472,0.6226415094339623,0.4166666666666667,-165,140,0.5981666073335706,0.40183339266642937,home,NYY,under,6.5,0.5238095238095238,-110,0.5011337868480725,NYY,PHI,2023 REG,9,4,5,2,6,14,1,0,2,-2,1,1,0,0,0,0,0,0,0,0.4988662131519274,0.5011337868480725
91473,0.7142857142857143,0.3278688524590164,-250,205,0.6841753094680495,0.3158246905319505,away,WSH,over,9,0.5024875621890548,-101,0.47839724939301687,LAD,WSH,2023 REG,6,6,6,1,7,12,1,0,5,-5,1,0,0,0,0,0,0,0,0,0.47839724939301687,0.5216027506069831
91473,0.7142857142857143,0.3278688524590164,-250,205,0.6841753094680495,0.3158246905319505,home,LAD,under,9,0.5454545454545454,-120,0.5216027506069831,LAD,WSH,2023 REG,6,6,6,1,7,12,1,0,5,-5,1,0,0,0,0,0,0,0,0,0.47839724939301687,0.5216027506069831
91474,0.75,0.2857142857142857,-300,250,0.7232142857142858,0.2767857142857142,away,COL,over,10,0.5145631067961165,-106,0.49023796582517226,ATL,COL,2023 REG,13,10,6,2,12,19,1,0,8,-8,1,1,0,0,0,0,0,0,0,0.49023796582517226,0.5097620341748277
91474,0.75,0.2857142857142857,-300,250,0.7232142857142858,0.2767857142857142,home,ATL,under,10,0.5327102803738317,-114,0.5097620341748277,ATL,COL,2023 REG,13,10,6,2,12,19,1,0,8,-8,1,1,0,0,0,0,0,0,0,0.49023796582517226,0.5097620341748277
91475,0.49751243781094534,0.5454545454545454,101,-120,0.476135829221149,0.523864170778851,away,PHI,over,9.5,0.5348837209302326,-115,0.5097020142727117,CHC,PHI,2023 REG,7,1,7,3,4,14,0,1,-2,2,1,0,0,0,0,0,0,0,0,0.5097020142727117,0.49029798572728833
91475,0.49751243781094534,0.5454545454545454,101,-120,0.476135829221149,0.523864170778851,home,CHC,under,9.5,0.5121951219512195,-105,0.49029798572728833,CHC,PHI,2023 REG,7,1,7,3,4,14,0,1,-2,2,1,0,0,0,0,0,0,0,0,0.5097020142727117,0.49029798572728833
91476,0.49751243781094534,0.5454545454545454,101,-120,0.476135829221149,0.523864170778851,away,TOR,over,7.5,0.5,100,0.4762443438914027,NYY,TOR,2023 REG,5,1,9,6,7,14,0,1,-5,5,1,0,0,0,0,0,0,0,0,0.4762443438914027,0.5237556561085973
91476,0.49751243781094534,0.5454545454545454,101,-120,0.476135829221149,0.523864170778851,home,NYY,under,7.5,0.5475113122171946,-121,0.5237556561085973,NYY,TOR,2023 REG,5,1,9,6,7,14,0,1,-5,5,1,0,0,0,0,0,0,0,0,0.4762443438914027,0.5237556561085973
91477,0.5348837209302326,0.5121951219512195,-115,-105,0.5097020142727117,0.49029798572728833,away,BAL,over,8,0.5348837209302326,-115,0.5097020142727117,SEA,BAL,2023 REG,6,3,9,5,8,15,0,1,-2,2,1,1,1,0,0,0,0,0,0,0.5097020142727117,0.49029798572728833
91477,0.5348837209302326,0.5121951219512195,-115,-105,0.5097020142727117,0.49029798572728833,home,SEA,under,8,0.5121951219512195,-105,0.49029798572728833,SEA,BAL,2023 REG,6,3,9,5,8,15,0,1,-2,2,1,1,1,0,0,0,0,0,0,0.5097020142727117,0.49029798572728833
91478,0.5652173913043479,0.47619047619047616,-130,110,0.5418129444594474,0.4581870555405526,away,NYY,over,6.5,0.5475113122171946,-121,0.5242087833606768,MIN,NYY,2023 REG,8,6,8,2,8,16,1,0,4,-4,1,1,0,0,0,0,0,0,0,0.5242087833606768,0.4757912166393232
91478,0.5652173913043479,0.47619047619047616,-130,110,0.5418129444594474,0.4581870555405526,home,MIN,under,6.5,0.49504950495049505,102,0.4757912166393232,MIN,NYY,2023 REG,8,6,8,2,8,16,1,0,4,-4,1,1,0,0,0,0,0,0,0,0.5242087833606768,0.4757912166393232
91479,0.6551724137931035,0.3846153846153846,-190,160,0.6291045458703008,0.37089545412969915,away,DET,over,9,0.5,100,0.4772727272727273,BAL,DET,2023 REG,7,2,5,1,3,12,1,0,1,-1,1,0,0,0,0,0,0,0,0,0.4772727272727273,0.5227272727272727
91479,0.6551724137931035,0.3846153846153846,-190,160,0.6291045458703008,0.37089545412969915,home,BAL,under,9,0.5454545454545454,-120,0.5227272727272727,BAL,DET,2023 REG,7,2,5,1,3,12,1,0,1,-1,1,0,0,0,0,0,0,0,0,0.4772727272727273,0.5227272727272727
91480,0.29411764705882354,0.7481108312342569,240,-297,0.2816975063843881,0.7183024936156119,away,ATL,over,9.5,0.49504950495049505,102,0.47297076509898783,WSH,ATL,2023 REG,12,5,10,8,13,22,0,1,-3,3,1,1,1,1,1,0,0,0,0,0.47297076509898783,0.5270292349010122
91480,0.29411764705882354,0.7481108312342569,240,-297,0.2816975063843881,0.7183024936156119,home,WSH,under,9.5,0.5495495495495495,-122,0.5270292349010122,WSH,ATL,2023 REG,12,5,10,8,13,22,0,1,-3,3,1,1,1,1,1,0,0,0,0,0.47297076509898783,0.5270292349010122
91481,0.5073891625615764,0.5305164319248826,-103,-113,0.4881562747186933,0.5118437252813067,away,TOR,over,9,0.5098039215686274,-104,0.48375889301574193,TB,TOR,2023 REG,7,6,11,4,10,18,1,0,2,-2,1,1,1,1,0,0,0,0,0,0.48375889301574193,0.5162411069842581
91481,0.5073891625615764,0.5305164319248826,-103,-113,0.4881562747186933,0.5118437252813067,home,TB,under,9,0.5412844036697247,-118,0.5162411069842581,TB,TOR,2023 REG,7,6,11,4,10,18,1,0,2,-2,1,1,1,1,0,0,0,0,0,0.48375889301574193,0.5162411069842581
91482,0.4347826086956522,0.607843137254902,130,-155,0.41624967567367205,0.583750324326328,away,DET,over,8.5,0.5192307692307692,-108,0.49455035168025013,KC,DET,2023 REG,5,2,8,3,5,13,0,1,-1,1,1,1,0,0,0,0,0,0,0,0.49455035168025013,0.5054496483197499
91482,0.4347826086956522,0.607843137254902,130,-155,0.41624967567367205,0.583750324326328,home,KC,under,8.5,0.5283018867924528,-112,0.5054496483197499,KC,DET,2023 REG,5,2,8,3,5,13,0,1,-1,1,1,1,0,0,0,0,0,0,0,0.49455035168025013,0.5054496483197499
91483,0.4464285714285714,0.5951417004048584,124,-147,0.427870414360076,0.572129585639924,away,STL,over,9.5,0.5,100,0.4772727272727273,KC,STL,2023 REG,11,4,8,5,9,19,0,1,-1,1,1,1,1,1,0,0,0,0,0,0.4772727272727273,0.5227272727272727
91483,0.4464285714285714,0.5951417004048584,124,-147,0.427870414360076,0.572129585639924,home,KC,under,9.5,0.5454545454545454,-120,0.5227272727272727,KC,STL,2023 REG,11,4,8,5,9,19,0,1,-1,1,1,1,1,1,0,0,0,0,0,0.4772727272727273,0.5227272727272727
91484,0.45454545454545453,0.5850622406639003,120,-141,0.4365419567230205,0.5634580432769796,away,CLE,over,8.5,0.5121951219512195,-105,0.48919479393107135,PIT,CLE,2023 REG,9,7,10,5,12,19,1,0,2,-2,1,1,1,1,1,0,0,0,0,0.48919479393107135,0.5108052060689287
91484,0.45454545454545453,0.5850622406639003,120,-141,0.4365419567230205,0.5634580432769796,home,PIT,under,8.5,0.5327102803738317,-114,0.5108052060689287,PIT,CLE,2023 REG,9,7,10,5,12,19,1,0,2,-2,1,1,1,1,1,0,0,0,0,0.48919479393107135,0.5108052060689287
91485,0.5475113122171946,0.49504950495049505,-121,102,0.5242087833606768,0.4757912166393232,away,CIN,over,7.5,0.5283018867924528,-112,0.5044173060022736,CLE,CIN,2023 REG,9,7,10,11,18,19,0,1,-4,4,1,1,1,1,1,1,1,0,0,0.5044173060022736,0.49558269399772636
91485,0.5475113122171946,0.49504950495049505,-121,102,0.5242087833606768,0.4757912166393232,home,CLE,under,7.5,0.5169082125603864,-107,0.49558269399772636,CLE,CIN,2023 REG,9,7,10,11,18,19,0,1,-4,4,1,1,1,1,1,1,1,0,0,0.5044173060022736,0.49558269399772636
91486,0.48309178743961345,0.5594713656387665,107,-127,0.46252987773991294,0.5374701222600871,away,BAL,over,8.5,0.5192307692307692,-108,0.49571111079951763,NYY,BAL,2023 REG,7,1,20,14,15,27,0,1,-13,13,1,0,0,0,0,0,0,0,0,0.49571111079951763,0.5042888892004824
91486,0.48309178743961345,0.5594713656387665,107,-127,0.46252987773991294,0.5374701222600871,home,NYY,under,8.5,0.5260663507109005,-111,0.5042888892004824,NYY,BAL,2023 REG,7,1,20,14,15,27,0,1,-13,13,1,0,0,0,0,0,0,0,0,0.49571111079951763,0.5042888892004824
91487,0.5833333333333333,0.4566210045662101,-140,119,0.5600266362252664,0.4399733637747336,away,OAK,over,9.5,0.5215311004784688,-109,0.4978845547971712,WSH,OAK,2023 REG,9,3,7,2,5,16,1,0,1,-1,1,1,0,0,0,0,0,0,0,0.4978845547971712,0.5021154452028288
91487,0.5833333333333333,0.4566210045662101,-140,119,0.5600266362252664,0.4399733637747336,home,WSH,under,9.5,0.5238095238095238,-110,0.5021154452028288,WSH,OAK,2023 REG,9,3,7,2,5,16,1,0,1,-1,1,1,0,0,0,0,0,0,0,0.4978845547971712,0.5021154452028288
91488,0.6363636363636364,0.40322580645161293,-175,148,0.6111703545721141,0.3888296454278859,away,BOS,over,9.5,0.5238095238095238,-110,0.4988662131519274,ATL,BOS,2023 REG,8,2,7,5,7,15,0,1,-3,3,1,1,0,0,0,0,0,0,0,0.4988662131519274,0.5011337868480725
91488,0.6363636363636364,0.40322580645161293,-175,148,0.6111703545721141,0.3888296454278859,home,ATL,under,9.5,0.5238095238095238,-110,0.5011337868480725,ATL,BOS,2023 REG,8,2,7,5,7,15,0,1,-3,3,1,1,0,0,0,0,0,0,0,0.4988662131519274,0.5011337868480725
91489,0.6825396825396826,0.3597122302158273,-215,178,0.6537010754208424,0.34629892457915756,away,COL,over,9,0.5238095238095238,-110,0.4988662131519274,ARI,COL,2023 REG,6,2,7,3,5,13,0,1,-1,1,1,1,0,0,0,0,0,0,0,0.4988662131519274,0.5011337868480725
91489,0.6825396825396826,0.3597122302158273,-215,178,0.6537010754208424,0.34629892457915756,home,ARI,under,9,0.5238095238095238,-110,0.5011337868480725,ARI,COL,2023 REG,6,2,7,3,5,13,0,1,-1,1,1,1,0,0,0,0,0,0,0,0.4988662131519274,0.5011337868480725
91490,0.47619047619047616,0.5633187772925764,110,-129,0.45737654596045113,0.5426234540395489,away,LAD,over,10,0.5238095238095238,-110,0.4988662131519274,BOS,LAD,2023 REG,10,8,10,5,13,20,1,0,3,-3,1,1,1,1,1,0,0,0,0,0.4988662131519274,0.5011337868480725
91490,0.47619047619047616,0.5633187772925764,110,-129,0.45737654596045113,0.5426234540395489,home,BOS,under,10,0.5238095238095238,-110,0.5011337868480725,BOS,LAD,2023 REG,10,8,10,5,13,20,1,0,3,-3,1,1,1,1,1,0,0,0,0,0.4988662131519274,0.5011337868480725
91491,0.47619047619047616,0.5652173913043479,110,-130,0.4564724440500838,0.5435275559499162,away,CIN,over,9,0.5348837209302326,-115,0.5097020142727117,STL,CIN,2023 REG,13,15,14,6,21,27,1,0,9,-9,1,1,1,1,1,1,0,0,0,0.5097020142727117,0.49029798572728833
91491,0.47619047619047616,0.5652173913043479,110,-130,0.4564724440500838,0.5435275559499162,home,STL,under,9,0.5121951219512195,-105,0.49029798572728833,STL,CIN,2023 REG,13,15,14,6,21,27,1,0,9,-9,1,1,1,1,1,1,0,0,0,0.5097020142727117,0.49029798572728833
91492,0.425531914893617,0.6108949416342413,135,-157,0.41003112488176247,0.5899688751182375,away,LAA,over,12,0.5305164319248826,-113,0.5066009958897986,COL,LAA,2023 REG,15,7,11,4,11,26,1,0,3,-3,1,1,1,1,0,0,0,0,0,0.5066009958897986,0.49339900411020143
91492,0.425531914893617,0.6108949416342413,135,-157,0.41003112488176247,0.5899688751182375,home,COL,under,12,0.5145631067961165,-106,0.49339900411020143,COL,LAA,2023 REG,15,7,11,4,11,26,1,0,3,-3,1,1,1,1,0,0,0,0,0,0.5066009958897986,0.49339900411020143
91493,0.6168582375478928,0.425531914893617,-161,135,0.5907095228234366,0.4092904771765634,away,CWS,over,8.5,0.5348837209302326,-115,0.5097020142727117,BOS,CWS,2023 REG,5,2,4,3,5,9,0,1,-1,1,1,1,0,0,0,0,0,0,0,0.5097020142727117,0.49029798572728833
91493,0.6168582375478928,0.425531914893617,-161,135,0.5907095228234366,0.4092904771765634,home,BOS,under,8.5,0.5121951219512195,-105,0.49029798572728833,BOS,CWS,2023 REG,5,2,4,3,5,9,0,1,-1,1,1,1,0,0,0,0,0,0,0,0.5097020142727117,0.49029798572728833
91494,0.44052863436123346,0.601593625498008,127,-151,0.42197257274923283,0.5780274272507672,away,LAD,over,9,0.5024875621890548,-101,0.47839724939301687,MIA,LAD,2023 REG,13,11,6,4,15,19,1,0,7,-7,1,1,1,1,0,0,0,0,0,0.47839724939301687,0.5216027506069831
91494,0.44052863436123346,0.601593625498008,127,-151,0.42197257274923283,0.5780274272507672,home,MIA,under,9,0.5454545454545454,-120,0.5216027506069831,MIA,LAD,2023 REG,13,11,6,4,15,19,1,0,7,-7,1,1,1,1,0,0,0,0,0,0.47839724939301687,0.5216027506069831
91495,0.3846153846153846,0.6491228070175439,160,-185,0.37163915706425826,0.6283608429357417,away,SEA,over,8.5,0.5121951219512195,-105,0.48808156828023186,DET,SEA,2023 REG,9,5,10,3,8,19,1,0,2,-2,1,1,1,0,0,0,0,0,0,0.48808156828023186,0.5119184317197681
91495,0.3846153846153846,0.6491228070175439,160,-185,0.37163915706425826,0.6283608429357417,home,DET,under,8.5,0.5348837209302326,-115,0.5119184317197681,DET,SEA,2023 REG,9,5,10,3,8,19,1,0,2,-2,1,1,1,0,0,0,0,0,0,0.48808156828023186,0.5119184317197681
91496,0.5121951219512195,0.5348837209302326,-105,-115,0.48808156828023186,0.5119184317197681,away,CIN,over,10,0.5348837209302326,-115,0.5097020142727117,WSH,CIN,2023 REG,7,4,16,8,12,23,0,1,-4,4,1,1,1,1,0,0,0,0,0,0.5097020142727117,0.49029798572728833
91496,0.5121951219512195,0.5348837209302326,-105,-115,0.48808156828023186,0.5119184317197681,home,WSH,under,10,0.5121951219512195,-105,0.49029798572728833,WSH,CIN,2023 REG,7,4,16,8,12,23,0,1,-4,4,1,1,1,1,0,0,0,0,0,0.5097020142727117,0.49029798572728833
91497,0.5726495726495727,0.4672897196261683,-134,114,0.5497783539959433,0.4502216460040567,away,CHC,over,8.5,0.5475113122171946,-121,0.5214983313199976,STL,CHC,2023 REG,8,3,5,0,3,13,1,0,3,-3,0,0,0,0,0,0,0,0,0,0.5214983313199976,0.47850166868000243
91497,0.5726495726495727,0.4672897196261683,-134,114,0.5497783539959433,0.4502216460040567,home,STL,under,8.5,0.5,100,0.47850166868000243,STL,CHC,2023 REG,8,3,5,0,3,13,1,0,3,-3,0,0,0,0,0,0,0,0,0,0.5214983313199976,0.47850166868000243
91990,0.5726495726495727,0.4629629629629629,-134,116,0.5522560693500865,0.44774393064991347,away,PHI,over,8.5,0.5098039215686274,-104,0.48592421718142587,CWS,PHI,2023 REG,3,3,1,0,3,4,1,0,3,-3,0,0,0,0,0,0,0,0,0,0.48592421718142587,0.5140757828185741
91990,0.5726495726495727,0.4629629629629629,-134,116,0.5522560693500865,0.44774393064991347,home,CWS,under,8.5,0.5370370370370371,-116,0.5140757828185741,CWS,PHI,2023 REG,3,3,1,0,3,4,1,0,3,-3,0,0,0,0,0,0,0,0,0,0.48592421718142587,0.5140757828185741
91991,0.46511627906976744,0.5689655172413793,115,-132,0.4492642807855131,0.5507357192144868,away,PHI,over,8,0.5121951219512195,-105,0.48808156828023186,CWS,PHI,2023 REG,8,4,14,7,11,22,0,1,-3,3,1,1,1,1,0,0,0,0,0,0.48808156828023186,0.5119184317197681
91991,0.46511627906976744,0.5689655172413793,115,-132,0.4492642807855131,0.5507357192144868,home,CWS,under,8,0.5348837209302326,-115,0.5119184317197681,CWS,PHI,2023 REG,8,4,14,7,11,22,0,1,-3,3,1,1,1,1,0,0,0,0,0,0.48808156828023186,0.5119184317197681
91992,0.08,0.9803921568627451,1150,-5000,0.07516862745098041,0.9248313725490196,away,TOR,over,NA,NA,NA,NA,CWS,TOR,2023 REG,4,2,8,6,8,12,0,1,-4,4,1,1,0,0,0,0,0,0,0,NA,NA
91992,0.08,0.9803921568627451,1150,-5000,0.07516862745098041,0.9248313725490196,home,CWS,under,NA,NA,NA,NA,CWS,TOR,2023 REG,4,2,8,6,8,12,0,1,-4,4,1,1,0,0,0,0,0,0,0,NA,NA
92515,0.5121951219512195,0.5348837209302326,-105,-115,0.48808156828023186,0.5119184317197681,away,KC,over,8.5,0.5121951219512195,-105,0.48808156828023186,NYM,KC,2024 REG,8,2,3,1,3,11,1,0,1,-1,1,0,0,0,0,0,0,0,0,0.48808156828023186,0.5119184317197681
92515,0.5121951219512195,0.5348837209302326,-105,-115,0.48808156828023186,0.5119184317197681,home,NYM,under,8.5,0.5348837209302326,-115,0.5119184317197681,NYM,KC,2024 REG,8,2,3,1,3,11,1,0,1,-1,1,0,0,0,0,0,0,0,0,0.48808156828023186,0.5119184317197681
92533,0.5884773662551441,0.4484304932735426,-143,123,0.5667579262855877,0.43324207371441226,away,WSH,over,8,0.5215311004784688,-109,0.49670754937970685,OAK,WSH,2024 REG,11,7,12,6,13,23,1,0,1,-1,1,1,1,1,1,1,0,0,0,0.49670754937970685,0.5032924506202932
92533,0.5884773662551441,0.4484304932735426,-143,123,0.5667579262855877,0.43324207371441226,home,OAK,under,8,0.5260663507109005,-111,0.5032924506202932,OAK,WSH,2024 REG,11,7,12,6,13,23,1,0,1,-1,1,1,1,1,1,1,0,0,0,0.49670754937970685,0.5032924506202932
92566,0.5,0.5454545454545454,100,-120,0.4772727272727273,0.5227272727272727,away,NYM,over,8.5,0.5238095238095238,-110,0.4988662131519274,CIN,NYM,2024 REG,3,1,9,3,4,12,0,1,-2,2,1,0,0,0,0,0,0,0,0,0.4988662131519274,0.5011337868480725
92566,0.5,0.5454545454545454,100,-120,0.4772727272727273,0.5227272727272727,home,CIN,under,8.5,0.5238095238095238,-110,0.5011337868480725,CIN,NYM,2024 REG,3,1,9,3,4,12,0,1,-2,2,1,0,0,0,0,0,0,0,0,0.4988662131519274,0.5011337868480725
92591,0.5348837209302326,0.5098039215686274,-115,-104,0.5109810284308424,0.48901897156915763,away,SD,over,8.5,0.5121951219512195,-105,0.48808156828023186,MIL,SD,2024 REG,10,3,12,7,10,22,0,1,-4,4,1,1,1,0,0,0,0,0,0,0.48808156828023186,0.5119184317197681
92591,0.5348837209302326,0.5098039215686274,-115,-104,0.5109810284308424,0.48901897156915763,home,MIL,under,8.5,0.5348837209302326,-115,0.5119184317197681,MIL,SD,2024 REG,10,3,12,7,10,22,0,1,-4,4,1,1,1,0,0,0,0,0,0,0.48808156828023186,0.5119184317197681
92601,0.4347826086956522,0.6031746031746031,130,-152,0.418279473099889,0.581720526900111,away,BOS,over,8.5,0.5121951219512195,-105,0.48808156828023186,OAK,BOS,2024 REG,7,4,12,5,9,19,0,1,-1,1,1,1,1,1,0,0,0,0,0,0.48808156828023186,0.5119184317197681
92601,0.4347826086956522,0.6031746031746031,130,-152,0.418279473099889,0.581720526900111,home,OAK,under,8.5,0.5348837209302326,-115,0.5119184317197681,OAK,BOS,2024 REG,7,4,12,5,9,19,0,1,-1,1,1,1,1,1,0,0,0,0,0,0.48808156828023186,0.5119184317197681
92609,0.6226415094339623,0.4166666666666667,-165,140,0.5981666073335706,0.40183339266642937,away,KC,over,8,0.5370370370370371,-116,0.5131785224377817,BAL,KC,2024 REG,9,6,7,4,10,16,1,0,2,-2,1,1,1,1,0,0,0,0,0,0.5131785224377817,0.4868214775622183
92609,0.6226415094339623,0.4166666666666667,-165,140,0.5981666073335706,0.40183339266642937,home,BAL,under,8,0.5073891625615764,-103,0.4868214775622183,BAL,KC,2024 REG,9,6,7,4,10,16,1,0,2,-2,1,1,1,1,0,0,0,0,0,0.5131785224377817,0.4868214775622183
92616,0.5689655172413793,0.4716981132075471,-132,112,0.5458293137100936,0.4541706862899064,away,MIN,over,9,0.5238095238095238,-110,0.4988662131519274,BAL,MIN,2024 REG,12,7,11,4,11,23,1,0,3,-3,1,1,1,1,0,0,0,0,0,0.4988662131519274,0.5011337868480725
92616,0.5689655172413793,0.4716981132075471,-132,112,0.5458293137100936,0.4541706862899064,home,BAL,under,9,0.5238095238095238,-110,0.5011337868480725,BAL,MIN,2024 REG,12,7,11,4,11,23,1,0,3,-3,1,1,1,1,0,0,0,0,0,0.4988662131519274,0.5011337868480725
92632,0.607843137254902,0.4347826086956522,-155,130,0.5819333701084867,0.41806662989151333,away,CLE,over,7.5,0.5,100,0.4772727272727273,SEA,CLE,2024 REG,5,0,10,8,8,15,0,1,-8,8,0,0,0,0,0,0,0,0,0,0.4772727272727273,0.5227272727272727
92632,0.607843137254902,0.4347826086956522,-155,130,0.5819333701084867,0.41806662989151333,home,SEA,under,7.5,0.5454545454545454,-120,0.5227272727272727,SEA,CLE,2024 REG,5,0,10,8,8,15,0,1,-8,8,0,0,0,0,0,0,0,0,0,0.4772727272727273,0.5227272727272727
92643,0.6774193548387096,0.3623188405797102,-210,176,0.6504999321359091,0.34950006786409094,away,SD,over,8.5,0.5495495495495495,-122,0.5223196169142115,LAD,SD,2024 REG,8,5,7,2,7,15,1,0,3,-3,1,1,0,0,0,0,0,0,0,0.5223196169142115,0.47768038308578853
92643,0.6774193548387096,0.3623188405797102,-210,176,0.6504999321359091,0.34950006786409094,home,LAD,under,8.5,0.5,100,0.47768038308578853,LAD,SD,2024 REG,8,5,7,2,7,15,1,0,3,-3,1,1,0,0,0,0,0,0,0,0.5223196169142115,0.47768038308578853
92695,0.46511627906976744,0.574468085106383,115,-135,0.44670494689481377,0.5532950531051862,away,ATL,over,8,0.5348837209302326,-115,0.5097020142727117,PHI,ATL,2024 REG,8,4,19,12,16,27,0,1,-8,8,1,1,1,1,0,0,0,0,0,0.5097020142727117,0.49029798572728833
92695,0.46511627906976744,0.574468085106383,115,-135,0.44670494689481377,0.5532950531051862,home,PHI,under,8,0.5121951219512195,-105,0.49029798572728833,PHI,ATL,2024 REG,8,4,19,12,16,27,0,1,-8,8,1,1,1,1,0,0,0,0,0,0.5097020142727117,0.49029798572728833
92697,0.5121951219512195,0.5348837209302326,-105,-115,0.48808156828023186,0.5119184317197681,away,CLE,over,8,0.5121951219512195,-105,0.48808156828023186,SEA,CLE,2024 REG,7,5,6,4,9,13,1,0,1,-1,1,1,1,1,0,0,0,0,0,0.48808156828023186,0.5119184317197681
92697,0.5121951219512195,0.5348837209302326,-105,-115,0.48808156828023186,0.5119184317197681,home,SEA,under,8,0.5348837209302326,-115,0.5119184317197681,SEA,CLE,2024 REG,7,5,6,4,9,13,1,0,1,-1,1,1,1,1,0,0,0,0,0,0.48808156828023186,0.5119184317197681
92708,0.4166666666666667,0.6240601503759399,140,-166,0.39969715956558066,0.6003028404344193,away,TB,over,12.5,0.5238095238095238,-110,0.4988662131519274,COL,TB,2024 REG,12,10,13,7,17,25,1,0,3,-3,1,1,1,1,1,1,1,0,0,0.4988662131519274,0.5011337868480725
92708,0.4166666666666667,0.6240601503759399,140,-166,0.39969715956558066,0.6003028404344193,home,COL,under,12.5,0.5238095238095238,-110,0.5011337868480725,COL,TB,2024 REG,12,10,13,7,17,25,1,0,3,-3,1,1,1,1,1,1,1,0,0,0.4988662131519274,0.5011337868480725
92723,0.5327102803738317,0.5121951219512195,-114,-105,0.508788710910954,0.491211289089046,away,SF,over,7.5,0.5192307692307692,-108,0.49455035168025013,TB,SF,2024 REG,8,2,13,11,13,21,0,1,-9,9,1,1,0,0,0,0,0,0,0,0.49455035168025013,0.5054496483197499
92723,0.5327102803738317,0.5121951219512195,-114,-105,0.508788710910954,0.491211289089046,home,TB,under,7.5,0.5283018867924528,-112,0.5054496483197499,TB,SF,2024 REG,8,2,13,11,13,21,0,1,-9,9,1,1,0,0,0,0,0,0,0,0.49455035168025013,0.5054496483197499
92738,0.6875,0.35714285714285715,-220,180,0.6568080357142857,0.3431919642857143,away,MIA,over,8.5,0.5305164319248826,-113,0.5053568787472517,NYY,MIA,2024 REG,6,2,6,5,7,12,0,1,-3,3,1,1,0,0,0,0,0,0,0,0.5053568787472517,0.49464312125274834
92738,0.6875,0.35714285714285715,-220,180,0.6568080357142857,0.3431919642857143,home,NYY,under,8.5,0.5169082125603864,-107,0.49464312125274834,NYY,MIA,2024 REG,6,2,6,5,7,12,0,1,-3,3,1,1,0,0,0,0,0,0,0,0.5053568787472517,0.49464312125274834
92766,0.5918367346938775,0.45454545454545453,-145,120,0.5643860512665178,0.43561394873348225,away,LAA,over,8.5,0.5348837209302326,-115,0.5097020142727117,BAL,LAA,2024 REG,3,1,6,4,5,9,0,1,-3,3,1,0,0,0,0,0,0,0,0,0.5097020142727117,0.49029798572728833
92766,0.5918367346938775,0.45454545454545453,-145,120,0.5643860512665178,0.43561394873348225,home,BAL,under,8.5,0.5121951219512195,-105,0.49029798572728833,BAL,LAA,2024 REG,3,1,6,4,5,9,0,1,-3,3,1,0,0,0,0,0,0,0,0,0.5097020142727117,0.49029798572728833
92770,0.5348837209302326,0.5121951219512195,-115,-105,0.5097020142727117,0.49029798572728833,away,TEX,over,8.5,0.5348837209302326,-115,0.5097020142727117,HOU,TEX,2024 REG,10,8,10,5,13,20,1,0,3,-3,1,1,1,1,1,0,0,0,0,0.5097020142727117,0.49029798572728833
92770,0.5348837209302326,0.5121951219512195,-115,-105,0.5097020142727117,0.49029798572728833,home,HOU,under,8.5,0.5121951219512195,-105,0.49029798572728833,HOU,TEX,2024 REG,10,8,10,5,13,20,1,0,3,-3,1,1,1,1,1,0,0,0,0,0.5097020142727117,0.49029798572728833
92783,0.5633187772925764,0.47619047619047616,-129,110,0.5410624729287608,0.45893752707123925,away,SF,over,7.5,0.5,100,0.4772727272727273,SD,SF,2024 REG,7,6,9,9,15,16,0,1,-3,3,1,1,1,1,1,1,0,0,0,0.4772727272727273,0.5227272727272727
92783,0.5633187772925764,0.47619047619047616,-129,110,0.5410624729287608,0.45893752707123925,home,SD,under,7.5,0.5454545454545454,-120,0.5227272727272727,SD,SF,2024 REG,7,6,9,9,15,16,0,1,-3,3,1,1,1,1,1,1,0,0,0,0.4772727272727273,0.5227272727272727
92789,0.39370078740157477,0.6491228070175439,154,-185,0.37684110455940206,0.623158895440598,away,LAD,over,8,0.5283018867924528,-112,0.5044173060022736,MIN,LAD,2024 REG,6,3,9,6,9,15,0,1,-3,3,1,1,1,0,0,0,0,0,0,0.5044173060022736,0.49558269399772636
92789,0.39370078740157477,0.6491228070175439,154,-185,0.37684110455940206,0.623158895440598,home,MIN,under,8,0.5169082125603864,-107,0.49558269399772636,MIN,LAD,2024 REG,6,3,9,6,9,15,0,1,-3,3,1,1,1,0,0,0,0,0,0,0.5044173060022736,0.49558269399772636
92812,0.7101449275362319,0.3333333333333333,-245,200,0.6792690611216132,0.3207309388783868,away,OAK,over,7,0.5454545454545454,-120,0.5206611570247933,DET,OAK,2024 REG,8,5,5,4,9,13,1,0,1,-1,1,1,1,1,0,0,0,0,0,0.5206611570247933,0.4793388429752067
92812,0.7101449275362319,0.3333333333333333,-245,200,0.6792690611216132,0.3207309388783868,home,DET,under,7,0.5,100,0.4793388429752067,DET,OAK,2024 REG,8,5,5,4,9,13,1,0,1,-1,1,1,1,1,0,0,0,0,0,0.5206611570247933,0.4793388429752067
92813,0.5192307692307692,0.5238095238095238,-108,-110,0.49688292476754015,0.5031170752324599,away,HOU,over,10,0.5169082125603864,-107,0.49353874091423283,TEX,HOU,2024 REG,15,7,8,2,9,23,1,0,5,-5,1,1,0,0,0,0,0,0,0,0.49353874091423283,0.5064612590857671
92813,0.5192307692307692,0.5238095238095238,-108,-110,0.49688292476754015,0.5031170752324599,home,TEX,under,10,0.5283018867924528,-112,0.5064612590857671,TEX,HOU,2024 REG,15,7,8,2,9,23,1,0,5,-5,1,1,0,0,0,0,0,0,0,0.49353874091423283,0.5064612590857671
92830,0.6153846153846154,0.425531914893617,-160,135,0.5902052121364724,0.40979478786352763,away,TOR,over,9,0.5024875621890548,-101,0.47839724939301687,HOU,TOR,2024 REG,15,8,1,0,8,16,1,0,8,-8,0,0,0,0,0,0,0,0,0,0.47839724939301687,0.5216027506069831
92830,0.6153846153846154,0.425531914893617,-160,135,0.5902052121364724,0.40979478786352763,home,HOU,under,9,0.5454545454545454,-120,0.5216027506069831,HOU,TOR,2024 REG,15,8,1,0,8,16,1,0,8,-8,0,0,0,0,0,0,0,0,0,0.47839724939301687,0.5216027506069831
92832,0.8076923076923077,0.23809523809523808,-420,320,0.7707100591715976,0.22928994082840237,away,WSH,over,8.5,0.5348837209302326,-115,0.5097020142727117,LAD,WSH,2024 REG,9,4,8,6,10,17,0,1,-2,2,1,1,1,1,0,0,0,0,0,0.5097020142727117,0.49029798572728833
92832,0.8076923076923077,0.23809523809523808,-420,320,0.7707100591715976,0.22928994082840237,home,LAD,under,8.5,0.5121951219512195,-105,0.49029798572728833,LAD,WSH,2024 REG,9,4,8,6,10,17,0,1,-2,2,1,1,1,1,0,0,0,0,0,0.5097020142727117,0.49029798572728833
92837,0.6000000000000001,0.4347826086956522,-150,130,0.5791304347826086,0.4208695652173914,away,BOS,over,7.5,0.5121951219512195,-105,0.48808156828023186,SEA,BOS,2024 REG,8,4,11,6,10,19,0,1,-2,2,1,1,1,1,0,0,0,0,0,0.48808156828023186,0.5119184317197681
92837,0.6000000000000001,0.4347826086956522,-150,130,0.5791304347826086,0.4208695652173914,home,SEA,under,7.5,0.5348837209302326,-115,0.5119184317197681,SEA,BOS,2024 REG,8,4,11,6,10,19,0,1,-2,2,1,1,1,1,0,0,0,0,0,0.48808156828023186,0.5119184317197681
92868,0.47619047619047616,0.5652173913043479,110,-130,0.4564724440500838,0.5435275559499162,away,CIN,over,7.5,0.5327102803738317,-114,0.508788710910954,CWS,CIN,2024 REG,2,0,4,5,5,6,0,1,-5,5,0,0,0,0,0,0,0,0,0,0.508788710910954,0.491211289089046
92868,0.47619047619047616,0.5652173913043479,110,-130,0.4564724440500838,0.5435275559499162,home,CWS,under,7.5,0.5121951219512195,-105,0.491211289089046,CWS,CIN,2024 REG,2,0,4,5,5,6,0,1,-5,5,0,0,0,0,0,0,0,0,0,0.508788710910954,0.491211289089046
92870,0.5348837209302326,0.5121951219512195,-115,-105,0.5097020142727117,0.49029798572728833,away,SF,over,8.5,0.5238095238095238,-110,0.4988662131519274,TB,SF,2024 REG,6,2,6,1,3,12,1,0,1,-1,1,0,0,0,0,0,0,0,0,0.4988662131519274,0.5011337868480725
92870,0.5348837209302326,0.5121951219512195,-115,-105,0.5097020142727117,0.49029798572728833,home,TB,under,8.5,0.5238095238095238,-110,0.5011337868480725,TB,SF,2024 REG,6,2,6,1,3,12,1,0,1,-1,1,0,0,0,0,0,0,0,0,0.4988662131519274,0.5011337868480725
92889,0.3508771929824561,0.6923076923076923,185,-225,0.3357246016525795,0.6642753983474206,away,ATL,over,8.5,0.5348837209302326,-115,0.5097020142727117,MIA,ATL,2024 REG,8,5,6,1,6,14,1,0,4,-4,1,0,0,0,0,0,0,0,0,0.5097020142727117,0.49029798572728833
92889,0.3508771929824561,0.6923076923076923,185,-225,0.3357246016525795,0.6642753983474206,home,MIA,under,8.5,0.5121951219512195,-105,0.49029798572728833,MIA,ATL,2024 REG,8,5,6,1,6,14,1,0,4,-4,1,0,0,0,0,0,0,0,0,0.5097020142727117,0.49029798572728833
92896,0.6000000000000001,0.4347826086956522,-150,130,0.5791304347826086,0.4208695652173914,away,STL,over,8,0.5121951219512195,-105,0.48808156828023186,SD,STL,2024 REG,9,2,6,5,7,15,0,1,-3,3,1,1,0,0,0,0,0,0,0,0.48808156828023186,0.5119184317197681
92896,0.6000000000000001,0.4347826086956522,-150,130,0.5791304347826086,0.4208695652173914,home,SD,under,8,0.5348837209302326,-115,0.5119184317197681,SD,STL,2024 REG,9,2,6,5,7,15,0,1,-3,3,1,1,0,0,0,0,0,0,0,0.48808156828023186,0.5119184317197681
92905,0.5121951219512195,0.5348837209302326,-105,-115,0.48808156828023186,0.5119184317197681,away,ARI,over,11,0.5305164319248826,-113,0.5066009958897986,COL,ARI,2024 REG,6,3,10,5,8,16,0,1,-2,2,1,1,1,0,0,0,0,0,0,0.5066009958897986,0.49339900411020143
92905,0.5121951219512195,0.5348837209302326,-105,-115,0.48808156828023186,0.5119184317197681,home,COL,under,11,0.5145631067961165,-106,0.49339900411020143,COL,ARI,2024 REG,6,3,10,5,8,16,0,1,-2,2,1,1,1,0,0,0,0,0,0,0.5066009958897986,0.49339900411020143
92913,0.5967741935483871,0.4464285714285714,-148,124,0.5709918983202021,0.42900810167979786,away,MIA,over,7.5,0.5412844036697247,-118,0.5149381613977361,STL,MIA,2024 REG,8,3,8,1,4,16,1,0,2,-2,1,0,0,0,0,0,0,0,0,0.5149381613977361,0.48506183860226393
92913,0.5967741935483871,0.4464285714285714,-148,124,0.5709918983202021,0.42900810167979786,home,STL,under,7.5,0.5073891625615764,-103,0.48506183860226393,STL,MIA,2024 REG,8,3,8,1,4,16,1,0,2,-2,1,0,0,0,0,0,0,0,0,0.5149381613977361,0.48506183860226393
92918,0.504950495049505,0.5370370370370371,-102,-116,0.4837488699364985,0.5162511300635015,away,ATL,over,10.5,0.5121951219512195,-105,0.4858858974112951,HOU,ATL,2024 REG,7,1,11,6,7,18,0,1,-5,5,1,0,0,0,0,0,0,0,0,0.4858858974112951,0.5141141025887048
92918,0.504950495049505,0.5370370370370371,-102,-116,0.4837488699364985,0.5162511300635015,home,HOU,under,10.5,0.5391705069124424,-117,0.5141141025887048,HOU,ATL,2024 REG,7,1,11,6,7,18,0,1,-5,5,1,0,0,0,0,0,0,0,0,0.4858858974112951,0.5141141025887048
92930,0.48780487804878053,0.5555555555555556,105,-125,0.4666534470222751,0.5333465529777248,away,HOU,over,8.5,0.5145631067961165,-106,0.49023796582517226,KC,HOU,2024 REG,7,4,14,3,7,21,1,0,1,-1,1,1,1,0,0,0,0,0,0,0.49023796582517226,0.5097620341748277
92930,0.48780487804878053,0.5555555555555556,105,-125,0.4666534470222751,0.5333465529777248,home,KC,under,8.5,0.5327102803738317,-114,0.5097620341748277,KC,HOU,2024 REG,7,4,14,3,7,21,1,0,1,-1,1,1,1,0,0,0,0,0,0,0.49023796582517226,0.5097620341748277
92936,0.49019607843137253,0.5495495495495495,104,-122,0.4707129274603323,0.5292870725396677,away,MIN,over,9,0.5348837209302326,-115,0.5097020142727117,KC,MIN,2024 REG,14,11,4,0,11,18,1,0,11,-11,0,0,0,0,0,0,0,0,0,0.5097020142727117,0.49029798572728833
92936,0.49019607843137253,0.5495495495495495,104,-122,0.4707129274603323,0.5292870725396677,home,KC,under,9,0.5121951219512195,-105,0.49029798572728833,KC,MIN,2024 REG,14,11,4,0,11,18,1,0,11,-11,0,0,0,0,0,0,0,0,0,0.5097020142727117,0.49029798572728833
92941,0.5867768595041323,0.45454545454545453,-142,120,0.5625298818386723,0.43747011816132775,away,KC,over,8.5,0.5238095238095238,-110,0.4988662131519274,NYM,KC,2024 REG,14,6,3,1,7,17,1,0,5,-5,1,0,0,0,0,0,0,0,0,0.4988662131519274,0.5011337868480725
92941,0.5867768595041323,0.45454545454545453,-142,120,0.5625298818386723,0.43747011816132775,home,NYM,under,8.5,0.5238095238095238,-110,0.5011337868480725,NYM,KC,2024 REG,14,6,3,1,7,17,1,0,5,-5,1,0,0,0,0,0,0,0,0,0.4988662131519274,0.5011337868480725
92958,0.6666666666666666,0.37037037037037035,-200,170,0.6419753086419753,0.3580246913580247,away,ARI,over,9,0.5238095238095238,-110,0.4988662131519274,ATL,ARI,2024 REG,15,9,12,8,17,27,1,0,1,-1,1,1,1,1,1,1,1,1,0,0.4988662131519274,0.5011337868480725
92958,0.6666666666666666,0.37037037037037035,-200,170,0.6419753086419753,0.3580246913580247,home,ATL,under,9,0.5238095238095238,-110,0.5011337868480725,ATL,ARI,2024 REG,15,9,12,8,17,27,1,0,1,-1,1,1,1,1,1,1,1,1,0,0.4988662131519274,0.5011337868480725
92971,0.2777777777777778,0.7752808988764045,260,-345,0.26303925648494936,0.7369607435150507,away,ATL,over,9,0.5283018867924528,-112,0.49492081101443036,CWS,ATL,2024 REG,3,0,11,9,9,14,0,1,-9,9,0,0,0,0,0,0,0,0,0,0.49492081101443036,0.5050791889855697
92971,0.2777777777777778,0.7752808988764045,260,-345,0.26303925648494936,0.7369607435150507,home,CWS,under,9,0.5348837209302326,-115,0.5050791889855697,CWS,ATL,2024 REG,3,0,11,9,9,14,0,1,-9,9,0,0,0,0,0,0,0,0,0,0.49492081101443036,0.5050791889855697
92977,0.6503496503496503,0.3846153846153846,-186,160,0.6276101520856765,0.3723898479143235,away,CWS,over,8,0.5348837209302326,-115,0.5097020142727117,KC,CWS,2024 REG,10,10,8,1,11,18,1,0,9,-9,1,0,0,0,0,0,0,0,0,0.5097020142727117,0.49029798572728833
92977,0.6503496503496503,0.3846153846153846,-186,160,0.6276101520856765,0.3723898479143235,home,KC,under,8,0.5121951219512195,-105,0.49029798572728833,KC,CWS,2024 REG,10,10,8,1,11,18,1,0,9,-9,1,0,0,0,0,0,0,0,0,0.5097020142727117,0.49029798572728833
92998,0.5652173913043479,0.47619047619047616,-130,110,0.5418129444594474,0.4581870555405526,away,CHC,over,8,0.5169082125603864,-107,0.49353874091423283,SEA,CHC,2024 REG,6,4,4,2,6,10,1,0,2,-2,1,1,0,0,0,0,0,0,0,0.49353874091423283,0.5064612590857671
92998,0.5652173913043479,0.47619047619047616,-130,110,0.5418129444594474,0.4581870555405526,home,SEA,under,8,0.5283018867924528,-112,0.5064612590857671,SEA,CHC,2024 REG,6,4,4,2,6,10,1,0,2,-2,1,1,0,0,0,0,0,0,0,0.49353874091423283,0.5064612590857671
93003,0.7142857142857143,0.3278688524590164,-250,205,0.6841753094680495,0.3158246905319505,away,STL,over,8.5,0.5495495495495495,-122,0.5250401592387142,LAD,STL,2024 REG,10,7,3,1,8,13,1,0,6,-6,1,0,0,0,0,0,0,0,0,0.5250401592387142,0.47495984076128583
93003,0.7142857142857143,0.3278688524590164,-250,205,0.6841753094680495,0.3158246905319505,home,LAD,under,8.5,0.49504950495049505,102,0.47495984076128583,LAD,STL,2024 REG,10,7,3,1,8,13,1,0,6,-6,1,0,0,0,0,0,0,0,0,0.5250401592387142,0.47495984076128583
93019,0.5867768595041323,0.45454545454545453,-142,120,0.5625298818386723,0.43747011816132775,away,CHC,over,7.5,0.504950495049505,-102,0.48160416005266615,SEA,CHC,2024 REG,5,2,8,3,5,13,0,1,-1,1,1,1,0,0,0,0,0,0,0,0.48160416005266615,0.5183958399473338
93019,0.5867768595041323,0.45454545454545453,-142,120,0.5625298818386723,0.43747011816132775,home,SEA,under,7.5,0.5412844036697247,-118,0.5183958399473338,SEA,CHC,2024 REG,5,2,8,3,5,13,0,1,-1,1,1,1,0,0,0,0,0,0,0,0.48160416005266615,0.5183958399473338
93030,0.5454545454545454,0.5,-120,100,0.5206611570247933,0.4793388429752067,away,SEA,over,8,0.5391705069124424,-117,0.5140669063204599,TOR,SEA,2024 REG,6,1,6,6,7,12,0,1,-5,5,1,0,0,0,0,0,0,0,0,0.5140669063204599,0.4859330936795401
93030,0.5454545454545454,0.5,-120,100,0.5206611570247933,0.4793388429752067,home,TOR,under,8,0.5073891625615764,-103,0.4859330936795401,TOR,SEA,2024 REG,6,1,6,6,7,12,0,1,-5,5,1,0,0,0,0,0,0,0,0,0.5140669063204599,0.4859330936795401
93036,0.5412844036697247,0.5,-118,100,0.5189377998484975,0.4810622001515025,away,MIN,over,8.5,0.5283018867924528,-112,0.5031902949311281,MIL,MIN,2024 REG,7,3,3,2,5,10,1,0,1,-1,1,1,0,0,0,0,0,0,0,0.5031902949311281,0.4968097050688719
93036,0.5412844036697247,0.5,-118,100,0.5189377998484975,0.4810622001515025,home,MIL,under,8.5,0.5192307692307692,-108,0.4968097050688719,MIL,MIN,2024 REG,7,3,3,2,5,10,1,0,1,-1,1,1,0,0,0,0,0,0,0,0.5031902949311281,0.4968097050688719
93039,0.5454545454545454,0.5,-120,100,0.5206611570247933,0.4793388429752067,away,SEA,over,8.5,0.5454545454545454,-120,0.5206611570247933,MIL,SEA,2024 REG,5,3,10,5,8,15,0,1,-2,2,1,1,1,0,0,0,0,0,0,0.5206611570247933,0.4793388429752067
93039,0.5454545454545454,0.5,-120,100,0.5206611570247933,0.4793388429752067,home,MIL,under,8.5,0.5,100,0.4793388429752067,MIL,SEA,2024 REG,5,3,10,5,8,15,0,1,-2,2,1,1,1,0,0,0,0,0,0,0.5206611570247933,0.4793388429752067
93041,0.48780487804878053,0.5555555555555556,105,-125,0.4666534470222751,0.5333465529777248,away,HOU,over,9.5,0.5238095238095238,-110,0.4988662131519274,KC,HOU,2024 REG,11,11,9,2,13,20,1,0,9,-9,1,1,0,0,0,0,0,0,0,0.4988662131519274,0.5011337868480725
93041,0.48780487804878053,0.5555555555555556,105,-125,0.4666534470222751,0.5333465529777248,home,KC,under,9.5,0.5238095238095238,-110,0.5011337868480725,KC,HOU,2024 REG,11,11,9,2,13,20,1,0,9,-9,1,1,0,0,0,0,0,0,0,0.4988662131519274,0.5011337868480725
93057,0.6226415094339623,0.4166666666666667,-165,140,0.5981666073335706,0.40183339266642937,away,TOR,over,8,0.5348837209302326,-115,0.5097020142727117,NYY,TOR,2024 REG,8,8,5,3,11,13,1,0,5,-5,1,1,1,0,0,0,0,0,0,0.5097020142727117,0.49029798572728833
93057,0.6226415094339623,0.4166666666666667,-165,140,0.5981666073335706,0.40183339266642937,home,NYY,under,8,0.5121951219512195,-105,0.49029798572728833,NYY,TOR,2024 REG,8,8,5,3,11,13,1,0,5,-5,1,1,1,0,0,0,0,0,0,0.5097020142727117,0.49029798572728833
93086,0.37735849056603776,0.6666666666666666,165,-200,0.36074522368577194,0.639254776314228,away,PHI,over,8,0.5348837209302326,-115,0.5097020142727117,WSH,PHI,2024 REG,2,0,9,4,4,11,0,1,-4,4,0,0,0,0,0,0,0,0,0,0.5097020142727117,0.49029798572728833
93086,0.37735849056603776,0.6666666666666666,165,-200,0.36074522368577194,0.639254776314228,home,WSH,under,8,0.5121951219512195,-105,0.49029798572728833,WSH,PHI,2024 REG,2,0,9,4,4,11,0,1,-4,4,0,0,0,0,0,0,0,0,0,0.5097020142727117,0.49029798572728833
93094,0.46511627906976744,0.574468085106383,115,-135,0.44670494689481377,0.5532950531051862,away,LAD,over,8.5,0.5391705069124424,-117,0.5127649394825569,MIN,LAD,2024 REG,3,2,10,4,6,13,0,1,-2,2,1,1,0,0,0,0,0,0,0,0.5127649394825569,0.48723506051744314
93094,0.46511627906976744,0.574468085106383,115,-135,0.44670494689481377,0.5532950531051862,home,MIN,under,8.5,0.5098039215686274,-104,0.48723506051744314,MIN,LAD,2024 REG,3,2,10,4,6,13,0,1,-2,2,1,1,0,0,0,0,0,0,0,0.5127649394825569,0.48723506051744314
93126,0.5412844036697247,0.5,-118,100,0.5189377998484975,0.4810622001515025,away,NYY,over,9.5,0.5238095238095238,-110,0.4988662131519274,HOU,NYY,2024 REG,12,3,10,4,7,22,0,1,-1,1,1,1,1,0,0,0,0,0,0,0.4988662131519274,0.5011337868480725
93126,0.5412844036697247,0.5,-118,100,0.5189377998484975,0.4810622001515025,home,HOU,under,9.5,0.5238095238095238,-110,0.5011337868480725,HOU,NYY,2024 REG,12,3,10,4,7,22,0,1,-1,1,1,1,1,0,0,0,0,0,0,0.4988662131519274,0.5011337868480725
93128,0.5726495726495727,0.46511627906976744,-134,115,0.5510229738017454,0.44897702619825464,away,SEA,over,9,0.5121951219512195,-105,0.48808156828023186,MIL,SEA,2024 REG,14,12,8,4,16,22,1,0,8,-8,1,1,1,1,0,0,0,0,0,0.48808156828023186,0.5119184317197681
93128,0.5726495726495727,0.46511627906976744,-134,115,0.5510229738017454,0.44897702619825464,home,MIL,under,9,0.5348837209302326,-115,0.5119184317197681,MIL,SEA,2024 REG,14,12,8,4,16,22,1,0,8,-8,1,1,1,1,0,0,0,0,0,0.48808156828023186,0.5119184317197681
93133,0.6825396825396826,0.35714285714285715,-215,180,0.6554547745023935,0.34454522549760647,away,WSH,over,7.5,0.5121951219512195,-105,0.48808156828023186,SF,WSH,2024 REG,6,1,10,8,9,16,0,1,-7,7,1,0,0,0,0,0,0,0,0,0.48808156828023186,0.5119184317197681
93133,0.6825396825396826,0.35714285714285715,-215,180,0.6554547745023935,0.34454522549760647,home,SF,under,7.5,0.5348837209302326,-115,0.5119184317197681,SF,WSH,2024 REG,6,1,10,8,9,16,0,1,-7,7,1,0,0,0,0,0,0,0,0,0.48808156828023186,0.5119184317197681
93140,0.5238095238095238,0.5192307692307692,-110,-108,0.5012646084074657,0.4987353915925343,away,PIT,over,8.5,0.5433789954337899,-119,0.5171177654451503,MIA,PIT,2024 REG,5,3,16,9,12,21,0,1,-6,6,1,1,1,0,0,0,0,0,0,0.5171177654451503,0.4828822345548497
93140,0.5238095238095238,0.5192307692307692,-110,-108,0.5012646084074657,0.4987353915925343,home,MIA,under,8.5,0.504950495049505,-102,0.4828822345548497,MIA,PIT,2024 REG,5,3,16,9,12,21,0,1,-6,6,1,1,1,0,0,0,0,0,0,0.5171177654451503,0.4828822345548497
93147,0.5594713656387665,0.4807692307692307,-127,108,0.5369579042122659,0.46304209578773414,away,PIT,over,7.5,0.5121951219512195,-105,0.48808156828023186,MIA,PIT,2024 REG,8,5,9,6,11,17,0,1,-1,1,1,1,1,1,1,0,0,0,0,0.48808156828023186,0.5119184317197681
93147,0.5594713656387665,0.4807692307692307,-127,108,0.5369579042122659,0.46304209578773414,home,MIA,under,7.5,0.5348837209302326,-115,0.5119184317197681,MIA,PIT,2024 REG,8,5,9,6,11,17,0,1,-1,1,1,1,1,1,1,0,0,0,0,0.48808156828023186,0.5119184317197681
93157,0.4132231404958678,0.6296296296296295,142,-170,0.3955153842456623,0.6044846157543378,away,BOS,over,7.5,0.5215311004784688,-109,0.49670754937970685,OAK,BOS,2024 REG,8,0,10,1,1,18,0,1,-1,1,0,0,0,0,0,0,0,0,0,0.49670754937970685,0.5032924506202932
93157,0.4132231404958678,0.6296296296296295,142,-170,0.3955153842456623,0.6044846157543378,home,OAK,under,7.5,0.5260663507109005,-111,0.5032924506202932,OAK,BOS,2024 REG,8,0,10,1,1,18,0,1,-1,1,0,0,0,0,0,0,0,0,0,0.49670754937970685,0.5032924506202932
93163,0.49504950495049505,0.5475113122171946,102,-121,0.4739797934813417,0.5260202065186583,away,TOR,over,8,0.5348837209302326,-115,0.5097020142727117,TB,TOR,2024 REG,3,2,10,9,11,13,0,1,-7,7,1,1,0,0,0,0,0,0,0,0.5097020142727117,0.49029798572728833
93163,0.49504950495049505,0.5475113122171946,102,-121,0.4739797934813417,0.5260202065186583,home,TB,under,8,0.5121951219512195,-105,0.49029798572728833,TB,TOR,2024 REG,3,2,10,9,11,13,0,1,-7,7,1,1,0,0,0,0,0,0,0,0.5097020142727117,0.49029798572728833
93174,0.5555555555555556,0.48780487804878053,-125,105,0.5314664257753688,0.46853357422463116,away,TEX,over,8.5,0.5238095238095238,-110,0.4988662131519274,DET,TEX,2024 REG,5,0,7,1,1,12,0,1,-1,1,0,0,0,0,0,0,0,0,0,0.4988662131519274,0.5011337868480725
93174,0.5555555555555556,0.48780487804878053,-125,105,0.5314664257753688,0.46853357422463116,home,DET,under,8.5,0.5238095238095238,-110,0.5011337868480725,DET,TEX,2024 REG,5,0,7,1,1,12,0,1,-1,1,0,0,0,0,0,0,0,0,0,0.4988662131519274,0.5011337868480725
93190,0.4347826086956522,0.607843137254902,130,-155,0.41624967567367205,0.583750324326328,away,LAD,over,8,0.5024875621890548,-101,0.4794401874631478,CHC,LAD,2024 REG,7,1,9,4,5,16,0,1,-3,3,1,0,0,0,0,0,0,0,0,0.4794401874631478,0.5205598125368522
93190,0.4347826086956522,0.607843137254902,130,-155,0.41624967567367205,0.583750324326328,home,CHC,under,8,0.5433789954337899,-119,0.5205598125368522,CHC,LAD,2024 REG,7,1,9,4,5,16,0,1,-3,3,1,0,0,0,0,0,0,0,0,0.4794401874631478,0.5205598125368522
93193,0.5238095238095238,0.5238095238095238,-110,-110,0.4988662131519274,0.5011337868480725,away,NYY,over,9,0.5121951219512195,-105,0.48808156828023186,ARI,NYY,2024 REG,12,7,3,0,7,15,1,0,7,-7,0,0,0,0,0,0,0,0,0,0.48808156828023186,0.5119184317197681
93193,0.5238095238095238,0.5238095238095238,-110,-110,0.4988662131519274,0.5011337868480725,home,ARI,under,9,0.5348837209302326,-115,0.5119184317197681,ARI,NYY,2024 REG,12,7,3,0,7,15,1,0,7,-7,0,0,0,0,0,0,0,0,0,0.48808156828023186,0.5119184317197681
93198,0.4587155963302753,0.5780590717299579,118,-137,0.4418464825411775,0.5581535174588226,away,TB,over,11.5,0.5,100,0.4762443438914027,COL,TB,2024 REG,11,6,9,8,14,20,0,1,-2,2,1,1,1,1,1,1,0,0,0,0.4762443438914027,0.5237556561085973
93198,0.4587155963302753,0.5780590717299579,118,-137,0.4418464825411775,0.5581535174588226,home,COL,under,11.5,0.5475113122171946,-121,0.5237556561085973,COL,TB,2024 REG,11,6,9,8,14,20,0,1,-2,2,1,1,1,1,1,1,0,0,0,0.4762443438914027,0.5237556561085973
93217,0.5555555555555556,0.48780487804878053,-125,105,0.5314664257753688,0.46853357422463116,away,CHC,over,9.5,0.5283018867924528,-112,0.5031902949311281,TEX,CHC,2024 REG,16,11,5,2,13,21,1,0,9,-9,1,1,0,0,0,0,0,0,0,0.5031902949311281,0.4968097050688719
93217,0.5555555555555556,0.48780487804878053,-125,105,0.5314664257753688,0.46853357422463116,home,TEX,under,9.5,0.5192307692307692,-108,0.4968097050688719,TEX,CHC,2024 REG,16,11,5,2,13,21,1,0,9,-9,1,1,0,0,0,0,0,0,0,0.5031902949311281,0.4968097050688719
93240,0.48309178743961345,0.5555555555555556,107,-125,0.4644215734322854,0.5355784265677146,away,MIL,over,8.5,0.5238095238095238,-110,0.4988662131519274,BAL,MIL,2024 REG,6,1,15,11,12,21,0,1,-10,10,1,0,0,0,0,0,0,0,0,0.4988662131519274,0.5011337868480725
93240,0.48309178743961345,0.5555555555555556,107,-125,0.4644215734322854,0.5355784265677146,home,BAL,under,8.5,0.5238095238095238,-110,0.5011337868480725,BAL,MIL,2024 REG,6,1,15,11,12,21,0,1,-10,10,1,0,0,0,0,0,0,0,0,0.4988662131519274,0.5011337868480725
93265,0.5967741935483871,0.4444444444444444,-148,125,0.5721759741010521,0.42782402589894786,away,TOR,over,7.5,0.5238095238095238,-110,0.4988662131519274,TB,TOR,2024 REG,8,2,7,8,10,15,0,1,-6,6,1,1,0,0,0,0,0,0,0,0.4988662131519274,0.5011337868480725
93265,0.5967741935483871,0.4444444444444444,-148,125,0.5721759741010521,0.42782402589894786,home,TB,under,7.5,0.5238095238095238,-110,0.5011337868480725,TB,TOR,2024 REG,8,2,7,8,10,15,0,1,-6,6,1,1,0,0,0,0,0,0,0,0.4988662131519274,0.5011337868480725
93268,0.3846153846153846,0.6551724137931035,160,-190,0.3693123852275045,0.6306876147724956,away,PHI,over,8,0.5238095238095238,-110,0.4988662131519274,WSH,PHI,2024 REG,4,2,9,5,7,13,0,1,-3,3,1,1,0,0,0,0,0,0,0,0.4988662131519274,0.5011337868480725
93268,0.3846153846153846,0.6551724137931035,160,-190,0.3693123852275045,0.6306876147724956,home,WSH,under,8,0.5238095238095238,-110,0.5011337868480725,WSH,PHI,2024 REG,4,2,9,5,7,13,0,1,-3,3,1,1,0,0,0,0,0,0,0,0.4988662131519274,0.5011337868480725
93271,0.5145631067961165,0.5283018867924528,-106,-112,0.4925063625223866,0.5074936374776133,away,BOS,over,8.5,0.5412844036697247,-118,0.5162581740877563,LAA,BOS,2024 REG,6,6,9,8,14,15,0,1,-2,2,1,1,1,1,1,1,0,0,0,0.5162581740877563,0.4837418259122437
93271,0.5145631067961165,0.5283018867924528,-106,-112,0.4925063625223866,0.5074936374776133,home,LAA,under,8.5,0.504950495049505,-102,0.4837418259122437,LAA,BOS,2024 REG,6,6,9,8,14,15,0,1,-2,2,1,1,1,1,1,1,0,0,0,0.5162581740877563,0.4837418259122437
93275,0.5780590717299579,0.4608294930875576,-137,117,0.5555791840506346,0.44442081594936544,away,PIT,over,8.5,0.5,100,0.4772727272727273,MIA,PIT,2024 REG,9,2,10,7,9,19,0,1,-5,5,1,1,0,0,0,0,0,0,0,0.4772727272727273,0.5227272727272727
93275,0.5780590717299579,0.4608294930875576,-137,117,0.5555791840506346,0.44442081594936544,home,MIA,under,8.5,0.5454545454545454,-120,0.5227272727272727,MIA,PIT,2024 REG,9,2,10,7,9,19,0,1,-5,5,1,1,0,0,0,0,0,0,0,0.4772727272727273,0.5227272727272727
93311,0.5918367346938775,0.4464285714285714,-145,124,0.5691899208663057,0.4308100791336943,away,PIT,over,8.5,0.5215311004784688,-109,0.4978845547971712,MIA,PIT,2024 REG,7,7,11,9,16,18,0,1,-2,2,1,1,1,1,1,1,1,0,0,0.4978845547971712,0.5021154452028288
93311,0.5918367346938775,0.4464285714285714,-145,124,0.5691899208663057,0.4308100791336943,home,MIA,under,8.5,0.5238095238095238,-110,0.5021154452028288,MIA,PIT,2024 REG,7,7,11,9,16,18,0,1,-2,2,1,1,1,1,1,1,1,0,0,0.4978845547971712,0.5021154452028288
93316,0.6108949416342413,0.425531914893617,-157,135,0.5886419592417365,0.41135804075826354,away,PIT,over,8.5,0.5305164319248826,-113,0.5041247242695369,PHI,PIT,2024 REG,9,4,5,3,7,14,1,0,1,-1,1,1,1,0,0,0,0,0,0,0.5041247242695369,0.4958752757304631
93316,0.6108949416342413,0.425531914893617,-157,135,0.5886419592417365,0.41135804075826354,home,PHI,under,8.5,0.5192307692307692,-108,0.4958752757304631,PHI,PIT,2024 REG,9,4,5,3,7,14,1,0,1,-1,1,1,1,0,0,0,0,0,0,0.5041247242695369,0.4958752757304631
93332,0.5192307692307692,0.5238095238095238,-108,-110,0.49688292476754015,0.5031170752324599,away,MIN,over,8.5,0.5454545454545454,-120,0.5193043049216726,MIL,MIN,2024 REG,7,3,11,7,10,18,0,1,-4,4,1,1,1,0,0,0,0,0,0,0.5193043049216726,0.48069569507832743
93332,0.5192307692307692,0.5238095238095238,-108,-110,0.49688292476754015,0.5031170752324599,home,MIL,under,8.5,0.5024875621890548,-101,0.48069569507832743,MIL,MIN,2024 REG,7,3,11,7,10,18,0,1,-4,4,1,1,1,0,0,0,0,0,0,0.5193043049216726,0.48069569507832743
93341,0.5867768595041323,0.45454545454545453,-142,120,0.5625298818386723,0.43747011816132775,away,CHC,over,8,0.5169082125603864,-107,0.49239402434819424,SD,CHC,2024 REG,4,1,9,5,6,13,0,1,-4,4,1,0,0,0,0,0,0,0,0,0.49239402434819424,0.5076059756518058
93341,0.5867768595041323,0.45454545454545453,-142,120,0.5625298818386723,0.43747011816132775,home,SD,under,8,0.5305164319248826,-113,0.5076059756518058,SD,CHC,2024 REG,4,1,9,5,6,13,0,1,-4,4,1,0,0,0,0,0,0,0,0,0.49239402434819424,0.5076059756518058
93352,0.607843137254902,0.4347826086956522,-155,130,0.5819333701084867,0.41806662989151333,away,WSH,over,9.5,0.5238095238095238,-110,0.4988662131519274,CIN,WSH,2024 REG,10,8,6,2,10,16,1,0,6,-6,1,1,0,0,0,0,0,0,0,0.4988662131519274,0.5011337868480725
93352,0.607843137254902,0.4347826086956522,-155,130,0.5819333701084867,0.41806662989151333,home,CIN,under,9.5,0.5238095238095238,-110,0.5011337868480725,CIN,WSH,2024 REG,10,8,6,2,10,16,1,0,6,-6,1,1,0,0,0,0,0,0,0,0.4988662131519274,0.5011337868480725
93359,0.5475113122171946,0.49504950495049505,-121,102,0.5242087833606768,0.4757912166393232,away,TOR,over,7.5,0.49504950495049505,102,0.47097973588023584,NYY,TOR,2024 REG,10,9,12,8,17,22,1,0,1,-1,1,1,1,1,1,1,1,1,0,0.47097973588023584,0.5290202641197641
93359,0.5475113122171946,0.49504950495049505,-121,102,0.5242087833606768,0.4757912166393232,home,NYY,under,7.5,0.5535714285714286,-124,0.5290202641197641,NYY,TOR,2024 REG,10,9,12,8,17,22,1,0,1,-1,1,1,1,1,1,1,1,1,0,0.47097973588023584,0.5290202641197641
93363,0.6153846153846154,0.425531914893617,-160,135,0.5902052121364724,0.40979478786352763,away,CHC,over,8,0.5454545454545454,-120,0.5206611570247933,SD,CHC,2024 REG,12,10,3,2,12,15,1,0,8,-8,1,1,0,0,0,0,0,0,0,0.5206611570247933,0.4793388429752067
93363,0.6153846153846154,0.425531914893617,-160,135,0.5902052121364724,0.40979478786352763,home,SD,under,8,0.5,100,0.4793388429752067,SD,CHC,2024 REG,12,10,3,2,12,15,1,0,8,-8,1,1,0,0,0,0,0,0,0,0.5206611570247933,0.4793388429752067
93381,0.4,0.6428571428571428,150,-180,0.38285714285714295,0.617142857142857,away,KC,over,7.5,0.5412844036697247,-118,0.5149381613977361,CWS,KC,2024 REG,4,0,5,2,2,9,0,1,-2,2,0,0,0,0,0,0,0,0,0,0.5149381613977361,0.48506183860226393
93381,0.4,0.6428571428571428,150,-180,0.38285714285714295,0.617142857142857,home,CWS,under,7.5,0.5073891625615764,-103,0.48506183860226393,CWS,KC,2024 REG,4,0,5,2,2,9,0,1,-2,2,0,0,0,0,0,0,0,0,0,0.5149381613977361,0.48506183860226393
93396,0.5555555555555556,0.48780487804878053,-125,105,0.5314664257753688,0.46853357422463116,away,CHC,over,8.5,0.5073891625615764,-103,0.48057683780462784,TEX,CHC,2024 REG,8,4,6,3,7,14,1,0,1,-1,1,1,1,0,0,0,0,0,0,0.48057683780462784,0.5194231621953722
93396,0.5555555555555556,0.48780487804878053,-125,105,0.5314664257753688,0.46853357422463116,home,TEX,under,8.5,0.5454545454545454,-120,0.5194231621953722,TEX,CHC,2024 REG,8,4,6,3,7,14,1,0,1,-1,1,1,1,0,0,0,0,0,0,0.48057683780462784,0.5194231621953722
93422,0.574468085106383,0.46511627906976744,-135,115,0.5517281312179562,0.44827186878204384,away,MIN,over,8.5,0.5327102803738317,-114,0.5075272610403079,DET,MIN,2024 REG,4,1,7,4,5,11,0,1,-3,3,1,0,0,0,0,0,0,0,0,0.5075272610403079,0.4924727389596921
93422,0.574468085106383,0.46511627906976744,-135,115,0.5517281312179562,0.44827186878204384,home,DET,under,8.5,0.5145631067961165,-106,0.4924727389596921,DET,MIN,2024 REG,4,1,7,4,5,11,0,1,-3,3,1,0,0,0,0,0,0,0,0,0.5075272610403079,0.4924727389596921
93424,0.5454545454545454,0.5,-120,100,0.5206611570247933,0.4793388429752067,away,SEA,over,8,0.5283018867924528,-112,0.5044173060022736,TOR,SEA,2024 REG,11,5,7,2,7,18,1,0,3,-3,1,1,0,0,0,0,0,0,0,0.5044173060022736,0.49558269399772636
93424,0.5454545454545454,0.5,-120,100,0.5206611570247933,0.4793388429752067,home,TOR,under,8,0.5169082125603864,-107,0.49558269399772636,TOR,SEA,2024 REG,11,5,7,2,7,18,1,0,3,-3,1,1,0,0,0,0,0,0,0,0.5044173060022736,0.49558269399772636
93438,0.6610169491525424,0.37735849056603776,-195,165,0.6356501330673793,0.3643498669326207,away,CWS,over,8,0.5348837209302326,-115,0.5097020142727117,KC,CWS,2024 REG,7,2,4,1,3,11,1,0,1,-1,1,0,0,0,0,0,0,0,0,0.5097020142727117,0.49029798572728833
93438,0.6610169491525424,0.37735849056603776,-195,165,0.6356501330673793,0.3643498669326207,home,KC,under,8,0.5121951219512195,-105,0.49029798572728833,KC,CWS,2024 REG,7,2,4,1,3,11,1,0,1,-1,1,0,0,0,0,0,0,0,0,0.5097020142727117,0.49029798572728833
93439,0.4672897196261683,0.5726495726495727,114,-134,0.44862649893656975,0.5513735010634302,away,WSH,over,8,0.5098039215686274,-104,0.48483656587239576,OAK,WSH,2024 REG,8,1,10,3,4,18,0,1,-2,2,1,0,0,0,0,0,0,0,0,0.48483656587239576,0.5151634341276042
93439,0.4672897196261683,0.5726495726495727,114,-134,0.44862649893656975,0.5513735010634302,home,OAK,under,8,0.5391705069124424,-117,0.5151634341276042,OAK,WSH,2024 REG,8,1,10,3,4,18,0,1,-2,2,1,0,0,0,0,0,0,0,0,0.48483656587239576,0.5151634341276042
93460,0.4484304932735426,0.5884773662551441,123,-143,0.43187988361942303,0.5681201163805769,away,CLE,over,7.5,0.5,100,0.4772727272727273,OAK,CLE,2024 REG,4,0,11,8,8,15,0,1,-8,8,0,0,0,0,0,0,0,0,0,0.4772727272727273,0.5227272727272727
93460,0.4484304932735426,0.5884773662551441,123,-143,0.43187988361942303,0.5681201163805769,home,OAK,under,7.5,0.5454545454545454,-120,0.5227272727272727,OAK,CLE,2024 REG,4,0,11,8,8,15,0,1,-8,8,0,0,0,0,0,0,0,0,0,0.4772727272727273,0.5227272727272727
93466,0.5348837209302326,0.5121951219512195,-115,-105,0.5097020142727117,0.49029798572728833,away,MIL,over,7.5,0.5,100,0.4772727272727273,NYM,MIL,2024 REG,1,1,8,3,4,9,0,1,-2,2,1,0,0,0,0,0,0,0,0,0.4772727272727273,0.5227272727272727
93466,0.5348837209302326,0.5121951219512195,-115,-105,0.5097020142727117,0.49029798572728833,home,NYM,under,7.5,0.5454545454545454,-120,0.5227272727272727,NYM,MIL,2024 REG,1,1,8,3,4,9,0,1,-2,2,1,0,0,0,0,0,0,0,0,0.4772727272727273,0.5227272727272727
93467,0.7014925373134329,0.3424657534246575,-235,192,0.6706561244076082,0.32934387559239175,away,STL,over,8.5,0.5283018867924528,-112,0.5031902949311281,LAD,STL,2024 REG,7,6,6,3,9,13,1,0,3,-3,1,1,1,0,0,0,0,0,0,0.5031902949311281,0.4968097050688719
93467,0.7014925373134329,0.3424657534246575,-235,192,0.6706561244076082,0.32934387559239175,home,LAD,under,8.5,0.5192307692307692,-108,0.4968097050688719,LAD,STL,2024 REG,7,6,6,3,9,13,1,0,3,-3,1,1,1,0,0,0,0,0,0,0.5031902949311281,0.4968097050688719
93478,0.5867768595041323,0.45454545454545453,-142,120,0.5625298818386723,0.43747011816132775,away,MIA,over,9,0.5260663507109005,-111,0.5022370601254724,STL,MIA,2024 REG,5,3,13,10,13,18,0,1,-7,7,1,1,1,0,0,0,0,0,0,0.5022370601254724,0.4977629398745276
93478,0.5867768595041323,0.45454545454545453,-142,120,0.5625298818386723,0.43747011816132775,home,STL,under,9,0.5192307692307692,-108,0.4977629398745276,STL,MIA,2024 REG,5,3,13,10,13,18,0,1,-7,7,1,1,1,0,0,0,0,0,0,0.5022370601254724,0.4977629398745276
93491,0.647887323943662,0.4,-184,150,0.6168617337829796,0.3831382662170204,away,WSH,over,10.5,0.5238095238095238,-110,0.4988662131519274,CIN,WSH,2024 REG,10,6,11,7,13,21,0,1,-1,1,1,1,1,1,1,1,0,0,0,0.4988662131519274,0.5011337868480725
93491,0.647887323943662,0.4,-184,150,0.6168617337829796,0.3831382662170204,home,CIN,under,10.5,0.5238095238095238,-110,0.5011337868480725,CIN,WSH,2024 REG,10,6,11,7,13,21,0,1,-1,1,1,1,1,1,1,1,0,0,0,0.4988662131519274,0.5011337868480725
93504,0.7142857142857143,0.3278688524590164,-250,205,0.6841753094680495,0.3158246905319505,away,CWS,over,8.5,0.5475113122171946,-121,0.5214983313199976,CLE,CWS,2024 REG,8,5,12,7,12,20,0,1,-2,2,1,1,1,1,1,0,0,0,0,0.5214983313199976,0.47850166868000243
93504,0.7142857142857143,0.3278688524590164,-250,205,0.6841753094680495,0.3158246905319505,home,CLE,under,8.5,0.5,100,0.47850166868000243,CLE,CWS,2024 REG,8,5,12,7,12,20,0,1,-2,2,1,1,1,1,1,0,0,0,0,0.5214983313199976,0.47850166868000243
93507,0.7101449275362319,0.3333333333333333,-245,200,0.6792690611216132,0.3207309388783868,away,SF,over,8.5,0.5121951219512195,-105,0.48808156828023186,LAD,SF,2024 REG,9,5,5,4,9,14,1,0,1,-1,1,1,1,1,0,0,0,0,0,0.48808156828023186,0.5119184317197681
93507,0.7101449275362319,0.3333333333333333,-245,200,0.6792690611216132,0.3207309388783868,home,LAD,under,8.5,0.5348837209302326,-115,0.5119184317197681,LAD,SF,2024 REG,9,5,5,4,9,14,1,0,1,-1,1,1,1,1,0,0,0,0,0,0.48808156828023186,0.5119184317197681
93510,0.6875,0.35714285714285715,-220,180,0.6568080357142857,0.3431919642857143,away,COL,over,7,0.5454545454545454,-120,0.5206611570247933,CHC,COL,2024 REG,10,9,11,8,17,21,1,0,1,-1,1,1,1,1,1,1,1,1,0,0.5206611570247933,0.4793388429752067
93510,0.6875,0.35714285714285715,-220,180,0.6568080357142857,0.3431919642857143,home,CHC,under,7,0.5,100,0.4793388429752067,CHC,COL,2024 REG,10,9,11,8,17,21,1,0,1,-1,1,1,1,1,1,1,1,1,0,0.5206611570247933,0.4793388429752067
93531,0.7297297297297298,0.3125,-270,220,0.6989134404674946,0.3010865595325054,away,COL,over,8.5,0.5348837209302326,-115,0.5097020142727117,PHI,COL,2024 REG,6,2,5,1,3,11,1,0,1,-1,1,0,0,0,0,0,0,0,0,0.5097020142727117,0.49029798572728833
93531,0.7297297297297298,0.3125,-270,220,0.6989134404674946,0.3010865595325054,home,PHI,under,8.5,0.5121951219512195,-105,0.49029798572728833,PHI,COL,2024 REG,6,2,5,1,3,11,1,0,1,-1,1,0,0,0,0,0,0,0,0,0.5097020142727117,0.49029798572728833
93554,0.5121951219512195,0.5348837209302326,-105,-115,0.48808156828023186,0.5119184317197681,away,LAA,over,10.5,0.5121951219512195,-105,0.48808156828023186,BOS,LAA,2024 REG,11,7,8,2,9,19,1,0,5,-5,1,1,0,0,0,0,0,0,0,0.48808156828023186,0.5119184317197681
93554,0.5121951219512195,0.5348837209302326,-105,-115,0.48808156828023186,0.5119184317197681,home,BOS,under,10.5,0.5348837209302326,-115,0.5119184317197681,BOS,LAA,2024 REG,11,7,8,2,9,19,1,0,5,-5,1,1,0,0,0,0,0,0,0,0.48808156828023186,0.5119184317197681
93556,0.5833333333333333,0.4587155963302753,-140,118,0.5588047910295616,0.4411952089704384,away,MIL,over,8,0.5238095238095238,-110,0.4988662131519274,NYM,MIL,2024 REG,7,1,9,4,5,16,0,1,-3,3,1,0,0,0,0,0,0,0,0,0.4988662131519274,0.5011337868480725
93556,0.5833333333333333,0.4587155963302753,-140,118,0.5588047910295616,0.4411952089704384,home,NYM,under,8,0.5238095238095238,-110,0.5011337868480725,NYM,MIL,2024 REG,7,1,9,4,5,16,0,1,-3,3,1,0,0,0,0,0,0,0,0,0.4988662131519274,0.5011337868480725
93565,0.6774193548387096,0.36363636363636365,-210,175,0.6496074165168858,0.3503925834831142,away,SF,over,8.5,0.5238095238095238,-110,0.4988662131519274,LAD,SF,2024 REG,9,8,8,3,11,17,1,0,5,-5,1,1,1,0,0,0,0,0,0,0.4988662131519274,0.5011337868480725
93565,0.6774193548387096,0.36363636363636365,-210,175,0.6496074165168858,0.3503925834831142,home,LAD,under,8.5,0.5238095238095238,-110,0.5011337868480725,LAD,SF,2024 REG,9,8,8,3,11,17,1,0,5,-5,1,1,1,0,0,0,0,0,0,0.4988662131519274,0.5011337868480725
93566,0.5283018867924528,0.5121951219512195,-112,-105,0.5069072406637203,0.4930927593362797,away,NYY,over,8.5,0.5348837209302326,-115,0.5097020142727117,TOR,NYY,2024 REG,4,3,4,1,4,8,1,0,2,-2,1,0,0,0,0,0,0,0,0,0.5097020142727117,0.49029798572728833
93566,0.5283018867924528,0.5121951219512195,-112,-105,0.5069072406637203,0.4930927593362797,home,TOR,under,8.5,0.5121951219512195,-105,0.49029798572728833,TOR,NYY,2024 REG,4,3,4,1,4,8,1,0,2,-2,1,0,0,0,0,0,0,0,0,0.5097020142727117,0.49029798572728833
93571,0.5652173913043479,0.47619047619047616,-130,110,0.5418129444594474,0.4581870555405526,away,DET,over,8,0.5121951219512195,-105,0.48808156828023186,PIT,DET,2024 REG,12,7,9,4,11,21,1,0,3,-3,1,1,1,1,0,0,0,0,0,0.48808156828023186,0.5119184317197681
93571,0.5652173913043479,0.47619047619047616,-130,110,0.5418129444594474,0.4581870555405526,home,PIT,under,8,0.5348837209302326,-115,0.5119184317197681,PIT,DET,2024 REG,12,7,9,4,11,21,1,0,3,-3,1,1,1,1,0,0,0,0,0,0.48808156828023186,0.5119184317197681
93593,0.6666666666666666,0.37735849056603776,-200,165,0.6373165618448637,0.36268343815513626,away,SD,over,8.5,0.5,100,0.47522522522522526,LAD,SD,2024 REG,7,7,10,8,15,17,0,1,-1,1,1,1,1,1,1,1,1,0,0,0.47522522522522526,0.5247747747747747
93593,0.6666666666666666,0.37735849056603776,-200,165,0.6373165618448637,0.36268343815513626,home,LAD,under,8.5,0.5495495495495495,-122,0.5247747747747747,LAD,SD,2024 REG,7,7,10,8,15,17,0,1,-1,1,1,1,1,1,1,1,1,0,0,0.47522522522522526,0.5247747747747747
93594,0.6363636363636364,0.4081632653061224,-175,145,0.6080283353010626,0.3919716646989374,away,CLE,over,8,0.5348837209302326,-115,0.5097020142727117,MIN,CLE,2024 REG,2,1,7,3,4,9,0,1,-2,2,1,0,0,0,0,0,0,0,0,0.5097020142727117,0.49029798572728833
93594,0.6363636363636364,0.4081632653061224,-175,145,0.6080283353010626,0.3919716646989374,home,MIN,under,8,0.5121951219512195,-105,0.49029798572728833,MIN,CLE,2024 REG,2,1,7,3,4,9,0,1,-2,2,1,0,0,0,0,0,0,0,0,0.5097020142727117,0.49029798572728833
93600,0.48780487804878053,0.5555555555555556,105,-125,0.4666534470222751,0.5333465529777248,away,MIN,over,8.5,0.5192307692307692,-108,0.49340049170764233,KC,MIN,2024 REG,5,1,10,4,5,15,0,1,-3,3,1,0,0,0,0,0,0,0,0,0.49340049170764233,0.5065995082923577
93600,0.48780487804878053,0.5555555555555556,105,-125,0.4666534470222751,0.5333465529777248,home,KC,under,8.5,0.5305164319248826,-113,0.5065995082923577,KC,MIN,2024 REG,5,1,10,4,5,15,0,1,-3,3,1,0,0,0,0,0,0,0,0,0.49340049170764233,0.5065995082923577
93606,0.6226415094339623,0.4166666666666667,-165,140,0.5981666073335706,0.40183339266642937,away,LAA,over,8.5,0.5169082125603864,-107,0.49239402434819424,TB,LAA,2024 REG,6,3,13,7,10,19,0,1,-4,4,1,1,1,0,0,0,0,0,0,0.49239402434819424,0.5076059756518058
93606,0.6226415094339623,0.4166666666666667,-165,140,0.5981666073335706,0.40183339266642937,home,TB,under,8.5,0.5305164319248826,-113,0.5076059756518058,TB,LAA,2024 REG,6,3,13,7,10,19,0,1,-4,4,1,1,1,0,0,0,0,0,0,0.49239402434819424,0.5076059756518058
93616,0.6240601503759399,0.4166666666666667,-166,140,0.5986441668079975,0.4013558331920025,away,CLE,over,7,0.5412844036697247,-118,0.5136310900085983,MIN,CLE,2024 REG,7,2,7,4,6,14,0,1,-2,2,1,1,0,0,0,0,0,0,0,0.5136310900085983,0.4863689099914017
93616,0.6240601503759399,0.4166666666666667,-166,140,0.5986441668079975,0.4013558331920025,home,MIN,under,7,0.5098039215686274,-104,0.4863689099914017,MIN,CLE,2024 REG,7,2,7,4,6,14,0,1,-2,2,1,1,0,0,0,0,0,0,0,0.5136310900085983,0.4863689099914017
93622,0.576271186440678,0.4629629629629629,-136,116,0.553661676614851,0.446338323385149,away,CHC,over,7.5,0.5283018867924528,-112,0.5019750255927206,SD,CHC,2024 REG,8,9,8,8,17,16,1,0,1,-1,1,1,1,1,1,1,1,1,0,0.5019750255927206,0.49802497440727944
93622,0.576271186440678,0.4629629629629629,-136,116,0.553661676614851,0.446338323385149,home,SD,under,7.5,0.5215311004784688,-109,0.49802497440727944,SD,CHC,2024 REG,8,9,8,8,17,16,1,0,1,-1,1,1,1,1,1,1,1,1,0,0.5019750255927206,0.49802497440727944
93624,0.5652173913043479,0.47619047619047616,-130,110,0.5418129444594474,0.4581870555405526,away,MIL,over,7.5,0.5238095238095238,-110,0.4988662131519274,NYM,MIL,2024 REG,12,6,16,7,13,28,0,1,-1,1,1,1,1,1,1,1,0,0,0,0.4988662131519274,0.5011337868480725
93624,0.5652173913043479,0.47619047619047616,-130,110,0.5418129444594474,0.4581870555405526,home,NYM,under,7.5,0.5238095238095238,-110,0.5011337868480725,NYM,MIL,2024 REG,12,6,16,7,13,28,0,1,-1,1,1,1,1,1,1,1,0,0,0,0.4988662131519274,0.5011337868480725
93627,0.5495495495495495,0.48780487804878053,-122,105,0.529021440689206,0.470978559310794,away,STL,over,9.5,0.5121951219512195,-105,0.48808156828023186,ARI,STL,2024 REG,9,6,14,9,15,23,0,1,-3,3,1,1,1,1,1,1,0,0,0,0.48808156828023186,0.5119184317197681
93627,0.5495495495495495,0.48780487804878053,-122,105,0.529021440689206,0.470978559310794,home,ARI,under,9.5,0.5348837209302326,-115,0.5119184317197681,ARI,STL,2024 REG,9,6,14,9,15,23,0,1,-3,3,1,1,1,1,1,1,0,0,0,0.48808156828023186,0.5119184317197681
93629,0.45454545454545453,0.5833333333333333,120,-140,0.43732782369146006,0.5626721763085399,away,BAL,over,8.5,0.5454545454545454,-120,0.5206611570247933,PIT,BAL,2024 REG,11,5,4,4,9,15,1,0,1,-1,1,1,1,1,0,0,0,0,0,0.5206611570247933,0.4793388429752067
93629,0.45454545454545453,0.5833333333333333,120,-140,0.43732782369146006,0.5626721763085399,home,PIT,under,8.5,0.5,100,0.4793388429752067,PIT,BAL,2024 REG,11,5,4,4,9,15,1,0,1,-1,1,1,1,1,0,0,0,0,0,0.5206611570247933,0.4793388429752067
93646,0.5652173913043479,0.47619047619047616,-130,110,0.5418129444594474,0.4581870555405526,away,LAA,over,10,0.5348837209302326,-115,0.5097020142727117,BOS,LAA,2024 REG,7,5,9,4,9,16,1,0,1,-1,1,1,1,1,0,0,0,0,0,0.5097020142727117,0.49029798572728833
93646,0.5652173913043479,0.47619047619047616,-130,110,0.5418129444594474,0.4581870555405526,home,BOS,under,10,0.5121951219512195,-105,0.49029798572728833,BOS,LAA,2024 REG,7,5,9,4,9,16,1,0,1,-1,1,1,1,1,0,0,0,0,0,0.5097020142727117,0.49029798572728833
93648,0.5215311004784688,0.5238095238095238,-109,-110,0.4978845547971712,0.5021154452028288,away,PIT,over,8.5,0.5121951219512195,-105,0.48808156828023186,WSH,PIT,2024 REG,8,4,15,8,12,23,0,1,-4,4,1,1,1,1,0,0,0,0,0,0.48808156828023186,0.5119184317197681
93648,0.5215311004784688,0.5238095238095238,-109,-110,0.4978845547971712,0.5021154452028288,home,WSH,under,8.5,0.5348837209302326,-115,0.5119184317197681,WSH,PIT,2024 REG,8,4,15,8,12,23,0,1,-4,4,1,1,1,1,0,0,0,0,0,0.48808156828023186,0.5119184317197681
93652,0.5633187772925764,0.47619047619047616,-129,110,0.5410624729287608,0.45893752707123925,away,TOR,over,8,0.5098039215686274,-104,0.48592421718142587,TB,TOR,2024 REG,10,8,6,2,10,16,1,0,6,-6,1,1,0,0,0,0,0,0,0,0.48592421718142587,0.5140757828185741
93652,0.5633187772925764,0.47619047619047616,-129,110,0.5410624729287608,0.45893752707123925,home,TB,under,8,0.5370370370370371,-116,0.5140757828185741,TB,TOR,2024 REG,10,8,6,2,10,16,1,0,6,-6,1,1,0,0,0,0,0,0,0,0.48592421718142587,0.5140757828185741
93653,0.49504950495049505,0.5495495495495495,102,-122,0.47297076509898783,0.5270292349010122,away,MIN,over,8,0.5238095238095238,-110,0.4988662131519274,KC,MIN,2024 REG,5,1,7,5,6,12,0,1,-4,4,1,0,0,0,0,0,0,0,0,0.4988662131519274,0.5011337868480725
93653,0.49504950495049505,0.5495495495495495,102,-122,0.47297076509898783,0.5270292349010122,home,KC,under,8,0.5238095238095238,-110,0.5011337868480725,KC,MIN,2024 REG,5,1,7,5,6,12,0,1,-4,4,1,0,0,0,0,0,0,0,0,0.4988662131519274,0.5011337868480725
93655,0.4347826086956522,0.607843137254902,130,-155,0.41624967567367205,0.583750324326328,away,CIN,over,9,0.5348837209302326,-115,0.5097020142727117,CWS,CIN,2024 REG,8,4,11,11,15,19,0,1,-7,7,1,1,1,1,0,0,0,0,0,0.5097020142727117,0.49029798572728833
93655,0.4347826086956522,0.607843137254902,130,-155,0.41624967567367205,0.583750324326328,home,CWS,under,9,0.5121951219512195,-105,0.49029798572728833,CWS,CIN,2024 REG,8,4,11,11,15,19,0,1,-7,7,1,1,1,1,0,0,0,0,0,0.5097020142727117,0.49029798572728833
93663,0.5283018867924528,0.5145631067961165,-112,-106,0.5056562298022652,0.4943437701977348,away,LAA,over,9,0.5,100,0.4772727272727273,MIA,LAA,2024 REG,9,4,7,7,11,16,0,1,-3,3,1,1,1,1,0,0,0,0,0,0.4772727272727273,0.5227272727272727
93663,0.5283018867924528,0.5145631067961165,-112,-106,0.5056562298022652,0.4943437701977348,home,MIA,under,9,0.5454545454545454,-120,0.5227272727272727,MIA,LAA,2024 REG,9,4,7,7,11,16,0,1,-3,3,1,1,1,1,0,0,0,0,0,0.4772727272727273,0.5227272727272727
93664,0.6226415094339623,0.4166666666666667,-165,140,0.5981666073335706,0.40183339266642937,away,KC,over,8.5,0.5121951219512195,-105,0.48808156828023186,NYM,KC,2024 REG,9,7,13,11,18,22,0,1,-4,4,1,1,1,1,1,1,1,0,0,0.48808156828023186,0.5119184317197681
93664,0.6226415094339623,0.4166666666666667,-165,140,0.5981666073335706,0.40183339266642937,home,NYM,under,8.5,0.5348837209302326,-115,0.5119184317197681,NYM,KC,2024 REG,9,7,13,11,18,22,0,1,-4,4,1,1,1,1,1,1,1,0,0,0.48808156828023186,0.5119184317197681
93665,0.6226415094339623,0.4166666666666667,-165,140,0.5981666073335706,0.40183339266642937,away,SD,over,8.5,0.5238095238095238,-110,0.4988662131519274,LAD,SD,2024 REG,6,3,8,6,9,14,0,1,-3,3,1,1,1,0,0,0,0,0,0,0.4988662131519274,0.5011337868480725
93665,0.6226415094339623,0.4166666666666667,-165,140,0.5981666073335706,0.40183339266642937,home,LAD,under,8.5,0.5238095238095238,-110,0.5011337868480725,LAD,SD,2024 REG,6,3,8,6,9,14,0,1,-3,3,1,1,1,0,0,0,0,0,0,0.4988662131519274,0.5011337868480725
93674,0.6551724137931035,0.3921568627450981,-190,155,0.6241635774404887,0.37583642255951133,away,WSH,over,8.5,0.5121951219512195,-105,0.48808156828023186,SF,WSH,2024 REG,10,3,8,5,8,18,0,1,-2,2,1,1,1,0,0,0,0,0,0,0.48808156828023186,0.5119184317197681
93674,0.6551724137931035,0.3921568627450981,-190,155,0.6241635774404887,0.37583642255951133,home,SF,under,8.5,0.5348837209302326,-115,0.5119184317197681,SF,WSH,2024 REG,10,3,8,5,8,18,0,1,-2,2,1,1,1,0,0,0,0,0,0,0.48808156828023186,0.5119184317197681
93678,0.49504950495049505,0.5454545454545454,102,-120,0.47499799484898986,0.5250020051510101,away,CLE,over,8.5,0.5238095238095238,-110,0.4988662131519274,OAK,CLE,2024 REG,9,4,7,3,7,16,1,0,1,-1,1,1,1,0,0,0,0,0,0,0.4988662131519274,0.5011337868480725
93678,0.49504950495049505,0.5454545454545454,102,-120,0.47499799484898986,0.5250020051510101,home,OAK,under,8.5,0.5238095238095238,-110,0.5011337868480725,OAK,CLE,2024 REG,9,4,7,3,7,16,1,0,1,-1,1,1,1,0,0,0,0,0,0,0.4988662131519274,0.5011337868480725
93680,0.5238095238095238,0.5238095238095238,-110,-110,0.4988662131519274,0.5011337868480725,away,MIL,over,9.5,0.5121951219512195,-105,0.48808156828023186,CIN,MIL,2024 REG,10,10,12,8,18,22,1,0,2,-2,1,1,1,1,1,1,1,1,0,0.48808156828023186,0.5119184317197681
93680,0.5238095238095238,0.5238095238095238,-110,-110,0.4988662131519274,0.5011337868480725,home,CIN,under,9.5,0.5348837209302326,-115,0.5119184317197681,CIN,MIL,2024 REG,10,10,12,8,18,22,1,0,2,-2,1,1,1,1,1,1,1,1,0,0.48808156828023186,0.5119184317197681
93699,0.5850622406639003,0.45454545454545453,-141,120,0.5618892737571823,0.43811072624281766,away,MIL,over,8.5,0.5121951219512195,-105,0.48808156828023186,CIN,MIL,2024 REG,4,2,6,7,9,10,0,1,-5,5,1,1,0,0,0,0,0,0,0,0.48808156828023186,0.5119184317197681
93699,0.5850622406639003,0.45454545454545453,-141,120,0.5618892737571823,0.43811072624281766,home,CIN,under,8.5,0.5348837209302326,-115,0.5119184317197681,CIN,MIL,2024 REG,4,2,6,7,9,10,0,1,-5,5,1,1,0,0,0,0,0,0,0,0.48808156828023186,0.5119184317197681
93710,0.5726495726495727,0.4672897196261683,-134,114,0.5497783539959433,0.4502216460040567,away,MIL,over,9.5,0.5121951219512195,-105,0.48808156828023186,CIN,MIL,2024 REG,10,5,13,9,14,23,0,1,-4,4,1,1,1,1,1,0,0,0,0,0.48808156828023186,0.5119184317197681
93710,0.5726495726495727,0.4672897196261683,-134,114,0.5497783539959433,0.4502216460040567,home,CIN,under,9.5,0.5348837209302326,-115,0.5119184317197681,CIN,MIL,2024 REG,10,5,13,9,14,23,0,1,-4,4,1,1,1,1,1,0,0,0,0,0.48808156828023186,0.5119184317197681
93714,0.49019607843137253,0.5495495495495495,104,-122,0.4707129274603323,0.5292870725396677,away,TB,over,8.5,0.5121951219512195,-105,0.48808156828023186,LAA,TB,2024 REG,7,4,12,6,10,19,0,1,-2,2,1,1,1,1,0,0,0,0,0,0.48808156828023186,0.5119184317197681
93714,0.49019607843137253,0.5495495495495495,104,-122,0.4707129274603323,0.5292870725396677,home,LAA,under,8.5,0.5348837209302326,-115,0.5119184317197681,LAA,TB,2024 REG,7,4,12,6,10,19,0,1,-2,2,1,1,1,1,0,0,0,0,0,0.48808156828023186,0.5119184317197681
93722,0.6923076923076923,0.3508771929824561,-225,185,0.6624104640298972,0.33758953597010277,away,MIL,over,8.5,0.5454545454545454,-120,0.5206611570247933,BAL,MIL,2024 REG,11,6,12,4,10,23,1,0,2,-2,1,1,1,1,0,0,0,0,0,0.5206611570247933,0.4793388429752067
93722,0.6923076923076923,0.3508771929824561,-225,185,0.6624104640298972,0.33758953597010277,home,BAL,under,8.5,0.5,100,0.4793388429752067,BAL,MIL,2024 REG,11,6,12,4,10,23,1,0,2,-2,1,1,1,1,0,0,0,0,0,0.5206611570247933,0.4793388429752067
93746,0.6389891696750902,0.4,-177,150,0.614075512518083,0.385924487481917,away,LAA,over,8.5,0.5238095238095238,-110,0.4988662131519274,BAL,LAA,2024 REG,14,13,10,4,17,24,1,0,9,-9,1,1,1,1,0,0,0,0,0,0.4988662131519274,0.5011337868480725
93746,0.6389891696750902,0.4,-177,150,0.614075512518083,0.385924487481917,home,BAL,under,8.5,0.5238095238095238,-110,0.5011337868480725,BAL,LAA,2024 REG,14,13,10,4,17,24,1,0,9,-9,1,1,1,1,0,0,0,0,0,0.4988662131519274,0.5011337868480725
93750,0.7142857142857143,0.3278688524590164,-250,205,0.6841753094680495,0.3158246905319505,away,COL,over,9,0.5391705069124424,-117,0.5127649394825569,ARI,COL,2024 REG,14,7,7,3,10,21,1,0,4,-4,1,1,1,0,0,0,0,0,0,0.5127649394825569,0.48723506051744314
93750,0.7142857142857143,0.3278688524590164,-250,205,0.6841753094680495,0.3158246905319505,home,ARI,under,9,0.5098039215686274,-104,0.48723506051744314,ARI,COL,2024 REG,14,7,7,3,10,21,1,0,4,-4,1,1,1,0,0,0,0,0,0,0.5127649394825569,0.48723506051744314
93754,0.4,0.6428571428571428,150,-180,0.38285714285714295,0.617142857142857,away,ARI,over,10.5,0.5238095238095238,-110,0.4988662131519274,COL,ARI,2024 REG,13,7,7,5,12,20,1,0,2,-2,1,1,1,1,1,0,0,0,0,0.4988662131519274,0.5011337868480725
93754,0.4,0.6428571428571428,150,-180,0.38285714285714295,0.617142857142857,home,COL,under,10.5,0.5238095238095238,-110,0.5011337868480725,COL,ARI,2024 REG,13,7,7,5,12,20,1,0,2,-2,1,1,1,1,1,0,0,0,0,0.4988662131519274,0.5011337868480725
93761,0.6721311475409836,0.37037037037037035,-205,170,0.6435645535349916,0.35643544646500835,away,WSH,over,8.5,0.5121951219512195,-105,0.48808156828023186,SF,WSH,2024 REG,12,7,4,1,8,16,1,0,6,-6,1,0,0,0,0,0,0,0,0,0.48808156828023186,0.5119184317197681
93761,0.6721311475409836,0.37037037037037035,-205,170,0.6435645535349916,0.35643544646500835,home,SF,under,8.5,0.5348837209302326,-115,0.5119184317197681,SF,WSH,2024 REG,12,7,4,1,8,16,1,0,6,-6,1,0,0,0,0,0,0,0,0,0.48808156828023186,0.5119184317197681
93771,0.5967741935483871,0.4444444444444444,-148,125,0.5721759741010521,0.42782402589894786,away,SF,over,8.5,0.5098039215686274,-104,0.48483656587239576,LAD,SF,2024 REG,9,5,9,4,9,18,1,0,1,-1,1,1,1,1,0,0,0,0,0,0.48483656587239576,0.5151634341276042
93771,0.5967741935483871,0.4444444444444444,-148,125,0.5721759741010521,0.42782402589894786,home,LAD,under,8.5,0.5391705069124424,-117,0.5151634341276042,LAD,SF,2024 REG,9,5,9,4,9,18,1,0,1,-1,1,1,1,1,0,0,0,0,0,0.48483656587239576,0.5151634341276042
93774,0.4444444444444444,0.6000000000000001,125,-150,0.4246913580246913,0.5753086419753086,away,DET,over,7.5,0.5454545454545454,-120,0.5179608869977906,CWS,DET,2024 REG,5,2,8,3,5,13,0,1,-1,1,1,1,0,0,0,0,0,0,0,0.5179608869977906,0.48203911300220936
93774,0.4444444444444444,0.6000000000000001,125,-150,0.4246913580246913,0.5753086419753086,home,CWS,under,7.5,0.504950495049505,-102,0.48203911300220936,CWS,DET,2024 REG,5,2,8,3,5,13,0,1,-1,1,1,1,0,0,0,0,0,0,0,0.5179608869977906,0.48203911300220936
93783,0.576271186440678,0.4629629629629629,-136,116,0.553661676614851,0.446338323385149,away,TEX,over,9,0.5260663507109005,-111,0.5010269332605688,HOU,TEX,2024 REG,14,9,8,2,11,22,1,0,7,-7,1,1,0,0,0,0,0,0,0,0.5010269332605688,0.4989730667394312
93783,0.576271186440678,0.4629629629629629,-136,116,0.553661676614851,0.446338323385149,home,HOU,under,9,0.5215311004784688,-109,0.4989730667394312,HOU,TEX,2024 REG,14,9,8,2,11,22,1,0,7,-7,1,1,0,0,0,0,0,0,0,0.5010269332605688,0.4989730667394312
93789,0.6666666666666666,0.37037037037037035,-200,170,0.6419753086419753,0.3580246913580247,away,OAK,over,9.5,0.5121951219512195,-105,0.48808156828023186,TEX,OAK,2024 REG,1,0,4,1,1,5,0,1,-1,1,0,0,0,0,0,0,0,0,0,0.48808156828023186,0.5119184317197681
93789,0.6666666666666666,0.37037037037037035,-200,170,0.6419753086419753,0.3580246913580247,home,TEX,under,9.5,0.5348837209302326,-115,0.5119184317197681,TEX,OAK,2024 REG,1,0,4,1,1,5,0,1,-1,1,0,0,0,0,0,0,0,0,0,0.48808156828023186,0.5119184317197681
93796,0.6226415094339623,0.4166666666666667,-165,140,0.5981666073335706,0.40183339266642937,away,KC,over,8.5,0.5215311004784688,-109,0.49670754937970685,BAL,KC,2024 REG,3,1,8,4,5,11,0,1,-3,3,1,0,0,0,0,0,0,0,0,0.49670754937970685,0.5032924506202932
93796,0.6226415094339623,0.4166666666666667,-165,140,0.5981666073335706,0.40183339266642937,home,BAL,under,8.5,0.5260663507109005,-111,0.5032924506202932,BAL,KC,2024 REG,3,1,8,4,5,11,0,1,-3,3,1,0,0,0,0,0,0,0,0,0.49670754937970685,0.5032924506202932
93825,0.7619047619047619,0.28169014084507044,-320,255,0.7286895979048896,0.27131040209511037,away,ARI,over,9,0.5238095238095238,-110,0.4988662131519274,ATL,ARI,2024 REG,12,6,9,5,11,21,1,0,1,-1,1,1,1,1,1,0,0,0,0,0.4988662131519274,0.5011337868480725
93825,0.7619047619047619,0.28169014084507044,-320,255,0.7286895979048896,0.27131040209511037,home,ATL,under,9,0.5238095238095238,-110,0.5011337868480725,ATL,ARI,2024 REG,12,6,9,5,11,21,1,0,1,-1,1,1,1,1,1,0,0,0,0,0.4988662131519274,0.5011337868480725
93832,0.5121951219512195,0.5348837209302326,-105,-115,0.48808156828023186,0.5119184317197681,away,LAD,over,8.5,0.5238095238095238,-110,0.4988662131519274,CHC,LAD,2024 REG,7,8,4,1,9,11,1,0,7,-7,1,0,0,0,0,0,0,0,0,0.4988662131519274,0.5011337868480725
93832,0.5121951219512195,0.5348837209302326,-105,-115,0.48808156828023186,0.5119184317197681,home,CHC,under,8.5,0.5238095238095238,-110,0.5011337868480725,CHC,LAD,2024 REG,7,8,4,1,9,11,1,0,7,-7,1,0,0,0,0,0,0,0,0,0.4988662131519274,0.5011337868480725
93835,0.5,0.5454545454545454,100,-120,0.4772727272727273,0.5227272727272727,away,TB,over,9,0.5391705069124424,-117,0.5140669063204599,LAA,TB,2024 REG,9,2,7,4,6,16,0,1,-2,2,1,1,0,0,0,0,0,0,0,0.5140669063204599,0.4859330936795401
93835,0.5,0.5454545454545454,100,-120,0.4772727272727273,0.5227272727272727,home,LAA,under,9,0.5073891625615764,-103,0.4859330936795401,LAA,TB,2024 REG,9,2,7,4,6,16,0,1,-2,2,1,1,0,0,0,0,0,0,0,0.5140669063204599,0.4859330936795401
93874,0.5454545454545454,0.5,-120,100,0.5206611570247933,0.4793388429752067,away,BOS,over,8,0.5238095238095238,-110,0.4988662131519274,LAA,BOS,2024 REG,6,2,3,1,3,9,1,0,1,-1,1,0,0,0,0,0,0,0,0,0.4988662131519274,0.5011337868480725
93874,0.5454545454545454,0.5,-120,100,0.5206611570247933,0.4793388429752067,home,LAA,under,8,0.5238095238095238,-110,0.5011337868480725,LAA,BOS,2024 REG,6,2,3,1,3,9,1,0,1,-1,1,0,0,0,0,0,0,0,0,0.4988662131519274,0.5011337868480725
93895,0.6226415094339623,0.4166666666666667,-165,140,0.5981666073335706,0.40183339266642937,away,NYM,over,9.5,0.5412844036697247,-118,0.5136310900085983,ATL,NYM,2024 REG,10,4,16,16,20,26,0,1,-12,12,1,1,1,1,0,0,0,0,0,0.5136310900085983,0.4863689099914017
93895,0.6226415094339623,0.4166666666666667,-165,140,0.5981666073335706,0.40183339266642937,home,ATL,under,9.5,0.5098039215686274,-104,0.4863689099914017,ATL,NYM,2024 REG,10,4,16,16,20,26,0,1,-12,12,1,1,1,1,0,0,0,0,0,0.5136310900085983,0.4863689099914017
93912,0.5073891625615764,0.5348837209302326,-103,-115,0.4859403596076043,0.5140596403923957,away,BAL,over,8.5,0.5348837209302326,-115,0.5097020142727117,PIT,BAL,2024 REG,7,3,6,2,5,13,1,0,1,-1,1,1,0,0,0,0,0,0,0,0.5097020142727117,0.49029798572728833
93912,0.5073891625615764,0.5348837209302326,-103,-115,0.4859403596076043,0.5140596403923957,home,PIT,under,8.5,0.5121951219512195,-105,0.49029798572728833,PIT,BAL,2024 REG,7,3,6,2,5,13,1,0,1,-1,1,1,0,0,0,0,0,0,0,0.5097020142727117,0.49029798572728833
93913,0.425531914893617,0.6153846153846154,135,-160,0.4081206254135181,0.5918793745864819,away,DET,over,7.5,0.5454545454545454,-120,0.5206611570247933,CWS,DET,2024 REG,3,0,6,1,1,9,0,1,-1,1,0,0,0,0,0,0,0,0,0,0.5206611570247933,0.4793388429752067
93913,0.425531914893617,0.6153846153846154,135,-160,0.4081206254135181,0.5918793745864819,home,CWS,under,7.5,0.5,100,0.4793388429752067,CWS,DET,2024 REG,3,0,6,1,1,9,0,1,-1,1,0,0,0,0,0,0,0,0,0,0.5206611570247933,0.4793388429752067
93917,0.5348837209302326,0.5098039215686274,-115,-104,0.5109810284308424,0.48901897156915763,away,BAL,over,9,0.5283018867924528,-112,0.5031902949311281,BOS,BAL,2024 REG,8,5,9,7,12,17,0,1,-2,2,1,1,1,1,1,0,0,0,0,0.5031902949311281,0.4968097050688719
93917,0.5348837209302326,0.5098039215686274,-115,-104,0.5109810284308424,0.48901897156915763,home,BOS,under,9,0.5192307692307692,-108,0.4968097050688719,BOS,BAL,2024 REG,8,5,9,7,12,17,0,1,-2,2,1,1,1,1,1,0,0,0,0,0.5031902949311281,0.4968097050688719
93923,0.4444444444444444,0.6000000000000001,125,-150,0.4246913580246913,0.5753086419753086,away,PIT,over,8.5,0.5215311004784688,-109,0.4978845547971712,WSH,PIT,2024 REG,10,5,4,3,8,14,1,0,2,-2,1,1,1,0,0,0,0,0,0,0.4978845547971712,0.5021154452028288
93923,0.4444444444444444,0.6000000000000001,125,-150,0.4246913580246913,0.5753086419753086,home,WSH,under,8.5,0.5238095238095238,-110,0.5021154452028288,WSH,PIT,2024 REG,10,5,4,3,8,14,1,0,2,-2,1,1,1,0,0,0,0,0,0,0.4978845547971712,0.5021154452028288
93931,0.5555555555555556,0.48780487804878053,-125,105,0.5314664257753688,0.46853357422463116,away,DET,over,8.5,0.5145631067961165,-106,0.4891195935000339,PIT,DET,2024 REG,8,3,9,5,8,17,0,1,-2,2,1,1,1,0,0,0,0,0,0,0.4891195935000339,0.5108804064999661
93931,0.5555555555555556,0.48780487804878053,-125,105,0.5314664257753688,0.46853357422463116,home,PIT,under,8.5,0.5348837209302326,-115,0.5108804064999661,PIT,DET,2024 REG,8,3,9,5,8,17,0,1,-2,2,1,1,1,0,0,0,0,0,0,0.4891195935000339,0.5108804064999661
93948,0.5652173913043479,0.47619047619047616,-130,110,0.5418129444594474,0.4581870555405526,away,HOU,over,10,0.5121951219512195,-105,0.48808156828023186,TEX,HOU,2024 REG,8,5,11,10,15,19,0,1,-5,5,1,1,1,1,1,0,0,0,0,0.48808156828023186,0.5119184317197681
93948,0.5652173913043479,0.47619047619047616,-130,110,0.5418129444594474,0.4581870555405526,home,TEX,under,10,0.5348837209302326,-115,0.5119184317197681,TEX,HOU,2024 REG,8,5,11,10,15,19,0,1,-5,5,1,1,1,1,1,0,0,0,0,0.48808156828023186,0.5119184317197681
93949,0.5495495495495495,0.49019607843137253,-122,104,0.5277073575960698,0.4722926424039302,away,STL,over,8,0.5238095238095238,-110,0.4988662131519274,SD,STL,2024 REG,5,2,14,6,8,19,0,1,-4,4,1,1,0,0,0,0,0,0,0,0.4988662131519274,0.5011337868480725
93949,0.5495495495495495,0.49019607843137253,-122,104,0.5277073575960698,0.4722926424039302,home,SD,under,8,0.5238095238095238,-110,0.5011337868480725,SD,STL,2024 REG,5,2,14,6,8,19,0,1,-4,4,1,1,0,0,0,0,0,0,0,0.4988662131519274,0.5011337868480725
93970,0.5652173913043479,0.47619047619047616,-130,110,0.5418129444594474,0.4581870555405526,away,SEA,over,7.5,0.5327102803738317,-114,0.5062779990911175,MIL,SEA,2024 REG,8,6,8,5,11,16,1,0,1,-1,1,1,1,1,1,0,0,0,0,0.5062779990911175,0.4937220009088825
93970,0.5652173913043479,0.47619047619047616,-130,110,0.5418129444594474,0.4581870555405526,home,MIL,under,7.5,0.5169082125603864,-107,0.4937220009088825,MIL,SEA,2024 REG,8,6,8,5,11,16,1,0,1,-1,1,1,1,1,1,0,0,0,0,0.5062779990911175,0.4937220009088825
93981,0.6923076923076923,0.3508771929824561,-225,185,0.6624104640298972,0.33758953597010277,away,COL,over,8.5,0.5192307692307692,-108,0.49340049170764233,ARI,COL,2024 REG,18,16,4,1,17,22,1,0,15,-15,1,0,0,0,0,0,0,0,0,0.49340049170764233,0.5065995082923577
93981,0.6923076923076923,0.3508771929824561,-225,185,0.6624104640298972,0.33758953597010277,home,ARI,under,8.5,0.5305164319248826,-113,0.5065995082923577,ARI,COL,2024 REG,18,16,4,1,17,22,1,0,15,-15,1,0,0,0,0,0,0,0,0,0.49340049170764233,0.5065995082923577
94014,0.49504950495049505,0.5454545454545454,102,-120,0.47499799484898986,0.5250020051510101,away,PIT,over,8.5,0.5192307692307692,-108,0.49455035168025013,WSH,PIT,2024 REG,8,4,11,7,11,19,0,1,-3,3,1,1,1,1,0,0,0,0,0,0.49455035168025013,0.5054496483197499
94014,0.49504950495049505,0.5454545454545454,102,-120,0.47499799484898986,0.5250020051510101,home,WSH,under,8.5,0.5283018867924528,-112,0.5054496483197499,WSH,PIT,2024 REG,8,4,11,7,11,19,0,1,-3,3,1,1,1,1,0,0,0,0,0,0.49455035168025013,0.5054496483197499
94015,0.46511627906976744,0.574468085106383,115,-135,0.44670494689481377,0.5532950531051862,away,NYY,over,8.5,0.5,100,0.4772727272727273,CLE,NYY,2024 REG,5,2,10,3,5,15,0,1,-1,1,1,1,0,0,0,0,0,0,0,0.4772727272727273,0.5227272727272727
94015,0.46511627906976744,0.574468085106383,115,-135,0.44670494689481377,0.5532950531051862,home,CLE,under,8.5,0.5454545454545454,-120,0.5227272727272727,CLE,NYY,2024 REG,5,2,10,3,5,15,0,1,-1,1,1,1,0,0,0,0,0,0,0,0.4772727272727273,0.5227272727272727
94028,0.6108949416342413,0.4273504273504274,-157,134,0.5875310391805721,0.41246896081942785,away,SF,over,8.5,0.5454545454545454,-120,0.5206611570247933,SD,SF,2024 REG,16,13,5,4,17,21,1,0,9,-9,1,1,1,1,0,0,0,0,0,0.5206611570247933,0.4793388429752067
94028,0.6108949416342413,0.4273504273504274,-157,134,0.5875310391805721,0.41246896081942785,home,SD,under,8.5,0.5,100,0.4793388429752067,SD,SF,2024 REG,16,13,5,4,17,21,1,0,9,-9,1,1,1,1,0,0,0,0,0,0.5206611570247933,0.4793388429752067
94034,0.3802281368821293,0.6610169491525424,163,-195,0.3645455946636229,0.6354544053363771,away,LAD,over,8.5,0.5412844036697247,-118,0.5149381613977361,SD,LAD,2024 REG,4,2,7,5,7,11,0,1,-3,3,1,1,0,0,0,0,0,0,0,0.5149381613977361,0.48506183860226393
94034,0.3802281368821293,0.6610169491525424,163,-195,0.3645455946636229,0.6354544053363771,home,SD,under,8.5,0.5073891625615764,-103,0.48506183860226393,SD,LAD,2024 REG,4,2,7,5,7,11,0,1,-3,3,1,1,0,0,0,0,0,0,0,0.5149381613977361,0.48506183860226393
94056,0.4807692307692307,0.5575221238938054,108,-126,0.46235992564277106,0.5376400743572289,away,NYY,over,8.5,0.5433789954337899,-119,0.5184560714286826,CLE,NYY,2024 REG,9,8,12,7,15,21,1,0,1,-1,1,1,1,1,1,1,1,0,0,0.5184560714286826,0.48154392857131745
94056,0.4807692307692307,0.5575221238938054,108,-126,0.46235992564277106,0.5376400743572289,home,CLE,under,8.5,0.5024875621890548,-101,0.48154392857131745,CLE,NYY,2024 REG,9,8,12,7,15,21,1,0,1,-1,1,1,1,1,1,1,1,0,0,0.5184560714286826,0.48154392857131745
94060,0.3921568627450981,0.6491228070175439,155,-185,0.37596875695582666,0.6240312430441733,away,ARI,over,11,0.5238095238095238,-110,0.4988662131519274,COL,ARI,2024 REG,8,2,9,3,5,17,0,1,-1,1,1,1,0,0,0,0,0,0,0,0.4988662131519274,0.5011337868480725
94060,0.3921568627450981,0.6491228070175439,155,-185,0.37596875695582666,0.6240312430441733,home,COL,under,11,0.5238095238095238,-110,0.5011337868480725,COL,ARI,2024 REG,8,2,9,3,5,17,0,1,-1,1,1,1,0,0,0,0,0,0,0,0.4988662131519274,0.5011337868480725
94067,0.6183206106870228,0.42016806722689076,-162,138,0.5945222678547557,0.4054777321452443,away,PIT,over,9,0.5348837209302326,-115,0.5097020142727117,PHI,PIT,2024 REG,7,2,9,5,7,16,0,1,-3,3,1,1,0,0,0,0,0,0,0,0.5097020142727117,0.49029798572728833
94067,0.6183206106870228,0.42016806722689076,-162,138,0.5945222678547557,0.4054777321452443,home,PHI,under,9,0.5121951219512195,-105,0.49029798572728833,PHI,PIT,2024 REG,7,2,9,5,7,16,0,1,-3,3,1,1,0,0,0,0,0,0,0,0.5097020142727117,0.49029798572728833
94073,0.6721311475409836,0.36363636363636365,-205,175,0.6480906892086682,0.3519093107913318,away,OAK,over,7.5,0.5412844036697247,-118,0.5136310900085983,DET,OAK,2024 REG,7,1,14,7,8,21,0,1,-6,6,1,0,0,0,0,0,0,0,0,0.5136310900085983,0.4863689099914017
94073,0.6721311475409836,0.36363636363636365,-205,175,0.6480906892086682,0.3519093107913318,home,DET,under,7.5,0.5098039215686274,-104,0.4863689099914017,DET,OAK,2024 REG,7,1,14,7,8,21,0,1,-6,6,1,0,0,0,0,0,0,0,0,0.5136310900085983,0.4863689099914017
94086,0.5238095238095238,0.5169082125603864,-110,-107,0.5024811857109994,0.4975188142890006,away,HOU,over,10.5,0.5121951219512195,-105,0.48808156828023186,TEX,HOU,2024 REG,2,1,4,3,4,6,0,1,-2,2,1,0,0,0,0,0,0,0,0,0.48808156828023186,0.5119184317197681
94086,0.5238095238095238,0.5169082125603864,-110,-107,0.5024811857109994,0.4975188142890006,home,TEX,under,10.5,0.5348837209302326,-115,0.5119184317197681,TEX,HOU,2024 REG,2,1,4,3,4,6,0,1,-2,2,1,0,0,0,0,0,0,0,0,0.48808156828023186,0.5119184317197681
94089,0.607843137254902,0.43103448275862066,-155,132,0.5842116427368785,0.41578835726312147,away,TEX,over,8.5,0.5169082125603864,-107,0.49239402434819424,TB,TEX,2024 REG,7,5,7,2,7,14,1,0,3,-3,1,1,0,0,0,0,0,0,0,0.49239402434819424,0.5076059756518058
94089,0.607843137254902,0.43103448275862066,-155,132,0.5842116427368785,0.41578835726312147,home,TB,under,8.5,0.5305164319248826,-113,0.5076059756518058,TB,TEX,2024 REG,7,5,7,2,7,14,1,0,3,-3,1,1,0,0,0,0,0,0,0,0.49239402434819424,0.5076059756518058
94101,0.5348837209302326,0.5121951219512195,-115,-105,0.5097020142727117,0.49029798572728833,away,LAA,over,8.5,0.5391705069124424,-117,0.5127649394825569,MIA,LAA,2024 REG,4,2,12,10,12,16,0,1,-8,8,1,1,0,0,0,0,0,0,0,0.5127649394825569,0.48723506051744314
94101,0.5348837209302326,0.5121951219512195,-115,-105,0.5097020142727117,0.49029798572728833,home,MIA,under,8.5,0.5098039215686274,-104,0.48723506051744314,MIA,LAA,2024 REG,4,2,12,10,12,16,0,1,-8,8,1,1,0,0,0,0,0,0,0,0.5127649394825569,0.48723506051744314
94106,0.5370370370370371,0.504950495049505,-116,-102,0.514488177212783,0.48551182278721705,away,LAA,over,9,0.5238095238095238,-110,0.4988662131519274,BOS,LAA,2024 REG,3,0,12,7,7,15,0,1,-7,7,0,0,0,0,0,0,0,0,0,0.4988662131519274,0.5011337868480725
94106,0.5370370370370371,0.504950495049505,-116,-102,0.514488177212783,0.48551182278721705,home,BOS,under,9,0.5238095238095238,-110,0.5011337868480725,BOS,LAA,2024 REG,3,0,12,7,7,15,0,1,-7,7,0,0,0,0,0,0,0,0,0,0.4988662131519274,0.5011337868480725
94107,0.4629629629629629,0.576271186440678,116,-136,0.4447990049057217,0.5552009950942782,away,PHI,over,7.5,0.5,100,0.4772727272727273,STL,PHI,2024 REG,7,3,8,0,3,15,1,0,3,-3,0,0,0,0,0,0,0,0,0,0.4772727272727273,0.5227272727272727
94107,0.4629629629629629,0.576271186440678,116,-136,0.4447990049057217,0.5552009950942782,home,STL,under,7.5,0.5454545454545454,-120,0.5227272727272727,STL,PHI,2024 REG,7,3,8,0,3,15,1,0,3,-3,0,0,0,0,0,0,0,0,0,0.4772727272727273,0.5227272727272727
94139,0.6774193548387096,0.36363636363636365,-210,175,0.6496074165168858,0.3503925834831142,away,MIA,over,8.5,0.5169082125603864,-107,0.49239402434819424,NYY,MIA,2024 REG,7,3,4,2,5,11,1,0,1,-1,1,1,0,0,0,0,0,0,0,0.49239402434819424,0.5076059756518058
94139,0.6774193548387096,0.36363636363636365,-210,175,0.6496074165168858,0.3503925834831142,home,NYY,under,8.5,0.5305164319248826,-113,0.5076059756518058,NYY,MIA,2024 REG,7,3,4,2,5,11,1,0,1,-1,1,1,0,0,0,0,0,0,0,0.49239402434819424,0.5076059756518058
94140,0.6153846153846154,0.425531914893617,-160,135,0.5902052121364724,0.40979478786352763,away,CLE,over,9.5,0.5215311004784688,-109,0.4978845547971712,BOS,CLE,2024 REG,3,0,9,6,6,12,0,1,-6,6,0,0,0,0,0,0,0,0,0,0.4978845547971712,0.5021154452028288
94140,0.6153846153846154,0.425531914893617,-160,135,0.5902052121364724,0.40979478786352763,home,BOS,under,9.5,0.5238095238095238,-110,0.5021154452028288,BOS,CLE,2024 REG,3,0,9,6,6,12,0,1,-6,6,0,0,0,0,0,0,0,0,0,0.4978845547971712,0.5021154452028288
94160,0.5884773662551441,0.4484304932735426,-143,123,0.5667579262855877,0.43324207371441226,away,CIN,over,7,0.5348837209302326,-115,0.5097020142727117,SEA,CIN,2024 REG,10,9,7,3,12,17,1,0,6,-6,1,1,1,0,0,0,0,0,0,0.5097020142727117,0.49029798572728833
94160,0.5884773662551441,0.4484304932735426,-143,123,0.5667579262855877,0.43324207371441226,home,SEA,under,7,0.5121951219512195,-105,0.49029798572728833,SEA,CIN,2024 REG,10,9,7,3,12,17,1,0,6,-6,1,1,1,0,0,0,0,0,0,0.5097020142727117,0.49029798572728833
94162,0.607843137254902,0.4347826086956522,-155,130,0.5819333701084867,0.41806662989151333,away,NYY,over,9,0.5238095238095238,-110,0.4988662131519274,HOU,NYY,2024 REG,13,4,8,5,9,21,0,1,-1,1,1,1,1,1,0,0,0,0,0,0.4988662131519274,0.5011337868480725
94162,0.607843137254902,0.4347826086956522,-155,130,0.5819333701084867,0.41806662989151333,home,HOU,under,9,0.5238095238095238,-110,0.5011337868480725,HOU,NYY,2024 REG,13,4,8,5,9,21,0,1,-1,1,1,1,1,1,0,0,0,0,0,0.4988662131519274,0.5011337868480725
94169,0.5918367346938775,0.45454545454545453,-145,120,0.5643860512665178,0.43561394873348225,away,CIN,over,8,0.5327102803738317,-114,0.508788710910954,PHI,CIN,2024 REG,7,3,8,6,9,15,0,1,-3,3,1,1,1,0,0,0,0,0,0,0.508788710910954,0.491211289089046
94169,0.5918367346938775,0.45454545454545453,-145,120,0.5643860512665178,0.43561394873348225,home,PHI,under,8,0.5121951219512195,-105,0.491211289089046,PHI,CIN,2024 REG,7,3,8,6,9,15,0,1,-3,3,1,1,1,0,0,0,0,0,0,0.508788710910954,0.491211289089046
94196,0.6000000000000001,0.4444444444444444,-150,125,0.5733333333333334,0.42666666666666664,away,TOR,over,8.5,0.5238095238095238,-110,0.4988662131519274,HOU,TOR,2024 REG,8,1,8,2,3,16,0,1,-1,1,1,0,0,0,0,0,0,0,0,0.4988662131519274,0.5011337868480725
94196,0.6000000000000001,0.4444444444444444,-150,125,0.5733333333333334,0.42666666666666664,home,HOU,under,8.5,0.5238095238095238,-110,0.5011337868480725,HOU,TOR,2024 REG,8,1,8,2,3,16,0,1,-1,1,1,0,0,0,0,0,0,0,0,0.4988662131519274,0.5011337868480725
94200,0.6491228070175439,0.3921568627450981,-185,155,0.6223272319084604,0.3776727680915396,away,COL,over,8.5,0.5238095238095238,-110,0.4988662131519274,CHC,COL,2024 REG,14,12,7,2,14,21,1,0,10,-10,1,1,0,0,0,0,0,0,0,0.4988662131519274,0.5011337868480725
94200,0.6491228070175439,0.3921568627450981,-185,155,0.6223272319084604,0.3776727680915396,home,CHC,under,8.5,0.5238095238095238,-110,0.5011337868480725,CHC,COL,2024 REG,14,12,7,2,14,21,1,0,10,-10,1,1,0,0,0,0,0,0,0,0.4988662131519274,0.5011337868480725
94218,0.5652173913043479,0.47619047619047616,-130,110,0.5418129444594474,0.4581870555405526,away,MIN,over,8.5,0.5238095238095238,-110,0.4988662131519274,DET,MIN,2024 REG,8,4,6,3,7,14,1,0,1,-1,1,1,1,0,0,0,0,0,0,0.4988662131519274,0.5011337868480725
94218,0.5652173913043479,0.47619047619047616,-130,110,0.5418129444594474,0.4581870555405526,home,DET,under,8.5,0.5238095238095238,-110,0.5011337868480725,DET,MIN,2024 REG,8,4,6,3,7,14,1,0,1,-1,1,1,1,0,0,0,0,0,0,0.4988662131519274,0.5011337868480725
94249,0.5884773662551441,0.4504504504504505,-143,122,0.5655692272061728,0.43443077279382725,away,LAA,over,9,0.5073891625615764,-103,0.4826927225525911,MIA,LAA,2024 REG,5,1,7,3,4,12,0,1,-2,2,1,0,0,0,0,0,0,0,0,0.4826927225525911,0.5173072774474089
94249,0.5884773662551441,0.4504504504504505,-143,122,0.5655692272061728,0.43443077279382725,home,MIA,under,9,0.5412844036697247,-118,0.5173072774474089,MIA,LAA,2024 REG,5,1,7,3,4,12,0,1,-2,2,1,0,0,0,0,0,0,0,0,0.4826927225525911,0.5173072774474089
94257,0.7142857142857143,0.3333333333333333,-250,200,0.6802721088435374,0.3197278911564626,away,ARI,over,9,0.5348837209302326,-115,0.5097020142727117,ATL,ARI,2024 REG,7,5,5,2,7,12,1,0,3,-3,1,1,0,0,0,0,0,0,0,0.5097020142727117,0.49029798572728833
94257,0.7142857142857143,0.3333333333333333,-250,200,0.6802721088435374,0.3197278911564626,home,ATL,under,9,0.5121951219512195,-105,0.49029798572728833,ATL,ARI,2024 REG,7,5,5,2,7,12,1,0,3,-3,1,1,0,0,0,0,0,0,0,0.5097020142727117,0.49029798572728833
94264,0.5555555555555556,0.48780487804878053,-125,105,0.5314664257753688,0.46853357422463116,away,TEX,over,9,0.5327102803738317,-114,0.508788710910954,HOU,TEX,2024 REG,11,8,12,12,20,23,0,1,-4,4,1,1,1,1,1,1,1,1,0,0.508788710910954,0.491211289089046
94264,0.5555555555555556,0.48780487804878053,-125,105,0.5314664257753688,0.46853357422463116,home,HOU,under,9,0.5121951219512195,-105,0.491211289089046,HOU,TEX,2024 REG,11,8,12,12,20,23,0,1,-4,4,1,1,1,1,1,1,1,1,0,0.508788710910954,0.491211289089046
94271,0.7142857142857143,0.3278688524590164,-250,205,0.6841753094680495,0.3158246905319505,away,CWS,over,8.5,0.5098039215686274,-104,0.48375889301574193,CLE,CWS,2024 REG,10,4,4,0,4,14,1,0,4,-4,0,0,0,0,0,0,0,0,0,0.48375889301574193,0.5162411069842581
94271,0.7142857142857143,0.3278688524590164,-250,205,0.6841753094680495,0.3158246905319505,home,CLE,under,8.5,0.5412844036697247,-118,0.5162411069842581,CLE,CWS,2024 REG,10,4,4,0,4,14,1,0,4,-4,0,0,0,0,0,0,0,0,0,0.48375889301574193,0.5162411069842581
94286,0.613899613899614,0.4273504273504274,-159,134,0.5885762295028705,0.4114237704971295,away,STL,over,8.5,0.5145631067961165,-106,0.49023796582517226,SD,STL,2024 REG,7,3,6,2,5,13,1,0,1,-1,1,1,0,0,0,0,0,0,0,0.49023796582517226,0.5097620341748277
94286,0.613899613899614,0.4273504273504274,-159,134,0.5885762295028705,0.4114237704971295,home,SD,under,8.5,0.5327102803738317,-114,0.5097620341748277,SD,STL,2024 REG,7,3,6,2,5,13,1,0,1,-1,1,1,0,0,0,0,0,0,0,0.49023796582517226,0.5097620341748277
94288,0.5555555555555556,0.48780487804878053,-125,105,0.5314664257753688,0.46853357422463116,away,NYM,over,9.5,0.5098039215686274,-104,0.48483656587239576,CIN,NYM,2024 REG,8,9,11,6,15,19,1,0,3,-3,1,1,1,1,1,1,0,0,0,0.48483656587239576,0.5151634341276042
94288,0.5555555555555556,0.48780487804878053,-125,105,0.5314664257753688,0.46853357422463116,home,CIN,under,9.5,0.5391705069124424,-117,0.5151634341276042,CIN,NYM,2024 REG,8,9,11,6,15,19,1,0,3,-3,1,1,1,1,1,1,0,0,0,0.48483656587239576,0.5151634341276042
94302,0.607843137254902,0.4347826086956522,-155,130,0.5819333701084867,0.41806662989151333,away,BOS,over,7.5,0.5,100,0.4772727272727273,SEA,BOS,2024 REG,7,4,7,3,7,14,1,0,1,-1,1,1,1,0,0,0,0,0,0,0.4772727272727273,0.5227272727272727
94302,0.607843137254902,0.4347826086956522,-155,130,0.5819333701084867,0.41806662989151333,home,SEA,under,7.5,0.5454545454545454,-120,0.5227272727272727,SEA,BOS,2024 REG,7,4,7,3,7,14,1,0,1,-1,1,1,1,0,0,0,0,0,0,0.4772727272727273,0.5227272727272727
94303,0.425531914893617,0.6153846153846154,135,-160,0.4081206254135181,0.5918793745864819,away,BOS,over,8.5,0.5238095238095238,-110,0.4988662131519274,OAK,BOS,2024 REG,4,0,9,9,9,13,0,1,-9,9,0,0,0,0,0,0,0,0,0,0.4988662131519274,0.5011337868480725
94303,0.425531914893617,0.6153846153846154,135,-160,0.4081206254135181,0.5918793745864819,home,OAK,under,8.5,0.5238095238095238,-110,0.5011337868480725,OAK,BOS,2024 REG,4,0,9,9,9,13,0,1,-9,9,0,0,0,0,0,0,0,0,0,0.4988662131519274,0.5011337868480725
94327,0.5726495726495727,0.4672897196261683,-134,114,0.5497783539959433,0.4502216460040567,away,WSH,over,8,0.5145631067961165,-106,0.4913668392989033,OAK,WSH,2024 REG,3,2,8,1,3,11,1,0,1,-1,1,0,0,0,0,0,0,0,0,0.4913668392989033,0.5086331607010968
94327,0.5726495726495727,0.4672897196261683,-134,114,0.5497783539959433,0.4502216460040567,home,OAK,under,8,0.5305164319248826,-113,0.5086331607010968,OAK,WSH,2024 REG,3,2,8,1,3,11,1,0,1,-1,1,0,0,0,0,0,0,0,0,0.4913668392989033,0.5086331607010968
94335,0.607843137254902,0.43103448275862066,-155,132,0.5842116427368785,0.41578835726312147,away,TOR,over,8.5,0.5348837209302326,-115,0.5097020142727117,NYY,TOR,2024 REG,6,0,7,3,3,13,0,1,-3,3,0,0,0,0,0,0,0,0,0,0.5097020142727117,0.49029798572728833
94335,0.607843137254902,0.43103448275862066,-155,132,0.5842116427368785,0.41578835726312147,home,NYY,under,8.5,0.5121951219512195,-105,0.49029798572728833,NYY,TOR,2024 REG,6,0,7,3,3,13,0,1,-3,3,0,0,0,0,0,0,0,0,0,0.5097020142727117,0.49029798572728833
94347,0.6551724137931035,0.3846153846153846,-190,160,0.6291045458703008,0.37089545412969915,away,COL,over,9,0.5169082125603864,-107,0.49353874091423283,TOR,COL,2024 REG,9,5,7,3,8,16,1,0,2,-2,1,1,1,0,0,0,0,0,0,0.49353874091423283,0.5064612590857671
94347,0.6551724137931035,0.3846153846153846,-190,160,0.6291045458703008,0.37089545412969915,home,TOR,under,9,0.5283018867924528,-112,0.5064612590857671,TOR,COL,2024 REG,9,5,7,3,8,16,1,0,2,-2,1,1,1,0,0,0,0,0,0,0.49353874091423283,0.5064612590857671
94356,0.3846153846153846,0.6551724137931035,160,-190,0.3693123852275045,0.6306876147724956,away,LAD,over,7.5,0.5,100,0.4772727272727273,CHC,LAD,2024 REG,9,9,12,7,16,21,1,0,2,-2,1,1,1,1,1,1,1,0,0,0.4772727272727273,0.5227272727272727
94356,0.3846153846153846,0.6551724137931035,160,-190,0.3693123852275045,0.6306876147724956,home,CHC,under,7.5,0.5454545454545454,-120,0.5227272727272727,CHC,LAD,2024 REG,9,9,12,7,16,21,1,0,2,-2,1,1,1,1,1,1,1,0,0,0.4772727272727273,0.5227272727272727
94365,0.46511627906976744,0.5726495726495727,115,-134,0.4475507666421673,0.5524492333578327,away,DET,over,8.5,0.5412844036697247,-118,0.5162581740877563,CWS,DET,2024 REG,10,6,12,7,13,22,0,1,-1,1,1,1,1,1,1,1,0,0,0,0.5162581740877563,0.4837418259122437
94365,0.46511627906976744,0.5726495726495727,115,-134,0.4475507666421673,0.5524492333578327,home,CWS,under,8.5,0.504950495049505,-102,0.4837418259122437,CWS,DET,2024 REG,10,6,12,7,13,22,0,1,-1,1,1,1,1,1,1,1,0,0,0,0.5162581740877563,0.4837418259122437
94398,0.6610169491525424,0.3846153846153846,-195,160,0.6308532031025568,0.36914679689744323,away,OAK,over,9,0.5238095238095238,-110,0.4988662131519274,TEX,OAK,2024 REG,12,6,9,2,8,21,1,0,4,-4,1,1,0,0,0,0,0,0,0,0.4988662131519274,0.5011337868480725
94398,0.6610169491525424,0.3846153846153846,-195,160,0.6308532031025568,0.36914679689744323,home,TEX,under,9,0.5238095238095238,-110,0.5011337868480725,TEX,OAK,2024 REG,12,6,9,2,8,21,1,0,4,-4,1,1,0,0,0,0,0,0,0,0.4988662131519274,0.5011337868480725
94399,0.609375,0.43103448275862066,-156,132,0.5847504714439656,0.41524952855603436,away,CHC,over,8.5,0.5495495495495495,-122,0.5223196169142115,ARI,CHC,2024 REG,3,2,9,3,5,12,0,1,-1,1,1,1,0,0,0,0,0,0,0,0.5223196169142115,0.47768038308578853
94399,0.609375,0.43103448275862066,-156,132,0.5847504714439656,0.41524952855603436,home,ARI,under,8.5,0.5,100,0.47768038308578853,ARI,CHC,2024 REG,3,2,9,3,5,12,0,1,-1,1,1,1,0,0,0,0,0,0,0,0.5223196169142115,0.47768038308578853
94407,0.49019607843137253,0.5495495495495495,104,-122,0.4707129274603323,0.5292870725396677,away,BAL,over,7.5,0.5348837209302326,-115,0.5097020142727117,PIT,BAL,2024 REG,6,2,12,5,7,18,0,1,-3,3,1,1,0,0,0,0,0,0,0,0.5097020142727117,0.49029798572728833
94407,0.49019607843137253,0.5495495495495495,104,-122,0.4707129274603323,0.5292870725396677,home,PIT,under,7.5,0.5121951219512195,-105,0.49029798572728833,PIT,BAL,2024 REG,6,2,12,5,7,18,0,1,-3,3,1,1,0,0,0,0,0,0,0,0.5097020142727117,0.49029798572728833
94417,0.4444444444444444,0.5967741935483871,125,-148,0.42612504978096366,0.5738749502190363,away,TB,over,8.5,0.5348837209302326,-115,0.5097020142727117,LAA,TB,2024 REG,14,7,8,1,8,22,1,0,6,-6,1,0,0,0,0,0,0,0,0,0.5097020142727117,0.49029798572728833
94417,0.4444444444444444,0.5967741935483871,125,-148,0.42612504978096366,0.5738749502190363,home,LAA,under,8.5,0.5121951219512195,-105,0.49029798572728833,LAA,TB,2024 REG,14,7,8,1,8,22,1,0,6,-6,1,0,0,0,0,0,0,0,0,0.5097020142727117,0.49029798572728833
94431,0.5652173913043479,0.4716981132075471,-130,112,0.5443521061454507,0.4556478938545493,away,NYY,over,9,0.5238095238095238,-110,0.4988662131519274,HOU,NYY,2024 REG,4,3,8,5,8,12,0,1,-2,2,1,1,1,0,0,0,0,0,0,0.4988662131519274,0.5011337868480725
94431,0.5652173913043479,0.4716981132075471,-130,112,0.5443521061454507,0.4556478938545493,home,HOU,under,9,0.5238095238095238,-110,0.5011337868480725,HOU,NYY,2024 REG,4,3,8,5,8,12,0,1,-2,2,1,1,1,0,0,0,0,0,0,0.4988662131519274,0.5011337868480725
94440,0.37037037037037035,0.6721311475409836,170,-205,0.35462906744023925,0.6453709325597607,away,ATL,over,8.5,0.5454545454545454,-120,0.5206611570247933,MIA,ATL,2024 REG,6,1,14,8,9,20,0,1,-7,7,1,0,0,0,0,0,0,0,0,0.5206611570247933,0.4793388429752067
94440,0.37037037037037035,0.6721311475409836,170,-205,0.35462906744023925,0.6453709325597607,home,MIA,under,8.5,0.5,100,0.4793388429752067,MIA,ATL,2024 REG,6,1,14,8,9,20,0,1,-7,7,1,0,0,0,0,0,0,0,0,0.5206611570247933,0.4793388429752067
94447,0.4081632653061224,0.6363636363636364,145,-175,0.3899890197266291,0.6100109802733709,away,CIN,over,9.5,0.5,100,0.4772727272727273,CWS,CIN,2024 REG,4,1,12,11,12,16,0,1,-10,10,1,0,0,0,0,0,0,0,0,0.4772727272727273,0.5227272727272727
94447,0.4081632653061224,0.6363636363636364,145,-175,0.3899890197266291,0.6100109802733709,home,CWS,under,9.5,0.5454545454545454,-120,0.5227272727272727,CWS,CIN,2024 REG,4,1,12,11,12,16,0,1,-10,10,1,0,0,0,0,0,0,0,0,0.4772727272727273,0.5227272727272727
94451,0.4081632653061224,0.6363636363636364,145,-175,0.3899890197266291,0.6100109802733709,away,STL,over,7.5,0.5238095238095238,-110,0.4988662131519274,OAK,STL,2024 REG,5,1,8,3,4,13,0,1,-2,2,1,0,0,0,0,0,0,0,0,0.4988662131519274,0.5011337868480725
94451,0.4081632653061224,0.6363636363636364,145,-175,0.3899890197266291,0.6100109802733709,home,OAK,under,7.5,0.5238095238095238,-110,0.5011337868480725,OAK,STL,2024 REG,5,1,8,3,4,13,0,1,-2,2,1,0,0,0,0,0,0,0,0,0.4988662131519274,0.5011337868480725
94461,0.5215311004784688,0.5192307692307692,-109,-108,0.50027251771145,0.49972748228855,away,NYY,over,8.5,0.5348837209302326,-115,0.5097020142727117,CLE,NYY,2024 REG,7,2,9,8,10,16,0,1,-6,6,1,1,0,0,0,0,0,0,0,0.5097020142727117,0.49029798572728833
94461,0.5215311004784688,0.5192307692307692,-109,-108,0.50027251771145,0.49972748228855,home,CLE,under,8.5,0.5121951219512195,-105,0.49029798572728833,CLE,NYY,2024 REG,7,2,9,8,10,16,0,1,-6,6,1,1,0,0,0,0,0,0,0,0.5097020142727117,0.49029798572728833
94465,0.4484304932735426,0.6000000000000001,123,-150,0.4267127832854069,0.573287216714593,away,ATL,over,8,0.5145631067961165,-106,0.49023796582517226,PHI,ATL,2024 REG,9,5,7,4,9,16,1,0,1,-1,1,1,1,1,0,0,0,0,0,0.49023796582517226,0.5097620341748277
94465,0.4484304932735426,0.6000000000000001,123,-150,0.4267127832854069,0.573287216714593,home,PHI,under,8,0.5327102803738317,-114,0.5097620341748277,PHI,ATL,2024 REG,9,5,7,4,9,16,1,0,1,-1,1,1,1,1,0,0,0,0,0,0.49023796582517226,0.5097620341748277
94489,0.5555555555555556,0.48309178743961345,-125,107,0.5340848094471283,0.46591519055287167,away,TEX,over,8.5,0.5238095238095238,-110,0.4988662131519274,TB,TEX,2024 REG,5,3,8,9,12,13,0,1,-6,6,1,1,1,0,0,0,0,0,0,0.4988662131519274,0.5011337868480725
94489,0.5555555555555556,0.48309178743961345,-125,107,0.5340848094471283,0.46591519055287167,home,TB,under,8.5,0.5238095238095238,-110,0.5011337868480725,TB,TEX,2024 REG,5,3,8,9,12,13,0,1,-6,6,1,1,1,0,0,0,0,0,0,0.4988662131519274,0.5011337868480725
94511,0.5652173913043479,0.47619047619047616,-130,110,0.5418129444594474,0.4581870555405526,away,CWS,over,9,0.5192307692307692,-108,0.49571111079951763,KC,CWS,2024 REG,5,5,12,3,8,17,1,0,2,-2,1,1,1,0,0,0,0,0,0,0.49571111079951763,0.5042888892004824
94511,0.5652173913043479,0.47619047619047616,-130,110,0.5418129444594474,0.4581870555405526,home,KC,under,9,0.5260663507109005,-111,0.5042888892004824,KC,CWS,2024 REG,5,5,12,3,8,17,1,0,2,-2,1,1,1,0,0,0,0,0,0,0.49571111079951763,0.5042888892004824
94512,0.6254681647940076,0.41152263374485604,-167,143,0.6023315979176397,0.3976684020823603,away,STL,over,8.5,0.5475113122171946,-121,0.5214983313199976,LAD,STL,2024 REG,8,5,8,4,9,16,1,0,1,-1,1,1,1,1,0,0,0,0,0,0.5214983313199976,0.47850166868000243
94512,0.6254681647940076,0.41152263374485604,-167,143,0.6023315979176397,0.3976684020823603,home,LAD,under,8.5,0.5,100,0.47850166868000243,LAD,STL,2024 REG,8,5,8,4,9,16,1,0,1,-1,1,1,1,1,0,0,0,0,0,0.5214983313199976,0.47850166868000243
94514,0.5305164319248826,0.5121951219512195,-113,-105,0.5078572507605655,0.49214274923943446,away,SEA,over,8,0.5391705069124424,-117,0.5114756747601454,TOR,SEA,2024 REG,11,5,6,3,8,17,1,0,2,-2,1,1,1,0,0,0,0,0,0,0.5114756747601454,0.48852432523985456
94514,0.5305164319248826,0.5121951219512195,-113,-105,0.5078572507605655,0.49214274923943446,home,TOR,under,8,0.5121951219512195,-105,0.48852432523985456,TOR,SEA,2024 REG,11,5,6,3,8,17,1,0,2,-2,1,1,1,0,0,0,0,0,0,0.5114756747601454,0.48852432523985456
94520,0.5884773662551441,0.45454545454545453,-143,120,0.5631594099815408,0.4368405900184592,away,STL,over,8.5,0.5454545454545454,-120,0.5206611570247933,ARI,STL,2024 REG,7,5,4,0,5,11,1,0,5,-5,0,0,0,0,0,0,0,0,0,0.5206611570247933,0.4793388429752067
94520,0.5884773662551441,0.45454545454545453,-143,120,0.5631594099815408,0.4368405900184592,home,ARI,under,8.5,0.5,100,0.4793388429752067,ARI,STL,2024 REG,7,5,4,0,5,11,1,0,5,-5,0,0,0,0,0,0,0,0,0,0.5206611570247933,0.4793388429752067
94530,0.5918367346938775,0.4464285714285714,-145,124,0.5691899208663057,0.4308100791336943,away,MIL,over,8.5,0.504950495049505,-102,0.47949844489399435,BAL,MIL,2024 REG,12,5,15,11,16,27,0,1,-6,6,1,1,1,1,1,0,0,0,0,0.47949844489399435,0.5205015551060057
94530,0.5918367346938775,0.4464285714285714,-145,124,0.5691899208663057,0.4308100791336943,home,BAL,under,8.5,0.5454545454545454,-120,0.5205015551060057,BAL,MIL,2024 REG,12,5,15,11,16,27,0,1,-6,6,1,1,1,1,1,0,0,0,0,0.47949844489399435,0.5205015551060057
94540,0.5652173913043479,0.47619047619047616,-130,110,0.5418129444594474,0.4581870555405526,away,CHC,over,9,0.5348837209302326,-115,0.5097020142727117,TEX,CHC,2024 REG,8,5,12,9,14,20,0,1,-4,4,1,1,1,1,1,0,0,0,0,0.5097020142727117,0.49029798572728833
94540,0.5652173913043479,0.47619047619047616,-130,110,0.5418129444594474,0.4581870555405526,home,TEX,under,9,0.5121951219512195,-105,0.49029798572728833,TEX,CHC,2024 REG,8,5,12,9,14,20,0,1,-4,4,1,1,1,1,1,0,0,0,0,0.5097020142727117,0.49029798572728833
94550,0.5,0.5454545454545454,100,-120,0.4772727272727273,0.5227272727272727,away,BOS,over,8.5,0.5283018867924528,-112,0.5031902949311281,LAA,BOS,2024 REG,8,2,12,12,14,20,0,1,-10,10,1,1,0,0,0,0,0,0,0,0.5031902949311281,0.4968097050688719
94550,0.5,0.5454545454545454,100,-120,0.4772727272727273,0.5227272727272727,home,LAA,under,8.5,0.5192307692307692,-108,0.4968097050688719,LAA,BOS,2024 REG,8,2,12,12,14,20,0,1,-10,10,1,1,0,0,0,0,0,0,0,0.5031902949311281,0.4968097050688719
94558,0.6551724137931035,0.38759689922480617,-190,158,0.6271511397468869,0.37284886025311315,away,COL,over,9.5,0.5238095238095238,-110,0.4988662131519274,ARI,COL,2024 REG,8,4,10,9,13,18,0,1,-5,5,1,1,1,1,0,0,0,0,0,0.4988662131519274,0.5011337868480725
94558,0.6551724137931035,0.38759689922480617,-190,158,0.6271511397468869,0.37284886025311315,home,ARI,under,9.5,0.5238095238095238,-110,0.5011337868480725,ARI,COL,2024 REG,8,4,10,9,13,18,0,1,-5,5,1,1,1,1,0,0,0,0,0,0.4988662131519274,0.5011337868480725
94568,0.5833333333333333,0.45454545454545453,-140,120,0.5612373737373737,0.4387626262626263,away,SF,over,7.5,0.5348837209302326,-115,0.5097020142727117,SD,SF,2024 REG,9,3,13,8,11,22,0,1,-5,5,1,1,1,0,0,0,0,0,0,0.5097020142727117,0.49029798572728833
94568,0.5833333333333333,0.45454545454545453,-140,120,0.5612373737373737,0.4387626262626263,home,SD,under,7.5,0.5121951219512195,-105,0.49029798572728833,SD,SF,2024 REG,9,3,13,8,11,22,0,1,-5,5,1,1,1,0,0,0,0,0,0,0.5097020142727117,0.49029798572728833
94578,0.5833333333333333,0.45454545454545453,-140,120,0.5612373737373737,0.4387626262626263,away,DET,over,7.5,0.5121951219512195,-105,0.48808156828023186,NYM,DET,2024 REG,6,3,9,6,9,15,0,1,-3,3,1,1,1,0,0,0,0,0,0,0.48808156828023186,0.5119184317197681
94578,0.5833333333333333,0.45454545454545453,-140,120,0.5612373737373737,0.4387626262626263,home,NYM,under,7.5,0.5348837209302326,-115,0.5119184317197681,NYM,DET,2024 REG,6,3,9,6,9,15,0,1,-3,3,1,1,1,0,0,0,0,0,0,0.48808156828023186,0.5119184317197681
94580,0.5121951219512195,0.5348837209302326,-105,-115,0.48808156828023186,0.5119184317197681,away,SF,over,8,0.5348837209302326,-115,0.5097020142727117,TB,SF,2024 REG,10,9,10,4,13,20,1,0,5,-5,1,1,1,1,0,0,0,0,0,0.5097020142727117,0.49029798572728833
94580,0.5121951219512195,0.5348837209302326,-105,-115,0.48808156828023186,0.5119184317197681,home,TB,under,8,0.5121951219512195,-105,0.49029798572728833,TB,SF,2024 REG,10,9,10,4,13,20,1,0,5,-5,1,1,1,1,0,0,0,0,0,0.5097020142727117,0.49029798572728833
94599,0.5412844036697247,0.5,-118,100,0.5189377998484975,0.4810622001515025,away,SD,over,8,0.5121951219512195,-105,0.48919479393107135,SF,SD,2024 REG,4,0,5,4,4,9,0,1,-4,4,0,0,0,0,0,0,0,0,0,0.48919479393107135,0.5108052060689287
94599,0.5412844036697247,0.5,-118,100,0.5189377998484975,0.4810622001515025,home,SF,under,8,0.5327102803738317,-114,0.5108052060689287,SF,SD,2024 REG,4,0,5,4,4,9,0,1,-4,4,0,0,0,0,0,0,0,0,0,0.48919479393107135,0.5108052060689287
94606,0.38759689922480617,0.6551724137931035,158,-190,0.37101964611708926,0.6289803538829107,away,ATL,over,9,0.5121951219512195,-105,0.48808156828023186,CWS,ATL,2024 REG,7,3,5,2,5,12,1,0,1,-1,1,1,0,0,0,0,0,0,0,0.48808156828023186,0.5119184317197681
94606,0.38759689922480617,0.6551724137931035,158,-190,0.37101964611708926,0.6289803538829107,home,CWS,under,9,0.5348837209302326,-115,0.5119184317197681,CWS,ATL,2024 REG,7,3,5,2,5,12,1,0,1,-1,1,1,0,0,0,0,0,0,0,0.48808156828023186,0.5119184317197681
94617,0.6610169491525424,0.37735849056603776,-195,165,0.6356501330673793,0.3643498669326207,away,SD,over,8.5,0.5475113122171946,-121,0.5214983313199976,LAD,SD,2024 REG,16,11,17,15,26,33,0,1,-4,4,1,1,1,1,1,1,1,1,1,0.5214983313199976,0.47850166868000243
94617,0.6610169491525424,0.37735849056603776,-195,165,0.6356501330673793,0.3643498669326207,home,LAD,under,8.5,0.5,100,0.47850166868000243,LAD,SD,2024 REG,16,11,17,15,26,33,0,1,-4,4,1,1,1,1,1,1,1,1,1,0.5214983313199976,0.47850166868000243
94620,0.43103448275862066,0.609375,132,-156,0.41361660225921526,0.5863833977407847,away,PHI,over,7.5,0.5348837209302326,-115,0.5097020142727117,WSH,PHI,2024 REG,8,3,5,2,5,13,1,0,1,-1,1,1,0,0,0,0,0,0,0,0.5097020142727117,0.49029798572728833
94620,0.43103448275862066,0.609375,132,-156,0.41361660225921526,0.5863833977407847,home,WSH,under,7.5,0.5121951219512195,-105,0.49029798572728833,WSH,PHI,2024 REG,8,3,5,2,5,13,1,0,1,-1,1,1,0,0,0,0,0,0,0,0.5097020142727117,0.49029798572728833
94624,0.5726495726495727,0.46511627906976744,-134,115,0.5510229738017454,0.44897702619825464,away,PIT,over,9,0.5475113122171946,-121,0.5214983313199976,PHI,PIT,2024 REG,7,5,7,1,6,14,1,0,4,-4,1,0,0,0,0,0,0,0,0,0.5214983313199976,0.47850166868000243
94624,0.5726495726495727,0.46511627906976744,-134,115,0.5510229738017454,0.44897702619825464,home,PHI,under,9,0.5,100,0.47850166868000243,PHI,PIT,2024 REG,7,5,7,1,6,14,1,0,4,-4,1,0,0,0,0,0,0,0,0,0.5214983313199976,0.47850166868000243
94625,0.5370370370370371,0.5098039215686274,-116,-104,0.5118817074154765,0.48811829258452355,away,STL,over,10.5,0.5192307692307692,-108,0.49455035168025013,ARI,STL,2024 REG,6,4,11,2,6,17,1,0,2,-2,1,1,0,0,0,0,0,0,0,0.49455035168025013,0.5054496483197499
94625,0.5370370370370371,0.5098039215686274,-116,-104,0.5118817074154765,0.48811829258452355,home,ARI,under,10.5,0.5283018867924528,-112,0.5054496483197499,ARI,STL,2024 REG,6,4,11,2,6,17,1,0,2,-2,1,1,0,0,0,0,0,0,0,0.49455035168025013,0.5054496483197499
94630,0.5918367346938775,0.4444444444444444,-145,125,0.5703642001018094,0.42963579989819056,away,BOS,over,7,0.5454545454545454,-120,0.5206611570247933,SEA,BOS,2024 REG,4,1,4,0,1,8,1,0,1,-1,0,0,0,0,0,0,0,0,0,0.5206611570247933,0.4793388429752067
94630,0.5918367346938775,0.4444444444444444,-145,125,0.5703642001018094,0.42963579989819056,home,SEA,under,7,0.5,100,0.4793388429752067,SEA,BOS,2024 REG,4,1,4,0,1,8,1,0,1,-1,0,0,0,0,0,0,0,0,0,0.5206611570247933,0.4793388429752067
94631,0.5073891625615764,0.5348837209302326,-103,-115,0.4859403596076043,0.5140596403923957,away,SF,over,8.5,0.5283018867924528,-112,0.5031902949311281,MIA,SF,2024 REG,10,3,8,4,7,18,0,1,-1,1,1,1,1,0,0,0,0,0,0,0.5031902949311281,0.4968097050688719
94631,0.5073891625615764,0.5348837209302326,-103,-115,0.4859403596076043,0.5140596403923957,home,MIA,under,8.5,0.5192307692307692,-108,0.4968097050688719,MIA,SF,2024 REG,10,3,8,4,7,18,0,1,-1,1,1,1,1,0,0,0,0,0,0,0.5031902949311281,0.4968097050688719
94632,0.7014925373134329,0.3389830508474576,-235,195,0.6730992142751963,0.32690078572480374,away,CWS,over,9,0.5454545454545454,-120,0.5206611570247933,KC,CWS,2024 REG,10,3,3,0,3,13,1,0,3,-3,0,0,0,0,0,0,0,0,0,0.5206611570247933,0.4793388429752067
94632,0.7014925373134329,0.3389830508474576,-235,195,0.6730992142751963,0.32690078572480374,home,KC,under,9,0.5,100,0.4793388429752067,KC,CWS,2024 REG,10,3,3,0,3,13,1,0,3,-3,0,0,0,0,0,0,0,0,0,0.5206611570247933,0.4793388429752067
94649,0.7058823529411764,0.33783783783783783,-240,196,0.6750210418030487,0.32497895819695133,away,COL,over,8,0.5283018867924528,-112,0.5044173060022736,TOR,COL,2024 REG,11,4,20,12,16,31,0,1,-8,8,1,1,1,1,0,0,0,0,0,0.5044173060022736,0.49558269399772636
94649,0.7058823529411764,0.33783783783783783,-240,196,0.6750210418030487,0.32497895819695133,home,TOR,under,8,0.5169082125603864,-107,0.49558269399772636,TOR,COL,2024 REG,11,4,20,12,16,31,0,1,-8,8,1,1,1,1,0,0,0,0,0,0.5044173060022736,0.49558269399772636
94659,0.5726495726495727,0.4672897196261683,-134,114,0.5497783539959433,0.4502216460040567,away,NYM,over,9,0.5,100,0.4772727272727273,CIN,NYM,2024 REG,7,2,4,3,5,11,0,1,-1,1,1,1,0,0,0,0,0,0,0,0.4772727272727273,0.5227272727272727
94659,0.5726495726495727,0.4672897196261683,-134,114,0.5497783539959433,0.4502216460040567,home,CIN,under,9,0.5454545454545454,-120,0.5227272727272727,CIN,NYM,2024 REG,7,2,4,3,5,11,0,1,-1,1,1,1,0,0,0,0,0,0,0,0.4772727272727273,0.5227272727272727
94660,0.4587155963302753,0.5815899581589958,118,-139,0.4402268098673069,0.5597731901326931,away,PHI,over,7.5,0.5454545454545454,-120,0.5193043049216726,STL,PHI,2024 REG,7,3,8,4,7,15,0,1,-1,1,1,1,1,0,0,0,0,0,0,0.5193043049216726,0.48069569507832743
94660,0.4587155963302753,0.5815899581589958,118,-139,0.4402268098673069,0.5597731901326931,home,STL,under,7.5,0.5024875621890548,-101,0.48069569507832743,STL,PHI,2024 REG,7,3,8,4,7,15,0,1,-1,1,1,1,1,0,0,0,0,0,0,0.5193043049216726,0.48069569507832743
94661,0.6363636363636364,0.4081632653061224,-175,145,0.6080283353010626,0.3919716646989374,away,WSH,over,9.5,0.5192307692307692,-108,0.49455035168025013,CIN,WSH,2024 REG,14,6,9,5,11,23,1,0,1,-1,1,1,1,1,1,0,0,0,0,0.49455035168025013,0.5054496483197499
94661,0.6363636363636364,0.4081632653061224,-175,145,0.6080283353010626,0.3919716646989374,home,CIN,under,9.5,0.5283018867924528,-112,0.5054496483197499,CIN,WSH,2024 REG,14,6,9,5,11,23,1,0,1,-1,1,1,1,1,1,0,0,0,0,0.49455035168025013,0.5054496483197499
94683,0.7041420118343195,0.3389830508474576,-238,195,0.6737758434370918,0.32622415656290815,away,STL,over,8.5,0.5348837209302326,-115,0.5097020142727117,LAD,STL,2024 REG,14,5,6,6,11,20,0,1,-1,1,1,1,1,1,1,0,0,0,0,0.5097020142727117,0.49029798572728833
94683,0.7041420118343195,0.3389830508474576,-238,195,0.6737758434370918,0.32622415656290815,home,LAD,under,8.5,0.5121951219512195,-105,0.49029798572728833,LAD,STL,2024 REG,14,5,6,6,11,20,0,1,-1,1,1,1,1,1,1,0,0,0,0,0.5097020142727117,0.49029798572728833
94686,0.49504950495049505,0.5454545454545454,102,-120,0.47499799484898986,0.5250020051510101,away,NYY,over,9.5,0.5327102803738317,-114,0.508788710910954,ARI,NYY,2024 REG,4,2,8,5,7,12,0,1,-3,3,1,1,0,0,0,0,0,0,0,0.508788710910954,0.491211289089046
94686,0.49504950495049505,0.5454545454545454,102,-120,0.47499799484898986,0.5250020051510101,home,ARI,under,9.5,0.5121951219512195,-105,0.491211289089046,ARI,NYY,2024 REG,4,2,8,5,7,12,0,1,-3,3,1,1,0,0,0,0,0,0,0,0.508788710910954,0.491211289089046
94707,0.5555555555555556,0.48780487804878053,-125,105,0.5314664257753688,0.46853357422463116,away,TEX,over,7.5,0.5283018867924528,-112,0.5031902949311281,TB,TEX,2024 REG,8,1,10,4,5,18,0,1,-3,3,1,0,0,0,0,0,0,0,0,0.5031902949311281,0.4968097050688719
94707,0.5555555555555556,0.48780487804878053,-125,105,0.5314664257753688,0.46853357422463116,home,TB,under,7.5,0.5192307692307692,-108,0.4968097050688719,TB,TEX,2024 REG,8,1,10,4,5,18,0,1,-3,3,1,0,0,0,0,0,0,0,0,0.5031902949311281,0.4968097050688719
94709,0.48780487804878053,0.5555555555555556,105,-125,0.4666534470222751,0.5333465529777248,away,NYY,over,8.5,0.5454545454545454,-120,0.5206611570247933,ARI,NYY,2024 REG,9,5,8,6,11,17,0,1,-1,1,1,1,1,1,1,0,0,0,0,0.5206611570247933,0.4793388429752067
94709,0.48780487804878053,0.5555555555555556,105,-125,0.4666534470222751,0.5333465529777248,home,ARI,under,8.5,0.5,100,0.4793388429752067,ARI,NYY,2024 REG,9,5,8,6,11,17,0,1,-1,1,1,1,1,1,1,0,0,0,0,0.5206611570247933,0.4793388429752067
94720,0.7041420118343195,0.3389830508474576,-238,195,0.6737758434370918,0.32622415656290815,away,NYM,over,10,0.5121951219512195,-105,0.48808156828023186,ATL,NYM,2024 REG,12,7,11,8,15,23,0,1,-1,1,1,1,1,1,1,1,1,0,0,0.48808156828023186,0.5119184317197681
94720,0.7041420118343195,0.3389830508474576,-238,195,0.6737758434370918,0.32622415656290815,home,ATL,under,10,0.5348837209302326,-115,0.5119184317197681,ATL,NYM,2024 REG,12,7,11,8,15,23,0,1,-1,1,1,1,1,1,1,1,1,0,0,0.48808156828023186,0.5119184317197681
94722,0.4716981132075471,0.5652173913043479,112,-130,0.4542851393811816,0.5457148606188185,away,CLE,over,8,0.5121951219512195,-105,0.48808156828023186,OAK,CLE,2024 REG,8,4,9,6,10,17,0,1,-2,2,1,1,1,1,0,0,0,0,0,0.48808156828023186,0.5119184317197681
94722,0.4716981132075471,0.5652173913043479,112,-130,0.4542851393811816,0.5457148606188185,home,OAK,under,8,0.5348837209302326,-115,0.5119184317197681,OAK,CLE,2024 REG,8,4,9,6,10,17,0,1,-2,2,1,1,1,1,0,0,0,0,0,0.48808156828023186,0.5119184317197681
94727,0.6000000000000001,0.4444444444444444,-150,125,0.5733333333333334,0.42666666666666664,away,MIA,over,8,0.5391705069124424,-117,0.5140669063204599,NYY,MIA,2024 REG,9,7,2,0,7,11,1,0,7,-7,0,0,0,0,0,0,0,0,0,0.5140669063204599,0.4859330936795401
94727,0.6000000000000001,0.4444444444444444,-150,125,0.5733333333333334,0.42666666666666664,home,NYY,under,8,0.5073891625615764,-103,0.4859330936795401,NYY,MIA,2024 REG,9,7,2,0,7,11,1,0,7,-7,0,0,0,0,0,0,0,0,0,0.5140669063204599,0.4859330936795401
94728,0.5884773662551441,0.4484304932735426,-143,123,0.5667579262855877,0.43324207371441226,away,MIA,over,8.5,0.5121951219512195,-105,0.48808156828023186,STL,MIA,2024 REG,10,8,9,5,13,19,1,0,3,-3,1,1,1,1,1,0,0,0,0,0.48808156828023186,0.5119184317197681
94728,0.5884773662551441,0.4484304932735426,-143,123,0.5667579262855877,0.43324207371441226,home,STL,under,8.5,0.5348837209302326,-115,0.5119184317197681,STL,MIA,2024 REG,10,8,9,5,13,19,1,0,3,-3,1,1,1,1,1,0,0,0,0,0.48808156828023186,0.5119184317197681
94755,0.4424778761061947,0.6000000000000001,126,-150,0.42368235570522356,0.5763176442947764,away,ATL,over,8.5,0.5192307692307692,-108,0.49455035168025013,MIA,ATL,2024 REG,9,7,12,9,16,21,0,1,-2,2,1,1,1,1,1,1,1,0,0,0.49455035168025013,0.5054496483197499
94755,0.4424778761061947,0.6000000000000001,126,-150,0.42368235570522356,0.5763176442947764,home,MIA,under,8.5,0.5283018867924528,-112,0.5054496483197499,MIA,ATL,2024 REG,9,7,12,9,16,21,0,1,-2,2,1,1,1,1,1,1,1,0,0,0.49455035168025013,0.5054496483197499
94766,0.7142857142857143,0.3278688524590164,-250,205,0.6841753094680495,0.3158246905319505,away,COL,over,7,0.5454545454545454,-120,0.5206611570247933,CHC,COL,2024 REG,9,5,3,0,5,12,1,0,5,-5,0,0,0,0,0,0,0,0,0,0.5206611570247933,0.4793388429752067
94766,0.7142857142857143,0.3278688524590164,-250,205,0.6841753094680495,0.3158246905319505,home,CHC,under,7,0.5,100,0.4793388429752067,CHC,COL,2024 REG,9,5,3,0,5,12,1,0,5,-5,0,0,0,0,0,0,0,0,0,0.5206611570247933,0.4793388429752067
94778,0.6551724137931035,0.3846153846153846,-190,160,0.6291045458703008,0.37089545412969915,away,NYM,over,9.5,0.5169082125603864,-107,0.49353874091423283,ATL,NYM,2024 REG,11,6,12,5,11,23,1,0,1,-1,1,1,1,1,1,0,0,0,0,0.49353874091423283,0.5064612590857671
94778,0.6551724137931035,0.3846153846153846,-190,160,0.6291045458703008,0.37089545412969915,home,ATL,under,9.5,0.5283018867924528,-112,0.5064612590857671,ATL,NYM,2024 REG,11,6,12,5,11,23,1,0,1,-1,1,1,1,1,1,0,0,0,0,0.49353874091423283,0.5064612590857671
94792,0.5495495495495495,0.48780487804878053,-122,105,0.529021440689206,0.470978559310794,away,NYY,over,9,0.5348837209302326,-115,0.5097020142727117,HOU,NYY,2024 REG,7,1,12,7,8,19,0,1,-6,6,1,0,0,0,0,0,0,0,0,0.5097020142727117,0.49029798572728833
94792,0.5495495495495495,0.48780487804878053,-122,105,0.529021440689206,0.470978559310794,home,HOU,under,9,0.5121951219512195,-105,0.49029798572728833,HOU,NYY,2024 REG,7,1,12,7,8,19,0,1,-6,6,1,0,0,0,0,0,0,0,0,0.5097020142727117,0.49029798572728833
94797,0.7333333333333333,0.3076923076923077,-275,225,0.7032478632478633,0.29675213675213674,away,CWS,over,7.5,0.5073891625615764,-103,0.4826927225525911,CLE,CWS,2024 REG,8,7,10,6,13,18,1,0,1,-1,1,1,1,1,1,1,0,0,0,0.4826927225525911,0.5173072774474089
94797,0.7333333333333333,0.3076923076923077,-275,225,0.7032478632478633,0.29675213675213674,home,CLE,under,7.5,0.5412844036697247,-118,0.5173072774474089,CLE,CWS,2024 REG,8,7,10,6,13,18,1,0,1,-1,1,1,1,1,1,1,0,0,0,0.4826927225525911,0.5173072774474089
94806,0.6551724137931035,0.3846153846153846,-190,160,0.6291045458703008,0.37089545412969915,away,PIT,over,8.5,0.5495495495495495,-122,0.5223196169142115,PHI,PIT,2024 REG,8,2,10,9,11,18,0,1,-7,7,1,1,0,0,0,0,0,0,0,0.5223196169142115,0.47768038308578853
94806,0.6551724137931035,0.3846153846153846,-190,160,0.6291045458703008,0.37089545412969915,home,PHI,under,8.5,0.5,100,0.47768038308578853,PHI,PIT,2024 REG,8,2,10,9,11,18,0,1,-7,7,1,1,0,0,0,0,0,0,0,0.5223196169142115,0.47768038308578853
94820,0.5884773662551441,0.45454545454545453,-143,120,0.5631594099815408,0.4368405900184592,away,CIN,over,8,0.5348837209302326,-115,0.5097020142727117,PHI,CIN,2024 REG,9,9,8,4,13,17,1,0,5,-5,1,1,1,1,0,0,0,0,0,0.5097020142727117,0.49029798572728833
94820,0.5884773662551441,0.45454545454545453,-143,120,0.5631594099815408,0.4368405900184592,home,PHI,under,8,0.5121951219512195,-105,0.49029798572728833,PHI,CIN,2024 REG,9,9,8,4,13,17,1,0,5,-5,1,1,1,1,0,0,0,0,0,0.5097020142727117,0.49029798572728833
94828,0.574468085106383,0.4672897196261683,-135,114,0.550479558983428,0.44952044101657196,away,TOR,over,8.5,0.504950495049505,-102,0.4826715732667395,TB,TOR,2024 REG,11,5,6,1,6,17,1,0,4,-4,1,0,0,0,0,0,0,0,0,0.4826715732667395,0.5173284267332605
94828,0.574468085106383,0.4672897196261683,-135,114,0.550479558983428,0.44952044101657196,home,TB,under,8.5,0.5391705069124424,-117,0.5173284267332605,TB,TOR,2024 REG,11,5,6,1,6,17,1,0,4,-4,1,0,0,0,0,0,0,0,0,0.4826715732667395,0.5173284267332605
94846,0.6000000000000001,0.43859649122807015,-150,128,0.5768421052631579,0.42315789473684207,away,TOR,over,9,0.5370370370370371,-116,0.5118817074154765,HOU,TOR,2024 REG,12,10,0,0,10,12,1,0,10,-10,0,0,0,0,0,0,0,0,0,0.5118817074154765,0.48811829258452355
94846,0.6000000000000001,0.43859649122807015,-150,128,0.5768421052631579,0.42315789473684207,home,HOU,under,9,0.5098039215686274,-104,0.48811829258452355,HOU,TOR,2024 REG,12,10,0,0,10,12,1,0,10,-10,0,0,0,0,0,0,0,0,0,0.5118817074154765,0.48811829258452355
94853,0.5348837209302326,0.5121951219512195,-115,-105,0.5097020142727117,0.49029798572728833,away,BOS,over,7.5,0.5283018867924528,-112,0.5044173060022736,SEA,BOS,2024 REG,4,1,10,5,6,14,0,1,-4,4,1,0,0,0,0,0,0,0,0,0.5044173060022736,0.49558269399772636
94853,0.5348837209302326,0.5121951219512195,-115,-105,0.5097020142727117,0.49029798572728833,home,SEA,under,7.5,0.5169082125603864,-107,0.49558269399772636,SEA,BOS,2024 REG,4,1,10,5,6,14,0,1,-4,4,1,0,0,0,0,0,0,0,0,0.5044173060022736,0.49558269399772636
94855,0.47619047619047616,0.5652173913043479,110,-130,0.4564724440500838,0.5435275559499162,away,HOU,over,8.5,0.5238095238095238,-110,0.4988662131519274,KC,HOU,2024 REG,16,13,11,3,16,27,1,0,10,-10,1,1,1,0,0,0,0,0,0,0.4988662131519274,0.5011337868480725
94855,0.47619047619047616,0.5652173913043479,110,-130,0.4564724440500838,0.5435275559499162,home,KC,under,8.5,0.5238095238095238,-110,0.5011337868480725,KC,HOU,2024 REG,16,13,11,3,16,27,1,0,10,-10,1,1,1,0,0,0,0,0,0,0.4988662131519274,0.5011337868480725
94862,0.4504504504504505,0.5901639344262295,122,-144,0.43215568248798203,0.567844317512018,away,TB,over,11,0.5348837209302326,-115,0.5097020142727117,COL,TB,2024 REG,7,2,8,3,5,15,0,1,-1,1,1,1,0,0,0,0,0,0,0,0.5097020142727117,0.49029798572728833
94862,0.4504504504504505,0.5901639344262295,122,-144,0.43215568248798203,0.567844317512018,home,COL,under,11,0.5121951219512195,-105,0.49029798572728833,COL,TB,2024 REG,7,2,8,3,5,15,0,1,-1,1,1,1,0,0,0,0,0,0,0,0.5097020142727117,0.49029798572728833
94889,0.6610169491525424,0.37735849056603776,-195,165,0.6356501330673793,0.3643498669326207,away,LAA,over,8,0.5073891625615764,-103,0.48484779035144243,BAL,LAA,2024 REG,10,11,2,3,14,12,1,0,8,-8,1,1,1,0,0,0,0,0,0,0.48484779035144243,0.5151522096485576
94889,0.6610169491525424,0.37735849056603776,-195,165,0.6356501330673793,0.3643498669326207,home,BAL,under,8,0.5370370370370371,-116,0.5151522096485576,BAL,LAA,2024 REG,10,11,2,3,14,12,1,0,8,-8,1,1,1,0,0,0,0,0,0,0.48484779035144243,0.5151522096485576
94901,0.5454545454545454,0.5,-120,100,0.5206611570247933,0.4793388429752067,away,SD,over,7.5,0.5348837209302326,-115,0.5097020142727117,SF,SD,2024 REG,5,3,6,2,5,11,1,0,1,-1,1,1,0,0,0,0,0,0,0,0.5097020142727117,0.49029798572728833
94901,0.5454545454545454,0.5,-120,100,0.5206611570247933,0.4793388429752067,home,SF,under,7.5,0.5121951219512195,-105,0.49029798572728833,SF,SD,2024 REG,5,3,6,2,5,11,1,0,1,-1,1,1,0,0,0,0,0,0,0,0.5097020142727117,0.49029798572728833
94903,0.6363636363636364,0.4081632653061224,-175,145,0.6080283353010626,0.3919716646989374,away,CIN,over,7.5,0.5238095238095238,-110,0.4988662131519274,PHI,CIN,2024 REG,6,1,6,4,5,12,0,1,-3,3,1,0,0,0,0,0,0,0,0,0.4988662131519274,0.5011337868480725
94903,0.6363636363636364,0.4081632653061224,-175,145,0.6080283353010626,0.3919716646989374,home,PHI,under,7.5,0.5238095238095238,-110,0.5011337868480725,PHI,CIN,2024 REG,6,1,6,4,5,12,0,1,-3,3,1,0,0,0,0,0,0,0,0,0.4988662131519274,0.5011337868480725
94905,0.6774193548387096,0.36363636363636365,-210,175,0.6496074165168858,0.3503925834831142,away,OAK,over,8.5,0.5495495495495495,-122,0.5223196169142115,TEX,OAK,2024 REG,7,3,5,4,7,12,0,1,-1,1,1,1,1,0,0,0,0,0,0,0.5223196169142115,0.47768038308578853
94905,0.6774193548387096,0.36363636363636365,-210,175,0.6496074165168858,0.3503925834831142,home,TEX,under,8.5,0.5,100,0.47768038308578853,TEX,OAK,2024 REG,7,3,5,4,7,12,0,1,-1,1,1,1,1,0,0,0,0,0,0,0.5223196169142115,0.47768038308578853
94910,0.45454545454545453,0.5850622406639003,120,-141,0.4365419567230205,0.5634580432769796,away,CHC,over,8,0.5098039215686274,-104,0.48483656587239576,SEA,CHC,2024 REG,6,1,6,4,5,12,0,1,-3,3,1,0,0,0,0,0,0,0,0,0.48483656587239576,0.5151634341276042
94910,0.45454545454545453,0.5850622406639003,120,-141,0.4365419567230205,0.5634580432769796,home,SEA,under,8,0.5391705069124424,-117,0.5151634341276042,SEA,CHC,2024 REG,6,1,6,4,5,12,0,1,-3,3,1,0,0,0,0,0,0,0,0,0.48483656587239576,0.5151634341276042
