game_id,closing_be_home,closing_be_away,closing_ml_home,closing_ml_away,home_prob,away_prob,home_away,team,over_under,line,closing_be,closing_odds,closing_prob,home,away,season_type,home_hits,home_score,away_hits,away_score,total_runs,total_hits,home_win,away_win,home_win_margin,away_win_margin,both_teams_score_1,both_teams_score_2,both_teams_score_3,both_teams_score_4,both_teams_score_5,both_teams_score_6,both_teams_score_7,both_teams_score_8,both_teams_score_9,total_over_prob,total_under_prob
85567,0.6240601503759399,0.41493775933609955,-166,141,0.5997231089766972,0.40027689102330277,away,MIL,over,8,0.5121951219512195,-105,0.48808156828023186,ARI,MIL,2022 REG,8,5,3,1,6,11,1,0,4,-4,1,0,0,0,0,0,0,0,0,0.48808156828023186,0.5119184317197681
85567,0.6240601503759399,0.41493775933609955,-166,141,0.5997231089766972,0.40027689102330277,home,ARI,under,8,0.5348837209302326,-115,0.5119184317197681,ARI,MIL,2022 REG,8,5,3,1,6,11,1,0,4,-4,1,0,0,0,0,0,0,0,0,0.48808156828023186,0.5119184317197681
85570,0.613899613899614,0.4273504273504274,-159,134,0.5885762295028705,0.4114237704971295,away,TEX,over,9.5,0.5121951219512195,-105,0.48919479393107135,BOS,TEX,2022 REG,7,5,10,3,8,17,1,0,2,-2,1,1,1,0,0,0,0,0,0,0.48919479393107135,0.5108052060689287
85570,0.613899613899614,0.4273504273504274,-159,134,0.5885762295028705,0.4114237704971295,home,BOS,under,9.5,0.5327102803738317,-114,0.5108052060689287,BOS,TEX,2022 REG,7,5,10,3,8,17,1,0,2,-2,1,1,1,0,0,0,0,0,0,0.48919479393107135,0.5108052060689287
85572,0.7601918465227817,0.2840909090909091,-317,252,0.7265284567636929,0.27347154323630707,away,ARI,over,8,0.5348837209302326,-115,0.5109810284308424,LAD,ARI,2022 REG,8,2,5,5,7,13,0,1,-3,3,1,1,0,0,0,0,0,0,0,0.5109810284308424,0.48901897156915763
85572,0.7601918465227817,0.2840909090909091,-317,252,0.7265284567636929,0.27347154323630707,home,LAD,under,8,0.5098039215686274,-104,0.48901897156915763,LAD,ARI,2022 REG,8,2,5,5,7,13,0,1,-3,3,1,1,0,0,0,0,0,0,0,0.5109810284308424,0.48901897156915763
85576,0.5901639344262295,0.4484304932735426,-144,123,0.5673868951280033,0.43261310487199667,away,CIN,over,8.5,0.5454545454545454,-120,0.5206611570247933,PIT,CIN,2022 REG,4,1,14,10,11,18,0,1,-9,9,1,0,0,0,0,0,0,0,0,0.5206611570247933,0.4793388429752067
85576,0.5901639344262295,0.4484304932735426,-144,123,0.5673868951280033,0.43261310487199667,home,PIT,under,8.5,0.5,100,0.4793388429752067,PIT,CIN,2022 REG,4,1,14,10,11,18,0,1,-9,9,1,0,0,0,0,0,0,0,0,0.5206611570247933,0.4793388429752067
85581,0.5555555555555556,0.47619047619047616,-125,110,0.5379188712522047,0.4620811287477953,away,OAK,over,8.5,0.5283018867924528,-112,0.5044173060022736,TEX,OAK,2022 REG,11,8,10,7,15,21,1,0,1,-1,1,1,1,1,1,1,1,0,0,0.5044173060022736,0.49558269399772636
85581,0.5555555555555556,0.47619047619047616,-125,110,0.5379188712522047,0.4620811287477953,home,TEX,under,8.5,0.5169082125603864,-107,0.49558269399772636,TEX,OAK,2022 REG,11,8,10,7,15,21,1,0,1,-1,1,1,1,1,1,1,1,0,0,0.5044173060022736,0.49558269399772636
85584,0.5535714285714286,0.48780487804878053,-124,105,0.53066668740667,0.46933331259333,away,TB,over,7,0.5,-100,0.4783105022831051,SEA,TB,2022 REG,11,7,13,8,15,24,0,1,-1,1,1,1,1,1,1,1,1,0,0,0.4783105022831051,0.5216894977168949
85584,0.5535714285714286,0.48780487804878053,-124,105,0.53066668740667,0.46933331259333,home,SEA,under,7,0.5433789954337899,-119,0.5216894977168949,SEA,TB,2022 REG,11,7,13,8,15,24,0,1,-1,1,1,1,1,1,1,1,1,0,0,0.4783105022831051,0.5216894977168949
85600,0.7014925373134329,0.3389830508474576,-235,195,0.6730992142751963,0.32690078572480374,away,SF,over,8,0.5238095238095238,-110,0.5012646084074657,LAD,SF,2022 REG,9,4,9,7,11,18,0,1,-3,3,1,1,1,1,0,0,0,0,0,0.5012646084074657,0.4987353915925343
85600,0.7014925373134329,0.3389830508474576,-235,195,0.6730992142751963,0.32690078572480374,home,LAD,under,8,0.5192307692307692,-108,0.4987353915925343,LAD,SF,2022 REG,9,4,9,7,11,18,0,1,-3,3,1,1,1,1,0,0,0,0,0,0.5012646084074657,0.4987353915925343
85606,0.6632996632996633,0.37735849056603776,-197,165,0.6363311235301577,0.36366887646984225,away,KC,over,8,0.5305164319248826,-113,0.5066009958897986,ARI,KC,2022 REG,9,8,9,6,14,18,1,0,2,-2,1,1,1,1,1,1,0,0,0,0.5066009958897986,0.49339900411020143
85606,0.6632996632996633,0.37735849056603776,-197,165,0.6363311235301577,0.36366887646984225,home,ARI,under,8,0.5145631067961165,-106,0.49339900411020143,ARI,KC,2022 REG,9,8,9,6,14,18,1,0,2,-2,1,1,1,1,1,1,0,0,0,0.5066009958897986,0.49339900411020143
85609,0.6254681647940076,0.41493775933609955,-167,141,0.6001955455815435,0.39980445441845647,away,TB,over,7.5,0.5391705069124424,-117,0.5140669063204599,TOR,TB,2022 REG,8,7,7,2,9,15,1,0,5,-5,1,1,0,0,0,0,0,0,0,0.5140669063204599,0.4859330936795401
85609,0.6254681647940076,0.41493775933609955,-167,141,0.6001955455815435,0.39980445441845647,home,TOR,under,7.5,0.5073891625615764,-103,0.4859330936795401,TOR,TB,2022 REG,8,7,7,2,9,15,1,0,5,-5,1,1,0,0,0,0,0,0,0,0.5140669063204599,0.4859330936795401
85612,0.6666666666666666,0.37037037037037035,-200,170,0.6419753086419753,0.3580246913580247,away,COL,over,7,0.5454545454545454,-120,0.5179608869977906,STL,COL,2022 REG,9,5,7,1,6,16,1,0,4,-4,1,0,0,0,0,0,0,0,0,0.5179608869977906,0.48203911300220936
85612,0.6666666666666666,0.37037037037037035,-200,170,0.6419753086419753,0.3580246913580247,home,STL,under,7,0.504950495049505,-102,0.48203911300220936,STL,COL,2022 REG,9,5,7,1,6,16,1,0,4,-4,1,0,0,0,0,0,0,0,0,0.5179608869977906,0.48203911300220936
85613,0.5495495495495495,0.49019607843137253,-122,104,0.5277073575960698,0.4722926424039302,away,BOS,over,8.5,0.5121951219512195,-105,0.48808156828023186,BAL,BOS,2022 REG,3,0,4,1,1,7,0,1,-1,1,0,0,0,0,0,0,0,0,0,0.48808156828023186,0.5119184317197681
85613,0.5495495495495495,0.49019607843137253,-122,104,0.5277073575960698,0.4722926424039302,home,BAL,under,8.5,0.5348837209302326,-115,0.5119184317197681,BAL,BOS,2022 REG,3,0,4,1,1,7,0,1,-1,1,0,0,0,0,0,0,0,0,0,0.48808156828023186,0.5119184317197681
85614,0.4016064257028112,0.6428571428571428,149,-180,0.3837495708594562,0.6162504291405437,away,BOS,over,8,0.5348837209302326,-115,0.5097020142727117,BAL,BOS,2022 REG,5,2,7,1,3,12,1,0,1,-1,1,0,0,0,0,0,0,0,0,0.5097020142727117,0.49029798572728833
85614,0.4016064257028112,0.6428571428571428,149,-180,0.3837495708594562,0.6162504291405437,home,BAL,under,8,0.5121951219512195,-105,0.49029798572728833,BAL,BOS,2022 REG,5,2,7,1,3,12,1,0,1,-1,1,0,0,0,0,0,0,0,0,0.5097020142727117,0.49029798572728833
85615,0.5594713656387665,0.47619047619047616,-127,110,0.5395195862893665,0.46048041371063353,away,NYY,over,7.5,0.5,100,0.4772727272727273,TB,NYY,2022 REG,11,9,5,0,9,16,1,0,9,-9,0,0,0,0,0,0,0,0,0,0.4772727272727273,0.5227272727272727
85615,0.5594713656387665,0.47619047619047616,-127,110,0.5395195862893665,0.46048041371063353,home,TB,under,7.5,0.5454545454545454,-120,0.5227272727272727,TB,NYY,2022 REG,11,9,5,0,9,16,1,0,9,-9,0,0,0,0,0,0,0,0,0,0.4772727272727273,0.5227272727272727
85616,0.4424778761061947,0.5967741935483871,126,-148,0.4251097036926629,0.5748902963073371,away,TOR,over,7.5,0.5215311004784688,-109,0.4978845547971712,STL,TOR,2022 REG,6,1,12,8,9,18,0,1,-7,7,1,0,0,0,0,0,0,0,0,0.4978845547971712,0.5021154452028288
85616,0.4424778761061947,0.5967741935483871,126,-148,0.4251097036926629,0.5748902963073371,home,STL,under,7.5,0.5238095238095238,-110,0.5021154452028288,STL,TOR,2022 REG,6,1,12,8,9,18,0,1,-7,7,1,0,0,0,0,0,0,0,0,0.4978845547971712,0.5021154452028288
85619,0.48309178743961345,0.5515695067264574,107,-123,0.46634720088595605,0.533652799114044,away,PHI,over,8.5,0.5454545454545454,-120,0.5206611570247933,SF,PHI,2022 REG,11,5,12,4,9,23,1,0,1,-1,1,1,1,1,0,0,0,0,0,0.5206611570247933,0.4793388429752067
85619,0.48309178743961345,0.5515695067264574,107,-123,0.46634720088595605,0.533652799114044,home,SF,under,8.5,0.5,100,0.4793388429752067,SF,PHI,2022 REG,11,5,12,4,9,23,1,0,1,-1,1,1,1,1,0,0,0,0,0,0.5206611570247933,0.4793388429752067
85621,0.45454545454545453,0.5798319327731092,120,-138,0.4389193694006528,0.5610806305993472,away,MIL,over,11.5,0.5327102803738317,-114,0.508788710910954,COL,MIL,2022 REG,5,4,9,6,10,14,0,1,-2,2,1,1,1,1,0,0,0,0,0,0.508788710910954,0.491211289089046
85621,0.45454545454545453,0.5798319327731092,120,-138,0.4389193694006528,0.5610806305993472,home,COL,under,11.5,0.5121951219512195,-105,0.491211289089046,COL,MIL,2022 REG,5,4,9,6,10,14,0,1,-2,2,1,1,1,1,0,0,0,0,0,0.508788710910954,0.491211289089046
85622,0.75,0.29411764705882354,-300,240,0.7169117647058822,0.28308823529411775,away,DET,over,8.5,0.5348837209302326,-115,0.5097020142727117,TOR,DET,2022 REG,6,4,3,1,5,9,1,0,3,-3,1,0,0,0,0,0,0,0,0,0.5097020142727117,0.49029798572728833
85622,0.75,0.29411764705882354,-300,240,0.7169117647058822,0.28308823529411775,home,TOR,under,8.5,0.5121951219512195,-105,0.49029798572728833,TOR,DET,2022 REG,6,4,3,1,5,9,1,0,3,-3,1,0,0,0,0,0,0,0,0,0.5097020142727117,0.49029798572728833
85623,0.5815899581589958,0.4566210045662101,-139,119,0.5593668459464284,0.4406331540535716,away,BOS,over,9,0.5370370370370371,-116,0.5118817074154765,TOR,BOS,2022 REG,13,6,10,5,11,23,1,0,1,-1,1,1,1,1,1,0,0,0,0,0.5118817074154765,0.48811829258452355
85623,0.5815899581589958,0.4566210045662101,-139,119,0.5593668459464284,0.4406331540535716,home,TOR,under,9,0.5098039215686274,-104,0.48811829258452355,TOR,BOS,2022 REG,13,6,10,5,11,23,1,0,1,-1,1,1,1,1,1,0,0,0,0,0.5118817074154765,0.48811829258452355
85626,0.5495495495495495,0.4926108374384236,-122,103,0.5263803278714742,0.47361967212852585,away,PHI,over,8,0.5169082125603864,-107,0.49353874091423283,TOR,PHI,2022 REG,11,8,2,2,10,13,1,0,6,-6,1,1,0,0,0,0,0,0,0,0.49353874091423283,0.5064612590857671
85626,0.5495495495495495,0.4926108374384236,-122,103,0.5263803278714742,0.47361967212852585,home,TOR,under,8,0.5283018867924528,-112,0.5064612590857671,TOR,PHI,2022 REG,11,8,2,2,10,13,1,0,6,-6,1,1,0,0,0,0,0,0,0,0.49353874091423283,0.5064612590857671
85627,0.5614035087719298,0.4716981132075471,-128,112,0.5428201420466094,0.45717985795339056,away,LAA,over,8,0.5327102803738317,-114,0.508788710910954,CLE,LAA,2022 REG,9,3,4,1,4,13,1,0,2,-2,1,0,0,0,0,0,0,0,0,0.508788710910954,0.491211289089046
85627,0.5614035087719298,0.4716981132075471,-128,112,0.5428201420466094,0.45717985795339056,home,CLE,under,8,0.5121951219512195,-105,0.491211289089046,CLE,LAA,2022 REG,9,3,4,1,4,13,1,0,2,-2,1,0,0,0,0,0,0,0,0,0.508788710910954,0.491211289089046
85629,0.5652173913043479,0.4716981132075471,-130,112,0.5443521061454507,0.4556478938545493,away,MIN,over,9.5,0.5098039215686274,-104,0.48592421718142587,BOS,MIN,2022 REG,6,4,5,0,4,11,1,0,4,-4,0,0,0,0,0,0,0,0,0,0.48592421718142587,0.5140757828185741
85629,0.5652173913043479,0.4716981132075471,-130,112,0.5443521061454507,0.4556478938545493,home,BOS,under,9.5,0.5370370370370371,-116,0.5140757828185741,BOS,MIN,2022 REG,6,4,5,0,4,11,1,0,4,-4,0,0,0,0,0,0,0,0,0,0.48592421718142587,0.5140757828185741
85630,0.5726495726495727,0.4672897196261683,-134,114,0.5497783539959433,0.4502216460040567,away,HOU,over,8.5,0.5238095238095238,-110,0.5000596729920038,TOR,HOU,2022 REG,6,2,8,1,3,14,1,0,1,-1,1,0,0,0,0,0,0,0,0,0.5000596729920038,0.4999403270079962
85630,0.5726495726495727,0.4672897196261683,-134,114,0.5497783539959433,0.4502216460040567,home,TOR,under,8.5,0.5215311004784688,-109,0.4999403270079962,TOR,HOU,2022 REG,6,2,8,1,3,14,1,0,1,-1,1,0,0,0,0,0,0,0,0,0.5000596729920038,0.4999403270079962
85631,0.49751243781094534,0.5454545454545454,101,-120,0.476135829221149,0.523864170778851,away,CWS,over,8,0.5433789954337899,-119,0.5184560714286826,TEX,CWS,2022 REG,7,8,2,0,8,9,1,0,8,-8,0,0,0,0,0,0,0,0,0,0.5184560714286826,0.48154392857131745
85631,0.49751243781094534,0.5454545454545454,101,-120,0.476135829221149,0.523864170778851,home,TEX,under,8,0.5024875621890548,-101,0.48154392857131745,TEX,CWS,2022 REG,7,8,2,0,8,9,1,0,8,-8,0,0,0,0,0,0,0,0,0,0.5184560714286826,0.48154392857131745
85635,0.6296296296296295,0.4081632653061224,-170,145,0.6058341031886005,0.39416589681139946,away,OAK,over,7.5,0.5121951219512195,-105,0.48808156828023186,SF,OAK,2022 REG,3,0,7,1,1,10,0,1,-1,1,0,0,0,0,0,0,0,0,0,0.48808156828023186,0.5119184317197681
85635,0.6296296296296295,0.4081632653061224,-170,145,0.6058341031886005,0.39416589681139946,home,SF,under,7.5,0.5348837209302326,-115,0.5119184317197681,SF,OAK,2022 REG,3,0,7,1,1,10,0,1,-1,1,0,0,0,0,0,0,0,0,0,0.48808156828023186,0.5119184317197681
85636,0.5121951219512195,0.5305164319248826,-105,-113,0.4903184724049234,0.5096815275950766,away,TOR,over,8,0.5121951219512195,-105,0.48808156828023186,NYY,TOR,2022 REG,4,0,8,4,4,12,0,1,-4,4,0,0,0,0,0,0,0,0,0,0.48808156828023186,0.5119184317197681
85636,0.5121951219512195,0.5305164319248826,-105,-113,0.4903184724049234,0.5096815275950766,home,NYY,under,8,0.5348837209302326,-115,0.5119184317197681,NYY,TOR,2022 REG,4,0,8,4,4,12,0,1,-4,4,0,0,0,0,0,0,0,0,0,0.48808156828023186,0.5119184317197681
85644,0.5454545454545454,0.5,-120,100,0.5206611570247933,0.4793388429752067,away,TEX,over,10,0.5098039215686274,-104,0.4870219861770517,BOS,TEX,2022 REG,12,5,4,2,7,16,1,0,3,-3,1,1,0,0,0,0,0,0,0,0.4870219861770517,0.5129780138229483
85644,0.5454545454545454,0.5,-120,100,0.5206611570247933,0.4793388429752067,home,BOS,under,10,0.5348837209302326,-115,0.5129780138229483,BOS,TEX,2022 REG,12,5,4,2,7,16,1,0,3,-3,1,1,0,0,0,0,0,0,0,0.4870219861770517,0.5129780138229483
85645,0.4329004329004329,0.6062992125984252,131,-154,0.4159308893944337,0.5840691106055663,away,SEA,over,7.5,0.5,100,0.4772727272727273,DET,SEA,2022 REG,4,0,10,7,7,14,0,1,-7,7,0,0,0,0,0,0,0,0,0,0.4772727272727273,0.5227272727272727
85645,0.4329004329004329,0.6062992125984252,131,-154,0.4159308893944337,0.5840691106055663,home,DET,under,7.5,0.5454545454545454,-120,0.5227272727272727,DET,SEA,2022 REG,4,0,10,7,7,14,0,1,-7,7,0,0,0,0,0,0,0,0,0,0.4772727272727273,0.5227272727272727
85646,0.47846889952153115,0.5594713656387665,109,-127,0.4603156626027285,0.5396843373972715,away,MIA,over,7.5,0.5305164319248826,-113,0.5066009958897986,WSH,MIA,2022 REG,8,5,11,4,9,19,1,0,1,-1,1,1,1,1,0,0,0,0,0,0.5066009958897986,0.49339900411020143
85646,0.47846889952153115,0.5594713656387665,109,-127,0.4603156626027285,0.5396843373972715,home,WSH,under,7.5,0.5145631067961165,-106,0.49339900411020143,WSH,MIA,2022 REG,8,5,11,4,9,19,1,0,1,-1,1,1,1,1,0,0,0,0,0,0.5066009958897986,0.49339900411020143
85647,0.24271844660194175,0.7967479674796748,312,-392,0.2331392198831028,0.7668607801168972,away,NYM,over,6.5,0.5412844036697247,-118,0.5162581740877563,OAK,NYM,2022 REG,14,10,9,4,14,23,1,0,6,-6,1,1,1,1,0,0,0,0,0,0.5162581740877563,0.4837418259122437
85647,0.24271844660194175,0.7967479674796748,312,-392,0.2331392198831028,0.7668607801168972,home,OAK,under,6.5,0.504950495049505,-102,0.4837418259122437,OAK,NYM,2022 REG,14,10,9,4,14,23,1,0,6,-6,1,1,1,1,0,0,0,0,0,0.5162581740877563,0.4837418259122437
85648,0.5215311004784688,0.5192307692307692,-109,-108,0.50027251771145,0.49972748228855,away,MIN,over,8,0.5098039215686274,-104,0.48592421718142587,CLE,MIN,2022 REG,3,0,10,3,3,13,0,1,-3,3,0,0,0,0,0,0,0,0,0,0.48592421718142587,0.5140757828185741
85648,0.5215311004784688,0.5192307692307692,-109,-108,0.50027251771145,0.49972748228855,home,CLE,under,8,0.5370370370370371,-116,0.5140757828185741,CLE,MIN,2022 REG,3,0,10,3,3,13,0,1,-3,3,0,0,0,0,0,0,0,0,0,0.48592421718142587,0.5140757828185741
85649,0.5833333333333333,0.45454545454545453,-140,120,0.5612373737373737,0.4387626262626263,away,SEA,over,7.5,0.5192307692307692,-108,0.49571111079951763,TB,SEA,2022 REG,7,3,5,2,5,12,1,0,1,-1,1,1,0,0,0,0,0,0,0,0.49571111079951763,0.5042888892004824
85649,0.5833333333333333,0.45454545454545453,-140,120,0.5612373737373737,0.4387626262626263,home,TB,under,7.5,0.5260663507109005,-111,0.5042888892004824,TB,SEA,2022 REG,7,3,5,2,5,12,1,0,1,-1,1,1,0,0,0,0,0,0,0,0.49571111079951763,0.5042888892004824
85651,0.5391705069124424,0.5024875621890548,-117,-101,0.5167097046779946,0.4832902953220054,away,SF,over,11.5,0.5121951219512195,-105,0.48919479393107135,COL,SF,2022 REG,10,3,9,6,9,19,0,1,-3,3,1,1,1,0,0,0,0,0,0,0.48919479393107135,0.5108052060689287
85651,0.5391705069124424,0.5024875621890548,-117,-101,0.5167097046779946,0.4832902953220054,home,COL,under,11.5,0.5327102803738317,-114,0.5108052060689287,COL,SF,2022 REG,10,3,9,6,9,19,0,1,-3,3,1,1,1,0,0,0,0,0,0,0.48919479393107135,0.5108052060689287
85652,0.574468085106383,0.46511627906976744,-135,115,0.5517281312179562,0.44827186878204384,away,LAA,over,7.5,0.5,100,0.4772727272727273,OAK,LAA,2022 REG,5,4,8,3,7,13,1,0,1,-1,1,1,1,0,0,0,0,0,0,0.4772727272727273,0.5227272727272727
85652,0.574468085106383,0.46511627906976744,-135,115,0.5517281312179562,0.44827186878204384,home,OAK,under,7.5,0.5454545454545454,-120,0.5227272727272727,OAK,LAA,2022 REG,5,4,8,3,7,13,1,0,1,-1,1,1,1,0,0,0,0,0,0,0.4772727272727273,0.5227272727272727
85653,0.5934959349593496,0.4484304932735426,-146,123,0.5686127702357632,0.4313872297642368,away,TB,over,9,0.49504950495049505,102,0.4739797934813417,CWS,TB,2022 REG,7,3,5,2,5,12,1,0,1,-1,1,1,0,0,0,0,0,0,0,0.4739797934813417,0.5260202065186583
85653,0.5934959349593496,0.4484304932735426,-146,123,0.5686127702357632,0.4313872297642368,home,CWS,under,9,0.5475113122171946,-121,0.5260202065186583,CWS,TB,2022 REG,7,3,5,2,5,12,1,0,1,-1,1,1,0,0,0,0,0,0,0,0.4739797934813417,0.5260202065186583
85655,0.4347826086956522,0.607843137254902,130,-155,0.41624967567367205,0.583750324326328,away,SF,over,8,0.5391705069124424,-117,0.5140669063204599,CLE,SF,2022 REG,3,1,8,4,5,11,0,1,-3,3,1,0,0,0,0,0,0,0,0,0.5140669063204599,0.4859330936795401
85655,0.4347826086956522,0.607843137254902,130,-155,0.41624967567367205,0.583750324326328,home,CLE,under,8,0.5073891625615764,-103,0.4859330936795401,CLE,SF,2022 REG,3,1,8,4,5,11,0,1,-3,3,1,0,0,0,0,0,0,0,0,0.5140669063204599,0.4859330936795401
85657,0.4854368932038835,0.5555555555555556,106,-125,0.465537646233282,0.534462353766718,away,TEX,over,8,0.5238095238095238,-110,0.4988662131519274,SEA,TEX,2022 REG,6,4,6,2,6,12,1,0,2,-2,1,1,0,0,0,0,0,0,0,0.4988662131519274,0.5011337868480725
85657,0.4854368932038835,0.5555555555555556,106,-125,0.465537646233282,0.534462353766718,home,SEA,under,8,0.5238095238095238,-110,0.5011337868480725,SEA,TEX,2022 REG,6,4,6,2,6,12,1,0,2,-2,1,1,0,0,0,0,0,0,0,0.4988662131519274,0.5011337868480725
85658,0.37735849056603776,0.6610169491525424,165,-195,0.36287719255902645,0.6371228074409736,away,SD,over,7.5,0.5,100,0.47935779816513757,PIT,SD,2022 REG,8,2,11,5,7,19,0,1,-3,3,1,1,0,0,0,0,0,0,0,0.47935779816513757,0.5206422018348624
85658,0.37735849056603776,0.6610169491525424,165,-195,0.36287719255902645,0.6371228074409736,home,PIT,under,7.5,0.5412844036697247,-118,0.5206422018348624,PIT,SD,2022 REG,8,2,11,5,7,19,0,1,-3,3,1,1,0,0,0,0,0,0,0,0.47935779816513757,0.5206422018348624
85661,0.5555555555555556,0.48780487804878053,-125,105,0.5314664257753688,0.46853357422463116,away,CHC,over,8.5,0.5238095238095238,-110,0.5012646084074657,ARI,CHC,2022 REG,6,2,8,3,5,14,0,1,-1,1,1,1,0,0,0,0,0,0,0,0.5012646084074657,0.4987353915925343
85661,0.5555555555555556,0.48780487804878053,-125,105,0.5314664257753688,0.46853357422463116,home,ARI,under,8.5,0.5192307692307692,-108,0.4987353915925343,ARI,CHC,2022 REG,6,2,8,3,5,14,0,1,-1,1,1,1,0,0,0,0,0,0,0,0.5012646084074657,0.4987353915925343
85662,0.6774193548387096,0.36101083032490977,-210,177,0.6513860035988384,0.34861399640116164,away,PHI,over,7.5,0.5433789954337899,-119,0.5171177654451503,ATL,PHI,2022 REG,7,7,6,2,9,13,1,0,5,-5,1,1,0,0,0,0,0,0,0,0.5171177654451503,0.4828822345548497
85662,0.6774193548387096,0.36101083032490977,-210,177,0.6513860035988384,0.34861399640116164,home,ATL,under,7.5,0.504950495049505,-102,0.4828822345548497,ATL,PHI,2022 REG,7,7,6,2,9,13,1,0,5,-5,1,1,0,0,0,0,0,0,0,0.5171177654451503,0.4828822345548497
85665,0.7409326424870467,0.29850746268656714,-286,235,0.7117101811407941,0.2882898188592059,away,WSH,over,7.5,0.5,100,0.4772727272727273,SEA,WSH,2022 REG,6,4,5,2,6,11,1,0,2,-2,1,1,0,0,0,0,0,0,0,0.4772727272727273,0.5227272727272727
85665,0.7409326424870467,0.29850746268656714,-286,235,0.7117101811407941,0.2882898188592059,home,SEA,under,7.5,0.5454545454545454,-120,0.5227272727272727,SEA,WSH,2022 REG,6,4,5,2,6,11,1,0,2,-2,1,1,0,0,0,0,0,0,0,0.4772727272727273,0.5227272727272727
85670,0.3802281368821293,0.6575342465753424,163,-192,0.3658698161758662,0.6341301838241338,away,STL,over,8,0.5238095238095238,-110,0.4953530708057871,CHC,STL,2022 REG,5,2,5,0,2,10,1,0,2,-2,0,0,0,0,0,0,0,0,0,0.4953530708057871,0.5046469291942128
85670,0.3802281368821293,0.6575342465753424,163,-192,0.3658698161758662,0.6341301838241338,home,CHC,under,8,0.5305164319248826,-113,0.5046469291942128,CHC,STL,2022 REG,5,2,5,0,2,10,1,0,2,-2,0,0,0,0,0,0,0,0,0,0.4953530708057871,0.5046469291942128
85673,0.75,0.2881844380403458,-300,247,0.7213616714697406,0.2786383285302594,away,OAK,over,8,0.5327102803738317,-114,0.5075272610403079,NYY,OAK,2022 REG,8,9,6,5,14,14,1,0,4,-4,1,1,1,1,1,0,0,0,0,0.5075272610403079,0.4924727389596921
85673,0.75,0.2881844380403458,-300,247,0.7213616714697406,0.2786383285302594,home,NYY,under,8,0.5145631067961165,-106,0.4924727389596921,NYY,OAK,2022 REG,8,9,6,5,14,14,1,0,4,-4,1,1,1,1,1,0,0,0,0,0.5075272610403079,0.4924727389596921
85674,0.7542997542997544,0.2881844380403458,-307,247,0.7222539384559933,0.2777460615440067,away,WSH,over,7.5,0.5238095238095238,-110,0.4988662131519274,SD,WSH,2022 REG,5,2,7,1,3,12,1,0,1,-1,1,0,0,0,0,0,0,0,0,0.4988662131519274,0.5011337868480725
85674,0.7542997542997544,0.2881844380403458,-307,247,0.7222539384559933,0.2777460615440067,home,SD,under,7.5,0.5238095238095238,-110,0.5011337868480725,SD,WSH,2022 REG,5,2,7,1,3,12,1,0,1,-1,1,0,0,0,0,0,0,0,0,0.4988662131519274,0.5011337868480725
85682,0.5689655172413793,0.4716981132075471,-132,112,0.5458293137100936,0.4541706862899064,away,MIN,over,7.5,0.5327102803738317,-114,0.508788710910954,TB,MIN,2022 REG,8,6,3,1,7,11,1,0,5,-5,1,0,0,0,0,0,0,0,0,0.508788710910954,0.491211289089046
85682,0.5689655172413793,0.4716981132075471,-132,112,0.5458293137100936,0.4541706862899064,home,TB,under,7.5,0.5121951219512195,-105,0.491211289089046,TB,MIN,2022 REG,8,6,3,1,7,11,1,0,5,-5,1,0,0,0,0,0,0,0,0,0.508788710910954,0.491211289089046
85683,0.43103448275862066,0.607843137254902,132,-155,0.4142768879252058,0.5857231120747942,away,NYY,over,8.5,0.5098039215686274,-104,0.48592421718142587,CWS,NYY,2022 REG,11,3,9,2,5,20,1,0,1,-1,1,1,0,0,0,0,0,0,0,0.48592421718142587,0.5140757828185741
85683,0.43103448275862066,0.607843137254902,132,-155,0.4142768879252058,0.5857231120747942,home,CWS,under,8.5,0.5370370370370371,-116,0.5140757828185741,CWS,NYY,2022 REG,11,3,9,2,5,20,1,0,1,-1,1,1,0,0,0,0,0,0,0,0.48592421718142587,0.5140757828185741
85685,0.49751243781094534,0.5391705069124424,101,-117,0.4792622165555285,0.5207377834444715,away,ATL,over,7,0.5433789954337899,-119,0.5171177654451503,SEA,ATL,2022 REG,6,4,10,6,10,16,0,1,-2,2,1,1,1,1,0,0,0,0,0,0.5171177654451503,0.4828822345548497
85685,0.49751243781094534,0.5391705069124424,101,-117,0.4792622165555285,0.5207377834444715,home,SEA,under,7,0.504950495049505,-102,0.4828822345548497,SEA,ATL,2022 REG,6,4,10,6,10,16,0,1,-2,2,1,1,1,1,0,0,0,0,0,0.5171177654451503,0.4828822345548497
85686,0.5934959349593496,0.4464285714285714,-146,124,0.5698009027128599,0.4301990972871401,away,TB,over,8.5,0.5215311004784688,-109,0.4978845547971712,CWS,TB,2022 REG,6,3,6,2,5,12,1,0,1,-1,1,1,0,0,0,0,0,0,0,0.4978845547971712,0.5021154452028288
85686,0.5934959349593496,0.4464285714285714,-146,124,0.5698009027128599,0.4301990972871401,home,CWS,under,8.5,0.5238095238095238,-110,0.5021154452028288,CWS,TB,2022 REG,6,3,6,2,5,12,1,0,1,-1,1,1,0,0,0,0,0,0,0,0.4978845547971712,0.5021154452028288
85690,0.7198879551820728,0.3205128205128205,-257,212,0.6908039233793066,0.30919607662069337,away,CIN,over,8,0.5121951219512195,-105,0.48808156828023186,STL,CIN,2022 REG,2,0,10,3,3,12,0,1,-3,3,0,0,0,0,0,0,0,0,0,0.48808156828023186,0.5119184317197681
85690,0.7198879551820728,0.3205128205128205,-257,212,0.6908039233793066,0.30919607662069337,home,STL,under,8,0.5348837209302326,-115,0.5119184317197681,STL,CIN,2022 REG,2,0,10,3,3,12,0,1,-3,3,0,0,0,0,0,0,0,0,0,0.48808156828023186,0.5119184317197681
85692,0.6551724137931035,0.3846153846153846,-190,160,0.6291045458703008,0.37089545412969915,away,DET,over,9,0.5412844036697247,-118,0.5136310900085983,MIN,DET,2022 REG,7,3,7,5,8,14,0,1,-2,2,1,1,1,0,0,0,0,0,0,0.5136310900085983,0.4863689099914017
85692,0.6551724137931035,0.3846153846153846,-190,160,0.6291045458703008,0.37089545412969915,home,MIN,under,9,0.5098039215686274,-104,0.4863689099914017,MIN,DET,2022 REG,7,3,7,5,8,14,0,1,-2,2,1,1,1,0,0,0,0,0,0,0.5136310900085983,0.4863689099914017
85693,0.44052863436123346,0.6000000000000001,127,-150,0.42267461041355353,0.5773253895864465,away,LAD,over,7.5,0.5238095238095238,-110,0.4988662131519274,SD,LAD,2022 REG,7,0,5,1,1,12,0,1,-1,1,0,0,0,0,0,0,0,0,0,0.4988662131519274,0.5011337868480725
85693,0.44052863436123346,0.6000000000000001,127,-150,0.42267461041355353,0.5773253895864465,home,SD,under,7.5,0.5238095238095238,-110,0.5011337868480725,SD,LAD,2022 REG,7,0,5,1,1,12,0,1,-1,1,0,0,0,0,0,0,0,0,0,0.4988662131519274,0.5011337868480725
85694,0.6923076923076923,0.35460992907801414,-225,182,0.6598262621175878,0.34017373788241223,away,TEX,over,7,0.5238095238095238,-110,0.5012646084074657,NYY,TEX,2022 REG,3,2,7,4,6,10,0,1,-2,2,1,1,0,0,0,0,0,0,0,0.5012646084074657,0.4987353915925343
85694,0.6923076923076923,0.35460992907801414,-225,182,0.6598262621175878,0.34017373788241223,home,NYY,under,7,0.5192307692307692,-108,0.4987353915925343,NYY,TEX,2022 REG,3,2,7,4,6,10,0,1,-2,2,1,1,0,0,0,0,0,0,0,0.5012646084074657,0.4987353915925343
85695,0.5327102803738317,0.5121951219512195,-114,-105,0.508788710910954,0.491211289089046,away,SEA,over,8,0.5073891625615764,-103,0.4837652908580103,MIN,SEA,2022 REG,4,1,5,2,3,9,0,1,-1,1,1,0,0,0,0,0,0,0,0,0.4837652908580103,0.5162347091419897
85695,0.5327102803738317,0.5121951219512195,-114,-105,0.508788710910954,0.491211289089046,home,MIN,under,8,0.5391705069124424,-117,0.5162347091419897,MIN,SEA,2022 REG,4,1,5,2,3,9,0,1,-1,1,1,0,0,0,0,0,0,0,0,0.4837652908580103,0.5162347091419897
85696,0.43859649122807015,0.6000000000000001,128,-150,0.4216682056017235,0.5783317943982764,away,TB,over,9.5,0.5348837209302326,-115,0.5097020142727117,CIN,TB,2022 REG,13,5,8,4,9,21,1,0,1,-1,1,1,1,1,0,0,0,0,0,0.5097020142727117,0.49029798572728833
85696,0.43859649122807015,0.6000000000000001,128,-150,0.4216682056017235,0.5783317943982764,home,CIN,under,9.5,0.5121951219512195,-105,0.49029798572728833,CIN,TB,2022 REG,13,5,8,4,9,21,1,0,1,-1,1,1,1,1,0,0,0,0,0,0.5097020142727117,0.49029798572728833
85697,0.5983935742971888,0.43859649122807015,-149,128,0.5762589567740419,0.42374104322595807,away,TOR,over,8.5,0.5283018867924528,-112,0.5044173060022736,NYY,TOR,2022 REG,10,4,8,6,10,18,0,1,-2,2,1,1,1,1,0,0,0,0,0,0.5044173060022736,0.49558269399772636
85697,0.5983935742971888,0.43859649122807015,-149,128,0.5762589567740419,0.42374104322595807,home,NYY,under,8.5,0.5169082125603864,-107,0.49558269399772636,NYY,TOR,2022 REG,10,4,8,6,10,18,0,1,-2,2,1,1,1,1,0,0,0,0,0,0.5044173060022736,0.49558269399772636
85699,0.4716981132075471,0.5670995670995671,112,-131,0.4533973206098518,0.5466026793901482,away,CWS,over,7.5,0.5348837209302326,-115,0.5097020142727117,BOS,CWS,2022 REG,7,1,11,3,4,18,0,1,-2,2,1,0,0,0,0,0,0,0,0,0.5097020142727117,0.49029798572728833
85699,0.4716981132075471,0.5670995670995671,112,-131,0.4533973206098518,0.5466026793901482,home,BOS,under,7.5,0.5121951219512195,-105,0.49029798572728833,BOS,CWS,2022 REG,7,1,11,3,4,18,0,1,-2,2,1,0,0,0,0,0,0,0,0,0.5097020142727117,0.49029798572728833
85703,0.3508771929824561,0.6845425867507886,185,-217,0.3384492000935983,0.6615507999064016,away,SF,over,7.5,0.5283018867924528,-112,0.5044173060022736,DET,SF,2022 REG,7,1,5,3,4,12,0,1,-2,2,1,0,0,0,0,0,0,0,0,0.5044173060022736,0.49558269399772636
85703,0.3508771929824561,0.6845425867507886,185,-217,0.3384492000935983,0.6615507999064016,home,DET,under,7.5,0.5169082125603864,-107,0.49558269399772636,DET,SF,2022 REG,7,1,5,3,4,12,0,1,-2,2,1,0,0,0,0,0,0,0,0,0.5044173060022736,0.49558269399772636
85706,0.6610169491525424,0.37735849056603776,-195,165,0.6356501330673793,0.3643498669326207,away,ARI,over,8.5,0.5,100,0.47935779816513757,NYM,ARI,2022 REG,6,5,5,0,5,11,1,0,5,-5,0,0,0,0,0,0,0,0,0,0.47935779816513757,0.5206422018348624
85706,0.6610169491525424,0.37735849056603776,-195,165,0.6356501330673793,0.3643498669326207,home,NYM,under,8.5,0.5412844036697247,-118,0.5206422018348624,NYM,ARI,2022 REG,6,5,5,0,5,11,1,0,5,-5,0,0,0,0,0,0,0,0,0,0.47935779816513757,0.5206422018348624
85707,0.37593984962406013,0.6632996632996633,166,-197,0.3611881530361942,0.6388118469638058,away,HOU,over,8,0.5238095238095238,-110,0.5000596729920038,WSH,HOU,2022 REG,4,0,11,8,8,15,0,1,-8,8,0,0,0,0,0,0,0,0,0,0.5000596729920038,0.4999403270079962
85707,0.37593984962406013,0.6632996632996633,166,-197,0.3611881530361942,0.6388118469638058,home,WSH,under,8,0.5215311004784688,-109,0.4999403270079962,WSH,HOU,2022 REG,4,0,11,8,8,15,0,1,-8,8,0,0,0,0,0,0,0,0,0,0.5000596729920038,0.4999403270079962
85710,0.4347826086956522,0.6031746031746031,130,-152,0.418279473099889,0.581720526900111,away,MIL,over,8.5,0.5238095238095238,-110,0.4988662131519274,CIN,MIL,2022 REG,6,2,5,1,3,11,1,0,1,-1,1,0,0,0,0,0,0,0,0,0.4988662131519274,0.5011337868480725
85710,0.4347826086956522,0.6031746031746031,130,-152,0.418279473099889,0.581720526900111,home,CIN,under,8.5,0.5238095238095238,-110,0.5011337868480725,CIN,MIL,2022 REG,6,2,5,1,3,11,1,0,1,-1,1,0,0,0,0,0,0,0,0,0.4988662131519274,0.5011337868480725
85714,0.5983935742971888,0.4444444444444444,-149,125,0.5727595791465728,0.42724042085342717,away,OAK,over,6.5,0.5454545454545454,-120,0.5193043049216726,SEA,OAK,2022 REG,5,2,4,1,3,9,1,0,1,-1,1,0,0,0,0,0,0,0,0,0.5193043049216726,0.48069569507832743
85714,0.5983935742971888,0.4444444444444444,-149,125,0.5727595791465728,0.42724042085342717,home,SEA,under,6.5,0.5024875621890548,-101,0.48069569507832743,SEA,OAK,2022 REG,5,2,4,1,3,9,1,0,1,-1,1,0,0,0,0,0,0,0,0,0.5193043049216726,0.48069569507832743
85715,0.4366812227074236,0.601593625498008,129,-151,0.4199673151941347,0.5800326848058652,away,KC,over,8,0.5260663507109005,-111,0.5022370601254724,OAK,KC,2022 REG,9,4,3,0,4,12,1,0,4,-4,0,0,0,0,0,0,0,0,0,0.5022370601254724,0.4977629398745276
85715,0.4366812227074236,0.601593625498008,129,-151,0.4199673151941347,0.5800326848058652,home,OAK,under,8,0.5192307692307692,-108,0.4977629398745276,OAK,KC,2022 REG,9,4,3,0,4,12,1,0,4,-4,0,0,0,0,0,0,0,0,0,0.5022370601254724,0.4977629398745276
85717,0.607843137254902,0.4291845493562232,-155,133,0.5853361120599043,0.4146638879400957,away,TB,over,6.5,0.5238095238095238,-110,0.4988662131519274,CLE,TB,2022 REG,14,5,7,6,11,21,0,1,-1,1,1,1,1,1,1,0,0,0,0,0.4988662131519274,0.5011337868480725
85717,0.607843137254902,0.4291845493562232,-155,133,0.5853361120599043,0.4146638879400957,home,CLE,under,6.5,0.5238095238095238,-110,0.5011337868480725,CLE,TB,2022 REG,14,5,7,6,11,21,0,1,-1,1,1,1,1,1,1,0,0,0,0,0.4988662131519274,0.5011337868480725
85719,0.36900369003690037,0.6688741721854304,171,-202,0.35502661910615096,0.644973380893849,away,PHI,over,8,0.5348837209302326,-115,0.5097020142727117,WSH,PHI,2022 REG,6,2,10,8,10,16,0,1,-6,6,1,1,0,0,0,0,0,0,0,0.5097020142727117,0.49029798572728833
85719,0.36900369003690037,0.6688741721854304,171,-202,0.35502661910615096,0.644973380893849,home,WSH,under,8,0.5121951219512195,-105,0.49029798572728833,WSH,PHI,2022 REG,6,2,10,8,10,16,0,1,-6,6,1,1,0,0,0,0,0,0,0,0.5097020142727117,0.49029798572728833
85721,0.43103448275862066,0.6108949416342413,132,-157,0.41296145500307674,0.5870385449969233,away,TOR,over,8,0.5073891625615764,-103,0.4859403596076043,TEX,TOR,2022 REG,7,3,10,4,7,17,0,1,-1,1,1,1,1,0,0,0,0,0,0,0.4859403596076043,0.5140596403923957
85721,0.43103448275862066,0.6108949416342413,132,-157,0.41296145500307674,0.5870385449969233,home,TEX,under,8,0.5348837209302326,-115,0.5140596403923957,TEX,TOR,2022 REG,7,3,10,4,7,17,0,1,-1,1,1,1,1,0,0,0,0,0,0,0.4859403596076043,0.5140596403923957
85723,0.5918367346938775,0.45248868778280543,-145,121,0.5656033213913509,0.43439667860864906,away,TEX,over,7.5,0.5305164319248826,-113,0.5078572507605655,SEA,TEX,2022 REG,7,6,6,2,8,13,1,0,4,-4,1,1,0,0,0,0,0,0,0,0.5078572507605655,0.49214274923943446
85723,0.5918367346938775,0.45248868778280543,-145,121,0.5656033213913509,0.43439667860864906,home,SEA,under,7.5,0.5121951219512195,-105,0.49214274923943446,SEA,TEX,2022 REG,7,6,6,2,8,13,1,0,4,-4,1,1,0,0,0,0,0,0,0,0.5078572507605655,0.49214274923943446
85724,0.4424778761061947,0.601593625498008,126,-151,0.4229772116795563,0.5770227883204437,away,CLE,over,8.5,0.5238095238095238,-110,0.4988662131519274,DET,CLE,2022 REG,7,3,8,4,7,15,0,1,-1,1,1,1,1,0,0,0,0,0,0,0.4988662131519274,0.5011337868480725
85724,0.4424778761061947,0.601593625498008,126,-151,0.4229772116795563,0.5770227883204437,home,DET,under,8.5,0.5238095238095238,-110,0.5011337868480725,DET,CLE,2022 REG,7,3,8,4,7,15,0,1,-1,1,1,1,1,0,0,0,0,0,0,0.4988662131519274,0.5011337868480725
85726,0.6845425867507886,0.36101083032490977,-217,177,0.6533593327904526,0.34664066720954745,away,OAK,over,7.5,0.5238095238095238,-110,0.4930654432315562,MIN,OAK,2022 REG,5,1,3,0,1,8,1,0,1,-1,0,0,0,0,0,0,0,0,0,0.4930654432315562,0.5069345567684438
85726,0.6845425867507886,0.36101083032490977,-217,177,0.6533593327904526,0.34664066720954745,home,MIN,under,7.5,0.5348837209302326,-115,0.5069345567684438,MIN,OAK,2022 REG,5,1,3,0,1,8,1,0,1,-1,0,0,0,0,0,0,0,0,0,0.4930654432315562,0.5069345567684438
85729,0.5815899581589958,0.4587155963302753,-139,118,0.5581486524100054,0.44185134758999456,away,HOU,over,6,0.5348837209302326,-115,0.5097020142727117,TB,HOU,2022 REG,3,0,8,5,5,11,0,1,-5,5,0,0,0,0,0,0,0,0,0,0.5097020142727117,0.49029798572728833
85729,0.5815899581589958,0.4587155963302753,-139,118,0.5581486524100054,0.44185134758999456,home,TB,under,6,0.5121951219512195,-105,0.49029798572728833,TB,HOU,2022 REG,3,0,8,5,5,11,0,1,-5,5,0,0,0,0,0,0,0,0,0,0.5097020142727117,0.49029798572728833
85731,0.7222222222222222,0.31545741324921134,-260,217,0.6950091521595202,0.3049908478404798,away,CIN,over,8.5,0.5370370370370371,-116,0.5118817074154765,STL,CIN,2022 REG,9,5,8,1,6,17,1,0,4,-4,1,0,0,0,0,0,0,0,0,0.5118817074154765,0.48811829258452355
85731,0.7222222222222222,0.31545741324921134,-260,217,0.6950091521595202,0.3049908478404798,home,STL,under,8.5,0.5098039215686274,-104,0.48811829258452355,STL,CIN,2022 REG,9,5,8,1,6,17,1,0,4,-4,1,0,0,0,0,0,0,0,0,0.5118817074154765,0.48811829258452355
85733,0.43103448275862066,0.607843137254902,132,-155,0.4142768879252058,0.5857231120747942,away,BOS,over,10.5,0.5145631067961165,-106,0.49023796582517226,CIN,BOS,2022 REG,8,5,6,1,6,14,1,0,4,-4,1,0,0,0,0,0,0,0,0,0.49023796582517226,0.5097620341748277
85733,0.43103448275862066,0.607843137254902,132,-155,0.4142768879252058,0.5857231120747942,home,CIN,under,10.5,0.5327102803738317,-114,0.5097620341748277,CIN,BOS,2022 REG,8,5,6,1,6,14,1,0,4,-4,1,0,0,0,0,0,0,0,0,0.49023796582517226,0.5097620341748277
85735,0.3125,0.726027397260274,220,-265,0.3004601883561644,0.6995398116438356,away,LAD,over,9,0.5215311004784688,-109,0.49907282342437215,KC,LAD,2022 REG,4,3,8,8,11,12,0,1,-5,5,1,1,1,0,0,0,0,0,0,0.49907282342437215,0.5009271765756278
85735,0.3125,0.726027397260274,220,-265,0.3004601883561644,0.6995398116438356,home,KC,under,9,0.5215311004784688,-109,0.5009271765756278,KC,LAD,2022 REG,4,3,8,8,11,12,0,1,-5,5,1,1,1,0,0,0,0,0,0,0.49907282342437215,0.5009271765756278
85736,0.601593625498008,0.4347826086956522,-151,130,0.5797099148874794,0.42029008511252064,away,DET,over,8.5,0.5348837209302326,-115,0.5109810284308424,ARI,DET,2022 REG,5,3,8,6,9,13,0,1,-3,3,1,1,1,0,0,0,0,0,0,0.5109810284308424,0.48901897156915763
85736,0.601593625498008,0.4347826086956522,-151,130,0.5797099148874794,0.42029008511252064,home,ARI,under,8.5,0.5098039215686274,-104,0.48901897156915763,ARI,DET,2022 REG,5,3,8,6,9,13,0,1,-3,3,1,1,1,0,0,0,0,0,0,0.5109810284308424,0.48901897156915763
85737,0.5215311004784688,0.5145631067961165,-109,-106,0.5027068488376564,0.4972931511623436,away,SF,over,8,0.5215311004784688,-109,0.49907282342437215,STL,SF,2022 REG,9,4,8,0,4,17,1,0,4,-4,0,0,0,0,0,0,0,0,0,0.49907282342437215,0.5009271765756278
85737,0.5215311004784688,0.5145631067961165,-109,-106,0.5027068488376564,0.4972931511623436,home,STL,under,8,0.5215311004784688,-109,0.5009271765756278,STL,SF,2022 REG,9,4,8,0,4,17,1,0,4,-4,0,0,0,0,0,0,0,0,0,0.49907282342437215,0.5009271765756278
85739,0.5833333333333333,0.4566210045662101,-140,119,0.5600266362252664,0.4399733637747336,away,TEX,over,8,0.5238095238095238,-110,0.4988662131519274,MIN,TEX,2022 REG,5,2,4,1,3,9,1,0,1,-1,1,0,0,0,0,0,0,0,0,0.4988662131519274,0.5011337868480725
85739,0.5833333333333333,0.4566210045662101,-140,119,0.5600266362252664,0.4399733637747336,home,MIN,under,8,0.5238095238095238,-110,0.5011337868480725,MIN,TEX,2022 REG,5,2,4,1,3,9,1,0,1,-1,1,0,0,0,0,0,0,0,0,0.4988662131519274,0.5011337868480725
85742,0.7142857142857143,0.3225806451612903,-250,210,0.6879526003949967,0.3120473996050033,away,DET,over,8.5,0.5121951219512195,-105,0.48808156828023186,LAD,DET,2022 REG,6,5,6,1,6,12,1,0,4,-4,1,0,0,0,0,0,0,0,0,0.48808156828023186,0.5119184317197681
85742,0.7142857142857143,0.3225806451612903,-250,210,0.6879526003949967,0.3120473996050033,home,LAD,under,8.5,0.5348837209302326,-115,0.5119184317197681,LAD,DET,2022 REG,6,5,6,1,6,12,1,0,4,-4,1,0,0,0,0,0,0,0,0,0.48808156828023186,0.5119184317197681
85743,0.4,0.6389891696750902,150,-177,0.3844043321299639,0.6155956678700361,away,HOU,over,8,0.5327102803738317,-114,0.5100625279371946,OAK,HOU,2022 REG,5,1,9,6,7,14,0,1,-5,5,1,0,0,0,0,0,0,0,0,0.5100625279371946,0.48993747206280536
85743,0.4,0.6389891696750902,150,-177,0.3844043321299639,0.6155956678700361,home,OAK,under,8,0.5098039215686274,-104,0.48993747206280536,OAK,HOU,2022 REG,5,1,9,6,7,14,0,1,-5,5,1,0,0,0,0,0,0,0,0,0.5100625279371946,0.48993747206280536
85744,0.635036496350365,0.4081632653061224,-174,145,0.6076030710648583,0.39239692893514166,away,LAA,over,7,0.5515695067264574,-123,0.527200976088429,TB,LAA,2022 REG,14,11,7,1,12,21,1,0,10,-10,1,0,0,0,0,0,0,0,0,0.527200976088429,0.472799023911571
85744,0.635036496350365,0.4081632653061224,-174,145,0.6076030710648583,0.39239692893514166,home,TB,under,7,0.4926108374384236,103,0.472799023911571,TB,LAA,2022 REG,14,11,7,1,12,21,1,0,10,-10,1,0,0,0,0,0,0,0,0,0.527200976088429,0.472799023911571
85747,0.5,0.5433789954337899,100,-119,0.4783105022831051,0.5216894977168949,away,ARI,over,6.5,0.5495495495495495,-122,0.5223196169142115,MIL,ARI,2022 REG,8,3,1,0,3,9,1,0,3,-3,0,0,0,0,0,0,0,0,0,0.5223196169142115,0.47768038308578853
85747,0.5,0.5433789954337899,100,-119,0.4783105022831051,0.5216894977168949,home,MIL,under,6.5,0.5,100,0.47768038308578853,MIL,ARI,2022 REG,8,3,1,0,3,9,1,0,3,-3,0,0,0,0,0,0,0,0,0,0.5223196169142115,0.47768038308578853
85748,0.5867768595041323,0.45454545454545453,-142,120,0.5625298818386723,0.43747011816132775,away,CLE,over,7.5,0.49504950495049505,102,0.47499799484898986,DET,CLE,2022 REG,9,4,8,3,7,17,1,0,1,-1,1,1,1,0,0,0,0,0,0,0.47499799484898986,0.5250020051510101
85748,0.5867768595041323,0.45454545454545453,-142,120,0.5625298818386723,0.43747011816132775,home,DET,under,7.5,0.5454545454545454,-120,0.5250020051510101,DET,CLE,2022 REG,9,4,8,3,7,17,1,0,1,-1,1,1,1,0,0,0,0,0,0,0.47499799484898986,0.5250020051510101
85749,0.42194092827004215,0.6108949416342413,137,-157,0.40808613084207446,0.5919138691579255,away,HOU,over,9,0.5121951219512195,-105,0.48919479393107135,TEX,HOU,2022 REG,11,5,7,3,8,18,1,0,2,-2,1,1,1,0,0,0,0,0,0,0.48919479393107135,0.5108052060689287
85749,0.42194092827004215,0.6108949416342413,137,-157,0.40808613084207446,0.5919138691579255,home,TEX,under,9,0.5327102803738317,-114,0.5108052060689287,TEX,HOU,2022 REG,11,5,7,3,8,18,1,0,2,-2,1,1,1,0,0,0,0,0,0,0.48919479393107135,0.5108052060689287
85751,0.6363636363636364,0.4065040650406504,-175,146,0.6090841900154538,0.3909158099845462,away,TEX,over,9,0.5391705069124424,-117,0.5153817639191344,BOS,TEX,2022 REG,13,9,13,8,17,26,1,0,1,-1,1,1,1,1,1,1,1,1,0,0.5153817639191344,0.4846182360808656
85751,0.6363636363636364,0.4065040650406504,-175,146,0.6090841900154538,0.3909158099845462,home,BOS,under,9,0.504950495049505,-102,0.4846182360808656,BOS,TEX,2022 REG,13,9,13,8,17,26,1,0,1,-1,1,1,1,1,1,1,1,1,0,0.5153817639191344,0.4846182360808656
85752,0.5633187772925764,0.47619047619047616,-129,110,0.5410624729287608,0.45893752707123925,away,MIN,over,8.5,0.5,100,0.4772727272727273,TEX,MIN,2022 REG,12,9,9,7,16,21,1,0,2,-2,1,1,1,1,1,1,1,0,0,0.4772727272727273,0.5227272727272727
85752,0.5633187772925764,0.47619047619047616,-129,110,0.5410624729287608,0.45893752707123925,home,TEX,under,8.5,0.5454545454545454,-120,0.5227272727272727,TEX,MIN,2022 REG,12,9,9,7,16,21,1,0,2,-2,1,1,1,1,1,1,1,0,0,0.4772727272727273,0.5227272727272727
85754,0.7304582210242588,0.3125,-271,220,0.6990790353165117,0.3009209646834883,away,PIT,over,7.5,0.49504950495049505,102,0.4739797934813417,NYM,PIT,2022 REG,10,7,4,1,8,14,1,0,6,-6,1,0,0,0,0,0,0,0,0,0.4739797934813417,0.5260202065186583
85754,0.7304582210242588,0.3125,-271,220,0.6990790353165117,0.3009209646834883,home,NYM,under,7.5,0.5475113122171946,-121,0.5260202065186583,NYM,PIT,2022 REG,10,7,4,1,8,14,1,0,6,-6,1,0,0,0,0,0,0,0,0,0.4739797934813417,0.5260202065186583
85755,0.36363636363636365,0.6774193548387096,175,-210,0.3487070114636097,0.6512929885363903,away,NYY,over,9.5,0.5192307692307692,-108,0.49688292476754015,BAL,NYY,2022 REG,6,2,7,1,3,13,1,0,1,-1,1,0,0,0,0,0,0,0,0,0.49688292476754015,0.5031170752324599
85755,0.36363636363636365,0.6774193548387096,175,-210,0.3487070114636097,0.6512929885363903,home,BAL,under,9.5,0.5238095238095238,-110,0.5031170752324599,BAL,NYY,2022 REG,6,2,7,1,3,13,1,0,1,-1,1,0,0,0,0,0,0,0,0,0.49688292476754015,0.5031170752324599
85756,0.7142857142857143,0.32573289902280134,-250,207,0.6857009904939174,0.3142990095060826,away,COL,over,7.5,0.5238095238095238,-110,0.4988662131519274,STL,COL,2022 REG,15,13,4,0,13,19,1,0,13,-13,0,0,0,0,0,0,0,0,0,0.4988662131519274,0.5011337868480725
85756,0.7142857142857143,0.32573289902280134,-250,207,0.6857009904939174,0.3142990095060826,home,STL,under,7.5,0.5238095238095238,-110,0.5011337868480725,STL,COL,2022 REG,15,13,4,0,13,19,1,0,13,-13,0,0,0,0,0,0,0,0,0,0.4988662131519274,0.5011337868480725
85757,0.7058823529411764,0.3367003367003367,-240,197,0.6758239837824612,0.3241760162175388,away,BAL,over,8,0.5412844036697247,-118,0.5162581740877563,NYY,BAL,2022 REG,12,10,14,5,15,26,1,0,5,-5,1,1,1,1,1,0,0,0,0,0.5162581740877563,0.4837418259122437
85757,0.7058823529411764,0.3367003367003367,-240,197,0.6758239837824612,0.3241760162175388,home,NYY,under,8,0.504950495049505,-102,0.4837418259122437,NYY,BAL,2022 REG,12,10,14,5,15,26,1,0,5,-5,1,1,1,1,1,0,0,0,0,0.5162581740877563,0.4837418259122437
85758,0.7101449275362319,0.3278688524590164,-245,205,0.6831496344961281,0.3168503655038719,away,BOS,over,7.5,0.49019607843137253,104,0.4707129274603323,NYY,BOS,2022 REG,8,5,7,4,9,15,1,0,1,-1,1,1,1,1,0,0,0,0,0,0.4707129274603323,0.5292870725396677
85758,0.7101449275362319,0.3278688524590164,-245,205,0.6831496344961281,0.3168503655038719,home,NYY,under,7.5,0.5495495495495495,-122,0.5292870725396677,NYY,BOS,2022 REG,8,5,7,4,9,15,1,0,1,-1,1,1,1,1,0,0,0,0,0,0.4707129274603323,0.5292870725396677
85760,0.6825396825396826,0.35842293906810035,-215,179,0.6545810677915133,0.34541893220848674,away,BOS,over,8,0.5348837209302326,-115,0.5097020142727117,HOU,BOS,2022 REG,9,1,5,2,3,14,0,1,-1,1,1,0,0,0,0,0,0,0,0,0.5097020142727117,0.49029798572728833
85760,0.6825396825396826,0.35842293906810035,-215,179,0.6545810677915133,0.34541893220848674,home,HOU,under,8,0.5121951219512195,-105,0.49029798572728833,HOU,BOS,2022 REG,9,1,5,2,3,14,0,1,-1,1,1,0,0,0,0,0,0,0,0,0.5097020142727117,0.49029798572728833
85761,0.5305164319248826,0.5098039215686274,-113,-104,0.5091258218555558,0.49087417814444423,away,ATL,over,7.5,0.5327102803738317,-114,0.508788710910954,SD,ATL,2022 REG,16,12,6,1,13,22,1,0,11,-11,1,0,0,0,0,0,0,0,0,0.508788710910954,0.491211289089046
85761,0.5305164319248826,0.5098039215686274,-113,-104,0.5091258218555558,0.49087417814444423,home,SD,under,7.5,0.5121951219512195,-105,0.491211289089046,SD,ATL,2022 REG,16,12,6,1,13,22,1,0,11,-11,1,0,0,0,0,0,0,0,0,0.508788710910954,0.491211289089046
85762,0.7340425531914894,0.3076923076923077,-276,225,0.7034073893512554,0.29659261064874465,away,WSH,over,7,0.5495495495495495,-122,0.5250401592387142,NYM,WSH,2022 REG,12,8,9,0,8,21,1,0,8,-8,0,0,0,0,0,0,0,0,0,0.5250401592387142,0.47495984076128583
85762,0.7340425531914894,0.3076923076923077,-276,225,0.7034073893512554,0.29659261064874465,home,NYM,under,7,0.49504950495049505,102,0.47495984076128583,NYM,WSH,2022 REG,12,8,9,0,8,21,1,0,8,-8,0,0,0,0,0,0,0,0,0,0.5250401592387142,0.47495984076128583
85763,0.5238095238095238,0.5192307692307692,-110,-108,0.5012646084074657,0.4987353915925343,away,COL,over,8.5,0.5238095238095238,-110,0.5000596729920038,ARI,COL,2022 REG,6,1,8,4,5,14,0,1,-3,3,1,0,0,0,0,0,0,0,0,0.5000596729920038,0.4999403270079962
85763,0.5238095238095238,0.5192307692307692,-110,-108,0.5012646084074657,0.4987353915925343,home,ARI,under,8.5,0.5215311004784688,-109,0.4999403270079962,ARI,COL,2022 REG,6,1,8,4,5,14,0,1,-3,3,1,0,0,0,0,0,0,0,0,0.5000596729920038,0.4999403270079962
85765,0.6031746031746031,0.4347826086956522,-152,130,0.5802797769671475,0.4197202230328525,away,ATL,over,8,0.5121951219512195,-105,0.48919479393107135,LAD,ATL,2022 REG,2,1,12,3,4,14,0,1,-2,2,1,0,0,0,0,0,0,0,0,0.48919479393107135,0.5108052060689287
85765,0.6031746031746031,0.4347826086956522,-152,130,0.5802797769671475,0.4197202230328525,home,LAD,under,8,0.5327102803738317,-114,0.5108052060689287,LAD,ATL,2022 REG,2,1,12,3,4,14,0,1,-2,2,1,0,0,0,0,0,0,0,0,0.48919479393107135,0.5108052060689287
85767,0.613899613899614,0.425531914893617,-159,135,0.589692613597978,0.410307386402022,away,LAD,over,8.5,0.5454545454545454,-120,0.5206611570247933,ATL,LAD,2022 REG,9,5,9,3,8,18,1,0,2,-2,1,1,1,0,0,0,0,0,0,0.5206611570247933,0.4793388429752067
85767,0.613899613899614,0.425531914893617,-159,135,0.589692613597978,0.410307386402022,home,ATL,under,8.5,0.5,100,0.4793388429752067,ATL,LAD,2022 REG,9,5,9,3,8,18,1,0,2,-2,1,1,1,0,0,0,0,0,0,0.5206611570247933,0.4793388429752067
85768,0.6515679442508712,0.3846153846153846,-187,160,0.6279920470453316,0.3720079529546684,away,KC,over,8,0.5073891625615764,-103,0.4826927225525911,MIN,KC,2022 REG,12,2,6,3,5,18,0,1,-1,1,1,1,0,0,0,0,0,0,0,0.4826927225525911,0.5173072774474089
85768,0.6515679442508712,0.3846153846153846,-187,160,0.6279920470453316,0.3720079529546684,home,MIN,under,8,0.5412844036697247,-118,0.5173072774474089,MIN,KC,2022 REG,12,2,6,3,5,18,0,1,-1,1,1,1,0,0,0,0,0,0,0,0.4826927225525911,0.5173072774474089
85769,0.6632996632996633,0.37453183520599254,-197,167,0.6382060430787401,0.36179395692125993,away,KC,over,8.5,0.5412844036697247,-118,0.5189377998484975,MIN,KC,2022 REG,11,7,7,3,10,18,1,0,4,-4,1,1,1,0,0,0,0,0,0,0.5189377998484975,0.4810622001515025
85769,0.6632996632996633,0.37453183520599254,-197,167,0.6382060430787401,0.36179395692125993,home,MIN,under,8.5,0.5,100,0.4810622001515025,MIN,KC,2022 REG,11,7,7,3,10,18,1,0,4,-4,1,1,1,0,0,0,0,0,0,0.5189377998484975,0.4810622001515025
85770,0.6254681647940076,0.41493775933609955,-167,141,0.6001955455815435,0.39980445441845647,away,TB,over,7,0.5192307692307692,-108,0.49571111079951763,NYY,TB,2022 REG,4,1,4,3,4,8,0,1,-2,2,1,0,0,0,0,0,0,0,0,0.49571111079951763,0.5042888892004824
85770,0.6254681647940076,0.41493775933609955,-167,141,0.6001955455815435,0.39980445441845647,home,NYY,under,7,0.5260663507109005,-111,0.5042888892004824,NYY,TB,2022 REG,4,1,4,3,4,8,0,1,-2,2,1,0,0,0,0,0,0,0,0,0.49571111079951763,0.5042888892004824
85772,0.4716981132075471,0.5689655172413793,112,-132,0.45251715544861953,0.5474828445513804,away,CLE,over,9,0.49751243781094534,101,0.47511256217505476,MIN,CLE,2022 REG,10,2,7,3,5,17,0,1,-1,1,1,1,0,0,0,0,0,0,0,0.47511256217505476,0.5248874378249453
85772,0.4716981132075471,0.5689655172413793,112,-132,0.45251715544861953,0.5474828445513804,home,MIN,under,9,0.5475113122171946,-121,0.5248874378249453,MIN,CLE,2022 REG,10,2,7,3,5,17,0,1,-1,1,1,1,0,0,0,0,0,0,0,0.47511256217505476,0.5248874378249453
85773,0.6453900709219857,0.3968253968253968,-182,152,0.6181446271984977,0.3818553728015023,away,DET,over,7,0.5495495495495495,-122,0.5223196169142115,CWS,DET,2022 REG,8,3,9,5,8,17,0,1,-2,2,1,1,1,0,0,0,0,0,0,0.5223196169142115,0.47768038308578853
85773,0.6453900709219857,0.3968253968253968,-182,152,0.6181446271984977,0.3818553728015023,home,CWS,under,7,0.5,100,0.47768038308578853,CWS,DET,2022 REG,8,3,9,5,8,17,0,1,-2,2,1,1,1,0,0,0,0,0,0,0.5223196169142115,0.47768038308578853
85774,0.5726495726495727,0.4716981132075471,-134,112,0.5472538892954956,0.45274611070450443,away,NYY,over,8,0.5145631067961165,-106,0.4913668392989033,TOR,NYY,2022 REG,8,1,10,9,10,18,0,1,-8,8,1,0,0,0,0,0,0,0,0,0.4913668392989033,0.5086331607010968
85774,0.5726495726495727,0.4716981132075471,-134,112,0.5472538892954956,0.45274611070450443,home,TOR,under,8,0.5305164319248826,-113,0.5086331607010968,TOR,NYY,2022 REG,8,1,10,9,10,18,0,1,-8,8,1,0,0,0,0,0,0,0,0,0.4913668392989033,0.5086331607010968
85777,0.5951417004048584,0.4444444444444444,-147,125,0.5715823348467713,0.42841766515322866,away,CHC,over,8.5,0.5454545454545454,-120,0.5220180091279142,MIL,CHC,2022 REG,5,5,6,2,7,11,1,0,3,-3,1,1,0,0,0,0,0,0,0,0.5220180091279142,0.4779819908720858
85777,0.5951417004048584,0.4444444444444444,-147,125,0.5715823348467713,0.42841766515322866,home,MIL,under,8.5,0.49751243781094534,101,0.4779819908720858,MIL,CHC,2022 REG,5,5,6,2,7,11,1,0,3,-3,1,1,0,0,0,0,0,0,0,0.5220180091279142,0.4779819908720858
85778,0.2531645569620253,0.7872340425531915,295,-370,0.24293706341386914,0.7570629365861309,away,NYM,over,8,0.5370370370370371,-116,0.5118817074154765,WSH,NYM,2022 REG,8,5,6,1,6,14,1,0,4,-4,1,0,0,0,0,0,0,0,0,0.5118817074154765,0.48811829258452355
85778,0.2531645569620253,0.7872340425531915,295,-370,0.24293706341386914,0.7570629365861309,home,WSH,under,8,0.5098039215686274,-104,0.48811829258452355,WSH,NYM,2022 REG,8,5,6,1,6,14,1,0,4,-4,1,0,0,0,0,0,0,0,0,0.5118817074154765,0.48811829258452355
85779,0.7198879551820728,0.3225806451612903,-257,210,0.6893153213214445,0.31068467867855554,away,MIA,over,7,0.5073891625615764,-103,0.48484779035144243,ATL,MIA,2022 REG,9,7,3,1,8,12,1,0,6,-6,1,0,0,0,0,0,0,0,0,0.48484779035144243,0.5151522096485576
85779,0.7198879551820728,0.3225806451612903,-257,210,0.6893153213214445,0.31068467867855554,home,ATL,under,7,0.5370370370370371,-116,0.5151522096485576,ATL,MIA,2022 REG,9,7,3,1,8,12,1,0,6,-6,1,0,0,0,0,0,0,0,0,0.48484779035144243,0.5151522096485576
85780,0.6402877697841727,0.39370078740157477,-178,154,0.6185253123055287,0.38147468769447135,away,BAL,over,9.5,0.5391705069124424,-117,0.5140669063204599,BOS,BAL,2022 REG,15,12,7,2,14,22,1,0,10,-10,1,1,0,0,0,0,0,0,0,0.5140669063204599,0.4859330936795401
85780,0.6402877697841727,0.39370078740157477,-178,154,0.6185253123055287,0.38147468769447135,home,BOS,under,9.5,0.5073891625615764,-103,0.4859330936795401,BOS,BAL,2022 REG,15,12,7,2,14,22,1,0,10,-10,1,1,0,0,0,0,0,0,0,0.5140669063204599,0.4859330936795401
85781,0.5192307692307692,0.5169082125603864,-108,-107,0.5004662979161306,0.4995337020838694,away,CLE,over,8.5,0.5238095238095238,-110,0.5000596729920038,KC,CLE,2022 REG,9,7,13,10,17,22,0,1,-3,3,1,1,1,1,1,1,1,0,0,0.5000596729920038,0.4999403270079962
85781,0.5192307692307692,0.5169082125603864,-108,-107,0.5004662979161306,0.4995337020838694,home,KC,under,8.5,0.5215311004784688,-109,0.4999403270079962,KC,CLE,2022 REG,9,7,13,10,17,22,0,1,-3,3,1,1,1,1,1,1,1,0,0,0.5000596729920038,0.4999403270079962
85782,0.49751243781094534,0.5412844036697247,101,-118,0.47821052662653235,0.5217894733734676,away,STL,over,7,0.5495495495495495,-122,0.5236866555946829,KC,STL,2022 REG,15,7,6,1,8,21,1,0,6,-6,1,0,0,0,0,0,0,0,0,0.5236866555946829,0.47631334440531714
85782,0.49751243781094534,0.5412844036697247,101,-118,0.47821052662653235,0.5217894733734676,home,KC,under,7,0.49751243781094534,101,0.47631334440531714,KC,STL,2022 REG,15,7,6,1,8,21,1,0,6,-6,1,0,0,0,0,0,0,0,0,0.5236866555946829,0.47631334440531714
85783,0.35714285714285715,0.6845425867507886,180,-217,0.3422551986094122,0.6577448013905878,away,LAD,over,8.5,0.5348837209302326,-115,0.5097020142727117,LAA,LAD,2022 REG,7,1,7,7,8,14,0,1,-6,6,1,0,0,0,0,0,0,0,0,0.5097020142727117,0.49029798572728833
85783,0.35714285714285715,0.6845425867507886,180,-217,0.3422551986094122,0.6577448013905878,home,LAA,under,8.5,0.5121951219512195,-105,0.49029798572728833,LAA,LAD,2022 REG,7,1,7,7,8,14,0,1,-6,6,1,0,0,0,0,0,0,0,0,0.5097020142727117,0.49029798572728833
85785,0.8198198198198198,0.2173913043478261,-455,360,0.7893134027094074,0.21068659729059258,away,PIT,over,6.5,0.5495495495495495,-122,0.5223196169142115,NYM,PIT,2022 REG,12,7,5,3,10,17,1,0,4,-4,1,1,1,0,0,0,0,0,0,0.5223196169142115,0.47768038308578853
85785,0.8198198198198198,0.2173913043478261,-455,360,0.7893134027094074,0.21068659729059258,home,NYM,under,6.5,0.5,100,0.47768038308578853,NYM,PIT,2022 REG,12,7,5,3,10,17,1,0,4,-4,1,1,1,0,0,0,0,0,0,0.5223196169142115,0.47768038308578853
85787,0.6666666666666666,0.37593984962406013,-200,166,0.6382623224728488,0.36173767752715125,away,CLE,over,7.5,0.5145631067961165,-106,0.4913668392989033,LAA,CLE,2022 REG,14,9,11,5,14,25,1,0,4,-4,1,1,1,1,1,0,0,0,0,0.4913668392989033,0.5086331607010968
85787,0.6666666666666666,0.37593984962406013,-200,166,0.6382623224728488,0.36173767752715125,home,LAA,under,7.5,0.5305164319248826,-113,0.5086331607010968,LAA,CLE,2022 REG,14,9,11,5,14,25,1,0,4,-4,1,1,1,1,1,0,0,0,0,0.4913668392989033,0.5086331607010968
85788,0.4926108374384236,0.5495495495495495,103,-122,0.4718421738975501,0.5281578261024499,away,TEX,over,8,0.5169082125603864,-107,0.49353874091423283,OAK,TEX,2022 REG,5,2,4,0,2,9,1,0,2,-2,0,0,0,0,0,0,0,0,0,0.49353874091423283,0.5064612590857671
85788,0.4926108374384236,0.5495495495495495,103,-122,0.4718421738975501,0.5281578261024499,home,OAK,under,8,0.5283018867924528,-112,0.5064612590857671,OAK,TEX,2022 REG,5,2,4,0,2,9,1,0,2,-2,0,0,0,0,0,0,0,0,0,0.49353874091423283,0.5064612590857671
85789,0.6363636363636364,0.4,-175,150,0.6132231404958678,0.3867768595041322,away,TEX,over,9,0.5348837209302326,-115,0.5097020142727117,TOR,TEX,2022 REG,9,10,8,8,18,17,1,0,2,-2,1,1,1,1,1,1,1,1,0,0.5097020142727117,0.49029798572728833
85789,0.6363636363636364,0.4,-175,150,0.6132231404958678,0.3867768595041322,home,TOR,under,9,0.5121951219512195,-105,0.49029798572728833,TOR,TEX,2022 REG,9,10,8,8,18,17,1,0,2,-2,1,1,1,1,1,1,1,1,0,0.5097020142727117,0.49029798572728833
85790,0.37735849056603776,0.6655518394648829,165,-199,0.361165913195879,0.638834086804121,away,LAD,over,11,0.5348837209302326,-115,0.5097020142727117,COL,LAD,2022 REG,8,3,12,7,10,20,0,1,-4,4,1,1,1,0,0,0,0,0,0,0.5097020142727117,0.49029798572728833
85790,0.37735849056603776,0.6655518394648829,165,-199,0.361165913195879,0.638834086804121,home,COL,under,11,0.5121951219512195,-105,0.49029798572728833,COL,LAD,2022 REG,8,3,12,7,10,20,0,1,-4,4,1,1,1,0,0,0,0,0,0,0.5097020142727117,0.49029798572728833
85792,0.5098039215686274,0.5283018867924528,-104,-112,0.4903774310316062,0.5096225689683938,away,TB,over,7,0.5024875621890548,-101,0.4794401874631478,NYY,TB,2022 REG,9,2,11,4,6,20,0,1,-2,2,1,1,0,0,0,0,0,0,0,0.4794401874631478,0.5205598125368522
85792,0.5098039215686274,0.5283018867924528,-104,-112,0.4903774310316062,0.5096225689683938,home,NYY,under,7,0.5433789954337899,-119,0.5205598125368522,NYY,TB,2022 REG,9,2,11,4,6,20,0,1,-2,2,1,1,0,0,0,0,0,0,0,0.4794401874631478,0.5205598125368522
85793,0.5867768595041323,0.45454545454545453,-142,120,0.5625298818386723,0.43747011816132775,away,KC,over,8.5,0.5238095238095238,-110,0.5000596729920038,BOS,KC,2022 REG,6,0,15,9,9,21,0,1,-9,9,0,0,0,0,0,0,0,0,0,0.5000596729920038,0.4999403270079962
85793,0.5867768595041323,0.45454545454545453,-142,120,0.5625298818386723,0.43747011816132775,home,BOS,under,8.5,0.5215311004784688,-109,0.4999403270079962,BOS,KC,2022 REG,6,0,15,9,9,21,0,1,-9,9,0,0,0,0,0,0,0,0,0,0.5000596729920038,0.4999403270079962
85794,0.7289972899728998,0.30864197530864196,-269,224,0.7015583675860848,0.2984416324139152,away,CIN,over,7.5,0.5192307692307692,-108,0.49571111079951763,MIL,CIN,2022 REG,17,18,7,4,22,24,1,0,14,-14,1,1,1,1,0,0,0,0,0,0.49571111079951763,0.5042888892004824
85794,0.7289972899728998,0.30864197530864196,-269,224,0.7015583675860848,0.2984416324139152,home,MIL,under,7.5,0.5260663507109005,-111,0.5042888892004824,MIL,CIN,2022 REG,17,18,7,4,22,24,1,0,14,-14,1,1,1,1,0,0,0,0,0,0.49571111079951763,0.5042888892004824
85795,0.5555555555555556,0.4854368932038835,-125,106,0.5327819729114227,0.4672180270885773,away,SEA,over,7,0.5192307692307692,-108,0.49571111079951763,TB,SEA,2022 REG,9,4,10,8,12,19,0,1,-4,4,1,1,1,1,0,0,0,0,0,0.49571111079951763,0.5042888892004824
85795,0.5555555555555556,0.4854368932038835,-125,106,0.5327819729114227,0.4672180270885773,home,TB,under,7,0.5260663507109005,-111,0.5042888892004824,TB,SEA,2022 REG,9,4,10,8,12,19,0,1,-4,4,1,1,1,1,0,0,0,0,0,0.49571111079951763,0.5042888892004824
85797,0.45454545454545453,0.5815899581589958,120,-139,0.43812026695252254,0.5618797330474774,away,STL,over,7.5,0.5454545454545454,-120,0.5206611570247933,KC,STL,2022 REG,4,0,8,10,10,12,0,1,-10,10,0,0,0,0,0,0,0,0,0,0.5206611570247933,0.4793388429752067
85797,0.45454545454545453,0.5815899581589958,120,-139,0.43812026695252254,0.5618797330474774,home,KC,under,7.5,0.5,100,0.4793388429752067,KC,STL,2022 REG,4,0,8,10,10,12,0,1,-10,10,0,0,0,0,0,0,0,0,0,0.5206611570247933,0.4793388429752067
85798,0.5555555555555556,0.4854368932038835,-125,106,0.5327819729114227,0.4672180270885773,away,LAD,over,8.5,0.5305164319248826,-113,0.5066009958897986,PHI,LAD,2022 REG,6,4,13,7,11,19,0,1,-3,3,1,1,1,1,0,0,0,0,0,0.5066009958897986,0.49339900411020143
85798,0.5555555555555556,0.4854368932038835,-125,106,0.5327819729114227,0.4672180270885773,home,PHI,under,8.5,0.5145631067961165,-106,0.49339900411020143,PHI,LAD,2022 REG,6,4,13,7,11,19,0,1,-3,3,1,1,1,1,0,0,0,0,0,0.5066009958897986,0.49339900411020143
85800,0.5412844036697247,0.5,-118,100,0.5189377998484975,0.4810622001515025,away,PHI,over,8.5,0.5169082125603864,-107,0.49353874091423283,STL,PHI,2022 REG,8,4,11,3,7,19,1,0,1,-1,1,1,1,0,0,0,0,0,0,0.49353874091423283,0.5064612590857671
85800,0.5412844036697247,0.5,-118,100,0.5189377998484975,0.4810622001515025,home,STL,under,8.5,0.5283018867924528,-112,0.5064612590857671,STL,PHI,2022 REG,8,4,11,3,7,19,1,0,1,-1,1,1,1,0,0,0,0,0,0,0.49353874091423283,0.5064612590857671
85801,0.47619047619047616,0.5652173913043479,110,-130,0.4564724440500838,0.5435275559499162,away,NYY,over,9,0.5,100,0.4772727272727273,BOS,NYY,2022 REG,7,3,10,5,8,17,0,1,-2,2,1,1,1,0,0,0,0,0,0,0.4772727272727273,0.5227272727272727
85801,0.47619047619047616,0.5652173913043479,110,-130,0.4564724440500838,0.5435275559499162,home,BOS,under,9,0.5454545454545454,-120,0.5227272727272727,BOS,NYY,2022 REG,7,3,10,5,8,17,0,1,-2,2,1,1,1,0,0,0,0,0,0,0.4772727272727273,0.5227272727272727
85803,0.613899613899614,0.42372881355932196,-159,136,0.5907995368109236,0.40920046318907644,away,WSH,over,9,0.5391705069124424,-117,0.5153817639191344,ARI,WSH,2022 REG,10,7,4,2,9,14,1,0,5,-5,1,1,0,0,0,0,0,0,0,0.5153817639191344,0.4846182360808656
85803,0.613899613899614,0.42372881355932196,-159,136,0.5907995368109236,0.40920046318907644,home,ARI,under,9,0.504950495049505,-102,0.4846182360808656,ARI,WSH,2022 REG,10,7,4,2,9,14,1,0,5,-5,1,1,0,0,0,0,0,0,0,0.5153817639191344,0.4846182360808656
85804,0.6721311475409836,0.3663003663003663,-205,173,0.6463001300410599,0.3536998699589401,away,CHC,over,7,0.5169082125603864,-107,0.49353874091423283,MIL,CHC,2022 REG,3,0,5,2,2,8,0,1,-2,2,0,0,0,0,0,0,0,0,0,0.49353874091423283,0.5064612590857671
85804,0.6721311475409836,0.3663003663003663,-205,173,0.6463001300410599,0.3536998699589401,home,MIL,under,7,0.5283018867924528,-112,0.5064612590857671,MIL,CHC,2022 REG,3,0,5,2,2,8,0,1,-2,2,0,0,0,0,0,0,0,0,0,0.49353874091423283,0.5064612590857671
85805,0.6363636363636364,0.4016064257028112,-175,149,0.6122008695940788,0.3877991304059212,away,KC,over,8,0.5073891625615764,-103,0.4837652908580103,SF,KC,2022 REG,5,6,6,2,8,11,1,0,4,-4,1,1,0,0,0,0,0,0,0,0.4837652908580103,0.5162347091419897
85805,0.6363636363636364,0.4016064257028112,-175,149,0.6122008695940788,0.3877991304059212,home,SF,under,8,0.5391705069124424,-117,0.5162347091419897,SF,KC,2022 REG,5,6,6,2,8,11,1,0,4,-4,1,1,0,0,0,0,0,0,0,0.4837652908580103,0.5162347091419897
85806,0.5983935742971888,0.43859649122807015,-149,128,0.5762589567740419,0.42374104322595807,away,CLE,over,7,0.5495495495495495,-122,0.5277073575960698,SEA,CLE,2022 REG,4,4,5,0,4,9,1,0,4,-4,0,0,0,0,0,0,0,0,0,0.5277073575960698,0.4722926424039302
85806,0.5983935742971888,0.43859649122807015,-149,128,0.5762589567740419,0.42374104322595807,home,SEA,under,7,0.49019607843137253,104,0.4722926424039302,SEA,CLE,2022 REG,4,4,5,0,4,9,1,0,4,-4,0,0,0,0,0,0,0,0,0,0.5277073575960698,0.4722926424039302
85807,0.6197718631178707,0.4166666666666667,-163,140,0.597188287624032,0.402811712375968,away,TEX,over,8.5,0.5121951219512195,-105,0.4903184724049234,PHI,TEX,2022 REG,11,4,9,6,10,20,0,1,-2,2,1,1,1,1,0,0,0,0,0,0.4903184724049234,0.5096815275950766
85807,0.6197718631178707,0.4166666666666667,-163,140,0.597188287624032,0.402811712375968,home,PHI,under,8.5,0.5305164319248826,-113,0.5096815275950766,PHI,TEX,2022 REG,11,4,9,6,10,20,0,1,-2,2,1,1,1,1,0,0,0,0,0,0.4903184724049234,0.5096815275950766
85808,0.6000000000000001,0.4291845493562232,-150,133,0.5824892703862661,0.4175107296137339,away,STL,over,9.5,0.5098039215686274,-104,0.48592421718142587,LAD,STL,2022 REG,7,4,7,1,5,14,1,0,3,-3,1,0,0,0,0,0,0,0,0,0.48592421718142587,0.5140757828185741
85808,0.6000000000000001,0.4291845493562232,-150,133,0.5824892703862661,0.4175107296137339,home,LAD,under,9.5,0.5370370370370371,-116,0.5140757828185741,LAD,STL,2022 REG,7,4,7,1,5,14,1,0,3,-3,1,0,0,0,0,0,0,0,0,0.48592421718142587,0.5140757828185741
85810,0.4166666666666667,0.6226415094339623,140,-165,0.4002882599580712,0.5997117400419287,away,STL,over,9,0.5121951219512195,-105,0.48808156828023186,WSH,STL,2022 REG,8,2,6,6,8,14,0,1,-4,4,1,1,0,0,0,0,0,0,0,0.48808156828023186,0.5119184317197681
85810,0.4166666666666667,0.6226415094339623,140,-165,0.4002882599580712,0.5997117400419287,home,WSH,under,9,0.5348837209302326,-115,0.5119184317197681,WSH,STL,2022 REG,8,2,6,6,8,14,0,1,-4,4,1,1,0,0,0,0,0,0,0,0.48808156828023186,0.5119184317197681
85811,0.7967479674796748,0.24390243902439027,-392,310,0.7643598387203383,0.2356401612796617,away,KC,over,8.5,0.5073891625615764,-103,0.4837652908580103,NYY,KC,2022 REG,11,11,9,5,16,20,1,0,6,-6,1,1,1,1,1,0,0,0,0,0.4837652908580103,0.5162347091419897
85811,0.7967479674796748,0.24390243902439027,-392,310,0.7643598387203383,0.2356401612796617,home,NYY,under,8.5,0.5391705069124424,-117,0.5162347091419897,NYY,KC,2022 REG,11,11,9,5,16,20,1,0,6,-6,1,1,1,1,1,0,0,0,0,0.4837652908580103,0.5162347091419897
85812,0.36363636363636365,0.6721311475409836,175,-205,0.3506299959355101,0.6493700040644899,away,NYY,over,7.5,0.5348837209302326,-115,0.5097020142727117,TEX,NYY,2022 REG,6,3,5,2,5,11,1,0,1,-1,1,1,0,0,0,0,0,0,0,0.5097020142727117,0.49029798572728833
85812,0.36363636363636365,0.6721311475409836,175,-205,0.3506299959355101,0.6493700040644899,home,TEX,under,7.5,0.5121951219512195,-105,0.49029798572728833,TEX,NYY,2022 REG,6,3,5,2,5,11,1,0,1,-1,1,1,0,0,0,0,0,0,0,0.5097020142727117,0.49029798572728833
85813,0.48780487804878053,0.5495495495495495,105,-122,0.4695832060495952,0.5304167939504048,away,NYM,over,5.5,0.5192307692307692,-108,0.4856441635287789,COL,NYM,2022 REG,6,0,7,2,2,13,0,1,-2,2,0,0,0,0,0,0,0,0,0,0.5109810284308424,0.48901897156915763
85813,0.48780487804878053,0.5495495495495495,105,-122,0.4695832060495952,0.5304167939504048,away,NYM,over,10.5,0.5348837209302326,-115,0.5109810284308424,COL,NYM,2022 REG,6,0,7,2,2,13,0,1,-2,2,0,0,0,0,0,0,0,0,0,0.5109810284308424,0.48901897156915763
85813,0.48780487804878053,0.5495495495495495,105,-122,0.4695832060495952,0.5304167939504048,home,COL,under,5.5,0.5454545454545454,-120,0.5143558364712211,COL,NYM,2022 REG,6,0,7,2,2,13,0,1,-2,2,0,0,0,0,0,0,0,0,0,0.5109810284308424,0.48901897156915763
85813,0.48780487804878053,0.5495495495495495,105,-122,0.4695832060495952,0.5304167939504048,home,COL,under,10.5,0.5098039215686274,-104,0.48901897156915763,COL,NYM,2022 REG,6,0,7,2,2,13,0,1,-2,2,0,0,0,0,0,0,0,0,0,0.5109810284308424,0.48901897156915763
85814,0.6923076923076923,0.35211267605633806,-225,184,0.6615551295941329,0.3384448704058671,away,DET,over,7.5,0.5121951219512195,-105,0.48919479393107135,CLE,DET,2022 REG,11,8,5,4,12,16,1,0,4,-4,1,1,1,1,0,0,0,0,0,0.48919479393107135,0.5108052060689287
85814,0.6923076923076923,0.35211267605633806,-225,184,0.6615551295941329,0.3384448704058671,home,CLE,under,7.5,0.5327102803738317,-114,0.5108052060689287,CLE,DET,2022 REG,11,8,5,4,12,16,1,0,4,-4,1,1,1,1,0,0,0,0,0,0.48919479393107135,0.5108052060689287
85815,0.4587155963302753,0.5798319327731092,118,-138,0.4410332435305576,0.5589667564694424,away,CHC,over,8,0.5098039215686274,-104,0.48592421718142587,WSH,CHC,2022 REG,8,5,7,4,9,15,1,0,1,-1,1,1,1,1,0,0,0,0,0,0.48592421718142587,0.5140757828185741
85815,0.4587155963302753,0.5798319327731092,118,-138,0.4410332435305576,0.5589667564694424,home,WSH,under,8,0.5370370370370371,-116,0.5140757828185741,WSH,CHC,2022 REG,8,5,7,4,9,15,1,0,1,-1,1,1,1,1,0,0,0,0,0,0.48592421718142587,0.5140757828185741
85816,0.7142857142857143,0.3333333333333333,-250,200,0.6802721088435374,0.3197278911564626,away,CHC,over,9,0.504950495049505,-102,0.48054649490447493,TOR,CHC,2022 REG,9,5,14,4,9,23,1,0,1,-1,1,1,1,1,0,0,0,0,0,0.48054649490447493,0.5194535050955251
85816,0.7142857142857143,0.3333333333333333,-250,200,0.6802721088435374,0.3197278911564626,home,TOR,under,9,0.5433789954337899,-119,0.5194535050955251,TOR,CHC,2022 REG,9,5,14,4,9,23,1,0,1,-1,1,1,1,1,0,0,0,0,0,0.48054649490447493,0.5194535050955251
85817,0.5121951219512195,0.5348837209302326,-105,-115,0.48808156828023186,0.5119184317197681,away,MIA,over,8.5,0.5454545454545454,-120,0.5179608869977906,CHC,MIA,2022 REG,10,4,5,0,4,15,1,0,4,-4,0,0,0,0,0,0,0,0,0,0.5179608869977906,0.48203911300220936
85817,0.5121951219512195,0.5348837209302326,-105,-115,0.48808156828023186,0.5119184317197681,home,CHC,under,8.5,0.504950495049505,-102,0.48203911300220936,CHC,MIA,2022 REG,10,4,5,0,4,15,1,0,4,-4,0,0,0,0,0,0,0,0,0,0.5179608869977906,0.48203911300220936
85818,0.6666666666666666,0.37037037037037035,-200,170,0.6419753086419753,0.3580246913580247,away,CLE,over,8.5,0.5215311004784688,-109,0.4978845547971712,HOU,CLE,2022 REG,4,1,9,6,7,13,0,1,-5,5,1,0,0,0,0,0,0,0,0,0.4978845547971712,0.5021154452028288
85818,0.6666666666666666,0.37037037037037035,-200,170,0.6419753086419753,0.3580246913580247,home,HOU,under,8.5,0.5238095238095238,-110,0.5021154452028288,HOU,CLE,2022 REG,4,1,9,6,7,13,0,1,-5,5,1,0,0,0,0,0,0,0,0,0.4978845547971712,0.5021154452028288
85819,0.6226415094339623,0.4184100418410042,-165,139,0.5970811095835115,0.40291889041648854,away,NYM,over,8.5,0.5454545454545454,-120,0.5193043049216726,ATL,NYM,2022 REG,8,5,3,0,5,11,1,0,5,-5,0,0,0,0,0,0,0,0,0,0.5193043049216726,0.48069569507832743
85819,0.6226415094339623,0.4184100418410042,-165,139,0.5970811095835115,0.40291889041648854,home,ATL,under,8.5,0.5024875621890548,-101,0.48069569507832743,ATL,NYM,2022 REG,8,5,3,0,5,11,1,0,5,-5,0,0,0,0,0,0,0,0,0,0.5193043049216726,0.48069569507832743
85820,0.5967741935483871,0.4444444444444444,-148,125,0.5721759741010521,0.42782402589894786,away,SEA,over,8.5,0.5121951219512195,-105,0.48808156828023186,MIN,SEA,2022 REG,4,3,9,4,7,13,0,1,-1,1,1,1,1,0,0,0,0,0,0,0.48808156828023186,0.5119184317197681
85820,0.5967741935483871,0.4444444444444444,-148,125,0.5721759741010521,0.42782402589894786,home,MIN,under,8.5,0.5348837209302326,-115,0.5119184317197681,MIN,SEA,2022 REG,4,3,9,4,7,13,0,1,-1,1,1,1,1,0,0,0,0,0,0,0.48808156828023186,0.5119184317197681
85821,0.6153846153846154,0.4166666666666667,-160,140,0.5956607495069033,0.4043392504930967,away,BAL,over,10.5,0.5238095238095238,-110,0.4988662131519274,BOS,BAL,2022 REG,9,2,7,4,6,16,0,1,-2,2,1,1,0,0,0,0,0,0,0,0.4988662131519274,0.5011337868480725
85821,0.6153846153846154,0.4166666666666667,-160,140,0.5956607495069033,0.4043392504930967,home,BOS,under,10.5,0.5238095238095238,-110,0.5011337868480725,BOS,BAL,2022 REG,9,2,7,4,6,16,0,1,-2,2,1,1,0,0,0,0,0,0,0,0.4988662131519274,0.5011337868480725
85822,0.6031746031746031,0.44052863436123346,-152,127,0.5768139202164795,0.4231860797835205,away,MIL,over,8,0.5283018867924528,-112,0.5044173060022736,PHI,MIL,2022 REG,7,3,9,5,8,16,0,1,-2,2,1,1,1,0,0,0,0,0,0,0.5044173060022736,0.49558269399772636
85822,0.6031746031746031,0.44052863436123346,-152,127,0.5768139202164795,0.4231860797835205,home,PHI,under,8,0.5169082125603864,-107,0.49558269399772636,PHI,MIL,2022 REG,7,3,9,5,8,16,0,1,-2,2,1,1,1,0,0,0,0,0,0,0.5044173060022736,0.49558269399772636
85823,0.5,0.5391705069124424,100,-117,0.4804147465437788,0.5195852534562212,away,SD,over,11.5,0.5305164319248826,-113,0.5066009958897986,COL,SD,2022 REG,9,5,10,4,9,19,1,0,1,-1,1,1,1,1,0,0,0,0,0,0.5066009958897986,0.49339900411020143
85823,0.5,0.5391705069124424,100,-117,0.4804147465437788,0.5195852534562212,home,COL,under,11.5,0.5145631067961165,-106,0.49339900411020143,COL,SD,2022 REG,9,5,10,4,9,19,1,0,1,-1,1,1,1,1,0,0,0,0,0,0.5066009958897986,0.49339900411020143
85824,0.5515695067264574,0.49019607843137253,-123,104,0.5285328835228112,0.47146711647718875,away,SEA,over,7,0.5169082125603864,-107,0.49586088023391106,MIA,SEA,2022 REG,10,3,12,7,10,22,0,1,-4,4,1,1,1,0,0,0,0,0,0,0.49586088023391106,0.5041391197660889
85824,0.5515695067264574,0.49019607843137253,-123,104,0.5285328835228112,0.47146711647718875,home,MIA,under,7,0.5238095238095238,-110,0.5041391197660889,MIA,SEA,2022 REG,10,3,12,7,10,22,0,1,-4,4,1,1,1,0,0,0,0,0,0,0.49586088023391106,0.5041391197660889
85825,0.5348837209302326,0.5121951219512195,-115,-105,0.5097020142727117,0.49029798572728833,away,LAA,over,7.5,0.5073891625615764,-103,0.4826927225525911,CLE,LAA,2022 REG,13,5,10,3,8,23,1,0,2,-2,1,1,1,0,0,0,0,0,0,0.4826927225525911,0.5173072774474089
85825,0.5348837209302326,0.5121951219512195,-115,-105,0.5097020142727117,0.49029798572728833,home,CLE,under,7.5,0.5412844036697247,-118,0.5173072774474089,CLE,LAA,2022 REG,13,5,10,3,8,23,1,0,2,-2,1,1,1,0,0,0,0,0,0,0.4826927225525911,0.5173072774474089
85827,0.726027397260274,0.31746031746031744,-265,215,0.6944541249288857,0.3055458750711143,away,LAA,over,9,0.5260663507109005,-111,0.5010269332605688,TOR,LAA,2022 REG,9,3,13,8,11,22,0,1,-5,5,1,1,1,0,0,0,0,0,0,0.5010269332605688,0.4989730667394312
85827,0.726027397260274,0.31746031746031744,-265,215,0.6944541249288857,0.3055458750711143,home,TOR,under,9,0.5215311004784688,-109,0.4989730667394312,TOR,LAA,2022 REG,9,3,13,8,11,22,0,1,-5,5,1,1,1,0,0,0,0,0,0,0.5010269332605688,0.4989730667394312
85828,0.5238095238095238,0.5238095238095238,-110,-110,0.4988662131519274,0.5011337868480725,away,LAA,over,8.5,0.5454545454545454,-120,0.5206611570247933,BAL,LAA,2022 REG,11,9,8,5,14,19,1,0,4,-4,1,1,1,1,1,0,0,0,0,0.5206611570247933,0.4793388429752067
85828,0.5238095238095238,0.5238095238095238,-110,-110,0.4988662131519274,0.5011337868480725,home,BAL,under,8.5,0.5,100,0.4793388429752067,BAL,LAA,2022 REG,11,9,8,5,14,19,1,0,4,-4,1,1,1,1,1,0,0,0,0,0.5206611570247933,0.4793388429752067
85829,0.7389033942558746,0.29850746268656714,-283,235,0.7112603850790834,0.2887396149209166,away,CIN,over,8,0.5238095238095238,-110,0.5012646084074657,STL,CIN,2022 REG,3,2,7,3,5,10,0,1,-1,1,1,1,0,0,0,0,0,0,0,0.5012646084074657,0.4987353915925343
85829,0.7389033942558746,0.29850746268656714,-283,235,0.7112603850790834,0.2887396149209166,home,STL,under,8,0.5192307692307692,-108,0.4987353915925343,STL,CIN,2022 REG,3,2,7,3,5,10,0,1,-1,1,1,1,0,0,0,0,0,0,0,0.5012646084074657,0.4987353915925343
85830,0.6453900709219857,0.3921568627450981,-182,155,0.6211576527396834,0.3788423472603166,away,TEX,over,8,0.5305164319248826,-113,0.5066009958897986,HOU,TEX,2022 REG,8,0,5,3,3,13,0,1,-3,3,0,0,0,0,0,0,0,0,0,0.5066009958897986,0.49339900411020143
85830,0.6453900709219857,0.3921568627450981,-182,155,0.6211576527396834,0.3788423472603166,home,HOU,under,8,0.5145631067961165,-106,0.49339900411020143,HOU,TEX,2022 REG,8,0,5,3,3,13,0,1,-3,3,0,0,0,0,0,0,0,0,0,0.5066009958897986,0.49339900411020143
85831,0.7354497354497355,0.3058103975535168,-278,227,0.7051049815478727,0.2948950184521273,away,SEA,over,8,0.5327102803738317,-114,0.508788710910954,HOU,SEA,2022 REG,7,4,6,1,5,13,1,0,3,-3,1,0,0,0,0,0,0,0,0,0.508788710910954,0.491211289089046
85831,0.7354497354497355,0.3058103975535168,-278,227,0.7051049815478727,0.2948950184521273,home,HOU,under,8,0.5121951219512195,-105,0.491211289089046,HOU,SEA,2022 REG,7,4,6,1,5,13,1,0,3,-3,1,0,0,0,0,0,0,0,0,0.508788710910954,0.491211289089046
85833,0.4629629629629629,0.576271186440678,116,-136,0.4447990049057217,0.5552009950942782,away,ATL,over,7.5,0.5391705069124424,-117,0.5140669063204599,MIA,ATL,2022 REG,5,2,11,5,7,16,0,1,-3,3,1,1,0,0,0,0,0,0,0,0.5140669063204599,0.4859330936795401
85833,0.4629629629629629,0.576271186440678,116,-136,0.4447990049057217,0.5552009950942782,home,MIA,under,7.5,0.5073891625615764,-103,0.4859330936795401,MIA,ATL,2022 REG,5,2,11,5,7,16,0,1,-3,3,1,1,0,0,0,0,0,0,0,0.5140669063204599,0.4859330936795401
85834,0.5708154506437768,0.4672897196261683,-133,114,0.5490644307042802,0.45093556929571976,away,MIN,over,8,0.5348837209302326,-115,0.5097020142727117,CWS,MIN,2022 REG,7,1,12,5,6,19,0,1,-4,4,1,0,0,0,0,0,0,0,0,0.5097020142727117,0.49029798572728833
85834,0.5708154506437768,0.4672897196261683,-133,114,0.5490644307042802,0.45093556929571976,home,CWS,under,8,0.5121951219512195,-105,0.49029798572728833,CWS,MIN,2022 REG,7,1,12,5,6,19,0,1,-4,4,1,0,0,0,0,0,0,0,0,0.5097020142727117,0.49029798572728833
85835,0.6575342465753424,0.38314176245210724,-192,161,0.6307883776257865,0.36921162237421346,away,BAL,over,8,0.5238095238095238,-110,0.5000596729920038,HOU,BAL,2022 REG,4,0,7,2,2,11,0,1,-2,2,0,0,0,0,0,0,0,0,0,0.5000596729920038,0.4999403270079962
85835,0.6575342465753424,0.38314176245210724,-192,161,0.6307883776257865,0.36921162237421346,home,HOU,under,8,0.5215311004784688,-109,0.4999403270079962,HOU,BAL,2022 REG,4,0,7,2,2,11,0,1,-2,2,0,0,0,0,0,0,0,0,0,0.5000596729920038,0.4999403270079962
85836,0.5391705069124424,0.5,-117,100,0.5180509248444435,0.4819490751555565,away,SD,over,8,0.5305164319248826,-113,0.5078572507605655,ATL,SD,2022 REG,5,3,7,7,10,12,0,1,-4,4,1,1,1,0,0,0,0,0,0,0.5078572507605655,0.49214274923943446
85836,0.5391705069124424,0.5,-117,100,0.5180509248444435,0.4819490751555565,home,ATL,under,8,0.5121951219512195,-105,0.49214274923943446,ATL,SD,2022 REG,5,3,7,7,10,12,0,1,-4,4,1,1,1,0,0,0,0,0,0,0.5078572507605655,0.49214274923943446
85838,0.5391705069124424,0.5,-117,100,0.5180509248444435,0.4819490751555565,away,LAA,over,8.5,0.5327102803738317,-114,0.5075272610403079,CWS,LAA,2022 REG,10,4,6,0,4,16,1,0,4,-4,0,0,0,0,0,0,0,0,0,0.5075272610403079,0.4924727389596921
85838,0.5391705069124424,0.5,-117,100,0.5180509248444435,0.4819490751555565,home,CWS,under,8.5,0.5145631067961165,-106,0.4924727389596921,CWS,LAA,2022 REG,10,4,6,0,4,16,1,0,4,-4,0,0,0,0,0,0,0,0,0,0.5075272610403079,0.4924727389596921
85840,0.43859649122807015,0.6000000000000001,128,-150,0.4216682056017235,0.5783317943982764,away,SD,over,7.5,0.5121951219512195,-105,0.48919479393107135,MIA,SD,2022 REG,6,4,10,3,7,16,1,0,1,-1,1,1,1,0,0,0,0,0,0,0.48919479393107135,0.5108052060689287
85840,0.43859649122807015,0.6000000000000001,128,-150,0.4216682056017235,0.5783317943982764,home,MIA,under,7.5,0.5327102803738317,-114,0.5108052060689287,MIA,SD,2022 REG,6,4,10,3,7,16,1,0,1,-1,1,1,1,0,0,0,0,0,0,0.48919479393107135,0.5108052060689287
85842,0.5145631067961165,0.5260663507109005,-106,-111,0.49365668691386505,0.506343313086135,away,NYM,over,7,0.5327102803738317,-114,0.508788710910954,STL,NYM,2022 REG,3,0,8,3,3,11,0,1,-3,3,0,0,0,0,0,0,0,0,0,0.508788710910954,0.491211289089046
85842,0.5145631067961165,0.5260663507109005,-106,-111,0.49365668691386505,0.506343313086135,home,STL,under,7,0.5121951219512195,-105,0.491211289089046,STL,NYM,2022 REG,3,0,8,3,3,11,0,1,-3,3,0,0,0,0,0,0,0,0,0,0.508788710910954,0.491211289089046
85844,0.5412844036697247,0.5024875621890548,-118,-101,0.5175913212324037,0.4824086787675963,away,SD,over,8.5,0.5348837209302326,-115,0.5097020142727117,PHI,SD,2022 REG,5,0,8,3,3,13,0,1,-3,3,0,0,0,0,0,0,0,0,0,0.5097020142727117,0.49029798572728833
85844,0.5412844036697247,0.5024875621890548,-118,-101,0.5175913212324037,0.4824086787675963,home,PHI,under,8.5,0.5121951219512195,-105,0.49029798572728833,PHI,SD,2022 REG,5,0,8,3,3,13,0,1,-3,3,0,0,0,0,0,0,0,0,0,0.5097020142727117,0.49029798572728833
85845,0.6441281138790036,0.3921568627450981,-181,155,0.6207559403239772,0.3792440596760228,away,KC,over,8,0.5121951219512195,-105,0.48919479393107135,MIN,KC,2022 REG,15,10,13,7,17,28,1,0,3,-3,1,1,1,1,1,1,1,0,0,0.48919479393107135,0.5108052060689287
85845,0.6441281138790036,0.3921568627450981,-181,155,0.6207559403239772,0.3792440596760228,home,MIN,under,8,0.5327102803738317,-114,0.5108052060689287,MIN,KC,2022 REG,15,10,13,7,17,28,1,0,3,-3,1,1,1,1,1,1,1,0,0,0.48919479393107135,0.5108052060689287
85850,0.5798319327731092,0.46511627906976744,-138,115,0.5537695242255589,0.4462304757744411,away,SD,over,9,0.5,100,0.4772727272727273,LAD,SD,2022 REG,11,4,2,0,4,13,1,0,4,-4,0,0,0,0,0,0,0,0,0,0.4772727272727273,0.5227272727272727
85850,0.5798319327731092,0.46511627906976744,-138,115,0.5537695242255589,0.4462304757744411,home,LAD,under,9,0.5454545454545454,-120,0.5227272727272727,LAD,SD,2022 REG,11,4,2,0,4,13,1,0,4,-4,0,0,0,0,0,0,0,0,0,0.4772727272727273,0.5227272727272727
85851,0.6551724137931035,0.38314176245210724,-190,161,0.6300700224600344,0.3699299775399656,away,DET,over,8.5,0.5121951219512195,-105,0.48808156828023186,LAA,DET,2022 REG,16,10,4,0,10,20,1,0,10,-10,0,0,0,0,0,0,0,0,0,0.48808156828023186,0.5119184317197681
85851,0.6551724137931035,0.38314176245210724,-190,161,0.6300700224600344,0.3699299775399656,home,LAA,under,8.5,0.5348837209302326,-115,0.5119184317197681,LAA,DET,2022 REG,16,10,4,0,10,20,1,0,10,-10,0,0,0,0,0,0,0,0,0,0.48808156828023186,0.5119184317197681
85852,0.5412844036697247,0.5,-118,100,0.5189377998484975,0.4810622001515025,away,NYY,over,7.5,0.5,100,0.47522522522522526,TB,NYY,2022 REG,2,0,6,2,2,8,0,1,-2,2,0,0,0,0,0,0,0,0,0,0.47522522522522526,0.5247747747747747
85852,0.5412844036697247,0.5,-118,100,0.5189377998484975,0.4810622001515025,home,TB,under,7.5,0.5495495495495495,-122,0.5247747747747747,TB,NYY,2022 REG,2,0,6,2,2,8,0,1,-2,2,0,0,0,0,0,0,0,0,0,0.47522522522522526,0.5247747747747747
85853,0.6441281138790036,0.3921568627450981,-181,155,0.6207559403239772,0.3792440596760228,away,MIN,over,7.5,0.5121951219512195,-105,0.48919479393107135,TB,MIN,2022 REG,4,1,14,9,10,18,0,1,-8,8,1,0,0,0,0,0,0,0,0,0.48919479393107135,0.5108052060689287
85853,0.6441281138790036,0.3921568627450981,-181,155,0.6207559403239772,0.3792440596760228,home,TB,under,7.5,0.5327102803738317,-114,0.5108052060689287,TB,MIN,2022 REG,4,1,14,9,10,18,0,1,-8,8,1,0,0,0,0,0,0,0,0,0.48919479393107135,0.5108052060689287
85854,0.49504950495049505,0.5475113122171946,102,-121,0.4739797934813417,0.5260202065186583,away,SEA,over,9,0.5098039215686274,-104,0.48375889301574193,BAL,SEA,2022 REG,8,6,12,7,13,20,0,1,-1,1,1,1,1,1,1,1,0,0,0,0.48375889301574193,0.5162411069842581
85854,0.49504950495049505,0.5475113122171946,102,-121,0.4739797934813417,0.5260202065186583,home,BAL,under,9,0.5412844036697247,-118,0.5162411069842581,BAL,SEA,2022 REG,8,6,12,7,13,20,0,1,-1,1,1,1,1,1,1,1,0,0,0,0.48375889301574193,0.5162411069842581
85855,0.35714285714285715,0.6875,180,-220,0.3411989795918367,0.6588010204081634,away,MIL,over,9,0.5348837209302326,-115,0.5097020142727117,PIT,MIL,2022 REG,9,7,11,4,11,20,1,0,3,-3,1,1,1,1,0,0,0,0,0,0.5097020142727117,0.49029798572728833
85855,0.35714285714285715,0.6875,180,-220,0.3411989795918367,0.6588010204081634,home,PIT,under,9,0.5121951219512195,-105,0.49029798572728833,PIT,MIL,2022 REG,9,7,11,4,11,20,1,0,3,-3,1,1,1,1,0,0,0,0,0,0.5097020142727117,0.49029798572728833
85856,0.45454545454545453,0.5815899581589958,120,-139,0.43812026695252254,0.5618797330474774,away,MIL,over,11.5,0.5348837209302326,-115,0.5097020142727117,COL,MIL,2022 REG,9,8,7,4,12,16,1,0,4,-4,1,1,1,1,0,0,0,0,0,0.5097020142727117,0.49029798572728833
85856,0.45454545454545453,0.5815899581589958,120,-139,0.43812026695252254,0.5618797330474774,home,COL,under,11.5,0.5121951219512195,-105,0.49029798572728833,COL,MIL,2022 REG,9,8,7,4,12,16,1,0,4,-4,1,1,1,1,0,0,0,0,0,0.5097020142727117,0.49029798572728833
85857,0.5215311004784688,0.5215311004784688,-109,-109,0.49907282342437215,0.5009271765756278,away,NYY,over,7,0.5348837209302326,-115,0.5097020142727117,TEX,NYY,2022 REG,8,4,8,5,9,16,0,1,-1,1,1,1,1,1,0,0,0,0,0,0.5097020142727117,0.49029798572728833
85857,0.5215311004784688,0.5215311004784688,-109,-109,0.49907282342437215,0.5009271765756278,home,TEX,under,7,0.5121951219512195,-105,0.49029798572728833,TEX,NYY,2022 REG,8,4,8,5,9,16,0,1,-1,1,1,1,1,1,0,0,0,0,0,0.5097020142727117,0.49029798572728833
85858,0.6551724137931035,0.3891050583657587,-190,157,0.6261630354821247,0.3738369645178753,away,ARI,over,7.5,0.5,100,0.4772727272727273,MIA,ARI,2022 REG,6,4,9,5,9,15,0,1,-1,1,1,1,1,1,0,0,0,0,0,0.4772727272727273,0.5227272727272727
85858,0.6551724137931035,0.3891050583657587,-190,157,0.6261630354821247,0.3738369645178753,home,MIA,under,7.5,0.5454545454545454,-120,0.5227272727272727,MIA,ARI,2022 REG,6,4,9,5,9,15,0,1,-1,1,1,1,1,1,0,0,0,0,0,0.4772727272727273,0.5227272727272727
85859,0.49751243781094534,0.5454545454545454,101,-120,0.476135829221149,0.523864170778851,away,LAD,over,8,0.5169082125603864,-107,0.49353874091423283,SD,LAD,2022 REG,5,3,5,2,5,10,1,0,1,-1,1,1,0,0,0,0,0,0,0,0.49353874091423283,0.5064612590857671
85859,0.49751243781094534,0.5454545454545454,101,-120,0.476135829221149,0.523864170778851,home,SD,under,8,0.5283018867924528,-112,0.5064612590857671,SD,LAD,2022 REG,5,3,5,2,5,10,1,0,1,-1,1,1,0,0,0,0,0,0,0,0.49353874091423283,0.5064612590857671
85860,0.5305164319248826,0.5121951219512195,-113,-105,0.5078572507605655,0.49214274923943446,away,PHI,over,8,0.5145631067961165,-106,0.4925063625223866,MIA,PHI,2022 REG,5,0,15,10,10,20,0,1,-10,10,0,0,0,0,0,0,0,0,0,0.4925063625223866,0.5074936374776133
85860,0.5305164319248826,0.5121951219512195,-113,-105,0.5078572507605655,0.49214274923943446,home,MIA,under,8,0.5283018867924528,-112,0.5074936374776133,MIA,PHI,2022 REG,5,0,15,10,10,20,0,1,-10,10,0,0,0,0,0,0,0,0,0,0.4925063625223866,0.5074936374776133
85861,0.7530864197530864,0.2857142857142857,-305,250,0.7238661353887691,0.2761338646112309,away,PIT,over,8.5,0.5454545454545454,-120,0.5193043049216726,ATL,PIT,2022 REG,6,3,8,1,4,14,1,0,2,-2,1,0,0,0,0,0,0,0,0,0.5193043049216726,0.48069569507832743
85861,0.7530864197530864,0.2857142857142857,-305,250,0.7238661353887691,0.2761338646112309,home,ATL,under,8.5,0.5024875621890548,-101,0.48069569507832743,ATL,PIT,2022 REG,6,3,8,1,4,14,1,0,2,-2,1,0,0,0,0,0,0,0,0,0.5193043049216726,0.48069569507832743
85862,0.6575342465753424,0.38167938931297707,-192,162,0.6317499380460364,0.3682500619539636,away,PIT,over,9,0.5238095238095238,-110,0.4988662131519274,BAL,PIT,2022 REG,4,1,9,8,9,13,0,1,-7,7,1,0,0,0,0,0,0,0,0,0.4988662131519274,0.5011337868480725
85862,0.6575342465753424,0.38167938931297707,-192,162,0.6317499380460364,0.3682500619539636,home,BAL,under,9,0.5238095238095238,-110,0.5011337868480725,BAL,PIT,2022 REG,4,1,9,8,9,13,0,1,-7,7,1,0,0,0,0,0,0,0,0,0.4988662131519274,0.5011337868480725
85864,0.6551724137931035,0.3846153846153846,-190,160,0.6291045458703008,0.37089545412969915,away,CHC,over,7.5,0.5,100,0.4772727272727273,STL,CHC,2022 REG,7,2,2,0,2,9,1,0,2,-2,0,0,0,0,0,0,0,0,0,0.4772727272727273,0.5227272727272727
85864,0.6551724137931035,0.3846153846153846,-190,160,0.6291045458703008,0.37089545412969915,home,STL,under,7.5,0.5454545454545454,-120,0.5227272727272727,STL,CHC,2022 REG,7,2,2,0,2,9,1,0,2,-2,0,0,0,0,0,0,0,0,0,0.4772727272727273,0.5227272727272727
85866,0.646643109540636,0.3921568627450981,-183,155,0.6215533748116984,0.37844662518830163,away,DET,over,8.5,0.5238095238095238,-110,0.5000596729920038,MIN,DET,2022 REG,7,5,10,4,9,17,1,0,1,-1,1,1,1,1,0,0,0,0,0,0.5000596729920038,0.4999403270079962
85866,0.646643109540636,0.3921568627450981,-183,155,0.6215533748116984,0.37844662518830163,home,MIN,under,8.5,0.5215311004784688,-109,0.4999403270079962,MIN,DET,2022 REG,7,5,10,4,9,17,1,0,1,-1,1,1,1,1,0,0,0,0,0,0.5000596729920038,0.4999403270079962
85867,0.6428571428571428,0.4,-180,150,0.6153061224489796,0.38469387755102036,away,SF,over,8,0.5073891625615764,-103,0.48484779035144243,LAD,SF,2022 REG,7,4,5,2,6,12,1,0,2,-2,1,1,0,0,0,0,0,0,0,0.48484779035144243,0.5151522096485576
85867,0.6428571428571428,0.4,-180,150,0.6153061224489796,0.38469387755102036,home,LAD,under,8,0.5370370370370371,-116,0.5151522096485576,LAD,SF,2022 REG,7,4,5,2,6,12,1,0,2,-2,1,1,0,0,0,0,0,0,0,0.48484779035144243,0.5151522096485576
85868,0.4566210045662101,0.5833333333333333,119,-140,0.4383770146577428,0.5616229853422572,away,SF,over,9.5,0.5348837209302326,-115,0.5097020142727117,COL,SF,2022 REG,5,1,15,6,7,20,0,1,-5,5,1,0,0,0,0,0,0,0,0,0.5097020142727117,0.49029798572728833
85868,0.4566210045662101,0.5833333333333333,119,-140,0.4383770146577428,0.5616229853422572,home,COL,under,9.5,0.5121951219512195,-105,0.49029798572728833,COL,SF,2022 REG,5,1,15,6,7,20,0,1,-5,5,1,0,0,0,0,0,0,0,0,0.5097020142727117,0.49029798572728833
85869,0.6845425867507886,0.35714285714285715,-217,180,0.6560071251579774,0.34399287484202257,away,DET,over,8.5,0.5454545454545454,-120,0.5179608869977906,MIN,DET,2022 REG,7,4,4,1,5,11,1,0,3,-3,1,0,0,0,0,0,0,0,0,0.5179608869977906,0.48203911300220936
85869,0.6845425867507886,0.35714285714285715,-217,180,0.6560071251579774,0.34399287484202257,home,MIN,under,8.5,0.504950495049505,-102,0.48203911300220936,MIN,DET,2022 REG,7,4,4,1,5,11,1,0,3,-3,1,0,0,0,0,0,0,0,0,0.5179608869977906,0.48203911300220936
85870,0.6742671009771988,0.36101083032490977,-207,177,0.6504803525096533,0.3495196474903467,away,OAK,over,10,0.5098039215686274,-104,0.4870219861770517,TOR,OAK,2022 REG,11,4,6,1,5,17,1,0,3,-3,1,0,0,0,0,0,0,0,0,0.4870219861770517,0.5129780138229483
85870,0.6742671009771988,0.36101083032490977,-207,177,0.6504803525096533,0.3495196474903467,home,TOR,under,10,0.5348837209302326,-115,0.5129780138229483,TOR,OAK,2022 REG,11,4,6,1,5,17,1,0,3,-3,1,0,0,0,0,0,0,0,0,0.4870219861770517,0.5129780138229483
85871,0.5454545454545454,0.49504950495049505,-120,102,0.5233614270517961,0.4766385729482039,away,ARI,over,7.5,0.5348837209302326,-115,0.5097020142727117,SF,ARI,2022 REG,8,4,12,8,12,20,0,1,-4,4,1,1,1,1,0,0,0,0,0,0.5097020142727117,0.49029798572728833
85871,0.5454545454545454,0.49504950495049505,-120,102,0.5233614270517961,0.4766385729482039,home,SF,under,7.5,0.5121951219512195,-105,0.49029798572728833,SF,ARI,2022 REG,8,4,12,8,12,20,0,1,-4,4,1,1,1,1,0,0,0,0,0,0.5097020142727117,0.49029798572728833
85872,0.37735849056603776,0.6610169491525424,165,-195,0.36287719255902645,0.6371228074409736,away,SF,over,7.5,0.5454545454545454,-120,0.5206611570247933,ARI,SF,2022 REG,11,8,7,3,11,18,1,0,5,-5,1,1,1,0,0,0,0,0,0,0.5206611570247933,0.4793388429752067
85872,0.37735849056603776,0.6610169491525424,165,-195,0.36287719255902645,0.6371228074409736,home,ARI,under,7.5,0.5,100,0.4793388429752067,ARI,SF,2022 REG,11,8,7,3,11,18,1,0,5,-5,1,1,1,0,0,0,0,0,0,0.5206611570247933,0.4793388429752067
85873,0.30303030303030304,0.7354497354497355,230,-278,0.29136968530907925,0.7086303146909207,away,TOR,over,8.5,0.5121951219512195,-105,0.48808156828023186,DET,TOR,2022 REG,8,3,9,1,4,17,1,0,2,-2,1,0,0,0,0,0,0,0,0,0.48808156828023186,0.5119184317197681
85873,0.30303030303030304,0.7354497354497355,230,-278,0.29136968530907925,0.7086303146909207,home,DET,under,8.5,0.5348837209302326,-115,0.5119184317197681,DET,TOR,2022 REG,8,3,9,1,4,17,1,0,2,-2,1,0,0,0,0,0,0,0,0,0.48808156828023186,0.5119184317197681
85874,0.5370370370370371,0.5,-116,100,0.5171467764060357,0.4828532235939643,away,OAK,over,7.5,0.5412844036697247,-118,0.5189377998484975,LAA,OAK,2022 REG,7,3,7,1,4,14,1,0,2,-2,1,0,0,0,0,0,0,0,0,0.5189377998484975,0.4810622001515025
85874,0.5370370370370371,0.5,-116,100,0.5171467764060357,0.4828532235939643,home,LAA,under,7.5,0.5,100,0.4810622001515025,LAA,OAK,2022 REG,7,3,7,1,4,14,1,0,2,-2,1,0,0,0,0,0,0,0,0,0.5189377998484975,0.4810622001515025
85875,0.5951417004048584,0.4444444444444444,-147,125,0.5715823348467713,0.42841766515322866,away,TB,over,9,0.5121951219512195,-105,0.48919479393107135,TOR,TB,2022 REG,11,9,9,2,11,20,1,0,7,-7,1,1,0,0,0,0,0,0,0,0.48919479393107135,0.5108052060689287
85875,0.5951417004048584,0.4444444444444444,-147,125,0.5715823348467713,0.42841766515322866,home,TOR,under,9,0.5327102803738317,-114,0.5108052060689287,TOR,TB,2022 REG,11,9,9,2,11,20,1,0,7,-7,1,1,0,0,0,0,0,0,0,0.48919479393107135,0.5108052060689287
85876,0.4329004329004329,0.6062992125984252,131,-154,0.4159308893944337,0.5840691106055663,away,STL,over,8.5,0.5238095238095238,-110,0.4988662131519274,PIT,STL,2022 REG,8,4,20,18,22,28,0,1,-14,14,1,1,1,1,0,0,0,0,0,0.4988662131519274,0.5011337868480725
85876,0.4329004329004329,0.6062992125984252,131,-154,0.4159308893944337,0.5840691106055663,home,PIT,under,8.5,0.5238095238095238,-110,0.5011337868480725,PIT,STL,2022 REG,8,4,20,18,22,28,0,1,-14,14,1,1,1,1,0,0,0,0,0,0.4988662131519274,0.5011337868480725
85877,0.7014925373134329,0.3412969283276451,-235,193,0.6714760464905872,0.32852395350941277,away,ARI,over,8,0.5370370370370371,-116,0.5118817074154765,ATL,ARI,2022 REG,5,1,4,0,1,9,1,0,1,-1,0,0,0,0,0,0,0,0,0,0.5118817074154765,0.48811829258452355
85877,0.7014925373134329,0.3412969283276451,-235,193,0.6714760464905872,0.32852395350941277,home,ATL,under,8,0.5098039215686274,-104,0.48811829258452355,ATL,ARI,2022 REG,5,1,4,0,1,9,1,0,1,-1,0,0,0,0,0,0,0,0,0,0.5118817074154765,0.48811829258452355
85878,0.6389891696750902,0.39840637450199207,-177,151,0.6150938219518283,0.38490617804817173,away,BOS,over,8,0.504950495049505,-102,0.4837488699364985,NYY,BOS,2022 REG,6,2,1,0,2,7,1,0,2,-2,0,0,0,0,0,0,0,0,0,0.4837488699364985,0.5162511300635015
85878,0.6389891696750902,0.39840637450199207,-177,151,0.6150938219518283,0.38490617804817173,home,NYY,under,8,0.5370370370370371,-116,0.5162511300635015,NYY,BOS,2022 REG,6,2,1,0,2,7,1,0,2,-2,0,0,0,0,0,0,0,0,0,0.4837488699364985,0.5162511300635015
85879,0.7468354430379747,0.29411764705882354,-295,240,0.7162502238517583,0.2837497761482417,away,TEX,over,8,0.5327102803738317,-114,0.508788710910954,HOU,TEX,2022 REG,4,4,5,3,7,9,1,0,1,-1,1,1,1,0,0,0,0,0,0,0.508788710910954,0.491211289089046
85879,0.7468354430379747,0.29411764705882354,-295,240,0.7162502238517583,0.2837497761482417,home,HOU,under,8,0.5121951219512195,-105,0.491211289089046,HOU,TEX,2022 REG,4,4,5,3,7,9,1,0,1,-1,1,1,1,0,0,0,0,0,0,0.508788710910954,0.491211289089046
85880,0.6376811594202898,0.4,-176,150,0.6136525939928585,0.38634740600714146,away,BAL,over,8.5,0.5121951219512195,-105,0.48808156828023186,TOR,BAL,2022 REG,8,6,4,1,7,12,1,0,5,-5,1,0,0,0,0,0,0,0,0,0.48808156828023186,0.5119184317197681
85880,0.6376811594202898,0.4,-176,150,0.6136525939928585,0.38634740600714146,home,TOR,under,8.5,0.5348837209302326,-115,0.5119184317197681,TOR,BAL,2022 REG,8,6,4,1,7,12,1,0,5,-5,1,0,0,0,0,0,0,0,0,0.48808156828023186,0.5119184317197681
85881,0.6774193548387096,0.36363636363636365,-210,175,0.6496074165168858,0.3503925834831142,away,OAK,over,8,0.5121951219512195,-105,0.48808156828023186,HOU,OAK,2022 REG,4,1,9,5,6,13,0,1,-4,4,1,0,0,0,0,0,0,0,0,0.48808156828023186,0.5119184317197681
85881,0.6774193548387096,0.36363636363636365,-210,175,0.6496074165168858,0.3503925834831142,home,HOU,under,8,0.5348837209302326,-115,0.5119184317197681,HOU,OAK,2022 REG,4,1,9,5,6,13,0,1,-4,4,1,0,0,0,0,0,0,0,0,0.48808156828023186,0.5119184317197681
85882,0.4854368932038835,0.5555555555555556,106,-125,0.465537646233282,0.534462353766718,away,ATL,over,7.5,0.49504950495049505,102,0.47499799484898986,PHI,ATL,2022 REG,5,3,10,6,9,15,0,1,-3,3,1,1,1,0,0,0,0,0,0,0.47499799484898986,0.5250020051510101
85882,0.4854368932038835,0.5555555555555556,106,-125,0.465537646233282,0.534462353766718,home,PHI,under,7.5,0.5454545454545454,-120,0.5250020051510101,PHI,ATL,2022 REG,5,3,10,6,9,15,0,1,-3,3,1,1,1,0,0,0,0,0,0,0.47499799484898986,0.5250020051510101
85883,0.4739336492890995,0.5670995670995671,111,-131,0.4544866273039494,0.5455133726960506,away,PHI,over,7,0.5283018867924528,-112,0.5044173060022736,SD,PHI,2022 REG,7,1,5,0,1,12,1,0,1,-1,0,0,0,0,0,0,0,0,0,0.5044173060022736,0.49558269399772636
85883,0.4739336492890995,0.5670995670995671,111,-131,0.4544866273039494,0.5455133726960506,home,SD,under,7,0.5169082125603864,-107,0.49558269399772636,SD,PHI,2022 REG,7,1,5,0,1,12,1,0,1,-1,0,0,0,0,0,0,0,0,0,0.5044173060022736,0.49558269399772636
85884,0.4926108374384236,0.5495495495495495,103,-122,0.4718421738975501,0.5281578261024499,away,TOR,over,7.5,0.5121951219512195,-105,0.48808156828023186,BAL,TOR,2022 REG,3,1,10,5,6,13,0,1,-4,4,1,0,0,0,0,0,0,0,0,0.48808156828023186,0.5119184317197681
85884,0.4926108374384236,0.5495495495495495,103,-122,0.4718421738975501,0.5281578261024499,home,BAL,under,7.5,0.5348837209302326,-115,0.5119184317197681,BAL,TOR,2022 REG,3,1,10,5,6,13,0,1,-4,4,1,0,0,0,0,0,0,0,0,0.48808156828023186,0.5119184317197681
85885,0.37037037037037035,0.6666666666666666,170,-200,0.35665294924554186,0.6433470507544581,away,NYY,over,8.5,0.5348837209302326,-115,0.5097020142727117,KC,NYY,2022 REG,8,2,10,12,14,18,0,1,-10,10,1,1,0,0,0,0,0,0,0,0.5097020142727117,0.49029798572728833
85885,0.37037037037037035,0.6666666666666666,170,-200,0.35665294924554186,0.6433470507544581,home,KC,under,8.5,0.5121951219512195,-105,0.49029798572728833,KC,NYY,2022 REG,8,2,10,12,14,18,0,1,-10,10,1,1,0,0,0,0,0,0,0,0.5097020142727117,0.49029798572728833
85886,0.576271186440678,0.46511627906976744,-136,115,0.552420782587201,0.44757921741279905,away,ATL,over,7,0.5121951219512195,-105,0.48808156828023186,NYM,ATL,2022 REG,8,6,7,2,8,15,1,0,4,-4,1,1,0,0,0,0,0,0,0,0.48808156828023186,0.5119184317197681
85886,0.576271186440678,0.46511627906976744,-136,115,0.552420782587201,0.44757921741279905,home,NYM,under,7,0.5348837209302326,-115,0.5119184317197681,NYM,ATL,2022 REG,8,6,7,2,8,15,1,0,4,-4,1,1,0,0,0,0,0,0,0,0.48808156828023186,0.5119184317197681
85889,0.4854368932038835,0.5555555555555556,106,-125,0.465537646233282,0.534462353766718,away,MIL,over,9,0.5348837209302326,-115,0.5097020142727117,CHC,MIL,2022 REG,8,6,4,5,11,12,1,0,1,-1,1,1,1,1,1,0,0,0,0,0.5097020142727117,0.49029798572728833
85889,0.4854368932038835,0.5555555555555556,106,-125,0.465537646233282,0.534462353766718,home,CHC,under,9,0.5121951219512195,-105,0.49029798572728833,CHC,MIL,2022 REG,8,6,4,5,11,12,1,0,1,-1,1,1,1,1,1,0,0,0,0,0.5097020142727117,0.49029798572728833
85890,0.6503496503496503,0.3921568627450981,-186,155,0.6227055544208978,0.3772944455791022,away,BOS,over,8,0.5348837209302326,-115,0.5109810284308424,TOR,BOS,2022 REG,8,6,9,5,11,17,1,0,1,-1,1,1,1,1,1,0,0,0,0,0.5109810284308424,0.48901897156915763
85890,0.6503496503496503,0.3921568627450981,-186,155,0.6227055544208978,0.3772944455791022,home,TOR,under,8,0.5098039215686274,-104,0.48901897156915763,TOR,BOS,2022 REG,8,6,9,5,11,17,1,0,1,-1,1,1,1,1,1,0,0,0,0,0.5109810284308424,0.48901897156915763
85891,0.45248868778280543,0.5850622406639003,121,-141,0.43549731744492953,0.5645026825550705,away,MIN,over,8,0.5215311004784688,-109,0.4978845547971712,KC,MIN,2022 REG,7,2,9,9,11,16,0,1,-7,7,1,1,0,0,0,0,0,0,0,0.4978845547971712,0.5021154452028288
85891,0.45248868778280543,0.5850622406639003,121,-141,0.43549731744492953,0.5645026825550705,home,KC,under,8,0.5238095238095238,-110,0.5021154452028288,KC,MIN,2022 REG,7,2,9,9,11,16,0,1,-7,7,1,1,0,0,0,0,0,0,0,0.4978845547971712,0.5021154452028288
85892,0.5689655172413793,0.4739336492890995,-132,111,0.5445573707671414,0.4554426292328586,away,SEA,over,8.5,0.5495495495495495,-122,0.5223196169142115,BOS,SEA,2022 REG,16,12,10,6,18,26,1,0,6,-6,1,1,1,1,1,1,0,0,0,0.5223196169142115,0.47768038308578853
85892,0.5689655172413793,0.4739336492890995,-132,111,0.5445573707671414,0.4554426292328586,home,BOS,under,8.5,0.5,100,0.47768038308578853,BOS,SEA,2022 REG,16,12,10,6,18,26,1,0,6,-6,1,1,1,1,1,1,0,0,0,0.5223196169142115,0.47768038308578853
85893,0.4347826086956522,0.6031746031746031,130,-152,0.418279473099889,0.581720526900111,away,STL,over,8,0.5412844036697247,-118,0.5189377998484975,PIT,STL,2022 REG,7,3,10,5,8,17,0,1,-2,2,1,1,1,0,0,0,0,0,0,0.5189377998484975,0.4810622001515025
85893,0.4347826086956522,0.6031746031746031,130,-152,0.418279473099889,0.581720526900111,home,PIT,under,8,0.5,100,0.4810622001515025,PIT,STL,2022 REG,7,3,10,5,8,17,0,1,-2,2,1,1,1,0,0,0,0,0,0,0.5189377998484975,0.4810622001515025
85894,0.38314176245210724,0.6551724137931035,161,-190,0.3684620014386165,0.6315379985613835,away,SD,over,8,0.5370370370370371,-116,0.5118817074154765,ARI,SD,2022 REG,7,3,17,12,15,24,0,1,-9,9,1,1,1,0,0,0,0,0,0,0.5118817074154765,0.48811829258452355
85894,0.38314176245210724,0.6551724137931035,161,-190,0.3684620014386165,0.6315379985613835,home,ARI,under,8,0.5098039215686274,-104,0.48811829258452355,ARI,SD,2022 REG,7,3,17,12,15,24,0,1,-9,9,1,1,1,0,0,0,0,0,0,0.5118817074154765,0.48811829258452355
85895,0.47619047619047616,0.5594713656387665,110,-127,0.4592086467479796,0.5407913532520203,away,MIA,over,7.5,0.504950495049505,-102,0.4826715732667395,WSH,MIA,2022 REG,8,2,9,5,7,17,0,1,-3,3,1,1,0,0,0,0,0,0,0,0.4826715732667395,0.5173284267332605
85895,0.47619047619047616,0.5594713656387665,110,-127,0.4592086467479796,0.5407913532520203,home,WSH,under,7.5,0.5391705069124424,-117,0.5173284267332605,WSH,MIA,2022 REG,8,2,9,5,7,17,0,1,-3,3,1,1,0,0,0,0,0,0,0,0.4826715732667395,0.5173284267332605
85896,0.3389830508474576,0.7014925373134329,195,-235,0.3252625124878337,0.6747374875121663,away,ATL,over,8,0.5283018867924528,-112,0.5056562298022652,OAK,ATL,2022 REG,9,9,13,10,19,22,0,1,-1,1,1,1,1,1,1,1,1,1,1,0.5056562298022652,0.4943437701977348
85896,0.3389830508474576,0.7014925373134329,195,-235,0.3252625124878337,0.6747374875121663,home,OAK,under,8,0.5145631067961165,-106,0.4943437701977348,OAK,ATL,2022 REG,9,9,13,10,19,22,0,1,-1,1,1,1,1,1,1,1,1,1,1,0.5056562298022652,0.4943437701977348
85897,0.5370370370370371,0.5024875621890548,-116,-101,0.5158108633785803,0.4841891366214197,away,BOS,over,8.5,0.5305164319248826,-113,0.5066009958897986,TEX,BOS,2022 REG,7,3,14,11,14,21,0,1,-8,8,1,1,1,0,0,0,0,0,0,0.5066009958897986,0.49339900411020143
85897,0.5370370370370371,0.5024875621890548,-116,-101,0.5158108633785803,0.4841891366214197,home,TEX,under,8.5,0.5145631067961165,-106,0.49339900411020143,TEX,BOS,2022 REG,7,3,14,11,14,21,0,1,-8,8,1,1,1,0,0,0,0,0,0,0.5066009958897986,0.49339900411020143
85898,0.5652173913043479,0.47846889952153115,-130,109,0.5405251399679815,0.45947486003201854,away,MIA,over,9,0.5412844036697247,-118,0.5189377998484975,WSH,MIA,2022 REG,5,3,12,6,9,17,0,1,-3,3,1,1,1,0,0,0,0,0,0,0.5189377998484975,0.4810622001515025
85898,0.5652173913043479,0.47846889952153115,-130,109,0.5405251399679815,0.45947486003201854,home,WSH,under,9,0.5,100,0.4810622001515025,WSH,MIA,2022 REG,5,3,12,6,9,17,0,1,-3,3,1,1,1,0,0,0,0,0,0,0.5189377998484975,0.4810622001515025
85899,0.4366812227074236,0.6000000000000001,129,-150,0.42066322152514246,0.5793367784748575,away,CHC,over,9.5,0.5,100,0.4772727272727273,CIN,CHC,2022 REG,13,8,12,5,13,25,1,0,3,-3,1,1,1,1,1,0,0,0,0,0.4772727272727273,0.5227272727272727
85899,0.4366812227074236,0.6000000000000001,129,-150,0.42066322152514246,0.5793367784748575,home,CIN,under,9.5,0.5454545454545454,-120,0.5227272727272727,CIN,CHC,2022 REG,13,8,12,5,13,25,1,0,3,-3,1,1,1,1,1,0,0,0,0,0.4772727272727273,0.5227272727272727
85900,0.47619047619047616,0.5652173913043479,110,-130,0.4564724440500838,0.5435275559499162,away,ARI,over,7.5,0.5,100,0.4772727272727273,KC,ARI,2022 REG,7,5,5,3,8,12,1,0,2,-2,1,1,1,0,0,0,0,0,0,0.4772727272727273,0.5227272727272727
85900,0.47619047619047616,0.5652173913043479,110,-130,0.4564724440500838,0.5435275559499162,home,KC,under,7.5,0.5454545454545454,-120,0.5227272727272727,KC,ARI,2022 REG,7,5,5,3,8,12,1,0,2,-2,1,1,1,0,0,0,0,0,0,0.4772727272727273,0.5227272727272727
85901,0.6923076923076923,0.34965034965034963,-225,186,0.663259817105971,0.33674018289402896,away,STL,over,8.5,0.5412844036697247,-118,0.5189377998484975,TOR,STL,2022 REG,14,10,8,3,13,22,1,0,7,-7,1,1,1,0,0,0,0,0,0,0.5189377998484975,0.4810622001515025
85901,0.6923076923076923,0.34965034965034963,-225,186,0.663259817105971,0.33674018289402896,home,TOR,under,8.5,0.5,100,0.4810622001515025,TOR,STL,2022 REG,14,10,8,3,13,22,1,0,7,-7,1,1,1,0,0,0,0,0,0,0.5189377998484975,0.4810622001515025
85902,0.626865671641791,0.41152263374485604,-168,143,0.6028013608024003,0.3971986391975997,away,PIT,over,12,0.5260663507109005,-111,0.5010269332605688,COL,PIT,2022 REG,9,3,16,8,11,25,0,1,-5,5,1,1,1,0,0,0,0,0,0,0.5010269332605688,0.4989730667394312
85902,0.626865671641791,0.41152263374485604,-168,143,0.6028013608024003,0.3971986391975997,home,COL,under,12,0.5215311004784688,-109,0.4989730667394312,COL,PIT,2022 REG,9,3,16,8,11,25,0,1,-5,5,1,1,1,0,0,0,0,0,0,0.5010269332605688,0.4989730667394312
85903,0.7340425531914894,0.30959752321981426,-276,223,0.7020088800810643,0.2979911199189357,away,WSH,over,9,0.504950495049505,-102,0.47949844489399435,LAD,WSH,2022 REG,11,7,5,1,8,16,1,0,6,-6,1,0,0,0,0,0,0,0,0,0.47949844489399435,0.5205015551060057
85903,0.7340425531914894,0.30959752321981426,-276,223,0.7020088800810643,0.2979911199189357,home,LAD,under,9,0.5454545454545454,-120,0.5205015551060057,LAD,WSH,2022 REG,11,7,5,1,8,16,1,0,6,-6,1,0,0,0,0,0,0,0,0,0.47949844489399435,0.5205015551060057
85904,0.48780487804878053,0.5555555555555556,105,-125,0.4666534470222751,0.5333465529777248,away,CWS,over,6.5,0.5454545454545454,-120,0.5206611570247933,MIN,CWS,2022 REG,10,4,2,0,4,12,1,0,4,-4,0,0,0,0,0,0,0,0,0,0.5206611570247933,0.4793388429752067
85904,0.48780487804878053,0.5555555555555556,105,-125,0.4666534470222751,0.5333465529777248,home,MIN,under,6.5,0.5,100,0.4793388429752067,MIN,CWS,2022 REG,10,4,2,0,4,12,1,0,4,-4,0,0,0,0,0,0,0,0,0,0.5206611570247933,0.4793388429752067
85905,0.6108949416342413,0.425531914893617,-157,135,0.5886419592417365,0.41135804075826354,away,OAK,over,7.5,0.5098039215686274,-104,0.4870219861770517,LAA,OAK,2022 REG,8,5,7,3,8,15,1,0,2,-2,1,1,1,0,0,0,0,0,0,0.4870219861770517,0.5129780138229483
85905,0.6108949416342413,0.425531914893617,-157,135,0.5886419592417365,0.41135804075826354,home,LAA,under,7.5,0.5348837209302326,-115,0.5129780138229483,LAA,OAK,2022 REG,8,5,7,3,8,15,1,0,2,-2,1,1,1,0,0,0,0,0,0,0.4870219861770517,0.5129780138229483
85906,0.613899613899614,0.425531914893617,-159,135,0.589692613597978,0.410307386402022,away,BAL,over,9,0.5215311004784688,-109,0.49907282342437215,TOR,BAL,2022 REG,8,3,8,7,10,16,0,1,-4,4,1,1,1,0,0,0,0,0,0,0.49907282342437215,0.5009271765756278
85906,0.613899613899614,0.425531914893617,-159,135,0.589692613597978,0.410307386402022,home,TOR,under,9,0.5215311004784688,-109,0.5009271765756278,TOR,BAL,2022 REG,8,3,8,7,10,16,0,1,-4,4,1,1,1,0,0,0,0,0,0,0.49907282342437215,0.5009271765756278
85907,0.4739336492890995,0.5708154506437768,111,-133,0.45272554505550877,0.5472744549444912,away,LAA,over,8.5,0.5145631067961165,-106,0.4913668392989033,TEX,LAA,2022 REG,11,10,11,5,15,22,1,0,5,-5,1,1,1,1,1,0,0,0,0,0.4913668392989033,0.5086331607010968
85907,0.4739336492890995,0.5708154506437768,111,-133,0.45272554505550877,0.5472744549444912,home,TEX,under,8.5,0.5305164319248826,-113,0.5086331607010968,TEX,LAA,2022 REG,11,10,11,5,15,22,1,0,5,-5,1,1,1,1,1,0,0,0,0,0.4913668392989033,0.5086331607010968
85908,0.6428571428571428,0.3921568627450981,-180,155,0.6203481392557023,0.3796518607442977,away,PIT,over,8.5,0.5024875621890548,-101,0.48049269377245407,MIL,PIT,2022 REG,6,6,8,1,7,14,1,0,5,-5,1,0,0,0,0,0,0,0,0,0.48049269377245407,0.5195073062275459
85908,0.6428571428571428,0.3921568627450981,-180,155,0.6203481392557023,0.3796518607442977,home,MIL,under,8.5,0.5412844036697247,-118,0.5195073062275459,MIL,PIT,2022 REG,6,6,8,1,7,14,1,0,5,-5,1,0,0,0,0,0,0,0,0,0.48049269377245407,0.5195073062275459
85910,0.47619047619047616,0.5633187772925764,110,-129,0.45737654596045113,0.5426234540395489,away,MIN,over,7.5,0.5,100,0.47522522522522526,OAK,MIN,2022 REG,4,1,8,3,4,12,0,1,-2,2,1,0,0,0,0,0,0,0,0,0.47522522522522526,0.5247747747747747
85910,0.47619047619047616,0.5633187772925764,110,-129,0.45737654596045113,0.5426234540395489,home,OAK,under,7.5,0.5495495495495495,-122,0.5247747747747747,OAK,MIN,2022 REG,4,1,8,3,4,12,0,1,-2,2,1,0,0,0,0,0,0,0,0,0.47522522522522526,0.5247747747747747
85911,0.5024875621890548,0.5391705069124424,-101,-117,0.4815549006007403,0.5184450993992598,away,BOS,over,7.5,0.5,100,0.4772727272727273,TB,BOS,2022 REG,6,3,6,2,5,12,1,0,1,-1,1,1,0,0,0,0,0,0,0,0.4772727272727273,0.5227272727272727
85911,0.5024875621890548,0.5391705069124424,-101,-117,0.4815549006007403,0.5184450993992598,home,TB,under,7.5,0.5454545454545454,-120,0.5227272727272727,TB,BOS,2022 REG,6,3,6,2,5,12,1,0,1,-1,1,1,0,0,0,0,0,0,0,0.4772727272727273,0.5227272727272727
85912,0.635036496350365,0.4081632653061224,-174,145,0.6076030710648583,0.39239692893514166,away,CIN,over,8.5,0.5121951219512195,-105,0.48808156828023186,STL,CIN,2022 REG,12,11,4,3,14,16,1,0,8,-8,1,1,1,0,0,0,0,0,0,0.48808156828023186,0.5119184317197681
85912,0.635036496350365,0.4081632653061224,-174,145,0.6076030710648583,0.39239692893514166,home,STL,under,8.5,0.5348837209302326,-115,0.5119184317197681,STL,CIN,2022 REG,12,11,4,3,14,16,1,0,8,-8,1,1,1,0,0,0,0,0,0,0.48808156828023186,0.5119184317197681
85913,0.5327102803738317,0.5098039215686274,-114,-104,0.5100625279371946,0.48993747206280536,away,BAL,over,9,0.5327102803738317,-114,0.508788710910954,CIN,BAL,2022 REG,13,8,6,2,10,19,1,0,6,-6,1,1,0,0,0,0,0,0,0,0.508788710910954,0.491211289089046
85913,0.5327102803738317,0.5098039215686274,-114,-104,0.5100625279371946,0.48993747206280536,home,CIN,under,9,0.5121951219512195,-105,0.491211289089046,CIN,BAL,2022 REG,13,8,6,2,10,19,1,0,6,-6,1,1,0,0,0,0,0,0,0,0.508788710910954,0.491211289089046
85914,0.609375,0.43103448275862066,-156,132,0.5847504714439656,0.41524952855603436,away,OAK,over,7,0.5238095238095238,-110,0.4988662131519274,SEA,OAK,2022 REG,9,5,13,7,12,22,0,1,-2,2,1,1,1,1,1,0,0,0,0,0.4988662131519274,0.5011337868480725
85914,0.609375,0.43103448275862066,-156,132,0.5847504714439656,0.41524952855603436,home,SEA,under,7,0.5238095238095238,-110,0.5011337868480725,SEA,OAK,2022 REG,9,5,13,7,12,22,0,1,-2,2,1,1,1,1,1,0,0,0,0,0.4988662131519274,0.5011337868480725
85915,0.6666666666666666,0.37037037037037035,-200,170,0.6419753086419753,0.3580246913580247,away,MIN,over,6.5,0.5169082125603864,-107,0.49239402434819424,NYY,MIN,2022 REG,6,7,8,1,8,14,1,0,6,-6,1,0,0,0,0,0,0,0,0,0.49239402434819424,0.5076059756518058
85915,0.6666666666666666,0.37037037037037035,-200,170,0.6419753086419753,0.3580246913580247,home,NYY,under,6.5,0.5305164319248826,-113,0.5076059756518058,NYY,MIN,2022 REG,6,7,8,1,8,14,1,0,6,-6,1,0,0,0,0,0,0,0,0,0.49239402434819424,0.5076059756518058
85917,0.6226415094339623,0.4166666666666667,-165,140,0.5981666073335706,0.40183339266642937,away,MIA,over,7.5,0.5024875621890548,-101,0.48049269377245407,LAD,MIA,2022 REG,16,10,6,3,13,22,1,0,7,-7,1,1,1,0,0,0,0,0,0,0.48049269377245407,0.5195073062275459
85917,0.6226415094339623,0.4166666666666667,-165,140,0.5981666073335706,0.40183339266642937,home,LAD,under,7.5,0.5412844036697247,-118,0.5195073062275459,LAD,MIA,2022 REG,16,10,6,3,13,22,1,0,7,-7,1,1,1,0,0,0,0,0,0,0.48049269377245407,0.5195073062275459
85918,0.4347826086956522,0.5983935742971888,130,-149,0.4203581813074605,0.5796418186925395,away,SD,over,10.5,0.5238095238095238,-110,0.5000596729920038,COL,SD,2022 REG,12,6,17,13,19,29,0,1,-7,7,1,1,1,1,1,1,0,0,0,0.5000596729920038,0.4999403270079962
85918,0.4347826086956522,0.5983935742971888,130,-149,0.4203581813074605,0.5796418186925395,home,COL,under,10.5,0.5215311004784688,-109,0.4999403270079962,COL,SD,2022 REG,12,6,17,13,19,29,0,1,-7,7,1,1,1,1,1,1,0,0,0,0.5000596729920038,0.4999403270079962
85919,0.4098360655737705,0.6336996336996338,144,-173,0.3919935658715556,0.6080064341284444,away,LAD,over,12,0.5238095238095238,-110,0.5012646084074657,COL,LAD,2022 REG,10,9,10,4,13,20,1,0,5,-5,1,1,1,1,0,0,0,0,0,0.5012646084074657,0.4987353915925343
85919,0.4098360655737705,0.6336996336996338,144,-173,0.3919935658715556,0.6080064341284444,home,COL,under,12,0.5192307692307692,-108,0.4987353915925343,COL,LAD,2022 REG,10,9,10,4,13,20,1,0,5,-5,1,1,1,1,0,0,0,0,0,0.5012646084074657,0.4987353915925343
85920,0.5515695067264574,0.48780487804878053,-123,105,0.5298517967383217,0.4701482032616783,away,KC,over,8,0.5121951219512195,-105,0.48808156828023186,DET,KC,2022 REG,7,2,9,3,5,16,0,1,-1,1,1,1,0,0,0,0,0,0,0,0.48808156828023186,0.5119184317197681
85920,0.5515695067264574,0.48780487804878053,-123,105,0.5298517967383217,0.4701482032616783,home,DET,under,8,0.5348837209302326,-115,0.5119184317197681,DET,KC,2022 REG,7,2,9,3,5,16,0,1,-1,1,1,1,0,0,0,0,0,0,0,0.48808156828023186,0.5119184317197681
85921,0.7762863534675616,0.2631578947368421,-347,280,0.7456663218636956,0.25433367813630436,away,WSH,over,8.5,0.5238095238095238,-110,0.4988662131519274,ATL,WSH,2022 REG,7,3,8,2,5,15,1,0,1,-1,1,1,0,0,0,0,0,0,0,0.4988662131519274,0.5011337868480725
85921,0.7762863534675616,0.2631578947368421,-347,280,0.7456663218636956,0.25433367813630436,home,ATL,under,8.5,0.5238095238095238,-110,0.5011337868480725,ATL,WSH,2022 REG,7,3,8,2,5,15,1,0,1,-1,1,1,0,0,0,0,0,0,0,0.4988662131519274,0.5011337868480725
85922,0.5098039215686274,0.5305164319248826,-104,-113,0.4892484472386027,0.5107515527613973,away,DET,over,8.5,0.5327102803738317,-114,0.508788710910954,CLE,DET,2022 REG,10,6,3,1,7,13,1,0,5,-5,1,0,0,0,0,0,0,0,0,0.508788710910954,0.491211289089046
85922,0.5098039215686274,0.5305164319248826,-104,-113,0.4892484472386027,0.5107515527613973,home,CLE,under,8.5,0.5121951219512195,-105,0.491211289089046,CLE,DET,2022 REG,10,6,3,1,7,13,1,0,5,-5,1,0,0,0,0,0,0,0,0,0.508788710910954,0.491211289089046
85923,0.4366812227074236,0.6000000000000001,129,-150,0.42066322152514246,0.5793367784748575,away,BOS,over,8.5,0.5192307692307692,-108,0.49688292476754015,BAL,BOS,2022 REG,13,9,11,5,14,24,1,0,4,-4,1,1,1,1,1,0,0,0,0,0.49688292476754015,0.5031170752324599
85923,0.4366812227074236,0.6000000000000001,129,-150,0.42066322152514246,0.5793367784748575,home,BAL,under,8.5,0.5238095238095238,-110,0.5031170752324599,BAL,BOS,2022 REG,13,9,11,5,14,24,1,0,4,-4,1,1,1,1,1,0,0,0,0,0.49688292476754015,0.5031170752324599
85924,0.6515679442508712,0.3921568627450981,-187,155,0.6230782616437414,0.37692173835625864,away,KC,over,7.5,0.5283018867924528,-112,0.5044173060022736,SEA,KC,2022 REG,10,5,9,4,9,19,1,0,1,-1,1,1,1,1,0,0,0,0,0,0.5044173060022736,0.49558269399772636
85924,0.6515679442508712,0.3921568627450981,-187,155,0.6230782616437414,0.37692173835625864,home,SEA,under,7.5,0.5169082125603864,-107,0.49558269399772636,SEA,KC,2022 REG,10,5,9,4,9,19,1,0,1,-1,1,1,1,1,0,0,0,0,0,0.5044173060022736,0.49558269399772636
85925,0.5833333333333333,0.4566210045662101,-140,119,0.5600266362252664,0.4399733637747336,away,TB,over,6.5,0.5454545454545454,-120,0.5206611570247933,NYY,TB,2022 REG,3,4,7,3,7,10,1,0,1,-1,1,1,1,0,0,0,0,0,0,0.5206611570247933,0.4793388429752067
85925,0.5833333333333333,0.4566210045662101,-140,119,0.5600266362252664,0.4399733637747336,home,NYY,under,6.5,0.5,100,0.4793388429752067,NYY,TB,2022 REG,3,4,7,3,7,10,1,0,1,-1,1,1,1,0,0,0,0,0,0,0.5206611570247933,0.4793388429752067
85926,0.782608695652174,0.25510204081632654,-360,292,0.7530959453724779,0.24690405462752207,away,DET,over,8.5,0.5454545454545454,-120,0.5179608869977906,TOR,DET,2022 REG,4,2,9,4,6,13,0,1,-2,2,1,1,0,0,0,0,0,0,0,0.5179608869977906,0.48203911300220936
85926,0.782608695652174,0.25510204081632654,-360,292,0.7530959453724779,0.24690405462752207,home,TOR,under,8.5,0.504950495049505,-102,0.48203911300220936,TOR,DET,2022 REG,4,2,9,4,6,13,0,1,-2,2,1,1,0,0,0,0,0,0,0,0.5179608869977906,0.48203911300220936
85927,0.7142857142857143,0.32573289902280134,-250,207,0.6857009904939174,0.3142990095060826,away,TEX,over,7.5,0.5283018867924528,-112,0.5056562298022652,HOU,TEX,2022 REG,6,2,10,1,3,16,1,0,1,-1,1,0,0,0,0,0,0,0,0,0.5056562298022652,0.4943437701977348
85927,0.7142857142857143,0.32573289902280134,-250,207,0.6857009904939174,0.3142990095060826,home,HOU,under,7.5,0.5145631067961165,-106,0.4943437701977348,HOU,TEX,2022 REG,6,2,10,1,3,16,1,0,1,-1,1,0,0,0,0,0,0,0,0,0.5056562298022652,0.4943437701977348
85928,0.5192307692307692,0.5192307692307692,-108,-108,0.4992603550295858,0.5007396449704142,away,TOR,over,8.5,0.5121951219512195,-105,0.48808156828023186,LAA,TOR,2022 REG,13,5,10,6,11,23,0,1,-1,1,1,1,1,1,1,0,0,0,0,0.48808156828023186,0.5119184317197681
85928,0.5192307692307692,0.5192307692307692,-108,-108,0.4992603550295858,0.5007396449704142,home,LAA,under,8.5,0.5348837209302326,-115,0.5119184317197681,LAA,TOR,2022 REG,13,5,10,6,11,23,0,1,-1,1,1,1,1,1,1,0,0,0,0,0.48808156828023186,0.5119184317197681
85929,0.425531914893617,0.6168582375478928,135,-161,0.407493552152549,0.592506447847451,away,CLE,over,6.5,0.5412844036697247,-118,0.5162581740877563,OAK,CLE,2022 REG,8,1,9,3,4,17,0,1,-2,2,1,0,0,0,0,0,0,0,0,0.5162581740877563,0.4837418259122437
85929,0.425531914893617,0.6168582375478928,135,-161,0.407493552152549,0.592506447847451,home,OAK,under,6.5,0.504950495049505,-102,0.4837418259122437,OAK,CLE,2022 REG,8,1,9,3,4,17,0,1,-2,2,1,0,0,0,0,0,0,0,0,0.5162581740877563,0.4837418259122437
85931,0.607843137254902,0.43103448275862066,-155,132,0.5842116427368785,0.41578835726312147,away,KC,over,7.5,0.504950495049505,-102,0.4826715732667395,SEA,KC,2022 REG,16,13,10,7,20,26,1,0,6,-6,1,1,1,1,1,1,1,0,0,0.4826715732667395,0.5173284267332605
85931,0.607843137254902,0.43103448275862066,-155,132,0.5842116427368785,0.41578835726312147,home,SEA,under,7.5,0.5391705069124424,-117,0.5173284267332605,SEA,KC,2022 REG,16,13,10,7,20,26,1,0,6,-6,1,1,1,1,1,1,1,0,0,0.4826715732667395,0.5173284267332605
85932,0.5967741935483871,0.4444444444444444,-148,125,0.5721759741010521,0.42782402589894786,away,COL,over,8,0.5348837209302326,-115,0.5109810284308424,ARI,COL,2022 REG,6,4,7,1,5,13,1,0,3,-3,1,0,0,0,0,0,0,0,0,0.5109810284308424,0.48901897156915763
85932,0.5967741935483871,0.4444444444444444,-148,125,0.5721759741010521,0.42782402589894786,home,ARI,under,8,0.5098039215686274,-104,0.48901897156915763,ARI,COL,2022 REG,6,4,7,1,5,13,1,0,3,-3,1,0,0,0,0,0,0,0,0,0.5109810284308424,0.48901897156915763
85933,0.5169082125603864,0.5192307692307692,-107,-108,0.4982276760789678,0.5017723239210322,away,ATL,over,8,0.5238095238095238,-110,0.4988662131519274,SD,ATL,2022 REG,4,2,9,5,7,13,0,1,-3,3,1,1,0,0,0,0,0,0,0,0.4988662131519274,0.5011337868480725
85933,0.5169082125603864,0.5192307692307692,-107,-108,0.4982276760789678,0.5017723239210322,home,SD,under,8,0.5238095238095238,-110,0.5011337868480725,SD,ATL,2022 REG,4,2,9,5,7,13,0,1,-3,3,1,1,0,0,0,0,0,0,0,0.4988662131519274,0.5011337868480725
85935,0.5454545454545454,0.49751243781094534,-120,101,0.5220180091279142,0.4779819908720858,away,DET,over,8,0.5073891625615764,-103,0.4837652908580103,KC,DET,2022 REG,8,5,8,2,7,16,1,0,3,-3,1,1,0,0,0,0,0,0,0,0.4837652908580103,0.5162347091419897
85935,0.5454545454545454,0.49751243781094534,-120,101,0.5220180091279142,0.4779819908720858,home,KC,under,8,0.5391705069124424,-117,0.5162347091419897,KC,DET,2022 REG,8,5,8,2,7,16,1,0,3,-3,1,1,0,0,0,0,0,0,0,0.4837652908580103,0.5162347091419897
85936,0.44052863436123346,0.6000000000000001,127,-150,0.42267461041355353,0.5773253895864465,away,MIA,over,10.5,0.5121951219512195,-105,0.48808156828023186,COL,MIA,2022 REG,10,7,5,1,8,15,1,0,6,-6,1,0,0,0,0,0,0,0,0,0.48808156828023186,0.5119184317197681
85936,0.44052863436123346,0.6000000000000001,127,-150,0.42267461041355353,0.5773253895864465,home,COL,under,10.5,0.5348837209302326,-115,0.5119184317197681,COL,MIA,2022 REG,10,7,5,1,8,15,1,0,6,-6,1,0,0,0,0,0,0,0,0,0.48808156828023186,0.5119184317197681
85938,0.5391705069124424,0.5,-117,100,0.5180509248444435,0.4819490751555565,away,LAD,over,7,0.5370370370370371,-116,0.5118817074154765,MIL,LAD,2022 REG,6,5,6,3,8,12,1,0,2,-2,1,1,1,0,0,0,0,0,0,0.5118817074154765,0.48811829258452355
85938,0.5391705069124424,0.5,-117,100,0.5180509248444435,0.4819490751555565,home,MIL,under,7,0.5098039215686274,-104,0.48811829258452355,MIL,LAD,2022 REG,6,5,6,3,8,12,1,0,2,-2,1,1,1,0,0,0,0,0,0,0.5118817074154765,0.48811829258452355
85939,0.4672897196261683,0.576271186440678,114,-136,0.4469341560435298,0.5530658439564702,away,MIN,over,8.5,0.5238095238095238,-110,0.4988662131519274,KC,MIN,2022 REG,6,2,5,0,2,11,1,0,2,-2,0,0,0,0,0,0,0,0,0,0.4988662131519274,0.5011337868480725
85939,0.4672897196261683,0.576271186440678,114,-136,0.4469341560435298,0.5530658439564702,home,KC,under,8.5,0.5238095238095238,-110,0.5011337868480725,KC,MIN,2022 REG,6,2,5,0,2,11,1,0,2,-2,0,0,0,0,0,0,0,0,0,0.4988662131519274,0.5011337868480725
85940,0.44052863436123346,0.6000000000000001,127,-150,0.42267461041355353,0.5773253895864465,away,BOS,over,9.5,0.5121951219512195,-105,0.48808156828023186,KC,BOS,2022 REG,8,5,8,4,9,16,1,0,1,-1,1,1,1,1,0,0,0,0,0,0.48808156828023186,0.5119184317197681
85940,0.44052863436123346,0.6000000000000001,127,-150,0.42267461041355353,0.5773253895864465,home,KC,under,9.5,0.5348837209302326,-115,0.5119184317197681,KC,BOS,2022 REG,8,5,8,4,9,16,1,0,1,-1,1,1,1,1,0,0,0,0,0,0.48808156828023186,0.5119184317197681
85941,0.5475113122171946,0.48780487804878053,-121,105,0.5281752985421585,0.4718247014578415,away,CLE,over,8.5,0.5327102803738317,-114,0.508788710910954,KC,CLE,2022 REG,6,1,5,0,1,11,1,0,1,-1,0,0,0,0,0,0,0,0,0,0.508788710910954,0.491211289089046
85941,0.5475113122171946,0.48780487804878053,-121,105,0.5281752985421585,0.4718247014578415,home,KC,under,8.5,0.5121951219512195,-105,0.491211289089046,KC,CLE,2022 REG,6,1,5,0,1,11,1,0,1,-1,0,0,0,0,0,0,0,0,0,0.508788710910954,0.491211289089046
85942,0.5689655172413793,0.4694835680751174,-132,113,0.5470893135268209,0.4529106864731791,away,BOS,over,9,0.5098039215686274,-104,0.48592421718142587,MIN,BOS,2022 REG,9,10,7,5,15,16,1,0,5,-5,1,1,1,1,1,0,0,0,0,0.48592421718142587,0.5140757828185741
85942,0.5689655172413793,0.4694835680751174,-132,113,0.5470893135268209,0.4529106864731791,home,MIN,under,9,0.5370370370370371,-116,0.5140757828185741,MIN,BOS,2022 REG,9,10,7,5,15,16,1,0,5,-5,1,1,1,1,1,0,0,0,0,0.48592421718142587,0.5140757828185741
85943,0.6363636363636364,0.40322580645161293,-175,148,0.6111703545721141,0.3888296454278859,away,KC,over,7,0.5145631067961165,-106,0.4925063625223866,CWS,KC,2022 REG,9,7,4,3,10,13,1,0,4,-4,1,1,1,0,0,0,0,0,0,0.4925063625223866,0.5074936374776133
85943,0.6363636363636364,0.40322580645161293,-175,148,0.6111703545721141,0.3888296454278859,home,CWS,under,7,0.5283018867924528,-112,0.5074936374776133,CWS,KC,2022 REG,9,7,4,3,10,13,1,0,4,-4,1,1,1,0,0,0,0,0,0,0.4925063625223866,0.5074936374776133
85944,0.726027397260274,0.3125,-265,220,0.6980554513041847,0.30194454869581533,away,ARI,over,7.5,0.5,100,0.4772727272727273,MIL,ARI,2022 REG,7,6,7,5,11,14,1,0,1,-1,1,1,1,1,1,0,0,0,0,0.4772727272727273,0.5227272727272727
85944,0.726027397260274,0.3125,-265,220,0.6980554513041847,0.30194454869581533,home,MIL,under,7.5,0.5454545454545454,-120,0.5227272727272727,MIL,ARI,2022 REG,7,6,7,5,11,14,1,0,1,-1,1,1,1,1,1,0,0,0,0,0.4772727272727273,0.5227272727272727
85947,0.4444444444444444,0.5967741935483871,125,-148,0.42612504978096366,0.5738749502190363,away,MIL,over,7.5,0.5192307692307692,-108,0.49688292476754015,STL,MIL,2022 REG,5,4,8,2,6,13,1,0,2,-2,1,1,0,0,0,0,0,0,0,0.49688292476754015,0.5031170752324599
85947,0.4444444444444444,0.5967741935483871,125,-148,0.42612504978096366,0.5738749502190363,home,STL,under,7.5,0.5238095238095238,-110,0.5031170752324599,STL,MIL,2022 REG,5,4,8,2,6,13,1,0,2,-2,1,1,0,0,0,0,0,0,0,0.49688292476754015,0.5031170752324599
85948,0.5652173913043479,0.47619047619047616,-130,110,0.5418129444594474,0.4581870555405526,away,PIT,over,8.5,0.5454545454545454,-120,0.5206611570247933,WSH,PIT,2022 REG,6,3,6,1,4,12,1,0,2,-2,1,0,0,0,0,0,0,0,0,0.5206611570247933,0.4793388429752067
85948,0.5652173913043479,0.47619047619047616,-130,110,0.5418129444594474,0.4581870555405526,home,WSH,under,8.5,0.5,100,0.4793388429752067,WSH,PIT,2022 REG,6,3,6,1,4,12,1,0,2,-2,1,0,0,0,0,0,0,0,0,0.5206611570247933,0.4793388429752067
85949,0.5215311004784688,0.5215311004784688,-109,-109,0.49907282342437215,0.5009271765756278,away,BOS,over,8.5,0.5454545454545454,-120,0.5220180091279142,BAL,BOS,2022 REG,18,15,19,10,25,37,1,0,5,-5,1,1,1,1,1,1,1,1,1,0.5220180091279142,0.4779819908720858
85949,0.5215311004784688,0.5215311004784688,-109,-109,0.49907282342437215,0.5009271765756278,home,BAL,under,8.5,0.49751243781094534,101,0.4779819908720858,BAL,BOS,2022 REG,18,15,19,10,25,37,1,0,5,-5,1,1,1,1,1,1,1,1,1,0.5220180091279142,0.4779819908720858
85951,0.6197718631178707,0.4166666666666667,-163,140,0.597188287624032,0.402811712375968,away,OAK,over,8.5,0.5145631067961165,-106,0.4913668392989033,KC,OAK,2022 REG,6,3,8,5,8,14,0,1,-2,2,1,1,1,0,0,0,0,0,0,0.4913668392989033,0.5086331607010968
85951,0.6197718631178707,0.4166666666666667,-163,140,0.597188287624032,0.402811712375968,home,KC,under,8.5,0.5305164319248826,-113,0.5086331607010968,KC,OAK,2022 REG,6,3,8,5,8,14,0,1,-2,2,1,1,1,0,0,0,0,0,0,0.4913668392989033,0.5086331607010968
85952,0.7835497835497836,0.2531645569620253,-362,295,0.7547822699885827,0.24521773001141733,away,OAK,over,7,0.5495495495495495,-122,0.5250401592387142,HOU,OAK,2022 REG,8,5,3,0,5,11,1,0,5,-5,0,0,0,0,0,0,0,0,0,0.5250401592387142,0.47495984076128583
85952,0.7835497835497836,0.2531645569620253,-362,295,0.7547822699885827,0.24521773001141733,home,HOU,under,7,0.49504950495049505,102,0.47495984076128583,HOU,OAK,2022 REG,8,5,3,0,5,11,1,0,5,-5,0,0,0,0,0,0,0,0,0,0.5250401592387142,0.47495984076128583
85953,0.5495495495495495,0.48780487804878053,-122,105,0.529021440689206,0.470978559310794,away,NYM,over,8.5,0.5238095238095238,-110,0.4988662131519274,PHI,NYM,2022 REG,9,6,9,9,15,18,0,1,-3,3,1,1,1,1,1,1,0,0,0,0.4988662131519274,0.5011337868480725
85953,0.5495495495495495,0.48780487804878053,-122,105,0.529021440689206,0.470978559310794,home,PHI,under,8.5,0.5238095238095238,-110,0.5011337868480725,PHI,NYM,2022 REG,9,6,9,9,15,18,0,1,-3,3,1,1,1,1,1,1,0,0,0,0.4988662131519274,0.5011337868480725
85954,0.3921568627450981,0.6453900709219857,155,-182,0.37743257503251615,0.6225674249674839,away,HOU,over,7,0.5145631067961165,-106,0.4913668392989033,OAK,HOU,2022 REG,2,1,6,5,6,8,0,1,-4,4,1,0,0,0,0,0,0,0,0,0.4913668392989033,0.5086331607010968
85954,0.3921568627450981,0.6453900709219857,155,-182,0.37743257503251615,0.6225674249674839,home,OAK,under,7,0.5305164319248826,-113,0.5086331607010968,OAK,HOU,2022 REG,2,1,6,5,6,8,0,1,-4,4,1,0,0,0,0,0,0,0,0,0.4913668392989033,0.5086331607010968
85955,0.5594713656387665,0.47619047619047616,-127,110,0.5395195862893665,0.46048041371063353,away,SEA,over,7.5,0.5192307692307692,-108,0.49688292476754015,KC,SEA,2022 REG,10,5,6,1,6,16,1,0,4,-4,1,0,0,0,0,0,0,0,0,0.49688292476754015,0.5031170752324599
85955,0.5594713656387665,0.47619047619047616,-127,110,0.5395195862893665,0.46048041371063353,home,KC,under,7.5,0.5238095238095238,-110,0.5031170752324599,KC,SEA,2022 REG,10,5,6,1,6,16,1,0,4,-4,1,0,0,0,0,0,0,0,0,0.49688292476754015,0.5031170752324599
85956,0.4347826086956522,0.6031746031746031,130,-152,0.418279473099889,0.581720526900111,away,MIL,over,7,0.48780487804878053,105,0.4666534470222751,CHC,MIL,2022 REG,5,2,7,5,7,12,0,1,-3,3,1,1,0,0,0,0,0,0,0,0.4666534470222751,0.5333465529777248
85956,0.4347826086956522,0.6031746031746031,130,-152,0.418279473099889,0.581720526900111,home,CHC,under,7,0.5555555555555556,-125,0.5333465529777248,CHC,MIL,2022 REG,5,2,7,5,7,12,0,1,-3,3,1,1,0,0,0,0,0,0,0,0.4666534470222751,0.5333465529777248
85959,0.5901639344262295,0.4464285714285714,-144,124,0.5685683572004454,0.4314316427995546,away,MIA,over,7.5,0.5,100,0.4772727272727273,SF,MIA,2022 REG,6,6,9,5,11,15,1,0,1,-1,1,1,1,1,1,0,0,0,0,0.4772727272727273,0.5227272727272727
85959,0.5901639344262295,0.4464285714285714,-144,124,0.5685683572004454,0.4314316427995546,home,SF,under,7.5,0.5454545454545454,-120,0.5227272727272727,SF,MIA,2022 REG,6,6,9,5,11,15,1,0,1,-1,1,1,1,1,1,0,0,0,0,0.4772727272727273,0.5227272727272727
85960,0.4081632653061224,0.635036496350365,145,-174,0.39053070952796426,0.6094692904720358,away,ATL,over,9,0.5121951219512195,-105,0.48919479393107135,ARI,ATL,2022 REG,12,8,14,7,15,26,1,0,1,-1,1,1,1,1,1,1,1,0,0,0.48919479393107135,0.5108052060689287
85960,0.4081632653061224,0.635036496350365,145,-174,0.39053070952796426,0.6094692904720358,home,ARI,under,9,0.5327102803738317,-114,0.5108052060689287,ARI,ATL,2022 REG,12,8,14,7,15,26,1,0,1,-1,1,1,1,1,1,1,1,0,0,0.48919479393107135,0.5108052060689287
85961,0.5726495726495727,0.4672897196261683,-134,114,0.5497783539959433,0.4502216460040567,away,NYM,over,7,0.5283018867924528,-112,0.5044173060022736,SD,NYM,2022 REG,16,13,5,2,15,21,1,0,11,-11,1,1,0,0,0,0,0,0,0,0.5044173060022736,0.49558269399772636
85961,0.5726495726495727,0.4672897196261683,-134,114,0.5497783539959433,0.4502216460040567,home,SD,under,7,0.5169082125603864,-107,0.49558269399772636,SD,NYM,2022 REG,16,13,5,2,15,21,1,0,11,-11,1,1,0,0,0,0,0,0,0,0.5044173060022736,0.49558269399772636
85962,0.4854368932038835,0.5535714285714286,106,-124,0.4665008146721786,0.5334991853278215,away,MIL,over,7,0.5121951219512195,-105,0.48808156828023186,STL,MIL,2022 REG,10,4,10,1,5,20,1,0,3,-3,1,0,0,0,0,0,0,0,0,0.48808156828023186,0.5119184317197681
85962,0.4854368932038835,0.5535714285714286,106,-124,0.4665008146721786,0.5334991853278215,home,STL,under,7,0.5348837209302326,-115,0.5119184317197681,STL,MIL,2022 REG,10,4,10,1,5,20,1,0,3,-3,1,0,0,0,0,0,0,0,0,0.48808156828023186,0.5119184317197681
85963,0.4716981132075471,0.5708154506437768,112,-133,0.4516445453531491,0.548355454646851,away,TOR,over,9.5,0.504950495049505,-102,0.48160416005266615,BAL,TOR,2022 REG,9,7,12,4,11,21,1,0,3,-3,1,1,1,1,0,0,0,0,0,0.48160416005266615,0.5183958399473338
85963,0.4716981132075471,0.5708154506437768,112,-133,0.4516445453531491,0.548355454646851,home,BAL,under,9.5,0.5412844036697247,-118,0.5183958399473338,BAL,TOR,2022 REG,9,7,12,4,11,21,1,0,3,-3,1,1,1,1,0,0,0,0,0,0.48160416005266615,0.5183958399473338
85964,0.5535714285714286,0.48309178743961345,-124,107,0.5332757197081732,0.4667242802918268,away,CWS,over,8.5,0.5454545454545454,-120,0.5179608869977906,LAA,CWS,2022 REG,9,4,17,11,15,26,0,1,-7,7,1,1,1,1,0,0,0,0,0,0.5179608869977906,0.48203911300220936
85964,0.5535714285714286,0.48309178743961345,-124,107,0.5332757197081732,0.4667242802918268,home,LAA,under,8.5,0.504950495049505,-102,0.48203911300220936,LAA,CWS,2022 REG,9,4,17,11,15,26,0,1,-7,7,1,1,1,1,0,0,0,0,0,0.5179608869977906,0.48203911300220936
85965,0.5951417004048584,0.4444444444444444,-147,125,0.5715823348467713,0.42841766515322866,away,NYM,over,8,0.5391705069124424,-117,0.5140669063204599,PHI,NYM,2022 REG,12,7,11,8,15,23,0,1,-1,1,1,1,1,1,1,1,1,0,0,0.5140669063204599,0.4859330936795401
85965,0.5951417004048584,0.4444444444444444,-147,125,0.5715823348467713,0.42841766515322866,home,PHI,under,8,0.5073891625615764,-103,0.4859330936795401,PHI,NYM,2022 REG,12,7,11,8,15,23,0,1,-1,1,1,1,1,1,1,1,1,0,0,0.5140669063204599,0.4859330936795401
85966,0.5121951219512195,0.5454545454545454,-105,-120,0.4826672435238765,0.5173327564761234,away,NYM,over,10.5,0.5454545454545454,-120,0.5140092723241282,COL,NYM,2022 REG,12,11,8,3,14,20,1,0,8,-8,1,1,1,0,0,0,0,0,0,0.5581298489970264,0.44187015100297355
85966,0.5121951219512195,0.5454545454545454,-105,-120,0.4826672435238765,0.5173327564761234,away,NYM,over,15.5,0.5918367346938775,-145,0.5581298489970264,COL,NYM,2022 REG,12,11,8,3,14,20,1,0,8,-8,1,1,1,0,0,0,0,0,0,0.5581298489970264,0.44187015100297355
85966,0.5121951219512195,0.5454545454545454,-105,-120,0.4826672435238765,0.5173327564761234,home,COL,under,10.5,0.5121951219512195,-105,0.4859907276758718,COL,NYM,2022 REG,12,11,8,3,14,20,1,0,8,-8,1,1,1,0,0,0,0,0,0,0.5581298489970264,0.44187015100297355
85966,0.5121951219512195,0.5454545454545454,-105,-120,0.4826672435238765,0.5173327564761234,home,COL,under,15.5,0.46511627906976744,115,0.44187015100297355,COL,NYM,2022 REG,12,11,8,3,14,20,1,0,8,-8,1,1,1,0,0,0,0,0,0,0.5581298489970264,0.44187015100297355
85967,0.7752808988764045,0.2631578947368421,-345,280,0.7454800364122021,0.25451996358779794,away,WSH,over,7.5,0.5454545454545454,-120,0.5179608869977906,SD,WSH,2022 REG,4,3,9,6,9,13,0,1,-3,3,1,1,1,0,0,0,0,0,0,0.5179608869977906,0.48203911300220936
85967,0.7752808988764045,0.2631578947368421,-345,280,0.7454800364122021,0.25451996358779794,home,SD,under,7.5,0.504950495049505,-102,0.48203911300220936,SD,WSH,2022 REG,4,3,9,6,9,13,0,1,-3,3,1,1,1,0,0,0,0,0,0,0.5179608869977906,0.48203911300220936
85969,0.37037037037037035,0.6610169491525424,170,-195,0.35874543721373603,0.641254562786264,away,MIL,over,11,0.5348837209302326,-115,0.5109810284308424,COL,MIL,2022 REG,10,10,9,7,17,19,1,0,3,-3,1,1,1,1,1,1,1,0,0,0.5109810284308424,0.48901897156915763
85969,0.37037037037037035,0.6610169491525424,170,-195,0.35874543721373603,0.641254562786264,home,COL,under,11,0.5098039215686274,-104,0.48901897156915763,COL,MIL,2022 REG,10,10,9,7,17,19,1,0,3,-3,1,1,1,1,1,1,1,0,0,0.5109810284308424,0.48901897156915763
85970,0.4081632653061224,0.6336996336996338,145,-173,0.39107636775275256,0.6089236322472474,away,LAD,over,7.5,0.5192307692307692,-108,0.49571111079951763,MIL,LAD,2022 REG,4,0,6,4,4,10,0,1,-4,4,0,0,0,0,0,0,0,0,0,0.49571111079951763,0.5042888892004824
85970,0.4081632653061224,0.6336996336996338,145,-173,0.39107636775275256,0.6089236322472474,home,MIL,under,7.5,0.5260663507109005,-111,0.5042888892004824,MIL,LAD,2022 REG,4,0,6,4,4,10,0,1,-4,4,0,0,0,0,0,0,0,0,0,0.49571111079951763,0.5042888892004824
85971,0.38759689922480617,0.6527777777777778,158,-188,0.37194779961140156,0.6280522003885984,away,LAD,over,9,0.5454545454545454,-120,0.5206611570247933,ARI,LAD,2022 REG,8,1,24,14,15,32,0,1,-13,13,1,0,0,0,0,0,0,0,0,0.5206611570247933,0.4793388429752067
85971,0.38759689922480617,0.6527777777777778,158,-188,0.37194779961140156,0.6280522003885984,home,ARI,under,9,0.5,100,0.4793388429752067,ARI,LAD,2022 REG,8,1,24,14,15,32,0,1,-13,13,1,0,0,0,0,0,0,0,0,0.5206611570247933,0.4793388429752067
85972,0.5689655172413793,0.4716981132075471,-132,112,0.5458293137100936,0.4541706862899064,away,ARI,over,8.5,0.5454545454545454,-120,0.5206611570247933,WSH,ARI,2022 REG,6,3,9,4,7,15,0,1,-1,1,1,1,1,0,0,0,0,0,0,0.5206611570247933,0.4793388429752067
85972,0.5689655172413793,0.4716981132075471,-132,112,0.5458293137100936,0.4541706862899064,home,WSH,under,8.5,0.5,100,0.4793388429752067,WSH,ARI,2022 REG,6,3,9,4,7,15,0,1,-1,1,1,1,1,0,0,0,0,0,0,0.5206611570247933,0.4793388429752067
85973,0.7222222222222222,0.31746031746031744,-260,215,0.693562610229277,0.306437389770723,away,BAL,over,7.5,0.5391705069124424,-117,0.5153817639191344,NYY,BAL,2022 REG,11,7,7,6,13,18,1,0,1,-1,1,1,1,1,1,1,0,0,0,0.5153817639191344,0.4846182360808656
85973,0.7222222222222222,0.31746031746031744,-260,215,0.693562610229277,0.306437389770723,away,BAL,over,8.5,0.5,100,0.47935779816513757,NYY,BAL,2022 REG,11,7,7,6,13,18,1,0,1,-1,1,1,1,1,1,1,0,0,0,0.5153817639191344,0.4846182360808656
85973,0.7222222222222222,0.31746031746031744,-260,215,0.693562610229277,0.306437389770723,home,NYY,under,7.5,0.504950495049505,-102,0.4846182360808656,NYY,BAL,2022 REG,11,7,7,6,13,18,1,0,1,-1,1,1,1,1,1,1,0,0,0,0.5153817639191344,0.4846182360808656
85973,0.7222222222222222,0.31746031746031744,-260,215,0.693562610229277,0.306437389770723,home,NYY,under,8.5,0.5412844036697247,-118,0.5206422018348624,NYY,BAL,2022 REG,11,7,7,6,13,18,1,0,1,-1,1,1,1,1,1,1,0,0,0,0.5153817639191344,0.4846182360808656
85974,0.6666666666666666,0.37037037037037035,-200,170,0.6419753086419753,0.3580246913580247,away,COL,over,7.5,0.5121951219512195,-105,0.48808156828023186,SF,COL,2022 REG,9,5,8,2,7,17,1,0,3,-3,1,1,0,0,0,0,0,0,0,0.48808156828023186,0.5119184317197681
85974,0.6666666666666666,0.37037037037037035,-200,170,0.6419753086419753,0.3580246913580247,home,SF,under,7.5,0.5348837209302326,-115,0.5119184317197681,SF,COL,2022 REG,9,5,8,2,7,17,1,0,3,-3,1,1,0,0,0,0,0,0,0,0.48808156828023186,0.5119184317197681
85976,0.7777777777777779,0.2717391304347826,-350,268,0.7392646269457865,0.26073537305421346,away,SF,over,8.5,0.5121951219512195,-105,0.48808156828023186,MIL,SF,2022 REG,6,4,4,2,6,10,1,0,2,-2,1,1,0,0,0,0,0,0,0,0.48808156828023186,0.5119184317197681
85976,0.7777777777777779,0.2717391304347826,-350,268,0.7392646269457865,0.26073537305421346,home,MIL,under,8.5,0.5348837209302326,-115,0.5119184317197681,MIL,SF,2022 REG,6,4,4,2,6,10,1,0,2,-2,1,1,0,0,0,0,0,0,0,0.48808156828023186,0.5119184317197681
85977,0.4608294930875576,0.576271186440678,117,-136,0.4437324057473569,0.5562675942526432,away,TOR,over,7,0.5495495495495495,-122,0.5277073575960698,TB,TOR,2022 REG,2,1,8,3,4,10,0,1,-2,2,1,0,0,0,0,0,0,0,0,0.5277073575960698,0.4722926424039302
85977,0.4608294930875576,0.576271186440678,117,-136,0.4437324057473569,0.5562675942526432,home,TB,under,7,0.49019607843137253,104,0.4722926424039302,TB,TOR,2022 REG,2,1,8,3,4,10,0,1,-2,2,1,0,0,0,0,0,0,0,0,0.5277073575960698,0.4722926424039302
85978,0.6240601503759399,0.4166666666666667,-166,140,0.5986441668079975,0.4013558331920025,away,MIA,over,8,0.5283018867924528,-112,0.5044173060022736,ATL,MIA,2022 REG,9,7,14,9,16,23,0,1,-2,2,1,1,1,1,1,1,1,0,0,0.5044173060022736,0.49558269399772636
85978,0.6240601503759399,0.4166666666666667,-166,140,0.5986441668079975,0.4013558331920025,home,ATL,under,8,0.5169082125603864,-107,0.49558269399772636,ATL,MIA,2022 REG,9,7,14,9,16,23,0,1,-2,2,1,1,1,1,1,1,1,0,0,0.5044173060022736,0.49558269399772636
85979,0.4854368932038835,0.5555555555555556,106,-125,0.465537646233282,0.534462353766718,away,MIN,over,8,0.5348837209302326,-115,0.5097020142727117,KC,MIN,2022 REG,10,4,2,1,5,12,1,0,3,-3,1,0,0,0,0,0,0,0,0,0.5097020142727117,0.49029798572728833
85979,0.4854368932038835,0.5555555555555556,106,-125,0.465537646233282,0.534462353766718,home,KC,under,8,0.5121951219512195,-105,0.49029798572728833,KC,MIN,2022 REG,10,4,2,1,5,12,1,0,3,-3,1,0,0,0,0,0,0,0,0,0.5097020142727117,0.49029798572728833
85980,0.7076023391812866,0.3412969283276451,-242,193,0.673001103107715,0.326998896892285,away,ARI,over,7.5,0.5,100,0.4772727272727273,SF,ARI,2022 REG,8,2,6,3,5,14,0,1,-1,1,1,1,0,0,0,0,0,0,0,0.4772727272727273,0.5227272727272727
85980,0.7076023391812866,0.3412969283276451,-242,193,0.673001103107715,0.326998896892285,home,SF,under,7.5,0.5454545454545454,-120,0.5227272727272727,SF,ARI,2022 REG,8,2,6,3,5,14,0,1,-1,1,1,1,0,0,0,0,0,0,0,0.4772727272727273,0.5227272727272727
85981,0.6441281138790036,0.390625,-181,156,0.6217426561846988,0.3782573438153012,away,TEX,over,8.5,0.5121951219512195,-105,0.48808156828023186,MIN,TEX,2022 REG,4,0,11,7,7,15,0,1,-7,7,0,0,0,0,0,0,0,0,0,0.48808156828023186,0.5119184317197681
85981,0.6441281138790036,0.390625,-181,156,0.6217426561846988,0.3782573438153012,home,MIN,under,8.5,0.5348837209302326,-115,0.5119184317197681,MIN,TEX,2022 REG,4,0,11,7,7,15,0,1,-7,7,0,0,0,0,0,0,0,0,0,0.48808156828023186,0.5119184317197681
85982,0.4504504504504505,0.5951417004048584,122,-147,0.4299134455606718,0.5700865544393282,away,LAA,over,8,0.5327102803738317,-114,0.508788710910954,BOS,LAA,2022 REG,6,0,8,8,8,14,0,1,-8,8,0,0,0,0,0,0,0,0,0,0.508788710910954,0.491211289089046
85982,0.4504504504504505,0.5951417004048584,122,-147,0.4299134455606718,0.5700865544393282,home,BOS,under,8,0.5121951219512195,-105,0.491211289089046,BOS,LAA,2022 REG,6,0,8,8,8,14,0,1,-8,8,0,0,0,0,0,0,0,0,0,0.508788710910954,0.491211289089046
85984,0.6197718631178707,0.41493775933609955,-163,141,0.5982598157414557,0.4017401842585443,away,CLE,over,8,0.5348837209302326,-115,0.5097020142727117,MIN,CLE,2022 REG,13,12,9,8,20,22,1,0,4,-4,1,1,1,1,1,1,1,1,0,0.5097020142727117,0.49029798572728833
85984,0.6197718631178707,0.41493775933609955,-163,141,0.5982598157414557,0.4017401842585443,home,MIN,under,8,0.5121951219512195,-105,0.49029798572728833,MIN,CLE,2022 REG,13,12,9,8,20,22,1,0,4,-4,1,1,1,1,1,1,1,1,0,0.5097020142727117,0.49029798572728833
85985,0.626865671641791,0.41493775933609955,-168,141,0.6006605358049044,0.3993394641950956,away,MIA,over,8,0.5215311004784688,-109,0.4978845547971712,ATL,MIA,2022 REG,7,2,5,1,3,12,1,0,1,-1,1,0,0,0,0,0,0,0,0,0.4978845547971712,0.5021154452028288
85985,0.626865671641791,0.41493775933609955,-168,141,0.6006605358049044,0.3993394641950956,home,ATL,under,8,0.5238095238095238,-110,0.5021154452028288,ATL,MIA,2022 REG,7,2,5,1,3,12,1,0,1,-1,1,0,0,0,0,0,0,0,0,0.4978845547971712,0.5021154452028288
85986,0.5348837209302326,0.5073891625615764,-115,-103,0.5122726437136835,0.48772735628631647,away,LAA,over,7.5,0.5169082125603864,-107,0.49586088023391106,NYY,LAA,2022 REG,7,2,2,1,3,9,1,0,1,-1,1,0,0,0,0,0,0,0,0,0.5044173060022736,0.49558269399772636
85986,0.5348837209302326,0.5073891625615764,-115,-103,0.5122726437136835,0.48772735628631647,away,LAA,over,8.5,0.5283018867924528,-112,0.5044173060022736,NYY,LAA,2022 REG,7,2,2,1,3,9,1,0,1,-1,1,0,0,0,0,0,0,0,0,0.5044173060022736,0.49558269399772636
85986,0.5348837209302326,0.5073891625615764,-115,-103,0.5122726437136835,0.48772735628631647,home,NYY,under,7.5,0.5238095238095238,-110,0.5041391197660889,NYY,LAA,2022 REG,7,2,2,1,3,9,1,0,1,-1,1,0,0,0,0,0,0,0,0,0.5044173060022736,0.49558269399772636
85986,0.5348837209302326,0.5073891625615764,-115,-103,0.5122726437136835,0.48772735628631647,home,NYY,under,8.5,0.5169082125603864,-107,0.49558269399772636,NYY,LAA,2022 REG,7,2,2,1,3,9,1,0,1,-1,1,0,0,0,0,0,0,0,0,0.5044173060022736,0.49558269399772636
85987,0.4854368932038835,0.5555555555555556,106,-125,0.465537646233282,0.534462353766718,away,SF,over,11,0.5327102803738317,-114,0.508788710910954,COL,SF,2022 REG,16,7,15,10,17,31,0,1,-3,3,1,1,1,1,1,1,1,0,0,0.508788710910954,0.491211289089046
85987,0.4854368932038835,0.5555555555555556,106,-125,0.465537646233282,0.534462353766718,home,COL,under,11,0.5121951219512195,-105,0.491211289089046,COL,SF,2022 REG,16,7,15,10,17,31,0,1,-3,3,1,1,1,1,1,1,1,0,0,0.508788710910954,0.491211289089046
85988,0.6402877697841727,0.39370078740157477,-178,154,0.6185253123055287,0.38147468769447135,away,PIT,over,7.5,0.5,100,0.4783105022831051,TB,PIT,2022 REG,14,6,8,5,11,22,1,0,1,-1,1,1,1,1,1,0,0,0,0,0.4783105022831051,0.5216894977168949
85988,0.6402877697841727,0.39370078740157477,-178,154,0.6185253123055287,0.38147468769447135,home,TB,under,7.5,0.5433789954337899,-119,0.5216894977168949,TB,PIT,2022 REG,14,6,8,5,11,22,1,0,1,-1,1,1,1,1,1,0,0,0,0,0.4783105022831051,0.5216894977168949
85990,0.5283018867924528,0.5121951219512195,-112,-105,0.5069072406637203,0.4930927593362797,away,BAL,over,9.5,0.5,100,0.4772727272727273,KC,BAL,2022 REG,10,7,10,5,12,20,1,0,2,-2,1,1,1,1,1,0,0,0,0,0.4772727272727273,0.5227272727272727
85990,0.5283018867924528,0.5121951219512195,-112,-105,0.5069072406637203,0.4930927593362797,home,KC,under,9.5,0.5454545454545454,-120,0.5227272727272727,KC,BAL,2022 REG,10,7,10,5,12,20,1,0,2,-2,1,1,1,1,1,0,0,0,0,0.4772727272727273,0.5227272727272727
85991,0.4739336492890995,0.5652173913043479,111,-130,0.4553786537471813,0.5446213462528187,away,SD,over,7.5,0.504950495049505,-102,0.4826715732667395,SF,SD,2022 REG,7,3,9,4,7,16,0,1,-1,1,1,1,1,0,0,0,0,0,0,0.4826715732667395,0.5173284267332605
85991,0.4739336492890995,0.5652173913043479,111,-130,0.4553786537471813,0.5446213462528187,home,SF,under,7.5,0.5391705069124424,-117,0.5173284267332605,SF,SD,2022 REG,7,3,9,4,7,16,0,1,-1,1,1,1,1,0,0,0,0,0,0,0.4826715732667395,0.5173284267332605
85992,0.6551724137931035,0.390625,-190,156,0.6251672116527942,0.3748327883472058,away,ARI,over,8,0.5145631067961165,-106,0.4913668392989033,SD,ARI,2022 REG,8,4,10,3,7,18,1,0,1,-1,1,1,1,0,0,0,0,0,0,0.4913668392989033,0.5086331607010968
85992,0.6551724137931035,0.390625,-190,156,0.6251672116527942,0.3748327883472058,home,SD,under,8,0.5305164319248826,-113,0.5086331607010968,SD,ARI,2022 REG,8,4,10,3,7,18,1,0,1,-1,1,1,1,0,0,0,0,0,0,0.4913668392989033,0.5086331607010968
85993,0.5495495495495495,0.49504950495049505,-122,102,0.5250401592387142,0.47495984076128583,away,NYM,over,9,0.5475113122171946,-121,0.5242087833606768,LAA,NYM,2022 REG,6,1,11,4,5,17,0,1,-3,3,1,0,0,0,0,0,0,0,0,0.5242087833606768,0.4757912166393232
85993,0.5495495495495495,0.49504950495049505,-122,102,0.5250401592387142,0.47495984076128583,home,LAA,under,9,0.49504950495049505,102,0.4757912166393232,LAA,NYM,2022 REG,6,1,11,4,5,17,0,1,-3,3,1,0,0,0,0,0,0,0,0,0.5242087833606768,0.4757912166393232
85994,0.4608294930875576,0.5798319327731092,117,-138,0.4420915088199692,0.5579084911800307,away,CHC,over,9,0.5348837209302326,-115,0.5097020142727117,PIT,CHC,2022 REG,5,5,13,14,19,18,0,1,-9,9,1,1,1,1,1,0,0,0,0,0.5097020142727117,0.49029798572728833
85994,0.4608294930875576,0.5798319327731092,117,-138,0.4420915088199692,0.5579084911800307,home,PIT,under,9,0.5121951219512195,-105,0.49029798572728833,PIT,CHC,2022 REG,5,5,13,14,19,18,0,1,-9,9,1,1,1,1,1,0,0,0,0,0.5097020142727117,0.49029798572728833
85995,0.5283018867924528,0.5121951219512195,-112,-105,0.5069072406637203,0.4930927593362797,away,SD,over,7.5,0.49019607843137253,104,0.4707129274603323,SEA,SD,2022 REG,3,0,8,2,2,11,0,1,-2,2,0,0,0,0,0,0,0,0,0,0.4707129274603323,0.5292870725396677
85995,0.5283018867924528,0.5121951219512195,-112,-105,0.5069072406637203,0.4930927593362797,home,SEA,under,7.5,0.5495495495495495,-122,0.5292870725396677,SEA,SD,2022 REG,3,0,8,2,2,11,0,1,-2,2,0,0,0,0,0,0,0,0,0,0.4707129274603323,0.5292870725396677
85997,0.3389830508474576,0.7032640949554896,195,-237,0.3246619844735772,0.6753380155264228,away,LAD,over,7.5,0.5169082125603864,-107,0.49353874091423283,PIT,LAD,2022 REG,15,5,4,1,6,19,1,0,4,-4,1,0,0,0,0,0,0,0,0,0.49353874091423283,0.5064612590857671
85997,0.3389830508474576,0.7032640949554896,195,-237,0.3246619844735772,0.6753380155264228,home,PIT,under,7.5,0.5283018867924528,-112,0.5064612590857671,PIT,LAD,2022 REG,15,5,4,1,6,19,1,0,4,-4,1,0,0,0,0,0,0,0,0,0.49353874091423283,0.5064612590857671
85998,0.4716981132075471,0.5652173913043479,112,-130,0.4542851393811816,0.5457148606188185,away,NYM,over,8.5,0.5283018867924528,-112,0.5044173060022736,LAA,NYM,2022 REG,9,3,13,7,10,22,0,1,-4,4,1,1,1,0,0,0,0,0,0,0.5044173060022736,0.49558269399772636
85998,0.4716981132075471,0.5652173913043479,112,-130,0.4542851393811816,0.5457148606188185,home,LAA,under,8.5,0.5169082125603864,-107,0.49558269399772636,LAA,NYM,2022 REG,9,3,13,7,10,22,0,1,-4,4,1,1,1,0,0,0,0,0,0,0.5044173060022736,0.49558269399772636
85999,0.4464285714285714,0.5918367346938775,124,-145,0.42934584548104954,0.5706541545189505,away,HOU,over,8,0.5348837209302326,-115,0.5097020142727117,NYM,HOU,2022 REG,2,0,7,2,2,9,0,1,-2,2,0,0,0,0,0,0,0,0,0,0.5097020142727117,0.49029798572728833
85999,0.4464285714285714,0.5918367346938775,124,-145,0.42934584548104954,0.5706541545189505,home,NYM,under,8,0.5121951219512195,-105,0.49029798572728833,NYM,HOU,2022 REG,2,0,7,2,2,9,0,1,-2,2,0,0,0,0,0,0,0,0,0,0.5097020142727117,0.49029798572728833
86000,0.6254681647940076,0.4098360655737705,-167,144,0.6033864926164085,0.39661350738359147,away,SD,over,7.5,0.49751243781094534,101,0.476135829221149,SEA,SD,2022 REG,8,6,7,1,7,15,1,0,5,-5,1,0,0,0,0,0,0,0,0,0.476135829221149,0.523864170778851
86000,0.6254681647940076,0.4098360655737705,-167,144,0.6033864926164085,0.39661350738359147,home,SEA,under,7.5,0.5454545454545454,-120,0.523864170778851,SEA,SD,2022 REG,8,6,7,1,7,15,1,0,5,-5,1,0,0,0,0,0,0,0,0,0.476135829221149,0.523864170778851
86002,0.7752808988764045,0.267379679144385,-345,274,0.7422069676018598,0.2577930323981402,away,CIN,over,8.5,0.5454545454545454,-120,0.5206611570247933,NYY,CIN,2022 REG,6,7,10,6,13,16,1,0,1,-1,1,1,1,1,1,1,0,0,0,0.5206611570247933,0.4793388429752067
86002,0.7752808988764045,0.267379679144385,-345,274,0.7422069676018598,0.2577930323981402,home,NYY,under,8.5,0.5,100,0.4793388429752067,NYY,CIN,2022 REG,6,7,10,6,13,16,1,0,1,-1,1,1,1,1,1,1,0,0,0,0.5206611570247933,0.4793388429752067
86003,0.08,0.9696969696969697,1150,-3200,0.07602424242424241,0.9239757575757576,away,COL,over,7.5,0.48780487804878053,105,0.4666534470222751,SD,COL,2022 REG,4,2,9,6,8,13,0,1,-4,4,1,1,0,0,0,0,0,0,0,0.6004801097393689,0.39951989026063106
86003,0.08,0.9696969696969697,1150,-3200,0.07602424242424241,0.9239757575757576,away,COL,over,8.5,0.6296296296296295,-170,0.6004801097393689,SD,COL,2022 REG,4,2,9,6,8,13,0,1,-4,4,1,1,0,0,0,0,0,0,0,0.6004801097393689,0.39951989026063106
86003,0.08,0.9696969696969697,1150,-3200,0.07602424242424241,0.9239757575757576,away,COL,over,10.5,0.5169082125603864,-107,0.47945109570818456,SD,COL,2022 REG,4,2,9,6,8,13,0,1,-4,4,1,1,0,0,0,0,0,0,0,0.6004801097393689,0.39951989026063106
86003,0.08,0.9696969696969697,1150,-3200,0.07602424242424241,0.9239757575757576,home,SD,under,7.5,0.5555555555555556,-125,0.5333465529777248,SD,COL,2022 REG,4,2,9,6,8,13,0,1,-4,4,1,1,0,0,0,0,0,0,0,0.6004801097393689,0.39951989026063106
86003,0.08,0.9696969696969697,1150,-3200,0.07602424242424241,0.9239757575757576,home,SD,under,8.5,0.4166666666666667,140,0.39951989026063106,SD,COL,2022 REG,4,2,9,6,8,13,0,1,-4,4,1,1,0,0,0,0,0,0,0,0.6004801097393689,0.39951989026063106
86003,0.08,0.9696969696969697,1150,-3200,0.07602424242424241,0.9239757575757576,home,SD,under,10.5,0.5555555555555556,-125,0.5205489042918154,SD,COL,2022 REG,4,2,9,6,8,13,0,1,-4,4,1,1,0,0,0,0,0,0,0,0.6004801097393689,0.39951989026063106
86004,0.6000000000000001,0.4444444444444444,-150,125,0.5733333333333334,0.42666666666666664,away,MIA,over,8.5,0.5169082125603864,-107,0.49353874091423283,ATL,MIA,2022 REG,6,3,5,0,3,11,1,0,3,-3,0,0,0,0,0,0,0,0,0,0.49353874091423283,0.5064612590857671
86004,0.6000000000000001,0.4444444444444444,-150,125,0.5733333333333334,0.42666666666666664,home,ATL,under,8.5,0.5283018867924528,-112,0.5064612590857671,ATL,MIA,2022 REG,6,3,5,0,3,11,1,0,3,-3,0,0,0,0,0,0,0,0,0,0.49353874091423283,0.5064612590857671
86005,0.47619047619047616,0.5652173913043479,110,-130,0.4564724440500838,0.5435275559499162,away,CWS,over,11.5,0.5238095238095238,-110,0.4988662131519274,COL,CWS,2022 REG,11,6,11,5,11,22,1,0,1,-1,1,1,1,1,1,0,0,0,0,0.4988662131519274,0.5011337868480725
86005,0.47619047619047616,0.5652173913043479,110,-130,0.4564724440500838,0.5435275559499162,home,COL,under,11.5,0.5238095238095238,-110,0.5011337868480725,COL,CWS,2022 REG,11,6,11,5,11,22,1,0,1,-1,1,1,1,1,1,0,0,0,0,0.4988662131519274,0.5011337868480725
86006,0.7916666666666667,0.25,-380,300,0.7586805555555556,0.24131944444444442,away,WSH,over,8.5,0.5348837209302326,-115,0.5097020142727117,ATL,WSH,2022 REG,10,5,9,2,7,19,1,0,3,-3,1,1,0,0,0,0,0,0,0,0.5097020142727117,0.49029798572728833
86006,0.7916666666666667,0.25,-380,300,0.7586805555555556,0.24131944444444442,home,ATL,under,8.5,0.5121951219512195,-105,0.49029798572728833,ATL,WSH,2022 REG,10,5,9,2,7,19,1,0,3,-3,1,1,0,0,0,0,0,0,0,0.5097020142727117,0.49029798572728833
86007,0.35460992907801414,0.6894409937888198,182,-222,0.33898903444438505,0.6610109655556149,away,HOU,over,7,0.5121951219512195,-105,0.48808156828023186,OAK,HOU,2022 REG,8,4,5,2,6,13,1,0,2,-2,1,1,0,0,0,0,0,0,0,0.48808156828023186,0.5119184317197681
86007,0.35460992907801414,0.6894409937888198,182,-222,0.33898903444438505,0.6610109655556149,home,OAK,under,7,0.5348837209302326,-115,0.5119184317197681,OAK,HOU,2022 REG,8,4,5,2,6,13,1,0,2,-2,1,1,0,0,0,0,0,0,0,0.48808156828023186,0.5119184317197681
86009,0.5348837209302326,0.5121951219512195,-115,-105,0.5097020142727117,0.49029798572728833,away,BOS,over,7.5,0.5412844036697247,-118,0.5149381613977361,TB,BOS,2022 REG,14,10,9,5,15,23,1,0,5,-5,1,1,1,1,1,0,0,0,0,0.5149381613977361,0.48506183860226393
86009,0.5348837209302326,0.5121951219512195,-115,-105,0.5097020142727117,0.49029798572728833,home,TB,under,7.5,0.5073891625615764,-103,0.48506183860226393,TB,BOS,2022 REG,14,10,9,5,15,23,1,0,5,-5,1,1,1,1,1,0,0,0,0,0.5149381613977361,0.48506183860226393
86010,0.4672897196261683,0.574468085106383,114,-135,0.4477767267604901,0.5522232732395099,away,MIN,over,9,0.5215311004784688,-109,0.4978845547971712,LAA,MIN,2022 REG,8,4,5,2,6,13,1,0,2,-2,1,1,0,0,0,0,0,0,0,0.4978845547971712,0.5021154452028288
86010,0.4672897196261683,0.574468085106383,114,-135,0.4477767267604901,0.5522232732395099,home,LAA,under,9,0.5238095238095238,-110,0.5021154452028288,LAA,MIN,2022 REG,8,4,5,2,6,13,1,0,2,-2,1,1,0,0,0,0,0,0,0,0.4978845547971712,0.5021154452028288
86011,0.7448979591836734,0.29673590504451036,-292,237,0.7138849786871693,0.28611502131283073,away,PIT,over,9,0.5412844036697247,-118,0.5189377998484975,PHI,PIT,2022 REG,7,6,6,0,6,13,1,0,6,-6,0,0,0,0,0,0,0,0,0,0.5189377998484975,0.4810622001515025
86011,0.7448979591836734,0.29673590504451036,-292,237,0.7138849786871693,0.28611502131283073,home,PHI,under,9,0.5,100,0.4810622001515025,PHI,PIT,2022 REG,7,6,6,0,6,13,1,0,6,-6,0,0,0,0,0,0,0,0,0,0.5189377998484975,0.4810622001515025
86012,0.3333333333333333,0.7058823529411764,200,-240,0.32026143790849676,0.6797385620915033,away,HOU,over,7,0.5454545454545454,-120,0.5193043049216726,DET,HOU,2022 REG,6,0,13,7,7,19,0,1,-7,7,0,0,0,0,0,0,0,0,0,0.5193043049216726,0.48069569507832743
86012,0.3333333333333333,0.7058823529411764,200,-240,0.32026143790849676,0.6797385620915033,home,DET,under,7,0.5024875621890548,-101,0.48069569507832743,DET,HOU,2022 REG,6,0,13,7,7,19,0,1,-7,7,0,0,0,0,0,0,0,0,0,0.5193043049216726,0.48069569507832743
86013,0.6183206106870228,0.4184100418410042,-162,139,0.5956092911849603,0.4043907088150397,away,CHC,over,9,0.5,100,0.4772727272727273,BAL,CHC,2022 REG,6,2,8,3,5,14,0,1,-1,1,1,1,0,0,0,0,0,0,0,0.4772727272727273,0.5227272727272727
86013,0.6183206106870228,0.4184100418410042,-162,139,0.5956092911849603,0.4043907088150397,home,BAL,under,9,0.5454545454545454,-120,0.5227272727272727,BAL,CHC,2022 REG,6,2,8,3,5,14,0,1,-1,1,1,1,0,0,0,0,0,0,0,0.4772727272727273,0.5227272727272727
86014,0.4716981132075471,0.5652173913043479,112,-130,0.4542851393811816,0.5457148606188185,away,TOR,over,9,0.5238095238095238,-110,0.4988662131519274,CWS,TOR,2022 REG,15,7,8,6,13,23,1,0,1,-1,1,1,1,1,1,1,0,0,0,0.4988662131519274,0.5011337868480725
86014,0.4716981132075471,0.5652173913043479,112,-130,0.4542851393811816,0.5457148606188185,home,CWS,under,9,0.5238095238095238,-110,0.5011337868480725,CWS,TOR,2022 REG,15,7,8,6,13,23,1,0,1,-1,1,1,1,1,1,1,0,0,0,0.4988662131519274,0.5011337868480725
86015,0.4081632653061224,0.626865671641791,145,-168,0.39386574002125985,0.6061342599787402,away,SD,over,8,0.5192307692307692,-108,0.49688292476754015,CIN,SD,2022 REG,8,6,12,9,15,20,0,1,-3,3,1,1,1,1,1,1,0,0,0,0.49688292476754015,0.5031170752324599
86015,0.4081632653061224,0.626865671641791,145,-168,0.39386574002125985,0.6061342599787402,home,CIN,under,8,0.5238095238095238,-110,0.5031170752324599,CIN,SD,2022 REG,8,6,12,9,15,20,0,1,-3,3,1,1,1,1,1,1,0,0,0,0.49688292476754015,0.5031170752324599
86016,0.5555555555555556,0.49504950495049505,-125,102,0.5274416330521942,0.47255836694780584,away,BOS,over,7.5,0.5,100,0.4772727272727273,TB,BOS,2022 REG,3,3,2,2,5,5,1,0,1,-1,1,1,0,0,0,0,0,0,0,0.4772727272727273,0.5227272727272727
86016,0.5555555555555556,0.49504950495049505,-125,102,0.5274416330521942,0.47255836694780584,home,TB,under,7.5,0.5454545454545454,-120,0.5227272727272727,TB,BOS,2022 REG,3,3,2,2,5,5,1,0,1,-1,1,1,0,0,0,0,0,0,0,0.4772727272727273,0.5227272727272727
86018,0.7402597402597403,0.29673590504451036,-285,237,0.7128733534760743,0.2871266465239257,away,MIA,over,8.5,0.5073891625615764,-103,0.4837652908580103,HOU,MIA,2022 REG,8,1,6,5,6,14,0,1,-4,4,1,0,0,0,0,0,0,0,0,0.4837652908580103,0.5162347091419897
86018,0.7402597402597403,0.29673590504451036,-285,237,0.7128733534760743,0.2871266465239257,home,HOU,under,8.5,0.5391705069124424,-117,0.5162347091419897,HOU,MIA,2022 REG,8,1,6,5,6,14,0,1,-4,4,1,0,0,0,0,0,0,0,0,0.4837652908580103,0.5162347091419897
86019,0.5283018867924528,0.5145631067961165,-112,-106,0.5056562298022652,0.4943437701977348,away,KC,over,8,0.5283018867924528,-112,0.5031902949311281,OAK,KC,2022 REG,2,0,7,2,2,9,0,1,-2,2,0,0,0,0,0,0,0,0,0,0.5031902949311281,0.4968097050688719
86019,0.5283018867924528,0.5145631067961165,-112,-106,0.5056562298022652,0.4943437701977348,home,OAK,under,8,0.5192307692307692,-108,0.4968097050688719,OAK,KC,2022 REG,2,0,7,2,2,9,0,1,-2,2,0,0,0,0,0,0,0,0,0,0.5031902949311281,0.4968097050688719
86020,0.4566210045662101,0.5780590717299579,119,-137,0.4407853532894211,0.559214646710579,away,PHI,over,9.5,0.5121951219512195,-105,0.48808156828023186,ARI,PHI,2022 REG,8,2,24,18,20,32,0,1,-16,16,1,1,0,0,0,0,0,0,0,0.48808156828023186,0.5119184317197681
86020,0.4566210045662101,0.5780590717299579,119,-137,0.4407853532894211,0.559214646710579,home,ARI,under,9.5,0.5348837209302326,-115,0.5119184317197681,ARI,PHI,2022 REG,8,2,24,18,20,32,0,1,-16,16,1,1,0,0,0,0,0,0,0,0.48808156828023186,0.5119184317197681
86021,0.6875,0.35714285714285715,-220,180,0.6568080357142857,0.3431919642857143,away,LAA,over,8.5,0.5145631067961165,-106,0.4925063625223866,ATL,LAA,2022 REG,11,7,8,2,9,19,1,0,5,-5,1,1,0,0,0,0,0,0,0,0.4925063625223866,0.5074936374776133
86021,0.6875,0.35714285714285715,-220,180,0.6568080357142857,0.3431919642857143,home,ATL,under,8.5,0.5283018867924528,-112,0.5074936374776133,ATL,LAA,2022 REG,11,7,8,2,9,19,1,0,5,-5,1,1,0,0,0,0,0,0,0,0.4925063625223866,0.5074936374776133
86022,0.5433789954337899,0.49751243781094534,-119,101,0.5211594495154178,0.4788405504845822,away,CLE,over,12,0.5305164319248826,-113,0.5066009958897986,COL,CLE,2022 REG,11,5,11,7,12,22,0,1,-2,2,1,1,1,1,1,0,0,0,0,0.5066009958897986,0.49339900411020143
86022,0.5433789954337899,0.49751243781094534,-119,101,0.5211594495154178,0.4788405504845822,home,COL,under,12,0.5145631067961165,-106,0.49339900411020143,COL,CLE,2022 REG,11,5,11,7,12,22,0,1,-2,2,1,1,1,1,1,0,0,0,0,0.5066009958897986,0.49339900411020143
86023,0.5348837209302326,0.5073891625615764,-115,-103,0.5122726437136835,0.48772735628631647,away,ATL,over,8.5,0.5121951219512195,-105,0.48808156828023186,SD,ATL,2022 REG,6,2,9,5,7,15,0,1,-3,3,1,1,0,0,0,0,0,0,0,0.48808156828023186,0.5119184317197681
86023,0.5348837209302326,0.5073891625615764,-115,-103,0.5122726437136835,0.48772735628631647,home,SD,under,8.5,0.5348837209302326,-115,0.5119184317197681,SD,ATL,2022 REG,6,2,9,5,7,15,0,1,-3,3,1,1,0,0,0,0,0,0,0,0.48808156828023186,0.5119184317197681
86024,0.7916666666666667,0.25,-380,300,0.7586805555555556,0.24131944444444442,away,OAK,over,7.5,0.5098039215686274,-104,0.48592421718142587,HOU,OAK,2022 REG,6,5,7,0,5,13,1,0,5,-5,0,0,0,0,0,0,0,0,0,0.48592421718142587,0.5140757828185741
86024,0.7916666666666667,0.25,-380,300,0.7586805555555556,0.24131944444444442,home,HOU,under,7.5,0.5370370370370371,-116,0.5140757828185741,HOU,OAK,2022 REG,6,5,7,0,5,13,1,0,5,-5,0,0,0,0,0,0,0,0,0,0.48592421718142587,0.5140757828185741
86025,0.4,0.6336996336996338,150,-173,0.3865201465201465,0.6134798534798536,away,CLE,over,11,0.5305164319248826,-113,0.5066009958897986,COL,CLE,2022 REG,9,3,12,4,7,21,0,1,-1,1,1,1,1,0,0,0,0,0,0,0.5066009958897986,0.49339900411020143
86025,0.4,0.6336996336996338,150,-173,0.3865201465201465,0.6134798534798536,home,COL,under,11,0.5145631067961165,-106,0.49339900411020143,COL,CLE,2022 REG,9,3,12,4,7,21,0,1,-1,1,1,1,1,0,0,0,0,0,0,0.5066009958897986,0.49339900411020143
86026,0.46511627906976744,0.574468085106383,115,-135,0.44670494689481377,0.5532950531051862,away,LAD,over,9.5,0.5348837209302326,-115,0.5097020142727117,PHI,LAD,2022 REG,8,4,6,3,7,14,1,0,1,-1,1,1,1,0,0,0,0,0,0,0.5097020142727117,0.49029798572728833
86026,0.46511627906976744,0.574468085106383,115,-135,0.44670494689481377,0.5532950531051862,home,PHI,under,9.5,0.5121951219512195,-105,0.49029798572728833,PHI,LAD,2022 REG,8,4,6,3,7,14,1,0,1,-1,1,1,1,0,0,0,0,0,0,0.5097020142727117,0.49029798572728833
86027,0.5614035087719298,0.47619047619047616,-128,110,0.5402981137053159,0.4597018862946841,away,SF,over,7.5,0.5238095238095238,-110,0.4988662131519274,MIN,SF,2022 REG,9,9,4,0,9,13,1,0,9,-9,0,0,0,0,0,0,0,0,0,0.4988662131519274,0.5011337868480725
86027,0.5614035087719298,0.47619047619047616,-128,110,0.5402981137053159,0.4597018862946841,home,MIN,under,7.5,0.5238095238095238,-110,0.5011337868480725,MIN,SF,2022 REG,9,9,4,0,9,13,1,0,9,-9,0,0,0,0,0,0,0,0,0,0.4988662131519274,0.5011337868480725
86028,0.7142857142857143,0.32573289902280134,-250,207,0.6857009904939174,0.3142990095060826,away,BAL,over,9,0.5098039215686274,-104,0.48592421718142587,MIN,BAL,2022 REG,10,4,7,3,7,17,1,0,1,-1,1,1,1,0,0,0,0,0,0,0.48592421718142587,0.5140757828185741
86028,0.7142857142857143,0.32573289902280134,-250,207,0.6857009904939174,0.3142990095060826,home,MIN,under,9,0.5370370370370371,-116,0.5140757828185741,MIN,BAL,2022 REG,10,4,7,3,7,17,1,0,1,-1,1,1,1,0,0,0,0,0,0,0.48592421718142587,0.5140757828185741
86030,0.5815899581589958,0.45454545454545453,-139,120,0.5605739649961564,0.4394260350038436,away,DET,over,7,0.5283018867924528,-112,0.5044173060022736,MIN,DET,2022 REG,12,7,11,1,8,23,1,0,6,-6,1,0,0,0,0,0,0,0,0,0.5044173060022736,0.49558269399772636
86030,0.5815899581589958,0.45454545454545453,-139,120,0.5605739649961564,0.4394260350038436,home,MIN,under,7,0.5169082125603864,-107,0.49558269399772636,MIN,DET,2022 REG,12,7,11,1,8,23,1,0,6,-6,1,0,0,0,0,0,0,0,0,0.5044173060022736,0.49558269399772636
86031,0.3508771929824561,0.6845425867507886,185,-217,0.3384492000935983,0.6615507999064016,away,LAD,over,11,0.5348837209302326,-115,0.5097020142727117,COL,LAD,2022 REG,11,7,9,4,11,20,1,0,3,-3,1,1,1,1,0,0,0,0,0,0.5097020142727117,0.49029798572728833
86031,0.3508771929824561,0.6845425867507886,185,-217,0.3384492000935983,0.6615507999064016,home,COL,under,11,0.5121951219512195,-105,0.49029798572728833,COL,LAD,2022 REG,11,7,9,4,11,20,1,0,3,-3,1,1,1,1,0,0,0,0,0,0.5097020142727117,0.49029798572728833
86032,0.5024875621890548,0.5391705069124424,-101,-117,0.4815549006007403,0.5184450993992598,away,TB,over,9,0.5121951219512195,-105,0.48808156828023186,MIN,TB,2022 REG,5,0,7,6,6,12,0,1,-6,6,0,0,0,0,0,0,0,0,0,0.48808156828023186,0.5119184317197681
86032,0.5024875621890548,0.5391705069124424,-101,-117,0.4815549006007403,0.5184450993992598,home,MIN,under,9,0.5348837209302326,-115,0.5119184317197681,MIN,TB,2022 REG,5,0,7,6,6,12,0,1,-6,6,0,0,0,0,0,0,0,0,0,0.48808156828023186,0.5119184317197681
86033,0.7542997542997544,0.2840909090909091,-307,252,0.7253416863367723,0.2746583136632277,away,DET,over,8.5,0.5370370370370371,-116,0.5118817074154765,NYY,DET,2022 REG,7,5,8,4,9,15,1,0,1,-1,1,1,1,1,0,0,0,0,0,0.5118817074154765,0.48811829258452355
86033,0.7542997542997544,0.2840909090909091,-307,252,0.7253416863367723,0.2746583136632277,home,NYY,under,8.5,0.5098039215686274,-104,0.48811829258452355,NYY,DET,2022 REG,7,5,8,4,9,15,1,0,1,-1,1,1,1,1,0,0,0,0,0,0.5118817074154765,0.48811829258452355
86034,0.4854368932038835,0.5515695067264574,106,-123,0.46747262139303836,0.5325273786069616,away,CWS,over,7.5,0.5073891625615764,-103,0.4837652908580103,SEA,CWS,2022 REG,6,2,5,3,5,11,0,1,-1,1,1,1,0,0,0,0,0,0,0,0.4837652908580103,0.5162347091419897
86034,0.4854368932038835,0.5515695067264574,106,-123,0.46747262139303836,0.5325273786069616,home,SEA,under,7.5,0.5391705069124424,-117,0.5162347091419897,SEA,CWS,2022 REG,6,2,5,3,5,11,0,1,-1,1,1,1,0,0,0,0,0,0,0,0.4837652908580103,0.5162347091419897
86035,0.5515695067264574,0.48780487804878053,-123,105,0.5298517967383217,0.4701482032616783,away,WSH,over,9.5,0.5238095238095238,-110,0.4988662131519274,ARI,WSH,2022 REG,10,3,9,4,7,19,0,1,-1,1,1,1,1,0,0,0,0,0,0,0.4988662131519274,0.5011337868480725
86035,0.5515695067264574,0.48780487804878053,-123,105,0.5298517967383217,0.4701482032616783,home,ARI,under,9.5,0.5238095238095238,-110,0.5011337868480725,ARI,WSH,2022 REG,10,3,9,4,7,19,0,1,-1,1,1,1,1,0,0,0,0,0,0,0.4988662131519274,0.5011337868480725
86036,0.5348837209302326,0.504950495049505,-115,-102,0.5135770472666521,0.4864229527333479,away,TOR,over,8,0.5305164319248826,-113,0.5066009958897986,STL,TOR,2022 REG,10,7,4,3,10,14,1,0,4,-4,1,1,1,0,0,0,0,0,0,0.5066009958897986,0.49339900411020143
86036,0.5348837209302326,0.504950495049505,-115,-102,0.5135770472666521,0.4864229527333479,home,STL,under,8,0.5145631067961165,-106,0.49339900411020143,STL,TOR,2022 REG,10,7,4,3,10,14,1,0,4,-4,1,1,1,0,0,0,0,0,0,0.5066009958897986,0.49339900411020143
86037,0.978002639683238,0.07418397626112759,-4446,1248,0.926963991533513,0.07303600846648695,away,DET,over,8.5,0.5833333333333333,-140,0.5486111111111112,KC,DET,2022 REG,11,7,11,3,10,22,1,0,4,-4,1,1,1,0,0,0,0,0,0,0.5486111111111112,0.45138888888888884
86037,0.978002639683238,0.07418397626112759,-4446,1248,0.926963991533513,0.07303600846648695,home,KC,under,8.5,0.47619047619047616,110,0.45138888888888884,KC,DET,2022 REG,11,7,11,3,10,22,1,0,4,-4,1,1,1,0,0,0,0,0,0,0.5486111111111112,0.45138888888888884
86038,0.7245179063360881,0.31746031746031744,-263,215,0.6941039315194085,0.3058960684805915,away,MIL,over,8.5,0.5327102803738317,-114,0.508788710910954,LAD,MIL,2022 REG,13,12,9,6,18,22,1,0,6,-6,1,1,1,1,1,1,0,0,0,0.508788710910954,0.491211289089046
86038,0.7245179063360881,0.31746031746031744,-263,215,0.6941039315194085,0.3058960684805915,home,LAD,under,8.5,0.5121951219512195,-105,0.491211289089046,LAD,MIL,2022 REG,13,12,9,6,18,22,1,0,6,-6,1,1,1,1,1,1,0,0,0,0.508788710910954,0.491211289089046
86039,0.49751243781094534,0.5454545454545454,101,-120,0.476135829221149,0.523864170778851,away,LAA,over,8,0.5327102803738317,-114,0.508788710910954,BAL,LAA,2022 REG,5,1,5,0,1,10,1,0,1,-1,0,0,0,0,0,0,0,0,0,0.508788710910954,0.491211289089046
86039,0.49751243781094534,0.5454545454545454,101,-120,0.476135829221149,0.523864170778851,home,BAL,under,8,0.5121951219512195,-105,0.491211289089046,BAL,LAA,2022 REG,5,1,5,0,1,10,1,0,1,-1,0,0,0,0,0,0,0,0,0,0.508788710910954,0.491211289089046
86040,0.5780590717299579,0.4608294930875576,-137,117,0.5555791840506346,0.44442081594936544,away,CIN,over,8,0.5169082125603864,-107,0.49353874091423283,CHC,CIN,2022 REG,8,8,12,3,11,20,1,0,5,-5,1,1,1,0,0,0,0,0,0,0.49353874091423283,0.5064612590857671
86040,0.5780590717299579,0.4608294930875576,-137,117,0.5555791840506346,0.44442081594936544,home,CHC,under,8,0.5283018867924528,-112,0.5064612590857671,CHC,CIN,2022 REG,8,8,12,3,11,20,1,0,5,-5,1,1,1,0,0,0,0,0,0,0.49353874091423283,0.5064612590857671
86041,0.5121951219512195,0.5238095238095238,-105,-110,0.4937537180249852,0.5062462819750149,away,ARI,over,11,0.5454545454545454,-120,0.5206611570247933,COL,ARI,2022 REG,9,4,5,1,5,14,1,0,3,-3,1,0,0,0,0,0,0,0,0,0.5206611570247933,0.4793388429752067
86041,0.5121951219512195,0.5238095238095238,-105,-110,0.4937537180249852,0.5062462819750149,home,COL,under,11,0.5,100,0.4793388429752067,COL,ARI,2022 REG,9,4,5,1,5,14,1,0,3,-3,1,0,0,0,0,0,0,0,0,0.5206611570247933,0.4793388429752067
86042,0.5515695067264574,0.49019607843137253,-123,104,0.5285328835228112,0.47146711647718875,away,BOS,over,8,0.5327102803738317,-114,0.508788710910954,SEA,BOS,2022 REG,13,7,8,6,13,21,1,0,1,-1,1,1,1,1,1,1,0,0,0,0.508788710910954,0.491211289089046
86042,0.5515695067264574,0.49019607843137253,-123,104,0.5285328835228112,0.47146711647718875,home,SEA,under,8,0.5121951219512195,-105,0.491211289089046,SEA,BOS,2022 REG,13,7,8,6,13,21,1,0,1,-1,1,1,1,1,1,1,0,0,0,0.508788710910954,0.491211289089046
86043,0.5260663507109005,0.5169082125603864,-111,-107,0.5034588790373798,0.49654112096262015,away,MIN,over,8.5,0.5454545454545454,-120,0.5206611570247933,TEX,MIN,2022 REG,8,5,10,6,11,18,0,1,-1,1,1,1,1,1,1,0,0,0,0,0.5206611570247933,0.4793388429752067
86043,0.5260663507109005,0.5169082125603864,-111,-107,0.5034588790373798,0.49654112096262015,home,TEX,under,8.5,0.5,100,0.4793388429752067,TEX,MIN,2022 REG,8,5,10,6,11,18,0,1,-1,1,1,1,1,1,1,0,0,0,0,0.5206611570247933,0.4793388429752067
86044,0.7304582210242588,0.3105590062111801,-271,222,0.7004968501865123,0.2995031498134877,away,WSH,over,9,0.5454545454545454,-120,0.5206611570247933,ATL,WSH,2022 REG,10,2,6,3,5,16,0,1,-1,1,1,1,0,0,0,0,0,0,0,0.5206611570247933,0.4793388429752067
86044,0.7304582210242588,0.3105590062111801,-271,222,0.7004968501865123,0.2995031498134877,home,ATL,under,9,0.5,100,0.4793388429752067,ATL,WSH,2022 REG,10,2,6,3,5,16,0,1,-1,1,1,1,0,0,0,0,0,0,0,0.5206611570247933,0.4793388429752067
86045,0.6323529411764706,0.40485829959514175,-172,147,0.6088223036297157,0.3911776963702843,away,CHC,over,8,0.5121951219512195,-105,0.48919479393107135,ATL,CHC,2022 REG,6,3,4,1,4,10,1,0,2,-2,1,0,0,0,0,0,0,0,0,0.48919479393107135,0.5108052060689287
86045,0.6323529411764706,0.40485829959514175,-172,147,0.6088223036297157,0.3911776963702843,home,ATL,under,8,0.5327102803738317,-114,0.5108052060689287,ATL,CHC,2022 REG,6,3,4,1,4,10,1,0,2,-2,1,0,0,0,0,0,0,0,0,0.48919479393107135,0.5108052060689287
86046,0.7701149425287357,0.2777777777777778,-335,260,0.7332320429823401,0.2667679570176599,away,PIT,over,8,0.5145631067961165,-106,0.4925063625223866,NYM,PIT,2022 REG,5,5,4,1,6,9,1,0,4,-4,1,0,0,0,0,0,0,0,0,0.4925063625223866,0.5074936374776133
86046,0.7701149425287357,0.2777777777777778,-335,260,0.7332320429823401,0.2667679570176599,home,NYM,under,8,0.5283018867924528,-112,0.5074936374776133,NYM,PIT,2022 REG,5,5,4,1,6,9,1,0,4,-4,1,0,0,0,0,0,0,0,0,0.4925063625223866,0.5074936374776133
86047,0.6226415094339623,0.4166666666666667,-165,140,0.5981666073335706,0.40183339266642937,away,CHC,over,8.5,0.5412844036697247,-118,0.5136310900085983,STL,CHC,2022 REG,5,0,8,3,3,13,0,1,-3,3,0,0,0,0,0,0,0,0,0,0.5136310900085983,0.4863689099914017
86047,0.6226415094339623,0.4166666666666667,-165,140,0.5981666073335706,0.40183339266642937,home,STL,under,8.5,0.5098039215686274,-104,0.4863689099914017,STL,CHC,2022 REG,5,0,8,3,3,13,0,1,-3,3,0,0,0,0,0,0,0,0,0,0.5136310900085983,0.4863689099914017
86048,0.425531914893617,0.613899613899614,135,-159,0.40875254093905067,0.5912474590609493,away,NYY,over,8.5,0.5327102803738317,-114,0.508788710910954,BOS,NYY,2022 REG,5,5,7,6,11,12,0,1,-1,1,1,1,1,1,1,0,0,0,0,0.508788710910954,0.491211289089046
86048,0.425531914893617,0.613899613899614,135,-159,0.40875254093905067,0.5912474590609493,home,BOS,under,8.5,0.5121951219512195,-105,0.491211289089046,BOS,NYY,2022 REG,5,5,7,6,11,12,0,1,-1,1,1,1,1,1,1,0,0,0,0,0.508788710910954,0.491211289089046
86049,0.7101449275362319,0.3389830508474576,-245,195,0.6752569428869452,0.32474305711305484,away,CIN,over,8.5,0.5454545454545454,-120,0.5193043049216726,MIL,CIN,2022 REG,7,5,7,1,6,14,1,0,4,-4,1,0,0,0,0,0,0,0,0,0.5193043049216726,0.48069569507832743
86049,0.7101449275362319,0.3389830508474576,-245,195,0.6752569428869452,0.32474305711305484,home,MIL,under,8.5,0.5024875621890548,-101,0.48069569507832743,MIL,CIN,2022 REG,7,5,7,1,6,14,1,0,4,-4,1,0,0,0,0,0,0,0,0,0.5193043049216726,0.48069569507832743
86050,0.6575342465753424,0.3846153846153846,-192,160,0.6298194205869192,0.3701805794130808,away,OAK,over,9.5,0.5305164319248826,-113,0.5066009958897986,BOS,OAK,2022 REG,13,10,7,1,11,20,1,0,9,-9,1,0,0,0,0,0,0,0,0,0.5066009958897986,0.49339900411020143
86050,0.6575342465753424,0.3846153846153846,-192,160,0.6298194205869192,0.3701805794130808,home,BOS,under,9.5,0.5145631067961165,-106,0.49339900411020143,BOS,OAK,2022 REG,13,10,7,1,11,20,1,0,9,-9,1,0,0,0,0,0,0,0,0,0.5066009958897986,0.49339900411020143
86051,0.35714285714285715,0.6875,180,-220,0.3411989795918367,0.6588010204081634,away,ATL,over,9,0.5215311004784688,-109,0.4978845547971712,WSH,ATL,2022 REG,4,2,14,8,10,18,0,1,-6,6,1,1,0,0,0,0,0,0,0,0.4978845547971712,0.5021154452028288
86051,0.35714285714285715,0.6875,180,-220,0.3411989795918367,0.6588010204081634,home,WSH,under,9,0.5238095238095238,-110,0.5021154452028288,WSH,ATL,2022 REG,4,2,14,8,10,18,0,1,-6,6,1,1,0,0,0,0,0,0,0,0.4978845547971712,0.5021154452028288
86052,0.6923076923076923,0.34965034965034963,-225,186,0.663259817105971,0.33674018289402896,away,CHC,over,8.5,0.5238095238095238,-110,0.4988662131519274,NYY,CHC,2022 REG,17,18,12,4,22,29,1,0,14,-14,1,1,1,1,0,0,0,0,0,0.4988662131519274,0.5011337868480725
86052,0.6923076923076923,0.34965034965034963,-225,186,0.663259817105971,0.33674018289402896,home,NYY,under,8.5,0.5238095238095238,-110,0.5011337868480725,NYY,CHC,2022 REG,17,18,12,4,22,29,1,0,14,-14,1,1,1,1,0,0,0,0,0,0.4988662131519274,0.5011337868480725
86053,0.5327102803738317,0.5121951219512195,-114,-105,0.508788710910954,0.491211289089046,away,TB,over,8,0.5121951219512195,-105,0.48808156828023186,TOR,TB,2022 REG,8,2,9,4,6,17,0,1,-2,2,1,1,0,0,0,0,0,0,0,0.48808156828023186,0.5119184317197681
86053,0.5327102803738317,0.5121951219512195,-114,-105,0.508788710910954,0.491211289089046,home,TOR,under,8,0.5348837209302326,-115,0.5119184317197681,TOR,TB,2022 REG,8,2,9,4,6,17,0,1,-2,2,1,1,0,0,0,0,0,0,0,0.48808156828023186,0.5119184317197681
86054,0.36101083032490977,0.6721311475409836,177,-205,0.34904621737693386,0.6509537826230661,away,CWS,over,7,0.5283018867924528,-112,0.5056562298022652,OAK,CWS,2022 REG,6,2,21,14,16,27,0,1,-12,12,1,1,0,0,0,0,0,0,0,0.5056562298022652,0.4943437701977348
86054,0.36101083032490977,0.6721311475409836,177,-205,0.34904621737693386,0.6509537826230661,home,OAK,under,7,0.5145631067961165,-106,0.4943437701977348,OAK,CWS,2022 REG,6,2,21,14,16,27,0,1,-12,12,1,1,0,0,0,0,0,0,0,0.5056562298022652,0.4943437701977348
86055,0.425531914893617,0.6124031007751938,135,-158,0.4093893550345486,0.5906106449654513,away,CWS,over,8.5,0.5348837209302326,-115,0.5097020142727117,DET,CWS,2022 REG,5,5,12,11,16,17,0,1,-6,6,1,1,1,1,1,0,0,0,0,0.5097020142727117,0.49029798572728833
86055,0.425531914893617,0.6124031007751938,135,-158,0.4093893550345486,0.5906106449654513,home,DET,under,8.5,0.5121951219512195,-105,0.49029798572728833,DET,CWS,2022 REG,5,5,12,11,16,17,0,1,-6,6,1,1,1,1,1,0,0,0,0,0.5097020142727117,0.49029798572728833
86056,0.6323529411764706,0.4016064257028112,-172,149,0.610878635649866,0.389121364350134,away,CWS,over,8.5,0.5121951219512195,-105,0.48808156828023186,BOS,CWS,2022 REG,6,2,10,4,6,16,0,1,-2,2,1,1,0,0,0,0,0,0,0,0.48808156828023186,0.5119184317197681
86056,0.6323529411764706,0.4016064257028112,-172,149,0.610878635649866,0.389121364350134,home,BOS,under,8.5,0.5348837209302326,-115,0.5119184317197681,BOS,CWS,2022 REG,6,2,10,4,6,16,0,1,-2,2,1,1,0,0,0,0,0,0,0,0.48808156828023186,0.5119184317197681
86057,0.646643109540636,0.3921568627450981,-183,155,0.6215533748116984,0.37844662518830163,away,MIN,over,7.5,0.504950495049505,-102,0.48160416005266615,CLE,MIN,2022 REG,14,5,4,1,6,18,1,0,4,-4,1,0,0,0,0,0,0,0,0,0.48160416005266615,0.5183958399473338
86057,0.646643109540636,0.3921568627450981,-183,155,0.6215533748116984,0.37844662518830163,home,CLE,under,7.5,0.5412844036697247,-118,0.5183958399473338,CLE,MIN,2022 REG,14,5,4,1,6,18,1,0,4,-4,1,0,0,0,0,0,0,0,0,0.48160416005266615,0.5183958399473338
86058,0.4629629629629629,0.576271186440678,116,-136,0.4447990049057217,0.5552009950942782,away,SEA,over,7,0.5412844036697247,-118,0.5175913212324037,OAK,SEA,2022 REG,7,0,13,9,9,20,0,1,-9,9,0,0,0,0,0,0,0,0,0,0.5175913212324037,0.4824086787675963
86058,0.4629629629629629,0.576271186440678,116,-136,0.4447990049057217,0.5552009950942782,home,OAK,under,7,0.5024875621890548,-101,0.4824086787675963,OAK,SEA,2022 REG,7,0,13,9,9,20,0,1,-9,9,0,0,0,0,0,0,0,0,0,0.5175913212324037,0.4824086787675963
86059,0.6402877697841727,0.4,-178,150,0.6144920035194866,0.38550799648051337,away,PIT,over,9,0.5,100,0.47935779816513757,MIL,PIT,2022 REG,7,2,7,4,6,14,0,1,-2,2,1,1,0,0,0,0,0,0,0,0.47935779816513757,0.5206422018348624
86059,0.6402877697841727,0.4,-178,150,0.6144920035194866,0.38550799648051337,home,MIL,under,9,0.5412844036697247,-118,0.5206422018348624,MIL,PIT,2022 REG,7,2,7,4,6,14,0,1,-2,2,1,1,0,0,0,0,0,0,0,0.47935779816513757,0.5206422018348624
86060,0.3968253968253968,0.6415770609318996,152,-179,0.3815863262867871,0.6184136737132129,away,LAD,over,9.5,0.5121951219512195,-105,0.4903184724049234,ARI,LAD,2022 REG,5,2,10,3,5,15,0,1,-1,1,1,1,0,0,0,0,0,0,0,0.4903184724049234,0.5096815275950766
86060,0.3968253968253968,0.6415770609318996,152,-179,0.3815863262867871,0.6184136737132129,home,ARI,under,9.5,0.5305164319248826,-113,0.5096815275950766,ARI,LAD,2022 REG,5,2,10,3,5,15,0,1,-1,1,1,1,0,0,0,0,0,0,0,0.4903184724049234,0.5096815275950766
86061,0.4444444444444444,0.5884773662551441,125,-143,0.4298125285779606,0.5701874714220394,away,SD,over,8,0.5073891625615764,-103,0.4837652908580103,CLE,SD,2022 REG,11,6,5,5,11,16,1,0,1,-1,1,1,1,1,1,0,0,0,0,0.4837652908580103,0.5162347091419897
86061,0.4444444444444444,0.5884773662551441,125,-143,0.4298125285779606,0.5701874714220394,home,CLE,under,8,0.5391705069124424,-117,0.5162347091419897,CLE,SD,2022 REG,11,6,5,5,11,16,1,0,1,-1,1,1,1,1,1,0,0,0,0,0.4837652908580103,0.5162347091419897
86062,0.5594713656387665,0.4854368932038835,-127,106,0.53434648073561,0.46565351926439,away,MIL,over,7.5,0.5370370370370371,-116,0.5118817074154765,STL,MIL,2022 REG,7,3,12,4,7,19,0,1,-1,1,1,1,1,0,0,0,0,0,0,0.5118817074154765,0.48811829258452355
86062,0.5594713656387665,0.4854368932038835,-127,106,0.53434648073561,0.46565351926439,home,STL,under,7.5,0.5098039215686274,-104,0.48811829258452355,STL,MIL,2022 REG,7,3,12,4,7,19,0,1,-1,1,1,1,1,0,0,0,0,0,0,0.5118817074154765,0.48811829258452355
86063,0.7333333333333333,0.3125,-275,220,0.6997222222222221,0.30027777777777787,away,CHC,over,7.5,0.5073891625615764,-103,0.4837652908580103,MIL,CHC,2022 REG,6,1,6,2,3,12,0,1,-1,1,1,0,0,0,0,0,0,0,0,0.4837652908580103,0.5162347091419897
86063,0.7333333333333333,0.3125,-275,220,0.6997222222222221,0.30027777777777787,home,MIL,under,7.5,0.5391705069124424,-117,0.5162347091419897,MIL,CHC,2022 REG,6,1,6,2,3,12,0,1,-1,1,1,0,0,0,0,0,0,0,0,0.4837652908580103,0.5162347091419897
86064,0.7340425531914894,0.303951367781155,-276,229,0.7061533984349738,0.2938466015650262,away,OAK,over,8,0.5327102803738317,-114,0.508788710910954,HOU,OAK,2022 REG,8,3,8,4,7,16,0,1,-1,1,1,1,1,0,0,0,0,0,0,0.508788710910954,0.491211289089046
86064,0.7340425531914894,0.303951367781155,-276,229,0.7061533984349738,0.2938466015650262,home,HOU,under,8,0.5121951219512195,-105,0.491211289089046,HOU,OAK,2022 REG,8,3,8,4,7,16,0,1,-1,1,1,1,1,0,0,0,0,0,0,0.508788710910954,0.491211289089046
86065,0.36363636363636365,0.6688741721854304,175,-202,0.35181435061025673,0.6481856493897433,away,LAD,over,8,0.5412844036697247,-118,0.5189377998484975,ARI,LAD,2022 REG,3,0,9,4,4,12,0,1,-4,4,0,0,0,0,0,0,0,0,0,0.5189377998484975,0.4810622001515025
86065,0.36363636363636365,0.6688741721854304,175,-202,0.35181435061025673,0.6481856493897433,home,ARI,under,8,0.5,100,0.4810622001515025,ARI,LAD,2022 REG,3,0,9,4,4,12,0,1,-4,4,0,0,0,0,0,0,0,0,0,0.5189377998484975,0.4810622001515025
86066,0.607843137254902,0.4329004329004329,-155,131,0.583077437748718,0.416922562251282,away,CHC,over,8.5,0.5238095238095238,-110,0.5000596729920038,CWS,CHC,2022 REG,7,1,10,5,6,17,0,1,-4,4,1,0,0,0,0,0,0,0,0,0.5000596729920038,0.4999403270079962
86066,0.607843137254902,0.4329004329004329,-155,131,0.583077437748718,0.416922562251282,home,CWS,under,8.5,0.5215311004784688,-109,0.4999403270079962,CWS,CHC,2022 REG,7,1,10,5,6,17,0,1,-4,4,1,0,0,0,0,0,0,0,0,0.5000596729920038,0.4999403270079962
86067,0.5798319327731092,0.4587155963302753,-138,118,0.557480844469466,0.442519155530534,away,CIN,over,7.5,0.49504950495049505,102,0.4739797934813417,ARI,CIN,2022 REG,8,7,5,4,11,13,1,0,3,-3,1,1,1,1,0,0,0,0,0,0.4739797934813417,0.5260202065186583
86067,0.5798319327731092,0.4587155963302753,-138,118,0.557480844469466,0.442519155530534,home,ARI,under,7.5,0.5475113122171946,-121,0.5260202065186583,ARI,CIN,2022 REG,8,7,5,4,11,13,1,0,3,-3,1,1,1,1,0,0,0,0,0,0.4739797934813417,0.5260202065186583
86068,0.5555555555555556,0.48780487804878053,-125,105,0.5314664257753688,0.46853357422463116,away,BAL,over,8,0.5238095238095238,-110,0.5000596729920038,TB,BAL,2022 REG,10,4,8,6,10,18,0,1,-2,2,1,1,1,1,0,0,0,0,0,0.5000596729920038,0.4999403270079962
86068,0.5555555555555556,0.48780487804878053,-125,105,0.5314664257753688,0.46853357422463116,home,TB,under,8,0.5215311004784688,-109,0.4999403270079962,TB,BAL,2022 REG,10,4,8,6,10,18,0,1,-2,2,1,1,1,1,0,0,0,0,0,0.5000596729920038,0.4999403270079962
86069,0.43859649122807015,0.6031746031746031,128,-152,0.4202758357883012,0.5797241642116988,away,SEA,over,8,0.5238095238095238,-110,0.4988662131519274,TEX,SEA,2022 REG,9,2,11,6,8,20,0,1,-4,4,1,1,0,0,0,0,0,0,0,0.4988662131519274,0.5011337868480725
86069,0.43859649122807015,0.6031746031746031,128,-152,0.4202758357883012,0.5797241642116988,home,TEX,under,8,0.5238095238095238,-110,0.5011337868480725,TEX,SEA,2022 REG,9,2,11,6,8,20,0,1,-4,4,1,1,0,0,0,0,0,0,0,0.4988662131519274,0.5011337868480725
86070,0.49019607843137253,0.5515695067264574,104,-123,0.4697227523736127,0.5302772476263873,away,LAA,over,9,0.5348837209302326,-115,0.5097020142727117,TEX,LAA,2022 REG,6,2,12,7,9,18,0,1,-5,5,1,1,0,0,0,0,0,0,0,0.5097020142727117,0.49029798572728833
86070,0.49019607843137253,0.5515695067264574,104,-123,0.4697227523736127,0.5302772476263873,home,TEX,under,9,0.5121951219512195,-105,0.49029798572728833,TEX,LAA,2022 REG,6,2,12,7,9,18,0,1,-5,5,1,1,0,0,0,0,0,0,0,0.5097020142727117,0.49029798572728833
86071,0.6894409937888198,0.3484320557491289,-222,187,0.6633297608775633,0.33667023912243665,away,CWS,over,9,0.5327102803738317,-114,0.5100625279371946,NYY,CWS,2022 REG,8,7,11,5,12,19,1,0,2,-2,1,1,1,1,1,0,0,0,0,0.5100625279371946,0.48993747206280536
86071,0.6894409937888198,0.3484320557491289,-222,187,0.6633297608775633,0.33667023912243665,home,NYY,under,9,0.5098039215686274,-104,0.48993747206280536,NYY,CWS,2022 REG,8,7,11,5,12,19,1,0,2,-2,1,1,1,1,1,0,0,0,0,0.5100625279371946,0.48993747206280536
86072,0.3921568627450981,0.6428571428571428,155,-180,0.37842588015598405,0.6215741198440159,away,MIL,over,9,0.5238095238095238,-110,0.4988662131519274,CHC,MIL,2022 REG,8,5,10,4,9,18,1,0,1,-1,1,1,1,1,0,0,0,0,0,0.4988662131519274,0.5011337868480725
86072,0.3921568627450981,0.6428571428571428,155,-180,0.37842588015598405,0.6215741198440159,home,CHC,under,9,0.5238095238095238,-110,0.5011337868480725,CHC,MIL,2022 REG,8,5,10,4,9,18,1,0,1,-1,1,1,1,1,0,0,0,0,0,0.4988662131519274,0.5011337868480725
86073,0.37878787878787884,0.6610169491525424,164,-195,0.3637102924468102,0.6362897075531898,away,TB,over,6.5,0.5098039215686274,-104,0.4870219861770517,MIA,TB,2022 REG,9,2,14,7,9,23,0,1,-5,5,1,1,0,0,0,0,0,0,0,0.4870219861770517,0.5129780138229483
86073,0.37878787878787884,0.6610169491525424,164,-195,0.3637102924468102,0.6362897075531898,home,MIA,under,6.5,0.5348837209302326,-115,0.5129780138229483,MIA,TB,2022 REG,9,2,14,7,9,23,0,1,-5,5,1,1,0,0,0,0,0,0,0,0.4870219861770517,0.5129780138229483
86074,0.4694835680751174,0.5708154506437768,113,-133,0.45056384097704505,0.549436159022955,away,SD,over,10.5,0.5348837209302326,-115,0.5097020142727117,CHC,SD,2022 REG,10,5,15,12,17,25,0,1,-7,7,1,1,1,1,1,0,0,0,0,0.5097020142727117,0.49029798572728833
86074,0.4694835680751174,0.5708154506437768,113,-133,0.45056384097704505,0.549436159022955,home,CHC,under,10.5,0.5121951219512195,-105,0.49029798572728833,CHC,SD,2022 REG,10,5,15,12,17,25,0,1,-7,7,1,1,1,1,1,0,0,0,0,0.5097020142727117,0.49029798572728833
86075,0.46511627906976744,0.574468085106383,115,-135,0.44670494689481377,0.5532950531051862,away,SEA,over,8.5,0.5192307692307692,-108,0.49688292476754015,OAK,SEA,2022 REG,7,2,12,8,10,19,0,1,-6,6,1,1,0,0,0,0,0,0,0,0.49688292476754015,0.5031170752324599
86075,0.46511627906976744,0.574468085106383,115,-135,0.44670494689481377,0.5532950531051862,home,OAK,under,8.5,0.5238095238095238,-110,0.5031170752324599,OAK,SEA,2022 REG,7,2,12,8,10,19,0,1,-6,6,1,1,0,0,0,0,0,0,0,0.49688292476754015,0.5031170752324599
86076,0.3412969283276451,0.6987951807228916,193,-232,0.32761361465851996,0.67238638534148,away,NYY,over,8,0.5348837209302326,-115,0.5097020142727117,OAK,NYY,2022 REG,6,3,2,2,5,8,1,0,1,-1,1,1,0,0,0,0,0,0,0,0.5097020142727117,0.49029798572728833
86076,0.3412969283276451,0.6987951807228916,193,-232,0.32761361465851996,0.67238638534148,home,OAK,under,8,0.5121951219512195,-105,0.49029798572728833,OAK,NYY,2022 REG,6,3,2,2,5,8,1,0,1,-1,1,1,0,0,0,0,0,0,0,0.5097020142727117,0.49029798572728833
86077,0.4081632653061224,0.626865671641791,145,-168,0.39386574002125985,0.6061342599787402,away,NYY,over,9,0.5098039215686274,-104,0.4870219861770517,LAA,NYY,2022 REG,7,4,9,7,11,16,0,1,-3,3,1,1,1,1,0,0,0,0,0,0.4870219861770517,0.5129780138229483
86077,0.4081632653061224,0.626865671641791,145,-168,0.39386574002125985,0.6061342599787402,home,LAA,under,9,0.5348837209302326,-115,0.5129780138229483,LAA,NYY,2022 REG,7,4,9,7,11,16,0,1,-3,3,1,1,1,1,0,0,0,0,0,0.4870219861770517,0.5129780138229483
86078,0.5983935742971888,0.4444444444444444,-149,125,0.5727595791465728,0.42724042085342717,away,CIN,over,7,0.5495495495495495,-122,0.5250401592387142,MIA,CIN,2022 REG,5,1,3,2,3,8,0,1,-1,1,1,0,0,0,0,0,0,0,0,0.5250401592387142,0.47495984076128583
86078,0.5983935742971888,0.4444444444444444,-149,125,0.5727595791465728,0.42724042085342717,home,MIA,under,7,0.49504950495049505,102,0.47495984076128583,MIA,CIN,2022 REG,5,1,3,2,3,8,0,1,-1,1,1,0,0,0,0,0,0,0,0,0.5250401592387142,0.47495984076128583
86079,0.5555555555555556,0.48780487804878053,-125,105,0.5314664257753688,0.46853357422463116,away,ARI,over,8,0.5073891625615764,-103,0.48484779035144243,SF,ARI,2022 REG,7,2,5,1,3,12,1,0,1,-1,1,0,0,0,0,0,0,0,0,0.48484779035144243,0.5151522096485576
86079,0.5555555555555556,0.48780487804878053,-125,105,0.5314664257753688,0.46853357422463116,home,SF,under,8,0.5370370370370371,-116,0.5151522096485576,SF,ARI,2022 REG,7,2,5,1,3,12,1,0,1,-1,1,0,0,0,0,0,0,0,0,0.48484779035144243,0.5151522096485576
86080,0.47619047619047616,0.5633187772925764,110,-129,0.45737654596045113,0.5426234540395489,away,NYY,over,7.5,0.5283018867924528,-112,0.5044173060022736,TB,NYY,2022 REG,6,2,6,7,9,12,0,1,-5,5,1,1,0,0,0,0,0,0,0,0.5044173060022736,0.49558269399772636
86080,0.47619047619047616,0.5633187772925764,110,-129,0.45737654596045113,0.5426234540395489,home,TB,under,7.5,0.5169082125603864,-107,0.49558269399772636,TB,NYY,2022 REG,6,2,6,7,9,12,0,1,-5,5,1,1,0,0,0,0,0,0,0,0.5044173060022736,0.49558269399772636
86081,0.6551724137931035,0.3802281368821293,-190,163,0.6319789495576061,0.36802105044239386,away,BOS,over,9.5,0.5121951219512195,-105,0.48808156828023186,TOR,BOS,2022 REG,10,7,8,2,9,18,1,0,5,-5,1,1,0,0,0,0,0,0,0,0.48808156828023186,0.5119184317197681
86081,0.6551724137931035,0.3802281368821293,-190,163,0.6319789495576061,0.36802105044239386,home,TOR,under,9.5,0.5348837209302326,-115,0.5119184317197681,TOR,BOS,2022 REG,10,7,8,2,9,18,1,0,5,-5,1,1,0,0,0,0,0,0,0,0.48808156828023186,0.5119184317197681
86082,0.6551724137931035,0.38759689922480617,-190,158,0.6271511397468869,0.37284886025311315,away,CIN,over,7.5,0.5412844036697247,-118,0.5189377998484975,NYY,CIN,2022 REG,6,6,11,7,13,17,0,1,-1,1,1,1,1,1,1,1,0,0,0,0.5189377998484975,0.4810622001515025
86082,0.6551724137931035,0.38759689922480617,-190,158,0.6271511397468869,0.37284886025311315,home,NYY,under,7.5,0.5,100,0.4810622001515025,NYY,CIN,2022 REG,6,6,11,7,13,17,0,1,-1,1,1,1,1,1,1,1,0,0,0,0.5189377998484975,0.4810622001515025
86083,0.6031746031746031,0.4366812227074236,-152,129,0.5791345812140156,0.4208654187859844,away,MIA,over,8.5,0.5169082125603864,-107,0.49353874091423283,CIN,MIA,2022 REG,8,5,7,3,8,15,1,0,2,-2,1,1,1,0,0,0,0,0,0,0.49353874091423283,0.5064612590857671
86083,0.6031746031746031,0.4366812227074236,-152,129,0.5791345812140156,0.4208654187859844,home,CIN,under,8.5,0.5283018867924528,-112,0.5064612590857671,CIN,MIA,2022 REG,8,5,7,3,8,15,1,0,2,-2,1,1,1,0,0,0,0,0,0,0.49353874091423283,0.5064612590857671
86084,0.5495495495495495,0.49019607843137253,-122,104,0.5277073575960698,0.4722926424039302,away,TOR,over,8.5,0.5215311004784688,-109,0.4978845547971712,LAA,TOR,2022 REG,12,10,13,11,21,25,0,1,-1,1,1,1,1,1,1,1,1,1,1,0.4978845547971712,0.5021154452028288
86084,0.5495495495495495,0.49019607843137253,-122,104,0.5277073575960698,0.4722926424039302,home,LAA,under,8.5,0.5238095238095238,-110,0.5021154452028288,LAA,TOR,2022 REG,12,10,13,11,21,25,0,1,-1,1,1,1,1,1,1,1,1,1,1,0.4978845547971712,0.5021154452028288
86085,0.4444444444444444,0.5983935742971888,125,-149,0.4254053250037185,0.5745946749962815,away,SD,over,12,0.5169082125603864,-107,0.49353874091423283,COL,SD,2022 REG,14,10,8,4,14,22,1,0,6,-6,1,1,1,1,0,0,0,0,0,0.49353874091423283,0.5064612590857671
86085,0.4444444444444444,0.5983935742971888,125,-149,0.4254053250037185,0.5745946749962815,home,COL,under,12,0.5283018867924528,-112,0.5064612590857671,COL,SD,2022 REG,14,10,8,4,14,22,1,0,6,-6,1,1,1,1,0,0,0,0,0,0.49353874091423283,0.5064612590857671
86086,0.7058823529411764,0.3333333333333333,-240,200,0.6782006920415226,0.32179930795847744,away,ARI,over,9,0.5348837209302326,-115,0.5097020142727117,LAD,ARI,2022 REG,9,7,6,6,13,15,1,0,1,-1,1,1,1,1,1,1,0,0,0,0.5097020142727117,0.49029798572728833
86086,0.7058823529411764,0.3333333333333333,-240,200,0.6782006920415226,0.32179930795847744,home,LAD,under,9,0.5121951219512195,-105,0.49029798572728833,LAD,ARI,2022 REG,9,7,6,6,13,15,1,0,1,-1,1,1,1,1,1,1,0,0,0,0.5097020142727117,0.49029798572728833
86087,0.5555555555555556,0.48780487804878053,-125,105,0.5314664257753688,0.46853357422463116,away,COL,over,7.5,0.5348837209302326,-115,0.5097020142727117,MIA,COL,2022 REG,13,9,13,8,17,26,1,0,1,-1,1,1,1,1,1,1,1,1,0,0.5097020142727117,0.49029798572728833
86087,0.5555555555555556,0.48780487804878053,-125,105,0.5314664257753688,0.46853357422463116,home,MIA,under,7.5,0.5121951219512195,-105,0.49029798572728833,MIA,COL,2022 REG,13,9,13,8,17,26,1,0,1,-1,1,1,1,1,1,1,1,1,0,0.5097020142727117,0.49029798572728833
86088,0.6254681647940076,0.4132231404958678,-167,142,0.6012679850808645,0.39873201491913546,away,SEA,over,8.5,0.5238095238095238,-110,0.4988662131519274,NYY,SEA,2022 REG,10,6,8,8,14,18,0,1,-2,2,1,1,1,1,1,1,0,0,0,0.4988662131519274,0.5011337868480725
86088,0.6254681647940076,0.4132231404958678,-167,142,0.6012679850808645,0.39873201491913546,home,NYY,under,8.5,0.5238095238095238,-110,0.5011337868480725,NYY,SEA,2022 REG,10,6,8,8,14,18,0,1,-2,2,1,1,1,1,1,1,0,0,0,0.4988662131519274,0.5011337868480725
86089,0.7333333333333333,0.3105590062111801,-275,222,0.7011456176673567,0.2988543823326433,away,WSH,over,9,0.5121951219512195,-105,0.48808156828023186,PHI,WSH,2022 REG,13,11,13,5,16,26,1,0,6,-6,1,1,1,1,1,0,0,0,0,0.48808156828023186,0.5119184317197681
86089,0.7333333333333333,0.3105590062111801,-275,222,0.7011456176673567,0.2988543823326433,home,PHI,under,9,0.5348837209302326,-115,0.5119184317197681,PHI,WSH,2022 REG,13,11,13,5,16,26,1,0,6,-6,1,1,1,1,1,0,0,0,0,0.48808156828023186,0.5119184317197681
86091,0.601593625498008,0.4347826086956522,-151,130,0.5797099148874794,0.42029008511252064,away,ARI,over,7,0.5238095238095238,-110,0.4988662131519274,SF,ARI,2022 REG,4,0,13,5,5,17,0,1,-5,5,0,0,0,0,0,0,0,0,0,0.4988662131519274,0.5011337868480725
86091,0.601593625498008,0.4347826086956522,-151,130,0.5797099148874794,0.42029008511252064,home,SF,under,7,0.5238095238095238,-110,0.5011337868480725,SF,ARI,2022 REG,4,0,13,5,5,17,0,1,-5,5,0,0,0,0,0,0,0,0,0,0.4988662131519274,0.5011337868480725
86092,0.6515679442508712,0.3846153846153846,-187,160,0.6279920470453316,0.3720079529546684,away,OAK,over,8.5,0.5073891625615764,-103,0.4837652908580103,PHI,OAK,2022 REG,11,9,6,5,14,17,1,0,4,-4,1,1,1,1,1,0,0,0,0,0.4837652908580103,0.5162347091419897
86092,0.6515679442508712,0.3846153846153846,-187,160,0.6279920470453316,0.3720079529546684,home,PHI,under,8.5,0.5391705069124424,-117,0.5162347091419897,PHI,OAK,2022 REG,11,9,6,5,14,17,1,0,4,-4,1,1,1,1,1,0,0,0,0,0.4837652908580103,0.5162347091419897
86094,0.5348837209302326,0.5098039215686274,-115,-104,0.5109810284308424,0.48901897156915763,away,MIL,over,7.5,0.5391705069124424,-117,0.5140669063204599,SD,MIL,2022 REG,9,3,8,2,5,17,1,0,1,-1,1,1,0,0,0,0,0,0,0,0.5140669063204599,0.4859330936795401
86094,0.5348837209302326,0.5098039215686274,-115,-104,0.5109810284308424,0.48901897156915763,home,SD,under,7.5,0.5073891625615764,-103,0.4859330936795401,SD,MIL,2022 REG,9,3,8,2,5,17,1,0,1,-1,1,1,0,0,0,0,0,0,0,0.5140669063204599,0.4859330936795401
86095,0.6825396825396826,0.35714285714285715,-215,180,0.6554547745023935,0.34454522549760647,away,CLE,over,7,0.5391705069124424,-117,0.5140669063204599,NYY,CLE,2022 REG,13,10,6,2,12,19,1,0,8,-8,1,1,0,0,0,0,0,0,0,0.5140669063204599,0.4859330936795401
86095,0.6825396825396826,0.35714285714285715,-215,180,0.6554547745023935,0.34454522549760647,home,NYY,under,7,0.5073891625615764,-103,0.4859330936795401,NYY,CLE,2022 REG,13,10,6,2,12,19,1,0,8,-8,1,1,0,0,0,0,0,0,0,0.5140669063204599,0.4859330936795401
86096,0.6875,0.35211267605633806,-220,184,0.6602662852112676,0.3397337147887324,away,MIN,over,9.5,0.5169082125603864,-107,0.49353874091423283,TOR,MIN,2022 REG,4,3,12,9,12,16,0,1,-6,6,1,1,1,0,0,0,0,0,0,0.49353874091423283,0.5064612590857671
86096,0.6875,0.35211267605633806,-220,184,0.6602662852112676,0.3397337147887324,home,TOR,under,9.5,0.5283018867924528,-112,0.5064612590857671,TOR,MIN,2022 REG,4,3,12,9,12,16,0,1,-6,6,1,1,1,0,0,0,0,0,0,0.49353874091423283,0.5064612590857671
86097,0.5652173913043479,0.4716981132075471,-130,112,0.5443521061454507,0.4556478938545493,away,KC,over,7.5,0.5098039215686274,-104,0.48592421718142587,DET,KC,2022 REG,12,10,9,3,13,21,1,0,7,-7,1,1,1,0,0,0,0,0,0,0.48592421718142587,0.5140757828185741
86097,0.5652173913043479,0.4716981132075471,-130,112,0.5443521061454507,0.4556478938545493,home,DET,under,7.5,0.5370370370370371,-116,0.5140757828185741,DET,KC,2022 REG,12,10,9,3,13,21,1,0,7,-7,1,1,1,0,0,0,0,0,0,0.48592421718142587,0.5140757828185741
86098,0.6666666666666666,0.37037037037037035,-200,170,0.6419753086419753,0.3580246913580247,away,CIN,over,8.5,0.5454545454545454,-120,0.5206611570247933,LAD,CIN,2022 REG,10,9,4,1,10,14,1,0,8,-8,1,0,0,0,0,0,0,0,0,0.5206611570247933,0.4793388429752067
86098,0.6666666666666666,0.37037037037037035,-200,170,0.6419753086419753,0.3580246913580247,home,LAD,under,8.5,0.5,100,0.4793388429752067,LAD,CIN,2022 REG,10,9,4,1,10,14,1,0,8,-8,1,0,0,0,0,0,0,0,0,0.5206611570247933,0.4793388429752067
86099,0.7058823529411764,0.33444816053511706,-240,199,0.6774137551932046,0.32258624480679543,away,COL,over,9,0.504950495049505,-102,0.47949844489399435,SF,COL,2022 REG,7,2,6,1,3,13,1,0,1,-1,1,0,0,0,0,0,0,0,0,0.47949844489399435,0.5205015551060057
86099,0.7058823529411764,0.33444816053511706,-240,199,0.6774137551932046,0.32258624480679543,home,SF,under,9,0.5454545454545454,-120,0.5205015551060057,SF,COL,2022 REG,7,2,6,1,3,13,1,0,1,-1,1,0,0,0,0,0,0,0,0,0.47949844489399435,0.5205015551060057
86101,0.47619047619047616,0.574468085106383,110,-135,0.4520673517634004,0.5479326482365996,away,MIN,over,8,0.5121951219512195,-105,0.48919479393107135,KC,MIN,2022 REG,3,0,8,1,1,11,0,1,-1,1,0,0,0,0,0,0,0,0,0,0.48919479393107135,0.5108052060689287
86101,0.47619047619047616,0.574468085106383,110,-135,0.4520673517634004,0.5479326482365996,home,KC,under,8,0.5327102803738317,-114,0.5108052060689287,KC,MIN,2022 REG,3,0,8,1,1,11,0,1,-1,1,0,0,0,0,0,0,0,0,0,0.48919479393107135,0.5108052060689287
86102,0.6453900709219857,0.39840637450199207,-182,151,0.6171242799036738,0.3828757200963262,away,OAK,over,8.5,0.5283018867924528,-112,0.5044173060022736,TEX,OAK,2022 REG,9,10,12,8,18,21,1,0,2,-2,1,1,1,1,1,1,1,1,0,0.5044173060022736,0.49558269399772636
86102,0.6453900709219857,0.39840637450199207,-182,151,0.6171242799036738,0.3828757200963262,home,TEX,under,8.5,0.5169082125603864,-107,0.49558269399772636,TEX,OAK,2022 REG,9,10,12,8,18,21,1,0,2,-2,1,1,1,1,1,1,1,1,0,0.5044173060022736,0.49558269399772636
86103,0.6240601503759399,0.4166666666666667,-166,140,0.5986441668079975,0.4013558331920025,away,CWS,over,7.5,0.5348837209302326,-115,0.5097020142727117,TOR,CWS,2022 REG,12,6,13,5,11,25,1,0,1,-1,1,1,1,1,1,0,0,0,0,0.5097020142727117,0.49029798572728833
86103,0.6240601503759399,0.4166666666666667,-166,140,0.5986441668079975,0.4013558331920025,home,TOR,under,7.5,0.5121951219512195,-105,0.49029798572728833,TOR,CWS,2022 REG,12,6,13,5,11,25,1,0,1,-1,1,1,1,1,1,0,0,0,0,0.5097020142727117,0.49029798572728833
86104,0.4854368932038835,0.5555555555555556,106,-125,0.465537646233282,0.534462353766718,away,NYM,over,10,0.5283018867924528,-112,0.5044173060022736,COL,NYM,2022 REG,9,1,13,5,6,22,0,1,-4,4,1,0,0,0,0,0,0,0,0,0.5044173060022736,0.49558269399772636
86104,0.4854368932038835,0.5555555555555556,106,-125,0.465537646233282,0.534462353766718,home,COL,under,10,0.5169082125603864,-107,0.49558269399772636,COL,NYM,2022 REG,9,1,13,5,6,22,0,1,-4,4,1,0,0,0,0,0,0,0,0,0.5044173060022736,0.49558269399772636
86105,0.5215311004784688,0.5192307692307692,-109,-108,0.50027251771145,0.49972748228855,away,BOS,over,7.5,0.5169082125603864,-107,0.49353874091423283,TB,BOS,2022 REG,9,4,7,3,7,16,1,0,1,-1,1,1,1,0,0,0,0,0,0,0.49353874091423283,0.5064612590857671
86105,0.5215311004784688,0.5192307692307692,-109,-108,0.50027251771145,0.49972748228855,home,TB,under,7.5,0.5283018867924528,-112,0.5064612590857671,TB,BOS,2022 REG,9,4,7,3,7,16,1,0,1,-1,1,1,1,0,0,0,0,0,0,0.49353874091423283,0.5064612590857671
86106,0.6226415094339623,0.4166666666666667,-165,140,0.5981666073335706,0.40183339266642937,away,PIT,over,8,0.5169082125603864,-107,0.49353874091423283,MIA,PIT,2022 REG,5,2,7,3,5,12,0,1,-1,1,1,1,0,0,0,0,0,0,0,0.49353874091423283,0.5064612590857671
86106,0.6226415094339623,0.4166666666666667,-165,140,0.5981666073335706,0.40183339266642937,home,MIA,under,8,0.5283018867924528,-112,0.5064612590857671,MIA,PIT,2022 REG,5,2,7,3,5,12,0,1,-1,1,1,1,0,0,0,0,0,0,0,0.49353874091423283,0.5064612590857671
86107,0.4444444444444444,0.6031746031746031,125,-152,0.4232804232804233,0.5767195767195767,away,MIL,over,9,0.5327102803738317,-114,0.508788710910954,BAL,MIL,2022 REG,6,2,6,0,2,12,1,0,2,-2,0,0,0,0,0,0,0,0,0,0.508788710910954,0.491211289089046
86107,0.4444444444444444,0.6031746031746031,125,-152,0.4232804232804233,0.5767195767195767,home,BAL,under,9,0.5121951219512195,-105,0.491211289089046,BAL,MIL,2022 REG,6,2,6,0,2,12,1,0,2,-2,0,0,0,0,0,0,0,0,0,0.508788710910954,0.491211289089046
86108,0.4926108374384236,0.5475113122171946,103,-121,0.47284623169673967,0.5271537683032603,away,NYM,over,6.5,0.504950495049505,-102,0.48054649490447493,MIA,NYM,2022 REG,7,4,11,6,10,18,0,1,-2,2,1,1,1,1,0,0,0,0,0,0.48054649490447493,0.5194535050955251
86108,0.4926108374384236,0.5475113122171946,103,-121,0.47284623169673967,0.5271537683032603,home,MIA,under,6.5,0.5433789954337899,-119,0.5194535050955251,MIA,NYM,2022 REG,7,4,11,6,10,18,0,1,-2,2,1,1,1,1,0,0,0,0,0,0.48054649490447493,0.5194535050955251
86109,0.47846889952153115,0.5575221238938054,109,-126,0.46124831415534145,0.5387516858446586,away,BAL,over,10,0.5348837209302326,-115,0.5097020142727117,CIN,BAL,2022 REG,7,2,9,6,8,16,0,1,-4,4,1,1,0,0,0,0,0,0,0,0.5097020142727117,0.49029798572728833
86109,0.47846889952153115,0.5575221238938054,109,-126,0.46124831415534145,0.5387516858446586,home,CIN,under,10,0.5121951219512195,-105,0.49029798572728833,CIN,BAL,2022 REG,7,2,9,6,8,16,0,1,-4,4,1,1,0,0,0,0,0,0,0,0.5097020142727117,0.49029798572728833
86110,0.5614035087719298,0.47846889952153115,-128,109,0.5390189988527938,0.4609810011472062,away,MIL,over,7.5,0.5348837209302326,-115,0.5097020142727117,TB,MIL,2022 REG,7,3,7,5,8,14,0,1,-2,2,1,1,1,0,0,0,0,0,0,0.5097020142727117,0.49029798572728833
86110,0.5614035087719298,0.47846889952153115,-128,109,0.5390189988527938,0.4609810011472062,home,TB,under,7.5,0.5121951219512195,-105,0.49029798572728833,TB,MIL,2022 REG,7,3,7,5,8,14,0,1,-2,2,1,1,1,0,0,0,0,0,0,0.5097020142727117,0.49029798572728833
86111,0.5815899581589958,0.45454545454545453,-139,120,0.5605739649961564,0.4394260350038436,away,SEA,over,7.5,0.5348837209302326,-115,0.5109810284308424,TB,SEA,2022 REG,7,2,6,1,3,13,1,0,1,-1,1,0,0,0,0,0,0,0,0,0.5109810284308424,0.48901897156915763
86111,0.5815899581589958,0.45454545454545453,-139,120,0.5605739649961564,0.4394260350038436,home,TB,under,7.5,0.5098039215686274,-104,0.48901897156915763,TB,SEA,2022 REG,7,2,6,1,3,13,1,0,1,-1,1,0,0,0,0,0,0,0,0,0.5109810284308424,0.48901897156915763
86112,0.5495495495495495,0.4926108374384236,-122,103,0.5263803278714742,0.47361967212852585,away,BAL,over,7.5,0.49019607843137253,104,0.46874141813588177,TB,BAL,2022 REG,8,5,10,4,9,18,1,0,1,-1,1,1,1,1,0,0,0,0,0,0.46874141813588177,0.5312585818641182
86112,0.5495495495495495,0.4926108374384236,-122,103,0.5263803278714742,0.47361967212852585,home,TB,under,7.5,0.5535714285714286,-124,0.5312585818641182,TB,BAL,2022 REG,8,5,10,4,9,18,1,0,1,-1,1,1,1,1,0,0,0,0,0,0.46874141813588177,0.5312585818641182
86113,0.5798319327731092,0.45454545454545453,-138,120,0.5598988258404966,0.44010117415950345,away,CIN,over,8,0.5348837209302326,-115,0.5109810284308424,CHC,CIN,2022 REG,7,3,9,4,7,16,0,1,-1,1,1,1,1,0,0,0,0,0,0,0.5109810284308424,0.48901897156915763
86113,0.5798319327731092,0.45454545454545453,-138,120,0.5598988258404966,0.44010117415950345,home,CHC,under,8,0.5098039215686274,-104,0.48901897156915763,CHC,CIN,2022 REG,7,3,9,4,7,16,0,1,-1,1,1,1,1,0,0,0,0,0,0,0.5109810284308424,0.48901897156915763
86115,0.5833333333333333,0.45454545454545453,-140,120,0.5612373737373737,0.4387626262626263,away,BOS,over,9.5,0.49504950495049505,102,0.47499799484898986,NYY,BOS,2022 REG,11,3,5,4,7,16,0,1,-1,1,1,1,1,0,0,0,0,0,0,0.47499799484898986,0.5250020051510101
86115,0.5833333333333333,0.45454545454545453,-140,120,0.5612373737373737,0.4387626262626263,home,NYY,under,9.5,0.5454545454545454,-120,0.5250020051510101,NYY,BOS,2022 REG,11,3,5,4,7,16,0,1,-1,1,1,1,1,0,0,0,0,0,0,0.47499799484898986,0.5250020051510101
86116,0.7032640949554896,0.33783783783783783,-237,196,0.6743585813886689,0.3256414186113311,away,WSH,over,13.5,0.5121951219512195,-105,0.4774935554233591,MIL,WSH,2022 REG,8,2,14,8,10,22,0,1,-6,6,1,1,0,0,0,0,0,0,0,0.4774935554233591,0.522506444576641
86116,0.7032640949554896,0.33783783783783783,-237,196,0.6743585813886689,0.3256414186113311,home,MIL,under,13.5,0.5555555555555556,-125,0.522506444576641,MIL,WSH,2022 REG,8,2,14,8,10,22,0,1,-6,6,1,1,0,0,0,0,0,0,0,0.4774935554233591,0.522506444576641
86117,0.5780590717299579,0.4608294930875576,-137,117,0.5555791840506346,0.44442081594936544,away,STL,over,8.5,0.5412844036697247,-118,0.5136310900085983,MIL,STL,2022 REG,7,6,5,5,11,12,1,0,1,-1,1,1,1,1,1,0,0,0,0,0.5136310900085983,0.4863689099914017
86117,0.5780590717299579,0.4608294930875576,-137,117,0.5555791840506346,0.44442081594936544,home,MIL,under,8.5,0.5098039215686274,-104,0.4863689099914017,MIL,STL,2022 REG,7,6,5,5,11,12,1,0,1,-1,1,1,1,1,1,0,0,0,0,0.5136310900085983,0.4863689099914017
86118,0.35714285714285715,0.6794871794871794,180,-212,0.3440607012035584,0.6559392987964416,away,LAD,over,11.5,0.5121951219512195,-105,0.48919479393107135,COL,LAD,2022 REG,10,4,11,8,12,21,0,1,-4,4,1,1,1,1,0,0,0,0,0,0.48919479393107135,0.5108052060689287
86118,0.35714285714285715,0.6794871794871794,180,-212,0.3440607012035584,0.6559392987964416,home,COL,under,11.5,0.5327102803738317,-114,0.5108052060689287,COL,LAD,2022 REG,10,4,11,8,12,21,0,1,-4,4,1,1,1,1,0,0,0,0,0,0.48919479393107135,0.5108052060689287
86119,0.7058823529411764,0.3436426116838488,-240,191,0.6709235543823352,0.3290764456176648,away,WSH,over,9.5,0.5121951219512195,-105,0.48808156828023186,ATL,WSH,2022 REG,9,4,12,3,7,21,1,0,1,-1,1,1,1,0,0,0,0,0,0,0.48808156828023186,0.5119184317197681
86119,0.7058823529411764,0.3436426116838488,-240,191,0.6709235543823352,0.3290764456176648,home,ATL,under,9.5,0.5348837209302326,-115,0.5119184317197681,ATL,WSH,2022 REG,9,4,12,3,7,21,1,0,1,-1,1,1,1,0,0,0,0,0,0,0.48808156828023186,0.5119184317197681
86120,0.4132231404958678,0.6254681647940076,142,-167,0.3972349978141011,0.6027650021858989,away,NYY,over,8.5,0.5454545454545454,-120,0.5206611570247933,MIN,NYY,2022 REG,12,4,14,10,14,26,0,1,-6,6,1,1,1,1,0,0,0,0,0,0.5206611570247933,0.4793388429752067
86120,0.4132231404958678,0.6254681647940076,142,-167,0.3972349978141011,0.6027650021858989,home,MIN,under,8.5,0.5,100,0.4793388429752067,MIN,NYY,2022 REG,12,4,14,10,14,26,0,1,-6,6,1,1,1,1,0,0,0,0,0,0.5206611570247933,0.4793388429752067
86121,0.504950495049505,0.5370370370370371,-102,-116,0.4837488699364985,0.5162511300635015,away,MIN,over,9,0.5454545454545454,-120,0.5206611570247933,KC,MIN,2022 REG,11,5,11,4,9,22,1,0,1,-1,1,1,1,1,0,0,0,0,0,0.5206611570247933,0.4793388429752067
86121,0.504950495049505,0.5370370370370371,-102,-116,0.4837488699364985,0.5162511300635015,home,KC,under,9,0.5,100,0.4793388429752067,KC,MIN,2022 REG,11,5,11,4,9,22,1,0,1,-1,1,1,1,1,0,0,0,0,0,0.5206611570247933,0.4793388429752067
86122,0.42194092827004215,0.6168582375478928,137,-161,0.4055699722287194,0.5944300277712806,away,MIN,over,8,0.5238095238095238,-110,0.4988662131519274,BAL,MIN,2022 REG,11,5,9,3,8,20,1,0,2,-2,1,1,1,0,0,0,0,0,0,0.4988662131519274,0.5011337868480725
86122,0.42194092827004215,0.6168582375478928,137,-161,0.4055699722287194,0.5944300277712806,home,BAL,under,8,0.5238095238095238,-110,0.5011337868480725,BAL,MIN,2022 REG,11,5,9,3,8,20,1,0,2,-2,1,1,1,0,0,0,0,0,0,0.4988662131519274,0.5011337868480725
86123,0.4347826086956522,0.5983935742971888,130,-149,0.4203581813074605,0.5796418186925395,away,HOU,over,8,0.5260663507109005,-111,0.5010269332605688,CWS,HOU,2022 REG,8,2,5,3,5,13,0,1,-1,1,1,1,0,0,0,0,0,0,0,0.5010269332605688,0.4989730667394312
86123,0.4347826086956522,0.5983935742971888,130,-149,0.4203581813074605,0.5796418186925395,home,CWS,under,8,0.5215311004784688,-109,0.4989730667394312,CWS,HOU,2022 REG,8,2,5,3,5,13,0,1,-1,1,1,1,0,0,0,0,0,0,0,0.5010269332605688,0.4989730667394312
86124,0.6363636363636364,0.4081632653061224,-175,145,0.6080283353010626,0.3919716646989374,away,CLE,over,7.5,0.5192307692307692,-108,0.49688292476754015,LAD,CLE,2022 REG,8,3,11,5,8,19,0,1,-2,2,1,1,1,0,0,0,0,0,0,0.49688292476754015,0.5031170752324599
86124,0.6363636363636364,0.4081632653061224,-175,145,0.6080283353010626,0.3919716646989374,home,LAD,under,7.5,0.5238095238095238,-110,0.5031170752324599,LAD,CLE,2022 REG,8,3,11,5,8,19,0,1,-2,2,1,1,1,0,0,0,0,0,0,0.49688292476754015,0.5031170752324599
86125,0.6240601503759399,0.41493775933609955,-166,141,0.5997231089766972,0.40027689102330277,away,DET,over,8.5,0.5238095238095238,-110,0.5012646084074657,TEX,DET,2022 REG,10,8,13,9,17,23,0,1,-1,1,1,1,1,1,1,1,1,1,0,0.5012646084074657,0.4987353915925343
86125,0.6240601503759399,0.41493775933609955,-166,141,0.5997231089766972,0.40027689102330277,home,TEX,under,8.5,0.5192307692307692,-108,0.4987353915925343,TEX,DET,2022 REG,10,8,13,9,17,23,0,1,-1,1,1,1,1,1,1,1,1,1,0,0.5012646084074657,0.4987353915925343
86126,0.5934959349593496,0.4444444444444444,-146,125,0.5709784740123824,0.42902152598761756,away,COL,over,9.5,0.5215311004784688,-109,0.4978845547971712,CHC,COL,2022 REG,9,1,5,3,4,14,0,1,-2,2,1,0,0,0,0,0,0,0,0,0.4978845547971712,0.5021154452028288
86126,0.5934959349593496,0.4444444444444444,-146,125,0.5709784740123824,0.42902152598761756,home,CHC,under,9.5,0.5238095238095238,-110,0.5021154452028288,CHC,COL,2022 REG,9,1,5,3,4,14,0,1,-2,2,1,0,0,0,0,0,0,0,0,0.4978845547971712,0.5021154452028288
86127,0.5535714285714286,0.49019607843137253,-124,104,0.5293429871948779,0.47065701280512207,away,MIA,over,7.5,0.5121951219512195,-105,0.48919479393107135,PHI,MIA,2022 REG,8,4,9,3,7,17,1,0,1,-1,1,1,1,0,0,0,0,0,0,0.48919479393107135,0.5108052060689287
86127,0.5535714285714286,0.49019607843137253,-124,104,0.5293429871948779,0.47065701280512207,home,PHI,under,7.5,0.5327102803738317,-114,0.5108052060689287,PHI,MIA,2022 REG,8,4,9,3,7,17,1,0,1,-1,1,1,1,0,0,0,0,0,0,0.48919479393107135,0.5108052060689287
86128,0.46511627906976744,0.574468085106383,115,-135,0.44670494689481377,0.5532950531051862,away,LAD,over,8.5,0.5454545454545454,-120,0.5206611570247933,CWS,LAD,2022 REG,10,9,12,11,20,22,0,1,-2,2,1,1,1,1,1,1,1,1,1,0.5206611570247933,0.4793388429752067
86128,0.46511627906976744,0.574468085106383,115,-135,0.44670494689481377,0.5532950531051862,home,CWS,under,8.5,0.5,100,0.4793388429752067,CWS,LAD,2022 REG,10,9,12,11,20,22,0,1,-2,2,1,1,1,1,1,1,1,1,1,0.5206611570247933,0.4793388429752067
86129,0.5867768595041323,0.45248868778280543,-142,121,0.563736744980392,0.43626325501960805,away,BOS,over,8.5,0.5348837209302326,-115,0.5109810284308424,TOR,BOS,2022 REG,5,1,13,7,8,18,0,1,-6,6,1,0,0,0,0,0,0,0,0,0.5109810284308424,0.48901897156915763
86129,0.5867768595041323,0.45248868778280543,-142,121,0.563736744980392,0.43626325501960805,home,TOR,under,8.5,0.5098039215686274,-104,0.48901897156915763,TOR,BOS,2022 REG,5,1,13,7,8,18,0,1,-6,6,1,0,0,0,0,0,0,0,0,0.5109810284308424,0.48901897156915763
86130,0.5555555555555556,0.4854368932038835,-125,106,0.5327819729114227,0.4672180270885773,away,BAL,over,9,0.49751243781094534,101,0.476135829221149,TEX,BAL,2022 REG,10,2,9,8,10,19,0,1,-6,6,1,1,0,0,0,0,0,0,0,0.476135829221149,0.523864170778851
86130,0.5555555555555556,0.4854368932038835,-125,106,0.5327819729114227,0.4672180270885773,home,TEX,under,9,0.5454545454545454,-120,0.523864170778851,TEX,BAL,2022 REG,10,2,9,8,10,19,0,1,-6,6,1,1,0,0,0,0,0,0,0,0.476135829221149,0.523864170778851
86131,0.37735849056603776,0.6575342465753424,165,-192,0.36419141994664905,0.635808580053351,away,HOU,over,7.5,0.5238095238095238,-110,0.4988662131519274,BAL,HOU,2022 REG,17,10,12,11,21,29,0,1,-1,1,1,1,1,1,1,1,1,1,1,0.4988662131519274,0.5011337868480725
86131,0.37735849056603776,0.6575342465753424,165,-192,0.36419141994664905,0.635808580053351,home,BAL,under,7.5,0.5238095238095238,-110,0.5011337868480725,BAL,HOU,2022 REG,17,10,12,11,21,29,0,1,-1,1,1,1,1,1,1,1,1,1,1,0.4988662131519274,0.5011337868480725
86132,0.5495495495495495,0.4854368932038835,-122,106,0.5303227656940593,0.46967723430594066,away,COL,over,9.5,0.5348837209302326,-115,0.5097020142727117,CHC,COL,2022 REG,6,3,6,4,7,12,0,1,-1,1,1,1,1,0,0,0,0,0,0,0.5097020142727117,0.49029798572728833
86132,0.5495495495495495,0.4854368932038835,-122,106,0.5303227656940593,0.46967723430594066,home,CHC,under,9.5,0.5121951219512195,-105,0.49029798572728833,CHC,COL,2022 REG,6,3,6,4,7,12,0,1,-1,1,1,1,1,0,0,0,0,0,0,0.5097020142727117,0.49029798572728833
86133,0.41493775933609955,0.626865671641791,141,-168,0.39759193735357234,0.6024080626464277,away,SD,over,11,0.5327102803738317,-114,0.5050407492760537,COL,SD,2022 REG,8,4,6,3,7,14,1,0,1,-1,1,1,1,0,0,0,0,0,0,0.5050407492760537,0.4949592507239463
86133,0.41493775933609955,0.626865671641791,141,-168,0.39759193735357234,0.6024080626464277,home,COL,under,11,0.5192307692307692,-108,0.4949592507239463,COL,SD,2022 REG,8,4,6,3,7,14,1,0,1,-1,1,1,1,0,0,0,0,0,0,0.5050407492760537,0.4949592507239463
86134,0.5555555555555556,0.48309178743961345,-125,107,0.5340848094471283,0.46591519055287167,away,ARI,over,7.5,0.5,100,0.4772727272727273,CHC,ARI,2022 REG,8,5,8,4,9,16,1,0,1,-1,1,1,1,1,0,0,0,0,0,0.4772727272727273,0.5227272727272727
86134,0.5555555555555556,0.48309178743961345,-125,107,0.5340848094471283,0.46591519055287167,home,CHC,under,7.5,0.5454545454545454,-120,0.5227272727272727,CHC,ARI,2022 REG,8,5,8,4,9,16,1,0,1,-1,1,1,1,1,0,0,0,0,0,0.4772727272727273,0.5227272727272727
86136,0.6551724137931035,0.38314176245210724,-190,161,0.6300700224600344,0.3699299775399656,away,KC,over,7,0.5412844036697247,-118,0.5162581740877563,CLE,KC,2022 REG,8,5,6,3,8,14,1,0,2,-2,1,1,1,0,0,0,0,0,0,0.5162581740877563,0.4837418259122437
86136,0.6551724137931035,0.38314176245210724,-190,161,0.6300700224600344,0.3699299775399656,home,CLE,under,7,0.504950495049505,-102,0.4837418259122437,CLE,KC,2022 REG,8,5,6,3,8,14,1,0,2,-2,1,1,1,0,0,0,0,0,0,0.5162581740877563,0.4837418259122437
86138,0.5370370370370371,0.504950495049505,-116,-102,0.514488177212783,0.48551182278721705,away,NYY,over,8.5,0.5348837209302326,-115,0.5097020142727117,STL,NYY,2022 REG,5,1,2,0,1,7,1,0,1,-1,0,0,0,0,0,0,0,0,0,0.5097020142727117,0.49029798572728833
86138,0.5370370370370371,0.504950495049505,-116,-102,0.514488177212783,0.48551182278721705,home,STL,under,8.5,0.5121951219512195,-105,0.49029798572728833,STL,NYY,2022 REG,5,1,2,0,1,7,1,0,1,-1,0,0,0,0,0,0,0,0,0,0.5097020142727117,0.49029798572728833
86139,0.6941896024464832,0.3448275862068966,-227,190,0.667104275766614,0.332895724233386,away,OAK,over,8.5,0.5192307692307692,-108,0.49455035168025013,BAL,OAK,2022 REG,11,8,8,1,9,19,1,0,7,-7,1,0,0,0,0,0,0,0,0,0.49455035168025013,0.5054496483197499
86139,0.6941896024464832,0.3448275862068966,-227,190,0.667104275766614,0.332895724233386,home,BAL,under,8.5,0.5283018867924528,-112,0.5054496483197499,BAL,OAK,2022 REG,11,8,8,1,9,19,1,0,7,-7,1,0,0,0,0,0,0,0,0,0.49455035168025013,0.5054496483197499
86140,0.4629629629629629,0.574468085106383,116,-135,0.44563377404196935,0.5543662259580306,away,SEA,over,7.5,0.5121951219512195,-105,0.48808156828023186,CLE,SEA,2022 REG,9,1,7,6,7,16,0,1,-5,5,1,0,0,0,0,0,0,0,0,0.48808156828023186,0.5119184317197681
86140,0.4629629629629629,0.574468085106383,116,-135,0.44563377404196935,0.5543662259580306,home,CLE,under,7.5,0.5348837209302326,-115,0.5119184317197681,CLE,SEA,2022 REG,9,1,7,6,7,16,0,1,-5,5,1,0,0,0,0,0,0,0,0,0.48808156828023186,0.5119184317197681
86141,0.7481108312342569,0.29673590504451036,-297,237,0.7145605020786049,0.2854394979213951,away,KC,over,9,0.5169082125603864,-107,0.49353874091423283,NYY,KC,2022 REG,8,8,7,2,10,15,1,0,6,-6,1,1,0,0,0,0,0,0,0,0.49353874091423283,0.5064612590857671
86141,0.7481108312342569,0.29673590504451036,-297,237,0.7145605020786049,0.2854394979213951,home,NYY,under,9,0.5283018867924528,-112,0.5064612590857671,NYY,KC,2022 REG,8,8,7,2,10,15,1,0,6,-6,1,1,0,0,0,0,0,0,0,0.49353874091423283,0.5064612590857671
86142,0.44052863436123346,0.6000000000000001,127,-150,0.42267461041355353,0.5773253895864465,away,TEX,over,8.5,0.5260663507109005,-111,0.5022370601254724,DET,TEX,2022 REG,8,7,5,3,10,13,1,0,4,-4,1,1,1,0,0,0,0,0,0,0.5022370601254724,0.4977629398745276
86142,0.44052863436123346,0.6000000000000001,127,-150,0.42267461041355353,0.5773253895864465,home,DET,under,8.5,0.5192307692307692,-108,0.4977629398745276,DET,TEX,2022 REG,8,7,5,3,10,13,1,0,4,-4,1,1,1,0,0,0,0,0,0,0.5022370601254724,0.4977629398745276
86143,0.5475113122171946,0.49504950495049505,-121,102,0.5242087833606768,0.4757912166393232,away,KC,over,8.5,0.5145631067961165,-106,0.49023796582517226,DET,KC,2022 REG,8,2,15,12,14,23,0,1,-10,10,1,1,0,0,0,0,0,0,0,0.49023796582517226,0.5097620341748277
86143,0.5475113122171946,0.49504950495049505,-121,102,0.5242087833606768,0.4757912166393232,home,DET,under,8.5,0.5327102803738317,-114,0.5097620341748277,DET,KC,2022 REG,8,2,15,12,14,23,0,1,-10,10,1,1,0,0,0,0,0,0,0,0.49023796582517226,0.5097620341748277
86144,0.5495495495495495,0.49019607843137253,-122,104,0.5277073575960698,0.4722926424039302,away,SF,over,6.5,0.5412844036697247,-118,0.5136310900085983,NYM,SF,2022 REG,8,3,2,1,4,10,1,0,2,-2,1,0,0,0,0,0,0,0,0,0.5136310900085983,0.4863689099914017
86144,0.5495495495495495,0.49019607843137253,-122,104,0.5277073575960698,0.4722926424039302,home,NYM,under,6.5,0.5098039215686274,-104,0.4863689099914017,NYM,SF,2022 REG,8,3,2,1,4,10,1,0,2,-2,1,0,0,0,0,0,0,0,0,0.5136310900085983,0.4863689099914017
86145,0.7762863534675616,0.26881720430107525,-347,272,0.7412730770789331,0.2587269229210669,away,KC,over,8,0.5238095238095238,-110,0.4988662131519274,TOR,KC,2022 REG,16,8,5,1,9,21,1,0,7,-7,1,0,0,0,0,0,0,0,0,0.4988662131519274,0.5011337868480725
86145,0.7762863534675616,0.26881720430107525,-347,272,0.7412730770789331,0.2587269229210669,home,TOR,under,8,0.5238095238095238,-110,0.5011337868480725,TOR,KC,2022 REG,16,8,5,1,9,21,1,0,7,-7,1,0,0,0,0,0,0,0,0,0.4988662131519274,0.5011337868480725
86146,0.4926108374384236,0.5495495495495495,103,-122,0.4718421738975501,0.5281578261024499,away,LAA,over,8.5,0.5348837209302326,-115,0.5097020142727117,TEX,LAA,2022 REG,5,2,13,5,7,18,0,1,-3,3,1,1,0,0,0,0,0,0,0,0.5097020142727117,0.49029798572728833
86146,0.4926108374384236,0.5495495495495495,103,-122,0.4718421738975501,0.5281578261024499,home,TEX,under,8.5,0.5121951219512195,-105,0.49029798572728833,TEX,LAA,2022 REG,5,2,13,5,7,18,0,1,-3,3,1,1,0,0,0,0,0,0,0,0.5097020142727117,0.49029798572728833
86147,0.6666666666666666,0.37735849056603776,-200,165,0.6373165618448637,0.36268343815513626,away,COL,over,7.5,0.5215311004784688,-109,0.49907282342437215,MIA,COL,2022 REG,11,7,6,4,11,17,1,0,3,-3,1,1,1,1,0,0,0,0,0,0.49907282342437215,0.5009271765756278
86147,0.6666666666666666,0.37735849056603776,-200,165,0.6373165618448637,0.36268343815513626,home,MIA,under,7.5,0.5215311004784688,-109,0.5009271765756278,MIA,COL,2022 REG,11,7,6,4,11,17,1,0,3,-3,1,1,1,1,0,0,0,0,0,0.49907282342437215,0.5009271765756278
86148,0.4347826086956522,0.607843137254902,130,-155,0.41624967567367205,0.583750324326328,away,CWS,over,7.5,0.5391705069124424,-117,0.5153817639191344,DET,CWS,2022 REG,6,3,6,2,5,12,1,0,1,-1,1,1,0,0,0,0,0,0,0,0.5153817639191344,0.4846182360808656
86148,0.4347826086956522,0.607843137254902,130,-155,0.41624967567367205,0.583750324326328,home,DET,under,7.5,0.504950495049505,-102,0.4846182360808656,DET,CWS,2022 REG,6,3,6,2,5,12,1,0,1,-1,1,1,0,0,0,0,0,0,0,0.5153817639191344,0.4846182360808656
86149,0.5555555555555556,0.48780487804878053,-125,105,0.5314664257753688,0.46853357422463116,away,CHC,over,10,0.5121951219512195,-105,0.48808156828023186,COL,CHC,2022 REG,11,6,13,5,11,24,1,0,1,-1,1,1,1,1,1,0,0,0,0,0.48808156828023186,0.5119184317197681
86149,0.5555555555555556,0.48780487804878053,-125,105,0.5314664257753688,0.46853357422463116,home,COL,under,10,0.5348837209302326,-115,0.5119184317197681,COL,CHC,2022 REG,11,6,13,5,11,24,1,0,1,-1,1,1,1,1,1,0,0,0,0,0.48808156828023186,0.5119184317197681
86150,0.5833333333333333,0.4587155963302753,-140,118,0.5588047910295616,0.4411952089704384,away,CHC,over,7.5,0.5073891625615764,-103,0.4826927225525911,SF,CHC,2022 REG,13,2,6,4,6,19,0,1,-2,2,1,1,0,0,0,0,0,0,0,0.4826927225525911,0.5173072774474089
86150,0.5833333333333333,0.4587155963302753,-140,118,0.5588047910295616,0.4411952089704384,home,SF,under,7.5,0.5412844036697247,-118,0.5173072774474089,SF,CHC,2022 REG,13,2,6,4,6,19,0,1,-2,2,1,1,0,0,0,0,0,0,0,0.4826927225525911,0.5173072774474089
86152,0.29411764705882354,0.7481108312342569,240,-297,0.2816975063843881,0.7183024936156119,away,SD,over,9,0.5145631067961165,-106,0.4913668392989033,WSH,SD,2022 REG,10,5,14,10,15,24,0,1,-5,5,1,1,1,1,1,0,0,0,0,0.4913668392989033,0.5086331607010968
86152,0.29411764705882354,0.7481108312342569,240,-297,0.2816975063843881,0.7183024936156119,home,WSH,under,9,0.5305164319248826,-113,0.5086331607010968,WSH,SD,2022 REG,10,5,14,10,15,24,0,1,-5,5,1,1,1,1,1,0,0,0,0,0.4913668392989033,0.5086331607010968
86153,0.5850622406639003,0.45248868778280543,-141,121,0.5630926103278608,0.43690738967213916,away,NYM,over,7,0.5348837209302326,-115,0.5097020142727117,MIA,NYM,2022 REG,11,3,6,5,8,17,0,1,-2,2,1,1,1,0,0,0,0,0,0,0.5097020142727117,0.49029798572728833
86153,0.5850622406639003,0.45248868778280543,-141,121,0.5630926103278608,0.43690738967213916,home,MIA,under,7,0.5121951219512195,-105,0.49029798572728833,MIA,NYM,2022 REG,11,3,6,5,8,17,0,1,-2,2,1,1,1,0,0,0,0,0,0,0.5097020142727117,0.49029798572728833
86154,0.6688741721854304,0.37453183520599254,-202,167,0.6398410149236177,0.36015898507638233,away,SF,over,7,0.5348837209302326,-115,0.5097020142727117,MIL,SF,2022 REG,5,2,6,4,6,11,0,1,-2,2,1,1,0,0,0,0,0,0,0,0.5097020142727117,0.49029798572728833
86154,0.6688741721854304,0.37453183520599254,-202,167,0.6398410149236177,0.36015898507638233,home,MIL,under,7,0.5121951219512195,-105,0.49029798572728833,MIL,SF,2022 REG,5,2,6,4,6,11,0,1,-2,2,1,1,0,0,0,0,0,0,0,0.5097020142727117,0.49029798572728833
86155,0.425531914893617,0.6124031007751938,135,-158,0.4093893550345486,0.5906106449654513,away,NYY,over,8.5,0.5215311004784688,-109,0.4955416477869355,STL,NYY,2022 REG,5,4,10,3,7,15,1,0,1,-1,1,1,1,0,0,0,0,0,0,0.4955416477869355,0.5044583522130646
86155,0.425531914893617,0.6124031007751938,135,-158,0.4093893550345486,0.5906106449654513,home,STL,under,8.5,0.5283018867924528,-112,0.5044583522130646,STL,NYY,2022 REG,5,4,10,3,7,15,1,0,1,-1,1,1,1,0,0,0,0,0,0,0.4955416477869355,0.5044583522130646
86156,0.6453900709219857,0.3891050583657587,-182,157,0.6231272569845053,0.37687274301549467,away,LAA,over,8,0.5283018867924528,-112,0.5044173060022736,PHI,LAA,2022 REG,7,7,7,2,9,14,1,0,5,-5,1,1,0,0,0,0,0,0,0,0.5044173060022736,0.49558269399772636
86156,0.6453900709219857,0.3891050583657587,-182,157,0.6231272569845053,0.37687274301549467,home,PHI,under,8,0.5169082125603864,-107,0.49558269399772636,PHI,LAA,2022 REG,7,7,7,2,9,14,1,0,5,-5,1,1,0,0,0,0,0,0,0,0.5044173060022736,0.49558269399772636
86157,0.7347480106100795,0.29850746268656714,-277,235,0.7103136177634717,0.2896863822365283,away,CIN,over,8.5,0.5121951219512195,-105,0.48808156828023186,STL,CIN,2022 REG,8,6,8,5,11,16,1,0,1,-1,1,1,1,1,1,0,0,0,0,0.48808156828023186,0.5119184317197681
86157,0.7347480106100795,0.29850746268656714,-277,235,0.7103136177634717,0.2896863822365283,home,STL,under,8.5,0.5348837209302326,-115,0.5119184317197681,STL,CIN,2022 REG,8,6,8,5,11,16,1,0,1,-1,1,1,1,1,1,0,0,0,0,0.48808156828023186,0.5119184317197681
86158,0.5535714285714286,0.48780487804878053,-124,105,0.53066668740667,0.46933331259333,away,WSH,over,9.5,0.49504950495049505,102,0.47499799484898986,PIT,WSH,2022 REG,14,9,8,4,13,22,1,0,5,-5,1,1,1,1,0,0,0,0,0,0.47499799484898986,0.5250020051510101
86158,0.5535714285714286,0.48780487804878053,-124,105,0.53066668740667,0.46933331259333,home,PIT,under,9.5,0.5454545454545454,-120,0.5250020051510101,PIT,WSH,2022 REG,14,9,8,4,13,22,1,0,5,-5,1,1,1,1,0,0,0,0,0,0.47499799484898986,0.5250020051510101
86159,0.4291845493562232,0.6047430830039526,133,-153,0.4146233337509975,0.5853766662490025,away,ATL,over,9,0.5454545454545454,-120,0.5220180091279142,ARI,ATL,2022 REG,3,0,12,6,6,15,0,1,-6,6,0,0,0,0,0,0,0,0,0,0.5220180091279142,0.4779819908720858
86159,0.4291845493562232,0.6047430830039526,133,-153,0.4146233337509975,0.5853766662490025,home,ARI,under,9,0.49751243781094534,101,0.4779819908720858,ARI,ATL,2022 REG,3,0,12,6,6,15,0,1,-6,6,0,0,0,0,0,0,0,0,0,0.5220180091279142,0.4779819908720858
86160,0.7237569060773481,0.31746031746031744,-262,215,0.6939256558926289,0.3060743441073711,away,WSH,over,9,0.5348837209302326,-115,0.5097020142727117,ATL,WSH,2022 REG,15,12,5,2,14,20,1,0,10,-10,1,1,0,0,0,0,0,0,0,0.5097020142727117,0.49029798572728833
86160,0.7237569060773481,0.31746031746031744,-262,215,0.6939256558926289,0.3060743441073711,home,ATL,under,9,0.5121951219512195,-105,0.49029798572728833,ATL,WSH,2022 REG,15,12,5,2,14,20,1,0,10,-10,1,1,0,0,0,0,0,0,0,0.5097020142727117,0.49029798572728833
86161,0.37735849056603776,0.6621621621621622,165,-196,0.36244503670633965,0.6375549632936603,away,NYM,over,8,0.5238095238095238,-110,0.4988662131519274,MIA,NYM,2022 REG,4,0,9,4,4,13,0,1,-4,4,0,0,0,0,0,0,0,0,0,0.4988662131519274,0.5011337868480725
86161,0.37735849056603776,0.6621621621621622,165,-196,0.36244503670633965,0.6375549632936603,home,MIA,under,8,0.5238095238095238,-110,0.5011337868480725,MIA,NYM,2022 REG,4,0,9,4,4,13,0,1,-4,4,0,0,0,0,0,0,0,0,0,0.4988662131519274,0.5011337868480725
86162,0.6000000000000001,0.44052863436123346,-150,127,0.57568281938326,0.42431718061673995,away,SD,over,7.5,0.5348837209302326,-115,0.5097020142727117,NYM,SD,2022 REG,8,1,4,2,3,12,0,1,-1,1,1,0,0,0,0,0,0,0,0,0.5097020142727117,0.49029798572728833
86162,0.6000000000000001,0.44052863436123346,-150,127,0.57568281938326,0.42431718061673995,home,NYM,under,7.5,0.5121951219512195,-105,0.49029798572728833,NYM,SD,2022 REG,8,1,4,2,3,12,0,1,-1,1,1,0,0,0,0,0,0,0,0,0.5097020142727117,0.49029798572728833
86163,0.6987951807228916,0.3412969283276451,-232,193,0.67077900813336,0.32922099186664,away,BAL,over,6.5,0.5348837209302326,-115,0.5097020142727117,NYY,BAL,2022 REG,14,8,3,0,8,17,1,0,8,-8,0,0,0,0,0,0,0,0,0,0.5097020142727117,0.49029798572728833
86163,0.6987951807228916,0.3412969283276451,-232,193,0.67077900813336,0.32922099186664,home,NYY,under,6.5,0.5121951219512195,-105,0.49029798572728833,NYY,BAL,2022 REG,14,8,3,0,8,17,1,0,8,-8,0,0,0,0,0,0,0,0,0,0.5097020142727117,0.49029798572728833
86164,0.6894409937888198,0.34965034965034963,-222,186,0.6624898191195787,0.3375101808804213,away,MIN,over,8,0.5215311004784688,-109,0.49670754937970685,MIL,MIN,2022 REG,8,10,7,4,14,15,1,0,6,-6,1,1,1,1,0,0,0,0,0,0.49670754937970685,0.5032924506202932
86164,0.6894409937888198,0.34965034965034963,-222,186,0.6624898191195787,0.3375101808804213,home,MIL,under,8,0.5260663507109005,-111,0.5032924506202932,MIL,MIN,2022 REG,8,10,7,4,14,15,1,0,6,-6,1,1,1,1,0,0,0,0,0,0.49670754937970685,0.5032924506202932
86165,0.3333333333333333,0.7101449275362319,200,-245,0.3188405797101449,0.6811594202898551,away,STL,over,9.5,0.5215311004784688,-109,0.4978845547971712,CIN,STL,2022 REG,14,3,8,5,8,22,0,1,-2,2,1,1,1,0,0,0,0,0,0,0.4978845547971712,0.5021154452028288
86165,0.3333333333333333,0.7101449275362319,200,-245,0.3188405797101449,0.6811594202898551,home,CIN,under,9.5,0.5238095238095238,-110,0.5021154452028288,CIN,STL,2022 REG,14,3,8,5,8,22,0,1,-2,2,1,1,1,0,0,0,0,0,0,0.4978845547971712,0.5021154452028288
86166,0.3472222222222222,0.6923076923076923,188,-225,0.3334965574548908,0.6665034425451092,away,LAD,over,9,0.504950495049505,-102,0.48160416005266615,ARI,LAD,2022 REG,5,0,7,6,6,12,0,1,-6,6,0,0,0,0,0,0,0,0,0,0.48160416005266615,0.5183958399473338
86166,0.3472222222222222,0.6923076923076923,188,-225,0.3334965574548908,0.6665034425451092,home,ARI,under,9,0.5412844036697247,-118,0.5183958399473338,ARI,LAD,2022 REG,5,0,7,6,6,12,0,1,-6,6,0,0,0,0,0,0,0,0,0,0.48160416005266615,0.5183958399473338
86167,0.35714285714285715,0.6774193548387096,180,-210,0.3447992100065833,0.6552007899934167,away,LAD,over,11.5,0.5,100,0.47935779816513757,COL,LAD,2022 REG,7,3,8,5,8,15,0,1,-2,2,1,1,1,0,0,0,0,0,0,0.47935779816513757,0.5206422018348624
86167,0.35714285714285715,0.6774193548387096,180,-210,0.3447992100065833,0.6552007899934167,home,COL,under,11.5,0.5412844036697247,-118,0.5206422018348624,COL,LAD,2022 REG,7,3,8,5,8,15,0,1,-2,2,1,1,1,0,0,0,0,0,0,0.47935779816513757,0.5206422018348624
86168,0.4739336492890995,0.5670995670995671,111,-131,0.4544866273039494,0.5455133726960506,away,HOU,over,7.5,0.5454545454545454,-120,0.5206611570247933,CLE,HOU,2022 REG,8,1,2,0,1,10,1,0,1,-1,0,0,0,0,0,0,0,0,0,0.5206611570247933,0.4793388429752067
86168,0.4739336492890995,0.5670995670995671,111,-131,0.4544866273039494,0.5455133726960506,home,CLE,under,7.5,0.5,100,0.4793388429752067,CLE,HOU,2022 REG,8,1,2,0,1,10,1,0,1,-1,0,0,0,0,0,0,0,0,0,0.5206611570247933,0.4793388429752067
86169,0.6226415094339623,0.4166666666666667,-165,140,0.5981666073335706,0.40183339266642937,away,LAA,over,7.5,0.5305164319248826,-113,0.5066009958897986,HOU,LAA,2022 REG,11,8,2,1,9,13,1,0,7,-7,1,0,0,0,0,0,0,0,0,0.5066009958897986,0.49339900411020143
86169,0.6226415094339623,0.4166666666666667,-165,140,0.5981666073335706,0.40183339266642937,home,HOU,under,7.5,0.5145631067961165,-106,0.49339900411020143,HOU,LAA,2022 REG,11,8,2,1,9,13,1,0,7,-7,1,0,0,0,0,0,0,0,0,0.5066009958897986,0.49339900411020143
86170,0.5689655172413793,0.46511627906976744,-132,115,0.5495741503746924,0.45042584962530763,away,TEX,over,7,0.5238095238095238,-110,0.5000596729920038,TB,TEX,2022 REG,7,5,6,1,6,13,1,0,4,-4,1,0,0,0,0,0,0,0,0,0.5000596729920038,0.4999403270079962
86170,0.5689655172413793,0.46511627906976744,-132,115,0.5495741503746924,0.45042584962530763,home,TB,under,7,0.5215311004784688,-109,0.4999403270079962,TB,TEX,2022 REG,7,5,6,1,6,13,1,0,4,-4,1,0,0,0,0,0,0,0,0,0.5000596729920038,0.4999403270079962
86171,0.45454545454545453,0.5833333333333333,120,-140,0.43732782369146006,0.5626721763085399,away,NYY,over,6.5,0.504950495049505,-102,0.47949844489399435,TB,NYY,2022 REG,3,2,7,4,6,10,0,1,-2,2,1,1,0,0,0,0,0,0,0,0.47949844489399435,0.5205015551060057
86171,0.45454545454545453,0.5833333333333333,120,-140,0.43732782369146006,0.5626721763085399,home,TB,under,6.5,0.5454545454545454,-120,0.5205015551060057,TB,NYY,2022 REG,3,2,7,4,6,10,0,1,-2,2,1,1,0,0,0,0,0,0,0,0.47949844489399435,0.5205015551060057
86172,0.35714285714285715,0.6825396825396826,180,-215,0.34297052154195007,0.6570294784580499,away,ATL,over,8.5,0.5260663507109005,-111,0.5022370601254724,WSH,ATL,2022 REG,5,3,6,2,5,11,1,0,1,-1,1,1,0,0,0,0,0,0,0,0.5022370601254724,0.4977629398745276
86172,0.35714285714285715,0.6825396825396826,180,-215,0.34297052154195007,0.6570294784580499,home,WSH,under,8.5,0.5192307692307692,-108,0.4977629398745276,WSH,ATL,2022 REG,5,3,6,2,5,11,1,0,1,-1,1,1,0,0,0,0,0,0,0,0.5022370601254724,0.4977629398745276
86173,0.6794871794871794,0.36101083032490977,-212,177,0.6519693010251187,0.34803069897488126,away,NYM,over,8.5,0.504950495049505,-102,0.47949844489399435,ATL,NYM,2022 REG,5,4,5,1,5,10,1,0,3,-3,1,0,0,0,0,0,0,0,0,0.47949844489399435,0.5205015551060057
86173,0.6794871794871794,0.36101083032490977,-212,177,0.6519693010251187,0.34803069897488126,home,ATL,under,8.5,0.5454545454545454,-120,0.5205015551060057,ATL,NYM,2022 REG,5,4,5,1,5,10,1,0,3,-3,1,0,0,0,0,0,0,0,0,0.47949844489399435,0.5205015551060057
86174,0.5454545454545454,0.49504950495049505,-120,102,0.5233614270517961,0.4766385729482039,away,HOU,over,8.5,0.5145631067961165,-106,0.4913668392989033,TOR,HOU,2022 REG,13,7,14,11,18,27,0,1,-4,4,1,1,1,1,1,1,1,0,0,0.4913668392989033,0.5086331607010968
86174,0.5454545454545454,0.49504950495049505,-120,102,0.5233614270517961,0.4766385729482039,home,TOR,under,8.5,0.5305164319248826,-113,0.5086331607010968,TOR,HOU,2022 REG,13,7,14,11,18,27,0,1,-4,4,1,1,1,1,1,1,1,0,0,0.4913668392989033,0.5086331607010968
86175,0.5901639344262295,0.45248868778280543,-144,121,0.5649918950897499,0.4350081049102501,away,TB,over,8,0.5238095238095238,-110,0.4988662131519274,BOS,TB,2022 REG,10,6,7,3,9,17,1,0,3,-3,1,1,1,0,0,0,0,0,0,0.4988662131519274,0.5011337868480725
86175,0.5901639344262295,0.45248868778280543,-144,121,0.5649918950897499,0.4350081049102501,home,BOS,under,8,0.5238095238095238,-110,0.5011337868480725,BOS,TB,2022 REG,10,6,7,3,9,17,1,0,3,-3,1,1,1,0,0,0,0,0,0,0.4988662131519274,0.5011337868480725
86176,0.574468085106383,0.46511627906976744,-135,115,0.5517281312179562,0.44827186878204384,away,PIT,over,8,0.5370370370370371,-116,0.5118817074154765,CIN,PIT,2022 REG,6,7,3,3,10,9,1,0,4,-4,1,1,1,0,0,0,0,0,0,0.5118817074154765,0.48811829258452355
86176,0.574468085106383,0.46511627906976744,-135,115,0.5517281312179562,0.44827186878204384,home,CIN,under,8,0.5098039215686274,-104,0.48811829258452355,CIN,PIT,2022 REG,6,7,3,3,10,9,1,0,4,-4,1,1,1,0,0,0,0,0,0,0.5118817074154765,0.48811829258452355
86177,0.4739336492890995,0.5652173913043479,111,-130,0.4553786537471813,0.5446213462528187,away,TB,over,7.5,0.5370370370370371,-116,0.5118817074154765,CHC,TB,2022 REG,5,5,10,6,11,15,0,1,-1,1,1,1,1,1,1,0,0,0,0,0.5118817074154765,0.48811829258452355
86177,0.4739336492890995,0.5652173913043479,111,-130,0.4553786537471813,0.5446213462528187,away,TB,over,8.5,0.5121951219512195,-105,0.48919479393107135,CHC,TB,2022 REG,5,5,10,6,11,15,0,1,-1,1,1,1,1,1,1,0,0,0,0,0.5118817074154765,0.48811829258452355
86177,0.4739336492890995,0.5652173913043479,111,-130,0.4553786537471813,0.5446213462528187,home,CHC,under,7.5,0.5098039215686274,-104,0.48811829258452355,CHC,TB,2022 REG,5,5,10,6,11,15,0,1,-1,1,1,1,1,1,1,0,0,0,0,0.5118817074154765,0.48811829258452355
86177,0.4739336492890995,0.5652173913043479,111,-130,0.4553786537471813,0.5446213462528187,home,CHC,under,8.5,0.5327102803738317,-114,0.5108052060689287,CHC,TB,2022 REG,5,5,10,6,11,15,0,1,-1,1,1,1,1,1,1,0,0,0,0,0.5118817074154765,0.48811829258452355
86178,0.6721311475409836,0.36363636363636365,-205,175,0.6480906892086682,0.3519093107913318,away,CHC,over,8.5,0.5238095238095238,-110,0.4988662131519274,ATL,CHC,2022 REG,8,3,11,6,9,19,0,1,-3,3,1,1,1,0,0,0,0,0,0,0.4988662131519274,0.5011337868480725
86178,0.6721311475409836,0.36363636363636365,-205,175,0.6480906892086682,0.3519093107913318,home,ATL,under,8.5,0.5238095238095238,-110,0.5011337868480725,ATL,CHC,2022 REG,8,3,11,6,9,19,0,1,-3,3,1,1,1,0,0,0,0,0,0,0.4988662131519274,0.5011337868480725
86179,0.4694835680751174,0.5670995670995671,113,-131,0.4523083872419321,0.5476916127580679,away,STL,over,7.5,0.5169082125603864,-107,0.49353874091423283,ARI,STL,2022 REG,8,4,12,6,10,20,0,1,-2,2,1,1,1,1,0,0,0,0,0,0.49353874091423283,0.5064612590857671
86179,0.4694835680751174,0.5670995670995671,113,-131,0.4523083872419321,0.5476916127580679,home,ARI,under,7.5,0.5283018867924528,-112,0.5064612590857671,ARI,STL,2022 REG,8,4,12,6,10,20,0,1,-2,2,1,1,1,1,0,0,0,0,0,0.49353874091423283,0.5064612590857671
86180,0.6415770609318996,0.3968253968253968,-179,152,0.616938924951412,0.383061075048588,away,BAL,over,9.5,0.5305164319248826,-113,0.5078572507605655,BOS,BAL,2022 REG,13,5,7,3,8,20,1,0,2,-2,1,1,1,0,0,0,0,0,0,0.5078572507605655,0.49214274923943446
86180,0.6415770609318996,0.3968253968253968,-179,152,0.616938924951412,0.383061075048588,home,BOS,under,9.5,0.5121951219512195,-105,0.49214274923943446,BOS,BAL,2022 REG,13,5,7,3,8,20,1,0,2,-2,1,1,1,0,0,0,0,0,0,0.5078572507605655,0.49214274923943446
86181,0.48780487804878053,0.5515695067264574,105,-123,0.4685978610852498,0.5314021389147502,away,STL,over,8.5,0.5391705069124424,-117,0.5140669063204599,CIN,STL,2022 REG,9,2,10,4,6,19,0,1,-2,2,1,1,0,0,0,0,0,0,0,0.5140669063204599,0.4859330936795401
86181,0.48780487804878053,0.5515695067264574,105,-123,0.4685978610852498,0.5314021389147502,home,CIN,under,8.5,0.5073891625615764,-103,0.4859330936795401,CIN,STL,2022 REG,9,2,10,4,6,19,0,1,-2,2,1,1,0,0,0,0,0,0,0,0.5140669063204599,0.4859330936795401
86182,0.4587155963302753,0.5815899581589958,118,-139,0.4402268098673069,0.5597731901326931,away,MIL,over,7,0.5391705069124424,-117,0.5140669063204599,ARI,MIL,2022 REG,10,5,4,0,5,14,1,0,5,-5,0,0,0,0,0,0,0,0,0,0.5140669063204599,0.4859330936795401
86182,0.4587155963302753,0.5815899581589958,118,-139,0.4402268098673069,0.5597731901326931,home,ARI,under,7,0.5073891625615764,-103,0.4859330936795401,ARI,MIL,2022 REG,10,5,4,0,5,14,1,0,5,-5,0,0,0,0,0,0,0,0,0,0.5140669063204599,0.4859330936795401
86183,0.44052863436123346,0.5951417004048584,127,-147,0.424814830499519,0.575185169500481,away,CWS,over,9,0.5121951219512195,-105,0.48808156828023186,TEX,CWS,2022 REG,12,3,5,2,5,17,1,0,1,-1,1,1,0,0,0,0,0,0,0,0.48808156828023186,0.5119184317197681
86183,0.44052863436123346,0.5951417004048584,127,-147,0.424814830499519,0.575185169500481,home,TEX,under,9,0.5348837209302326,-115,0.5119184317197681,TEX,CWS,2022 REG,12,3,5,2,5,17,1,0,1,-1,1,1,0,0,0,0,0,0,0,0.48808156828023186,0.5119184317197681
86184,0.5833333333333333,0.4566210045662101,-140,119,0.5600266362252664,0.4399733637747336,away,CLE,over,7.5,0.5215311004784688,-109,0.49907282342437215,MIN,CLE,2022 REG,4,3,6,1,4,10,1,0,2,-2,1,0,0,0,0,0,0,0,0,0.49907282342437215,0.5009271765756278
86184,0.5833333333333333,0.4566210045662101,-140,119,0.5600266362252664,0.4399733637747336,home,MIN,under,7.5,0.5215311004784688,-109,0.5009271765756278,MIN,CLE,2022 REG,4,3,6,1,4,10,1,0,2,-2,1,0,0,0,0,0,0,0,0,0.49907282342437215,0.5009271765756278
86185,0.4444444444444444,0.5934959349593496,125,-146,0.42758205359831375,0.5724179464016863,away,SD,over,6.5,0.5145631067961165,-106,0.4913668392989033,MIA,SD,2022 REG,9,3,5,0,3,14,1,0,3,-3,0,0,0,0,0,0,0,0,0,0.4913668392989033,0.5086331607010968
86185,0.4444444444444444,0.5934959349593496,125,-146,0.42758205359831375,0.5724179464016863,home,MIA,under,6.5,0.5305164319248826,-113,0.5086331607010968,MIA,SD,2022 REG,9,3,5,0,3,14,1,0,3,-3,0,0,0,0,0,0,0,0,0,0.4913668392989033,0.5086331607010968
86186,0.33557046979865773,0.7076023391812866,198,-242,0.3210829500067301,0.67891704999327,away,TOR,over,8,0.5121951219512195,-105,0.48808156828023186,PIT,TOR,2022 REG,5,0,9,4,4,14,0,1,-4,4,0,0,0,0,0,0,0,0,0,0.48808156828023186,0.5119184317197681
86186,0.33557046979865773,0.7076023391812866,198,-242,0.3210829500067301,0.67891704999327,home,PIT,under,8,0.5348837209302326,-115,0.5119184317197681,PIT,TOR,2022 REG,5,0,9,4,4,14,0,1,-4,4,0,0,0,0,0,0,0,0,0,0.48808156828023186,0.5119184317197681
86187,0.6254681647940076,0.4166666666666667,-167,140,0.5991141690863948,0.4008858309136052,away,BOS,over,9,0.5238095238095238,-110,0.4988662131519274,NYY,BOS,2022 REG,12,14,3,1,15,15,1,0,13,-13,1,0,0,0,0,0,0,0,0,0.4988662131519274,0.5011337868480725
86187,0.6254681647940076,0.4166666666666667,-167,140,0.5991141690863948,0.4008858309136052,home,NYY,under,9,0.5238095238095238,-110,0.5011337868480725,NYY,BOS,2022 REG,12,14,3,1,15,15,1,0,13,-13,1,0,0,0,0,0,0,0,0,0.4988662131519274,0.5011337868480725
86188,0.4,0.6453900709219857,150,-182,0.38184397163120565,0.6181560283687944,away,LAD,over,9,0.5238095238095238,-110,0.4988662131519274,CIN,LAD,2022 REG,5,2,17,8,10,22,0,1,-6,6,1,1,0,0,0,0,0,0,0,0.4988662131519274,0.5011337868480725
86188,0.4,0.6453900709219857,150,-182,0.38184397163120565,0.6181560283687944,home,CIN,under,9,0.5238095238095238,-110,0.5011337868480725,CIN,LAD,2022 REG,5,2,17,8,10,22,0,1,-6,6,1,1,0,0,0,0,0,0,0,0.4988662131519274,0.5011337868480725
86190,0.4184100418410042,0.6240601503759399,139,-166,0.4006400869385171,0.5993599130614828,away,NYY,over,7.5,0.5192307692307692,-108,0.49340049170764233,CLE,NYY,2022 REG,7,2,1,0,2,8,1,0,2,-2,0,0,0,0,0,0,0,0,0,0.49340049170764233,0.5065995082923577
86190,0.4184100418410042,0.6240601503759399,139,-166,0.4006400869385171,0.5993599130614828,home,CLE,under,7.5,0.5305164319248826,-113,0.5065995082923577,CLE,NYY,2022 REG,7,2,1,0,2,8,1,0,2,-2,0,0,0,0,0,0,0,0,0,0.49340049170764233,0.5065995082923577
86191,0.7118155619596541,0.3333333333333333,-247,200,0.6796778756848186,0.32032212431518137,away,BAL,over,9.5,0.5192307692307692,-108,0.49688292476754015,MIN,BAL,2022 REG,5,3,4,2,5,9,1,0,1,-1,1,1,0,0,0,0,0,0,0,0.49688292476754015,0.5031170752324599
86191,0.7118155619596541,0.3333333333333333,-247,200,0.6796778756848186,0.32032212431518137,home,MIN,under,9.5,0.5238095238095238,-110,0.5031170752324599,MIN,BAL,2022 REG,5,3,4,2,5,9,1,0,1,-1,1,1,0,0,0,0,0,0,0,0.49688292476754015,0.5031170752324599
86192,0.6168582375478928,0.425531914893617,-161,135,0.5907095228234366,0.4092904771765634,away,CWS,over,7,0.49504950495049505,102,0.47297076509898783,SD,CWS,2022 REG,7,1,5,2,3,12,0,1,-1,1,1,0,0,0,0,0,0,0,0,0.47297076509898783,0.5270292349010122
86192,0.6168582375478928,0.425531914893617,-161,135,0.5907095228234366,0.4092904771765634,home,SD,under,7,0.5495495495495495,-122,0.5270292349010122,SD,CWS,2022 REG,7,1,5,2,3,12,0,1,-1,1,1,0,0,0,0,0,0,0,0,0.47297076509898783,0.5270292349010122
86193,0.7198879551820728,0.32573289902280134,-257,207,0.6870460517348665,0.31295394826513345,away,DET,over,7,0.5145631067961165,-106,0.49023796582517226,TB,DET,2022 REG,11,8,7,1,9,18,1,0,7,-7,1,0,0,0,0,0,0,0,0,0.49023796582517226,0.5097620341748277
86193,0.7198879551820728,0.32573289902280134,-257,207,0.6870460517348665,0.31295394826513345,home,TB,under,7,0.5327102803738317,-114,0.5097620341748277,TB,DET,2022 REG,11,8,7,1,9,18,1,0,7,-7,1,0,0,0,0,0,0,0,0,0.49023796582517226,0.5097620341748277
86194,0.48780487804878053,0.5535714285714286,105,-124,0.4676213138438005,0.5323786861561994,away,TOR,over,8.5,0.5215311004784688,-109,0.49670754937970685,MIN,TOR,2022 REG,11,6,11,5,11,22,1,0,1,-1,1,1,1,1,1,0,0,0,0,0.49670754937970685,0.5032924506202932
86194,0.48780487804878053,0.5535714285714286,105,-124,0.4676213138438005,0.5323786861561994,home,MIN,under,8.5,0.5260663507109005,-111,0.5032924506202932,MIN,TOR,2022 REG,11,6,11,5,11,22,1,0,1,-1,1,1,1,1,1,0,0,0,0,0.49670754937970685,0.5032924506202932
86195,0.37037037037037035,0.6666666666666666,170,-200,0.35665294924554186,0.6433470507544581,away,LAD,over,7,0.5283018867924528,-112,0.5044173060022736,CHC,LAD,2022 REG,4,1,10,7,8,14,0,1,-6,6,1,0,0,0,0,0,0,0,0,0.5044173060022736,0.49558269399772636
86195,0.37037037037037035,0.6666666666666666,170,-200,0.35665294924554186,0.6433470507544581,home,CHC,under,7,0.5169082125603864,-107,0.49558269399772636,CHC,LAD,2022 REG,4,1,10,7,8,14,0,1,-6,6,1,0,0,0,0,0,0,0,0,0.5044173060022736,0.49558269399772636
86196,0.6774193548387096,0.36363636363636365,-210,175,0.6496074165168858,0.3503925834831142,away,TEX,over,8.5,0.5098039215686274,-104,0.48592421718142587,MIN,TEX,2022 REG,7,1,6,2,3,13,0,1,-1,1,1,0,0,0,0,0,0,0,0,0.48592421718142587,0.5140757828185741
86196,0.6774193548387096,0.36363636363636365,-210,175,0.6496074165168858,0.3503925834831142,home,MIN,under,8.5,0.5370370370370371,-116,0.5140757828185741,MIN,TEX,2022 REG,7,1,6,2,3,13,0,1,-1,1,1,0,0,0,0,0,0,0,0,0.48592421718142587,0.5140757828185741
86197,0.5391705069124424,0.49751243781094534,-117,101,0.5193921450108923,0.48060785498910774,away,ATL,over,8.5,0.5,100,0.47935779816513757,MIL,ATL,2022 REG,5,0,6,3,3,11,0,1,-3,3,0,0,0,0,0,0,0,0,0,0.47935779816513757,0.5206422018348624
86197,0.5391705069124424,0.49751243781094534,-117,101,0.5193921450108923,0.48060785498910774,home,MIL,under,8.5,0.5412844036697247,-118,0.5206422018348624,MIL,ATL,2022 REG,5,0,6,3,3,11,0,1,-3,3,0,0,0,0,0,0,0,0,0,0.47935779816513757,0.5206422018348624
86198,0.6441281138790036,0.390625,-181,156,0.6217426561846988,0.3782573438153012,away,STL,over,7,0.5260663507109005,-111,0.5022370601254724,MIL,STL,2022 REG,9,5,9,1,6,18,1,0,4,-4,1,0,0,0,0,0,0,0,0,0.5022370601254724,0.4977629398745276
86198,0.6441281138790036,0.390625,-181,156,0.6217426561846988,0.3782573438153012,home,MIL,under,7,0.5192307692307692,-108,0.4977629398745276,MIL,STL,2022 REG,9,5,9,1,6,18,1,0,4,-4,1,0,0,0,0,0,0,0,0,0.5022370601254724,0.4977629398745276
86199,0.42016806722689076,0.6197718631178707,138,-163,0.4033865838887557,0.5966134161112443,away,LAD,over,9,0.5391705069124424,-117,0.5140669063204599,CIN,LAD,2022 REG,7,4,9,8,12,16,0,1,-4,4,1,1,1,1,0,0,0,0,0,0.5140669063204599,0.4859330936795401
86199,0.42016806722689076,0.6197718631178707,138,-163,0.4033865838887557,0.5966134161112443,home,CIN,under,9,0.5073891625615764,-103,0.4859330936795401,CIN,LAD,2022 REG,7,4,9,8,12,16,0,1,-4,4,1,1,1,1,0,0,0,0,0,0.5140669063204599,0.4859330936795401
86200,0.47619047619047616,0.5652173913043479,110,-130,0.4564724440500838,0.5435275559499162,away,CLE,over,9,0.5454545454545454,-120,0.5206611570247933,BOS,CLE,2022 REG,6,4,5,2,6,11,1,0,2,-2,1,1,0,0,0,0,0,0,0,0.5206611570247933,0.4793388429752067
86200,0.47619047619047616,0.5652173913043479,110,-130,0.4564724440500838,0.5435275559499162,home,BOS,under,9,0.5,100,0.4793388429752067,BOS,CLE,2022 REG,6,4,5,2,6,11,1,0,2,-2,1,1,0,0,0,0,0,0,0,0.5206611570247933,0.4793388429752067
86201,0.4273504273504274,0.609375,134,-156,0.4116558002775952,0.5883441997224048,away,NYM,over,9.5,0.5073891625615764,-103,0.4837652908580103,WSH,NYM,2022 REG,4,0,9,5,5,13,0,1,-5,5,0,0,0,0,0,0,0,0,0,0.4837652908580103,0.5162347091419897
86201,0.4273504273504274,0.609375,134,-156,0.4116558002775952,0.5883441997224048,home,WSH,under,9.5,0.5391705069124424,-117,0.5162347091419897,WSH,NYM,2022 REG,4,0,9,5,5,13,0,1,-5,5,0,0,0,0,0,0,0,0,0,0.4837652908580103,0.5162347091419897
86202,0.4739336492890995,0.5652173913043479,111,-130,0.4553786537471813,0.5446213462528187,away,TB,over,6.5,0.5238095238095238,-110,0.4988662131519274,CLE,TB,2022 REG,6,2,4,1,3,10,1,0,1,-1,1,0,0,0,0,0,0,0,0,0.4988662131519274,0.5011337868480725
86202,0.4739336492890995,0.5652173913043479,111,-130,0.4553786537471813,0.5446213462528187,home,CLE,under,6.5,0.5238095238095238,-110,0.5011337868480725,CLE,TB,2022 REG,6,2,4,1,3,10,1,0,1,-1,1,0,0,0,0,0,0,0,0,0.4988662131519274,0.5011337868480725
86203,0.5475113122171946,0.4926108374384236,-121,103,0.5255439814102724,0.47445601858972763,away,CIN,over,9,0.504950495049505,-102,0.4826715732667395,ARI,CIN,2022 REG,5,3,13,5,8,18,0,1,-2,2,1,1,1,0,0,0,0,0,0,0.4826715732667395,0.5173284267332605
86203,0.5475113122171946,0.4926108374384236,-121,103,0.5255439814102724,0.47445601858972763,home,ARI,under,9,0.5391705069124424,-117,0.5173284267332605,ARI,CIN,2022 REG,5,3,13,5,8,18,0,1,-2,2,1,1,1,0,0,0,0,0,0,0.4826715732667395,0.5173284267332605
86204,0.8181818181818181,0.21978021978021978,-450,355,0.7871219689401509,0.21287803105984915,away,COL,over,7,0.5,100,0.47935779816513757,NYM,COL,2022 REG,8,3,6,1,4,14,1,0,2,-2,1,0,0,0,0,0,0,0,0,0.47935779816513757,0.5206422018348624
86204,0.8181818181818181,0.21978021978021978,-450,355,0.7871219689401509,0.21287803105984915,home,NYM,under,7,0.5412844036697247,-118,0.5206422018348624,NYM,COL,2022 REG,8,3,6,1,4,14,1,0,2,-2,1,0,0,0,0,0,0,0,0,0.47935779816513757,0.5206422018348624
86205,0.3333333333333333,0.7118155619596541,200,-247,0.31828370156900415,0.6817162984309959,away,ATL,over,8.5,0.5370370370370371,-116,0.5118817074154765,WSH,ATL,2022 REG,7,3,9,6,9,16,0,1,-3,3,1,1,1,0,0,0,0,0,0,0.5118817074154765,0.48811829258452355
86205,0.3333333333333333,0.7118155619596541,200,-247,0.31828370156900415,0.6817162984309959,home,WSH,under,8.5,0.5098039215686274,-104,0.48811829258452355,WSH,ATL,2022 REG,7,3,9,6,9,16,0,1,-3,3,1,1,1,0,0,0,0,0,0,0.5118817074154765,0.48811829258452355
86206,0.7058823529411764,0.32894736842105265,-240,204,0.6812966672737206,0.3187033327262794,away,PIT,over,7,0.5238095238095238,-110,0.5000596729920038,SD,PIT,2022 REG,10,2,8,4,6,18,0,1,-2,2,1,1,0,0,0,0,0,0,0,0.5000596729920038,0.4999403270079962
86206,0.7058823529411764,0.32894736842105265,-240,204,0.6812966672737206,0.3187033327262794,home,SD,under,7,0.5215311004784688,-109,0.4999403270079962,SD,PIT,2022 REG,10,2,8,4,6,18,0,1,-2,2,1,1,0,0,0,0,0,0,0,0.5000596729920038,0.4999403270079962
86207,0.47619047619047616,0.5652173913043479,110,-130,0.4564724440500838,0.5435275559499162,away,MIL,over,9.5,0.5215311004784688,-109,0.4978845547971712,WSH,MIL,2022 REG,8,1,9,4,5,17,0,1,-3,3,1,0,0,0,0,0,0,0,0,0.4978845547971712,0.5021154452028288
86207,0.47619047619047616,0.5652173913043479,110,-130,0.4564724440500838,0.5435275559499162,home,WSH,under,9.5,0.5238095238095238,-110,0.5021154452028288,WSH,MIL,2022 REG,8,1,9,4,5,17,0,1,-3,3,1,0,0,0,0,0,0,0,0,0.4978845547971712,0.5021154452028288
86208,0.5614035087719298,0.47846889952153115,-128,109,0.5390189988527938,0.4609810011472062,away,SEA,over,8.5,0.5073891625615764,-103,0.4837652908580103,TEX,SEA,2022 REG,12,5,11,6,11,23,0,1,-1,1,1,1,1,1,1,0,0,0,0,0.4837652908580103,0.5162347091419897
86208,0.5614035087719298,0.47846889952153115,-128,109,0.5390189988527938,0.4609810011472062,home,TEX,under,8.5,0.5391705069124424,-117,0.5162347091419897,TEX,SEA,2022 REG,12,5,11,6,11,23,0,1,-1,1,1,1,1,1,1,0,0,0,0,0.4837652908580103,0.5162347091419897
86209,0.5391705069124424,0.5024875621890548,-117,-101,0.5167097046779946,0.4832902953220054,away,CIN,over,7,0.5454545454545454,-120,0.5206611570247933,MIA,CIN,2022 REG,6,1,9,3,4,15,0,1,-2,2,1,0,0,0,0,0,0,0,0,0.5206611570247933,0.4793388429752067
86209,0.5391705069124424,0.5024875621890548,-117,-101,0.5167097046779946,0.4832902953220054,home,MIA,under,7,0.5,100,0.4793388429752067,MIA,CIN,2022 REG,6,1,9,3,4,15,0,1,-2,2,1,0,0,0,0,0,0,0,0,0.5206611570247933,0.4793388429752067
86210,0.47619047619047616,0.5689655172413793,110,-132,0.4546876221753069,0.5453123778246931,away,NYY,over,8,0.5145631067961165,-106,0.4913668392989033,STL,NYY,2022 REG,11,12,16,9,21,27,1,0,3,-3,1,1,1,1,1,1,1,1,1,0.4913668392989033,0.5086331607010968
86210,0.47619047619047616,0.5689655172413793,110,-132,0.4546876221753069,0.5453123778246931,home,STL,under,8,0.5305164319248826,-113,0.5086331607010968,STL,NYY,2022 REG,11,12,16,9,21,27,1,0,3,-3,1,1,1,1,1,1,1,1,1,0.4913668392989033,0.5086331607010968
86211,0.6153846153846154,0.42194092827004215,-160,137,0.5924150500586723,0.40758494994132766,away,COL,over,10,0.5260663507109005,-111,0.5010269332605688,TEX,COL,2022 REG,4,1,7,4,5,11,0,1,-3,3,1,0,0,0,0,0,0,0,0,0.5010269332605688,0.4989730667394312
86211,0.6153846153846154,0.42194092827004215,-160,137,0.5924150500586723,0.40758494994132766,home,TEX,under,10,0.5215311004784688,-109,0.4989730667394312,TEX,COL,2022 REG,4,1,7,4,5,11,0,1,-3,3,1,0,0,0,0,0,0,0,0,0.5010269332605688,0.4989730667394312
86212,0.4587155963302753,0.5780590717299579,118,-137,0.4418464825411775,0.5581535174588226,away,CLE,over,8.5,0.5305164319248826,-113,0.5066009958897986,BAL,CLE,2022 REG,5,3,14,6,9,19,0,1,-3,3,1,1,1,0,0,0,0,0,0,0.5066009958897986,0.49339900411020143
86212,0.4587155963302753,0.5780590717299579,118,-137,0.4418464825411775,0.5581535174588226,home,BAL,under,8.5,0.5145631067961165,-106,0.49339900411020143,BAL,CLE,2022 REG,5,3,14,6,9,19,0,1,-3,3,1,1,1,0,0,0,0,0,0,0.5066009958897986,0.49339900411020143
86213,0.5260663507109005,0.5169082125603864,-111,-107,0.5034588790373798,0.49654112096262015,away,CWS,over,7.5,0.5348837209302326,-115,0.5097020142727117,MIN,CWS,2022 REG,12,8,9,4,12,21,1,0,4,-4,1,1,1,1,0,0,0,0,0,0.5097020142727117,0.49029798572728833
86213,0.5260663507109005,0.5169082125603864,-111,-107,0.5034588790373798,0.49654112096262015,home,MIN,under,7.5,0.5121951219512195,-105,0.49029798572728833,MIN,CWS,2022 REG,12,8,9,4,12,21,1,0,4,-4,1,1,1,1,0,0,0,0,0,0.5097020142727117,0.49029798572728833
86214,0.4081632653061224,0.6309963099630996,145,-171,0.3921797651962359,0.6078202348037641,away,TOR,over,9.5,0.5121951219512195,-105,0.48808156828023186,BOS,TOR,2022 REG,7,1,7,4,5,14,0,1,-3,3,1,0,0,0,0,0,0,0,0,0.48808156828023186,0.5119184317197681
86214,0.4081632653061224,0.6309963099630996,145,-171,0.3921797651962359,0.6078202348037641,home,BOS,under,9.5,0.5348837209302326,-115,0.5119184317197681,BOS,TOR,2022 REG,7,1,7,4,5,14,0,1,-3,3,1,0,0,0,0,0,0,0,0,0.48808156828023186,0.5119184317197681
86215,0.4716981132075471,0.5689655172413793,112,-132,0.45251715544861953,0.5474828445513804,away,MIN,over,8.5,0.5,100,0.47935779816513757,KC,MIN,2022 REG,11,4,7,6,10,18,0,1,-2,2,1,1,1,1,0,0,0,0,0,0.47935779816513757,0.5206422018348624
86215,0.4716981132075471,0.5689655172413793,112,-132,0.45251715544861953,0.5474828445513804,home,KC,under,8.5,0.5412844036697247,-118,0.5206422018348624,KC,MIN,2022 REG,11,4,7,6,10,18,0,1,-2,2,1,1,1,1,0,0,0,0,0,0.47935779816513757,0.5206422018348624
86216,0.5780590717299579,0.46511627906976744,-137,115,0.5531011685250534,0.4468988314749466,away,BAL,over,10,0.5121951219512195,-105,0.48808156828023186,KC,BAL,2022 REG,10,7,15,10,17,25,0,1,-3,3,1,1,1,1,1,1,1,0,0,0.48808156828023186,0.5119184317197681
86216,0.5780590717299579,0.46511627906976744,-137,115,0.5531011685250534,0.4468988314749466,home,KC,under,10,0.5348837209302326,-115,0.5119184317197681,KC,BAL,2022 REG,10,7,15,10,17,25,0,1,-3,3,1,1,1,1,1,1,1,0,0,0.48808156828023186,0.5119184317197681
86217,0.6363636363636364,0.40485829959514175,-175,147,0.6101314952989593,0.38986850470104073,away,OAK,over,8,0.5121951219512195,-105,0.48808156828023186,CWS,OAK,2022 REG,9,3,8,2,5,17,1,0,1,-1,1,1,0,0,0,0,0,0,0,0.48808156828023186,0.5119184317197681
86217,0.6363636363636364,0.40485829959514175,-175,147,0.6101314952989593,0.38986850470104073,home,CWS,under,8,0.5348837209302326,-115,0.5119184317197681,CWS,OAK,2022 REG,9,3,8,2,5,17,1,0,1,-1,1,1,0,0,0,0,0,0,0,0.48808156828023186,0.5119184317197681
86218,0.7142857142857143,0.3278688524590164,-250,205,0.6841753094680495,0.3158246905319505,away,STL,over,9,0.5475113122171946,-121,0.5214983313199976,ATL,STL,2022 REG,8,2,8,3,5,16,0,1,-1,1,1,1,0,0,0,0,0,0,0,0.5214983313199976,0.47850166868000243
86218,0.7142857142857143,0.3278688524590164,-250,205,0.6841753094680495,0.3158246905319505,home,ATL,under,9,0.5,100,0.47850166868000243,ATL,STL,2022 REG,8,2,8,3,5,16,0,1,-1,1,1,1,0,0,0,0,0,0,0,0.5214983313199976,0.47850166868000243
86220,0.4366812227074236,0.6031746031746031,129,-152,0.419276931929246,0.580723068070754,away,ATL,over,9,0.5391705069124424,-117,0.5153817639191344,BOS,ATL,2022 REG,9,4,12,8,12,21,0,1,-4,4,1,1,1,1,0,0,0,0,0,0.5153817639191344,0.4846182360808656
86220,0.4366812227074236,0.6031746031746031,129,-152,0.419276931929246,0.580723068070754,home,BOS,under,9,0.504950495049505,-102,0.4846182360808656,BOS,ATL,2022 REG,9,4,12,8,12,21,0,1,-4,4,1,1,1,1,0,0,0,0,0,0.5153817639191344,0.4846182360808656
86221,0.5370370370370371,0.5,-116,100,0.5171467764060357,0.4828532235939643,away,STL,over,10.5,0.5283018867924528,-112,0.5044173060022736,BOS,STL,2022 REG,11,6,10,5,11,21,1,0,1,-1,1,1,1,1,1,0,0,0,0,0.5044173060022736,0.49558269399772636
86221,0.5370370370370371,0.5,-116,100,0.5171467764060357,0.4828532235939643,home,BOS,under,10.5,0.5169082125603864,-107,0.49558269399772636,BOS,STL,2022 REG,11,6,10,5,11,21,1,0,1,-1,1,1,1,1,1,0,0,0,0,0.5044173060022736,0.49558269399772636
86222,0.6539792387543253,0.390625,-189,156,0.6248089926485555,0.3751910073514445,away,MIA,over,6,0.5238095238095238,-110,0.4988662131519274,MIL,MIA,2022 REG,5,1,5,0,1,10,1,0,1,-1,0,0,0,0,0,0,0,0,0,0.4988662131519274,0.5011337868480725
86222,0.6539792387543253,0.390625,-189,156,0.6248089926485555,0.3751910073514445,home,MIL,under,6,0.5238095238095238,-110,0.5011337868480725,MIL,MIA,2022 REG,5,1,5,0,1,10,1,0,1,-1,0,0,0,0,0,0,0,0,0,0.4988662131519274,0.5011337868480725
86223,0.574468085106383,0.46511627906976744,-135,115,0.5517281312179562,0.44827186878204384,away,LAA,over,7,0.5454545454545454,-120,0.5220180091279142,HOU,LAA,2022 REG,7,1,11,6,7,18,0,1,-5,5,1,0,0,0,0,0,0,0,0,0.5220180091279142,0.4779819908720858
86223,0.574468085106383,0.46511627906976744,-135,115,0.5517281312179562,0.44827186878204384,home,HOU,under,7,0.49751243781094534,101,0.4779819908720858,HOU,LAA,2022 REG,7,1,11,6,7,18,0,1,-5,5,1,0,0,0,0,0,0,0,0,0.5220180091279142,0.4779819908720858
86224,0.29673590504451036,0.7435897435897436,237,-290,0.28476983720051807,0.7152301627994819,away,ATL,over,9,0.5,100,0.4783105022831051,WSH,ATL,2022 REG,7,4,13,10,14,20,0,1,-6,6,1,1,1,1,0,0,0,0,0,0.4783105022831051,0.5216894977168949
86224,0.29673590504451036,0.7435897435897436,237,-290,0.28476983720051807,0.7152301627994819,home,WSH,under,9,0.5433789954337899,-119,0.5216894977168949,WSH,ATL,2022 REG,7,4,13,10,14,20,0,1,-6,6,1,1,1,1,0,0,0,0,0,0.4783105022831051,0.5216894977168949
86225,0.5169082125603864,0.5238095238095238,-107,-110,0.49586088023391106,0.5041391197660889,away,NYY,over,8,0.5121951219512195,-105,0.48808156828023186,TEX,NYY,2022 REG,11,4,5,2,6,16,1,0,2,-2,1,1,0,0,0,0,0,0,0,0.48808156828023186,0.5119184317197681
86225,0.5169082125603864,0.5238095238095238,-107,-110,0.49586088023391106,0.5041391197660889,home,TEX,under,8,0.5348837209302326,-115,0.5119184317197681,TEX,NYY,2022 REG,11,4,5,2,6,16,1,0,2,-2,1,1,0,0,0,0,0,0,0,0.48808156828023186,0.5119184317197681
86226,0.6666666666666666,0.3717472118959108,-200,169,0.641057414291615,0.358942585708385,away,PHI,over,7.5,0.5073891625615764,-103,0.4837652908580103,HOU,PHI,2022 REG,12,3,4,2,5,16,1,0,1,-1,1,1,0,0,0,0,0,0,0,0.4837652908580103,0.5162347091419897
86226,0.6666666666666666,0.3717472118959108,-200,169,0.641057414291615,0.358942585708385,home,HOU,under,7.5,0.5391705069124424,-117,0.5162347091419897,HOU,PHI,2022 REG,12,3,4,2,5,16,1,0,1,-1,1,1,0,0,0,0,0,0,0,0.4837652908580103,0.5162347091419897
86227,0.6794871794871794,0.36101083032490977,-212,177,0.6519693010251187,0.34803069897488126,away,CIN,over,8,0.5121951219512195,-105,0.48808156828023186,PHI,CIN,2022 REG,7,7,11,6,13,18,1,0,1,-1,1,1,1,1,1,1,0,0,0,0.48808156828023186,0.5119184317197681
86227,0.6794871794871794,0.36101083032490977,-212,177,0.6519693010251187,0.34803069897488126,home,PHI,under,8,0.5348837209302326,-115,0.5119184317197681,PHI,CIN,2022 REG,7,7,11,6,13,18,1,0,1,-1,1,1,1,1,1,1,0,0,0,0.48808156828023186,0.5119184317197681
86228,0.607843137254902,0.43103448275862066,-155,132,0.5842116427368785,0.41578835726312147,away,CWS,over,7.5,0.5215311004784688,-109,0.49670754937970685,SEA,CWS,2022 REG,6,3,7,0,3,13,1,0,3,-3,0,0,0,0,0,0,0,0,0,0.49670754937970685,0.5032924506202932
86228,0.607843137254902,0.43103448275862066,-155,132,0.5842116427368785,0.41578835726312147,home,SEA,under,7.5,0.5260663507109005,-111,0.5032924506202932,SEA,CWS,2022 REG,6,3,7,0,3,13,1,0,3,-3,0,0,0,0,0,0,0,0,0,0.49670754937970685,0.5032924506202932
86229,0.7375328083989502,0.30120481927710846,-281,232,0.7089625370683137,0.2910374629316863,away,KC,over,7.5,0.5327102803738317,-114,0.508788710910954,HOU,KC,2022 REG,7,4,9,7,11,16,0,1,-3,3,1,1,1,1,0,0,0,0,0,0.508788710910954,0.491211289089046
86229,0.7375328083989502,0.30120481927710846,-281,232,0.7089625370683137,0.2910374629316863,home,HOU,under,7.5,0.5121951219512195,-105,0.491211289089046,HOU,KC,2022 REG,7,4,9,7,11,16,0,1,-3,3,1,1,1,1,0,0,0,0,0,0.508788710910954,0.491211289089046
86230,0.5614035087719298,0.47846889952153115,-128,109,0.5390189988527938,0.4609810011472062,away,CIN,over,10.5,0.5192307692307692,-108,0.49688292476754015,CHC,CIN,2022 REG,23,15,12,7,22,35,1,0,8,-8,1,1,1,1,1,1,1,0,0,0.49688292476754015,0.5031170752324599
86230,0.5614035087719298,0.47846889952153115,-128,109,0.5390189988527938,0.4609810011472062,home,CHC,under,10.5,0.5238095238095238,-110,0.5031170752324599,CHC,CIN,2022 REG,23,15,12,7,22,35,1,0,8,-8,1,1,1,1,1,1,1,0,0,0.49688292476754015,0.5031170752324599
86231,0.4854368932038835,0.5555555555555556,106,-125,0.465537646233282,0.534462353766718,away,LAD,over,9,0.5121951219512195,-105,0.48808156828023186,ARI,LAD,2022 REG,5,5,5,3,8,10,1,0,2,-2,1,1,1,0,0,0,0,0,0,0.48808156828023186,0.5119184317197681
86231,0.4854368932038835,0.5555555555555556,106,-125,0.465537646233282,0.534462353766718,home,ARI,under,9,0.5348837209302326,-115,0.5119184317197681,ARI,LAD,2022 REG,5,5,5,3,8,10,1,0,2,-2,1,1,1,0,0,0,0,0,0,0.48808156828023186,0.5119184317197681
86232,0.4166666666666667,0.6226415094339623,140,-165,0.4002882599580712,0.5997117400419287,away,NYM,over,7.5,0.5,100,0.4783105022831051,NYY,NYM,2022 REG,8,4,4,2,6,12,1,0,2,-2,1,1,0,0,0,0,0,0,0,0.4783105022831051,0.5216894977168949
86232,0.4166666666666667,0.6226415094339623,140,-165,0.4002882599580712,0.5997117400419287,home,NYY,under,7.5,0.5433789954337899,-119,0.5216894977168949,NYY,NYM,2022 REG,8,4,4,2,6,12,1,0,2,-2,1,1,0,0,0,0,0,0,0,0.4783105022831051,0.5216894977168949
86233,0.5370370370370371,0.504950495049505,-116,-102,0.514488177212783,0.48551182278721705,away,ATL,over,6.5,0.5475113122171946,-121,0.5242087833606768,NYM,ATL,2022 REG,5,2,8,5,7,13,0,1,-3,3,1,1,0,0,0,0,0,0,0,0.5242087833606768,0.4757912166393232
86233,0.5370370370370371,0.504950495049505,-116,-102,0.514488177212783,0.48551182278721705,home,NYM,under,6.5,0.49504950495049505,102,0.4757912166393232,NYM,ATL,2022 REG,5,2,8,5,7,13,0,1,-3,3,1,1,0,0,0,0,0,0,0,0.5242087833606768,0.4757912166393232
86234,0.574468085106383,0.46511627906976744,-135,115,0.5517281312179562,0.44827186878204384,away,BAL,over,9,0.5327102803738317,-114,0.508788710910954,BOS,BAL,2022 REG,7,3,7,1,4,14,1,0,2,-2,1,0,0,0,0,0,0,0,0,0.508788710910954,0.491211289089046
86234,0.574468085106383,0.46511627906976744,-135,115,0.5517281312179562,0.44827186878204384,home,BOS,under,9,0.5121951219512195,-105,0.491211289089046,BOS,BAL,2022 REG,7,3,7,1,4,14,1,0,2,-2,1,0,0,0,0,0,0,0,0,0.508788710910954,0.491211289089046
86235,0.5633187772925764,0.47846889952153115,-129,109,0.539778994283756,0.460221005716244,away,SEA,over,8.5,0.5327102803738317,-114,0.5100625279371946,LAA,SEA,2022 REG,8,5,6,1,6,14,1,0,4,-4,1,0,0,0,0,0,0,0,0,0.5100625279371946,0.48993747206280536
86235,0.5633187772925764,0.47846889952153115,-129,109,0.539778994283756,0.460221005716244,home,LAA,under,8.5,0.5098039215686274,-104,0.48993747206280536,LAA,SEA,2022 REG,8,5,6,1,6,14,1,0,4,-4,1,0,0,0,0,0,0,0,0,0.5100625279371946,0.48993747206280536
86236,0.5073891625615764,0.5370370370370371,-103,-116,0.48484779035144243,0.5151522096485576,away,CWS,over,7,0.5535714285714286,-124,0.5293429871948779,TB,CWS,2022 REG,9,5,16,6,11,25,0,1,-1,1,1,1,1,1,1,0,0,0,0,0.5293429871948779,0.47065701280512207
86236,0.5073891625615764,0.5370370370370371,-103,-116,0.48484779035144243,0.5151522096485576,home,TB,under,7,0.49019607843137253,104,0.47065701280512207,TB,CWS,2022 REG,9,5,16,6,11,25,0,1,-1,1,1,1,1,1,1,0,0,0,0,0.5293429871948779,0.47065701280512207
86237,0.5,0.5348837209302326,100,-115,0.4825581395348837,0.5174418604651163,away,LAA,over,8.5,0.5121951219512195,-105,0.48808156828023186,MIN,LAA,2022 REG,11,3,16,10,13,27,0,1,-7,7,1,1,1,0,0,0,0,0,0,0.48808156828023186,0.5119184317197681
86237,0.5,0.5348837209302326,100,-115,0.4825581395348837,0.5174418604651163,home,MIN,under,8.5,0.5348837209302326,-115,0.5119184317197681,MIN,LAA,2022 REG,11,3,16,10,13,27,0,1,-7,7,1,1,1,0,0,0,0,0,0,0.48808156828023186,0.5119184317197681
86238,0.5305164319248826,0.5098039215686274,-113,-104,0.5091258218555558,0.49087417814444423,away,MIA,over,7,0.5,100,0.4772727272727273,NYM,MIA,2022 REG,7,0,6,2,2,13,0,1,-2,2,0,0,0,0,0,0,0,0,0,0.4772727272727273,0.5227272727272727
86238,0.5305164319248826,0.5098039215686274,-113,-104,0.5091258218555558,0.49087417814444423,home,NYM,under,7,0.5454545454545454,-120,0.5227272727272727,NYM,MIA,2022 REG,7,0,6,2,2,13,0,1,-2,2,0,0,0,0,0,0,0,0,0,0.4772727272727273,0.5227272727272727
86240,0.7142857142857143,0.33112582781456956,-250,202,0.6818488984997972,0.31815110150020276,away,OAK,over,7,0.5145631067961165,-106,0.4913668392989033,SEA,OAK,2022 REG,6,2,3,1,3,9,1,0,1,-1,1,0,0,0,0,0,0,0,0,0.4913668392989033,0.5086331607010968
86240,0.7142857142857143,0.33112582781456956,-250,202,0.6818488984997972,0.31815110150020276,home,SEA,under,7,0.5305164319248826,-113,0.5086331607010968,SEA,OAK,2022 REG,6,2,3,1,3,9,1,0,1,-1,1,0,0,0,0,0,0,0,0,0.4913668392989033,0.5086331607010968
86241,0.6666666666666666,0.38167938931297707,-200,162,0.6344359626802376,0.3655640373197624,away,BOS,over,8.5,0.5238095238095238,-110,0.4988662131519274,HOU,BOS,2022 REG,12,6,4,1,7,16,1,0,5,-5,1,0,0,0,0,0,0,0,0,0.4988662131519274,0.5011337868480725
86241,0.6666666666666666,0.38167938931297707,-200,162,0.6344359626802376,0.3655640373197624,home,HOU,under,8.5,0.5238095238095238,-110,0.5011337868480725,HOU,BOS,2022 REG,12,6,4,1,7,16,1,0,5,-5,1,0,0,0,0,0,0,0,0,0.4988662131519274,0.5011337868480725
86242,0.47619047619047616,0.5652173913043479,110,-130,0.4564724440500838,0.5435275559499162,away,TOR,over,8.5,0.5073891625615764,-103,0.4826927225525911,MIN,TOR,2022 REG,3,3,13,9,12,16,0,1,-6,6,1,1,1,0,0,0,0,0,0,0.4826927225525911,0.5173072774474089
86242,0.47619047619047616,0.5652173913043479,110,-130,0.4564724440500838,0.5435275559499162,home,MIN,under,8.5,0.5412844036697247,-118,0.5173072774474089,MIN,TOR,2022 REG,3,3,13,9,12,16,0,1,-6,6,1,1,1,0,0,0,0,0,0,0.4826927225525911,0.5173072774474089
86243,0.5689655172413793,0.4716981132075471,-132,112,0.5458293137100936,0.4541706862899064,away,COL,over,8.5,0.5,100,0.47935779816513757,DET,COL,2022 REG,7,2,11,6,8,18,0,1,-4,4,1,1,0,0,0,0,0,0,0,0.47935779816513757,0.5206422018348624
86243,0.5689655172413793,0.4716981132075471,-132,112,0.5458293137100936,0.4541706862899064,home,DET,under,8.5,0.5412844036697247,-118,0.5206422018348624,DET,COL,2022 REG,7,2,11,6,8,18,0,1,-4,4,1,1,0,0,0,0,0,0,0,0.47935779816513757,0.5206422018348624
86244,0.6254681647940076,0.41152263374485604,-167,143,0.6023315979176397,0.3976684020823603,away,BOS,over,7.5,0.5238095238095238,-110,0.5000596729920038,TB,BOS,2022 REG,9,5,6,2,7,15,1,0,3,-3,1,1,0,0,0,0,0,0,0,0.5000596729920038,0.4999403270079962
86244,0.6254681647940076,0.41152263374485604,-167,143,0.6023315979176397,0.3976684020823603,home,TB,under,7.5,0.5215311004784688,-109,0.4999403270079962,TB,BOS,2022 REG,9,5,6,2,7,15,1,0,3,-3,1,1,0,0,0,0,0,0,0,0.5000596729920038,0.4999403270079962
86245,0.5433789954337899,0.5,-119,100,0.5198077604720502,0.48019223952794976,away,PHI,over,7.5,0.5412844036697247,-118,0.5175913212324037,SF,PHI,2022 REG,11,13,5,1,14,16,1,0,12,-12,1,0,0,0,0,0,0,0,0,0.5175913212324037,0.4824086787675963
86245,0.5433789954337899,0.5,-119,100,0.5198077604720502,0.48019223952794976,home,SF,under,7.5,0.5024875621890548,-101,0.4824086787675963,SF,PHI,2022 REG,11,13,5,1,14,16,1,0,12,-12,1,0,0,0,0,0,0,0,0,0.5175913212324037,0.4824086787675963
86246,0.5689655172413793,0.47619047619047616,-132,110,0.5432733140818753,0.4567266859181247,away,LAA,over,7.5,0.5098039215686274,-104,0.4826910619203363,OAK,LAA,2022 REG,2,0,5,1,1,7,0,1,-1,1,0,0,0,0,0,0,0,0,0,0.4826910619203363,0.5173089380796637
86246,0.5689655172413793,0.47619047619047616,-132,110,0.5432733140818753,0.4567266859181247,home,OAK,under,7.5,0.5433789954337899,-119,0.5173089380796637,OAK,LAA,2022 REG,2,0,5,1,1,7,0,1,-1,1,0,0,0,0,0,0,0,0,0,0.4826910619203363,0.5173089380796637
86247,0.425531914893617,0.6108949416342413,135,-157,0.41003112488176247,0.5899688751182375,away,LAD,over,8.5,0.5348837209302326,-115,0.5109810284308424,SD,LAD,2022 REG,8,5,6,4,9,14,1,0,1,-1,1,1,1,1,0,0,0,0,0,0.5109810284308424,0.48901897156915763
86247,0.425531914893617,0.6108949416342413,135,-157,0.41003112488176247,0.5899688751182375,home,SD,under,8.5,0.5098039215686274,-104,0.48901897156915763,SD,LAD,2022 REG,8,5,6,4,9,14,1,0,1,-1,1,1,1,1,0,0,0,0,0,0.5109810284308424,0.48901897156915763
86248,0.4166666666666667,0.6153846153846154,140,-160,0.40331196581196577,0.5966880341880343,away,LAD,over,7.5,0.5238095238095238,-110,0.5000596729920038,SF,LAD,2022 REG,2,0,9,5,5,11,0,1,-5,5,0,0,0,0,0,0,0,0,0,0.5000596729920038,0.4999403270079962
86248,0.4166666666666667,0.6153846153846154,140,-160,0.40331196581196577,0.5966880341880343,home,SF,under,7.5,0.5215311004784688,-109,0.4999403270079962,SF,LAD,2022 REG,2,0,9,5,5,11,0,1,-5,5,0,0,0,0,0,0,0,0,0,0.5000596729920038,0.4999403270079962
86249,0.5073891625615764,0.5348837209302326,-103,-115,0.4859403596076043,0.5140596403923957,away,SEA,over,9,0.504950495049505,-102,0.48160416005266615,CWS,SEA,2022 REG,10,6,8,4,10,18,1,0,2,-2,1,1,1,1,0,0,0,0,0,0.48160416005266615,0.5183958399473338
86249,0.5073891625615764,0.5348837209302326,-103,-115,0.4859403596076043,0.5140596403923957,home,CWS,under,9,0.5412844036697247,-118,0.5183958399473338,CWS,SEA,2022 REG,10,6,8,4,10,18,1,0,2,-2,1,1,1,1,0,0,0,0,0,0.48160416005266615,0.5183958399473338
86250,0.5238095238095238,0.5192307692307692,-110,-108,0.5012646084074657,0.4987353915925343,away,CLE,over,9.5,0.5,100,0.47935779816513757,BOS,CLE,2022 REG,6,3,8,1,4,14,1,0,2,-2,1,0,0,0,0,0,0,0,0,0.47935779816513757,0.5206422018348624
86250,0.5238095238095238,0.5192307692307692,-110,-108,0.5012646084074657,0.4987353915925343,home,BOS,under,9.5,0.5412844036697247,-118,0.5206422018348624,BOS,CLE,2022 REG,6,3,8,1,4,14,1,0,2,-2,1,0,0,0,0,0,0,0,0,0.47935779816513757,0.5206422018348624
86251,0.5454545454545454,0.49751243781094534,-120,101,0.5220180091279142,0.4779819908720858,away,ARI,over,9.5,0.504950495049505,-102,0.4826715732667395,CIN,ARI,2022 REG,5,0,11,7,7,16,0,1,-7,7,0,0,0,0,0,0,0,0,0,0.4826715732667395,0.5173284267332605
86251,0.5454545454545454,0.49751243781094534,-120,101,0.5220180091279142,0.4779819908720858,home,CIN,under,9.5,0.5391705069124424,-117,0.5173284267332605,CIN,ARI,2022 REG,5,0,11,7,7,16,0,1,-7,7,0,0,0,0,0,0,0,0,0,0.4826715732667395,0.5173284267332605
86252,0.613899613899614,0.425531914893617,-159,135,0.589692613597978,0.410307386402022,away,ARI,over,12,0.5238095238095238,-110,0.5012646084074657,COL,ARI,2022 REG,12,11,9,7,18,21,1,0,4,-4,1,1,1,1,1,1,1,0,0,0.5012646084074657,0.4987353915925343
86252,0.613899613899614,0.425531914893617,-159,135,0.589692613597978,0.410307386402022,home,COL,under,12,0.5192307692307692,-108,0.4987353915925343,COL,ARI,2022 REG,12,11,9,7,18,21,1,0,4,-4,1,1,1,1,1,1,1,0,0,0.5012646084074657,0.4987353915925343
86253,0.6389891696750902,0.4,-177,150,0.614075512518083,0.385924487481917,away,BAL,over,8,0.5412844036697247,-118,0.5189377998484975,CLE,BAL,2022 REG,5,0,8,4,4,13,0,1,-4,4,0,0,0,0,0,0,0,0,0,0.5189377998484975,0.4810622001515025
86253,0.6389891696750902,0.4,-177,150,0.614075512518083,0.385924487481917,home,CLE,under,8,0.5,100,0.4810622001515025,CLE,BAL,2022 REG,5,0,8,4,4,13,0,1,-4,4,0,0,0,0,0,0,0,0,0,0.5189377998484975,0.4810622001515025
86255,0.5073891625615764,0.5412844036697247,-103,-118,0.4826927225525911,0.5173072774474089,away,NYM,over,7,0.5391705069124424,-117,0.5140669063204599,STL,NYM,2022 REG,16,10,11,5,15,27,1,0,5,-5,1,1,1,1,1,0,0,0,0,0.5140669063204599,0.4859330936795401
86255,0.5073891625615764,0.5412844036697247,-103,-118,0.4826927225525911,0.5173072774474089,home,STL,under,7,0.5073891625615764,-103,0.4859330936795401,STL,NYM,2022 REG,16,10,11,5,15,27,1,0,5,-5,1,1,1,1,1,0,0,0,0,0.5140669063204599,0.4859330936795401
86256,0.5454545454545454,0.49019607843137253,-120,104,0.526008750607681,0.47399124939231896,away,TB,over,7.5,0.5238095238095238,-110,0.5012646084074657,SEA,TB,2022 REG,8,2,5,1,3,13,1,0,1,-1,1,0,0,0,0,0,0,0,0,0.5012646084074657,0.4987353915925343
86256,0.5454545454545454,0.49019607843137253,-120,104,0.526008750607681,0.47399124939231896,home,SEA,under,7.5,0.5192307692307692,-108,0.4987353915925343,SEA,TB,2022 REG,8,2,5,1,3,13,1,0,1,-1,1,0,0,0,0,0,0,0,0,0.5012646084074657,0.4987353915925343
86257,0.6402877697841727,0.3968253968253968,-178,152,0.616524663106103,0.383475336893897,away,CHC,over,8,0.5238095238095238,-110,0.5000596729920038,STL,CHC,2022 REG,6,4,9,3,7,15,1,0,1,-1,1,1,1,0,0,0,0,0,0,0.5000596729920038,0.4999403270079962
86257,0.6402877697841727,0.3968253968253968,-178,152,0.616524663106103,0.383475336893897,home,STL,under,8,0.5215311004784688,-109,0.4999403270079962,STL,CHC,2022 REG,6,4,9,3,7,15,1,0,1,-1,1,1,1,0,0,0,0,0,0,0.5000596729920038,0.4999403270079962
86258,0.696969696969697,0.3436426116838488,-230,191,0.6686641485141954,0.3313358514858046,away,COL,over,8.5,0.5348837209302326,-115,0.5097020142727117,LAD,COL,2022 REG,8,5,8,2,7,16,1,0,3,-3,1,1,0,0,0,0,0,0,0,0.5097020142727117,0.49029798572728833
86258,0.696969696969697,0.3436426116838488,-230,191,0.6686641485141954,0.3313358514858046,home,LAD,under,8.5,0.5121951219512195,-105,0.49029798572728833,LAD,COL,2022 REG,8,5,8,2,7,16,1,0,3,-3,1,1,0,0,0,0,0,0,0,0.5097020142727117,0.49029798572728833
86259,0.6226415094339623,0.4166666666666667,-165,140,0.5981666073335706,0.40183339266642937,away,BAL,over,8,0.5348837209302326,-115,0.5097020142727117,TOR,BAL,2022 REG,9,6,9,3,9,18,1,0,3,-3,1,1,1,0,0,0,0,0,0,0.5097020142727117,0.49029798572728833
86259,0.6226415094339623,0.4166666666666667,-165,140,0.5981666073335706,0.40183339266642937,home,TOR,under,8,0.5121951219512195,-105,0.49029798572728833,TOR,BAL,2022 REG,9,6,9,3,9,18,1,0,3,-3,1,1,1,0,0,0,0,0,0,0.5097020142727117,0.49029798572728833
86260,0.601593625498008,0.43859649122807015,-151,128,0.5774155074675785,0.4225844925324215,away,CLE,over,7.5,0.5,100,0.4772727272727273,CWS,CLE,2022 REG,8,6,11,3,9,19,1,0,3,-3,1,1,1,0,0,0,0,0,0,0.4772727272727273,0.5227272727272727
86260,0.601593625498008,0.43859649122807015,-151,128,0.5774155074675785,0.4225844925324215,home,CWS,under,7.5,0.5454545454545454,-120,0.5227272727272727,CWS,CLE,2022 REG,8,6,11,3,9,19,1,0,3,-3,1,1,1,0,0,0,0,0,0,0.4772727272727273,0.5227272727272727
86261,0.6323529411764706,0.40485829959514175,-172,147,0.6088223036297157,0.3911776963702843,away,LAA,over,7.5,0.5305164319248826,-113,0.5066009958897986,SEA,LAA,2022 REG,2,0,9,4,4,11,0,1,-4,4,0,0,0,0,0,0,0,0,0,0.5066009958897986,0.49339900411020143
86261,0.6323529411764706,0.40485829959514175,-172,147,0.6088223036297157,0.3911776963702843,home,SEA,under,7.5,0.5145631067961165,-106,0.49339900411020143,SEA,LAA,2022 REG,2,0,9,4,4,11,0,1,-4,4,0,0,0,0,0,0,0,0,0,0.5066009958897986,0.49339900411020143
86262,0.6551724137931035,0.3802281368821293,-190,163,0.6319789495576061,0.36802105044239386,away,DET,over,8,0.5370370370370371,-116,0.5118817074154765,SF,DET,2022 REG,7,2,9,3,5,16,0,1,-1,1,1,1,0,0,0,0,0,0,0,0.5118817074154765,0.48811829258452355
86262,0.6551724137931035,0.3802281368821293,-190,163,0.6319789495576061,0.36802105044239386,home,SF,under,8,0.5098039215686274,-104,0.48811829258452355,SF,DET,2022 REG,7,2,9,3,5,16,0,1,-1,1,1,1,0,0,0,0,0,0,0,0.5118817074154765,0.48811829258452355
86263,0.609375,0.4366812227074236,-156,129,0.5813094892876637,0.4186905107123363,away,BOS,over,8,0.5121951219512195,-105,0.48919479393107135,TOR,BOS,2022 REG,6,1,4,0,1,10,1,0,1,-1,0,0,0,0,0,0,0,0,0,0.48919479393107135,0.5108052060689287
86263,0.609375,0.4366812227074236,-156,129,0.5813094892876637,0.4186905107123363,home,TOR,under,8,0.5327102803738317,-114,0.5108052060689287,TOR,BOS,2022 REG,6,1,4,0,1,10,1,0,1,-1,0,0,0,0,0,0,0,0,0,0.48919479393107135,0.5108052060689287
86264,0.7118155619596541,0.33112582781456956,-247,202,0.6812492124661865,0.3187507875338135,away,KC,over,8.5,0.5121951219512195,-105,0.48808156828023186,SF,KC,2022 REG,5,4,8,2,6,13,1,0,2,-2,1,1,0,0,0,0,0,0,0,0.48808156828023186,0.5119184317197681
86264,0.7118155619596541,0.33112582781456956,-247,202,0.6812492124661865,0.3187507875338135,home,SF,under,8.5,0.5348837209302326,-115,0.5119184317197681,SF,KC,2022 REG,5,4,8,2,6,13,1,0,2,-2,1,1,0,0,0,0,0,0,0,0.48808156828023186,0.5119184317197681
86265,0.6240601503759399,0.4166666666666667,-166,140,0.5986441668079975,0.4013558331920025,away,COL,over,9.5,0.5,100,0.4772727272727273,MIN,COL,2022 REG,10,6,1,0,6,11,1,0,6,-6,0,0,0,0,0,0,0,0,0,0.4772727272727273,0.5227272727272727
86265,0.6240601503759399,0.4166666666666667,-166,140,0.5986441668079975,0.4013558331920025,home,MIN,under,9.5,0.5454545454545454,-120,0.5227272727272727,MIN,COL,2022 REG,10,6,1,0,6,11,1,0,6,-6,0,0,0,0,0,0,0,0,0,0.4772727272727273,0.5227272727272727
86266,0.5726495726495727,0.4672897196261683,-134,114,0.5497783539959433,0.4502216460040567,away,DET,over,8.5,0.5391705069124424,-117,0.5153817639191344,KC,DET,2022 REG,9,3,4,1,4,13,1,0,2,-2,1,0,0,0,0,0,0,0,0,0.5153817639191344,0.4846182360808656
86266,0.5726495726495727,0.4672897196261683,-134,114,0.5497783539959433,0.4502216460040567,home,KC,under,8.5,0.504950495049505,-102,0.4846182360808656,KC,DET,2022 REG,9,3,4,1,4,13,1,0,2,-2,1,0,0,0,0,0,0,0,0,0.5153817639191344,0.4846182360808656
86267,0.45454545454545453,0.5815899581589958,120,-139,0.43812026695252254,0.5618797330474774,away,ATL,over,8.5,0.5495495495495495,-122,0.5223196169142115,PHI,ATL,2022 REG,10,7,11,8,15,21,0,1,-1,1,1,1,1,1,1,1,1,0,0,0.5223196169142115,0.47768038308578853
86267,0.45454545454545453,0.5815899581589958,120,-139,0.43812026695252254,0.5618797330474774,home,PHI,under,8.5,0.5,100,0.47768038308578853,PHI,ATL,2022 REG,10,7,11,8,15,21,0,1,-1,1,1,1,1,1,1,1,1,0,0,0.5223196169142115,0.47768038308578853
86268,0.6655518394648829,0.373134328358209,-199,168,0.639804189308377,0.360195810691623,away,BAL,over,9.5,0.5283018867924528,-112,0.5044173060022736,BOS,BAL,2022 REG,14,8,15,12,20,29,0,1,-4,4,1,1,1,1,1,1,1,1,0,0.5044173060022736,0.49558269399772636
86268,0.6655518394648829,0.373134328358209,-199,168,0.639804189308377,0.360195810691623,home,BOS,under,9.5,0.5169082125603864,-107,0.49558269399772636,BOS,BAL,2022 REG,14,8,15,12,20,29,0,1,-4,4,1,1,1,1,1,1,1,1,0,0.5044173060022736,0.49558269399772636
86269,0.7304582210242588,0.3105590062111801,-271,222,0.7004968501865123,0.2995031498134877,away,WSH,over,8,0.5412844036697247,-118,0.5189377998484975,STL,WSH,2022 REG,3,0,14,6,6,17,0,1,-6,6,0,0,0,0,0,0,0,0,0,0.5189377998484975,0.4810622001515025
86269,0.7304582210242588,0.3105590062111801,-271,222,0.7004968501865123,0.2995031498134877,home,STL,under,8,0.5,100,0.4810622001515025,STL,WSH,2022 REG,3,0,14,6,6,17,0,1,-6,6,0,0,0,0,0,0,0,0,0,0.5189377998484975,0.4810622001515025
86270,0.5884773662551441,0.45248868778280543,-143,121,0.5643697706690257,0.4356302293309743,away,STL,over,7.5,0.5348837209302326,-115,0.5109810284308424,TB,STL,2022 REG,18,11,8,3,14,26,1,0,8,-8,1,1,1,0,0,0,0,0,0,0.5109810284308424,0.48901897156915763
86270,0.5884773662551441,0.45248868778280543,-143,121,0.5643697706690257,0.4356302293309743,home,TB,under,7.5,0.5098039215686274,-104,0.48901897156915763,TB,STL,2022 REG,18,11,8,3,14,26,1,0,8,-8,1,1,1,0,0,0,0,0,0,0.5109810284308424,0.48901897156915763
86271,0.41152263374485604,0.6226415094339623,143,-165,0.39746331556427233,0.6025366844357276,away,TB,over,6.5,0.5283018867924528,-112,0.5031902949311281,MIA,TB,2022 REG,5,1,10,2,3,15,0,1,-1,1,1,0,0,0,0,0,0,0,0,0.5031902949311281,0.4968097050688719
86271,0.41152263374485604,0.6226415094339623,143,-165,0.39746331556427233,0.6025366844357276,home,MIA,under,6.5,0.5192307692307692,-108,0.4968097050688719,MIA,TB,2022 REG,5,1,10,2,3,15,0,1,-1,1,1,0,0,0,0,0,0,0,0,0.5031902949311281,0.4968097050688719
86272,0.6923076923076923,0.3508771929824561,-225,185,0.6624104640298972,0.33758953597010277,away,DET,over,7.5,0.5192307692307692,-108,0.49688292476754015,CLE,DET,2022 REG,9,4,3,1,5,12,1,0,3,-3,1,0,0,0,0,0,0,0,0,0.49688292476754015,0.5031170752324599
86272,0.6923076923076923,0.3508771929824561,-225,185,0.6624104640298972,0.33758953597010277,home,CLE,under,7.5,0.5238095238095238,-110,0.5031170752324599,CLE,DET,2022 REG,9,4,3,1,5,12,1,0,3,-3,1,0,0,0,0,0,0,0,0,0.49688292476754015,0.5031170752324599
86273,0.4081632653061224,0.6226415094339623,145,-165,0.3955898878611898,0.6044101121388101,away,ATL,over,7,0.5215311004784688,-109,0.4978845547971712,STL,ATL,2022 REG,10,4,16,11,15,26,0,1,-7,7,1,1,1,1,0,0,0,0,0,0.4978845547971712,0.5021154452028288
86273,0.4081632653061224,0.6226415094339623,145,-165,0.3955898878611898,0.6044101121388101,home,STL,under,7,0.5238095238095238,-110,0.5021154452028288,STL,ATL,2022 REG,10,4,16,11,15,26,0,1,-7,7,1,1,1,1,0,0,0,0,0,0.4978845547971712,0.5021154452028288
86274,0.43103448275862066,0.607843137254902,132,-155,0.4142768879252058,0.5857231120747942,away,LAD,over,11.5,0.5098039215686274,-104,0.48483656587239576,COL,LAD,2022 REG,8,3,7,2,5,15,1,0,1,-1,1,1,0,0,0,0,0,0,0,0.48483656587239576,0.5151634341276042
86274,0.43103448275862066,0.607843137254902,132,-155,0.4142768879252058,0.5857231120747942,home,COL,under,11.5,0.5391705069124424,-117,0.5151634341276042,COL,LAD,2022 REG,8,3,7,2,5,15,1,0,1,-1,1,1,0,0,0,0,0,0,0,0.48483656587239576,0.5151634341276042
86275,0.6323529411764706,0.4081632653061224,-172,145,0.6067323988418897,0.3932676011581103,away,BAL,over,7.5,0.5454545454545454,-120,0.5206611570247933,TB,BAL,2022 REG,8,4,1,1,5,9,1,0,3,-3,1,0,0,0,0,0,0,0,0,0.5206611570247933,0.4793388429752067
86275,0.6323529411764706,0.4081632653061224,-172,145,0.6067323988418897,0.3932676011581103,home,TB,under,7.5,0.5,100,0.4793388429752067,TB,BAL,2022 REG,8,4,1,1,5,9,1,0,3,-3,1,0,0,0,0,0,0,0,0,0.5206611570247933,0.4793388429752067
86276,0.3968253968253968,0.6389891696750902,152,-177,0.3826132672617115,0.6173867327382885,away,PHI,over,8.5,0.5391705069124424,-117,0.5153817639191344,ARI,PHI,2022 REG,10,13,11,7,20,21,1,0,6,-6,1,1,1,1,1,1,1,0,0,0.5153817639191344,0.4846182360808656
86276,0.3968253968253968,0.6389891696750902,152,-177,0.3826132672617115,0.6173867327382885,home,ARI,under,8.5,0.504950495049505,-102,0.4846182360808656,ARI,PHI,2022 REG,10,13,11,7,20,21,1,0,6,-6,1,1,1,1,1,1,1,0,0,0.5153817639191344,0.4846182360808656
86277,0.6721311475409836,0.36363636363636365,-205,175,0.6480906892086682,0.3519093107913318,away,LAA,over,8.5,0.5454545454545454,-120,0.5206611570247933,LAD,LAA,2022 REG,6,4,3,1,5,9,1,0,3,-3,1,0,0,0,0,0,0,0,0,0.5206611570247933,0.4793388429752067
86277,0.6721311475409836,0.36363636363636365,-205,175,0.6480906892086682,0.3519093107913318,home,LAD,under,8.5,0.5,100,0.4793388429752067,LAD,LAA,2022 REG,6,4,3,1,5,9,1,0,3,-3,1,0,0,0,0,0,0,0,0,0.5206611570247933,0.4793388429752067
86278,0.6108949416342413,0.44052863436123346,-157,127,0.5794805391778618,0.4205194608221382,away,SF,over,8,0.5238095238095238,-110,0.5012646084074657,LAD,SF,2022 REG,8,5,7,1,6,15,1,0,4,-4,1,0,0,0,0,0,0,0,0,0.5012646084074657,0.4987353915925343
86278,0.6108949416342413,0.44052863436123346,-157,127,0.5794805391778618,0.4205194608221382,home,LAD,under,8,0.5192307692307692,-108,0.4987353915925343,LAD,SF,2022 REG,8,5,7,1,6,15,1,0,4,-4,1,0,0,0,0,0,0,0,0,0.5012646084074657,0.4987353915925343
86279,0.4464285714285714,0.5918367346938775,124,-145,0.42934584548104954,0.5706541545189505,away,MIN,over,7.5,0.5348837209302326,-115,0.5109810284308424,SEA,MIN,2022 REG,5,0,8,5,5,13,0,1,-5,5,0,0,0,0,0,0,0,0,0,0.5109810284308424,0.48901897156915763
86279,0.4464285714285714,0.5918367346938775,124,-145,0.42934584548104954,0.5706541545189505,home,SEA,under,7.5,0.5098039215686274,-104,0.48901897156915763,SEA,MIN,2022 REG,5,0,8,5,5,13,0,1,-5,5,0,0,0,0,0,0,0,0,0,0.5109810284308424,0.48901897156915763
86280,0.6825396825396826,0.35714285714285715,-215,180,0.6554547745023935,0.34454522549760647,away,DET,over,8,0.5412844036697247,-118,0.5189377998484975,BAL,DET,2022 REG,2,0,14,11,11,16,0,1,-11,11,0,0,0,0,0,0,0,0,0,0.5189377998484975,0.4810622001515025
86280,0.6825396825396826,0.35714285714285715,-215,180,0.6554547745023935,0.34454522549760647,home,BAL,under,8,0.5,100,0.4810622001515025,BAL,DET,2022 REG,2,0,14,11,11,16,0,1,-11,11,0,0,0,0,0,0,0,0,0,0.5189377998484975,0.4810622001515025
86281,0.6666666666666666,0.37593984962406013,-200,166,0.6382623224728488,0.36173767752715125,away,WSH,over,8.5,0.5454545454545454,-120,0.5233614270517961,LAA,WSH,2022 REG,8,5,11,4,9,19,1,0,1,-1,1,1,1,1,0,0,0,0,0,0.5233614270517961,0.4766385729482039
86281,0.6666666666666666,0.37593984962406013,-200,166,0.6382623224728488,0.36173767752715125,home,LAA,under,8.5,0.49504950495049505,102,0.4766385729482039,LAA,WSH,2022 REG,8,5,11,4,9,19,1,0,1,-1,1,1,1,1,0,0,0,0,0,0.5233614270517961,0.4766385729482039
86282,0.4716981132075471,0.5652173913043479,112,-130,0.4542851393811816,0.5457148606188185,away,ATL,over,8.5,0.5238095238095238,-110,0.4988662131519274,SEA,ATL,2022 REG,9,8,6,7,15,15,1,0,1,-1,1,1,1,1,1,1,1,0,0,0.4988662131519274,0.5011337868480725
86282,0.4716981132075471,0.5652173913043479,112,-130,0.4542851393811816,0.5457148606188185,home,SEA,under,8.5,0.5238095238095238,-110,0.5011337868480725,SEA,ATL,2022 REG,9,8,6,7,15,15,1,0,1,-1,1,1,1,1,1,1,1,0,0,0.4988662131519274,0.5011337868480725
86283,0.5454545454545454,0.4926108374384236,-120,103,0.5246916093311078,0.4753083906688922,away,TB,over,10,0.5098039215686274,-104,0.4870219861770517,BOS,TB,2022 REG,11,4,2,0,4,13,1,0,4,-4,0,0,0,0,0,0,0,0,0,0.4870219861770517,0.5129780138229483
86283,0.5454545454545454,0.4926108374384236,-120,103,0.5246916093311078,0.4753083906688922,home,BOS,under,10,0.5348837209302326,-115,0.5129780138229483,BOS,TB,2022 REG,11,4,2,0,4,13,1,0,4,-4,0,0,0,0,0,0,0,0,0,0.4870219861770517,0.5129780138229483
86284,0.425531914893617,0.6124031007751938,135,-158,0.4093893550345486,0.5906106449654513,away,CHC,over,8.5,0.5238095238095238,-110,0.4988662131519274,WSH,CHC,2022 REG,13,5,10,7,12,23,0,1,-2,2,1,1,1,1,1,0,0,0,0,0.4988662131519274,0.5011337868480725
86284,0.425531914893617,0.6124031007751938,135,-158,0.4093893550345486,0.5906106449654513,home,WSH,under,8.5,0.5238095238095238,-110,0.5011337868480725,WSH,CHC,2022 REG,13,5,10,7,12,23,0,1,-2,2,1,1,1,1,1,0,0,0,0,0.4988662131519274,0.5011337868480725
86285,0.5652173913043479,0.47619047619047616,-130,110,0.5418129444594474,0.4581870555405526,away,OAK,over,7.5,0.5098039215686274,-104,0.4870219861770517,CLE,OAK,2022 REG,9,5,13,10,15,22,0,1,-5,5,1,1,1,1,1,0,0,0,0,0.4870219861770517,0.5129780138229483
86285,0.5652173913043479,0.47619047619047616,-130,110,0.5418129444594474,0.4581870555405526,home,CLE,under,7.5,0.5348837209302326,-115,0.5129780138229483,CLE,OAK,2022 REG,9,5,13,10,15,22,0,1,-5,5,1,1,1,1,1,0,0,0,0,0.4870219861770517,0.5129780138229483
86286,0.5073891625615764,0.5327102803738317,-103,-114,0.487043139791394,0.512956860208606,away,TEX,over,9.5,0.504950495049505,-102,0.48160416005266615,KC,TEX,2022 REG,7,2,5,1,3,12,1,0,1,-1,1,0,0,0,0,0,0,0,0,0.48160416005266615,0.5183958399473338
86286,0.5073891625615764,0.5327102803738317,-103,-114,0.487043139791394,0.512956860208606,home,KC,under,9.5,0.5412844036697247,-118,0.5183958399473338,KC,TEX,2022 REG,7,2,5,1,3,12,1,0,1,-1,1,0,0,0,0,0,0,0,0,0.48160416005266615,0.5183958399473338
86287,0.6108949416342413,0.425531914893617,-157,135,0.5886419592417365,0.41135804075826354,away,MIA,over,9,0.5121951219512195,-105,0.48808156828023186,LAA,MIA,2022 REG,4,4,5,3,7,9,1,0,1,-1,1,1,1,0,0,0,0,0,0,0.48808156828023186,0.5119184317197681
86287,0.6108949416342413,0.425531914893617,-157,135,0.5886419592417365,0.41135804075826354,home,LAA,under,9,0.5348837209302326,-115,0.5119184317197681,LAA,MIA,2022 REG,4,4,5,3,7,9,1,0,1,-1,1,1,1,0,0,0,0,0,0,0.48808156828023186,0.5119184317197681
86288,0.4807692307692307,0.5575221238938054,108,-126,0.46235992564277106,0.5376400743572289,away,PHI,over,8,0.5348837209302326,-115,0.5109810284308424,MIL,PHI,2022 REG,5,0,14,10,10,19,0,1,-10,10,0,0,0,0,0,0,0,0,0,0.5109810284308424,0.48901897156915763
86288,0.4807692307692307,0.5575221238938054,108,-126,0.46235992564277106,0.5376400743572289,home,MIL,under,8,0.5098039215686274,-104,0.48901897156915763,MIL,PHI,2022 REG,5,0,14,10,10,19,0,1,-10,10,0,0,0,0,0,0,0,0,0,0.5109810284308424,0.48901897156915763
86289,0.36764705882352944,0.6688741721854304,172,-202,0.3542201356584706,0.6457798643415293,away,LAD,over,7.5,0.5145631067961165,-106,0.4913668392989033,LAA,LAD,2022 REG,2,1,13,9,10,15,0,1,-8,8,1,0,0,0,0,0,0,0,0,0.4913668392989033,0.5086331607010968
86289,0.36764705882352944,0.6688741721854304,172,-202,0.3542201356584706,0.6457798643415293,home,LAA,under,7.5,0.5305164319248826,-113,0.5086331607010968,LAA,LAD,2022 REG,2,1,13,9,10,15,0,1,-8,8,1,0,0,0,0,0,0,0,0,0.4913668392989033,0.5086331607010968
86290,0.43859649122807015,0.6000000000000001,128,-150,0.4216682056017235,0.5783317943982764,away,CWS,over,7.5,0.5238095238095238,-110,0.4988662131519274,CLE,CWS,2022 REG,10,2,13,8,10,23,0,1,-6,6,1,1,0,0,0,0,0,0,0,0.4988662131519274,0.5011337868480725
86290,0.43859649122807015,0.6000000000000001,128,-150,0.4216682056017235,0.5783317943982764,home,CLE,under,7.5,0.5238095238095238,-110,0.5011337868480725,CLE,CWS,2022 REG,10,2,13,8,10,23,0,1,-6,6,1,1,0,0,0,0,0,0,0,0.4988662131519274,0.5011337868480725
86291,0.5348837209302326,0.5121951219512195,-115,-105,0.5097020142727117,0.49029798572728833,away,STL,over,8.5,0.5,100,0.4772727272727273,CHC,STL,2022 REG,12,4,11,7,11,23,0,1,-3,3,1,1,1,1,0,0,0,0,0,0.4772727272727273,0.5227272727272727
86291,0.5348837209302326,0.5121951219512195,-115,-105,0.5097020142727117,0.49029798572728833,home,CHC,under,8.5,0.5454545454545454,-120,0.5227272727272727,CHC,STL,2022 REG,12,4,11,7,11,23,0,1,-3,3,1,1,1,1,0,0,0,0,0,0.4772727272727273,0.5227272727272727
86292,0.6721311475409836,0.37037037037037035,-205,170,0.6435645535349916,0.35643544646500835,away,TEX,over,9,0.5454545454545454,-120,0.5206611570247933,TOR,TEX,2022 REG,9,4,9,3,7,18,1,0,1,-1,1,1,1,0,0,0,0,0,0,0.5206611570247933,0.4793388429752067
86292,0.6721311475409836,0.37037037037037035,-205,170,0.6435645535349916,0.35643544646500835,home,TOR,under,9,0.5,100,0.4793388429752067,TOR,TEX,2022 REG,9,4,9,3,7,18,1,0,1,-1,1,1,1,0,0,0,0,0,0,0.5206611570247933,0.4793388429752067
86293,0.6453900709219857,0.3921568627450981,-182,155,0.6211576527396834,0.3788423472603166,away,TEX,over,8,0.5192307692307692,-108,0.49571111079951763,HOU,TEX,2022 REG,8,1,3,0,1,11,1,0,1,-1,0,0,0,0,0,0,0,0,0,0.49571111079951763,0.5042888892004824
86293,0.6453900709219857,0.3921568627450981,-182,155,0.6211576527396834,0.3788423472603166,home,HOU,under,8,0.5260663507109005,-111,0.5042888892004824,HOU,TEX,2022 REG,8,1,3,0,1,11,1,0,1,-1,0,0,0,0,0,0,0,0,0,0.49571111079951763,0.5042888892004824
86294,0.6108949416342413,0.425531914893617,-157,135,0.5886419592417365,0.41135804075826354,away,CLE,over,8.5,0.5145631067961165,-106,0.4913668392989033,LAA,CLE,2022 REG,8,4,4,1,5,12,1,0,3,-3,1,0,0,0,0,0,0,0,0,0.4913668392989033,0.5086331607010968
86294,0.6108949416342413,0.425531914893617,-157,135,0.5886419592417365,0.41135804075826354,home,LAA,under,8.5,0.5305164319248826,-113,0.5086331607010968,LAA,CLE,2022 REG,8,4,4,1,5,12,1,0,3,-3,1,0,0,0,0,0,0,0,0,0.4913668392989033,0.5086331607010968
86295,0.5555555555555556,0.4854368932038835,-125,106,0.5327819729114227,0.4672180270885773,away,MIN,over,7,0.5391705069124424,-117,0.5140669063204599,SEA,MIN,2022 REG,6,5,4,0,5,10,1,0,5,-5,0,0,0,0,0,0,0,0,0,0.5140669063204599,0.4859330936795401
86295,0.5555555555555556,0.4854368932038835,-125,106,0.5327819729114227,0.4672180270885773,home,SEA,under,7,0.5073891625615764,-103,0.4859330936795401,SEA,MIN,2022 REG,6,5,4,0,5,10,1,0,5,-5,0,0,0,0,0,0,0,0,0,0.5140669063204599,0.4859330936795401
86296,0.5454545454545454,0.48780487804878053,-120,105,0.5273130417254586,0.47268695827454144,away,COL,over,8,0.5238095238095238,-110,0.4988662131519274,CIN,COL,2022 REG,4,4,8,8,12,12,0,1,-4,4,1,1,1,1,0,0,0,0,0,0.4988662131519274,0.5011337868480725
86296,0.5454545454545454,0.48780487804878053,-120,105,0.5273130417254586,0.47268695827454144,home,CIN,under,8,0.5238095238095238,-110,0.5011337868480725,CIN,COL,2022 REG,4,4,8,8,12,12,0,1,-4,4,1,1,1,1,0,0,0,0,0,0.4988662131519274,0.5011337868480725
86297,0.5850622406639003,0.45454545454545453,-141,120,0.5618892737571823,0.43811072624281766,away,DET,over,9,0.5121951219512195,-105,0.48808156828023186,ARI,DET,2022 REG,13,11,8,7,18,21,1,0,4,-4,1,1,1,1,1,1,1,0,0,0.48808156828023186,0.5119184317197681
86297,0.5850622406639003,0.45454545454545453,-141,120,0.5618892737571823,0.43811072624281766,home,ARI,under,9,0.5348837209302326,-115,0.5119184317197681,ARI,DET,2022 REG,13,11,8,7,18,21,1,0,4,-4,1,1,1,1,1,1,1,0,0,0.48808156828023186,0.5119184317197681
86298,0.7304582210242588,0.31545741324921134,-271,217,0.6969187684956594,0.30308123150434063,away,STL,over,8,0.5348837209302326,-115,0.5097020142727117,TOR,STL,2022 REG,5,1,13,6,7,18,0,1,-5,5,1,0,0,0,0,0,0,0,0,0.5097020142727117,0.49029798572728833
86298,0.7304582210242588,0.31545741324921134,-271,217,0.6969187684956594,0.30308123150434063,home,TOR,under,8,0.5121951219512195,-105,0.49029798572728833,TOR,STL,2022 REG,5,1,13,6,7,18,0,1,-5,5,1,0,0,0,0,0,0,0,0,0.5097020142727117,0.49029798572728833
86299,0.5327102803738317,0.504950495049505,-114,-102,0.5126479981389701,0.4873520018610299,away,PHI,over,7.5,0.5098039215686274,-104,0.48592421718142587,SF,PHI,2022 REG,8,5,9,3,8,17,1,0,2,-2,1,1,1,0,0,0,0,0,0,0.48592421718142587,0.5140757828185741
86299,0.5327102803738317,0.504950495049505,-114,-102,0.5126479981389701,0.4873520018610299,home,SF,under,7.5,0.5370370370370371,-116,0.5140757828185741,SF,PHI,2022 REG,8,5,9,3,8,17,1,0,2,-2,1,1,1,0,0,0,0,0,0,0.48592421718142587,0.5140757828185741
86300,0.576271186440678,0.4587155963302753,-136,118,0.5561093116235184,0.4438906883764816,away,BAL,over,8,0.5192307692307692,-108,0.49688292476754015,OAK,BAL,2022 REG,7,0,5,1,1,12,0,1,-1,1,0,0,0,0,0,0,0,0,0,0.49688292476754015,0.5031170752324599
86300,0.576271186440678,0.4587155963302753,-136,118,0.5561093116235184,0.4438906883764816,home,OAK,under,8,0.5238095238095238,-110,0.5031170752324599,OAK,BAL,2022 REG,7,0,5,1,1,12,0,1,-1,1,0,0,0,0,0,0,0,0,0,0.49688292476754015,0.5031170752324599
86301,0.6453900709219857,0.3968253968253968,-182,152,0.6181446271984977,0.3818553728015023,away,OAK,over,7,0.5121951219512195,-105,0.48808156828023186,MIN,OAK,2022 REG,9,4,8,3,7,17,1,0,1,-1,1,1,1,0,0,0,0,0,0,0.48808156828023186,0.5119184317197681
86301,0.6453900709219857,0.3968253968253968,-182,152,0.6181446271984977,0.3818553728015023,home,MIN,under,7,0.5348837209302326,-115,0.5119184317197681,MIN,OAK,2022 REG,9,4,8,3,7,17,1,0,1,-1,1,1,1,0,0,0,0,0,0,0.48808156828023186,0.5119184317197681
86302,0.48780487804878053,0.5475113122171946,105,-121,0.470577468162939,0.529422531837061,away,SF,over,7.5,0.5238095238095238,-110,0.5000596729920038,CHC,SF,2022 REG,7,2,11,5,7,18,0,1,-3,3,1,1,0,0,0,0,0,0,0,0.5000596729920038,0.4999403270079962
86302,0.48780487804878053,0.5475113122171946,105,-121,0.470577468162939,0.529422531837061,home,CHC,under,7.5,0.5215311004784688,-109,0.4999403270079962,CHC,SF,2022 REG,7,2,11,5,7,18,0,1,-3,3,1,1,0,0,0,0,0,0,0,0.5000596729920038,0.4999403270079962
86303,0.5850622406639003,0.4566210045662101,-141,119,0.5606749478114291,0.4393250521885709,away,TOR,over,7.5,0.5098039215686274,-104,0.4870219861770517,NYY,TOR,2022 REG,8,5,9,3,8,17,1,0,2,-2,1,1,1,0,0,0,0,0,0,0.4870219861770517,0.5129780138229483
86303,0.5850622406639003,0.4566210045662101,-141,119,0.5606749478114291,0.4393250521885709,home,NYY,under,7.5,0.5348837209302326,-115,0.5129780138229483,NYY,TOR,2022 REG,8,5,9,3,8,17,1,0,2,-2,1,1,1,0,0,0,0,0,0,0.4870219861770517,0.5129780138229483
86304,0.613899613899614,0.425531914893617,-159,135,0.589692613597978,0.410307386402022,away,MIA,over,8.5,0.5283018867924528,-112,0.5044173060022736,NYM,MIA,2022 REG,9,6,7,0,6,16,1,0,6,-6,0,0,0,0,0,0,0,0,0,0.5044173060022736,0.49558269399772636
86304,0.613899613899614,0.425531914893617,-159,135,0.589692613597978,0.410307386402022,home,NYM,under,8.5,0.5169082125603864,-107,0.49558269399772636,NYM,MIA,2022 REG,9,6,7,0,6,16,1,0,6,-6,0,0,0,0,0,0,0,0,0,0.5044173060022736,0.49558269399772636
86305,0.6666666666666666,0.36764705882352944,-200,172,0.6437908496732027,0.35620915032679734,away,TEX,over,7,0.504950495049505,-102,0.48054649490447493,TB,TEX,2022 REG,10,5,6,3,8,16,1,0,2,-2,1,1,1,0,0,0,0,0,0,0.48054649490447493,0.5194535050955251
86305,0.6666666666666666,0.36764705882352944,-200,172,0.6437908496732027,0.35620915032679734,home,TB,under,7,0.5433789954337899,-119,0.5194535050955251,TB,TEX,2022 REG,10,5,6,3,8,16,1,0,2,-2,1,1,1,0,0,0,0,0,0,0.48054649490447493,0.5194535050955251
86306,0.6539792387543253,0.390625,-189,156,0.6248089926485555,0.3751910073514445,away,SF,over,7.5,0.5348837209302326,-115,0.5097020142727117,SD,SF,2022 REG,5,0,7,1,1,12,0,1,-1,1,0,0,0,0,0,0,0,0,0,0.5097020142727117,0.49029798572728833
86306,0.6539792387543253,0.390625,-189,156,0.6248089926485555,0.3751910073514445,home,SD,under,7.5,0.5121951219512195,-105,0.49029798572728833,SD,SF,2022 REG,5,0,7,1,1,12,0,1,-1,1,0,0,0,0,0,0,0,0,0,0.5097020142727117,0.49029798572728833
86307,0.29411764705882354,0.7455470737913487,240,-293,0.2824515526911259,0.7175484473088741,away,MIL,over,7.5,0.5327102803738317,-114,0.508788710910954,PIT,MIL,2022 REG,4,5,9,3,8,13,1,0,2,-2,1,1,1,0,0,0,0,0,0,0.508788710910954,0.491211289089046
86307,0.29411764705882354,0.7455470737913487,240,-293,0.2824515526911259,0.7175484473088741,home,PIT,under,7.5,0.5121951219512195,-105,0.491211289089046,PIT,MIL,2022 REG,4,5,9,3,8,13,1,0,2,-2,1,1,1,0,0,0,0,0,0,0.508788710910954,0.491211289089046
86308,0.6309963099630996,0.4098360655737705,-171,144,0.6052312316723071,0.3947687683276929,away,ARI,over,7,0.5,100,0.4783105022831051,MIL,ARI,2022 REG,7,2,11,4,6,18,0,1,-2,2,1,1,0,0,0,0,0,0,0,0.4783105022831051,0.5216894977168949
86308,0.6309963099630996,0.4098360655737705,-171,144,0.6052312316723071,0.3947687683276929,home,MIL,under,7,0.5433789954337899,-119,0.5216894977168949,MIL,ARI,2022 REG,7,2,11,4,6,18,0,1,-2,2,1,1,0,0,0,0,0,0,0,0.4783105022831051,0.5216894977168949
86309,0.6575342465753424,0.38167938931297707,-192,162,0.6317499380460364,0.3682500619539636,away,SEA,over,8,0.5121951219512195,-105,0.48808156828023186,HOU,SEA,2022 REG,9,4,8,5,9,17,0,1,-1,1,1,1,1,1,0,0,0,0,0,0.48808156828023186,0.5119184317197681
86309,0.6575342465753424,0.38167938931297707,-192,162,0.6317499380460364,0.3682500619539636,home,HOU,under,8,0.5348837209302326,-115,0.5119184317197681,HOU,SEA,2022 REG,9,4,8,5,9,17,0,1,-1,1,1,1,1,1,0,0,0,0,0,0.48808156828023186,0.5119184317197681
86310,0.4424778761061947,0.5967741935483871,126,-148,0.4251097036926629,0.5748902963073371,away,HOU,over,7,0.5535714285714286,-124,0.5293429871948779,TEX,HOU,2022 REG,7,2,8,4,6,15,0,1,-2,2,1,1,0,0,0,0,0,0,0,0.5293429871948779,0.47065701280512207
86310,0.4424778761061947,0.5967741935483871,126,-148,0.4251097036926629,0.5748902963073371,home,TEX,under,7,0.49019607843137253,104,0.47065701280512207,TEX,HOU,2022 REG,7,2,8,4,6,15,0,1,-2,2,1,1,0,0,0,0,0,0,0,0.5293429871948779,0.47065701280512207
86311,0.574468085106383,0.46511627906976744,-135,115,0.5517281312179562,0.44827186878204384,away,CLE,over,8.5,0.5260663507109005,-111,0.5010269332605688,BOS,CLE,2022 REG,9,6,12,7,13,21,0,1,-1,1,1,1,1,1,1,1,0,0,0,0.5010269332605688,0.4989730667394312
86311,0.574468085106383,0.46511627906976744,-135,115,0.5517281312179562,0.44827186878204384,home,BOS,under,8.5,0.5215311004784688,-109,0.4989730667394312,BOS,CLE,2022 REG,9,6,12,7,13,21,0,1,-1,1,1,1,1,1,1,1,0,0,0,0.5010269332605688,0.4989730667394312
86312,0.4,0.6402877697841727,150,-178,0.383884892086331,0.6161151079136691,away,LAD,over,7.5,0.5283018867924528,-112,0.5044173060022736,SF,LAD,2022 REG,6,3,6,4,7,12,0,1,-1,1,1,1,1,0,0,0,0,0,0,0.5044173060022736,0.49558269399772636
86312,0.4,0.6402877697841727,150,-178,0.383884892086331,0.6161151079136691,home,SF,under,7.5,0.5169082125603864,-107,0.49558269399772636,SF,LAD,2022 REG,6,3,6,4,7,12,0,1,-1,1,1,1,1,0,0,0,0,0,0,0.5044173060022736,0.49558269399772636
86313,0.5652173913043479,0.47619047619047616,-130,110,0.5418129444594474,0.4581870555405526,away,ARI,over,8.5,0.5121951219512195,-105,0.48808156828023186,WSH,ARI,2022 REG,9,2,10,11,13,19,0,1,-9,9,1,1,0,0,0,0,0,0,0,0.48808156828023186,0.5119184317197681
86313,0.5652173913043479,0.47619047619047616,-130,110,0.5418129444594474,0.4581870555405526,home,WSH,under,8.5,0.5348837209302326,-115,0.5119184317197681,WSH,ARI,2022 REG,9,2,10,11,13,19,0,1,-9,9,1,1,0,0,0,0,0,0,0,0.48808156828023186,0.5119184317197681
86314,0.36764705882352944,0.6721311475409836,172,-205,0.3530227182483408,0.64697728175165925,away,MIL,over,7.5,0.5238095238095238,-110,0.5000596729920038,PIT,MIL,2022 REG,3,2,16,19,21,19,0,1,-17,17,1,1,0,0,0,0,0,0,0,0.5000596729920038,0.4999403270079962
86314,0.36764705882352944,0.6721311475409836,172,-205,0.3530227182483408,0.64697728175165925,home,PIT,under,7.5,0.5215311004784688,-109,0.4999403270079962,PIT,MIL,2022 REG,3,2,16,19,21,19,0,1,-17,17,1,1,0,0,0,0,0,0,0,0.5000596729920038,0.4999403270079962
86315,0.46511627906976744,0.5798319327731092,115,-138,0.44421013402656906,0.5557898659734309,away,CWS,over,8,0.5238095238095238,-110,0.4988662131519274,TEX,CWS,2022 REG,9,2,15,8,10,24,0,1,-6,6,1,1,0,0,0,0,0,0,0,0.4988662131519274,0.5011337868480725
86315,0.46511627906976744,0.5798319327731092,115,-138,0.44421013402656906,0.5557898659734309,home,TEX,under,8,0.5238095238095238,-110,0.5011337868480725,TEX,CWS,2022 REG,9,2,15,8,10,24,0,1,-6,6,1,1,0,0,0,0,0,0,0,0.4988662131519274,0.5011337868480725
86316,0.35714285714285715,0.6742671009771988,180,-207,0.34592501495712286,0.6540749850428771,away,NYY,over,8,0.5348837209302326,-115,0.5097020142727117,OAK,NYY,2022 REG,8,4,4,1,5,12,1,0,3,-3,1,0,0,0,0,0,0,0,0,0.5097020142727117,0.49029798572728833
86316,0.35714285714285715,0.6742671009771988,180,-207,0.34592501495712286,0.6540749850428771,home,OAK,under,8,0.5121951219512195,-105,0.49029798572728833,OAK,NYY,2022 REG,8,4,4,1,5,12,1,0,3,-3,1,0,0,0,0,0,0,0,0,0.5097020142727117,0.49029798572728833
86317,0.5327102803738317,0.504950495049505,-114,-102,0.5126479981389701,0.4873520018610299,away,MIN,over,8.5,0.5192307692307692,-108,0.49571111079951763,SEA,MIN,2022 REG,6,2,9,3,5,15,0,1,-1,1,1,1,0,0,0,0,0,0,0,0.49571111079951763,0.5042888892004824
86317,0.5327102803738317,0.504950495049505,-114,-102,0.5126479981389701,0.4873520018610299,home,SEA,under,8.5,0.5260663507109005,-111,0.5042888892004824,SEA,MIN,2022 REG,6,2,9,3,5,15,0,1,-1,1,1,1,0,0,0,0,0,0,0,0.49571111079951763,0.5042888892004824
86318,0.609375,0.43103448275862066,-156,132,0.5847504714439656,0.41524952855603436,away,ATL,over,7,0.5,100,0.4772727272727273,NYM,ATL,2022 REG,10,5,2,2,7,12,1,0,3,-3,1,1,0,0,0,0,0,0,0,0.4772727272727273,0.5227272727272727
86318,0.609375,0.43103448275862066,-156,132,0.5847504714439656,0.41524952855603436,home,NYM,under,7,0.5454545454545454,-120,0.5227272727272727,NYM,ATL,2022 REG,10,5,2,2,7,12,1,0,3,-3,1,1,0,0,0,0,0,0,0,0.4772727272727273,0.5227272727272727
86319,0.5867768595041323,0.45248868778280543,-142,121,0.563736744980392,0.43626325501960805,away,ATL,over,8.5,0.5412844036697247,-118,0.5149381613977361,STL,ATL,2022 REG,6,6,10,3,9,16,1,0,3,-3,1,1,1,0,0,0,0,0,0,0.5149381613977361,0.48506183860226393
86319,0.5867768595041323,0.45248868778280543,-142,121,0.563736744980392,0.43626325501960805,home,STL,under,8.5,0.5073891625615764,-103,0.48506183860226393,STL,ATL,2022 REG,6,6,10,3,9,16,1,0,3,-3,1,1,1,0,0,0,0,0,0,0.5149381613977361,0.48506183860226393
86320,0.7275204359673024,0.3125,-267,220,0.6984047509447691,0.30159524905523094,away,TEX,over,8,0.5098039215686274,-104,0.4870219861770517,HOU,TEX,2022 REG,10,7,8,3,10,18,1,0,4,-4,1,1,1,0,0,0,0,0,0,0.4870219861770517,0.5129780138229483
86320,0.7275204359673024,0.3125,-267,220,0.6984047509447691,0.30159524905523094,home,HOU,under,8,0.5348837209302326,-115,0.5129780138229483,HOU,TEX,2022 REG,10,7,8,3,10,18,1,0,4,-4,1,1,1,0,0,0,0,0,0,0.4870219861770517,0.5129780138229483
86321,0.6644295302013422,0.37878787878787884,-198,164,0.6357146074501149,0.3642853925498851,away,COL,over,8,0.5348837209302326,-115,0.5097020142727117,MIL,COL,2022 REG,5,0,5,2,2,10,0,1,-2,2,0,0,0,0,0,0,0,0,0,0.5097020142727117,0.49029798572728833
86321,0.6644295302013422,0.37878787878787884,-198,164,0.6357146074501149,0.3642853925498851,home,MIL,under,8,0.5121951219512195,-105,0.49029798572728833,MIL,COL,2022 REG,5,0,5,2,2,10,0,1,-2,2,0,0,0,0,0,0,0,0,0,0.5097020142727117,0.49029798572728833
86322,0.7142857142857143,0.33112582781456956,-250,202,0.6818488984997972,0.31815110150020276,away,CIN,over,9,0.5098039215686274,-104,0.4870219861770517,LAD,CIN,2022 REG,8,5,4,2,7,12,1,0,3,-3,1,1,0,0,0,0,0,0,0,0.4870219861770517,0.5129780138229483
86322,0.7142857142857143,0.33112582781456956,-250,202,0.6818488984997972,0.31815110150020276,home,LAD,under,9,0.5348837209302326,-115,0.5129780138229483,LAD,CIN,2022 REG,8,5,4,2,7,12,1,0,3,-3,1,1,0,0,0,0,0,0,0,0.4870219861770517,0.5129780138229483
86323,0.6610169491525424,0.3802281368821293,-195,163,0.6337532482143695,0.3662467517856305,away,TEX,over,8,0.5412844036697247,-118,0.5149381613977361,HOU,TEX,2022 REG,8,5,9,2,7,17,1,0,3,-3,1,1,0,0,0,0,0,0,0,0.5149381613977361,0.48506183860226393
86323,0.6610169491525424,0.3802281368821293,-195,163,0.6337532482143695,0.3662467517856305,home,HOU,under,8,0.5073891625615764,-103,0.48506183860226393,HOU,TEX,2022 REG,8,5,9,2,7,17,1,0,3,-3,1,1,0,0,0,0,0,0,0,0.5149381613977361,0.48506183860226393
86324,0.6240601503759399,0.41493775933609955,-166,141,0.5997231089766972,0.40027689102330277,away,BAL,over,9,0.5121951219512195,-105,0.48808156828023186,TOR,BAL,2022 REG,8,6,5,3,9,13,1,0,3,-3,1,1,1,0,0,0,0,0,0,0.48808156828023186,0.5119184317197681
86324,0.6240601503759399,0.41493775933609955,-166,141,0.5997231089766972,0.40027689102330277,home,TOR,under,9,0.5348837209302326,-115,0.5119184317197681,TOR,BAL,2022 REG,8,6,5,3,9,13,1,0,3,-3,1,1,1,0,0,0,0,0,0,0.48808156828023186,0.5119184317197681
86325,0.5633187772925764,0.4807692307692307,-129,108,0.5384831744979339,0.4615168255020661,away,STL,over,7.5,0.5073891625615764,-103,0.4837652908580103,MIA,STL,2022 REG,7,5,5,0,5,12,1,0,5,-5,0,0,0,0,0,0,0,0,0,0.4837652908580103,0.5162347091419897
86325,0.5633187772925764,0.4807692307692307,-129,108,0.5384831744979339,0.4615168255020661,home,MIA,under,7.5,0.5391705069124424,-117,0.5162347091419897,MIA,STL,2022 REG,7,5,5,0,5,12,1,0,5,-5,0,0,0,0,0,0,0,0,0,0.4837652908580103,0.5162347091419897
86326,0.49751243781094534,0.5433789954337899,101,-119,0.4771684411717736,0.5228315588282264,away,CLE,over,7.5,0.5121951219512195,-105,0.48808156828023186,MIN,CLE,2022 REG,12,4,7,6,10,19,0,1,-2,2,1,1,1,1,0,0,0,0,0,0.48808156828023186,0.5119184317197681
86326,0.49751243781094534,0.5433789954337899,101,-119,0.4771684411717736,0.5228315588282264,home,MIN,under,7.5,0.5348837209302326,-115,0.5119184317197681,MIN,CLE,2022 REG,12,4,7,6,10,19,0,1,-2,2,1,1,1,1,0,0,0,0,0,0.48808156828023186,0.5119184317197681
86327,0.6183206106870228,0.4184100418410042,-162,139,0.5956092911849603,0.4043907088150397,away,WSH,over,8.5,0.5305164319248826,-113,0.5066009958897986,ARI,WSH,2022 REG,12,10,3,1,11,15,1,0,9,-9,1,0,0,0,0,0,0,0,0,0.5066009958897986,0.49339900411020143
86327,0.6183206106870228,0.4184100418410042,-162,139,0.5956092911849603,0.4043907088150397,home,ARI,under,8.5,0.5145631067961165,-106,0.49339900411020143,ARI,WSH,2022 REG,12,10,3,1,11,15,1,0,9,-9,1,0,0,0,0,0,0,0,0,0.5066009958897986,0.49339900411020143
86328,0.7267759562841529,0.3125,-266,220,0.6982311355967631,0.3017688644032369,away,COL,over,7.5,0.5073891625615764,-103,0.4837652908580103,CWS,COL,2022 REG,8,0,7,3,3,15,0,1,-3,3,0,0,0,0,0,0,0,0,0,0.4837652908580103,0.5162347091419897
86328,0.7267759562841529,0.3125,-266,220,0.6982311355967631,0.3017688644032369,home,CWS,under,7.5,0.5391705069124424,-117,0.5162347091419897,CWS,COL,2022 REG,8,0,7,3,3,15,0,1,-3,3,0,0,0,0,0,0,0,0,0,0.4837652908580103,0.5162347091419897
86329,0.5412844036697247,0.49751243781094534,-118,101,0.5202842784645914,0.47971572153540865,away,PHI,over,7.5,0.5121951219512195,-105,0.48919479393107135,NYM,PHI,2022 REG,7,5,5,4,9,12,1,0,1,-1,1,1,1,1,0,0,0,0,0,0.48919479393107135,0.5108052060689287
86329,0.5412844036697247,0.49751243781094534,-118,101,0.5202842784645914,0.47971572153540865,home,NYM,under,7.5,0.5327102803738317,-114,0.5108052060689287,NYM,PHI,2022 REG,7,5,5,4,9,12,1,0,1,-1,1,1,1,1,0,0,0,0,0,0.48919479393107135,0.5108052060689287
86330,0.609375,0.4273504273504274,-156,134,0.5869954427083333,0.41300455729166674,away,CIN,over,10.5,0.5327102803738317,-114,0.5075272610403079,COL,CIN,2022 REG,12,10,4,1,11,16,1,0,9,-9,1,0,0,0,0,0,0,0,0,0.5075272610403079,0.4924727389596921
86330,0.609375,0.4273504273504274,-156,134,0.5869954427083333,0.41300455729166674,home,COL,under,10.5,0.5145631067961165,-106,0.4924727389596921,COL,CIN,2022 REG,12,10,4,1,11,16,1,0,9,-9,1,0,0,0,0,0,0,0,0,0.5075272610403079,0.4924727389596921
86331,0.75,0.29411764705882354,-300,240,0.7169117647058822,0.28308823529411775,away,COL,over,8,0.5073891625615764,-103,0.4837652908580103,SD,COL,2022 REG,9,3,14,7,10,23,0,1,-4,4,1,1,1,0,0,0,0,0,0,0.4837652908580103,0.5162347091419897
86331,0.75,0.29411764705882354,-300,240,0.7169117647058822,0.28308823529411775,home,SD,under,8,0.5391705069124424,-117,0.5162347091419897,SD,COL,2022 REG,9,3,14,7,10,23,0,1,-4,4,1,1,1,0,0,0,0,0,0,0.4837652908580103,0.5162347091419897
86332,0.5652173913043479,0.4716981132075471,-130,112,0.5443521061454507,0.4556478938545493,away,SD,over,7,0.5454545454545454,-120,0.5193043049216726,SF,SD,2022 REG,11,5,7,6,11,18,0,1,-1,1,1,1,1,1,1,0,0,0,0,0.5193043049216726,0.48069569507832743
86332,0.5652173913043479,0.4716981132075471,-130,112,0.5443521061454507,0.4556478938545493,home,SF,under,7,0.5024875621890548,-101,0.48069569507832743,SF,SD,2022 REG,11,5,7,6,11,18,0,1,-1,1,1,1,1,1,1,0,0,0,0,0.5193043049216726,0.48069569507832743
86333,0.5901639344262295,0.45454545454545453,-144,120,0.5637780655249077,0.4362219344750923,away,MIA,over,7.5,0.5145631067961165,-106,0.4913668392989033,CHC,MIA,2022 REG,4,2,7,1,3,11,1,0,1,-1,1,0,0,0,0,0,0,0,0,0.4913668392989033,0.5086331607010968
86333,0.5901639344262295,0.45454545454545453,-144,120,0.5637780655249077,0.4362219344750923,home,CHC,under,7.5,0.5305164319248826,-113,0.5086331607010968,CHC,MIA,2022 REG,4,2,7,1,3,11,1,0,1,-1,1,0,0,0,0,0,0,0,0,0.4913668392989033,0.5086331607010968
86334,0.7601918465227817,0.2777777777777778,-317,260,0.731327647713963,0.26867235228603703,away,SF,over,9,0.5073891625615764,-103,0.4837652908580103,LAD,SF,2022 REG,8,6,8,3,9,16,1,0,3,-3,1,1,1,0,0,0,0,0,0,0.4837652908580103,0.5162347091419897
86334,0.7601918465227817,0.2777777777777778,-317,260,0.731327647713963,0.26867235228603703,home,LAD,under,9,0.5391705069124424,-117,0.5162347091419897,LAD,SF,2022 REG,8,6,8,3,9,16,1,0,3,-3,1,1,1,0,0,0,0,0,0,0.4837652908580103,0.5162347091419897
86335,0.425531914893617,0.6183206106870228,135,-162,0.406871265710366,0.593128734289634,away,TOR,over,10.5,0.5348837209302326,-115,0.5097020142727117,BOS,TOR,2022 REG,9,4,15,8,12,24,0,1,-4,4,1,1,1,1,0,0,0,0,0,0.5097020142727117,0.49029798572728833
86335,0.425531914893617,0.6183206106870228,135,-162,0.406871265710366,0.593128734289634,home,BOS,under,10.5,0.5121951219512195,-105,0.49029798572728833,BOS,TOR,2022 REG,9,4,15,8,12,24,0,1,-4,4,1,1,1,1,0,0,0,0,0,0.5097020142727117,0.49029798572728833
86336,0.5215311004784688,0.5121951219512195,-109,-105,0.5039418265797319,0.49605817342026814,away,TB,over,8.5,0.5,100,0.47935779816513757,BOS,TB,2022 REG,13,4,17,12,16,30,0,1,-8,8,1,1,1,1,0,0,0,0,0,0.47935779816513757,0.5206422018348624
86336,0.5215311004784688,0.5121951219512195,-109,-105,0.5039418265797319,0.49605817342026814,home,BOS,under,8.5,0.5412844036697247,-118,0.5206422018348624,BOS,TB,2022 REG,13,4,17,12,16,30,0,1,-8,8,1,1,1,1,0,0,0,0,0,0.47935779816513757,0.5206422018348624
86337,0.6774193548387096,0.35714285714285715,-210,180,0.6540062434963579,0.34599375650364206,away,PIT,over,9,0.5,100,0.4772727272727273,STL,PIT,2022 REG,14,9,1,1,10,15,1,0,8,-8,1,0,0,0,0,0,0,0,0,0.4772727272727273,0.5227272727272727
86337,0.6774193548387096,0.35714285714285715,-210,180,0.6540062434963579,0.34599375650364206,home,STL,under,9,0.5454545454545454,-120,0.5227272727272727,STL,PIT,2022 REG,14,9,1,1,10,15,1,0,8,-8,1,0,0,0,0,0,0,0,0,0.4772727272727273,0.5227272727272727
86338,0.6240601503759399,0.42372881355932196,-166,136,0.5942369623561901,0.40576303764380994,away,CLE,over,9.5,0.5,100,0.47522522522522526,MIN,CLE,2022 REG,9,5,12,6,11,21,0,1,-1,1,1,1,1,1,1,0,0,0,0,0.47522522522522526,0.5247747747747747
86338,0.6240601503759399,0.42372881355932196,-166,136,0.5942369623561901,0.40576303764380994,home,MIN,under,9.5,0.5495495495495495,-122,0.5247747747747747,MIN,CLE,2022 REG,9,5,12,6,11,21,0,1,-1,1,1,1,1,1,1,0,0,0,0,0.47522522522522526,0.5247747747747747
86339,0.504950495049505,0.5391705069124424,-102,-117,0.4826715732667395,0.5173284267332605,away,KC,over,7,0.5348837209302326,-115,0.5097020142727117,BAL,KC,2022 REG,15,4,11,6,10,26,0,1,-2,2,1,1,1,1,0,0,0,0,0,0.5097020142727117,0.49029798572728833
86339,0.504950495049505,0.5391705069124424,-102,-117,0.4826715732667395,0.5173284267332605,home,BAL,under,7,0.5121951219512195,-105,0.49029798572728833,BAL,KC,2022 REG,15,4,11,6,10,26,0,1,-2,2,1,1,1,1,0,0,0,0,0,0.5097020142727117,0.49029798572728833
86340,0.5073891625615764,0.5348837209302326,-103,-115,0.4859403596076043,0.5140596403923957,away,MIL,over,9.5,0.5348837209302326,-115,0.5097020142727117,CIN,MIL,2022 REG,8,4,7,5,9,15,0,1,-1,1,1,1,1,1,0,0,0,0,0,0.5097020142727117,0.49029798572728833
86340,0.5073891625615764,0.5348837209302326,-103,-115,0.4859403596076043,0.5140596403923957,home,CIN,under,9.5,0.5121951219512195,-105,0.49029798572728833,CIN,MIL,2022 REG,8,4,7,5,9,15,0,1,-1,1,1,1,1,1,0,0,0,0,0,0.5097020142727117,0.49029798572728833
86341,0.5121951219512195,0.5283018867924528,-105,-112,0.49145275161909474,0.5085472483809053,away,NYY,over,7.5,0.5348837209302326,-115,0.5109810284308424,NYM,NYY,2022 REG,10,6,9,3,9,19,1,0,3,-3,1,1,1,0,0,0,0,0,0,0.5109810284308424,0.48901897156915763
86341,0.5121951219512195,0.5283018867924528,-105,-112,0.49145275161909474,0.5085472483809053,home,NYM,under,7.5,0.5098039215686274,-104,0.48901897156915763,NYM,NYY,2022 REG,10,6,9,3,9,19,1,0,3,-3,1,1,1,0,0,0,0,0,0,0.5109810284308424,0.48901897156915763
86342,0.7762863534675616,0.2631578947368421,-347,280,0.7456663218636956,0.25433367813630436,away,OAK,over,8.5,0.5305164319248826,-113,0.5066009958897986,HOU,OAK,2022 REG,11,7,11,5,12,22,1,0,2,-2,1,1,1,1,1,0,0,0,0,0.5066009958897986,0.49339900411020143
86342,0.7762863534675616,0.2631578947368421,-347,280,0.7456663218636956,0.25433367813630436,home,HOU,under,8.5,0.5145631067961165,-106,0.49339900411020143,HOU,OAK,2022 REG,11,7,11,5,12,22,1,0,2,-2,1,1,1,1,1,0,0,0,0,0.5066009958897986,0.49339900411020143
86343,0.4347826086956522,0.6108949416342413,130,-157,0.4149228042043941,0.5850771957956059,away,CLE,over,7.5,0.5305164319248826,-113,0.5066009958897986,DET,CLE,2022 REG,4,2,7,1,3,11,1,0,1,-1,1,0,0,0,0,0,0,0,0,0.5066009958897986,0.49339900411020143
86343,0.4347826086956522,0.6108949416342413,130,-157,0.4149228042043941,0.5850771957956059,home,DET,under,7.5,0.5145631067961165,-106,0.49339900411020143,DET,CLE,2022 REG,4,2,7,1,3,11,1,0,1,-1,1,0,0,0,0,0,0,0,0,0.5066009958897986,0.49339900411020143
86344,0.6376811594202898,0.4,-176,150,0.6136525939928585,0.38634740600714146,away,COL,over,8.5,0.5433789954337899,-119,0.5198077604720502,ARI,COL,2022 REG,9,5,9,6,11,18,0,1,-1,1,1,1,1,1,1,0,0,0,0,0.5198077604720502,0.48019223952794976
86344,0.6376811594202898,0.4,-176,150,0.6136525939928585,0.38634740600714146,home,ARI,under,8.5,0.5,100,0.48019223952794976,ARI,COL,2022 REG,9,5,9,6,11,18,0,1,-1,1,1,1,1,1,1,0,0,0,0,0.5198077604720502,0.48019223952794976
86345,0.4,0.6428571428571428,150,-180,0.38285714285714295,0.617142857142857,away,MIL,over,7.5,0.4926108374384236,103,0.4718421738975501,PIT,MIL,2022 REG,13,8,14,12,20,27,0,1,-4,4,1,1,1,1,1,1,1,1,0,0.4718421738975501,0.5281578261024499
86345,0.4,0.6428571428571428,150,-180,0.38285714285714295,0.617142857142857,home,PIT,under,7.5,0.5495495495495495,-122,0.5281578261024499,PIT,MIL,2022 REG,13,8,14,12,20,27,0,1,-4,4,1,1,1,1,1,1,1,1,0,0.4718421738975501,0.5281578261024499
86346,0.6000000000000001,0.43859649122807015,-150,128,0.5768421052631579,0.42315789473684207,away,MIA,over,8.5,0.5327102803738317,-114,0.508788710910954,ATL,MIA,2022 REG,6,6,5,4,10,11,1,0,2,-2,1,1,1,1,0,0,0,0,0,0.508788710910954,0.491211289089046
86346,0.6000000000000001,0.43859649122807015,-150,128,0.5768421052631579,0.42315789473684207,home,ATL,under,8.5,0.5121951219512195,-105,0.491211289089046,ATL,MIA,2022 REG,6,6,5,4,10,11,1,0,2,-2,1,1,1,1,0,0,0,0,0,0.508788710910954,0.491211289089046
86347,0.613899613899614,0.425531914893617,-159,135,0.589692613597978,0.410307386402022,away,NYM,over,8,0.5073891625615764,-103,0.4837652908580103,ATL,NYM,2022 REG,8,3,8,7,10,16,0,1,-4,4,1,1,1,0,0,0,0,0,0,0.4837652908580103,0.5162347091419897
86347,0.613899613899614,0.425531914893617,-159,135,0.589692613597978,0.410307386402022,home,ATL,under,8,0.5391705069124424,-117,0.5162347091419897,ATL,NYM,2022 REG,8,3,8,7,10,16,0,1,-4,4,1,1,1,0,0,0,0,0,0,0.4837652908580103,0.5162347091419897
86348,0.6721311475409836,0.37037037037037035,-205,170,0.6435645535349916,0.35643544646500835,away,WSH,over,7.5,0.5145631067961165,-106,0.4913668392989033,MIL,WSH,2022 REG,12,5,9,1,6,21,1,0,4,-4,1,0,0,0,0,0,0,0,0,0.4913668392989033,0.5086331607010968
86348,0.6721311475409836,0.37037037037037035,-205,170,0.6435645535349916,0.35643544646500835,home,MIL,under,7.5,0.5305164319248826,-113,0.5086331607010968,MIL,WSH,2022 REG,12,5,9,1,6,21,1,0,4,-4,1,0,0,0,0,0,0,0,0,0.4913668392989033,0.5086331607010968
86349,0.7183098591549296,0.3205128205128205,-255,212,0.690423145590771,0.309576854409229,away,PIT,over,7.5,0.5121951219512195,-105,0.48919479393107135,NYM,PIT,2022 REG,7,4,5,3,7,12,1,0,1,-1,1,1,1,0,0,0,0,0,0,0.48919479393107135,0.5108052060689287
86349,0.7183098591549296,0.3205128205128205,-255,212,0.690423145590771,0.309576854409229,home,NYM,under,7.5,0.5327102803738317,-114,0.5108052060689287,NYM,PIT,2022 REG,7,4,5,3,7,12,1,0,1,-1,1,1,1,0,0,0,0,0,0,0.48919479393107135,0.5108052060689287
86350,0.7572815533980582,0.28169014084507044,-312,255,0.7277690082430677,0.27223099175693233,away,CIN,over,8.5,0.5348837209302326,-115,0.5097020142727117,NYM,CIN,2022 REG,9,6,8,2,8,17,1,0,4,-4,1,1,0,0,0,0,0,0,0,0.5097020142727117,0.49029798572728833
86350,0.7572815533980582,0.28169014084507044,-312,255,0.7277690082430677,0.27223099175693233,home,NYM,under,8.5,0.5121951219512195,-105,0.49029798572728833,NYM,CIN,2022 REG,9,6,8,2,8,17,1,0,4,-4,1,1,0,0,0,0,0,0,0,0.5097020142727117,0.49029798572728833
86351,0.5633187772925764,0.47619047619047616,-129,110,0.5410624729287608,0.45893752707123925,away,SD,over,8,0.5121951219512195,-105,0.48919479393107135,ATL,SD,2022 REG,9,6,4,5,11,13,1,0,1,-1,1,1,1,1,1,0,0,0,0,0.48919479393107135,0.5108052060689287
86351,0.5633187772925764,0.47619047619047616,-129,110,0.5410624729287608,0.45893752707123925,home,ATL,under,8,0.5327102803738317,-114,0.5108052060689287,ATL,SD,2022 REG,9,6,4,5,11,13,1,0,1,-1,1,1,1,1,1,0,0,0,0,0.48919479393107135,0.5108052060689287
86352,0.613899613899614,0.42372881355932196,-159,136,0.5907995368109236,0.40920046318907644,away,MIA,over,7.5,0.5260663507109005,-111,0.5010269332605688,HOU,MIA,2022 REG,11,4,7,7,11,18,0,1,-3,3,1,1,1,1,0,0,0,0,0,0.5010269332605688,0.4989730667394312
86352,0.613899613899614,0.42372881355932196,-159,136,0.5907995368109236,0.40920046318907644,home,HOU,under,7.5,0.5215311004784688,-109,0.4989730667394312,HOU,MIA,2022 REG,11,4,7,7,11,18,0,1,-3,3,1,1,1,1,0,0,0,0,0,0.5010269332605688,0.4989730667394312
86353,0.4694835680751174,0.574468085106383,113,-135,0.44884898911666654,0.5511510108833335,away,NYY,over,9.5,0.5098039215686274,-104,0.48592421718142587,BOS,NYY,2022 REG,6,3,2,0,3,8,1,0,3,-3,0,0,0,0,0,0,0,0,0,0.48592421718142587,0.5140757828185741
86353,0.4694835680751174,0.574468085106383,113,-135,0.44884898911666654,0.5511510108833335,home,BOS,under,9.5,0.5370370370370371,-116,0.5140757828185741,BOS,NYY,2022 REG,6,3,2,0,3,8,1,0,3,-3,0,0,0,0,0,0,0,0,0,0.48592421718142587,0.5140757828185741
86354,0.42194092827004215,0.6168582375478928,137,-161,0.4055699722287194,0.5944300277712806,away,SF,over,11.5,0.5215311004784688,-109,0.49907282342437215,COL,SF,2022 REG,12,7,14,10,17,26,0,1,-3,3,1,1,1,1,1,1,1,0,0,0.49907282342437215,0.5009271765756278
86354,0.42194092827004215,0.6168582375478928,137,-161,0.4055699722287194,0.5944300277712806,home,COL,under,11.5,0.5215311004784688,-109,0.5009271765756278,COL,SF,2022 REG,12,7,14,10,17,26,0,1,-3,3,1,1,1,1,1,1,1,0,0,0.49907282342437215,0.5009271765756278
86355,0.4807692307692307,0.5555555555555556,108,-125,0.4633053911900066,0.5366946088099934,away,BOS,over,9,0.5238095238095238,-110,0.5012646084074657,DET,BOS,2022 REG,5,3,9,5,8,14,0,1,-2,2,1,1,1,0,0,0,0,0,0,0.5012646084074657,0.4987353915925343
86355,0.4807692307692307,0.5555555555555556,108,-125,0.4633053911900066,0.5366946088099934,home,DET,under,9,0.5192307692307692,-108,0.4987353915925343,DET,BOS,2022 REG,5,3,9,5,8,14,0,1,-2,2,1,1,1,0,0,0,0,0,0,0.5012646084074657,0.4987353915925343
86356,0.6987951807228916,0.33444816053511706,-232,199,0.6755648940606687,0.32443510593933134,away,SD,over,8.5,0.5370370370370371,-116,0.5118817074154765,LAD,SD,2022 REG,13,12,2,1,13,15,1,0,11,-11,1,0,0,0,0,0,0,0,0,0.5118817074154765,0.48811829258452355
86356,0.6987951807228916,0.33444816053511706,-232,199,0.6755648940606687,0.32443510593933134,home,LAD,under,8.5,0.5098039215686274,-104,0.48811829258452355,LAD,SD,2022 REG,13,12,2,1,13,15,1,0,11,-11,1,0,0,0,0,0,0,0,0,0.5118817074154765,0.48811829258452355
86358,0.6575342465753424,0.37878787878787884,-192,164,0.6336512052406216,0.3663487947593784,away,CHC,over,9,0.5098039215686274,-104,0.48592421718142587,STL,CHC,2022 REG,10,5,8,3,8,18,1,0,2,-2,1,1,1,0,0,0,0,0,0,0.48592421718142587,0.5140757828185741
86358,0.6575342465753424,0.37878787878787884,-192,164,0.6336512052406216,0.3663487947593784,home,STL,under,9,0.5370370370370371,-116,0.5140757828185741,STL,CHC,2022 REG,10,5,8,3,8,18,1,0,2,-2,1,1,1,0,0,0,0,0,0,0.48592421718142587,0.5140757828185741
86359,0.3968253968253968,0.646643109540636,152,-183,0.3795759895372886,0.6204240104627115,away,HOU,over,8,0.5283018867924528,-112,0.5056562298022652,CLE,HOU,2022 REG,3,0,11,6,6,14,0,1,-6,6,0,0,0,0,0,0,0,0,0,0.5056562298022652,0.4943437701977348
86359,0.3968253968253968,0.646643109540636,152,-183,0.3795759895372886,0.6204240104627115,home,CLE,under,8,0.5145631067961165,-106,0.4943437701977348,CLE,HOU,2022 REG,3,0,11,6,6,14,0,1,-6,6,0,0,0,0,0,0,0,0,0,0.5056562298022652,0.4943437701977348
86360,0.41493775933609955,0.6240601503759399,141,-166,0.3987560540613944,0.6012439459386056,away,HOU,over,7,0.49504950495049505,102,0.4739797934813417,OAK,HOU,2022 REG,6,5,7,3,8,13,1,0,2,-2,1,1,1,0,0,0,0,0,0,0.4739797934813417,0.5260202065186583
86360,0.41493775933609955,0.6240601503759399,141,-166,0.3987560540613944,0.6012439459386056,home,OAK,under,7,0.5475113122171946,-121,0.5260202065186583,OAK,HOU,2022 REG,6,5,7,3,8,13,1,0,2,-2,1,1,1,0,0,0,0,0,0,0.4739797934813417,0.5260202065186583
86361,0.5454545454545454,0.49504950495049505,-120,102,0.5233614270517961,0.4766385729482039,away,TOR,over,7.5,0.5348837209302326,-115,0.5109810284308424,NYY,TOR,2022 REG,6,4,5,2,6,11,1,0,2,-2,1,1,0,0,0,0,0,0,0,0.5109810284308424,0.48901897156915763
86361,0.5454545454545454,0.49504950495049505,-120,102,0.5233614270517961,0.4766385729482039,home,NYY,under,7.5,0.5098039215686274,-104,0.48901897156915763,NYY,TOR,2022 REG,6,4,5,2,6,11,1,0,2,-2,1,1,0,0,0,0,0,0,0,0.5109810284308424,0.48901897156915763
86362,0.5780590717299579,0.4629629629629629,-137,116,0.5543459124348938,0.44565408756510616,away,SF,over,6.5,0.5495495495495495,-122,0.5250401592387142,LAD,SF,2022 REG,5,3,6,1,4,11,1,0,2,-2,1,0,0,0,0,0,0,0,0,0.5250401592387142,0.47495984076128583
86362,0.5780590717299579,0.4629629629629629,-137,116,0.5543459124348938,0.44565408756510616,home,LAD,under,6.5,0.49504950495049505,102,0.47495984076128583,LAD,SF,2022 REG,5,3,6,1,4,11,1,0,2,-2,1,0,0,0,0,0,0,0,0,0.5250401592387142,0.47495984076128583
86363,0.7118155619596541,0.33112582781456956,-247,202,0.6812492124661865,0.3187507875338135,away,PIT,over,9.5,0.5,100,0.4772727272727273,ATL,PIT,2022 REG,7,5,7,3,8,14,1,0,2,-2,1,1,1,0,0,0,0,0,0,0.4772727272727273,0.5227272727272727
86363,0.7118155619596541,0.33112582781456956,-247,202,0.6812492124661865,0.3187507875338135,home,ATL,under,9.5,0.5454545454545454,-120,0.5227272727272727,ATL,PIT,2022 REG,7,5,7,3,8,14,1,0,2,-2,1,1,1,0,0,0,0,0,0,0.4772727272727273,0.5227272727272727
86364,0.6153846153846154,0.425531914893617,-160,135,0.5902052121364724,0.40979478786352763,away,DET,over,7,0.5370370370370371,-116,0.5118817074154765,SEA,DET,2022 REG,12,7,10,6,13,22,1,0,1,-1,1,1,1,1,1,1,0,0,0,0.5118817074154765,0.48811829258452355
86364,0.6153846153846154,0.425531914893617,-160,135,0.5902052121364724,0.40979478786352763,home,SEA,under,7,0.5098039215686274,-104,0.48811829258452355,SEA,DET,2022 REG,12,7,10,6,13,22,1,0,1,-1,1,1,1,1,1,1,0,0,0,0.5118817074154765,0.48811829258452355
86365,0.696969696969697,0.3436426116838488,-230,191,0.6686641485141954,0.3313358514858046,away,OAK,over,6.5,0.5495495495495495,-122,0.5250401592387142,SEA,OAK,2022 REG,7,5,2,1,6,9,1,0,4,-4,1,0,0,0,0,0,0,0,0,0.5250401592387142,0.47495984076128583
86365,0.696969696969697,0.3436426116838488,-230,191,0.6686641485141954,0.3313358514858046,home,SEA,under,6.5,0.49504950495049505,102,0.47495984076128583,SEA,OAK,2022 REG,7,5,2,1,6,9,1,0,4,-4,1,0,0,0,0,0,0,0,0,0.5250401592387142,0.47495984076128583
86366,0.3333333333333333,0.7058823529411764,200,-240,0.32026143790849676,0.6797385620915033,away,NYY,over,8.5,0.5238095238095238,-110,0.5012646084074657,BAL,NYY,2022 REG,10,6,11,3,9,21,1,0,3,-3,1,1,1,0,0,0,0,0,0,0.5012646084074657,0.4987353915925343
86366,0.3333333333333333,0.7058823529411764,200,-240,0.32026143790849676,0.6797385620915033,home,BAL,under,8.5,0.5192307692307692,-108,0.4987353915925343,BAL,NYY,2022 REG,10,6,11,3,9,21,1,0,3,-3,1,1,1,0,0,0,0,0,0,0.5012646084074657,0.4987353915925343
86367,0.4672897196261683,0.5708154506437768,114,-133,0.44948356529441824,0.5505164347055818,away,TOR,over,7.5,0.5283018867924528,-112,0.5044173060022736,SEA,TOR,2022 REG,3,2,5,1,3,8,1,0,1,-1,1,0,0,0,0,0,0,0,0,0.5044173060022736,0.49558269399772636
86367,0.4672897196261683,0.5708154506437768,114,-133,0.44948356529441824,0.5505164347055818,home,SEA,under,7.5,0.5169082125603864,-107,0.49558269399772636,SEA,TOR,2022 REG,3,2,5,1,3,8,1,0,1,-1,1,0,0,0,0,0,0,0,0,0.5044173060022736,0.49558269399772636
86368,0.613899613899614,0.42372881355932196,-159,136,0.5907995368109236,0.40920046318907644,away,SEA,over,8.5,0.5215311004784688,-109,0.49907282342437215,HOU,SEA,2022 REG,5,4,4,0,4,9,1,0,4,-4,0,0,0,0,0,0,0,0,0,0.49907282342437215,0.5009271765756278
86368,0.613899613899614,0.42372881355932196,-159,136,0.5907995368109236,0.40920046318907644,home,HOU,under,8.5,0.5215311004784688,-109,0.5009271765756278,HOU,SEA,2022 REG,5,4,4,0,4,9,1,0,4,-4,0,0,0,0,0,0,0,0,0,0.49907282342437215,0.5009271765756278
86369,0.6774193548387096,0.36101083032490977,-210,177,0.6513860035988384,0.34861399640116164,away,PIT,over,7,0.5454545454545454,-120,0.5206611570247933,STL,PIT,2022 REG,6,2,6,1,3,12,1,0,1,-1,1,0,0,0,0,0,0,0,0,0.5206611570247933,0.4793388429752067
86369,0.6774193548387096,0.36101083032490977,-210,177,0.6513860035988384,0.34861399640116164,home,STL,under,7,0.5,100,0.4793388429752067,STL,PIT,2022 REG,6,2,6,1,3,12,1,0,1,-1,1,0,0,0,0,0,0,0,0,0.5206611570247933,0.4793388429752067
86370,0.4739336492890995,0.5652173913043479,111,-130,0.4553786537471813,0.5446213462528187,away,TOR,over,7.5,0.5098039215686274,-104,0.4870219861770517,TB,TOR,2022 REG,6,3,5,0,3,11,1,0,3,-3,0,0,0,0,0,0,0,0,0,0.4870219861770517,0.5129780138229483
86370,0.4739336492890995,0.5652173913043479,111,-130,0.4553786537471813,0.5446213462528187,home,TB,under,7.5,0.5348837209302326,-115,0.5129780138229483,TB,TOR,2022 REG,6,3,5,0,3,11,1,0,3,-3,0,0,0,0,0,0,0,0,0,0.4870219861770517,0.5129780138229483
86371,0.6336996336996338,0.41152263374485604,-173,143,0.6050422993849938,0.39495770061500624,away,DET,over,8.5,0.5238095238095238,-110,0.4988662131519274,CWS,DET,2022 REG,11,8,6,0,8,17,1,0,8,-8,0,0,0,0,0,0,0,0,0,0.4988662131519274,0.5011337868480725
86371,0.6336996336996338,0.41152263374485604,-173,143,0.6050422993849938,0.39495770061500624,home,CWS,under,8.5,0.5238095238095238,-110,0.5011337868480725,CWS,DET,2022 REG,11,8,6,0,8,17,1,0,8,-8,0,0,0,0,0,0,0,0,0,0.4988662131519274,0.5011337868480725
86372,0.48780487804878053,0.5495495495495495,105,-122,0.4695832060495952,0.5304167939504048,away,MIN,over,7.5,0.5145631067961165,-106,0.4913668392989033,TEX,MIN,2022 REG,8,6,11,5,11,19,1,0,1,-1,1,1,1,1,1,0,0,0,0,0.4913668392989033,0.5086331607010968
86372,0.48780487804878053,0.5495495495495495,105,-122,0.4695832060495952,0.5304167939504048,home,TEX,under,7.5,0.5305164319248826,-113,0.5086331607010968,TEX,MIN,2022 REG,8,6,11,5,11,19,1,0,1,-1,1,1,1,1,1,0,0,0,0,0.4913668392989033,0.5086331607010968
86373,0.5348837209302326,0.5024875621890548,-115,-101,0.514894429959451,0.485105570040549,away,MIN,over,9.5,0.5073891625615764,-103,0.4837652908580103,MIL,MIN,2022 REG,11,7,7,6,13,18,1,0,1,-1,1,1,1,1,1,1,0,0,0,0.4837652908580103,0.5162347091419897
86373,0.5348837209302326,0.5024875621890548,-115,-101,0.514894429959451,0.485105570040549,home,MIL,under,9.5,0.5391705069124424,-117,0.5162347091419897,MIL,MIN,2022 REG,11,7,7,6,13,18,1,0,1,-1,1,1,1,1,1,1,0,0,0,0.4837652908580103,0.5162347091419897
86374,0.7014925373134329,0.3424657534246575,-235,192,0.6706561244076082,0.32934387559239175,away,BAL,over,8.5,0.5121951219512195,-105,0.48808156828023186,TB,BAL,2022 REG,8,5,8,3,8,16,1,0,2,-2,1,1,1,0,0,0,0,0,0,0.48808156828023186,0.5119184317197681
86374,0.7014925373134329,0.3424657534246575,-235,192,0.6706561244076082,0.32934387559239175,home,TB,under,8.5,0.5348837209302326,-115,0.5119184317197681,TB,BAL,2022 REG,8,5,8,3,8,16,1,0,2,-2,1,1,1,0,0,0,0,0,0,0.48808156828023186,0.5119184317197681
86375,0.6666666666666666,0.37037037037037035,-200,170,0.6419753086419753,0.3580246913580247,away,TEX,over,8.5,0.5192307692307692,-108,0.49571111079951763,HOU,TEX,2022 REG,10,5,6,1,6,16,1,0,4,-4,1,0,0,0,0,0,0,0,0,0.49571111079951763,0.5042888892004824
86375,0.6666666666666666,0.37037037037037035,-200,170,0.6419753086419753,0.3580246913580247,home,HOU,under,8.5,0.5260663507109005,-111,0.5042888892004824,HOU,TEX,2022 REG,10,5,6,1,6,16,1,0,4,-4,1,0,0,0,0,0,0,0,0,0.49571111079951763,0.5042888892004824
86376,0.5454545454545454,0.49504950495049505,-120,102,0.5233614270517961,0.4766385729482039,away,SF,over,8,0.5391705069124424,-117,0.5140669063204599,PHI,SF,2022 REG,10,6,5,5,11,15,1,0,1,-1,1,1,1,1,1,0,0,0,0,0.5140669063204599,0.4859330936795401
86376,0.5454545454545454,0.49504950495049505,-120,102,0.5233614270517961,0.4766385729482039,home,PHI,under,8,0.5073891625615764,-103,0.4859330936795401,PHI,SF,2022 REG,10,6,5,5,11,15,1,0,1,-1,1,1,1,1,1,0,0,0,0,0.5140669063204599,0.4859330936795401
86377,0.765807962529274,0.27624309392265195,-327,262,0.7336049286656211,0.2663950713343789,away,WSH,over,7.5,0.5327102803738317,-114,0.508788710910954,STL,WSH,2022 REG,9,6,10,5,11,19,1,0,1,-1,1,1,1,1,1,0,0,0,0,0.508788710910954,0.491211289089046
86377,0.765807962529274,0.27624309392265195,-327,262,0.7336049286656211,0.2663950713343789,home,STL,under,7.5,0.5121951219512195,-105,0.491211289089046,STL,WSH,2022 REG,9,6,10,5,11,19,1,0,1,-1,1,1,1,1,1,0,0,0,0,0.508788710910954,0.491211289089046
86378,0.6124031007751938,0.425531914893617,-158,135,0.5891715795516586,0.41082842044834145,away,PHI,over,7,0.5121951219512195,-105,0.48808156828023186,SD,PHI,2022 REG,7,2,8,6,8,15,0,1,-4,4,1,1,0,0,0,0,0,0,0,0.48808156828023186,0.5119184317197681
86378,0.6124031007751938,0.425531914893617,-158,135,0.5891715795516586,0.41082842044834145,home,SD,under,7,0.5348837209302326,-115,0.5119184317197681,SD,PHI,2022 REG,7,2,8,6,8,15,0,1,-4,4,1,1,0,0,0,0,0,0,0,0.48808156828023186,0.5119184317197681
86379,0.5884773662551441,0.4484304932735426,-143,123,0.5667579262855877,0.43324207371441226,away,WSH,over,7,0.5169082125603864,-107,0.49353874091423283,MIA,WSH,2022 REG,9,5,8,2,7,17,1,0,3,-3,1,1,0,0,0,0,0,0,0,0.49353874091423283,0.5064612590857671
86379,0.5884773662551441,0.4484304932735426,-143,123,0.5667579262855877,0.43324207371441226,home,MIA,under,7,0.5283018867924528,-112,0.5064612590857671,MIA,WSH,2022 REG,9,5,8,2,7,17,1,0,3,-3,1,1,0,0,0,0,0,0,0,0.49353874091423283,0.5064612590857671
86380,0.5515695067264574,0.48780487804878053,-123,105,0.5298517967383217,0.4701482032616783,away,NYM,over,10,0.5098039215686274,-104,0.4870219861770517,PHI,NYM,2022 REG,14,9,16,10,19,30,0,1,-1,1,1,1,1,1,1,1,1,1,1,0.4870219861770517,0.5129780138229483
86380,0.5515695067264574,0.48780487804878053,-123,105,0.5298517967383217,0.4701482032616783,home,PHI,under,10,0.5348837209302326,-115,0.5129780138229483,PHI,NYM,2022 REG,14,9,16,10,19,30,0,1,-1,1,1,1,1,1,1,1,1,1,1,0.4870219861770517,0.5129780138229483
86381,0.5024875621890548,0.5391705069124424,-101,-117,0.4815549006007403,0.5184450993992598,away,HOU,over,8,0.5348837209302326,-115,0.5097020142727117,LAA,HOU,2022 REG,6,2,2,0,2,8,1,0,2,-2,0,0,0,0,0,0,0,0,0,0.5097020142727117,0.49029798572728833
86381,0.5024875621890548,0.5391705069124424,-101,-117,0.4815549006007403,0.5184450993992598,home,LAA,under,8,0.5121951219512195,-105,0.49029798572728833,LAA,HOU,2022 REG,6,2,2,0,2,8,1,0,2,-2,0,0,0,0,0,0,0,0,0,0.5097020142727117,0.49029798572728833
86382,0.6183206106870228,0.42194092827004215,-162,137,0.5934260713318911,0.40657392866810893,away,CHC,over,7,0.5024875621890548,-101,0.47839724939301687,MIA,CHC,2022 REG,9,1,6,2,3,15,0,1,-1,1,1,0,0,0,0,0,0,0,0,0.47839724939301687,0.5216027506069831
86382,0.6183206106870228,0.42194092827004215,-162,137,0.5934260713318911,0.40657392866810893,home,MIA,under,7,0.5454545454545454,-120,0.5216027506069831,MIA,CHC,2022 REG,9,1,6,2,3,15,0,1,-1,1,1,0,0,0,0,0,0,0,0,0.47839724939301687,0.5216027506069831
86383,0.6389891696750902,0.4,-177,150,0.614075512518083,0.385924487481917,away,KC,over,9,0.5495495495495495,-122,0.5250401592387142,CWS,KC,2022 REG,10,1,6,2,3,16,0,1,-1,1,1,0,0,0,0,0,0,0,0,0.5250401592387142,0.47495984076128583
86383,0.6389891696750902,0.4,-177,150,0.614075512518083,0.385924487481917,home,CWS,under,9,0.49504950495049505,102,0.47495984076128583,CWS,KC,2022 REG,10,1,6,2,3,16,0,1,-1,1,1,0,0,0,0,0,0,0,0,0.5250401592387142,0.47495984076128583
86384,0.39840637450199207,0.6389891696750902,151,-177,0.3835077513238716,0.6164922486761284,away,CWS,over,7.5,0.5348837209302326,-115,0.5097020142727117,DET,CWS,2022 REG,9,1,12,5,6,21,0,1,-4,4,1,0,0,0,0,0,0,0,0,0.5097020142727117,0.49029798572728833
86384,0.39840637450199207,0.6389891696750902,151,-177,0.3835077513238716,0.6164922486761284,home,DET,under,7.5,0.5121951219512195,-105,0.49029798572728833,DET,CWS,2022 REG,9,1,12,5,6,21,0,1,-4,4,1,0,0,0,0,0,0,0,0,0.5097020142727117,0.49029798572728833
86385,0.635036496350365,0.40322580645161293,-174,148,0.6107385376367002,0.38926146236329984,away,KC,over,8.5,0.5348837209302326,-115,0.5097020142727117,MIN,KC,2022 REG,8,3,6,2,5,14,1,0,1,-1,1,1,0,0,0,0,0,0,0,0.5097020142727117,0.49029798572728833
86385,0.635036496350365,0.40322580645161293,-174,148,0.6107385376367002,0.38926146236329984,home,MIN,under,8.5,0.5121951219512195,-105,0.49029798572728833,MIN,KC,2022 REG,8,3,6,2,5,14,1,0,1,-1,1,1,0,0,0,0,0,0,0,0.5097020142727117,0.49029798572728833
86386,0.7361477572559366,0.29850746268656714,-279,235,0.7106363948180513,0.2893636051819487,away,BAL,over,8.5,0.5169082125603864,-107,0.49353874091423283,TOR,BAL,2022 REG,19,11,5,1,12,24,1,0,10,-10,1,0,0,0,0,0,0,0,0,0.49353874091423283,0.5064612590857671
86386,0.7361477572559366,0.29850746268656714,-279,235,0.7106363948180513,0.2893636051819487,home,TOR,under,8.5,0.5283018867924528,-112,0.5064612590857671,TOR,BAL,2022 REG,19,11,5,1,12,24,1,0,10,-10,1,0,0,0,0,0,0,0,0,0.49353874091423283,0.5064612590857671
86387,0.6000000000000001,0.43859649122807015,-150,128,0.5768421052631579,0.42315789473684207,away,MIA,over,7.5,0.5169082125603864,-107,0.49353874091423283,NYM,MIA,2022 REG,9,10,10,4,14,19,1,0,6,-6,1,1,1,1,0,0,0,0,0,0.49353874091423283,0.5064612590857671
86387,0.6000000000000001,0.43859649122807015,-150,128,0.5768421052631579,0.42315789473684207,home,NYM,under,7.5,0.5283018867924528,-112,0.5064612590857671,NYM,MIA,2022 REG,9,10,10,4,14,19,1,0,6,-6,1,1,1,1,0,0,0,0,0,0.49353874091423283,0.5064612590857671
86388,0.6894409937888198,0.3472222222222222,-222,188,0.6641638697066728,0.33583613029332715,away,DET,over,9,0.5024875621890548,-101,0.48049269377245407,LAA,DET,2022 REG,11,4,13,5,9,24,0,1,-1,1,1,1,1,1,0,0,0,0,0,0.48049269377245407,0.5195073062275459
86388,0.6894409937888198,0.3472222222222222,-222,188,0.6641638697066728,0.33583613029332715,home,LAA,under,9,0.5412844036697247,-118,0.5195073062275459,LAA,DET,2022 REG,11,4,13,5,9,24,0,1,-1,1,1,1,1,1,0,0,0,0,0,0.48049269377245407,0.5195073062275459
86389,0.7530864197530864,0.2801120448179272,-305,257,0.728085106928002,0.271914893071998,away,TEX,over,7.5,0.5,100,0.4783105022831051,HOU,TEX,2022 REG,8,4,12,8,12,20,0,1,-4,4,1,1,1,1,0,0,0,0,0,0.4783105022831051,0.5216894977168949
86389,0.7530864197530864,0.2801120448179272,-305,257,0.728085106928002,0.271914893071998,home,HOU,under,7.5,0.5433789954337899,-119,0.5216894977168949,HOU,TEX,2022 REG,8,4,12,8,12,20,0,1,-4,4,1,1,1,1,0,0,0,0,0,0.4783105022831051,0.5216894977168949
86390,0.5515695067264574,0.48780487804878053,-123,105,0.5298517967383217,0.4701482032616783,away,MIN,over,7.5,0.5260663507109005,-111,0.5022370601254724,CWS,MIN,2022 REG,8,1,10,10,11,18,0,1,-9,9,1,0,0,0,0,0,0,0,0,0.5022370601254724,0.4977629398745276
86390,0.5515695067264574,0.48780487804878053,-123,105,0.5298517967383217,0.4701482032616783,home,CWS,under,7.5,0.5192307692307692,-108,0.4977629398745276,CWS,MIN,2022 REG,8,1,10,10,11,18,0,1,-9,9,1,0,0,0,0,0,0,0,0,0.5022370601254724,0.4977629398745276
86391,0.626865671641791,0.4081632653061224,-168,145,0.6049072335550394,0.3950927664449606,away,ARI,over,7.5,0.5238095238095238,-110,0.4988662131519274,SD,ARI,2022 REG,16,10,8,4,14,24,1,0,6,-6,1,1,1,1,0,0,0,0,0,0.4988662131519274,0.5011337868480725
86391,0.626865671641791,0.4081632653061224,-168,145,0.6049072335550394,0.3950927664449606,home,SD,under,7.5,0.5238095238095238,-110,0.5011337868480725,SD,ARI,2022 REG,16,10,8,4,14,24,1,0,6,-6,1,1,1,1,0,0,0,0,0,0.4988662131519274,0.5011337868480725
86392,0.46511627906976744,0.5780590717299579,115,-137,0.4450347205582673,0.5549652794417327,away,MIN,over,7.5,0.5,100,0.47935779816513757,BAL,MIN,2022 REG,12,9,8,4,13,20,1,0,5,-5,1,1,1,1,0,0,0,0,0,0.47935779816513757,0.5206422018348624
86392,0.46511627906976744,0.5780590717299579,115,-137,0.4450347205582673,0.5549652794417327,home,BAL,under,7.5,0.5412844036697247,-118,0.5206422018348624,BAL,MIN,2022 REG,12,9,8,4,13,20,1,0,5,-5,1,1,1,1,0,0,0,0,0,0.47935779816513757,0.5206422018348624
86393,0.5283018867924528,0.5121951219512195,-112,-105,0.5069072406637203,0.4930927593362797,away,TB,over,8.5,0.5098039215686274,-104,0.4881300146960012,CWS,TB,2022 REG,3,3,12,9,12,15,0,1,-6,6,1,1,1,0,0,0,0,0,0,0.4881300146960012,0.5118699853039987
86393,0.5283018867924528,0.5121951219512195,-112,-105,0.5069072406637203,0.4930927593362797,home,CWS,under,8.5,0.5327102803738317,-114,0.5118699853039987,CWS,TB,2022 REG,3,3,12,9,12,15,0,1,-6,6,1,1,1,0,0,0,0,0,0,0.4881300146960012,0.5118699853039987
86394,0.42194092827004215,0.6153846153846154,137,-160,0.40619175373221195,0.593808246267788,away,HOU,over,7,0.5121951219512195,-105,0.48919479393107135,SEA,HOU,2022 REG,4,1,7,3,4,11,0,1,-2,2,1,0,0,0,0,0,0,0,0,0.48919479393107135,0.5108052060689287
86394,0.42194092827004215,0.6153846153846154,137,-160,0.40619175373221195,0.593808246267788,home,SEA,under,7,0.5327102803738317,-114,0.5108052060689287,SEA,HOU,2022 REG,4,1,7,3,4,11,0,1,-2,2,1,0,0,0,0,0,0,0,0,0.48919479393107135,0.5108052060689287
86395,0.6491228070175439,0.390625,-185,156,0.6233215989535241,0.3766784010464759,away,SD,over,7,0.5238095238095238,-110,0.4988662131519274,NYM,SD,2022 REG,4,1,8,4,5,12,0,1,-3,3,1,0,0,0,0,0,0,0,0,0.4988662131519274,0.5011337868480725
86395,0.6491228070175439,0.390625,-185,156,0.6233215989535241,0.3766784010464759,home,NYM,under,7,0.5238095238095238,-110,0.5011337868480725,NYM,SD,2022 REG,4,1,8,4,5,12,0,1,-3,3,1,0,0,0,0,0,0,0,0,0.4988662131519274,0.5011337868480725
86396,0.574468085106383,0.46511627906976744,-135,115,0.5517281312179562,0.44827186878204384,away,CHC,over,9,0.5348837209302326,-115,0.5097020142727117,PHI,CHC,2022 REG,6,2,19,15,17,25,0,1,-13,13,1,1,0,0,0,0,0,0,0,0.5097020142727117,0.49029798572728833
86396,0.574468085106383,0.46511627906976744,-135,115,0.5517281312179562,0.44827186878204384,home,PHI,under,9,0.5121951219512195,-105,0.49029798572728833,PHI,CHC,2022 REG,6,2,19,15,17,25,0,1,-13,13,1,1,0,0,0,0,0,0,0,0.5097020142727117,0.49029798572728833
86397,0.4504504504504505,0.5884773662551441,122,-143,0.4329153978803628,0.5670846021196372,away,BOS,over,8,0.5121951219512195,-105,0.48808156828023186,PIT,BOS,2022 REG,4,3,5,5,8,9,0,1,-2,2,1,1,1,0,0,0,0,0,0,0.48808156828023186,0.5119184317197681
86397,0.4504504504504505,0.5884773662551441,122,-143,0.4329153978803628,0.5670846021196372,home,PIT,under,8,0.5348837209302326,-115,0.5119184317197681,PIT,BOS,2022 REG,4,3,5,5,8,9,0,1,-2,2,1,1,1,0,0,0,0,0,0,0.48808156828023186,0.5119184317197681
86398,0.5884773662551441,0.4484304932735426,-143,123,0.5667579262855877,0.43324207371441226,away,NYY,over,7.5,0.5121951219512195,-105,0.48808156828023186,MIL,NYY,2022 REG,4,4,5,1,5,9,1,0,3,-3,1,0,0,0,0,0,0,0,0,0.48808156828023186,0.5119184317197681
86398,0.5884773662551441,0.4484304932735426,-143,123,0.5667579262855877,0.43324207371441226,home,MIL,under,7.5,0.5348837209302326,-115,0.5119184317197681,MIL,NYY,2022 REG,4,4,5,1,5,9,1,0,3,-3,1,0,0,0,0,0,0,0,0,0.48808156828023186,0.5119184317197681
86399,0.4166666666666667,0.6226415094339623,140,-165,0.4002882599580712,0.5997117400419287,away,STL,over,7.5,0.5238095238095238,-110,0.5000596729920038,PIT,STL,2022 REG,7,3,7,4,7,14,0,1,-1,1,1,1,1,0,0,0,0,0,0,0.5000596729920038,0.4999403270079962
86399,0.4166666666666667,0.6226415094339623,140,-165,0.4002882599580712,0.5997117400419287,home,PIT,under,7.5,0.5215311004784688,-109,0.4999403270079962,PIT,STL,2022 REG,7,3,7,4,7,14,0,1,-1,1,1,1,1,0,0,0,0,0,0,0.5000596729920038,0.4999403270079962
86400,0.6551724137931035,0.38167938931297707,-190,162,0.6310281289994645,0.3689718710005355,away,TOR,over,8,0.5121951219512195,-105,0.48808156828023186,NYY,TOR,2022 REG,9,2,7,5,7,16,0,1,-3,3,1,1,0,0,0,0,0,0,0,0.48808156828023186,0.5119184317197681
86400,0.6551724137931035,0.38167938931297707,-190,162,0.6310281289994645,0.3689718710005355,home,NYY,under,8,0.5348837209302326,-115,0.5119184317197681,NYY,TOR,2022 REG,9,2,7,5,7,16,0,1,-3,3,1,1,0,0,0,0,0,0,0,0.48808156828023186,0.5119184317197681
86401,0.5594713656387665,0.47846889952153115,-127,109,0.5382448736768379,0.46175512632316207,away,SD,over,7,0.5391705069124424,-117,0.5140669063204599,SF,SD,2022 REG,4,2,5,1,3,9,1,0,1,-1,1,0,0,0,0,0,0,0,0,0.5140669063204599,0.4859330936795401
86401,0.5594713656387665,0.47846889952153115,-127,109,0.5382448736768379,0.46175512632316207,home,SF,under,7,0.5073891625615764,-103,0.4859330936795401,SF,SD,2022 REG,4,2,5,1,3,9,1,0,1,-1,1,0,0,0,0,0,0,0,0,0.5140669063204599,0.4859330936795401
86402,0.5121951219512195,0.5327102803738317,-105,-114,0.48919479393107135,0.5108052060689287,away,MIN,over,7.5,0.5348837209302326,-115,0.5109810284308424,KC,MIN,2022 REG,8,6,12,7,13,20,0,1,-1,1,1,1,1,1,1,1,0,0,0,0.5109810284308424,0.48901897156915763
86402,0.5121951219512195,0.5327102803738317,-105,-114,0.48919479393107135,0.5108052060689287,home,KC,under,7.5,0.5098039215686274,-104,0.48901897156915763,KC,MIN,2022 REG,8,6,12,7,13,20,0,1,-1,1,1,1,1,1,1,1,0,0,0,0.5109810284308424,0.48901897156915763
86403,0.4672897196261683,0.5708154506437768,114,-133,0.44948356529441824,0.5505164347055818,away,PHI,over,7.5,0.5121951219512195,-105,0.48808156828023186,MIA,PHI,2022 REG,8,1,8,6,7,16,0,1,-5,5,1,0,0,0,0,0,0,0,0,0.48808156828023186,0.5119184317197681
86403,0.4672897196261683,0.5708154506437768,114,-133,0.44948356529441824,0.5505164347055818,home,MIA,under,7.5,0.5348837209302326,-115,0.5119184317197681,MIA,PHI,2022 REG,8,1,8,6,7,16,0,1,-5,5,1,0,0,0,0,0,0,0,0,0.48808156828023186,0.5119184317197681
86404,0.47619047619047616,0.5614035087719298,110,-128,0.4582885785893304,0.5417114214106695,away,CWS,over,9,0.5283018867924528,-112,0.5044173060022736,KC,CWS,2022 REG,6,3,10,5,8,16,0,1,-2,2,1,1,1,0,0,0,0,0,0,0.5044173060022736,0.49558269399772636
86404,0.47619047619047616,0.5614035087719298,110,-128,0.4582885785893304,0.5417114214106695,home,KC,under,9,0.5169082125603864,-107,0.49558269399772636,KC,CWS,2022 REG,6,3,10,5,8,16,0,1,-2,2,1,1,1,0,0,0,0,0,0,0.5044173060022736,0.49558269399772636
86405,0.3846153846153846,0.6575342465753424,160,-192,0.3684039880035665,0.6315960119964334,away,SD,over,11,0.5260663507109005,-111,0.5022370601254724,CHC,SD,2022 REG,7,4,11,6,10,18,0,1,-2,2,1,1,1,1,0,0,0,0,0,0.5022370601254724,0.4977629398745276
86405,0.3846153846153846,0.6575342465753424,160,-192,0.3684039880035665,0.6315960119964334,home,CHC,under,11,0.5192307692307692,-108,0.4977629398745276,CHC,SD,2022 REG,7,4,11,6,10,18,0,1,-2,2,1,1,1,1,0,0,0,0,0,0.5022370601254724,0.4977629398745276
86406,0.6226415094339623,0.4166666666666667,-165,140,0.5981666073335706,0.40183339266642937,away,CHC,over,7.5,0.5283018867924528,-112,0.5056562298022652,MIL,CHC,2022 REG,12,9,6,1,10,18,1,0,8,-8,1,0,0,0,0,0,0,0,0,0.5056562298022652,0.4943437701977348
86406,0.6226415094339623,0.4166666666666667,-165,140,0.5981666073335706,0.40183339266642937,home,MIL,under,7.5,0.5145631067961165,-106,0.4943437701977348,MIL,CHC,2022 REG,12,9,6,1,10,18,1,0,8,-8,1,0,0,0,0,0,0,0,0,0.5056562298022652,0.4943437701977348
86407,0.5475113122171946,0.4926108374384236,-121,103,0.5255439814102724,0.47445601858972763,away,TEX,over,9,0.5192307692307692,-108,0.49571111079951763,LAA,TEX,2022 REG,14,8,4,3,11,18,1,0,5,-5,1,1,1,0,0,0,0,0,0,0.49571111079951763,0.5042888892004824
86407,0.5475113122171946,0.4926108374384236,-121,103,0.5255439814102724,0.47445601858972763,home,LAA,under,9,0.5260663507109005,-111,0.5042888892004824,LAA,TEX,2022 REG,14,8,4,3,11,18,1,0,5,-5,1,1,1,0,0,0,0,0,0,0.49571111079951763,0.5042888892004824
86408,0.6845425867507886,0.35714285714285715,-217,180,0.6560071251579774,0.34399287484202257,away,OAK,over,8.5,0.5215311004784688,-109,0.4978845547971712,TB,OAK,2022 REG,13,9,8,8,17,21,1,0,1,-1,1,1,1,1,1,1,1,1,0,0.4978845547971712,0.5021154452028288
86408,0.6845425867507886,0.35714285714285715,-217,180,0.6560071251579774,0.34399287484202257,home,TB,under,8.5,0.5238095238095238,-110,0.5021154452028288,TB,OAK,2022 REG,13,9,8,8,17,21,1,0,1,-1,1,1,1,1,1,1,1,1,0,0.4978845547971712,0.5021154452028288
86409,0.5454545454545454,0.49751243781094534,-120,101,0.5220180091279142,0.4779819908720858,away,SF,over,7.5,0.5121951219512195,-105,0.48919479393107135,ARI,SF,2022 REG,7,5,4,2,7,11,1,0,3,-3,1,1,0,0,0,0,0,0,0,0.48919479393107135,0.5108052060689287
86409,0.5454545454545454,0.49751243781094534,-120,101,0.5220180091279142,0.4779819908720858,home,ARI,under,7.5,0.5327102803738317,-114,0.5108052060689287,ARI,SF,2022 REG,7,5,4,2,7,11,1,0,3,-3,1,1,0,0,0,0,0,0,0,0.48919479393107135,0.5108052060689287
86410,0.49504950495049505,0.5454545454545454,102,-120,0.47499799484898986,0.5250020051510101,away,CWS,over,8.5,0.5,100,0.4772727272727273,MIN,CWS,2022 REG,1,0,16,11,11,17,0,1,-11,11,0,0,0,0,0,0,0,0,0,0.4772727272727273,0.5227272727272727
86410,0.49504950495049505,0.5454545454545454,102,-120,0.47499799484898986,0.5250020051510101,home,MIN,under,8.5,0.5454545454545454,-120,0.5227272727272727,MIN,CWS,2022 REG,1,0,16,11,11,17,0,1,-11,11,0,0,0,0,0,0,0,0,0,0.4772727272727273,0.5227272727272727
86411,0.48780487804878053,0.5515695067264574,105,-123,0.4685978610852498,0.5314021389147502,away,TB,over,7,0.5192307692307692,-108,0.49688292476754015,SEA,TB,2022 REG,6,2,10,8,10,16,0,1,-6,6,1,1,0,0,0,0,0,0,0,0.49688292476754015,0.5031170752324599
86411,0.48780487804878053,0.5515695067264574,105,-123,0.4685978610852498,0.5314021389147502,home,SEA,under,7,0.5238095238095238,-110,0.5031170752324599,SEA,TB,2022 REG,6,2,10,8,10,16,0,1,-6,6,1,1,0,0,0,0,0,0,0,0.49688292476754015,0.5031170752324599
86412,0.790356394129979,0.25510204081632654,-377,292,0.7544280294030247,0.24557197059697533,away,COL,over,8.5,0.5121951219512195,-105,0.48480316980390653,ATL,COL,2022 REG,7,2,11,3,5,18,0,1,-1,1,1,1,0,0,0,0,0,0,0,0.48480316980390653,0.5151968301960934
86412,0.790356394129979,0.25510204081632654,-377,292,0.7544280294030247,0.24557197059697533,home,ATL,under,8.5,0.5412844036697247,-118,0.5151968301960934,ATL,COL,2022 REG,7,2,11,3,5,18,0,1,-1,1,1,1,0,0,0,0,0,0,0,0.48480316980390653,0.5151968301960934
86413,0.4184100418410042,0.6168582375478928,139,-161,0.4036534395862356,0.5963465604137643,away,ATL,over,9,0.5098039215686274,-104,0.48592421718142587,CHC,ATL,2022 REG,6,0,9,6,6,15,0,1,-6,6,0,0,0,0,0,0,0,0,0,0.48592421718142587,0.5140757828185741
86413,0.4184100418410042,0.6168582375478928,139,-161,0.4036534395862356,0.5963465604137643,home,CHC,under,9,0.5370370370370371,-116,0.5140757828185741,CHC,ATL,2022 REG,6,0,9,6,6,15,0,1,-6,6,0,0,0,0,0,0,0,0,0,0.48592421718142587,0.5140757828185741
86414,0.5901639344262295,0.4484304932735426,-144,123,0.5673868951280033,0.43261310487199667,away,TOR,over,7.5,0.5,100,0.4772727272727273,TB,TOR,2022 REG,11,10,8,6,16,19,1,0,4,-4,1,1,1,1,1,1,0,0,0,0.4772727272727273,0.5227272727272727
86414,0.5901639344262295,0.4484304932735426,-144,123,0.5673868951280033,0.43261310487199667,home,TB,under,7.5,0.5454545454545454,-120,0.5227272727272727,TB,TOR,2022 REG,11,10,8,6,16,19,1,0,4,-4,1,1,1,1,1,1,0,0,0,0.4772727272727273,0.5227272727272727
86415,0.5575221238938054,0.4854368932038835,-126,106,0.5335715214411116,0.46642847855888836,away,MIL,over,8,0.5412844036697247,-118,0.5189377998484975,ATL,MIL,2022 REG,10,9,4,2,11,14,1,0,7,-7,1,1,0,0,0,0,0,0,0,0.5189377998484975,0.4810622001515025
86415,0.5575221238938054,0.4854368932038835,-126,106,0.5335715214411116,0.46642847855888836,home,ATL,under,8,0.5,100,0.4810622001515025,ATL,MIL,2022 REG,10,9,4,2,11,14,1,0,7,-7,1,1,0,0,0,0,0,0,0,0.5189377998484975,0.4810622001515025
86416,0.4,0.6402877697841727,150,-178,0.383884892086331,0.6161151079136691,away,SF,over,9,0.5238095238095238,-110,0.5012646084074657,CIN,SF,2022 REG,5,3,12,2,5,17,1,0,1,-1,1,1,0,0,0,0,0,0,0,0.5012646084074657,0.4987353915925343
86416,0.4,0.6402877697841727,150,-178,0.383884892086331,0.6161151079136691,home,CIN,under,9,0.5192307692307692,-108,0.4987353915925343,CIN,SF,2022 REG,5,3,12,2,5,17,1,0,1,-1,1,1,0,0,0,0,0,0,0,0.5012646084074657,0.4987353915925343
86417,0.5726495726495727,0.46511627906976744,-134,115,0.5510229738017454,0.44897702619825464,away,CIN,over,8.5,0.5169082125603864,-107,0.49353874091423283,PIT,CIN,2022 REG,0,1,4,0,1,4,1,0,1,-1,0,0,0,0,0,0,0,0,0,0.49353874091423283,0.5064612590857671
86417,0.5726495726495727,0.46511627906976744,-134,115,0.5510229738017454,0.44897702619825464,home,PIT,under,8.5,0.5283018867924528,-112,0.5064612590857671,PIT,CIN,2022 REG,0,1,4,0,1,4,1,0,1,-1,0,0,0,0,0,0,0,0,0,0.49353874091423283,0.5064612590857671
86418,0.6000000000000001,0.4347826086956522,-150,130,0.5791304347826086,0.4208695652173914,away,BOS,over,8,0.5327102803738317,-114,0.508788710910954,NYY,BOS,2022 REG,9,5,8,4,9,17,1,0,1,-1,1,1,1,1,0,0,0,0,0,0.508788710910954,0.491211289089046
86418,0.6000000000000001,0.4347826086956522,-150,130,0.5791304347826086,0.4208695652173914,home,NYY,under,8,0.5121951219512195,-105,0.491211289089046,NYY,BOS,2022 REG,9,5,8,4,9,17,1,0,1,-1,1,1,1,1,0,0,0,0,0,0.508788710910954,0.491211289089046
86419,0.5815899581589958,0.4566210045662101,-139,119,0.5593668459464284,0.4406331540535716,away,NYM,over,7.5,0.5348837209302326,-115,0.5109810284308424,SF,NYM,2022 REG,7,3,18,13,16,25,0,1,-10,10,1,1,1,0,0,0,0,0,0,0.5109810284308424,0.48901897156915763
86419,0.5815899581589958,0.4566210045662101,-139,119,0.5593668459464284,0.4406331540535716,home,SF,under,7.5,0.5098039215686274,-104,0.48901897156915763,SF,NYM,2022 REG,7,3,18,13,16,25,0,1,-10,10,1,1,1,0,0,0,0,0,0,0.5109810284308424,0.48901897156915763
86420,0.425531914893617,0.6108949416342413,135,-157,0.41003112488176247,0.5899688751182375,away,ATL,over,7,0.5454545454545454,-120,0.5206611570247933,MIA,ATL,2022 REG,9,4,4,0,4,13,1,0,4,-4,0,0,0,0,0,0,0,0,0,0.5206611570247933,0.4793388429752067
86420,0.425531914893617,0.6108949416342413,135,-157,0.41003112488176247,0.5899688751182375,home,MIA,under,7,0.5,100,0.4793388429752067,MIA,ATL,2022 REG,9,4,4,0,4,13,1,0,4,-4,0,0,0,0,0,0,0,0,0,0.5206611570247933,0.4793388429752067
86421,0.5614035087719298,0.4739336492890995,-128,111,0.5415651042464397,0.45843489575356033,away,COL,over,8.5,0.5454545454545454,-120,0.5206611570247933,CHC,COL,2022 REG,7,2,4,1,3,11,1,0,1,-1,1,0,0,0,0,0,0,0,0,0.5206611570247933,0.4793388429752067
86421,0.5614035087719298,0.4739336492890995,-128,111,0.5415651042464397,0.45843489575356033,home,CHC,under,8.5,0.5,100,0.4793388429752067,CHC,COL,2022 REG,7,2,4,1,3,11,1,0,1,-1,1,0,0,0,0,0,0,0,0,0.5206611570247933,0.4793388429752067
86422,0.5433789954337899,0.5,-119,100,0.5198077604720502,0.48019223952794976,away,STL,over,9,0.5169082125603864,-107,0.49353874091423283,MIL,STL,2022 REG,7,4,7,5,9,14,0,1,-1,1,1,1,1,1,0,0,0,0,0,0.49353874091423283,0.5064612590857671
86422,0.5433789954337899,0.5,-119,100,0.5198077604720502,0.48019223952794976,home,MIL,under,9,0.5283018867924528,-112,0.5064612590857671,MIL,STL,2022 REG,7,4,7,5,9,14,0,1,-1,1,1,1,1,1,0,0,0,0,0,0.49353874091423283,0.5064612590857671
86423,0.3508771929824561,0.6923076923076923,185,-225,0.3357246016525795,0.6642753983474206,away,HOU,over,8,0.5283018867924528,-112,0.5044173060022736,OAK,HOU,2022 REG,10,7,7,5,12,17,1,0,2,-2,1,1,1,1,1,0,0,0,0,0.5044173060022736,0.49558269399772636
86423,0.3508771929824561,0.6923076923076923,185,-225,0.3357246016525795,0.6642753983474206,home,OAK,under,8,0.5169082125603864,-107,0.49558269399772636,OAK,HOU,2022 REG,10,7,7,5,12,17,1,0,2,-2,1,1,1,1,1,0,0,0,0,0.5044173060022736,0.49558269399772636
86424,0.5708154506437768,0.4694835680751174,-133,113,0.5478121481132493,0.4521878518867507,away,CHC,over,11.5,0.5305164319248826,-113,0.5066009958897986,COL,CHC,2022 REG,11,9,13,6,15,24,1,0,3,-3,1,1,1,1,1,1,0,0,0,0.5066009958897986,0.49339900411020143
86424,0.5708154506437768,0.4694835680751174,-133,113,0.5478121481132493,0.4521878518867507,home,COL,under,11.5,0.5145631067961165,-106,0.49339900411020143,COL,CHC,2022 REG,11,9,13,6,15,24,1,0,3,-3,1,1,1,1,1,1,0,0,0,0.5066009958897986,0.49339900411020143
86425,0.5454545454545454,0.49751243781094534,-120,101,0.5220180091279142,0.4779819908720858,away,ATL,over,8,0.5454545454545454,-120,0.5206611570247933,NYM,ATL,2022 REG,9,6,7,4,10,16,1,0,2,-2,1,1,1,1,0,0,0,0,0,0.5206611570247933,0.4793388429752067
86425,0.5454545454545454,0.49751243781094534,-120,101,0.5220180091279142,0.4779819908720858,home,NYM,under,8,0.5,100,0.4793388429752067,NYM,ATL,2022 REG,9,6,7,4,10,16,1,0,2,-2,1,1,1,1,0,0,0,0,0,0.5206611570247933,0.4793388429752067
86426,0.4444444444444444,0.5967741935483871,125,-148,0.42612504978096366,0.5738749502190363,away,SF,over,7,0.5283018867924528,-112,0.5044173060022736,STL,SF,2022 REG,17,15,7,6,21,24,1,0,9,-9,1,1,1,1,1,1,0,0,0,0.5044173060022736,0.49558269399772636
86426,0.4444444444444444,0.5967741935483871,125,-148,0.42612504978096366,0.5738749502190363,home,STL,under,7,0.5169082125603864,-107,0.49558269399772636,STL,SF,2022 REG,17,15,7,6,21,24,1,0,9,-9,1,1,1,1,1,1,0,0,0,0.5044173060022736,0.49558269399772636
86427,0.6124031007751938,0.425531914893617,-158,135,0.5891715795516586,0.41082842044834145,away,ARI,over,7.5,0.5283018867924528,-112,0.5044173060022736,SF,ARI,2022 REG,8,3,10,4,7,18,0,1,-1,1,1,1,1,0,0,0,0,0,0,0.5044173060022736,0.49558269399772636
86427,0.6124031007751938,0.425531914893617,-158,135,0.5891715795516586,0.41082842044834145,home,SF,under,7.5,0.5169082125603864,-107,0.49558269399772636,SF,ARI,2022 REG,8,3,10,4,7,18,0,1,-1,1,1,1,1,0,0,0,0,0,0,0.5044173060022736,0.49558269399772636
86428,0.4,0.6389891696750902,150,-177,0.3844043321299639,0.6155956678700361,away,TB,over,7.5,0.504950495049505,-102,0.47949844489399435,CIN,TB,2022 REG,4,2,5,1,3,9,1,0,1,-1,1,0,0,0,0,0,0,0,0,0.47949844489399435,0.5205015551060057
86428,0.4,0.6389891696750902,150,-177,0.3844043321299639,0.6155956678700361,home,CIN,under,7.5,0.5454545454545454,-120,0.5205015551060057,CIN,TB,2022 REG,4,2,5,1,3,9,1,0,1,-1,1,0,0,0,0,0,0,0,0,0.47949844489399435,0.5205015551060057
86429,0.6515679442508712,0.390625,-187,156,0.6240763743034393,0.3759236256965607,away,TEX,over,9.5,0.5169082125603864,-107,0.49353874091423283,NYM,TEX,2022 REG,6,4,6,3,7,12,1,0,1,-1,1,1,1,0,0,0,0,0,0,0.49353874091423283,0.5064612590857671
86429,0.6515679442508712,0.390625,-187,156,0.6240763743034393,0.3759236256965607,home,NYM,under,9.5,0.5283018867924528,-112,0.5064612590857671,NYM,TEX,2022 REG,6,4,6,3,7,12,1,0,1,-1,1,1,1,0,0,0,0,0,0,0.49353874091423283,0.5064612590857671
86430,0.37878787878787884,0.6644295302013422,164,-198,0.3624176481101436,0.6375823518898565,away,CLE,over,7,0.5121951219512195,-105,0.48808156828023186,DET,CLE,2022 REG,6,2,11,5,7,17,0,1,-3,3,1,1,0,0,0,0,0,0,0,0.48808156828023186,0.5119184317197681
86430,0.37878787878787884,0.6644295302013422,164,-198,0.3624176481101436,0.6375823518898565,home,DET,under,7,0.5348837209302326,-115,0.5119184317197681,DET,CLE,2022 REG,6,2,11,5,7,17,0,1,-3,3,1,1,0,0,0,0,0,0,0,0.48808156828023186,0.5119184317197681
86431,0.6000000000000001,0.44052863436123346,-150,127,0.57568281938326,0.42431718061673995,away,SD,over,8,0.5238095238095238,-110,0.5012646084074657,SF,SD,2022 REG,10,2,10,4,6,20,0,1,-2,2,1,1,0,0,0,0,0,0,0,0.5012646084074657,0.4987353915925343
86431,0.6000000000000001,0.44052863436123346,-150,127,0.57568281938326,0.42431718061673995,home,SF,under,8,0.5192307692307692,-108,0.4987353915925343,SF,SD,2022 REG,10,2,10,4,6,20,0,1,-2,2,1,1,0,0,0,0,0,0,0,0.5012646084074657,0.4987353915925343
86432,0.5884773662551441,0.45454545454545453,-143,120,0.5631594099815408,0.4368405900184592,away,ARI,over,7,0.49019607843137253,104,0.4707129274603323,SD,ARI,2022 REG,5,3,4,2,5,9,1,0,1,-1,1,1,0,0,0,0,0,0,0,0.4707129274603323,0.5292870725396677
86432,0.5884773662551441,0.45454545454545453,-143,120,0.5631594099815408,0.4368405900184592,home,SD,under,7,0.5495495495495495,-122,0.5292870725396677,SD,ARI,2022 REG,5,3,4,2,5,9,1,0,1,-1,1,1,0,0,0,0,0,0,0,0.4707129274603323,0.5292870725396677
86433,0.37735849056603776,0.6621621621621622,165,-196,0.36244503670633965,0.6375549632936603,away,LAD,over,9.5,0.5192307692307692,-108,0.49571111079951763,ARI,LAD,2022 REG,4,5,9,3,8,13,1,0,2,-2,1,1,1,0,0,0,0,0,0,0.49571111079951763,0.5042888892004824
86433,0.37735849056603776,0.6621621621621622,165,-196,0.36244503670633965,0.6375549632936603,home,ARI,under,9.5,0.5260663507109005,-111,0.5042888892004824,ARI,LAD,2022 REG,4,5,9,3,8,13,1,0,2,-2,1,1,1,0,0,0,0,0,0,0.49571111079951763,0.5042888892004824
86434,0.5633187772925764,0.47619047619047616,-129,110,0.5410624729287608,0.45893752707123925,away,OAK,over,7,0.5215311004784688,-109,0.4978845547971712,DET,OAK,2022 REG,4,0,6,2,2,10,0,1,-2,2,0,0,0,0,0,0,0,0,0,0.4978845547971712,0.5021154452028288
86434,0.5633187772925764,0.47619047619047616,-129,110,0.5410624729287608,0.45893752707123925,home,DET,under,7,0.5238095238095238,-110,0.5021154452028288,DET,OAK,2022 REG,4,0,6,2,2,10,0,1,-2,2,0,0,0,0,0,0,0,0,0,0.4978845547971712,0.5021154452028288
86435,0.3861003861003861,0.6551724137931035,159,-190,0.37016494212606577,0.6298350578739342,away,CWS,over,7.5,0.5348837209302326,-115,0.5097020142727117,TEX,CWS,2022 REG,3,1,6,2,3,9,0,1,-1,1,1,0,0,0,0,0,0,0,0,0.5097020142727117,0.49029798572728833
86435,0.3861003861003861,0.6551724137931035,159,-190,0.37016494212606577,0.6298350578739342,home,TEX,under,7.5,0.5121951219512195,-105,0.49029798572728833,TEX,CWS,2022 REG,3,1,6,2,3,9,0,1,-1,1,1,0,0,0,0,0,0,0,0,0.5097020142727117,0.49029798572728833
86436,0.6794871794871794,0.36101083032490977,-212,177,0.6519693010251187,0.34803069897488126,away,WSH,over,7.5,0.5121951219512195,-105,0.48808156828023186,SF,WSH,2022 REG,11,4,22,14,18,33,0,1,-10,10,1,1,1,1,0,0,0,0,0,0.48808156828023186,0.5119184317197681
86436,0.6794871794871794,0.36101083032490977,-212,177,0.6519693010251187,0.34803069897488126,home,SF,under,7.5,0.5348837209302326,-115,0.5119184317197681,SF,WSH,2022 REG,11,4,22,14,18,33,0,1,-10,10,1,1,1,1,0,0,0,0,0,0.48808156828023186,0.5119184317197681
86437,0.5614035087719298,0.47619047619047616,-128,110,0.5402981137053159,0.4597018862946841,away,HOU,over,8,0.5348837209302326,-115,0.5097020142727117,NYY,HOU,2022 REG,5,1,5,3,4,10,0,1,-2,2,1,0,0,0,0,0,0,0,0,0.5097020142727117,0.49029798572728833
86437,0.5614035087719298,0.47619047619047616,-128,110,0.5402981137053159,0.4597018862946841,home,NYY,under,8,0.5121951219512195,-105,0.49029798572728833,NYY,HOU,2022 REG,5,1,5,3,4,10,0,1,-2,2,1,0,0,0,0,0,0,0,0,0.5097020142727117,0.49029798572728833
86438,0.6941896024464832,0.3448275862068966,-227,190,0.667104275766614,0.332895724233386,away,CIN,over,8,0.5121951219512195,-105,0.48808156828023186,SF,CIN,2022 REG,9,9,5,2,11,14,1,0,7,-7,1,1,0,0,0,0,0,0,0,0.48808156828023186,0.5119184317197681
86438,0.6941896024464832,0.3448275862068966,-227,190,0.667104275766614,0.332895724233386,home,SF,under,8,0.5348837209302326,-115,0.5119184317197681,SF,CIN,2022 REG,9,9,5,2,11,14,1,0,7,-7,1,1,0,0,0,0,0,0,0,0.48808156828023186,0.5119184317197681
86439,0.574468085106383,0.4587155963302753,-135,118,0.5554051191746856,0.4445948808253144,away,STL,over,7.5,0.5215311004784688,-109,0.49670754937970685,SD,STL,2022 REG,5,1,2,0,1,7,1,0,1,-1,0,0,0,0,0,0,0,0,0,0.49670754937970685,0.5032924506202932
86439,0.574468085106383,0.4587155963302753,-135,118,0.5554051191746856,0.4445948808253144,home,SD,under,7.5,0.5260663507109005,-111,0.5032924506202932,SD,STL,2022 REG,5,1,2,0,1,7,1,0,1,-1,0,0,0,0,0,0,0,0,0,0.49670754937970685,0.5032924506202932
86440,0.5283018867924528,0.5238095238095238,-112,-110,0.5007713302480123,0.49922866975198765,away,CWS,over,9,0.5348837209302326,-115,0.502282519819859,CLE,CWS,2022 REG,12,8,8,4,12,20,1,0,4,-4,1,1,1,1,0,0,0,0,0,0.502282519819859,0.49771748018014095
86440,0.5283018867924528,0.5238095238095238,-112,-110,0.5007713302480123,0.49922866975198765,home,CLE,under,9,0.5260663507109005,-111,0.49771748018014095,CLE,CWS,2022 REG,12,8,8,4,12,20,1,0,4,-4,1,1,1,1,0,0,0,0,0,0.502282519819859,0.49771748018014095
86441,0.41493775933609955,0.6226415094339623,141,-165,0.39934470175516107,0.600655298244839,away,TOR,over,8.5,0.5121951219512195,-105,0.48808156828023186,PIT,TOR,2022 REG,7,1,6,4,5,13,0,1,-3,3,1,0,0,0,0,0,0,0,0,0.48808156828023186,0.5119184317197681
86441,0.41493775933609955,0.6226415094339623,141,-165,0.39934470175516107,0.600655298244839,home,PIT,under,8.5,0.5348837209302326,-115,0.5119184317197681,PIT,TOR,2022 REG,7,1,6,4,5,13,0,1,-3,3,1,0,0,0,0,0,0,0,0,0.48808156828023186,0.5119184317197681
86442,0.6666666666666666,0.36900369003690037,-200,171,0.6428864288642886,0.3571135711357114,away,WSH,over,8,0.5370370370370371,-116,0.5118817074154765,MIL,WSH,2022 REG,9,7,6,0,7,15,1,0,7,-7,0,0,0,0,0,0,0,0,0,0.5118817074154765,0.48811829258452355
86442,0.6666666666666666,0.36900369003690037,-200,171,0.6428864288642886,0.3571135711357114,home,MIL,under,8,0.5098039215686274,-104,0.48811829258452355,MIL,WSH,2022 REG,9,7,6,0,7,15,1,0,7,-7,0,0,0,0,0,0,0,0,0,0.5118817074154765,0.48811829258452355
86443,0.4504504504504505,0.5884773662551441,122,-143,0.4329153978803628,0.5670846021196372,away,CWS,over,8.5,0.5454545454545454,-120,0.5206611570247933,KC,CWS,2022 REG,15,8,7,3,11,22,1,0,5,-5,1,1,1,0,0,0,0,0,0,0.5206611570247933,0.4793388429752067
86443,0.4504504504504505,0.5884773662551441,122,-143,0.4329153978803628,0.5670846021196372,home,KC,under,8.5,0.5,100,0.4793388429752067,KC,CWS,2022 REG,15,8,7,3,11,22,1,0,5,-5,1,1,1,0,0,0,0,0,0,0.5206611570247933,0.4793388429752067
86444,0.4132231404958678,0.6282527881040892,142,-169,0.3960843270248111,0.6039156729751889,away,MIL,over,7.5,0.5121951219512195,-105,0.48919479393107135,PIT,MIL,2022 REG,6,2,9,3,5,15,0,1,-1,1,1,1,0,0,0,0,0,0,0,0.48919479393107135,0.5108052060689287
86444,0.4132231404958678,0.6282527881040892,142,-169,0.3960843270248111,0.6039156729751889,home,PIT,under,7.5,0.5327102803738317,-114,0.5108052060689287,PIT,MIL,2022 REG,6,2,9,3,5,15,0,1,-1,1,1,1,0,0,0,0,0,0,0,0.48919479393107135,0.5108052060689287
86445,0.4,0.6491228070175439,150,-185,0.38035087719298244,0.6196491228070176,away,NYY,over,8,0.5283018867924528,-112,0.4983980064079744,CWS,NYY,2022 REG,9,4,14,10,14,23,0,1,-6,6,1,1,1,1,0,0,0,0,0,0.4983980064079744,0.5016019935920256
86445,0.4,0.6491228070175439,150,-185,0.38035087719298244,0.6196491228070176,home,CWS,under,8,0.5283018867924528,-112,0.5016019935920256,CWS,NYY,2022 REG,9,4,14,10,14,23,0,1,-6,6,1,1,1,1,0,0,0,0,0,0.4983980064079744,0.5016019935920256
86446,0.40485829959514175,0.6309963099630996,147,-171,0.3903422633367445,0.6096577366632555,away,ATL,over,8,0.5098039215686274,-104,0.48483656587239576,MIA,ATL,2022 REG,4,1,8,2,3,12,0,1,-1,1,1,0,0,0,0,0,0,0,0,0.48483656587239576,0.5151634341276042
86446,0.40485829959514175,0.6309963099630996,147,-171,0.3903422633367445,0.6096577366632555,home,MIA,under,8,0.5391705069124424,-117,0.5151634341276042,MIA,ATL,2022 REG,4,1,8,2,3,12,0,1,-1,1,1,0,0,0,0,0,0,0,0,0.48483656587239576,0.5151634341276042
86447,0.646643109540636,0.3921568627450981,-183,155,0.6215533748116984,0.37844662518830163,away,DET,over,8,0.5238095238095238,-110,0.5012646084074657,BAL,DET,2022 REG,6,2,10,3,5,16,0,1,-1,1,1,1,0,0,0,0,0,0,0,0.5012646084074657,0.4987353915925343
86447,0.646643109540636,0.3921568627450981,-183,155,0.6215533748116984,0.37844662518830163,home,BAL,under,8,0.5192307692307692,-108,0.4987353915925343,BAL,DET,2022 REG,6,2,10,3,5,16,0,1,-1,1,1,1,0,0,0,0,0,0,0,0.5012646084074657,0.4987353915925343
86448,0.5780590717299579,0.4587155963302753,-137,118,0.5568011412478822,0.44319885875211784,away,CWS,over,7.5,0.5,100,0.4772727272727273,CLE,CWS,2022 REG,9,5,7,2,7,16,1,0,3,-3,1,1,0,0,0,0,0,0,0,0.4772727272727273,0.5227272727272727
86448,0.5780590717299579,0.4587155963302753,-137,118,0.5568011412478822,0.44319885875211784,home,CLE,under,7.5,0.5454545454545454,-120,0.5227272727272727,CLE,CWS,2022 REG,9,5,7,2,7,16,1,0,3,-3,1,1,0,0,0,0,0,0,0,0.4772727272727273,0.5227272727272727
86449,0.4081632653061224,0.6336996336996338,145,-173,0.39107636775275256,0.6089236322472474,away,LAA,over,7.5,0.5073891625615764,-103,0.4837652908580103,OAK,LAA,2022 REG,11,5,8,4,9,19,1,0,1,-1,1,1,1,1,0,0,0,0,0,0.4837652908580103,0.5162347091419897
86449,0.4081632653061224,0.6336996336996338,145,-173,0.39107636775275256,0.6089236322472474,home,OAK,under,7.5,0.5391705069124424,-117,0.5162347091419897,OAK,LAA,2022 REG,11,5,8,4,9,19,1,0,1,-1,1,1,1,1,0,0,0,0,0,0.4837652908580103,0.5162347091419897
86450,0.6610169491525424,0.37735849056603776,-195,165,0.6356501330673793,0.3643498669326207,away,COL,over,7,0.5327102803738317,-114,0.508788710910954,SF,COL,2022 REG,12,9,10,2,11,22,1,0,7,-7,1,1,0,0,0,0,0,0,0,0.508788710910954,0.491211289089046
86450,0.6610169491525424,0.37735849056603776,-195,165,0.6356501330673793,0.3643498669326207,home,SF,under,7,0.5121951219512195,-105,0.491211289089046,SF,COL,2022 REG,12,9,10,2,11,22,1,0,7,-7,1,1,0,0,0,0,0,0,0,0.508788710910954,0.491211289089046
86451,0.607843137254902,0.4329004329004329,-155,131,0.583077437748718,0.416922562251282,away,SF,over,7.5,0.5283018867924528,-112,0.5044173060022736,LAD,SF,2022 REG,11,9,6,1,10,17,1,0,8,-8,1,0,0,0,0,0,0,0,0,0.5044173060022736,0.49558269399772636
86451,0.607843137254902,0.4329004329004329,-155,131,0.583077437748718,0.416922562251282,home,LAD,under,7.5,0.5169082125603864,-107,0.49558269399772636,LAD,SF,2022 REG,11,9,6,1,10,17,1,0,8,-8,1,0,0,0,0,0,0,0,0,0.5044173060022736,0.49558269399772636
86452,0.6323529411764706,0.4081632653061224,-172,145,0.6067323988418897,0.3932676011581103,away,KC,over,8.5,0.5192307692307692,-108,0.49571111079951763,CWS,KC,2022 REG,14,9,7,2,11,21,1,0,7,-7,1,1,0,0,0,0,0,0,0,0.49571111079951763,0.5042888892004824
86452,0.6323529411764706,0.4081632653061224,-172,145,0.6067323988418897,0.3932676011581103,home,CWS,under,8.5,0.5260663507109005,-111,0.5042888892004824,CWS,KC,2022 REG,14,9,7,2,11,21,1,0,7,-7,1,1,0,0,0,0,0,0,0,0.49571111079951763,0.5042888892004824
86453,0.5454545454545454,0.5,-120,100,0.5206611570247933,0.4793388429752067,away,CHC,over,7.5,0.5121951219512195,-105,0.48808156828023186,PIT,CHC,2022 REG,6,2,7,3,5,13,0,1,-1,1,1,1,0,0,0,0,0,0,0,0.48808156828023186,0.5119184317197681
86453,0.5454545454545454,0.5,-120,100,0.5206611570247933,0.4793388429752067,home,PIT,under,7.5,0.5348837209302326,-115,0.5119184317197681,PIT,CHC,2022 REG,6,2,7,3,5,13,0,1,-1,1,1,1,0,0,0,0,0,0,0,0.48808156828023186,0.5119184317197681
86454,0.6894409937888198,0.3484320557491289,-222,187,0.6633297608775633,0.33667023912243665,away,COL,over,8.5,0.5192307692307692,-108,0.49688292476754015,PHI,COL,2022 REG,12,7,12,3,10,24,1,0,4,-4,1,1,1,0,0,0,0,0,0,0.49688292476754015,0.5031170752324599
86454,0.6894409937888198,0.3484320557491289,-222,187,0.6633297608775633,0.33667023912243665,home,PHI,under,8.5,0.5238095238095238,-110,0.5031170752324599,PHI,COL,2022 REG,12,7,12,3,10,24,1,0,4,-4,1,1,1,0,0,0,0,0,0,0.49688292476754015,0.5031170752324599
86455,0.7142857142857143,0.3225806451612903,-250,210,0.6879526003949967,0.3120473996050033,away,DET,over,7,0.5238095238095238,-110,0.4988662131519274,SEA,DET,2022 REG,7,3,8,4,7,15,0,1,-1,1,1,1,1,0,0,0,0,0,0,0.4988662131519274,0.5011337868480725
86455,0.7142857142857143,0.3225806451612903,-250,210,0.6879526003949967,0.3120473996050033,home,SEA,under,7,0.5238095238095238,-110,0.5011337868480725,SEA,DET,2022 REG,7,3,8,4,7,15,0,1,-1,1,1,1,1,0,0,0,0,0,0,0.4988662131519274,0.5011337868480725
86456,0.6894409937888198,0.35460992907801414,-222,182,0.6590704817501952,0.3409295182498048,away,WSH,over,10,0.5192307692307692,-108,0.49688292476754015,ATL,WSH,2022 REG,12,4,5,3,7,17,1,0,1,-1,1,1,1,0,0,0,0,0,0,0.49688292476754015,0.5031170752324599
86456,0.6894409937888198,0.35460992907801414,-222,182,0.6590704817501952,0.3409295182498048,home,ATL,under,10,0.5238095238095238,-110,0.5031170752324599,ATL,WSH,2022 REG,12,4,5,3,7,17,1,0,1,-1,1,1,1,0,0,0,0,0,0,0.49688292476754015,0.5031170752324599
86457,0.48780487804878053,0.5555555555555556,105,-125,0.4666534470222751,0.5333465529777248,away,MIN,over,7,0.5348837209302326,-115,0.5097020142727117,OAK,MIN,2022 REG,11,5,7,2,7,18,1,0,3,-3,1,1,0,0,0,0,0,0,0,0.5097020142727117,0.49029798572728833
86457,0.48780487804878053,0.5555555555555556,105,-125,0.4666534470222751,0.5333465529777248,home,OAK,under,7,0.5121951219512195,-105,0.49029798572728833,OAK,MIN,2022 REG,11,5,7,2,7,18,1,0,3,-3,1,1,0,0,0,0,0,0,0,0.5097020142727117,0.49029798572728833
86458,0.5121951219512195,0.5305164319248826,-105,-113,0.4903184724049234,0.5096815275950766,away,CHC,over,8.5,0.5348837209302326,-115,0.5097020142727117,CIN,CHC,2022 REG,6,3,3,2,5,9,1,0,1,-1,1,1,0,0,0,0,0,0,0,0.5097020142727117,0.49029798572728833
86458,0.5121951219512195,0.5305164319248826,-105,-113,0.4903184724049234,0.5096815275950766,home,CIN,under,8.5,0.5121951219512195,-105,0.49029798572728833,CIN,CHC,2022 REG,6,3,3,2,5,9,1,0,1,-1,1,1,0,0,0,0,0,0,0,0.5097020142727117,0.49029798572728833
86459,0.696969696969697,0.3436426116838488,-230,191,0.6686641485141954,0.3313358514858046,away,PHI,over,6.5,0.5454545454545454,-120,0.5206611570247933,HOU,PHI,2022 REG,17,10,3,0,10,20,1,0,10,-10,0,0,0,0,0,0,0,0,0,0.5206611570247933,0.4793388429752067
86459,0.696969696969697,0.3436426116838488,-230,191,0.6686641485141954,0.3313358514858046,home,HOU,under,6.5,0.5,100,0.4793388429752067,HOU,PHI,2022 REG,17,10,3,0,10,20,1,0,10,-10,0,0,0,0,0,0,0,0,0,0.5206611570247933,0.4793388429752067
86460,0.5918367346938775,0.4484304932735426,-145,123,0.5680051099784656,0.43199489002153435,away,CIN,over,8,0.5283018867924528,-112,0.5031902949311281,CHC,CIN,2022 REG,12,1,10,7,8,22,0,1,-6,6,1,0,0,0,0,0,0,0,0,0.5031902949311281,0.4968097050688719
86460,0.5918367346938775,0.4484304932735426,-145,123,0.5680051099784656,0.43199489002153435,home,CHC,under,8,0.5192307692307692,-108,0.4968097050688719,CHC,CIN,2022 REG,12,1,10,7,8,22,0,1,-6,6,1,0,0,0,0,0,0,0,0,0.5031902949311281,0.4968097050688719
86461,0.5780590717299579,0.4608294930875576,-137,117,0.5555791840506346,0.44442081594936544,away,LAA,over,8.5,0.5495495495495495,-122,0.5250401592387142,BAL,LAA,2022 REG,10,5,12,4,9,22,1,0,1,-1,1,1,1,1,0,0,0,0,0,0.5250401592387142,0.47495984076128583
86461,0.5780590717299579,0.4608294930875576,-137,117,0.5555791840506346,0.44442081594936544,home,BAL,under,8.5,0.49504950495049505,102,0.47495984076128583,BAL,LAA,2022 REG,10,5,12,4,9,22,1,0,1,-1,1,1,1,1,0,0,0,0,0,0.5250401592387142,0.47495984076128583
86462,0.5305164319248826,0.5121951219512195,-113,-105,0.5078572507605655,0.49214274923943446,away,LAA,over,8,0.5121951219512195,-105,0.48808156828023186,KC,LAA,2022 REG,12,7,5,0,7,17,1,0,7,-7,0,0,0,0,0,0,0,0,0,0.48808156828023186,0.5119184317197681
86462,0.5305164319248826,0.5121951219512195,-113,-105,0.5078572507605655,0.49214274923943446,home,KC,under,8,0.5348837209302326,-115,0.5119184317197681,KC,LAA,2022 REG,12,7,5,0,7,17,1,0,7,-7,0,0,0,0,0,0,0,0,0,0.48808156828023186,0.5119184317197681
86463,0.5327102803738317,0.504950495049505,-114,-102,0.5126479981389701,0.4873520018610299,away,SEA,over,7,0.5121951219512195,-105,0.4903184724049234,LAA,SEA,2022 REG,4,2,5,1,3,9,1,0,1,-1,1,0,0,0,0,0,0,0,0,0.4903184724049234,0.5096815275950766
86463,0.5327102803738317,0.504950495049505,-114,-102,0.5126479981389701,0.4873520018610299,home,LAA,under,7,0.5305164319248826,-113,0.5096815275950766,LAA,SEA,2022 REG,4,2,5,1,3,9,1,0,1,-1,1,0,0,0,0,0,0,0,0,0.4903184724049234,0.5096815275950766
86464,0.696969696969697,0.3448275862068966,-230,190,0.6678382571799499,0.33216174282005007,away,BAL,over,9,0.5412844036697247,-118,0.5175913212324037,TOR,BAL,2022 REG,10,5,8,6,11,18,0,1,-1,1,1,1,1,1,1,0,0,0,0,0.5175913212324037,0.4824086787675963
86464,0.696969696969697,0.3448275862068966,-230,190,0.6678382571799499,0.33216174282005007,home,TOR,under,9,0.5024875621890548,-101,0.4824086787675963,TOR,BAL,2022 REG,10,5,8,6,11,18,0,1,-1,1,1,1,1,1,1,0,0,0,0,0.5175913212324037,0.4824086787675963
86465,0.2898550724637681,0.7512437810945274,245,-302,0.2779423612874506,0.7220576387125495,away,HOU,over,8,0.5238095238095238,-110,0.4988662131519274,OAK,HOU,2022 REG,4,3,5,2,5,9,1,0,1,-1,1,1,0,0,0,0,0,0,0,0.4988662131519274,0.5011337868480725
86465,0.2898550724637681,0.7512437810945274,245,-302,0.2779423612874506,0.7220576387125495,home,OAK,under,8,0.5238095238095238,-110,0.5011337868480725,OAK,HOU,2022 REG,4,3,5,2,5,9,1,0,1,-1,1,1,0,0,0,0,0,0,0,0.4988662131519274,0.5011337868480725
86466,0.6226415094339623,0.4166666666666667,-165,140,0.5981666073335706,0.40183339266642937,away,OAK,over,8,0.5391705069124424,-117,0.5140669063204599,TEX,OAK,2022 REG,8,2,3,1,3,11,1,0,1,-1,1,0,0,0,0,0,0,0,0,0.5140669063204599,0.4859330936795401
86466,0.6226415094339623,0.4166666666666667,-165,140,0.5981666073335706,0.40183339266642937,home,TEX,under,8,0.5073891625615764,-103,0.4859330936795401,TEX,OAK,2022 REG,8,2,3,1,3,11,1,0,1,-1,1,0,0,0,0,0,0,0,0,0.5140669063204599,0.4859330936795401
86467,0.5652173913043479,0.47619047619047616,-130,110,0.5418129444594474,0.4581870555405526,away,ATL,over,7.5,0.5348837209302326,-115,0.5097020142727117,MIL,ATL,2022 REG,5,1,2,0,1,7,1,0,1,-1,0,0,0,0,0,0,0,0,0,0.5097020142727117,0.49029798572728833
86467,0.5652173913043479,0.47619047619047616,-130,110,0.5418129444594474,0.4581870555405526,home,MIL,under,7.5,0.5121951219512195,-105,0.49029798572728833,MIL,ATL,2022 REG,5,1,2,0,1,7,1,0,1,-1,0,0,0,0,0,0,0,0,0,0.5097020142727117,0.49029798572728833
86468,0.7159090909090909,0.3225806451612903,-252,210,0.6883539389496134,0.3116460610503866,away,BAL,over,8.5,0.5348837209302326,-115,0.5097020142727117,LAA,BAL,2022 REG,6,4,6,5,9,12,0,1,-1,1,1,1,1,1,0,0,0,0,0,0.5097020142727117,0.49029798572728833
86468,0.7159090909090909,0.3225806451612903,-252,210,0.6883539389496134,0.3116460610503866,home,LAA,under,8.5,0.5121951219512195,-105,0.49029798572728833,LAA,BAL,2022 REG,6,4,6,5,9,12,0,1,-1,1,1,1,1,1,0,0,0,0,0,0.5097020142727117,0.49029798572728833
86469,0.42194092827004215,0.6197718631178707,137,-163,0.40434059435109154,0.5956594056489084,away,NYM,over,7,0.5260663507109005,-111,0.5022370601254724,MIA,NYM,2022 REG,9,3,16,11,14,25,0,1,-8,8,1,1,1,0,0,0,0,0,0,0.5022370601254724,0.4977629398745276
86469,0.42194092827004215,0.6197718631178707,137,-163,0.40434059435109154,0.5956594056489084,home,MIA,under,7,0.5192307692307692,-108,0.4977629398745276,MIA,NYM,2022 REG,9,3,16,11,14,25,0,1,-8,8,1,1,1,0,0,0,0,0,0,0.5022370601254724,0.4977629398745276
86470,0.6376811594202898,0.4,-176,150,0.6136525939928585,0.38634740600714146,away,OAK,over,8,0.5348837209302326,-115,0.5109810284308424,SEA,OAK,2022 REG,4,1,12,3,4,16,0,1,-2,2,1,0,0,0,0,0,0,0,0,0.5109810284308424,0.48901897156915763
86470,0.6376811594202898,0.4,-176,150,0.6136525939928585,0.38634740600714146,home,SEA,under,8,0.5098039215686274,-104,0.48901897156915763,SEA,OAK,2022 REG,4,1,12,3,4,16,0,1,-2,2,1,0,0,0,0,0,0,0,0,0.5109810284308424,0.48901897156915763
86471,0.5726495726495727,0.4739336492890995,-134,111,0.5459737105137519,0.4540262894862481,away,DET,over,8.5,0.5412844036697247,-118,0.5149381613977361,KC,DET,2022 REG,5,1,3,2,3,8,0,1,-1,1,1,0,0,0,0,0,0,0,0,0.5149381613977361,0.48506183860226393
86471,0.5726495726495727,0.4739336492890995,-134,111,0.5459737105137519,0.4540262894862481,home,KC,under,8.5,0.5073891625615764,-103,0.48506183860226393,KC,DET,2022 REG,5,1,3,2,3,8,0,1,-1,1,1,0,0,0,0,0,0,0,0,0.5149381613977361,0.48506183860226393
86472,0.6987951807228916,0.3401360544217687,-232,194,0.6715902212242133,0.3284097787757867,away,WSH,over,9,0.5412844036697247,-118,0.5189377998484975,NYM,WSH,2022 REG,8,5,6,0,5,14,1,0,5,-5,0,0,0,0,0,0,0,0,0,0.5189377998484975,0.4810622001515025
86472,0.6987951807228916,0.3401360544217687,-232,194,0.6715902212242133,0.3284097787757867,home,NYM,under,9,0.5,100,0.4810622001515025,NYM,WSH,2022 REG,8,5,6,0,5,14,1,0,5,-5,0,0,0,0,0,0,0,0,0,0.5189377998484975,0.4810622001515025
86473,0.5726495726495727,0.4629629629629629,-134,116,0.5522560693500865,0.44774393064991347,away,SF,over,8,0.5348837209302326,-115,0.5097020142727117,SD,SF,2022 REG,4,1,12,8,9,16,0,1,-7,7,1,0,0,0,0,0,0,0,0,0.5097020142727117,0.49029798572728833
86473,0.5726495726495727,0.4629629629629629,-134,116,0.5522560693500865,0.44774393064991347,home,SD,under,8,0.5121951219512195,-105,0.49029798572728833,SD,SF,2022 REG,4,1,12,8,9,16,0,1,-7,7,1,0,0,0,0,0,0,0,0,0.5097020142727117,0.49029798572728833
86474,0.35460992907801414,0.6845425867507886,182,-217,0.3407260582167365,0.6592739417832635,away,NYY,over,7.5,0.5433789954337899,-119,0.5198077604720502,DET,NYY,2022 REG,4,2,6,4,6,10,0,1,-2,2,1,1,0,0,0,0,0,0,0,0.5198077604720502,0.48019223952794976
86474,0.35460992907801414,0.6845425867507886,182,-217,0.3407260582167365,0.6592739417832635,home,DET,under,7.5,0.5,100,0.48019223952794976,DET,NYY,2022 REG,4,2,6,4,6,10,0,1,-2,2,1,1,0,0,0,0,0,0,0,0.5198077604720502,0.48019223952794976
86475,0.7118155619596541,0.3333333333333333,-247,200,0.6796778756848186,0.32032212431518137,away,SEA,over,7,0.5370370370370371,-116,0.5171467764060357,NYM,SEA,2022 REG,5,1,4,2,3,9,0,1,-1,1,1,0,0,0,0,0,0,0,0,0.5171467764060357,0.4828532235939643
86475,0.7118155619596541,0.3333333333333333,-247,200,0.6796778756848186,0.32032212431518137,home,NYM,under,7,0.5,100,0.4828532235939643,NYM,SEA,2022 REG,5,1,4,2,3,9,0,1,-1,1,1,0,0,0,0,0,0,0,0,0.5171467764060357,0.4828532235939643
86476,0.576271186440678,0.46511627906976744,-136,115,0.552420782587201,0.44757921741279905,away,NYM,over,7.5,0.5348837209302326,-115,0.5097020142727117,SD,NYM,2022 REG,6,7,2,0,7,8,1,0,7,-7,0,0,0,0,0,0,0,0,0,0.5097020142727117,0.49029798572728833
86476,0.576271186440678,0.46511627906976744,-136,115,0.552420782587201,0.44757921741279905,home,SD,under,7.5,0.5121951219512195,-105,0.49029798572728833,SD,NYM,2022 REG,6,7,2,0,7,8,1,0,7,-7,0,0,0,0,0,0,0,0,0,0.5097020142727117,0.49029798572728833
86477,0.425531914893617,0.6183206106870228,135,-162,0.406871265710366,0.593128734289634,away,SF,over,11,0.5305164319248826,-113,0.5066009958897986,COL,SF,2022 REG,10,7,5,4,11,15,1,0,3,-3,1,1,1,1,0,0,0,0,0,0.5066009958897986,0.49339900411020143
86477,0.425531914893617,0.6183206106870228,135,-162,0.406871265710366,0.593128734289634,home,COL,under,11,0.5145631067961165,-106,0.49339900411020143,COL,SF,2022 REG,10,7,5,4,11,15,1,0,3,-3,1,1,1,1,0,0,0,0,0,0.5066009958897986,0.49339900411020143
86478,0.4807692307692307,0.5594713656387665,108,-127,0.46142279018846283,0.5385772098115371,away,MIA,over,7,0.5,100,0.4783105022831051,OAK,MIA,2022 REG,4,3,5,2,5,9,1,0,1,-1,1,1,0,0,0,0,0,0,0,0.4783105022831051,0.5216894977168949
86478,0.4807692307692307,0.5594713656387665,108,-127,0.46142279018846283,0.5385772098115371,home,OAK,under,7,0.5433789954337899,-119,0.5216894977168949,OAK,MIA,2022 REG,4,3,5,2,5,9,1,0,1,-1,1,1,0,0,0,0,0,0,0,0.4783105022831051,0.5216894977168949
86479,0.4166666666666667,0.6197718631178707,140,-163,0.4014839459231095,0.5985160540768906,away,SEA,over,7.5,0.5454545454545454,-120,0.5193043049216726,CLE,SEA,2022 REG,9,0,7,4,4,16,0,1,-4,4,0,0,0,0,0,0,0,0,0,0.5193043049216726,0.48069569507832743
86479,0.4166666666666667,0.6197718631178707,140,-163,0.4014839459231095,0.5985160540768906,home,CLE,under,7.5,0.5024875621890548,-101,0.48069569507832743,CLE,SEA,2022 REG,9,0,7,4,4,16,0,1,-4,4,0,0,0,0,0,0,0,0,0,0.5193043049216726,0.48069569507832743
86480,0.48780487804878053,0.5555555555555556,105,-125,0.4666534470222751,0.5333465529777248,away,PIT,over,8.5,0.5238095238095238,-110,0.4988662131519274,CIN,PIT,2022 REG,8,9,8,2,11,16,1,0,7,-7,1,1,0,0,0,0,0,0,0,0.4988662131519274,0.5011337868480725
86480,0.48780487804878053,0.5555555555555556,105,-125,0.4666534470222751,0.5333465529777248,home,CIN,under,8.5,0.5238095238095238,-110,0.5011337868480725,CIN,PIT,2022 REG,8,9,8,2,11,16,1,0,7,-7,1,1,0,0,0,0,0,0,0,0.4988662131519274,0.5011337868480725
86481,0.46511627906976744,0.574468085106383,115,-135,0.44670494689481377,0.5532950531051862,away,CWS,over,7,0.5454545454545454,-120,0.5206611570247933,BAL,CWS,2022 REG,5,5,11,3,8,16,1,0,2,-2,1,1,1,0,0,0,0,0,0,0.5206611570247933,0.4793388429752067
86481,0.46511627906976744,0.574468085106383,115,-135,0.44670494689481377,0.5532950531051862,home,BAL,under,7,0.5,100,0.4793388429752067,BAL,CWS,2022 REG,5,5,11,3,8,16,1,0,2,-2,1,1,1,0,0,0,0,0,0,0.5206611570247933,0.4793388429752067
86482,0.6031746031746031,0.4291845493562232,-152,133,0.5836563841877556,0.41634361581224444,away,CIN,over,8.5,0.5412844036697247,-118,0.5149381613977361,WSH,CIN,2022 REG,8,3,9,7,10,17,0,1,-4,4,1,1,1,0,0,0,0,0,0,0.5149381613977361,0.48506183860226393
86482,0.6031746031746031,0.4291845493562232,-152,133,0.5836563841877556,0.41634361581224444,home,WSH,under,8.5,0.5073891625615764,-103,0.48506183860226393,WSH,CIN,2022 REG,8,3,9,7,10,17,0,1,-4,4,1,1,1,0,0,0,0,0,0,0.5149381613977361,0.48506183860226393
86483,0.4081632653061224,0.6376811594202898,145,-176,0.3894512552137092,0.6105487447862907,away,SEA,over,7.5,0.5238095238095238,-110,0.5000596729920038,DET,SEA,2022 REG,7,3,11,9,12,18,0,1,-6,6,1,1,1,0,0,0,0,0,0,0.5000596729920038,0.4999403270079962
86483,0.4081632653061224,0.6376811594202898,145,-176,0.3894512552137092,0.6105487447862907,home,DET,under,7.5,0.5215311004784688,-109,0.4999403270079962,DET,SEA,2022 REG,7,3,11,9,12,18,0,1,-6,6,1,1,1,0,0,0,0,0,0,0.5000596729920038,0.4999403270079962
86484,0.6515679442508712,0.3891050583657587,-187,157,0.6250667195494433,0.37493328045055674,away,NYM,over,8.5,0.5283018867924528,-112,0.5056562298022652,LAD,NYM,2022 REG,6,4,13,9,13,19,0,1,-5,5,1,1,1,1,0,0,0,0,0,0.5056562298022652,0.4943437701977348
86484,0.6515679442508712,0.3891050583657587,-187,157,0.6250667195494433,0.37493328045055674,home,LAD,under,8.5,0.5145631067961165,-106,0.4943437701977348,LAD,NYM,2022 REG,6,4,13,9,13,19,0,1,-5,5,1,1,1,1,0,0,0,0,0,0.5056562298022652,0.4943437701977348
86485,0.4166666666666667,0.6240601503759399,140,-166,0.39969715956558066,0.6003028404344193,away,CWS,over,7.5,0.5327102803738317,-114,0.508788710910954,KC,CWS,2022 REG,12,6,10,2,8,22,1,0,4,-4,1,1,0,0,0,0,0,0,0,0.508788710910954,0.491211289089046
86485,0.4166666666666667,0.6240601503759399,140,-166,0.39969715956558066,0.6003028404344193,home,KC,under,7.5,0.5121951219512195,-105,0.491211289089046,KC,CWS,2022 REG,12,6,10,2,8,22,1,0,4,-4,1,1,0,0,0,0,0,0,0,0.508788710910954,0.491211289089046
86486,0.5555555555555556,0.4854368932038835,-125,106,0.5327819729114227,0.4672180270885773,away,TEX,over,7.5,0.5098039215686274,-104,0.4870219861770517,MIA,TEX,2022 REG,5,2,6,3,5,11,0,1,-1,1,1,1,0,0,0,0,0,0,0,0.4870219861770517,0.5129780138229483
86486,0.5555555555555556,0.4854368932038835,-125,106,0.5327819729114227,0.4672180270885773,home,MIA,under,7.5,0.5348837209302326,-115,0.5129780138229483,MIA,TEX,2022 REG,5,2,6,3,5,11,0,1,-1,1,1,1,0,0,0,0,0,0,0,0.4870219861770517,0.5129780138229483
86487,0.5652173913043479,0.47619047619047616,-130,110,0.5418129444594474,0.4581870555405526,away,NYM,over,7.5,0.5238095238095238,-110,0.4988662131519274,ATL,NYM,2022 REG,5,5,11,3,8,16,1,0,2,-2,1,1,1,0,0,0,0,0,0,0.4988662131519274,0.5011337868480725
86487,0.5652173913043479,0.47619047619047616,-130,110,0.5418129444594474,0.4581870555405526,home,ATL,under,7.5,0.5238095238095238,-110,0.5011337868480725,ATL,NYM,2022 REG,5,5,11,3,8,16,1,0,2,-2,1,1,1,0,0,0,0,0,0,0.4988662131519274,0.5011337868480725
86488,0.6666666666666666,0.37037037037037035,-200,170,0.6419753086419753,0.3580246913580247,away,OAK,over,7.5,0.5283018867924528,-112,0.5044173060022736,LAA,OAK,2022 REG,10,4,4,1,5,14,1,0,3,-3,1,0,0,0,0,0,0,0,0,0.5044173060022736,0.49558269399772636
86488,0.6666666666666666,0.37037037037037035,-200,170,0.6419753086419753,0.3580246913580247,home,LAA,under,7.5,0.5169082125603864,-107,0.49558269399772636,LAA,OAK,2022 REG,10,4,4,1,5,14,1,0,3,-3,1,0,0,0,0,0,0,0,0,0.5044173060022736,0.49558269399772636
86489,0.5918367346938775,0.45248868778280543,-145,121,0.5656033213913509,0.43439667860864906,away,MIN,over,9,0.5391705069124424,-117,0.5140669063204599,CWS,MIN,2022 REG,8,3,8,6,9,16,0,1,-3,3,1,1,1,0,0,0,0,0,0,0.5140669063204599,0.4859330936795401
86489,0.5918367346938775,0.45248868778280543,-145,121,0.5656033213913509,0.43439667860864906,home,CWS,under,9,0.5073891625615764,-103,0.4859330936795401,CWS,MIN,2022 REG,8,3,8,6,9,16,0,1,-3,3,1,1,1,0,0,0,0,0,0,0.5140669063204599,0.4859330936795401
86490,0.5238095238095238,0.5145631067961165,-110,-106,0.5037095744446646,0.4962904255553354,away,HOU,over,9.5,0.5283018867924528,-112,0.5056562298022652,LAA,HOU,2022 REG,13,6,14,13,19,27,0,1,-7,7,1,1,1,1,1,1,0,0,0,0.5056562298022652,0.4943437701977348
86490,0.5238095238095238,0.5145631067961165,-110,-106,0.5037095744446646,0.4962904255553354,home,LAA,under,9.5,0.5145631067961165,-106,0.4943437701977348,LAA,HOU,2022 REG,13,6,14,13,19,27,0,1,-7,7,1,1,1,1,1,1,0,0,0,0.5056562298022652,0.4943437701977348
86491,0.5708154506437768,0.4716981132075471,-133,112,0.5465480515355103,0.45345194846448966,away,MIN,over,9,0.5454545454545454,-120,0.5179608869977906,CWS,MIN,2022 REG,10,2,12,8,10,22,0,1,-6,6,1,1,0,0,0,0,0,0,0,0.5179608869977906,0.48203911300220936
86491,0.5708154506437768,0.4716981132075471,-133,112,0.5465480515355103,0.45345194846448966,home,CWS,under,9,0.504950495049505,-102,0.48203911300220936,CWS,MIN,2022 REG,10,2,12,8,10,22,0,1,-6,6,1,1,0,0,0,0,0,0,0,0.5179608869977906,0.48203911300220936
86492,0.4273504273504274,0.609375,134,-156,0.4116558002775952,0.5883441997224048,away,NYY,over,10,0.5121951219512195,-105,0.48808156828023186,BOS,NYY,2022 REG,13,5,14,12,17,27,0,1,-7,7,1,1,1,1,1,0,0,0,0,0.48808156828023186,0.5119184317197681
86492,0.4273504273504274,0.609375,134,-156,0.4116558002775952,0.5883441997224048,home,BOS,under,10,0.5348837209302326,-115,0.5119184317197681,BOS,NYY,2022 REG,13,5,14,12,17,27,0,1,-7,7,1,1,1,1,1,0,0,0,0,0.48808156828023186,0.5119184317197681
86493,0.5,0.5348837209302326,100,-115,0.4825581395348837,0.5174418604651163,away,NYY,over,8.5,0.5121951219512195,-105,0.48808156828023186,TOR,NYY,2022 REG,9,2,8,3,5,17,0,1,-1,1,1,1,0,0,0,0,0,0,0,0.48808156828023186,0.5119184317197681
86493,0.5,0.5348837209302326,100,-115,0.4825581395348837,0.5174418604651163,home,TOR,under,8.5,0.5348837209302326,-115,0.5119184317197681,TOR,NYY,2022 REG,9,2,8,3,5,17,0,1,-1,1,1,1,0,0,0,0,0,0,0,0.48808156828023186,0.5119184317197681
86494,0.5370370370370371,0.504950495049505,-116,-102,0.514488177212783,0.48551182278721705,away,MIL,over,7,0.49504950495049505,102,0.47297076509898783,TB,MIL,2022 REG,5,3,9,5,8,14,0,1,-2,2,1,1,1,0,0,0,0,0,0,0.47297076509898783,0.5270292349010122
86494,0.5370370370370371,0.504950495049505,-116,-102,0.514488177212783,0.48551182278721705,home,TB,under,7,0.5495495495495495,-122,0.5270292349010122,TB,MIL,2022 REG,5,3,9,5,8,14,0,1,-2,2,1,1,1,0,0,0,0,0,0,0.47297076509898783,0.5270292349010122
86495,0.574468085106383,0.46511627906976744,-135,115,0.5517281312179562,0.44827186878204384,away,PHI,over,7,0.5454545454545454,-120,0.5220180091279142,NYM,PHI,2022 REG,10,6,9,0,6,19,1,0,6,-6,0,0,0,0,0,0,0,0,0,0.5220180091279142,0.4779819908720858
86495,0.574468085106383,0.46511627906976744,-135,115,0.5517281312179562,0.44827186878204384,home,NYM,under,7,0.49751243781094534,101,0.4779819908720858,NYM,PHI,2022 REG,10,6,9,0,6,19,1,0,6,-6,0,0,0,0,0,0,0,0,0,0.5220180091279142,0.4779819908720858
86496,0.5192307692307692,0.5215311004784688,-108,-109,0.49806595226635714,0.5019340477336429,away,OAK,over,8.5,0.5073891625615764,-103,0.4826927225525911,WSH,OAK,2022 REG,11,6,13,10,16,24,0,1,-4,4,1,1,1,1,1,1,0,0,0,0.4826927225525911,0.5173072774474089
86496,0.5192307692307692,0.5215311004784688,-108,-109,0.49806595226635714,0.5019340477336429,home,WSH,under,8.5,0.5412844036697247,-118,0.5173072774474089,WSH,OAK,2022 REG,11,6,13,10,16,24,0,1,-4,4,1,1,1,1,1,1,0,0,0,0.4826927225525911,0.5173072774474089
86497,0.4081632653061224,0.6254681647940076,145,-167,0.39443615097953877,0.6055638490204612,away,CWS,over,8.5,0.5073891625615764,-103,0.4837652908580103,CLE,CWS,2022 REG,8,0,9,7,7,17,0,1,-7,7,0,0,0,0,0,0,0,0,0,0.4837652908580103,0.5162347091419897
86497,0.4081632653061224,0.6254681647940076,145,-167,0.39443615097953877,0.6055638490204612,home,CLE,under,8.5,0.5391705069124424,-117,0.5162347091419897,CLE,CWS,2022 REG,8,0,9,7,7,17,0,1,-7,7,0,0,0,0,0,0,0,0,0,0.4837652908580103,0.5162347091419897
86498,0.4329004329004329,0.607843137254902,131,-155,0.41526252374227923,0.5847374762577208,away,CWS,over,8,0.5121951219512195,-105,0.48808156828023186,KC,CWS,2022 REG,6,6,10,4,10,16,1,0,2,-2,1,1,1,1,0,0,0,0,0,0.48808156828023186,0.5119184317197681
86498,0.4329004329004329,0.607843137254902,131,-155,0.41526252374227923,0.5847374762577208,home,KC,under,8,0.5348837209302326,-115,0.5119184317197681,KC,CWS,2022 REG,6,6,10,4,10,16,1,0,2,-2,1,1,1,1,0,0,0,0,0,0.48808156828023186,0.5119184317197681
86499,0.6721311475409836,0.36764705882352944,-205,172,0.6453949760500813,0.35460502394991866,away,CHC,over,8.5,0.5327102803738317,-114,0.5062779990911175,LAD,CHC,2022 REG,6,4,5,3,7,11,1,0,1,-1,1,1,1,0,0,0,0,0,0,0.5062779990911175,0.4937220009088825
86499,0.6721311475409836,0.36764705882352944,-205,172,0.6453949760500813,0.35460502394991866,home,LAD,under,8.5,0.5169082125603864,-107,0.4937220009088825,LAD,CHC,2022 REG,6,4,5,3,7,11,1,0,1,-1,1,1,1,0,0,0,0,0,0,0.5062779990911175,0.4937220009088825
86500,0.5215311004784688,0.5238095238095238,-109,-110,0.4978845547971712,0.5021154452028288,away,TEX,over,8.5,0.5238095238095238,-110,0.4988662131519274,BAL,TEX,2022 REG,12,7,9,6,13,21,1,0,1,-1,1,1,1,1,1,1,0,0,0,0.4988662131519274,0.5011337868480725
86500,0.5215311004784688,0.5238095238095238,-109,-110,0.4978845547971712,0.5021154452028288,home,BAL,under,8.5,0.5238095238095238,-110,0.5011337868480725,BAL,TEX,2022 REG,12,7,9,6,13,21,1,0,1,-1,1,1,1,1,1,1,0,0,0,0.4988662131519274,0.5011337868480725
86501,0.7455470737913487,0.29411764705882354,-293,240,0.7159751572287522,0.28402484277124784,away,CIN,over,7.5,0.5412844036697247,-118,0.5175913212324037,MIL,CIN,2022 REG,9,7,9,6,13,18,1,0,1,-1,1,1,1,1,1,1,0,0,0,0.5175913212324037,0.4824086787675963
86501,0.7455470737913487,0.29411764705882354,-293,240,0.7159751572287522,0.28402484277124784,home,MIL,under,7.5,0.5024875621890548,-101,0.4824086787675963,MIL,CIN,2022 REG,9,7,9,6,13,18,1,0,1,-1,1,1,1,1,1,1,0,0,0,0.5175913212324037,0.4824086787675963
86502,0.5850622406639003,0.45454545454545453,-141,120,0.5618892737571823,0.43811072624281766,away,CLE,over,10,0.5121951219512195,-105,0.48808156828023186,BOS,CLE,2022 REG,7,3,12,8,11,19,0,1,-5,5,1,1,1,0,0,0,0,0,0,0.48808156828023186,0.5119184317197681
86502,0.5850622406639003,0.45454545454545453,-141,120,0.5618892737571823,0.43811072624281766,home,BOS,under,10,0.5348837209302326,-115,0.5119184317197681,BOS,CLE,2022 REG,7,3,12,8,11,19,0,1,-5,5,1,1,1,0,0,0,0,0,0,0.48808156828023186,0.5119184317197681
86503,0.3115264797507788,0.7333333333333333,221,-275,0.29755146009840744,0.7024485399015925,away,NYM,over,8.5,0.5283018867924528,-112,0.5031902949311281,WSH,NYM,2022 REG,6,3,13,7,10,19,0,1,-4,4,1,1,1,0,0,0,0,0,0,0.5031902949311281,0.4968097050688719
86503,0.3115264797507788,0.7333333333333333,221,-275,0.29755146009840744,0.7024485399015925,home,WSH,under,8.5,0.5192307692307692,-108,0.4968097050688719,WSH,NYM,2022 REG,6,3,13,7,10,19,0,1,-4,4,1,1,1,0,0,0,0,0,0,0.5031902949311281,0.4968097050688719
86504,0.45248868778280543,0.5918367346938775,121,-145,0.4324319355309127,0.5675680644690873,away,STL,over,9.5,0.5260663507109005,-111,0.5010269332605688,PHI,STL,2022 REG,7,5,7,3,8,14,1,0,2,-2,1,1,1,0,0,0,0,0,0,0.5010269332605688,0.4989730667394312
86504,0.45248868778280543,0.5918367346938775,121,-145,0.4324319355309127,0.5675680644690873,home,PHI,under,9.5,0.5215311004784688,-109,0.4989730667394312,PHI,STL,2022 REG,7,5,7,3,8,14,1,0,2,-2,1,1,1,0,0,0,0,0,0,0.5010269332605688,0.4989730667394312
86505,0.5024875621890548,0.5412844036697247,-101,-118,0.48049269377245407,0.5195073062275459,away,LAA,over,10,0.5215311004784688,-109,0.49907282342437215,TEX,LAA,2022 REG,8,6,11,9,15,19,0,1,-3,3,1,1,1,1,1,1,0,0,0,0.49907282342437215,0.5009271765756278
86505,0.5024875621890548,0.5412844036697247,-101,-118,0.48049269377245407,0.5195073062275459,home,TEX,under,10,0.5215311004784688,-109,0.5009271765756278,TEX,LAA,2022 REG,8,6,11,9,15,19,0,1,-3,3,1,1,1,1,1,1,0,0,0,0.49907282342437215,0.5009271765756278
86506,0.6153846153846154,0.42372881355932196,-160,136,0.591314812957577,0.40868518704242296,away,WSH,over,9,0.5348837209302326,-115,0.5097020142727117,TEX,WSH,2022 REG,8,1,9,2,3,17,0,1,-1,1,1,0,0,0,0,0,0,0,0,0.5097020142727117,0.49029798572728833
86506,0.6153846153846154,0.42372881355932196,-160,136,0.591314812957577,0.40868518704242296,home,TEX,under,9,0.5121951219512195,-105,0.49029798572728833,TEX,WSH,2022 REG,8,1,9,2,3,17,0,1,-1,1,1,0,0,0,0,0,0,0,0,0.5097020142727117,0.49029798572728833
86507,0.3846153846153846,0.6503496503496503,160,-186,0.3711672942442173,0.6288327057557828,away,NYY,over,9,0.5283018867924528,-112,0.5044173060022736,BAL,NYY,2022 REG,7,2,11,5,7,18,0,1,-3,3,1,1,0,0,0,0,0,0,0,0.5044173060022736,0.49558269399772636
86507,0.3846153846153846,0.6503496503496503,160,-186,0.3711672942442173,0.6288327057557828,home,BAL,under,9,0.5169082125603864,-107,0.49558269399772636,BAL,NYY,2022 REG,7,2,11,5,7,18,0,1,-3,3,1,1,0,0,0,0,0,0,0,0.5044173060022736,0.49558269399772636
86508,0.4587155963302753,0.5833333333333333,118,-140,0.4394270964845833,0.5605729035154168,away,NYM,over,9,0.5145631067961165,-106,0.4913668392989033,ARI,NYM,2022 REG,11,5,7,2,7,18,1,0,3,-3,1,1,0,0,0,0,0,0,0,0.4913668392989033,0.5086331607010968
86508,0.4587155963302753,0.5833333333333333,118,-140,0.4394270964845833,0.5605729035154168,home,ARI,under,9,0.5305164319248826,-113,0.5086331607010968,ARI,NYM,2022 REG,11,5,7,2,7,18,1,0,3,-3,1,1,0,0,0,0,0,0,0,0.4913668392989033,0.5086331607010968
86509,0.7142857142857143,0.3333333333333333,-250,200,0.6802721088435374,0.3197278911564626,away,DET,over,8,0.5283018867924528,-112,0.5056562298022652,MIN,DET,2022 REG,8,2,5,0,2,13,1,0,2,-2,0,0,0,0,0,0,0,0,0,0.5056562298022652,0.4943437701977348
86509,0.7142857142857143,0.3333333333333333,-250,200,0.6802721088435374,0.3197278911564626,home,MIN,under,8,0.5145631067961165,-106,0.4943437701977348,MIN,DET,2022 REG,8,2,5,0,2,13,1,0,2,-2,0,0,0,0,0,0,0,0,0,0.5056562298022652,0.4943437701977348
86510,0.6551724137931035,0.3846153846153846,-190,160,0.6291045458703008,0.37089545412969915,away,PHI,over,9.5,0.5121951219512195,-105,0.48919479393107135,TOR,PHI,2022 REG,14,4,7,3,7,21,1,0,1,-1,1,1,1,0,0,0,0,0,0,0.48919479393107135,0.5108052060689287
86510,0.6551724137931035,0.3846153846153846,-190,160,0.6291045458703008,0.37089545412969915,home,TOR,under,9.5,0.5327102803738317,-114,0.5108052060689287,TOR,PHI,2022 REG,14,4,7,3,7,21,1,0,1,-1,1,1,1,0,0,0,0,0,0,0.48919479393107135,0.5108052060689287
86511,0.3389830508474576,0.7032640949554896,195,-237,0.3246619844735772,0.6753380155264228,away,LAD,over,6.5,0.5555555555555556,-125,0.5314664257753688,CHC,LAD,2022 REG,5,0,11,7,7,16,0,1,-7,7,0,0,0,0,0,0,0,0,0,0.5314664257753688,0.46853357422463116
86511,0.3389830508474576,0.7032640949554896,195,-237,0.3246619844735772,0.6753380155264228,home,CHC,under,6.5,0.48780487804878053,105,0.46853357422463116,CHC,LAD,2022 REG,5,0,11,7,7,16,0,1,-7,7,0,0,0,0,0,0,0,0,0,0.5314664257753688,0.46853357422463116
86512,0.4672897196261683,0.5708154506437768,114,-133,0.44948356529441824,0.5505164347055818,away,SD,over,8,0.5433789954337899,-119,0.5171177654451503,ARI,SD,2022 REG,4,0,9,4,4,13,0,1,-4,4,0,0,0,0,0,0,0,0,0,0.5171177654451503,0.4828822345548497
86512,0.4672897196261683,0.5708154506437768,114,-133,0.44948356529441824,0.5505164347055818,home,ARI,under,8,0.504950495049505,-102,0.4828822345548497,ARI,SD,2022 REG,4,0,9,4,4,13,0,1,-4,4,0,0,0,0,0,0,0,0,0,0.5171177654451503,0.4828822345548497
86513,0.5024875621890548,0.5370370370370371,-101,-116,0.48262694267743644,0.5173730573225636,away,CHC,over,9,0.49751243781094534,101,0.476135829221149,BAL,CHC,2022 REG,9,9,7,3,12,16,1,0,6,-6,1,1,1,0,0,0,0,0,0,0.476135829221149,0.523864170778851
86513,0.5024875621890548,0.5370370370370371,-101,-116,0.48262694267743644,0.5173730573225636,home,BAL,under,9,0.5454545454545454,-120,0.523864170778851,BAL,CHC,2022 REG,9,9,7,3,12,16,1,0,6,-6,1,1,1,0,0,0,0,0,0,0.476135829221149,0.523864170778851
86514,0.6226415094339623,0.4166666666666667,-165,140,0.5981666073335706,0.40183339266642937,away,BOS,over,9.5,0.5192307692307692,-108,0.49688292476754015,NYY,BOS,2022 REG,4,4,5,2,6,9,1,0,2,-2,1,1,0,0,0,0,0,0,0,0.49688292476754015,0.5031170752324599
86514,0.6226415094339623,0.4166666666666667,-165,140,0.5981666073335706,0.40183339266642937,home,NYY,under,9.5,0.5238095238095238,-110,0.5031170752324599,NYY,BOS,2022 REG,4,4,5,2,6,9,1,0,2,-2,1,1,0,0,0,0,0,0,0,0.49688292476754015,0.5031170752324599
86515,0.3436426116838488,0.6923076923076923,191,-225,0.33128855532936735,0.6687114446706326,away,NYM,over,8.5,0.5215311004784688,-109,0.4978845547971712,PIT,NYM,2022 REG,12,8,7,2,10,19,1,0,6,-6,1,1,0,0,0,0,0,0,0,0.4978845547971712,0.5021154452028288
86515,0.3436426116838488,0.6923076923076923,191,-225,0.33128855532936735,0.6687114446706326,home,PIT,under,8.5,0.5238095238095238,-110,0.5021154452028288,PIT,NYM,2022 REG,12,8,7,2,10,19,1,0,6,-6,1,1,0,0,0,0,0,0,0,0.4978845547971712,0.5021154452028288
86516,0.6376811594202898,0.4,-176,150,0.6136525939928585,0.38634740600714146,away,KC,over,7,0.5145631067961165,-106,0.4913668392989033,CWS,KC,2022 REG,5,2,6,5,7,11,0,1,-3,3,1,1,0,0,0,0,0,0,0,0.4913668392989033,0.5086331607010968
86516,0.6376811594202898,0.4,-176,150,0.6136525939928585,0.38634740600714146,home,CWS,under,7,0.5305164319248826,-113,0.5086331607010968,CWS,KC,2022 REG,5,2,6,5,7,11,0,1,-3,3,1,1,0,0,0,0,0,0,0,0.4913668392989033,0.5086331607010968
86517,0.41493775933609955,0.6254681647940076,141,-167,0.39817181571364846,0.6018281842863515,away,SF,over,8,0.5348837209302326,-115,0.5097020142727117,WSH,SF,2022 REG,7,2,10,5,7,17,0,1,-3,3,1,1,0,0,0,0,0,0,0,0.5097020142727117,0.49029798572728833
86517,0.41493775933609955,0.6254681647940076,141,-167,0.39817181571364846,0.6018281842863515,home,WSH,under,8,0.5121951219512195,-105,0.49029798572728833,WSH,SF,2022 REG,7,2,10,5,7,17,0,1,-3,3,1,1,0,0,0,0,0,0,0,0.5097020142727117,0.49029798572728833
86518,0.3424657534246575,0.6941896024464832,192,-227,0.3299125493591984,0.6700874506408017,away,NYY,over,8.5,0.5192307692307692,-108,0.49571111079951763,CLE,NYY,2022 REG,5,4,14,13,17,19,0,1,-9,9,1,1,1,1,0,0,0,0,0,0.49571111079951763,0.5042888892004824
86518,0.3424657534246575,0.6941896024464832,192,-227,0.3299125493591984,0.6700874506408017,home,CLE,under,8.5,0.5260663507109005,-111,0.5042888892004824,CLE,NYY,2022 REG,5,4,14,13,17,19,0,1,-9,9,1,1,1,1,0,0,0,0,0,0.49571111079951763,0.5042888892004824
86519,0.5555555555555556,0.4854368932038835,-125,106,0.5327819729114227,0.4672180270885773,away,BOS,over,8,0.5238095238095238,-110,0.4988662131519274,MIN,BOS,2022 REG,9,5,13,6,11,22,0,1,-1,1,1,1,1,1,1,0,0,0,0,0.4988662131519274,0.5011337868480725
86519,0.5555555555555556,0.4854368932038835,-125,106,0.5327819729114227,0.4672180270885773,home,MIN,under,8,0.5238095238095238,-110,0.5011337868480725,MIN,BOS,2022 REG,9,5,13,6,11,22,0,1,-1,1,1,1,1,1,1,0,0,0,0,0.4988662131519274,0.5011337868480725
86520,0.8058252427184467,0.23529411764705882,-415,325,0.7726902241714859,0.22730977582851408,away,COL,over,7.5,0.5238095238095238,-110,0.4988662131519274,LAD,COL,2022 REG,15,10,7,1,11,22,1,0,9,-9,1,0,0,0,0,0,0,0,0,0.4988662131519274,0.5011337868480725
86520,0.8058252427184467,0.23529411764705882,-415,325,0.7726902241714859,0.22730977582851408,home,LAD,under,7.5,0.5238095238095238,-110,0.5011337868480725,LAD,COL,2022 REG,15,10,7,1,11,22,1,0,9,-9,1,0,0,0,0,0,0,0,0,0.4988662131519274,0.5011337868480725
86521,0.7076023391812866,0.3367003367003367,-242,197,0.6762536620954597,0.3237463379045403,away,MIA,over,7,0.5391705069124424,-117,0.5114756747601454,PHI,MIA,2022 REG,8,4,5,1,5,13,1,0,3,-3,1,0,0,0,0,0,0,0,0,0.5114756747601454,0.48852432523985456
86521,0.7076023391812866,0.3367003367003367,-242,197,0.6762536620954597,0.3237463379045403,home,PHI,under,7,0.5121951219512195,-105,0.48852432523985456,PHI,MIA,2022 REG,8,4,5,1,5,13,1,0,3,-3,1,0,0,0,0,0,0,0,0,0.5114756747601454,0.48852432523985456
86522,0.6254681647940076,0.4081632653061224,-167,145,0.6044327759298813,0.3955672240701187,away,DET,over,8,0.5370370370370371,-116,0.5118817074154765,ARI,DET,2022 REG,3,1,9,5,6,12,0,1,-4,4,1,0,0,0,0,0,0,0,0,0.5118817074154765,0.48811829258452355
86522,0.6254681647940076,0.4081632653061224,-167,145,0.6044327759298813,0.3955672240701187,home,ARI,under,8,0.5098039215686274,-104,0.48811829258452355,ARI,DET,2022 REG,3,1,9,5,6,12,0,1,-4,4,1,0,0,0,0,0,0,0,0,0.5118817074154765,0.48811829258452355
86523,0.6666666666666666,0.37453183520599254,-200,167,0.6392009987515606,0.36079900124843944,away,OAK,over,7.5,0.5327102803738317,-114,0.508788710910954,NYY,OAK,2022 REG,5,2,6,1,3,11,1,0,1,-1,1,0,0,0,0,0,0,0,0,0.508788710910954,0.491211289089046
86523,0.6666666666666666,0.37453183520599254,-200,167,0.6392009987515606,0.36079900124843944,home,NYY,under,7.5,0.5121951219512195,-105,0.491211289089046,NYY,OAK,2022 REG,5,2,6,1,3,11,1,0,1,-1,1,0,0,0,0,0,0,0,0,0.508788710910954,0.491211289089046
86524,0.5555555555555556,0.48780487804878053,-125,105,0.5314664257753688,0.46853357422463116,away,CHC,over,8,0.5283018867924528,-112,0.5031902949311281,PIT,CHC,2022 REG,6,5,10,6,11,16,0,1,-1,1,1,1,1,1,1,0,0,0,0,0.5031902949311281,0.4968097050688719
86524,0.5555555555555556,0.48780487804878053,-125,105,0.5314664257753688,0.46853357422463116,home,PIT,under,8,0.5192307692307692,-108,0.4968097050688719,PIT,CHC,2022 REG,6,5,10,6,11,16,0,1,-1,1,1,1,1,1,1,0,0,0,0,0.5031902949311281,0.4968097050688719
86525,0.425531914893617,0.613899613899614,135,-159,0.40875254093905067,0.5912474590609493,away,NYM,over,9,0.504950495049505,-102,0.4837488699364985,ARI,NYM,2022 REG,6,2,10,6,8,16,0,1,-4,4,1,1,0,0,0,0,0,0,0,0.4837488699364985,0.5162511300635015
86525,0.425531914893617,0.613899613899614,135,-159,0.40875254093905067,0.5912474590609493,home,ARI,under,9,0.5370370370370371,-116,0.5162511300635015,ARI,NYM,2022 REG,6,2,10,6,8,16,0,1,-4,4,1,1,0,0,0,0,0,0,0,0.4837488699364985,0.5162511300635015
86526,0.6551724137931035,0.3802281368821293,-190,163,0.6319789495576061,0.36802105044239386,away,KC,over,8.5,0.5169082125603864,-107,0.49353874091423283,MIN,KC,2022 REG,11,6,2,3,9,13,1,0,3,-3,1,1,1,0,0,0,0,0,0,0.49353874091423283,0.5064612590857671
86526,0.6551724137931035,0.3802281368821293,-190,163,0.6319789495576061,0.36802105044239386,home,MIN,under,8.5,0.5283018867924528,-112,0.5064612590857671,MIN,KC,2022 REG,11,6,2,3,9,13,1,0,3,-3,1,1,1,0,0,0,0,0,0,0.49353874091423283,0.5064612590857671
86527,0.6197718631178707,0.41493775933609955,-163,141,0.5982598157414557,0.4017401842585443,away,SEA,over,7.5,0.5098039215686274,-104,0.4870219861770517,NYM,SEA,2022 REG,7,5,9,4,9,16,1,0,1,-1,1,1,1,1,0,0,0,0,0,0.4870219861770517,0.5129780138229483
86527,0.6197718631178707,0.41493775933609955,-163,141,0.5982598157414557,0.4017401842585443,home,NYM,under,7.5,0.5348837209302326,-115,0.5129780138229483,NYM,SEA,2022 REG,7,5,9,4,9,16,1,0,1,-1,1,1,1,1,0,0,0,0,0,0.4870219861770517,0.5129780138229483
86528,0.6551724137931035,0.3861003861003861,-190,159,0.6281316138628862,0.3718683861371138,away,SEA,over,8,0.5121951219512195,-105,0.48808156828023186,SD,SEA,2022 REG,7,2,12,8,10,19,0,1,-6,6,1,1,0,0,0,0,0,0,0,0.48808156828023186,0.5119184317197681
86528,0.6551724137931035,0.3861003861003861,-190,159,0.6281316138628862,0.3718683861371138,home,SD,under,8,0.5348837209302326,-115,0.5119184317197681,SD,SEA,2022 REG,7,2,12,8,10,19,0,1,-6,6,1,1,0,0,0,0,0,0,0,0.48808156828023186,0.5119184317197681
86529,0.635036496350365,0.4081632653061224,-174,145,0.6076030710648583,0.39239692893514166,away,PIT,over,7.5,0.5348837209302326,-115,0.5097020142727117,MIL,PIT,2022 REG,9,6,13,8,14,22,0,1,-2,2,1,1,1,1,1,1,0,0,0,0.5097020142727117,0.49029798572728833
86529,0.635036496350365,0.4081632653061224,-174,145,0.6076030710648583,0.39239692893514166,home,MIL,under,7.5,0.5121951219512195,-105,0.49029798572728833,MIL,PIT,2022 REG,9,6,13,8,14,22,0,1,-2,2,1,1,1,1,1,1,0,0,0,0.5097020142727117,0.49029798572728833
86530,0.5121951219512195,0.5305164319248826,-105,-113,0.4903184724049234,0.5096815275950766,away,SEA,over,7.5,0.5121951219512195,-105,0.48808156828023186,MIA,SEA,2022 REG,6,3,5,1,4,11,1,0,2,-2,1,0,0,0,0,0,0,0,0,0.48808156828023186,0.5119184317197681
86530,0.5121951219512195,0.5305164319248826,-105,-113,0.4903184724049234,0.5096815275950766,home,MIA,under,7.5,0.5348837209302326,-115,0.5119184317197681,MIA,SEA,2022 REG,6,3,5,1,4,11,1,0,2,-2,1,0,0,0,0,0,0,0,0,0.48808156828023186,0.5119184317197681
86531,0.5555555555555556,0.4807692307692307,-125,108,0.5353751187084521,0.4646248812915479,away,CLE,over,7.5,0.504950495049505,-102,0.48160416005266615,TEX,CLE,2022 REG,9,3,7,6,9,16,0,1,-3,3,1,1,1,0,0,0,0,0,0,0.48160416005266615,0.5183958399473338
86531,0.5555555555555556,0.4807692307692307,-125,108,0.5353751187084521,0.4646248812915479,home,TEX,under,7.5,0.5412844036697247,-118,0.5183958399473338,TEX,CLE,2022 REG,9,3,7,6,9,16,0,1,-3,3,1,1,1,0,0,0,0,0,0,0.48160416005266615,0.5183958399473338
86532,0.5555555555555556,0.48780487804878053,-125,105,0.5314664257753688,0.46853357422463116,away,OAK,over,8,0.5412844036697247,-118,0.5175913212324037,LAA,OAK,2022 REG,9,7,8,8,15,17,0,1,-1,1,1,1,1,1,1,1,1,0,0,0.5175913212324037,0.4824086787675963
86532,0.5555555555555556,0.48780487804878053,-125,105,0.5314664257753688,0.46853357422463116,home,LAA,under,8,0.5024875621890548,-101,0.4824086787675963,LAA,OAK,2022 REG,9,7,8,8,15,17,0,1,-1,1,1,1,1,1,1,1,1,0,0,0.5175913212324037,0.4824086787675963
86533,0.5555555555555556,0.48780487804878053,-125,105,0.5314664257753688,0.46853357422463116,away,TEX,over,8.5,0.5305164319248826,-113,0.5066009958897986,LAA,TEX,2022 REG,7,9,8,7,16,15,1,0,2,-2,1,1,1,1,1,1,1,0,0,0.5066009958897986,0.49339900411020143
86533,0.5555555555555556,0.48780487804878053,-125,105,0.5314664257753688,0.46853357422463116,home,LAA,under,8.5,0.5145631067961165,-106,0.49339900411020143,LAA,TEX,2022 REG,7,9,8,7,16,15,1,0,2,-2,1,1,1,1,1,1,1,0,0,0.5066009958897986,0.49339900411020143
86534,0.44052863436123346,0.6031746031746031,127,-152,0.4212761068124068,0.5787238931875932,away,BAL,over,8.5,0.5348837209302326,-115,0.5109810284308424,WSH,BAL,2022 REG,4,2,11,6,8,15,0,1,-4,4,1,1,0,0,0,0,0,0,0,0.5109810284308424,0.48901897156915763
86534,0.44052863436123346,0.6031746031746031,127,-152,0.4212761068124068,0.5787238931875932,home,WSH,under,8.5,0.5098039215686274,-104,0.48901897156915763,WSH,BAL,2022 REG,4,2,11,6,8,15,0,1,-4,4,1,1,0,0,0,0,0,0,0,0.5109810284308424,0.48901897156915763
86535,0.5934959349593496,0.4444444444444444,-146,125,0.5709784740123824,0.42902152598761756,away,BAL,over,7.5,0.5,100,0.4772727272727273,TB,BAL,2022 REG,5,3,19,10,13,24,0,1,-7,7,1,1,1,0,0,0,0,0,0,0.4772727272727273,0.5227272727272727
86535,0.5934959349593496,0.4444444444444444,-146,125,0.5709784740123824,0.42902152598761756,home,TB,under,7.5,0.5454545454545454,-120,0.5227272727272727,TB,BAL,2022 REG,5,3,19,10,13,24,0,1,-7,7,1,1,1,0,0,0,0,0,0,0.4772727272727273,0.5227272727272727
86536,0.6428571428571428,0.3968253968253968,-180,152,0.6173469387755103,0.3826530612244897,away,MIA,over,8,0.5121951219512195,-105,0.48808156828023186,NYM,MIA,2022 REG,5,5,10,4,9,15,1,0,1,-1,1,1,1,1,0,0,0,0,0,0.48808156828023186,0.5119184317197681
86536,0.6428571428571428,0.3968253968253968,-180,152,0.6173469387755103,0.3826530612244897,home,NYM,under,8,0.5348837209302326,-115,0.5119184317197681,NYM,MIA,2022 REG,5,5,10,4,9,15,1,0,1,-1,1,1,1,1,0,0,0,0,0,0.48808156828023186,0.5119184317197681
86537,0.4608294930875576,0.5780590717299579,117,-137,0.44290849547579936,0.5570915045242006,away,HOU,over,8.5,0.5215311004784688,-109,0.4978845547971712,KC,HOU,2022 REG,6,3,14,10,13,20,0,1,-7,7,1,1,1,0,0,0,0,0,0,0.4978845547971712,0.5021154452028288
86537,0.4608294930875576,0.5780590717299579,117,-137,0.44290849547579936,0.5570915045242006,home,KC,under,8.5,0.5238095238095238,-110,0.5021154452028288,KC,HOU,2022 REG,6,3,14,10,13,20,0,1,-7,7,1,1,1,0,0,0,0,0,0,0.4978845547971712,0.5021154452028288
86538,0.4672897196261683,0.574468085106383,114,-135,0.4477767267604901,0.5522232732395099,away,PHI,over,11.5,0.5327102803738317,-114,0.508788710910954,COL,PHI,2022 REG,8,6,11,5,11,19,1,0,1,-1,1,1,1,1,1,0,0,0,0,0.508788710910954,0.491211289089046
86538,0.4672897196261683,0.574468085106383,114,-135,0.4477767267604901,0.5522232732395099,home,COL,under,11.5,0.5121951219512195,-105,0.491211289089046,COL,PHI,2022 REG,8,6,11,5,11,19,1,0,1,-1,1,1,1,1,1,0,0,0,0,0.508788710910954,0.491211289089046
86539,0.6551724137931035,0.38759689922480617,-190,158,0.6271511397468869,0.37284886025311315,away,BOS,over,7.5,0.5024875621890548,-101,0.48049269377245407,NYY,BOS,2022 REG,14,13,6,2,15,20,1,0,11,-11,1,1,0,0,0,0,0,0,0,0.48049269377245407,0.5195073062275459
86539,0.6551724137931035,0.38759689922480617,-190,158,0.6271511397468869,0.37284886025311315,home,NYY,under,7.5,0.5412844036697247,-118,0.5195073062275459,NYY,BOS,2022 REG,14,13,6,2,15,20,1,0,11,-11,1,1,0,0,0,0,0,0,0,0.48049269377245407,0.5195073062275459
86540,0.6197718631178707,0.42016806722689076,-163,138,0.5950182180753,0.4049817819247,away,SD,over,9.5,0.5305164319248826,-113,0.5066009958897986,LAD,SD,2022 REG,9,9,8,4,13,17,1,0,5,-5,1,1,1,1,0,0,0,0,0,0.5066009958897986,0.49339900411020143
86540,0.6197718631178707,0.42016806722689076,-163,138,0.5950182180753,0.4049817819247,home,LAD,under,9.5,0.5145631067961165,-106,0.49339900411020143,LAD,SD,2022 REG,9,9,8,4,13,17,1,0,5,-5,1,1,1,1,0,0,0,0,0,0.5066009958897986,0.49339900411020143
86541,0.6875,0.35460992907801414,-220,182,0.6585494237588654,0.3414505762411346,away,DET,over,8,0.5121951219512195,-105,0.48808156828023186,CLE,DET,2022 REG,8,3,11,4,7,19,0,1,-1,1,1,1,1,0,0,0,0,0,0,0.48808156828023186,0.5119184317197681
86541,0.6875,0.35460992907801414,-220,182,0.6585494237588654,0.3414505762411346,home,CLE,under,8,0.5348837209302326,-115,0.5119184317197681,CLE,DET,2022 REG,8,3,11,4,7,19,0,1,-1,1,1,1,1,0,0,0,0,0,0,0.48808156828023186,0.5119184317197681
86542,0.5121951219512195,0.5348837209302326,-105,-115,0.48808156828023186,0.5119184317197681,away,BOS,over,8.5,0.5391705069124424,-117,0.5140669063204599,SEA,BOS,2022 REG,10,3,6,4,7,16,0,1,-1,1,1,1,1,0,0,0,0,0,0,0.5140669063204599,0.4859330936795401
86542,0.5121951219512195,0.5348837209302326,-105,-115,0.48808156828023186,0.5119184317197681,home,SEA,under,8.5,0.5073891625615764,-103,0.4859330936795401,SEA,BOS,2022 REG,10,3,6,4,7,16,0,1,-1,1,1,1,1,0,0,0,0,0,0,0.5140669063204599,0.4859330936795401
86543,0.5726495726495727,0.4672897196261683,-134,114,0.5497783539959433,0.4502216460040567,away,SEA,over,9.5,0.5073891625615764,-103,0.4837652908580103,BOS,SEA,2022 REG,10,8,9,4,12,19,1,0,4,-4,1,1,1,1,0,0,0,0,0,0.4837652908580103,0.5162347091419897
86543,0.5726495726495727,0.4672897196261683,-134,114,0.5497783539959433,0.4502216460040567,home,BOS,under,9.5,0.5391705069124424,-117,0.5162347091419897,BOS,SEA,2022 REG,10,8,9,4,12,19,1,0,4,-4,1,1,1,1,0,0,0,0,0,0.4837652908580103,0.5162347091419897
86544,0.6845425867507886,0.35211267605633806,-217,184,0.6594504983307682,0.3405495016692318,away,ARI,over,9,0.5215311004784688,-109,0.49907282342437215,LAD,ARI,2022 REG,13,6,10,5,11,23,1,0,1,-1,1,1,1,1,1,0,0,0,0,0.49907282342437215,0.5009271765756278
86544,0.6845425867507886,0.35211267605633806,-217,184,0.6594504983307682,0.3405495016692318,home,LAD,under,9,0.5215311004784688,-109,0.5009271765756278,LAD,ARI,2022 REG,13,6,10,5,11,23,1,0,1,-1,1,1,1,1,1,0,0,0,0,0.49907282342437215,0.5009271765756278
86545,0.5833333333333333,0.4587155963302753,-140,118,0.5588047910295616,0.4411952089704384,away,CWS,over,7.5,0.5169082125603864,-107,0.49353874091423283,CLE,CWS,2022 REG,6,2,3,1,3,9,1,0,1,-1,1,0,0,0,0,0,0,0,0,0.49353874091423283,0.5064612590857671
86545,0.5833333333333333,0.4587155963302753,-140,118,0.5588047910295616,0.4411952089704384,home,CLE,under,7.5,0.5283018867924528,-112,0.5064612590857671,CLE,CWS,2022 REG,6,2,3,1,3,9,1,0,1,-1,1,0,0,0,0,0,0,0,0,0.49353874091423283,0.5064612590857671
86546,0.6226415094339623,0.4166666666666667,-165,140,0.5981666073335706,0.40183339266642937,away,CWS,over,8,0.5121951219512195,-105,0.48808156828023186,HOU,CWS,2022 REG,12,13,8,3,16,20,1,0,10,-10,1,1,1,0,0,0,0,0,0,0.48808156828023186,0.5119184317197681
86546,0.6226415094339623,0.4166666666666667,-165,140,0.5981666073335706,0.40183339266642937,home,HOU,under,8,0.5348837209302326,-115,0.5119184317197681,HOU,CWS,2022 REG,12,13,8,3,16,20,1,0,10,-10,1,1,1,0,0,0,0,0,0,0.48808156828023186,0.5119184317197681
86547,0.5833333333333333,0.45454545454545453,-140,120,0.5612373737373737,0.4387626262626263,away,COL,over,8,0.5238095238095238,-110,0.4988662131519274,DET,COL,2022 REG,20,13,7,0,13,27,1,0,13,-13,0,0,0,0,0,0,0,0,0,0.4988662131519274,0.5011337868480725
86547,0.5833333333333333,0.45454545454545453,-140,120,0.5612373737373737,0.4387626262626263,home,DET,under,8,0.5238095238095238,-110,0.5011337868480725,DET,COL,2022 REG,20,13,7,0,13,27,1,0,13,-13,0,0,0,0,0,0,0,0,0,0.4988662131519274,0.5011337868480725
86548,0.47846889952153115,0.5594713656387665,109,-127,0.4603156626027285,0.5396843373972715,away,TEX,over,7.5,0.5283018867924528,-112,0.5044173060022736,OAK,TEX,2022 REG,2,1,9,8,9,11,0,1,-7,7,1,0,0,0,0,0,0,0,0,0.5044173060022736,0.49558269399772636
86548,0.47846889952153115,0.5594713656387665,109,-127,0.4603156626027285,0.5396843373972715,away,TEX,over,8.5,0.5073891625615764,-103,0.4837652908580103,OAK,TEX,2022 REG,2,1,9,8,9,11,0,1,-7,7,1,0,0,0,0,0,0,0,0,0.5044173060022736,0.49558269399772636
86548,0.47846889952153115,0.5594713656387665,109,-127,0.4603156626027285,0.5396843373972715,home,OAK,under,7.5,0.5169082125603864,-107,0.49558269399772636,OAK,TEX,2022 REG,2,1,9,8,9,11,0,1,-7,7,1,0,0,0,0,0,0,0,0,0.5044173060022736,0.49558269399772636
86548,0.47846889952153115,0.5594713656387665,109,-127,0.4603156626027285,0.5396843373972715,home,OAK,under,8.5,0.5391705069124424,-117,0.5162347091419897,OAK,TEX,2022 REG,2,1,9,8,9,11,0,1,-7,7,1,0,0,0,0,0,0,0,0,0.5044173060022736,0.49558269399772636
86549,0.5689655172413793,0.47619047619047616,-132,110,0.5432733140818753,0.4567266859181247,away,WSH,over,9.5,0.5121951219512195,-105,0.48808156828023186,CIN,WSH,2022 REG,10,8,5,1,9,15,1,0,7,-7,1,0,0,0,0,0,0,0,0,0.48808156828023186,0.5119184317197681
86549,0.5689655172413793,0.47619047619047616,-132,110,0.5432733140818753,0.4567266859181247,home,CIN,under,9.5,0.5348837209302326,-115,0.5119184317197681,CIN,WSH,2022 REG,10,8,5,1,9,15,1,0,7,-7,1,0,0,0,0,0,0,0,0,0.48808156828023186,0.5119184317197681
86550,0.5260663507109005,0.5145631067961165,-111,-106,0.5046925602688205,0.4953074397311795,away,TOR,over,8.5,0.5454545454545454,-120,0.5206611570247933,BAL,TOR,2022 REG,9,9,13,6,15,22,1,0,3,-3,1,1,1,1,1,1,0,0,0,0.5206611570247933,0.4793388429752067
86550,0.5260663507109005,0.5145631067961165,-111,-106,0.5046925602688205,0.4953074397311795,home,BAL,under,8.5,0.5,100,0.4793388429752067,BAL,TOR,2022 REG,9,9,13,6,15,22,1,0,3,-3,1,1,1,1,1,1,0,0,0,0.5206611570247933,0.4793388429752067
86551,0.6453900709219857,0.3921568627450981,-182,155,0.6211576527396834,0.3788423472603166,away,KC,over,7.5,0.5305164319248826,-113,0.5066009958897986,CLE,KC,2022 REG,15,9,6,2,11,21,1,0,7,-7,1,1,0,0,0,0,0,0,0,0.5066009958897986,0.49339900411020143
86551,0.6453900709219857,0.3921568627450981,-182,155,0.6211576527396834,0.3788423472603166,home,CLE,under,7.5,0.5145631067961165,-106,0.49339900411020143,CLE,KC,2022 REG,15,9,6,2,11,21,1,0,7,-7,1,1,0,0,0,0,0,0,0,0.5066009958897986,0.49339900411020143
86552,0.49019607843137253,0.5475113122171946,104,-121,0.47171206340756505,0.5282879365924349,away,SF,over,8,0.5412844036697247,-118,0.5149381613977361,CLE,SF,2022 REG,8,2,5,4,6,13,0,1,-2,2,1,1,0,0,0,0,0,0,0,0.5149381613977361,0.48506183860226393
86552,0.49019607843137253,0.5475113122171946,104,-121,0.47171206340756505,0.5282879365924349,home,CLE,under,8,0.5073891625615764,-103,0.48506183860226393,CLE,SF,2022 REG,8,2,5,4,6,13,0,1,-2,2,1,1,0,0,0,0,0,0,0,0.5149381613977361,0.48506183860226393
86553,0.6551724137931035,0.38167938931297707,-190,162,0.6310281289994645,0.3689718710005355,away,COL,over,8,0.5121951219512195,-105,0.48808156828023186,SD,COL,2022 REG,6,2,9,4,6,15,0,1,-2,2,1,1,0,0,0,0,0,0,0,0.48808156828023186,0.5119184317197681
86553,0.6551724137931035,0.38167938931297707,-190,162,0.6310281289994645,0.3689718710005355,home,SD,under,8,0.5348837209302326,-115,0.5119184317197681,SD,COL,2022 REG,6,2,9,4,6,15,0,1,-2,2,1,1,0,0,0,0,0,0,0,0.48808156828023186,0.5119184317197681
86554,0.3424657534246575,0.696969696969697,192,-230,0.32896046219371416,0.6710395378062859,away,HOU,over,8,0.5238095238095238,-110,0.4988662131519274,DET,HOU,2022 REG,5,1,5,2,3,10,0,1,-1,1,1,0,0,0,0,0,0,0,0,0.4988662131519274,0.5011337868480725
86554,0.3424657534246575,0.696969696969697,192,-230,0.32896046219371416,0.6710395378062859,home,DET,under,8,0.5238095238095238,-110,0.5011337868480725,DET,HOU,2022 REG,5,1,5,2,3,10,0,1,-1,1,1,0,0,0,0,0,0,0,0,0.4988662131519274,0.5011337868480725
86555,0.6721311475409836,0.36363636363636365,-205,175,0.6480906892086682,0.3519093107913318,away,LAA,over,6,0.5454545454545454,-120,0.5206611570247933,TB,LAA,2022 REG,7,8,10,3,11,17,1,0,5,-5,1,1,1,0,0,0,0,0,0,0.5206611570247933,0.4793388429752067
86555,0.6721311475409836,0.36363636363636365,-205,175,0.6480906892086682,0.3519093107913318,home,TB,under,6,0.5,100,0.4793388429752067,TB,LAA,2022 REG,7,8,10,3,11,17,1,0,5,-5,1,1,1,0,0,0,0,0,0,0.5206611570247933,0.4793388429752067
86556,0.6226415094339623,0.4166666666666667,-165,140,0.5981666073335706,0.40183339266642937,away,MIN,over,8.5,0.5145631067961165,-106,0.4913668392989033,HOU,MIN,2022 REG,11,6,7,3,9,18,1,0,3,-3,1,1,1,0,0,0,0,0,0,0.4913668392989033,0.5086331607010968
86556,0.6226415094339623,0.4166666666666667,-165,140,0.5981666073335706,0.40183339266642937,home,HOU,under,8.5,0.5305164319248826,-113,0.5086331607010968,HOU,MIN,2022 REG,11,6,7,3,9,18,1,0,3,-3,1,1,1,0,0,0,0,0,0,0.4913668392989033,0.5086331607010968
86557,0.6666666666666666,0.37037037037037035,-200,170,0.6419753086419753,0.3580246913580247,away,OAK,over,8,0.5305164319248826,-113,0.5053568787472517,TB,OAK,2022 REG,7,3,9,6,9,16,0,1,-3,3,1,1,1,0,0,0,0,0,0,0.5053568787472517,0.49464312125274834
86557,0.6666666666666666,0.37037037037037035,-200,170,0.6419753086419753,0.3580246913580247,home,TB,under,8,0.5169082125603864,-107,0.49464312125274834,TB,OAK,2022 REG,7,3,9,6,9,16,0,1,-3,3,1,1,1,0,0,0,0,0,0,0.5053568787472517,0.49464312125274834
86558,0.6108949416342413,0.425531914893617,-157,135,0.5886419592417365,0.41135804075826354,away,ARI,over,7.5,0.5215311004784688,-109,0.4978845547971712,SD,ARI,2022 REG,6,1,6,3,4,12,0,1,-2,2,1,0,0,0,0,0,0,0,0,0.4978845547971712,0.5021154452028288
86558,0.6108949416342413,0.425531914893617,-157,135,0.5886419592417365,0.41135804075826354,home,SD,under,7.5,0.5238095238095238,-110,0.5021154452028288,SD,ARI,2022 REG,6,1,6,3,4,12,0,1,-2,2,1,0,0,0,0,0,0,0,0,0.4978845547971712,0.5021154452028288
86559,0.6825396825396826,0.35714285714285715,-215,180,0.6554547745023935,0.34454522549760647,away,BAL,over,8.5,0.5412844036697247,-118,0.5189377998484975,TOR,BAL,2022 REG,7,2,7,4,6,14,0,1,-2,2,1,1,0,0,0,0,0,0,0,0.5189377998484975,0.4810622001515025
86559,0.6825396825396826,0.35714285714285715,-215,180,0.6554547745023935,0.34454522549760647,home,TOR,under,8.5,0.5,100,0.4810622001515025,TOR,BAL,2022 REG,7,2,7,4,6,14,0,1,-2,2,1,1,0,0,0,0,0,0,0,0.5189377998484975,0.4810622001515025
86560,0.4081632653061224,0.6296296296296295,145,-170,0.39273759390377466,0.6072624060962253,away,SEA,over,8.5,0.5121951219512195,-105,0.48919479393107135,LAA,SEA,2022 REG,11,8,9,7,15,20,1,0,1,-1,1,1,1,1,1,1,1,0,0,0.48919479393107135,0.5108052060689287
86560,0.4081632653061224,0.6296296296296295,145,-170,0.39273759390377466,0.6072624060962253,home,LAA,under,8.5,0.5327102803738317,-114,0.5108052060689287,LAA,SEA,2022 REG,11,8,9,7,15,20,1,0,1,-1,1,1,1,1,1,1,1,0,0,0.48919479393107135,0.5108052060689287
86561,0.46511627906976744,0.574468085106383,115,-135,0.44670494689481377,0.5532950531051862,away,TEX,over,11,0.5391705069124424,-117,0.5140669063204599,COL,TEX,2022 REG,9,4,18,16,20,27,0,1,-12,12,1,1,1,1,0,0,0,0,0,0.5140669063204599,0.4859330936795401
86561,0.46511627906976744,0.574468085106383,115,-135,0.44670494689481377,0.5532950531051862,home,COL,under,11,0.5073891625615764,-103,0.4859330936795401,COL,TEX,2022 REG,9,4,18,16,20,27,0,1,-12,12,1,1,1,1,0,0,0,0,0,0.5140669063204599,0.4859330936795401
86562,0.6666666666666666,0.37593984962406013,-200,166,0.6382623224728488,0.36173767752715125,away,BAL,over,8.5,0.5283018867924528,-112,0.5044173060022736,NYY,BAL,2022 REG,6,2,5,0,2,11,1,0,2,-2,0,0,0,0,0,0,0,0,0,0.5044173060022736,0.49558269399772636
86562,0.6666666666666666,0.37593984962406013,-200,166,0.6382623224728488,0.36173767752715125,home,NYY,under,8.5,0.5169082125603864,-107,0.49558269399772636,NYY,BAL,2022 REG,6,2,5,0,2,11,1,0,2,-2,0,0,0,0,0,0,0,0,0,0.5044173060022736,0.49558269399772636
86564,0.5798319327731092,0.46511627906976744,-138,115,0.5537695242255589,0.4462304757744411,away,MIA,over,9,0.5454545454545454,-120,0.5179608869977906,CIN,MIA,2022 REG,11,6,10,7,13,21,0,1,-1,1,1,1,1,1,1,1,0,0,0,0.5179608869977906,0.48203911300220936
86564,0.5798319327731092,0.46511627906976744,-138,115,0.5537695242255589,0.4462304757744411,home,CIN,under,9,0.504950495049505,-102,0.48203911300220936,CIN,MIA,2022 REG,11,6,10,7,13,21,0,1,-1,1,1,1,1,1,1,1,0,0,0,0.5179608869977906,0.48203911300220936
86565,0.7333333333333333,0.3105590062111801,-275,222,0.7011456176673567,0.2988543823326433,away,PIT,over,8,0.5238095238095238,-110,0.5012646084074657,SF,PIT,2022 REG,13,8,11,7,15,24,1,0,1,-1,1,1,1,1,1,1,1,0,0,0.5012646084074657,0.4987353915925343
86565,0.7333333333333333,0.3105590062111801,-275,222,0.7011456176673567,0.2988543823326433,home,SF,under,8,0.5192307692307692,-108,0.4987353915925343,SF,PIT,2022 REG,13,8,11,7,15,24,1,0,1,-1,1,1,1,1,1,1,1,0,0,0.5012646084074657,0.4987353915925343
86566,0.5652173913043479,0.47619047619047616,-130,110,0.5418129444594474,0.4581870555405526,away,SD,over,8.5,0.5121951219512195,-105,0.48808156828023186,STL,SD,2022 REG,7,3,5,2,5,12,1,0,1,-1,1,1,0,0,0,0,0,0,0,0.48808156828023186,0.5119184317197681
86566,0.5652173913043479,0.47619047619047616,-130,110,0.5418129444594474,0.4581870555405526,home,STL,under,8.5,0.5348837209302326,-115,0.5119184317197681,STL,SD,2022 REG,7,3,5,2,5,12,1,0,1,-1,1,1,0,0,0,0,0,0,0,0.48808156828023186,0.5119184317197681
86567,0.7183098591549296,0.32573289902280134,-255,207,0.686673511731489,0.31332648826851095,away,DET,over,10,0.5215311004784688,-109,0.49907282342437215,TOR,DET,2022 REG,10,5,4,3,8,14,1,0,2,-2,1,1,1,0,0,0,0,0,0,0.49907282342437215,0.5009271765756278
86567,0.7183098591549296,0.32573289902280134,-255,207,0.686673511731489,0.31332648826851095,home,TOR,under,10,0.5215311004784688,-109,0.5009271765756278,TOR,DET,2022 REG,10,5,4,3,8,14,1,0,2,-2,1,1,1,0,0,0,0,0,0,0.49907282342437215,0.5009271765756278
86568,0.5433789954337899,0.5,-119,100,0.5198077604720502,0.48019223952794976,away,DET,over,7.5,0.5169082125603864,-107,0.49586088023391106,TEX,DET,2022 REG,9,2,18,11,13,27,0,1,-9,9,1,1,0,0,0,0,0,0,0,0.49586088023391106,0.5041391197660889
86568,0.5433789954337899,0.5,-119,100,0.5198077604720502,0.48019223952794976,home,TEX,under,7.5,0.5238095238095238,-110,0.5041391197660889,TEX,DET,2022 REG,9,2,18,11,13,27,0,1,-9,9,1,1,0,0,0,0,0,0,0,0.49586088023391106,0.5041391197660889
86569,0.47846889952153115,0.5594713656387665,109,-127,0.4603156626027285,0.5396843373972715,away,TB,over,7,0.5,100,0.4772727272727273,OAK,TB,2022 REG,10,7,14,10,17,24,0,1,-3,3,1,1,1,1,1,1,1,0,0,0.4772727272727273,0.5227272727272727
86569,0.47846889952153115,0.5594713656387665,109,-127,0.4603156626027285,0.5396843373972715,home,OAK,under,7,0.5454545454545454,-120,0.5227272727272727,OAK,TB,2022 REG,10,7,14,10,17,24,0,1,-3,3,1,1,1,1,1,1,1,0,0,0.4772727272727273,0.5227272727272727
86570,0.6226415094339623,0.4166666666666667,-165,140,0.5981666073335706,0.40183339266642937,away,KC,over,9,0.5169082125603864,-107,0.49353874091423283,CLE,KC,2022 REG,8,7,9,3,10,17,1,0,4,-4,1,1,1,0,0,0,0,0,0,0.49353874091423283,0.5064612590857671
86570,0.6226415094339623,0.4166666666666667,-165,140,0.5981666073335706,0.40183339266642937,home,CLE,under,9,0.5283018867924528,-112,0.5064612590857671,CLE,KC,2022 REG,8,7,9,3,10,17,1,0,4,-4,1,1,1,0,0,0,0,0,0,0.49353874091423283,0.5064612590857671
86571,0.45454545454545453,0.5780590717299579,120,-137,0.439725215329358,0.560274784670642,away,LAA,over,9,0.5098039215686274,-104,0.4870219861770517,TEX,LAA,2022 REG,13,10,11,5,15,24,1,0,5,-5,1,1,1,1,1,0,0,0,0,0.4870219861770517,0.5129780138229483
86571,0.45454545454545453,0.5780590717299579,120,-137,0.439725215329358,0.560274784670642,home,TEX,under,9,0.5348837209302326,-115,0.5129780138229483,TEX,LAA,2022 REG,13,10,11,5,15,24,1,0,5,-5,1,1,1,1,1,0,0,0,0,0.4870219861770517,0.5129780138229483
86572,0.4504504504504505,0.5934959349593496,122,-146,0.43065478134693697,0.569345218653063,away,SD,over,9,0.5238095238095238,-110,0.4988662131519274,ARI,SD,2022 REG,2,0,11,3,3,13,0,1,-3,3,0,0,0,0,0,0,0,0,0,0.4988662131519274,0.5011337868480725
86572,0.4504504504504505,0.5934959349593496,122,-146,0.43065478134693697,0.569345218653063,home,ARI,under,9,0.5238095238095238,-110,0.5011337868480725,ARI,SD,2022 REG,2,0,11,3,3,13,0,1,-3,3,0,0,0,0,0,0,0,0,0,0.4988662131519274,0.5011337868480725
86573,0.43103448275862066,0.6108949416342413,132,-157,0.41296145500307674,0.5870385449969233,away,NYM,over,8.5,0.5475113122171946,-121,0.5242087833606768,WSH,NYM,2022 REG,4,1,5,4,5,9,0,1,-3,3,1,0,0,0,0,0,0,0,0,0.5242087833606768,0.4757912166393232
86573,0.43103448275862066,0.6108949416342413,132,-157,0.41296145500307674,0.5870385449969233,home,WSH,under,8.5,0.49504950495049505,102,0.4757912166393232,WSH,NYM,2022 REG,4,1,5,4,5,9,0,1,-3,3,1,0,0,0,0,0,0,0,0,0.5242087833606768,0.4757912166393232
86574,0.5454545454545454,0.4926108374384236,-120,103,0.5246916093311078,0.4753083906688922,away,NYM,over,7.5,0.5370370370370371,-116,0.5118817074154765,PHI,NYM,2022 REG,9,2,11,7,9,20,0,1,-5,5,1,1,0,0,0,0,0,0,0,0.5118817074154765,0.48811829258452355
86574,0.5454545454545454,0.4926108374384236,-120,103,0.5246916093311078,0.4753083906688922,home,PHI,under,7.5,0.5098039215686274,-104,0.48811829258452355,PHI,NYM,2022 REG,9,2,11,7,9,20,0,1,-5,5,1,1,0,0,0,0,0,0,0,0.5118817074154765,0.48811829258452355
86575,0.6923076923076923,0.34965034965034963,-225,186,0.663259817105971,0.33674018289402896,away,PIT,over,7.5,0.5348837209302326,-115,0.5109810284308424,MIL,PIT,2022 REG,9,4,6,3,7,15,1,0,1,-1,1,1,1,0,0,0,0,0,0,0.5109810284308424,0.48901897156915763
86575,0.6923076923076923,0.34965034965034963,-225,186,0.663259817105971,0.33674018289402896,home,MIL,under,7.5,0.5098039215686274,-104,0.48901897156915763,MIL,PIT,2022 REG,9,4,6,3,7,15,1,0,1,-1,1,1,1,0,0,0,0,0,0,0.5109810284308424,0.48901897156915763
86576,0.5633187772925764,0.47619047619047616,-129,110,0.5410624729287608,0.45893752707123925,away,CHC,over,8.5,0.5305164319248826,-113,0.5066009958897986,CIN,CHC,2022 REG,7,4,5,3,7,12,1,0,1,-1,1,1,1,0,0,0,0,0,0,0.5066009958897986,0.49339900411020143
86576,0.5633187772925764,0.47619047619047616,-129,110,0.5410624729287608,0.45893752707123925,home,CIN,under,8.5,0.5145631067961165,-106,0.49339900411020143,CIN,CHC,2022 REG,7,4,5,3,7,12,1,0,1,-1,1,1,1,0,0,0,0,0,0,0.5066009958897986,0.49339900411020143
86577,0.7560975609756098,0.2840909090909091,-310,252,0.7257111567789735,0.27428884322102653,away,WSH,over,7.5,0.5,100,0.4772727272727273,NYM,WSH,2022 REG,8,4,7,2,6,15,1,0,2,-2,1,1,0,0,0,0,0,0,0,0.4772727272727273,0.5227272727272727
86577,0.7560975609756098,0.2840909090909091,-310,252,0.7257111567789735,0.27428884322102653,home,NYM,under,7.5,0.5454545454545454,-120,0.5227272727272727,NYM,WSH,2022 REG,8,4,7,2,6,15,1,0,2,-2,1,1,0,0,0,0,0,0,0,0.4772727272727273,0.5227272727272727
86578,0.5867768595041323,0.45454545454545453,-142,120,0.5625298818386723,0.43747011816132775,away,SEA,over,8.5,0.5454545454545454,-120,0.5193043049216726,MIN,SEA,2022 REG,10,10,7,4,14,17,1,0,6,-6,1,1,1,1,0,0,0,0,0,0.5193043049216726,0.48069569507832743
86578,0.5867768595041323,0.45454545454545453,-142,120,0.5625298818386723,0.43747011816132775,home,MIN,under,8.5,0.5024875621890548,-101,0.48069569507832743,MIN,SEA,2022 REG,10,10,7,4,14,17,1,0,6,-6,1,1,1,1,0,0,0,0,0,0.5193043049216726,0.48069569507832743
86579,0.37037037037037035,0.6721311475409836,170,-205,0.35462906744023925,0.6453709325597607,away,ATL,over,7,0.5412844036697247,-118,0.5149381613977361,CHC,ATL,2022 REG,13,6,9,3,9,22,1,0,3,-3,1,1,1,0,0,0,0,0,0,0.5149381613977361,0.48506183860226393
86579,0.37037037037037035,0.6721311475409836,170,-205,0.35462906744023925,0.6453709325597607,home,CHC,under,7,0.5073891625615764,-103,0.48506183860226393,CHC,ATL,2022 REG,13,6,9,3,9,22,1,0,3,-3,1,1,1,0,0,0,0,0,0,0.5149381613977361,0.48506183860226393
86580,0.6183206106870228,0.4184100418410042,-162,139,0.5956092911849603,0.4043907088150397,away,CIN,over,7,0.5348837209302326,-115,0.5097020142727117,CHC,CIN,2022 REG,8,6,4,1,7,12,1,0,5,-5,1,0,0,0,0,0,0,0,0,0.5097020142727117,0.49029798572728833
86580,0.6183206106870228,0.4184100418410042,-162,139,0.5956092911849603,0.4043907088150397,home,CHC,under,7,0.5121951219512195,-105,0.49029798572728833,CHC,CIN,2022 REG,8,6,4,1,7,12,1,0,5,-5,1,0,0,0,0,0,0,0,0,0.5097020142727117,0.49029798572728833
86581,0.4926108374384236,0.5555555555555556,103,-125,0.46888355024927125,0.5311164497507288,away,MIN,over,8.5,0.5169082125603864,-107,0.4901365367947041,KC,MIN,2022 REG,9,4,9,3,7,18,1,0,1,-1,1,1,1,0,0,0,0,0,0,0.4901365367947041,0.5098634632052959
86581,0.4926108374384236,0.5555555555555556,103,-125,0.46888355024927125,0.5311164497507288,home,KC,under,8.5,0.5348837209302326,-115,0.5098634632052959,KC,MIN,2022 REG,9,4,9,3,7,18,1,0,1,-1,1,1,1,0,0,0,0,0,0,0.4901365367947041,0.5098634632052959
86582,0.7402597402597403,0.29850746268656714,-285,235,0.7115619406761102,0.2884380593238898,away,PIT,over,9,0.5215311004784688,-109,0.49907282342437215,PHI,PIT,2022 REG,11,7,7,4,11,18,1,0,3,-3,1,1,1,1,0,0,0,0,0,0.49907282342437215,0.5009271765756278
86582,0.7402597402597403,0.29850746268656714,-285,235,0.7115619406761102,0.2884380593238898,home,PHI,under,9,0.5215311004784688,-109,0.5009271765756278,PHI,PIT,2022 REG,11,7,7,4,11,18,1,0,3,-3,1,1,1,1,0,0,0,0,0,0.49907282342437215,0.5009271765756278
86583,0.6336996336996338,0.40485829959514175,-173,147,0.6092654854945195,0.39073451450548047,away,PHI,over,7.5,0.5098039215686274,-104,0.4870219861770517,MIL,PHI,2022 REG,11,3,9,8,11,20,0,1,-5,5,1,1,1,0,0,0,0,0,0,0.4870219861770517,0.5129780138229483
86583,0.6336996336996338,0.40485829959514175,-173,147,0.6092654854945195,0.39073451450548047,home,MIL,under,7.5,0.5348837209302326,-115,0.5129780138229483,MIL,PHI,2022 REG,11,3,9,8,11,20,0,1,-5,5,1,1,1,0,0,0,0,0,0,0.4870219861770517,0.5129780138229483
86584,0.5594713656387665,0.47846889952153115,-127,109,0.5382448736768379,0.46175512632316207,away,BAL,over,9,0.5348837209302326,-115,0.5109810284308424,BOS,BAL,2022 REG,11,13,15,9,22,26,1,0,4,-4,1,1,1,1,1,1,1,1,1,0.5109810284308424,0.48901897156915763
86584,0.5594713656387665,0.47846889952153115,-127,109,0.5382448736768379,0.46175512632316207,home,BOS,under,9,0.5098039215686274,-104,0.48901897156915763,BOS,BAL,2022 REG,11,13,15,9,22,26,1,0,4,-4,1,1,1,1,1,1,1,1,1,0.5109810284308424,0.48901897156915763
86585,0.5689655172413793,0.47619047619047616,-132,110,0.5432733140818753,0.4567266859181247,away,SF,over,9.5,0.5098039215686274,-104,0.4870219861770517,PHI,SF,2022 REG,9,4,12,7,11,21,0,1,-3,3,1,1,1,1,0,0,0,0,0,0.4870219861770517,0.5129780138229483
86585,0.5689655172413793,0.47619047619047616,-132,110,0.5432733140818753,0.4567266859181247,home,PHI,under,9.5,0.5348837209302326,-115,0.5129780138229483,PHI,SF,2022 REG,9,4,12,7,11,21,0,1,-3,3,1,1,1,1,0,0,0,0,0,0.4870219861770517,0.5129780138229483
86586,0.40485829959514175,0.635036496350365,147,-174,0.38870656034594875,0.6112934396540513,away,CLE,over,8,0.5370370370370371,-116,0.514488177212783,DET,CLE,2022 REG,8,2,8,3,5,16,0,1,-1,1,1,1,0,0,0,0,0,0,0,0.514488177212783,0.48551182278721705
86586,0.40485829959514175,0.635036496350365,147,-174,0.38870656034594875,0.6112934396540513,home,DET,under,8,0.504950495049505,-102,0.48551182278721705,DET,CLE,2022 REG,8,2,8,3,5,16,0,1,-1,1,1,1,0,0,0,0,0,0,0,0.514488177212783,0.48551182278721705
86587,0.4504504504504505,0.5918367346938775,122,-145,0.43140216885390636,0.5685978311460936,away,TOR,over,8.5,0.5454545454545454,-120,0.5206611570247933,KC,TOR,2022 REG,13,8,12,4,12,25,1,0,4,-4,1,1,1,1,0,0,0,0,0,0.5206611570247933,0.4793388429752067
86587,0.4504504504504505,0.5918367346938775,122,-145,0.43140216885390636,0.5685978311460936,home,KC,under,8.5,0.5,100,0.4793388429752067,KC,TOR,2022 REG,13,8,12,4,12,25,1,0,4,-4,1,1,1,1,0,0,0,0,0,0.5206611570247933,0.4793388429752067
86588,0.4444444444444444,0.5951417004048584,125,-147,0.4268506022891988,0.5731493977108012,away,NYY,over,9,0.5260663507109005,-111,0.49982833141342614,BOS,NYY,2022 REG,11,11,11,6,17,22,1,0,5,-5,1,1,1,1,1,1,0,0,0,0.49982833141342614,0.5001716685865738
86588,0.4444444444444444,0.5951417004048584,125,-147,0.4268506022891988,0.5731493977108012,home,BOS,under,9,0.5238095238095238,-110,0.5001716685865738,BOS,NYY,2022 REG,11,11,11,6,17,22,1,0,5,-5,1,1,1,1,1,1,0,0,0,0.49982833141342614,0.5001716685865738
86589,0.5633187772925764,0.4739336492890995,-129,111,0.5423337858994053,0.4576662141005947,away,BOS,over,7.5,0.5121951219512195,-105,0.48808156828023186,LAA,BOS,2022 REG,8,5,6,2,7,14,1,0,3,-3,1,1,0,0,0,0,0,0,0,0.48808156828023186,0.5119184317197681
86589,0.5633187772925764,0.4739336492890995,-129,111,0.5423337858994053,0.4576662141005947,home,LAA,under,7.5,0.5348837209302326,-115,0.5119184317197681,LAA,BOS,2022 REG,8,5,6,2,7,14,1,0,3,-3,1,1,0,0,0,0,0,0,0,0.48808156828023186,0.5119184317197681
86590,0.7590361445783133,0.2840909090909091,-315,252,0.7263011520342048,0.27369884796579524,away,COL,over,7.5,0.5145631067961165,-106,0.4913668392989033,MIL,COL,2022 REG,11,6,9,5,11,20,1,0,1,-1,1,1,1,1,1,0,0,0,0,0.4913668392989033,0.5086331607010968
86590,0.7590361445783133,0.2840909090909091,-315,252,0.7263011520342048,0.27369884796579524,home,MIL,under,7.5,0.5305164319248826,-113,0.5086331607010968,MIL,COL,2022 REG,11,6,9,5,11,20,1,0,1,-1,1,1,1,1,1,0,0,0,0,0.4913668392989033,0.5086331607010968
86591,0.36363636363636365,0.6774193548387096,175,-210,0.3487070114636097,0.6512929885363903,away,NYY,over,8.5,0.5412844036697247,-118,0.5175913212324037,PIT,NYY,2022 REG,4,0,22,16,16,26,0,1,-16,16,0,0,0,0,0,0,0,0,0,0.5175913212324037,0.4824086787675963
86591,0.36363636363636365,0.6774193548387096,175,-210,0.3487070114636097,0.6512929885363903,home,PIT,under,8.5,0.5024875621890548,-101,0.4824086787675963,PIT,NYY,2022 REG,4,0,22,16,16,26,0,1,-16,16,0,0,0,0,0,0,0,0,0,0.5175913212324037,0.4824086787675963
86592,0.3968253968253968,0.6415770609318996,152,-179,0.3815863262867871,0.6184136737132129,away,SEA,over,7.5,0.5454545454545454,-120,0.5206611570247933,LAA,SEA,2022 REG,7,2,9,8,10,16,0,1,-6,6,1,1,0,0,0,0,0,0,0,0.5206611570247933,0.4793388429752067
86592,0.3968253968253968,0.6415770609318996,152,-179,0.3815863262867871,0.6184136737132129,home,LAA,under,7.5,0.5,100,0.4793388429752067,LAA,SEA,2022 REG,7,2,9,8,10,16,0,1,-6,6,1,1,0,0,0,0,0,0,0,0.5206611570247933,0.4793388429752067
86593,0.45454545454545453,0.5833333333333333,120,-140,0.43732782369146006,0.5626721763085399,away,CLE,over,8.5,0.5454545454545454,-120,0.5206611570247933,KC,CLE,2022 REG,7,1,23,13,14,30,0,1,-12,12,1,0,0,0,0,0,0,0,0,0.5206611570247933,0.4793388429752067
86593,0.45454545454545453,0.5833333333333333,120,-140,0.43732782369146006,0.5626721763085399,home,KC,under,8.5,0.5,100,0.4793388429752067,KC,CLE,2022 REG,7,1,23,13,14,30,0,1,-12,12,1,0,0,0,0,0,0,0,0,0.5206611570247933,0.4793388429752067
86594,0.6632996632996633,0.3717472118959108,-197,169,0.6400530827827337,0.35994691721726635,away,DET,over,8,0.5412844036697247,-118,0.5189377998484975,MIN,DET,2022 REG,7,2,8,4,6,15,0,1,-2,2,1,1,0,0,0,0,0,0,0,0.5189377998484975,0.4810622001515025
86594,0.6632996632996633,0.3717472118959108,-197,169,0.6400530827827337,0.35994691721726635,home,MIN,under,8,0.5,100,0.4810622001515025,MIN,DET,2022 REG,7,2,8,4,6,15,0,1,-2,2,1,1,0,0,0,0,0,0,0,0.5189377998484975,0.4810622001515025
86595,0.635036496350365,0.4081632653061224,-174,145,0.6076030710648583,0.39239692893514166,away,CHC,over,7.5,0.5283018867924528,-112,0.5044173060022736,CWS,CHC,2022 REG,10,5,5,4,9,15,1,0,1,-1,1,1,1,1,0,0,0,0,0,0.5044173060022736,0.49558269399772636
86595,0.635036496350365,0.4081632653061224,-174,145,0.6076030710648583,0.39239692893514166,home,CWS,under,7.5,0.5169082125603864,-107,0.49558269399772636,CWS,CHC,2022 REG,10,5,5,4,9,15,1,0,1,-1,1,1,1,1,0,0,0,0,0,0.5044173060022736,0.49558269399772636
86596,0.35211267605633806,0.6875,184,-220,0.33816455068438805,0.661835449315612,away,NYY,over,7.5,0.5260663507109005,-111,0.5022370601254724,OAK,NYY,2022 REG,8,4,20,13,17,28,0,1,-9,9,1,1,1,1,0,0,0,0,0,0.5022370601254724,0.4977629398745276
86596,0.35211267605633806,0.6875,184,-220,0.33816455068438805,0.661835449315612,home,OAK,under,7.5,0.5192307692307692,-108,0.4977629398745276,OAK,NYY,2022 REG,8,4,20,13,17,28,0,1,-9,9,1,1,1,1,0,0,0,0,0,0.5022370601254724,0.4977629398745276
86597,0.5535714285714286,0.4807692307692307,-124,108,0.5345614207221351,0.4654385792778649,away,ARI,over,8.5,0.5370370370370371,-116,0.5007583222241543,WSH,ARI,2022 REG,4,1,5,0,1,9,1,0,1,-1,0,0,0,0,0,0,0,0,0,0.5007583222241543,0.4992416777758457
86597,0.5535714285714286,0.4807692307692307,-124,108,0.5345614207221351,0.4654385792778649,home,WSH,under,8.5,0.5305164319248826,-113,0.4992416777758457,WSH,ARI,2022 REG,4,1,5,0,1,9,1,0,1,-1,0,0,0,0,0,0,0,0,0,0.5007583222241543,0.4992416777758457
86598,0.601593625498008,0.43859649122807015,-151,128,0.5774155074675785,0.4225844925324215,away,STL,over,8.5,0.5145631067961165,-106,0.4913668392989033,MIL,STL,2022 REG,6,1,14,10,11,20,0,1,-9,9,1,0,0,0,0,0,0,0,0,0.4913668392989033,0.5086331607010968
86598,0.601593625498008,0.43859649122807015,-151,128,0.5774155074675785,0.4225844925324215,home,MIL,under,8.5,0.5305164319248826,-113,0.5086331607010968,MIL,STL,2022 REG,6,1,14,10,11,20,0,1,-9,9,1,0,0,0,0,0,0,0,0,0.4913668392989033,0.5086331607010968
86599,0.48780487804878053,0.5535714285714286,105,-124,0.4676213138438005,0.5323786861561994,away,SEA,over,8,0.5192307692307692,-108,0.49688292476754015,TEX,SEA,2022 REG,7,3,5,4,7,12,0,1,-1,1,1,1,1,0,0,0,0,0,0,0.49688292476754015,0.5031170752324599
86599,0.48780487804878053,0.5535714285714286,105,-124,0.4676213138438005,0.5323786861561994,home,TEX,under,8,0.5238095238095238,-110,0.5031170752324599,TEX,SEA,2022 REG,7,3,5,4,7,12,0,1,-1,1,1,1,1,0,0,0,0,0,0,0.49688292476754015,0.5031170752324599
86600,0.646643109540636,0.3921568627450981,-183,155,0.6215533748116984,0.37844662518830163,away,DET,over,7,0.5454545454545454,-120,0.5220180091279142,MIN,DET,2022 REG,9,5,2,0,5,11,1,0,5,-5,0,0,0,0,0,0,0,0,0,0.5220180091279142,0.4779819908720858
86600,0.646643109540636,0.3921568627450981,-183,155,0.6215533748116984,0.37844662518830163,home,MIN,under,7,0.49751243781094534,101,0.4779819908720858,MIN,DET,2022 REG,9,5,2,0,5,11,1,0,5,-5,0,0,0,0,0,0,0,0,0,0.5220180091279142,0.4779819908720858
86601,0.6183206106870228,0.4184100418410042,-162,139,0.5956092911849603,0.4043907088150397,away,CWS,over,8.5,0.5260663507109005,-111,0.5022370601254724,MIN,CWS,2022 REG,11,2,17,12,14,28,0,1,-10,10,1,1,0,0,0,0,0,0,0,0.5022370601254724,0.4977629398745276
86601,0.6183206106870228,0.4184100418410042,-162,139,0.5956092911849603,0.4043907088150397,home,MIN,under,8.5,0.5192307692307692,-108,0.4977629398745276,MIN,CWS,2022 REG,11,2,17,12,14,28,0,1,-10,10,1,1,0,0,0,0,0,0,0,0.5022370601254724,0.4977629398745276
86602,0.6226415094339623,0.425531914893617,-165,135,0.5926467357960356,0.40735326420396445,away,HOU,over,7.5,0.5098039215686274,-104,0.4881300146960012,TOR,HOU,2022 REG,3,3,8,2,5,11,1,0,1,-1,1,1,0,0,0,0,0,0,0,0.4881300146960012,0.5118699853039987
86602,0.6226415094339623,0.425531914893617,-165,135,0.5926467357960356,0.40735326420396445,home,TOR,under,7.5,0.5327102803738317,-114,0.5118699853039987,TOR,HOU,2022 REG,3,3,8,2,5,11,1,0,1,-1,1,1,0,0,0,0,0,0,0,0.4881300146960012,0.5118699853039987
86603,0.4347826086956522,0.6047430830039526,130,-153,0.4175975253479979,0.5824024746520021,away,NYY,over,8,0.5121951219512195,-105,0.48808156828023186,TEX,NYY,2022 REG,2,1,8,3,4,10,0,1,-2,2,1,0,0,0,0,0,0,0,0,0.48808156828023186,0.5119184317197681
86603,0.4347826086956522,0.6047430830039526,130,-153,0.4175975253479979,0.5824024746520021,home,TEX,under,8,0.5348837209302326,-115,0.5119184317197681,TEX,NYY,2022 REG,2,1,8,3,4,10,0,1,-2,2,1,0,0,0,0,0,0,0,0,0.48808156828023186,0.5119184317197681
86604,0.4166666666666667,0.6226415094339623,140,-165,0.4002882599580712,0.5997117400419287,away,NYY,over,9,0.5215311004784688,-109,0.4978845547971712,BOS,NYY,2022 REG,10,6,10,5,11,20,1,0,1,-1,1,1,1,1,1,0,0,0,0,0.4978845547971712,0.5021154452028288
86604,0.4166666666666667,0.6226415094339623,140,-165,0.4002882599580712,0.5997117400419287,home,BOS,under,9,0.5238095238095238,-110,0.5021154452028288,BOS,NYY,2022 REG,10,6,10,5,11,20,1,0,1,-1,1,1,1,1,1,0,0,0,0,0.4978845547971712,0.5021154452028288
86605,0.4587155963302753,0.5780590717299579,118,-137,0.4418464825411775,0.5581535174588226,away,ATL,over,9,0.5215311004784688,-109,0.49907282342437215,TEX,ATL,2022 REG,11,7,6,3,10,17,1,0,4,-4,1,1,1,0,0,0,0,0,0,0.49907282342437215,0.5009271765756278
86605,0.4587155963302753,0.5780590717299579,118,-137,0.4418464825411775,0.5581535174588226,home,TEX,under,9,0.5215311004784688,-109,0.5009271765756278,TEX,ATL,2022 REG,11,7,6,3,10,17,1,0,4,-4,1,1,1,0,0,0,0,0,0,0.49907282342437215,0.5009271765756278
86606,0.6721311475409836,0.36900369003690037,-205,171,0.6444831419558484,0.35551685804415156,away,KC,over,6.5,0.5121951219512195,-105,0.48808156828023186,TB,KC,2022 REG,6,2,4,3,5,10,0,1,-1,1,1,1,0,0,0,0,0,0,0,0.48808156828023186,0.5119184317197681
86606,0.6721311475409836,0.36900369003690037,-205,171,0.6444831419558484,0.35551685804415156,home,TB,under,6.5,0.5348837209302326,-115,0.5119184317197681,TB,KC,2022 REG,6,2,4,3,5,10,0,1,-1,1,1,1,0,0,0,0,0,0,0,0.48808156828023186,0.5119184317197681
86607,0.6212121212121212,0.4184100418410042,-164,139,0.5965983532548766,0.40340164674512335,away,STL,over,7,0.5348837209302326,-115,0.5097020142727117,NYM,STL,2022 REG,11,7,13,6,13,24,1,0,1,-1,1,1,1,1,1,1,0,0,0,0.5097020142727117,0.49029798572728833
86607,0.6212121212121212,0.4184100418410042,-164,139,0.5965983532548766,0.40340164674512335,home,NYM,under,7,0.5121951219512195,-105,0.49029798572728833,NYM,STL,2022 REG,11,7,13,6,13,24,1,0,1,-1,1,1,1,1,1,1,0,0,0,0.5097020142727117,0.49029798572728833
86608,0.46511627906976744,0.5780590717299579,115,-137,0.4450347205582673,0.5549652794417327,away,MIA,over,8,0.5348837209302326,-115,0.5109810284308424,ARI,MIA,2022 REG,11,9,9,3,12,20,1,0,6,-6,1,1,1,0,0,0,0,0,0,0.5109810284308424,0.48901897156915763
86608,0.46511627906976744,0.5780590717299579,115,-137,0.4450347205582673,0.5549652794417327,home,ARI,under,8,0.5098039215686274,-104,0.48901897156915763,ARI,MIA,2022 REG,11,9,9,3,12,20,1,0,6,-6,1,1,1,0,0,0,0,0,0,0.5109810284308424,0.48901897156915763
86609,0.5708154506437768,0.4672897196261683,-133,114,0.5490644307042802,0.45093556929571976,away,SD,over,8,0.5121951219512195,-105,0.48808156828023186,NYM,SD,2022 REG,12,8,13,5,13,25,1,0,3,-3,1,1,1,1,1,0,0,0,0,0.48808156828023186,0.5119184317197681
86609,0.5708154506437768,0.4672897196261683,-133,114,0.5490644307042802,0.45093556929571976,home,NYM,under,8,0.5348837209302326,-115,0.5119184317197681,NYM,SD,2022 REG,12,8,13,5,13,25,1,0,3,-3,1,1,1,1,1,0,0,0,0,0.48808156828023186,0.5119184317197681
86610,0.39370078740157477,0.6453900709219857,154,-182,0.3783106856993856,0.6216893143006144,away,PHI,over,9,0.5348837209302326,-115,0.5097020142727117,CIN,PHI,2022 REG,9,3,12,4,7,21,0,1,-1,1,1,1,1,0,0,0,0,0,0,0.5097020142727117,0.49029798572728833
86610,0.39370078740157477,0.6453900709219857,154,-182,0.3783106856993856,0.6216893143006144,home,CIN,under,9,0.5121951219512195,-105,0.49029798572728833,CIN,PHI,2022 REG,9,3,12,4,7,21,0,1,-1,1,1,1,1,0,0,0,0,0,0,0.5097020142727117,0.49029798572728833
86611,0.5983935742971888,0.44052863436123346,-149,127,0.5751027747385346,0.42489722526146545,away,STL,over,7.5,0.5283018867924528,-112,0.5044173060022736,TB,STL,2022 REG,3,4,9,2,6,12,1,0,2,-2,1,1,0,0,0,0,0,0,0,0.5044173060022736,0.49558269399772636
86611,0.5983935742971888,0.44052863436123346,-149,127,0.5751027747385346,0.42489722526146545,home,TB,under,7.5,0.5169082125603864,-107,0.49558269399772636,TB,STL,2022 REG,3,4,9,2,6,12,1,0,2,-2,1,1,0,0,0,0,0,0,0,0.5044173060022736,0.49558269399772636
86612,0.6655518394648829,0.37735849056603776,-199,165,0.6369927903807584,0.3630072096192416,away,LAA,over,7,0.5098039215686274,-104,0.48483656587239576,SEA,LAA,2022 REG,6,3,8,4,7,14,0,1,-1,1,1,1,1,0,0,0,0,0,0,0.48483656587239576,0.5151634341276042
86612,0.6655518394648829,0.37735849056603776,-199,165,0.6369927903807584,0.3630072096192416,home,SEA,under,7,0.5391705069124424,-117,0.5151634341276042,SEA,LAA,2022 REG,6,3,8,4,7,14,0,1,-1,1,1,1,1,0,0,0,0,0,0,0.48483656587239576,0.5151634341276042
86613,0.6610169491525424,0.37735849056603776,-195,165,0.6356501330673793,0.3643498669326207,away,TEX,over,9.5,0.5,100,0.47935779816513757,BOS,TEX,2022 REG,13,9,6,1,10,19,1,0,8,-8,1,0,0,0,0,0,0,0,0,0.47935779816513757,0.5206422018348624
86613,0.6610169491525424,0.37735849056603776,-195,165,0.6356501330673793,0.3643498669326207,home,BOS,under,9.5,0.5412844036697247,-118,0.5206422018348624,BOS,TEX,2022 REG,13,9,6,1,10,19,1,0,8,-8,1,0,0,0,0,0,0,0,0,0.47935779816513757,0.5206422018348624
86614,0.6254681647940076,0.4166666666666667,-167,140,0.5991141690863948,0.4008858309136052,away,BOS,over,8.5,0.5121951219512195,-105,0.48919479393107135,TOR,BOS,2022 REG,10,5,8,6,11,18,0,1,-1,1,1,1,1,1,1,0,0,0,0,0.48919479393107135,0.5108052060689287
86614,0.6254681647940076,0.4166666666666667,-167,140,0.5991141690863948,0.4008858309136052,home,TOR,under,8.5,0.5327102803738317,-114,0.5108052060689287,TOR,BOS,2022 REG,10,5,8,6,11,18,0,1,-1,1,1,1,1,1,1,0,0,0,0,0.48919479393107135,0.5108052060689287
86615,0.46511627906976744,0.5798319327731092,115,-138,0.44421013402656906,0.5557898659734309,away,HOU,over,7,0.5454545454545454,-120,0.5220180091279142,OAK,HOU,2022 REG,8,1,7,3,4,15,0,1,-2,2,1,0,0,0,0,0,0,0,0,0.5220180091279142,0.4779819908720858
86615,0.46511627906976744,0.5798319327731092,115,-138,0.44421013402656906,0.5557898659734309,home,OAK,under,7,0.49751243781094534,101,0.4779819908720858,OAK,HOU,2022 REG,8,1,7,3,4,15,0,1,-2,2,1,0,0,0,0,0,0,0,0,0.5220180091279142,0.4779819908720858
86616,0.5192307692307692,0.5215311004784688,-108,-109,0.49806595226635714,0.5019340477336429,away,MIL,over,6.5,0.5260663507109005,-111,0.5034588790373798,ATL,MIL,2022 REG,8,3,7,2,5,15,1,0,1,-1,1,1,0,0,0,0,0,0,0,0.5034588790373798,0.49654112096262015
86616,0.5192307692307692,0.5215311004784688,-108,-109,0.49806595226635714,0.5019340477336429,home,ATL,under,6.5,0.5169082125603864,-107,0.49654112096262015,ATL,MIL,2022 REG,8,3,7,2,5,15,1,0,1,-1,1,1,0,0,0,0,0,0,0,0.5034588790373798,0.49654112096262015
86617,0.6527777777777778,0.390625,-188,156,0.6244454089506174,0.3755545910493826,away,PIT,over,7,0.5192307692307692,-108,0.49571111079951763,STL,PIT,2022 REG,10,5,9,7,12,19,0,1,-2,2,1,1,1,1,1,0,0,0,0,0.49571111079951763,0.5042888892004824
86617,0.6527777777777778,0.390625,-188,156,0.6244454089506174,0.3755545910493826,home,STL,under,7,0.5260663507109005,-111,0.5042888892004824,STL,PIT,2022 REG,10,5,9,7,12,19,0,1,-2,2,1,1,1,1,1,0,0,0,0,0.49571111079951763,0.5042888892004824
86618,0.6845425867507886,0.35714285714285715,-217,180,0.6560071251579774,0.34399287484202257,away,COL,over,7.5,0.5238095238095238,-110,0.5000596729920038,SD,COL,2022 REG,6,4,7,1,5,13,1,0,3,-3,1,0,0,0,0,0,0,0,0,0.5000596729920038,0.4999403270079962
86618,0.6845425867507886,0.35714285714285715,-217,180,0.6560071251579774,0.34399287484202257,home,SD,under,7.5,0.5215311004784688,-109,0.4999403270079962,SD,COL,2022 REG,6,4,7,1,5,13,1,0,3,-3,1,0,0,0,0,0,0,0,0,0.5000596729920038,0.4999403270079962
86619,0.45454545454545453,0.5833333333333333,120,-140,0.43732782369146006,0.5626721763085399,away,MIL,over,11.5,0.5121951219512195,-105,0.48808156828023186,CHC,MIL,2022 REG,12,6,7,7,13,19,0,1,-1,1,1,1,1,1,1,1,0,0,0,0.48808156828023186,0.5119184317197681
86619,0.45454545454545453,0.5833333333333333,120,-140,0.43732782369146006,0.5626721763085399,home,CHC,under,11.5,0.5348837209302326,-115,0.5119184317197681,CHC,MIL,2022 REG,12,6,7,7,13,19,0,1,-1,1,1,1,1,1,1,1,0,0,0,0.48808156828023186,0.5119184317197681
86620,0.5260663507109005,0.5121951219512195,-111,-105,0.5059382774147141,0.4940617225852859,away,TOR,over,8.5,0.5121951219512195,-105,0.48919479393107135,PHI,TOR,2022 REG,12,4,7,3,7,19,1,0,1,-1,1,1,1,0,0,0,0,0,0,0.48919479393107135,0.5108052060689287
86620,0.5260663507109005,0.5121951219512195,-111,-105,0.5059382774147141,0.4940617225852859,home,PHI,under,8.5,0.5327102803738317,-114,0.5108052060689287,PHI,TOR,2022 REG,12,4,7,3,7,19,1,0,1,-1,1,1,1,0,0,0,0,0,0,0.48919479393107135,0.5108052060689287
86621,0.576271186440678,0.46511627906976744,-136,115,0.552420782587201,0.44757921741279905,away,SF,over,7,0.5391705069124424,-117,0.5153817639191344,MIA,SF,2022 REG,7,3,3,0,3,10,1,0,3,-3,0,0,0,0,0,0,0,0,0,0.5153817639191344,0.4846182360808656
86621,0.576271186440678,0.46511627906976744,-136,115,0.552420782587201,0.44757921741279905,home,MIA,under,7,0.504950495049505,-102,0.4846182360808656,MIA,SF,2022 REG,7,3,3,0,3,10,1,0,3,-3,0,0,0,0,0,0,0,0,0,0.5153817639191344,0.4846182360808656
86622,0.6721311475409836,0.36363636363636365,-205,175,0.6480906892086682,0.3519093107913318,away,CHC,over,7.5,0.5260663507109005,-111,0.5022370601254724,NYM,CHC,2022 REG,8,3,7,6,9,15,0,1,-3,3,1,1,1,0,0,0,0,0,0,0.5022370601254724,0.4977629398745276
86622,0.6721311475409836,0.36363636363636365,-205,175,0.6480906892086682,0.3519093107913318,home,NYM,under,7.5,0.5192307692307692,-108,0.4977629398745276,NYM,CHC,2022 REG,8,3,7,6,9,15,0,1,-3,3,1,1,1,0,0,0,0,0,0,0.5022370601254724,0.4977629398745276
86623,0.4484304932735426,0.5901639344262295,123,-144,0.43112357502252374,0.5688764249774763,away,TEX,over,8.5,0.5454545454545454,-120,0.5179608869977906,KC,TEX,2022 REG,8,4,15,10,14,23,0,1,-6,6,1,1,1,1,0,0,0,0,0,0.5179608869977906,0.48203911300220936
86623,0.4484304932735426,0.5901639344262295,123,-144,0.43112357502252374,0.5688764249774763,home,KC,under,8.5,0.504950495049505,-102,0.48203911300220936,KC,TEX,2022 REG,8,4,15,10,14,23,0,1,-6,6,1,1,1,1,0,0,0,0,0,0.5179608869977906,0.48203911300220936
86624,0.6363636363636364,0.40322580645161293,-175,148,0.6111703545721141,0.3888296454278859,away,PIT,over,7,0.5169082125603864,-107,0.49353874091423283,MIA,PIT,2022 REG,7,5,6,4,9,13,1,0,1,-1,1,1,1,1,0,0,0,0,0,0.49353874091423283,0.5064612590857671
86624,0.6363636363636364,0.40322580645161293,-175,148,0.6111703545721141,0.3888296454278859,home,MIA,under,7,0.5283018867924528,-112,0.5064612590857671,MIA,PIT,2022 REG,7,5,6,4,9,13,1,0,1,-1,1,1,1,1,0,0,0,0,0,0.49353874091423283,0.5064612590857671
86625,0.42372881355932196,0.6108949416342413,136,-157,0.409057730850185,0.590942269149815,away,MIL,over,9,0.5475113122171946,-121,0.5242087833606768,WSH,MIL,2022 REG,9,8,11,6,14,20,1,0,2,-2,1,1,1,1,1,1,0,0,0,0.5242087833606768,0.4757912166393232
86625,0.42372881355932196,0.6108949416342413,136,-157,0.409057730850185,0.590942269149815,home,WSH,under,9,0.49504950495049505,102,0.4757912166393232,WSH,MIL,2022 REG,9,8,11,6,14,20,1,0,2,-2,1,1,1,1,1,1,0,0,0,0.5242087833606768,0.4757912166393232
86626,0.47619047619047616,0.5652173913043479,110,-130,0.4564724440500838,0.5435275559499162,away,LAD,over,8,0.5391705069124424,-117,0.5153817639191344,SD,LAD,2022 REG,6,2,12,11,13,18,0,1,-9,9,1,1,0,0,0,0,0,0,0,0.5153817639191344,0.4846182360808656
86626,0.47619047619047616,0.5652173913043479,110,-130,0.4564724440500838,0.5435275559499162,home,SD,under,8,0.504950495049505,-102,0.4846182360808656,SD,LAD,2022 REG,6,2,12,11,13,18,0,1,-9,9,1,1,0,0,0,0,0,0,0,0.5153817639191344,0.4846182360808656
86627,0.5433789954337899,0.49504950495049505,-119,102,0.5224977554989502,0.47750224450104983,away,SD,over,7.5,0.5283018867924528,-112,0.5031902949311281,SF,SD,2022 REG,15,13,5,2,15,20,1,0,11,-11,1,1,0,0,0,0,0,0,0,0.5031902949311281,0.4968097050688719
86627,0.5433789954337899,0.49504950495049505,-119,102,0.5224977554989502,0.47750224450104983,home,SF,under,7.5,0.5192307692307692,-108,0.4968097050688719,SF,SD,2022 REG,15,13,5,2,15,20,1,0,11,-11,1,1,0,0,0,0,0,0,0,0.5031902949311281,0.4968097050688719
86628,0.6845425867507886,0.35714285714285715,-217,180,0.6560071251579774,0.34399287484202257,away,CHC,over,7.5,0.5348837209302326,-115,0.5097020142727117,TOR,CHC,2022 REG,6,5,7,3,8,13,1,0,2,-2,1,1,1,0,0,0,0,0,0,0.5097020142727117,0.49029798572728833
86628,0.6845425867507886,0.35714285714285715,-217,180,0.6560071251579774,0.34399287484202257,home,TOR,under,7.5,0.5121951219512195,-105,0.49029798572728833,TOR,CHC,2022 REG,6,5,7,3,8,13,1,0,2,-2,1,1,1,0,0,0,0,0,0,0.5097020142727117,0.49029798572728833
86629,0.4504504504504505,0.5918367346938775,122,-145,0.43140216885390636,0.5685978311460936,away,MIN,over,9,0.5305164319248826,-113,0.5066009958897986,DET,MIN,2022 REG,8,2,9,8,10,17,0,1,-6,6,1,1,0,0,0,0,0,0,0,0.5066009958897986,0.49339900411020143
86629,0.4504504504504505,0.5918367346938775,122,-145,0.43140216885390636,0.5685978311460936,home,DET,under,9,0.5145631067961165,-106,0.49339900411020143,DET,MIN,2022 REG,8,2,9,8,10,17,0,1,-6,6,1,1,0,0,0,0,0,0,0,0.5066009958897986,0.49339900411020143
86630,0.6000000000000001,0.43859649122807015,-150,128,0.5768421052631579,0.42315789473684207,away,SD,over,8,0.5215311004784688,-109,0.49907282342437215,PHI,SD,2022 REG,5,3,4,0,3,9,1,0,3,-3,0,0,0,0,0,0,0,0,0,0.49907282342437215,0.5009271765756278
86630,0.6000000000000001,0.43859649122807015,-150,128,0.5768421052631579,0.42315789473684207,home,PHI,under,8,0.5215311004784688,-109,0.5009271765756278,PHI,SD,2022 REG,5,3,4,0,3,9,1,0,3,-3,0,0,0,0,0,0,0,0,0,0.49907282342437215,0.5009271765756278
86631,0.4444444444444444,0.5967741935483871,125,-148,0.42612504978096366,0.5738749502190363,away,ATL,over,9.5,0.5348837209302326,-115,0.5109810284308424,WSH,ATL,2022 REG,10,5,10,9,14,20,0,1,-4,4,1,1,1,1,1,0,0,0,0,0.5109810284308424,0.48901897156915763
86631,0.4444444444444444,0.5967741935483871,125,-148,0.42612504978096366,0.5738749502190363,home,WSH,under,9.5,0.5098039215686274,-104,0.48901897156915763,WSH,ATL,2022 REG,10,5,10,9,14,20,0,1,-4,4,1,1,1,1,1,0,0,0,0,0.5109810284308424,0.48901897156915763
86632,0.5515695067264574,0.48780487804878053,-123,105,0.5298517967383217,0.4701482032616783,away,BAL,over,9.5,0.5454545454545454,-120,0.5206611570247933,BOS,BAL,2022 REG,15,8,14,14,22,29,0,1,-6,6,1,1,1,1,1,1,1,1,0,0.5206611570247933,0.4793388429752067
86632,0.5515695067264574,0.48780487804878053,-123,105,0.5298517967383217,0.4701482032616783,home,BOS,under,9.5,0.5,100,0.4793388429752067,BOS,BAL,2022 REG,15,8,14,14,22,29,0,1,-6,6,1,1,1,1,1,1,1,1,0,0.5206611570247933,0.4793388429752067
86633,0.4672897196261683,0.5708154506437768,114,-133,0.44948356529441824,0.5505164347055818,away,HOU,over,7,0.5121951219512195,-105,0.48808156828023186,CWS,HOU,2022 REG,10,4,9,3,7,19,1,0,1,-1,1,1,1,0,0,0,0,0,0,0.48808156828023186,0.5119184317197681
86633,0.4672897196261683,0.5708154506437768,114,-133,0.44948356529441824,0.5505164347055818,home,CWS,under,7,0.5348837209302326,-115,0.5119184317197681,CWS,HOU,2022 REG,10,4,9,3,7,19,1,0,1,-1,1,1,1,0,0,0,0,0,0,0.48808156828023186,0.5119184317197681
86634,0.31746031746031744,0.7159090909090909,215,-252,0.30686685448590206,0.6931331455140979,away,TB,over,7.5,0.5,100,0.4772727272727273,DET,TB,2022 REG,12,9,9,1,10,21,1,0,8,-8,1,0,0,0,0,0,0,0,0,0.4772727272727273,0.5227272727272727
86634,0.31746031746031744,0.7159090909090909,215,-252,0.30686685448590206,0.6931331455140979,home,DET,under,7.5,0.5454545454545454,-120,0.5227272727272727,DET,TB,2022 REG,12,9,9,1,10,21,1,0,8,-8,1,0,0,0,0,0,0,0,0,0.4772727272727273,0.5227272727272727
86635,0.601593625498008,0.4424778761061947,-151,126,0.5750804910667944,0.4249195089332056,away,CHC,over,9,0.5098039215686274,-104,0.4870219861770517,PIT,CHC,2022 REG,7,7,6,1,8,13,1,0,6,-6,1,0,0,0,0,0,0,0,0,0.4870219861770517,0.5129780138229483
86635,0.601593625498008,0.4424778761061947,-151,126,0.5750804910667944,0.4249195089332056,home,PIT,under,9,0.5348837209302326,-115,0.5129780138229483,PIT,CHC,2022 REG,7,7,6,1,8,13,1,0,6,-6,1,0,0,0,0,0,0,0,0,0.4870219861770517,0.5129780138229483
86636,0.4347826086956522,0.6047430830039526,130,-153,0.4175975253479979,0.5824024746520021,away,CLE,over,7.5,0.5073891625615764,-103,0.4837652908580103,DET,CLE,2022 REG,10,1,11,8,9,21,0,1,-7,7,1,0,0,0,0,0,0,0,0,0.4837652908580103,0.5162347091419897
86636,0.4347826086956522,0.6047430830039526,130,-153,0.4175975253479979,0.5824024746520021,home,DET,under,7.5,0.5391705069124424,-117,0.5162347091419897,DET,CLE,2022 REG,10,1,11,8,9,21,0,1,-7,7,1,0,0,0,0,0,0,0,0,0.4837652908580103,0.5162347091419897
86637,0.7142857142857143,0.3225806451612903,-250,210,0.6879526003949967,0.3120473996050033,away,CIN,over,9.5,0.49751243781094534,101,0.47511256217505476,LAD,CIN,2022 REG,7,3,5,1,4,12,1,0,2,-2,1,0,0,0,0,0,0,0,0,0.47511256217505476,0.5248874378249453
86637,0.7142857142857143,0.3225806451612903,-250,210,0.6879526003949967,0.3120473996050033,home,LAD,under,9.5,0.5475113122171946,-121,0.5248874378249453,LAD,CIN,2022 REG,7,3,5,1,4,12,1,0,2,-2,1,0,0,0,0,0,0,0,0,0.47511256217505476,0.5248874378249453
86638,0.48780487804878053,0.5535714285714286,105,-124,0.4676213138438005,0.5323786861561994,away,HOU,over,8,0.5305164319248826,-113,0.5066009958897986,NYM,HOU,2022 REG,8,1,12,9,10,20,0,1,-8,8,1,0,0,0,0,0,0,0,0,0.5066009958897986,0.49339900411020143
86638,0.48780487804878053,0.5535714285714286,105,-124,0.4676213138438005,0.5323786861561994,home,NYM,under,8,0.5145631067961165,-106,0.49339900411020143,NYM,HOU,2022 REG,8,1,12,9,10,20,0,1,-8,8,1,0,0,0,0,0,0,0,0,0.5066009958897986,0.49339900411020143
86639,0.5689655172413793,0.4716981132075471,-132,112,0.5458293137100936,0.4541706862899064,away,MIA,over,7.5,0.5145631067961165,-106,0.4925063625223866,STL,MIA,2022 REG,11,9,8,0,9,19,1,0,9,-9,0,0,0,0,0,0,0,0,0,0.4925063625223866,0.5074936374776133
86639,0.5689655172413793,0.4716981132075471,-132,112,0.5458293137100936,0.4541706862899064,home,STL,under,7.5,0.5283018867924528,-112,0.5074936374776133,STL,MIA,2022 REG,11,9,8,0,9,19,1,0,9,-9,0,0,0,0,0,0,0,0,0,0.4925063625223866,0.5074936374776133
86640,0.5633187772925764,0.4716981132075471,-129,112,0.5435931053514588,0.45640689464854123,away,PHI,over,8,0.5098039215686274,-104,0.4870219861770517,NYM,PHI,2022 REG,9,8,9,6,14,18,1,0,2,-2,1,1,1,1,1,1,0,0,0,0.4870219861770517,0.5129780138229483
86640,0.5633187772925764,0.4716981132075471,-129,112,0.5435931053514588,0.45640689464854123,home,NYM,under,8,0.5348837209302326,-115,0.5129780138229483,NYM,PHI,2022 REG,9,8,9,6,14,18,1,0,2,-2,1,1,1,1,1,1,0,0,0,0.4870219861770517,0.5129780138229483
86641,0.4566210045662101,0.5798319327731092,119,-138,0.43997582769894106,0.5600241723010589,away,SD,over,9,0.5192307692307692,-108,0.49571111079951763,ARI,SD,2022 REG,3,4,4,2,6,7,1,0,2,-2,1,1,0,0,0,0,0,0,0,0.49571111079951763,0.5042888892004824
86641,0.4566210045662101,0.5798319327731092,119,-138,0.43997582769894106,0.5600241723010589,home,ARI,under,9,0.5260663507109005,-111,0.5042888892004824,ARI,SD,2022 REG,3,4,4,2,6,7,1,0,2,-2,1,1,0,0,0,0,0,0,0,0.49571111079951763,0.5042888892004824
86642,0.6197718631178707,0.4166666666666667,-163,140,0.597188287624032,0.402811712375968,away,OAK,over,9.5,0.5215311004784688,-109,0.4978845547971712,KC,OAK,2022 REG,10,7,13,9,16,23,0,1,-2,2,1,1,1,1,1,1,1,0,0,0.4978845547971712,0.5021154452028288
86642,0.6197718631178707,0.4166666666666667,-163,140,0.597188287624032,0.402811712375968,home,KC,under,9.5,0.5238095238095238,-110,0.5021154452028288,KC,OAK,2022 REG,10,7,13,9,16,23,0,1,-2,2,1,1,1,1,1,1,1,0,0,0.4978845547971712,0.5021154452028288
86643,0.5348837209302326,0.5121951219512195,-115,-105,0.5097020142727117,0.49029798572728833,away,MIN,over,7,0.5454545454545454,-120,0.5206611570247933,CWS,MIN,2022 REG,5,3,7,2,5,12,1,0,1,-1,1,1,0,0,0,0,0,0,0,0.5206611570247933,0.4793388429752067
86643,0.5348837209302326,0.5121951219512195,-115,-105,0.5097020142727117,0.49029798572728833,home,CWS,under,7,0.5,100,0.4793388429752067,CWS,MIN,2022 REG,5,3,7,2,5,12,1,0,1,-1,1,1,0,0,0,0,0,0,0,0.5206611570247933,0.4793388429752067
86644,0.5305164319248826,0.5098039215686274,-113,-104,0.5091258218555558,0.49087417814444423,away,ARI,over,10,0.5238095238095238,-110,0.4988662131519274,COL,ARI,2022 REG,14,13,9,10,23,23,1,0,3,-3,1,1,1,1,1,1,1,1,1,0.4988662131519274,0.5011337868480725
86644,0.5305164319248826,0.5098039215686274,-113,-104,0.5091258218555558,0.49087417814444423,home,COL,under,10,0.5238095238095238,-110,0.5011337868480725,COL,ARI,2022 REG,14,13,9,10,23,23,1,0,3,-3,1,1,1,1,1,1,1,1,1,0.4988662131519274,0.5011337868480725
86645,0.7468354430379747,0.29411764705882354,-295,240,0.7162502238517583,0.2837497761482417,away,OAK,over,8.5,0.5348837209302326,-115,0.5109810284308424,HOU,OAK,2022 REG,12,8,5,0,8,17,1,0,8,-8,0,0,0,0,0,0,0,0,0,0.5109810284308424,0.48901897156915763
86645,0.7468354430379747,0.29411764705882354,-295,240,0.7162502238517583,0.2837497761482417,home,HOU,under,8.5,0.5098039215686274,-104,0.48901897156915763,HOU,OAK,2022 REG,12,8,5,0,8,17,1,0,8,-8,0,0,0,0,0,0,0,0,0,0.5109810284308424,0.48901897156915763
86646,0.5555555555555556,0.4807692307692307,-125,108,0.5353751187084521,0.4646248812915479,away,SF,over,6.5,0.5,100,0.47935779816513757,NYM,SF,2022 REG,8,5,9,4,9,17,1,0,1,-1,1,1,1,1,0,0,0,0,0,0.47935779816513757,0.5206422018348624
86646,0.5555555555555556,0.4807692307692307,-125,108,0.5353751187084521,0.4646248812915479,home,NYM,under,6.5,0.5412844036697247,-118,0.5206422018348624,NYM,SF,2022 REG,8,5,9,4,9,17,1,0,1,-1,1,1,1,1,0,0,0,0,0,0.47935779816513757,0.5206422018348624
86647,0.5348837209302326,0.5121951219512195,-115,-105,0.5097020142727117,0.49029798572728833,away,MIA,over,10.5,0.5121951219512195,-105,0.48808156828023186,COL,MIA,2022 REG,3,1,21,14,15,24,0,1,-13,13,1,0,0,0,0,0,0,0,0,0.48808156828023186,0.5119184317197681
86647,0.5348837209302326,0.5121951219512195,-115,-105,0.5097020142727117,0.49029798572728833,home,COL,under,10.5,0.5348837209302326,-115,0.5119184317197681,COL,MIA,2022 REG,3,1,21,14,15,24,0,1,-13,13,1,0,0,0,0,0,0,0,0,0.48808156828023186,0.5119184317197681
86648,0.3891050583657587,0.6503496503496503,157,-186,0.3737530316282454,0.6262469683717546,away,HOU,over,8,0.5283018867924528,-112,0.5044173060022736,LAA,HOU,2022 REG,8,2,7,3,5,15,0,1,-1,1,1,1,0,0,0,0,0,0,0,0.5044173060022736,0.49558269399772636
86648,0.3891050583657587,0.6503496503496503,157,-186,0.3737530316282454,0.6262469683717546,home,LAA,under,8,0.5169082125603864,-107,0.49558269399772636,LAA,HOU,2022 REG,8,2,7,3,5,15,0,1,-1,1,1,1,0,0,0,0,0,0,0,0.5044173060022736,0.49558269399772636
86649,0.5,0.5454545454545454,100,-120,0.4772727272727273,0.5227272727272727,away,CHC,over,8.5,0.5391705069124424,-117,0.5114756747601454,PIT,CHC,2022 REG,6,1,8,2,3,14,0,1,-1,1,1,0,0,0,0,0,0,0,0,0.5114756747601454,0.48852432523985456
86649,0.5,0.5454545454545454,100,-120,0.4772727272727273,0.5227272727272727,home,PIT,under,8.5,0.5121951219512195,-105,0.48852432523985456,PIT,CHC,2022 REG,6,1,8,2,3,14,0,1,-1,1,1,0,0,0,0,0,0,0,0,0.5114756747601454,0.48852432523985456
86650,0.4672897196261683,0.5708154506437768,114,-133,0.44948356529441824,0.5505164347055818,away,SD,over,7,0.5283018867924528,-112,0.5044173060022736,CLE,SD,2022 REG,7,4,6,5,9,13,0,1,-1,1,1,1,1,1,0,0,0,0,0,0.5044173060022736,0.49558269399772636
86650,0.4672897196261683,0.5708154506437768,114,-133,0.44948356529441824,0.5505164347055818,home,CLE,under,7,0.5169082125603864,-107,0.49558269399772636,CLE,SD,2022 REG,7,4,6,5,9,13,0,1,-1,1,1,1,1,1,0,0,0,0,0,0.5044173060022736,0.49558269399772636
86651,0.5454545454545454,0.49019607843137253,-120,104,0.526008750607681,0.47399124939231896,away,SF,over,7.5,0.5283018867924528,-112,0.5044173060022736,SD,SF,2022 REG,6,0,17,12,12,23,0,1,-12,12,0,0,0,0,0,0,0,0,0,0.5044173060022736,0.49558269399772636
86651,0.5454545454545454,0.49019607843137253,-120,104,0.526008750607681,0.47399124939231896,home,SD,under,7.5,0.5169082125603864,-107,0.49558269399772636,SD,SF,2022 REG,6,0,17,12,12,23,0,1,-12,12,0,0,0,0,0,0,0,0,0,0.5044173060022736,0.49558269399772636
86652,0.6575342465753424,0.37735849056603776,-192,165,0.6345910769481337,0.36540892305186634,away,PHI,over,6.5,0.5454545454545454,-120,0.5206611570247933,NYM,PHI,2022 REG,15,10,8,6,16,23,1,0,4,-4,1,1,1,1,1,1,0,0,0,0.5206611570247933,0.4793388429752067
86652,0.6575342465753424,0.37735849056603776,-192,165,0.6345910769481337,0.36540892305186634,home,NYM,under,6.5,0.5,100,0.4793388429752067,NYM,PHI,2022 REG,15,10,8,6,16,23,1,0,4,-4,1,1,1,1,1,1,0,0,0,0.5206611570247933,0.4793388429752067
86653,0.5555555555555556,0.48780487804878053,-125,105,0.5314664257753688,0.46853357422463116,away,SEA,over,8,0.5283018867924528,-112,0.5044173060022736,LAA,SEA,2022 REG,10,3,11,5,8,21,0,1,-2,2,1,1,1,0,0,0,0,0,0,0.5044173060022736,0.49558269399772636
86653,0.5555555555555556,0.48780487804878053,-125,105,0.5314664257753688,0.46853357422463116,home,LAA,under,8,0.5169082125603864,-107,0.49558269399772636,LAA,SEA,2022 REG,10,3,11,5,8,21,0,1,-2,2,1,1,1,0,0,0,0,0,0,0.5044173060022736,0.49558269399772636
86654,0.45248868778280543,0.5918367346938775,121,-145,0.4324319355309127,0.5675680644690873,away,MIL,over,9.5,0.5169082125603864,-107,0.4946943078742622,BOS,MIL,2022 REG,11,7,11,2,9,22,1,0,5,-5,1,1,0,0,0,0,0,0,0,0.4946943078742622,0.5053056921257377
86654,0.45248868778280543,0.5918367346938775,121,-145,0.4324319355309127,0.5675680644690873,home,BOS,under,9.5,0.5260663507109005,-111,0.5053056921257377,BOS,MIL,2022 REG,11,7,11,2,9,22,1,0,5,-5,1,1,0,0,0,0,0,0,0,0.4946943078742622,0.5053056921257377
86655,0.6031746031746031,0.4347826086956522,-152,130,0.5802797769671475,0.4197202230328525,away,LAA,over,8,0.5454545454545454,-120,0.5206611570247933,SEA,LAA,2022 REG,8,6,8,3,9,16,1,0,3,-3,1,1,1,0,0,0,0,0,0,0.5206611570247933,0.4793388429752067
86655,0.6031746031746031,0.4347826086956522,-152,130,0.5802797769671475,0.4197202230328525,home,SEA,under,8,0.5,100,0.4793388429752067,SEA,LAA,2022 REG,8,6,8,3,9,16,1,0,3,-3,1,1,1,0,0,0,0,0,0,0.5206611570247933,0.4793388429752067
86656,0.4016064257028112,0.6415770609318996,149,-179,0.3842636599860599,0.6157363400139402,away,NYM,over,8.5,0.5454545454545454,-120,0.5206611570247933,WSH,NYM,2022 REG,5,3,13,7,10,18,0,1,-4,4,1,1,1,0,0,0,0,0,0,0.5206611570247933,0.4793388429752067
86656,0.4016064257028112,0.6415770609318996,149,-179,0.3842636599860599,0.6157363400139402,home,WSH,under,8.5,0.5,100,0.4793388429752067,WSH,NYM,2022 REG,5,3,13,7,10,18,0,1,-4,4,1,1,1,0,0,0,0,0,0,0.5206611570247933,0.4793388429752067
86657,0.7101449275362319,0.33557046979865773,-245,198,0.6776803700085567,0.32231962999144326,away,PIT,over,8,0.5348837209302326,-115,0.5097020142727117,ARI,PIT,2022 REG,6,3,3,0,3,9,1,0,3,-3,0,0,0,0,0,0,0,0,0,0.5097020142727117,0.49029798572728833
86657,0.7101449275362319,0.33557046979865773,-245,198,0.6776803700085567,0.32231962999144326,home,ARI,under,8,0.5121951219512195,-105,0.49029798572728833,ARI,PIT,2022 REG,6,3,3,0,3,9,1,0,3,-3,0,0,0,0,0,0,0,0,0,0.5097020142727117,0.49029798572728833
86658,0.4081632653061224,0.6323529411764706,145,-172,0.39162603817037017,0.6083739618296298,away,MIN,over,8.5,0.5454545454545454,-120,0.5206611570247933,DET,MIN,2022 REG,6,4,11,8,12,17,0,1,-4,4,1,1,1,1,0,0,0,0,0,0.5206611570247933,0.4793388429752067
86658,0.4081632653061224,0.6323529411764706,145,-172,0.39162603817037017,0.6083739618296298,home,DET,under,8.5,0.5,100,0.4793388429752067,DET,MIN,2022 REG,6,4,11,8,12,17,0,1,-4,4,1,1,1,1,0,0,0,0,0,0.5206611570247933,0.4793388429752067
86659,0.7109826589595376,0.3436426116838488,-246,191,0.6721450387911183,0.3278549612088817,away,CHC,over,8.5,0.5215311004784688,-109,0.4978845547971712,STL,CHC,2022 REG,10,7,2,2,9,12,1,0,5,-5,1,1,0,0,0,0,0,0,0,0.4978845547971712,0.5021154452028288
86659,0.7109826589595376,0.3436426116838488,-246,191,0.6721450387911183,0.3278549612088817,home,STL,under,8.5,0.5238095238095238,-110,0.5021154452028288,STL,CHC,2022 REG,10,7,2,2,9,12,1,0,5,-5,1,1,0,0,0,0,0,0,0,0.4978845547971712,0.5021154452028288
86660,0.4926108374384236,0.5454545454545454,103,-120,0.47385941729410397,0.526140582705896,away,TOR,over,8.5,0.5098039215686274,-104,0.48375889301574193,TEX,TOR,2022 REG,9,4,7,1,5,16,1,0,3,-3,1,0,0,0,0,0,0,0,0,0.48375889301574193,0.5162411069842581
86660,0.4926108374384236,0.5454545454545454,103,-120,0.47385941729410397,0.526140582705896,home,TEX,under,8.5,0.5412844036697247,-118,0.5162411069842581,TEX,TOR,2022 REG,9,4,7,1,5,16,1,0,3,-3,1,0,0,0,0,0,0,0,0,0.48375889301574193,0.5162411069842581
86661,0.797979797979798,0.24390243902439027,-395,310,0.7645586189562539,0.23544138104374612,away,WSH,over,8,0.5238095238095238,-110,0.4988662131519274,SD,WSH,2022 REG,3,1,6,3,4,9,0,1,-2,2,1,0,0,0,0,0,0,0,0,0.4988662131519274,0.5011337868480725
86661,0.797979797979798,0.24390243902439027,-395,310,0.7645586189562539,0.23544138104374612,home,SD,under,8,0.5238095238095238,-110,0.5011337868480725,SD,WSH,2022 REG,3,1,6,3,4,9,0,1,-2,2,1,0,0,0,0,0,0,0,0,0.4988662131519274,0.5011337868480725
86662,0.4587155963302753,0.5798319327731092,118,-138,0.4410332435305576,0.5589667564694424,away,TB,over,8.5,0.5121951219512195,-105,0.48808156828023186,CIN,TB,2022 REG,14,10,12,5,15,26,1,0,5,-5,1,1,1,1,1,0,0,0,0,0.48808156828023186,0.5119184317197681
86662,0.4587155963302753,0.5798319327731092,118,-138,0.4410332435305576,0.5589667564694424,home,CIN,under,8.5,0.5348837209302326,-115,0.5119184317197681,CIN,TB,2022 REG,14,10,12,5,15,26,1,0,5,-5,1,1,1,1,1,0,0,0,0,0.48808156828023186,0.5119184317197681
86663,0.7894736842105263,0.25,-375,300,0.7583102493074793,0.24168975069252074,away,COL,over,7.5,0.5454545454545454,-120,0.5206611570247933,LAD,COL,2022 REG,5,2,9,5,7,14,0,1,-3,3,1,1,0,0,0,0,0,0,0,0.5206611570247933,0.4793388429752067
86663,0.7894736842105263,0.25,-375,300,0.7583102493074793,0.24168975069252074,home,LAD,under,7.5,0.5,100,0.4793388429752067,LAD,COL,2022 REG,5,2,9,5,7,14,0,1,-3,3,1,1,0,0,0,0,0,0,0,0.5206611570247933,0.4793388429752067
86664,0.5983935742971888,0.4444444444444444,-149,125,0.5727595791465728,0.42724042085342717,away,TB,over,6.5,0.5391705069124424,-117,0.5153817639191344,HOU,TB,2022 REG,6,2,4,1,3,10,1,0,1,-1,1,0,0,0,0,0,0,0,0,0.5153817639191344,0.4846182360808656
86664,0.5983935742971888,0.4444444444444444,-149,125,0.5727595791465728,0.42724042085342717,home,HOU,under,6.5,0.504950495049505,-102,0.4846182360808656,HOU,TB,2022 REG,6,2,4,1,3,10,1,0,1,-1,1,0,0,0,0,0,0,0,0,0.5153817639191344,0.4846182360808656
86665,0.5918367346938775,0.4444444444444444,-145,125,0.5703642001018094,0.42963579989819056,away,CLE,over,10,0.5098039215686274,-104,0.48592421718142587,MIN,CLE,2022 REG,5,1,5,0,1,10,1,0,1,-1,0,0,0,0,0,0,0,0,0,0.48592421718142587,0.5140757828185741
86665,0.5918367346938775,0.4444444444444444,-145,125,0.5703642001018094,0.42963579989819056,home,MIN,under,10,0.5370370370370371,-116,0.5140757828185741,MIN,CLE,2022 REG,5,1,5,0,1,10,1,0,1,-1,0,0,0,0,0,0,0,0,0,0.48592421718142587,0.5140757828185741
86666,0.5238095238095238,0.5215311004784688,-110,-109,0.5000596729920038,0.4999403270079962,away,SD,over,7.5,0.5370370370370371,-116,0.5118817074154765,ARI,SD,2022 REG,9,7,10,6,13,19,1,0,1,-1,1,1,1,1,1,1,0,0,0,0.5118817074154765,0.48811829258452355
86666,0.5238095238095238,0.5215311004784688,-110,-109,0.5000596729920038,0.4999403270079962,home,ARI,under,7.5,0.5098039215686274,-104,0.48811829258452355,ARI,SD,2022 REG,9,7,10,6,13,19,1,0,1,-1,1,1,1,1,1,1,0,0,0,0.5118817074154765,0.48811829258452355
86667,0.6254681647940076,0.41493775933609955,-167,141,0.6001955455815435,0.39980445441845647,away,TEX,over,6.5,0.5283018867924528,-112,0.5031902949311281,SEA,TEX,2022 REG,5,3,5,1,4,10,1,0,2,-2,1,0,0,0,0,0,0,0,0,0.5031902949311281,0.4968097050688719
86667,0.6254681647940076,0.41493775933609955,-167,141,0.6001955455815435,0.39980445441845647,home,SEA,under,6.5,0.5192307692307692,-108,0.4968097050688719,SEA,TEX,2022 REG,5,3,5,1,4,10,1,0,2,-2,1,0,0,0,0,0,0,0,0,0.5031902949311281,0.4968097050688719
86668,0.6688741721854304,0.3717472118959108,-202,169,0.641703577534997,0.35829642246500304,away,KC,over,7,0.5454545454545454,-120,0.5206611570247933,TB,KC,2022 REG,10,5,4,2,7,14,1,0,3,-3,1,1,0,0,0,0,0,0,0,0.5206611570247933,0.4793388429752067
86668,0.6688741721854304,0.3717472118959108,-202,169,0.641703577534997,0.35829642246500304,home,TB,under,7,0.5,100,0.4793388429752067,TB,KC,2022 REG,10,5,4,2,7,14,1,0,3,-3,1,1,0,0,0,0,0,0,0,0.5206611570247933,0.4793388429752067
86669,0.6031746031746031,0.4366812227074236,-152,129,0.5791345812140156,0.4208654187859844,away,CIN,over,8,0.5260663507109005,-111,0.5010269332605688,MIL,CIN,2022 REG,5,2,17,8,10,22,0,1,-6,6,1,1,0,0,0,0,0,0,0,0.5010269332605688,0.4989730667394312
86669,0.6031746031746031,0.4366812227074236,-152,129,0.5791345812140156,0.4208654187859844,home,MIL,under,8,0.5215311004784688,-109,0.4989730667394312,MIL,CIN,2022 REG,5,2,17,8,10,22,0,1,-6,6,1,1,0,0,0,0,0,0,0,0.5010269332605688,0.4989730667394312
86670,0.7590361445783133,0.2777777777777778,-315,260,0.7310930468863406,0.2689069531136594,away,KC,over,9.5,0.5121951219512195,-105,0.48808156828023186,TOR,KC,2022 REG,12,6,9,5,11,21,1,0,1,-1,1,1,1,1,1,0,0,0,0,0.48808156828023186,0.5119184317197681
86670,0.7590361445783133,0.2777777777777778,-315,260,0.7310930468863406,0.2689069531136594,home,TOR,under,9.5,0.5348837209302326,-115,0.5119184317197681,TOR,KC,2022 REG,12,6,9,5,11,21,1,0,1,-1,1,1,1,1,1,0,0,0,0,0.48808156828023186,0.5119184317197681
86671,0.4,0.6376811594202898,150,-176,0.384927536231884,0.615072463768116,away,NYM,over,10,0.5121951219512195,-105,0.48919479393107135,CIN,NYM,2022 REG,7,4,12,7,11,19,0,1,-3,3,1,1,1,1,0,0,0,0,0,0.48919479393107135,0.5108052060689287
86671,0.4,0.6376811594202898,150,-176,0.384927536231884,0.615072463768116,home,CIN,under,10,0.5327102803738317,-114,0.5108052060689287,CIN,NYM,2022 REG,7,4,12,7,11,19,0,1,-3,3,1,1,1,1,0,0,0,0,0,0.48919479393107135,0.5108052060689287
86672,0.6610169491525424,0.3802281368821293,-195,163,0.6337532482143695,0.3662467517856305,away,PIT,over,8,0.5348837209302326,-115,0.5097020142727117,CHC,PIT,2022 REG,10,4,4,2,6,14,1,0,2,-2,1,1,0,0,0,0,0,0,0,0.5097020142727117,0.49029798572728833
86672,0.6610169491525424,0.3802281368821293,-195,163,0.6337532482143695,0.3662467517856305,home,CHC,under,8,0.5121951219512195,-105,0.49029798572728833,CHC,PIT,2022 REG,10,4,4,2,6,14,1,0,2,-2,1,1,0,0,0,0,0,0,0,0.5097020142727117,0.49029798572728833
86673,0.6183206106870228,0.4166666666666667,-162,140,0.5966872559874133,0.40331274401258665,away,CHC,over,7.5,0.5,100,0.47935779816513757,SD,CHC,2022 REG,11,5,10,4,9,21,1,0,1,-1,1,1,1,1,0,0,0,0,0,0.47935779816513757,0.5206422018348624
86673,0.6183206106870228,0.4166666666666667,-162,140,0.5966872559874133,0.40331274401258665,home,SD,under,7.5,0.5412844036697247,-118,0.5206422018348624,SD,CHC,2022 REG,11,5,10,4,9,21,1,0,1,-1,1,1,1,1,0,0,0,0,0,0.47935779816513757,0.5206422018348624
86674,0.49751243781094534,0.5454545454545454,101,-120,0.476135829221149,0.523864170778851,away,TOR,over,8.5,0.5348837209302326,-115,0.5097020142727117,PHI,TOR,2022 REG,15,11,21,18,29,36,0,1,-7,7,1,1,1,1,1,1,1,1,1,0.5097020142727117,0.49029798572728833
86674,0.49751243781094534,0.5454545454545454,101,-120,0.476135829221149,0.523864170778851,home,PHI,under,8.5,0.5121951219512195,-105,0.49029798572728833,PHI,TOR,2022 REG,15,11,21,18,29,36,0,1,-7,7,1,1,1,1,1,1,1,1,1,0.5097020142727117,0.49029798572728833
86675,0.5145631067961165,0.5169082125603864,-106,-107,0.4983691269330616,0.5016308730669383,away,ATL,over,7,0.5327102803738317,-114,0.508788710910954,STL,ATL,2022 REG,9,6,10,5,11,19,1,0,1,-1,1,1,1,1,1,0,0,0,0,0.508788710910954,0.491211289089046
86675,0.5145631067961165,0.5169082125603864,-106,-107,0.4983691269330616,0.5016308730669383,home,STL,under,7,0.5121951219512195,-105,0.491211289089046,STL,ATL,2022 REG,9,6,10,5,11,19,1,0,1,-1,1,1,1,1,1,0,0,0,0,0.508788710910954,0.491211289089046
86676,0.7402597402597403,0.29850746268656714,-285,235,0.7115619406761102,0.2884380593238898,away,PIT,over,7.5,0.5,100,0.47935779816513757,SF,PIT,2022 REG,7,5,10,3,8,17,1,0,2,-2,1,1,1,0,0,0,0,0,0,0.47935779816513757,0.5206422018348624
86676,0.7402597402597403,0.29850746268656714,-285,235,0.7115619406761102,0.2884380593238898,home,SF,under,7.5,0.5412844036697247,-118,0.5206422018348624,SF,PIT,2022 REG,7,5,10,3,8,17,1,0,2,-2,1,1,1,0,0,0,0,0,0,0.47935779816513757,0.5206422018348624
86677,0.48780487804878053,0.5515695067264574,105,-123,0.4685978610852498,0.5314021389147502,away,TEX,over,7,0.5238095238095238,-110,0.5000596729920038,MIA,TEX,2022 REG,10,10,8,6,16,18,1,0,4,-4,1,1,1,1,1,1,0,0,0,0.5000596729920038,0.4999403270079962
86677,0.48780487804878053,0.5515695067264574,105,-123,0.4685978610852498,0.5314021389147502,home,MIA,under,7,0.5215311004784688,-109,0.4999403270079962,MIA,TEX,2022 REG,10,10,8,6,16,18,1,0,4,-4,1,1,1,1,1,1,0,0,0,0.5000596729920038,0.4999403270079962
86678,0.5918367346938775,0.45248868778280543,-145,121,0.5656033213913509,0.43439667860864906,away,CLE,over,7.5,0.5,100,0.4772727272727273,TB,CLE,2022 REG,10,6,11,4,10,21,1,0,2,-2,1,1,1,1,0,0,0,0,0,0.4772727272727273,0.5227272727272727
86678,0.5918367346938775,0.45248868778280543,-145,121,0.5656033213913509,0.43439667860864906,home,TB,under,7.5,0.5454545454545454,-120,0.5227272727272727,TB,CLE,2022 REG,10,6,11,4,10,21,1,0,2,-2,1,1,1,1,0,0,0,0,0,0.4772727272727273,0.5227272727272727
86679,0.5833333333333333,0.45454545454545453,-140,120,0.5612373737373737,0.4387626262626263,away,KC,over,10.5,0.5238095238095238,-110,0.4988662131519274,COL,KC,2022 REG,13,10,18,14,24,31,0,1,-4,4,1,1,1,1,1,1,1,1,1,0.4988662131519274,0.5011337868480725
86679,0.5833333333333333,0.45454545454545453,-140,120,0.5612373737373737,0.4387626262626263,home,COL,under,10.5,0.5238095238095238,-110,0.5011337868480725,COL,KC,2022 REG,13,10,18,14,24,31,0,1,-4,4,1,1,1,1,1,1,1,1,1,0.4988662131519274,0.5011337868480725
86680,0.6168582375478928,0.42194092827004215,-161,137,0.592924652503113,0.407075347496887,away,NYM,over,8.5,0.5169082125603864,-107,0.49353874091423283,LAD,NYM,2022 REG,8,6,5,1,7,13,1,0,5,-5,1,0,0,0,0,0,0,0,0,0.49353874091423283,0.5064612590857671
86680,0.6168582375478928,0.42194092827004215,-161,137,0.592924652503113,0.407075347496887,home,LAD,under,8.5,0.5283018867924528,-112,0.5064612590857671,LAD,NYM,2022 REG,8,6,5,1,7,13,1,0,5,-5,1,0,0,0,0,0,0,0,0,0.49353874091423283,0.5064612590857671
86681,0.4716981132075471,0.5726495726495727,112,-134,0.4507793934636226,0.5492206065363774,away,TOR,over,9.5,0.5145631067961165,-106,0.4913668392989033,MIL,TOR,2022 REG,13,10,6,3,13,19,1,0,7,-7,1,1,1,0,0,0,0,0,0,0.4913668392989033,0.5086331607010968
86681,0.4716981132075471,0.5726495726495727,112,-134,0.4507793934636226,0.5492206065363774,home,MIL,under,9.5,0.5305164319248826,-113,0.5086331607010968,MIL,TOR,2022 REG,13,10,6,3,13,19,1,0,7,-7,1,1,1,0,0,0,0,0,0,0.4913668392989033,0.5086331607010968
86682,0.4854368932038835,0.5555555555555556,106,-125,0.465537646233282,0.534462353766718,away,NYY,over,7,0.5348837209302326,-115,0.5109810284308424,TOR,NYY,2022 REG,4,3,11,8,11,15,0,1,-5,5,1,1,1,0,0,0,0,0,0,0.5109810284308424,0.48901897156915763
86682,0.4854368932038835,0.5555555555555556,106,-125,0.465537646233282,0.534462353766718,home,TOR,under,7,0.5098039215686274,-104,0.48901897156915763,TOR,NYY,2022 REG,4,3,11,8,11,15,0,1,-5,5,1,1,1,0,0,0,0,0,0,0.5109810284308424,0.48901897156915763
86683,0.5918367346938775,0.4504504504504505,-145,122,0.566809625118663,0.43319037488133705,away,KC,over,9,0.5215311004784688,-109,0.49907282342437215,CLE,KC,2022 REG,8,4,7,0,4,15,1,0,4,-4,0,0,0,0,0,0,0,0,0,0.49907282342437215,0.5009271765756278
86683,0.5918367346938775,0.4504504504504505,-145,122,0.566809625118663,0.43319037488133705,home,CLE,under,9,0.5215311004784688,-109,0.5009271765756278,CLE,KC,2022 REG,8,4,7,0,4,15,1,0,4,-4,0,0,0,0,0,0,0,0,0,0.49907282342437215,0.5009271765756278
86684,0.6226415094339623,0.4166666666666667,-165,140,0.5981666073335706,0.40183339266642937,away,OAK,over,8.5,0.5348837209302326,-115,0.5109810284308424,TEX,OAK,2022 REG,9,7,13,14,21,22,0,1,-7,7,1,1,1,1,1,1,1,0,0,0.5109810284308424,0.48901897156915763
86684,0.6226415094339623,0.4166666666666667,-165,140,0.5981666073335706,0.40183339266642937,home,TEX,under,8.5,0.5098039215686274,-104,0.48901897156915763,TEX,OAK,2022 REG,9,7,13,14,21,22,0,1,-7,7,1,1,1,1,1,1,1,0,0,0.5109810284308424,0.48901897156915763
86685,0.6666666666666666,0.37037037037037035,-200,170,0.6419753086419753,0.3580246913580247,away,PIT,over,7,0.5283018867924528,-112,0.5056562298022652,SD,PIT,2022 REG,8,4,4,3,7,12,1,0,1,-1,1,1,1,0,0,0,0,0,0,0.5056562298022652,0.4943437701977348
86685,0.6666666666666666,0.37037037037037035,-200,170,0.6419753086419753,0.3580246913580247,home,SD,under,7,0.5145631067961165,-106,0.4943437701977348,SD,PIT,2022 REG,8,4,4,3,7,12,1,0,1,-1,1,1,1,0,0,0,0,0,0,0.5056562298022652,0.4943437701977348
86686,0.765807962529274,0.27624309392265195,-327,262,0.7336049286656211,0.2663950713343789,away,COL,over,9,0.5283018867924528,-112,0.5056562298022652,LAD,COL,2022 REG,8,2,1,1,3,9,1,0,1,-1,1,0,0,0,0,0,0,0,0,0.5056562298022652,0.4943437701977348
86686,0.765807962529274,0.27624309392265195,-327,262,0.7336049286656211,0.2663950713343789,home,LAD,under,9,0.5145631067961165,-106,0.4943437701977348,LAD,COL,2022 REG,8,2,1,1,3,9,1,0,1,-1,1,0,0,0,0,0,0,0,0,0.5056562298022652,0.4943437701977348
86687,0.6282527881040892,0.4065040650406504,-169,146,0.6064166982101823,0.3935833017898177,away,PIT,over,9,0.5238095238095238,-110,0.5000596729920038,STL,PIT,2022 REG,7,3,7,1,4,14,1,0,2,-2,1,0,0,0,0,0,0,0,0,0.5000596729920038,0.4999403270079962
86687,0.6282527881040892,0.4065040650406504,-169,146,0.6064166982101823,0.3935833017898177,home,STL,under,9,0.5215311004784688,-109,0.4999403270079962,STL,PIT,2022 REG,7,3,7,1,4,14,1,0,2,-2,1,0,0,0,0,0,0,0,0,0.5000596729920038,0.4999403270079962
86688,0.6402877697841727,0.4,-178,150,0.6144920035194866,0.38550799648051337,away,DET,over,7.5,0.5454545454545454,-120,0.5179608869977906,SEA,DET,2022 REG,12,9,8,6,15,20,1,0,3,-3,1,1,1,1,1,1,0,0,0,0.5179608869977906,0.48203911300220936
86688,0.6402877697841727,0.4,-178,150,0.6144920035194866,0.38550799648051337,home,SEA,under,7.5,0.504950495049505,-102,0.48203911300220936,SEA,DET,2022 REG,12,9,8,6,15,20,1,0,3,-3,1,1,1,1,1,1,0,0,0,0.5179608869977906,0.48203911300220936
86689,0.6666666666666666,0.36764705882352944,-200,172,0.6437908496732027,0.35620915032679734,away,DET,over,8,0.5145631067961165,-106,0.4925063625223866,HOU,DET,2022 REG,4,3,11,2,5,15,1,0,1,-1,1,1,0,0,0,0,0,0,0,0.4925063625223866,0.5074936374776133
86689,0.6666666666666666,0.36764705882352944,-200,172,0.6437908496732027,0.35620915032679734,home,HOU,under,8,0.5283018867924528,-112,0.5074936374776133,HOU,DET,2022 REG,4,3,11,2,5,15,1,0,1,-1,1,1,0,0,0,0,0,0,0,0.4925063625223866,0.5074936374776133
86690,0.6551724137931035,0.3861003861003861,-190,159,0.6281316138628862,0.3718683861371138,away,COL,over,9,0.5348837209302326,-115,0.5097020142727117,MIL,COL,2022 REG,12,10,13,9,19,25,1,0,1,-1,1,1,1,1,1,1,1,1,1,0.5097020142727117,0.49029798572728833
86690,0.6551724137931035,0.3861003861003861,-190,159,0.6281316138628862,0.3718683861371138,home,MIL,under,9,0.5121951219512195,-105,0.49029798572728833,MIL,COL,2022 REG,12,10,13,9,19,25,1,0,1,-1,1,1,1,1,1,1,1,1,1,0.5097020142727117,0.49029798572728833
86691,0.425531914893617,0.6124031007751938,135,-158,0.4093893550345486,0.5906106449654513,away,SD,over,7,0.5238095238095238,-110,0.5000596729920038,MIA,SD,2022 REG,7,3,11,10,13,18,0,1,-7,7,1,1,1,0,0,0,0,0,0,0.5000596729920038,0.4999403270079962
86691,0.425531914893617,0.6124031007751938,135,-158,0.4093893550345486,0.5906106449654513,home,MIA,under,7,0.5215311004784688,-109,0.4999403270079962,MIA,SD,2022 REG,7,3,11,10,13,18,0,1,-7,7,1,1,1,0,0,0,0,0,0,0.5000596729920038,0.4999403270079962
86692,0.7333333333333333,0.303951367781155,-275,229,0.7059912191827085,0.29400878081729154,away,LAA,over,8,0.5238095238095238,-110,0.4988662131519274,HOU,LAA,2022 REG,12,12,11,4,16,23,1,0,8,-8,1,1,1,1,0,0,0,0,0,0.4988662131519274,0.5011337868480725
86692,0.7333333333333333,0.303951367781155,-275,229,0.7059912191827085,0.29400878081729154,home,HOU,under,8,0.5238095238095238,-110,0.5011337868480725,HOU,LAA,2022 REG,12,12,11,4,16,23,1,0,8,-8,1,1,1,1,0,0,0,0,0,0.4988662131519274,0.5011337868480725
86693,0.47619047619047616,0.5652173913043479,110,-130,0.4564724440500838,0.5435275559499162,away,SD,over,9.5,0.5121951219512195,-105,0.48808156828023186,CHC,SD,2022 REG,5,1,10,4,5,15,0,1,-3,3,1,0,0,0,0,0,0,0,0,0.48808156828023186,0.5119184317197681
86693,0.47619047619047616,0.5652173913043479,110,-130,0.4564724440500838,0.5435275559499162,home,CHC,under,9.5,0.5348837209302326,-115,0.5119184317197681,CHC,SD,2022 REG,5,1,10,4,5,15,0,1,-3,3,1,0,0,0,0,0,0,0,0,0.48808156828023186,0.5119184317197681
86694,0.6632996632996633,0.37593984962406013,-197,166,0.6372721075893149,0.36272789241068515,away,PIT,over,8.5,0.5412844036697247,-118,0.5189377998484975,STL,PIT,2022 REG,9,4,7,6,10,16,0,1,-2,2,1,1,1,1,0,0,0,0,0,0.5189377998484975,0.4810622001515025
86694,0.6632996632996633,0.37593984962406013,-197,166,0.6372721075893149,0.36272789241068515,home,STL,under,8.5,0.5,100,0.4810622001515025,STL,PIT,2022 REG,9,4,7,6,10,16,0,1,-2,2,1,1,1,1,0,0,0,0,0,0.5189377998484975,0.4810622001515025
86695,0.3921568627450981,0.6441281138790036,155,-181,0.37792746014741113,0.6220725398525888,away,ATL,over,8.5,0.5169082125603864,-107,0.49353874091423283,CHC,ATL,2022 REG,3,1,2,0,1,5,1,0,1,-1,0,0,0,0,0,0,0,0,0,0.49353874091423283,0.5064612590857671
86695,0.3921568627450981,0.6441281138790036,155,-181,0.37792746014741113,0.6220725398525888,home,CHC,under,8.5,0.5283018867924528,-112,0.5064612590857671,CHC,ATL,2022 REG,3,1,2,0,1,5,1,0,1,-1,0,0,0,0,0,0,0,0,0,0.49353874091423283,0.5064612590857671
86696,0.5652173913043479,0.4807692307692307,-130,108,0.5392249527410209,0.4607750472589791,away,MIL,over,7.5,0.5121951219512195,-105,0.48808156828023186,SD,MIL,2022 REG,5,1,4,2,3,9,0,1,-1,1,1,0,0,0,0,0,0,0,0,0.48808156828023186,0.5119184317197681
86696,0.5652173913043479,0.4807692307692307,-130,108,0.5392249527410209,0.4607750472589791,home,SD,under,7.5,0.5348837209302326,-115,0.5119184317197681,SD,MIL,2022 REG,5,1,4,2,3,9,0,1,-1,1,1,0,0,0,0,0,0,0,0,0.48808156828023186,0.5119184317197681
86697,0.45248868778280543,0.5918367346938775,121,-145,0.4324319355309127,0.5675680644690873,away,TOR,over,7.5,0.5348837209302326,-115,0.5097020142727117,BAL,TOR,2022 REG,3,1,9,4,5,12,0,1,-3,3,1,0,0,0,0,0,0,0,0,0.5097020142727117,0.49029798572728833
86697,0.45248868778280543,0.5918367346938775,121,-145,0.4324319355309127,0.5675680644690873,home,BAL,under,7.5,0.5121951219512195,-105,0.49029798572728833,BAL,TOR,2022 REG,3,1,9,4,5,12,0,1,-3,3,1,0,0,0,0,0,0,0,0,0.5097020142727117,0.49029798572728833
86698,0.647887323943662,0.39370078740157477,-184,154,0.6209429137763255,0.3790570862236745,away,OAK,over,8.5,0.5169082125603864,-107,0.49353874091423283,LAA,OAK,2022 REG,7,4,5,1,5,12,1,0,3,-3,1,0,0,0,0,0,0,0,0,0.49353874091423283,0.5064612590857671
86698,0.647887323943662,0.39370078740157477,-184,154,0.6209429137763255,0.3790570862236745,home,LAA,under,8.5,0.5283018867924528,-112,0.5064612590857671,LAA,OAK,2022 REG,7,4,5,1,5,12,1,0,3,-3,1,0,0,0,0,0,0,0,0,0.49353874091423283,0.5064612590857671
86699,0.45454545454545453,0.5833333333333333,120,-140,0.43732782369146006,0.5626721763085399,away,PHI,over,10.5,0.5238095238095238,-110,0.4988662131519274,WSH,PHI,2022 REG,10,7,7,8,15,17,0,1,-1,1,1,1,1,1,1,1,1,0,0,0.4988662131519274,0.5011337868480725
86699,0.45454545454545453,0.5833333333333333,120,-140,0.43732782369146006,0.5626721763085399,home,WSH,under,10.5,0.5238095238095238,-110,0.5011337868480725,WSH,PHI,2022 REG,10,7,7,8,15,17,0,1,-1,1,1,1,1,1,1,1,1,0,0,0.4988662131519274,0.5011337868480725
86700,0.6402877697841727,0.4,-178,150,0.6144920035194866,0.38550799648051337,away,WSH,over,7.5,0.49019607843137253,104,0.4707129274603323,MIA,WSH,2022 REG,6,1,13,6,7,19,0,1,-5,5,1,0,0,0,0,0,0,0,0,0.4707129274603323,0.5292870725396677
86700,0.6402877697841727,0.4,-178,150,0.6144920035194866,0.38550799648051337,home,MIA,under,7.5,0.5495495495495495,-122,0.5292870725396677,MIA,WSH,2022 REG,6,1,13,6,7,19,0,1,-5,5,1,0,0,0,0,0,0,0,0,0.4707129274603323,0.5292870725396677
86701,0.6226415094339623,0.4166666666666667,-165,140,0.5981666073335706,0.40183339266642937,away,SD,over,7.5,0.5305164319248826,-113,0.5078572507605655,LAD,SD,2022 REG,4,1,7,7,8,11,0,1,-6,6,1,0,0,0,0,0,0,0,0,0.5078572507605655,0.49214274923943446
86701,0.6226415094339623,0.4166666666666667,-165,140,0.5981666073335706,0.40183339266642937,home,LAD,under,7.5,0.5121951219512195,-105,0.49214274923943446,LAD,SD,2022 REG,4,1,7,7,8,11,0,1,-6,6,1,0,0,0,0,0,0,0,0,0.5078572507605655,0.49214274923943446
86702,0.4716981132075471,0.5689655172413793,112,-132,0.45251715544861953,0.5474828445513804,away,PHI,over,7.5,0.5412844036697247,-118,0.5189377998484975,STL,PHI,2022 REG,9,6,8,1,7,17,1,0,5,-5,1,0,0,0,0,0,0,0,0,0.5189377998484975,0.4810622001515025
86702,0.4716981132075471,0.5689655172413793,112,-132,0.45251715544861953,0.5474828445513804,home,STL,under,7.5,0.5,100,0.4810622001515025,STL,PHI,2022 REG,9,6,8,1,7,17,1,0,5,-5,1,0,0,0,0,0,0,0,0,0.5189377998484975,0.4810622001515025
86703,0.6825396825396826,0.35714285714285715,-215,180,0.6554547745023935,0.34454522549760647,away,ARI,over,8.5,0.5169082125603864,-107,0.49353874091423283,HOU,ARI,2022 REG,14,10,6,2,12,20,1,0,8,-8,1,1,0,0,0,0,0,0,0,0.49353874091423283,0.5064612590857671
86703,0.6825396825396826,0.35714285714285715,-215,180,0.6554547745023935,0.34454522549760647,home,HOU,under,8.5,0.5283018867924528,-112,0.5064612590857671,HOU,ARI,2022 REG,14,10,6,2,12,20,1,0,8,-8,1,1,0,0,0,0,0,0,0,0.49353874091423283,0.5064612590857671
86704,0.30120481927710846,0.7409326424870467,232,-286,0.28851281272164003,0.7114871872783599,away,ATL,over,9,0.5145631067961165,-106,0.4913668392989033,WSH,ATL,2022 REG,7,7,6,3,10,13,1,0,4,-4,1,1,1,0,0,0,0,0,0,0.4913668392989033,0.5086331607010968
86704,0.30120481927710846,0.7409326424870467,232,-286,0.28851281272164003,0.7114871872783599,home,WSH,under,9,0.5305164319248826,-113,0.5086331607010968,WSH,ATL,2022 REG,7,7,6,3,10,13,1,0,4,-4,1,1,1,0,0,0,0,0,0,0.4913668392989033,0.5086331607010968
86705,0.5918367346938775,0.45248868778280543,-145,121,0.5656033213913509,0.43439667860864906,away,CWS,over,7,0.5145631067961165,-106,0.4913668392989033,SF,CWS,2022 REG,8,3,8,5,8,16,0,1,-2,2,1,1,1,0,0,0,0,0,0,0.4913668392989033,0.5086331607010968
86705,0.5918367346938775,0.45248868778280543,-145,121,0.5656033213913509,0.43439667860864906,home,SF,under,7,0.5305164319248826,-113,0.5086331607010968,SF,CWS,2022 REG,8,3,8,5,8,16,0,1,-2,2,1,1,1,0,0,0,0,0,0,0.4913668392989033,0.5086331607010968
86706,0.5983935742971888,0.4424778761061947,-149,126,0.5739363610035978,0.4260636389964022,away,PIT,over,8,0.5121951219512195,-105,0.48919479393107135,ARI,PIT,2022 REG,7,4,11,6,10,18,0,1,-2,2,1,1,1,1,0,0,0,0,0,0.48919479393107135,0.5108052060689287
86706,0.5983935742971888,0.4424778761061947,-149,126,0.5739363610035978,0.4260636389964022,home,ARI,under,8,0.5327102803738317,-114,0.5108052060689287,ARI,PIT,2022 REG,7,4,11,6,10,18,0,1,-2,2,1,1,1,1,0,0,0,0,0,0.48919479393107135,0.5108052060689287
86707,0.5815899581589958,0.4566210045662101,-139,119,0.5593668459464284,0.4406331540535716,away,KC,over,7,0.5,100,0.4772727272727273,CLE,KC,2022 REG,9,6,4,3,9,13,1,0,3,-3,1,1,1,0,0,0,0,0,0,0.4772727272727273,0.5227272727272727
86707,0.5815899581589958,0.4566210045662101,-139,119,0.5593668459464284,0.4406331540535716,home,CLE,under,7,0.5454545454545454,-120,0.5227272727272727,CLE,KC,2022 REG,9,6,4,3,9,13,1,0,3,-3,1,1,1,0,0,0,0,0,0,0.4772727272727273,0.5227272727272727
86708,0.6323529411764706,0.40485829959514175,-172,147,0.6088223036297157,0.3911776963702843,away,MIA,over,9.5,0.504950495049505,-102,0.4826715732667395,PHI,MIA,2022 REG,8,3,7,1,4,15,1,0,2,-2,1,0,0,0,0,0,0,0,0,0.4826715732667395,0.5173284267332605
86708,0.6323529411764706,0.40485829959514175,-172,147,0.6088223036297157,0.3911776963702843,home,PHI,under,9.5,0.5391705069124424,-117,0.5173284267332605,PHI,MIA,2022 REG,8,3,7,1,4,15,1,0,2,-2,1,0,0,0,0,0,0,0,0,0.4826715732667395,0.5173284267332605
86709,0.6376811594202898,0.4,-176,150,0.6136525939928585,0.38634740600714146,away,SF,over,7.5,0.5098039215686274,-104,0.48592421718142587,SD,SF,2022 REG,11,7,9,4,11,20,1,0,3,-3,1,1,1,1,0,0,0,0,0,0.48592421718142587,0.5140757828185741
86709,0.6376811594202898,0.4,-176,150,0.6136525939928585,0.38634740600714146,home,SD,under,7.5,0.5370370370370371,-116,0.5140757828185741,SD,SF,2022 REG,11,7,9,4,11,20,1,0,3,-3,1,1,1,1,0,0,0,0,0,0.48592421718142587,0.5140757828185741
86710,0.7142857142857143,0.3205128205128205,-250,212,0.6894296180010466,0.31057038199895337,away,COL,over,8,0.5145631067961165,-106,0.4913668392989033,SF,COL,2022 REG,5,3,8,5,8,13,0,1,-2,2,1,1,1,0,0,0,0,0,0,0.4913668392989033,0.5086331607010968
86710,0.7142857142857143,0.3205128205128205,-250,212,0.6894296180010466,0.31057038199895337,home,SF,under,8,0.5305164319248826,-113,0.5086331607010968,SF,COL,2022 REG,5,3,8,5,8,13,0,1,-2,2,1,1,1,0,0,0,0,0,0,0.4913668392989033,0.5086331607010968
86711,0.7701149425287357,0.27027027027027023,-335,270,0.7390136866950185,0.26098631330498145,away,PIT,over,8,0.5348837209302326,-115,0.5097020142727117,LAD,PIT,2022 REG,10,5,9,6,11,19,0,1,-1,1,1,1,1,1,1,0,0,0,0,0.5097020142727117,0.49029798572728833
86711,0.7701149425287357,0.27027027027027023,-335,270,0.7390136866950185,0.26098631330498145,home,LAD,under,8,0.5121951219512195,-105,0.49029798572728833,LAD,PIT,2022 REG,10,5,9,6,11,19,0,1,-1,1,1,1,1,1,1,0,0,0,0,0.5097020142727117,0.49029798572728833
86712,0.5454545454545454,0.49751243781094534,-120,101,0.5220180091279142,0.4779819908720858,away,BAL,over,7.5,0.5327102803738317,-114,0.508788710910954,DET,BAL,2022 REG,7,3,4,0,3,11,1,0,3,-3,0,0,0,0,0,0,0,0,0,0.508788710910954,0.491211289089046
86712,0.5454545454545454,0.49751243781094534,-120,101,0.5220180091279142,0.4779819908720858,home,DET,under,7.5,0.5121951219512195,-105,0.491211289089046,DET,BAL,2022 REG,7,3,4,0,3,11,1,0,3,-3,0,0,0,0,0,0,0,0,0,0.508788710910954,0.491211289089046
86713,0.607843137254902,0.4347826086956522,-155,130,0.5819333701084867,0.41806662989151333,away,SEA,over,9,0.5260663507109005,-111,0.5022370601254724,BOS,SEA,2022 REG,11,6,12,5,11,23,1,0,1,-1,1,1,1,1,1,0,0,0,0,0.5022370601254724,0.4977629398745276
86713,0.607843137254902,0.4347826086956522,-155,130,0.5819333701084867,0.41806662989151333,home,BOS,under,9,0.5192307692307692,-108,0.4977629398745276,BOS,SEA,2022 REG,11,6,12,5,11,23,1,0,1,-1,1,1,1,1,1,0,0,0,0,0.5022370601254724,0.4977629398745276
86714,0.4444444444444444,0.5918367346938775,125,-145,0.42831947593852354,0.5716805240614764,away,CWS,over,7,0.5,100,0.4772727272727273,CHC,CWS,2022 REG,5,3,9,4,7,14,0,1,-1,1,1,1,1,0,0,0,0,0,0,0.4772727272727273,0.5227272727272727
86714,0.4444444444444444,0.5918367346938775,125,-145,0.42831947593852354,0.5716805240614764,home,CHC,under,7,0.5454545454545454,-120,0.5227272727272727,CHC,CWS,2022 REG,5,3,9,4,7,14,0,1,-1,1,1,1,1,0,0,0,0,0,0,0.4772727272727273,0.5227272727272727
86715,0.6515679442508712,0.3921568627450981,-187,155,0.6230782616437414,0.37692173835625864,away,MIA,over,7.5,0.5,100,0.4772727272727273,MIL,MIA,2022 REG,7,3,4,4,7,11,0,1,-1,1,1,1,1,0,0,0,0,0,0,0.4772727272727273,0.5227272727272727
86715,0.6515679442508712,0.3921568627450981,-187,155,0.6230782616437414,0.37692173835625864,home,MIL,under,7.5,0.5454545454545454,-120,0.5227272727272727,MIL,MIA,2022 REG,7,3,4,4,7,11,0,1,-1,1,1,1,1,0,0,0,0,0,0,0.4772727272727273,0.5227272727272727
86716,0.5305164319248826,0.5121951219512195,-113,-105,0.5078572507605655,0.49214274923943446,away,CHC,over,8.5,0.5454545454545454,-120,0.5206611570247933,CIN,CHC,2022 REG,7,2,10,4,6,17,0,1,-2,2,1,1,0,0,0,0,0,0,0,0.5206611570247933,0.4793388429752067
86716,0.5305164319248826,0.5121951219512195,-113,-105,0.5078572507605655,0.49214274923943446,home,CIN,under,8.5,0.5,100,0.4793388429752067,CIN,CHC,2022 REG,7,2,10,4,6,17,0,1,-2,2,1,1,0,0,0,0,0,0,0,0.5206611570247933,0.4793388429752067
86717,0.46511627906976744,0.5726495726495727,115,-134,0.4475507666421673,0.5524492333578327,away,TEX,over,8,0.5121951219512195,-105,0.48808156828023186,OAK,TEX,2022 REG,6,3,7,1,4,13,1,0,2,-2,1,0,0,0,0,0,0,0,0,0.48808156828023186,0.5119184317197681
86717,0.46511627906976744,0.5726495726495727,115,-134,0.4475507666421673,0.5524492333578327,home,OAK,under,8,0.5348837209302326,-115,0.5119184317197681,OAK,TEX,2022 REG,6,3,7,1,4,13,1,0,2,-2,1,0,0,0,0,0,0,0,0,0.48808156828023186,0.5119184317197681
86718,0.6825396825396826,0.35714285714285715,-215,180,0.6554547745023935,0.34454522549760647,away,CHC,over,7.5,0.5,100,0.4772727272727273,STL,CHC,2022 REG,9,8,10,4,12,19,1,0,4,-4,1,1,1,1,0,0,0,0,0,0.4772727272727273,0.5227272727272727
86718,0.6825396825396826,0.35714285714285715,-215,180,0.6554547745023935,0.34454522549760647,home,STL,under,7.5,0.5454545454545454,-120,0.5227272727272727,STL,CHC,2022 REG,9,8,10,4,12,19,1,0,4,-4,1,1,1,1,0,0,0,0,0,0.4772727272727273,0.5227272727272727
86719,0.425531914893617,0.6124031007751938,135,-158,0.4093893550345486,0.5906106449654513,away,SF,over,8,0.5348837209302326,-115,0.5097020142727117,DET,SF,2022 REG,7,6,8,1,7,15,1,0,5,-5,1,0,0,0,0,0,0,0,0,0.5097020142727117,0.49029798572728833
86719,0.425531914893617,0.6124031007751938,135,-158,0.4093893550345486,0.5906106449654513,home,DET,under,8,0.5121951219512195,-105,0.49029798572728833,DET,SF,2022 REG,7,6,8,1,7,15,1,0,5,-5,1,0,0,0,0,0,0,0,0,0.5097020142727117,0.49029798572728833
86720,0.5726495726495727,0.4672897196261683,-134,114,0.5497783539959433,0.4502216460040567,away,KC,over,8.5,0.5121951219512195,-105,0.48808156828023186,TEX,KC,2022 REG,6,3,5,1,4,11,1,0,2,-2,1,0,0,0,0,0,0,0,0,0.48808156828023186,0.5119184317197681
86720,0.5726495726495727,0.4672897196261683,-134,114,0.5497783539959433,0.4502216460040567,home,TEX,under,8.5,0.5348837209302326,-115,0.5119184317197681,TEX,KC,2022 REG,6,3,5,1,4,11,1,0,2,-2,1,0,0,0,0,0,0,0,0,0.48808156828023186,0.5119184317197681
86721,0.6774193548387096,0.36496350364963503,-210,174,0.6487083861853148,0.3512916138146852,away,BAL,over,8,0.5215311004784688,-109,0.49907282342437215,STL,BAL,2022 REG,11,10,5,1,11,16,1,0,9,-9,1,0,0,0,0,0,0,0,0,0.49907282342437215,0.5009271765756278
86721,0.6774193548387096,0.36496350364963503,-210,174,0.6487083861853148,0.3512916138146852,home,STL,under,8,0.5215311004784688,-109,0.5009271765756278,STL,BAL,2022 REG,11,10,5,1,11,16,1,0,9,-9,1,0,0,0,0,0,0,0,0,0.49907282342437215,0.5009271765756278
86722,0.6742671009771988,0.36363636363636365,-207,175,0.6487100417752203,0.3512899582247797,away,KC,over,8.5,0.5169082125603864,-107,0.49353874091423283,CWS,KC,2022 REG,9,4,6,2,6,15,1,0,2,-2,1,1,0,0,0,0,0,0,0,0.49353874091423283,0.5064612590857671
86722,0.6742671009771988,0.36363636363636365,-207,175,0.6487100417752203,0.3512899582247797,home,CWS,under,8.5,0.5283018867924528,-112,0.5064612590857671,CWS,KC,2022 REG,9,4,6,2,6,15,1,0,2,-2,1,1,0,0,0,0,0,0,0,0.49353874091423283,0.5064612590857671
86723,0.6336996336996338,0.40485829959514175,-173,147,0.6092654854945195,0.39073451450548047,away,WSH,over,9.5,0.5024875621890548,-101,0.47839724939301687,ATL,WSH,2022 REG,19,16,9,4,20,28,1,0,12,-12,1,1,1,1,0,0,0,0,0,0.47839724939301687,0.5216027506069831
86723,0.6336996336996338,0.40485829959514175,-173,147,0.6092654854945195,0.39073451450548047,home,ATL,under,9.5,0.5454545454545454,-120,0.5216027506069831,ATL,WSH,2022 REG,19,16,9,4,20,28,1,0,12,-12,1,1,1,1,0,0,0,0,0,0.47839724939301687,0.5216027506069831
86725,0.35714285714285715,0.6774193548387096,180,-210,0.3447992100065833,0.6552007899934167,away,TOR,over,8,0.5192307692307692,-108,0.49571111079951763,PIT,TOR,2022 REG,5,3,9,4,7,14,0,1,-1,1,1,1,1,0,0,0,0,0,0,0.49571111079951763,0.5042888892004824
86725,0.35714285714285715,0.6774193548387096,180,-210,0.3447992100065833,0.6552007899934167,home,PIT,under,8,0.5260663507109005,-111,0.5042888892004824,PIT,TOR,2022 REG,5,3,9,4,7,14,0,1,-1,1,1,1,1,0,0,0,0,0,0,0.49571111079951763,0.5042888892004824
86726,0.5594713656387665,0.47846889952153115,-127,109,0.5382448736768379,0.46175512632316207,away,CHC,over,11.5,0.5073891625615764,-103,0.4837652908580103,COL,CHC,2022 REG,10,2,10,5,7,20,0,1,-3,3,1,1,0,0,0,0,0,0,0,0.4837652908580103,0.5162347091419897
86726,0.5594713656387665,0.47846889952153115,-127,109,0.5382448736768379,0.46175512632316207,home,COL,under,11.5,0.5391705069124424,-117,0.5162347091419897,COL,CHC,2022 REG,10,2,10,5,7,20,0,1,-3,3,1,1,0,0,0,0,0,0,0,0.4837652908580103,0.5162347091419897
86727,0.607843137254902,0.4347826086956522,-155,130,0.5819333701084867,0.41806662989151333,away,BAL,over,9,0.5098039215686274,-104,0.48592421718142587,MIN,BAL,2022 REG,4,1,7,3,4,11,0,1,-2,2,1,0,0,0,0,0,0,0,0,0.48592421718142587,0.5140757828185741
86727,0.607843137254902,0.4347826086956522,-155,130,0.5819333701084867,0.41806662989151333,home,MIN,under,9,0.5370370370370371,-116,0.5140757828185741,MIN,BAL,2022 REG,4,1,7,3,4,11,0,1,-2,2,1,0,0,0,0,0,0,0,0,0.48592421718142587,0.5140757828185741
86728,0.5348837209302326,0.5098039215686274,-115,-104,0.5109810284308424,0.48901897156915763,away,MIA,over,8,0.5348837209302326,-115,0.5109810284308424,WSH,MIA,2022 REG,8,2,10,3,5,18,0,1,-1,1,1,1,0,0,0,0,0,0,0,0.5109810284308424,0.48901897156915763
86728,0.5348837209302326,0.5098039215686274,-115,-104,0.5109810284308424,0.48901897156915763,home,WSH,under,8,0.5098039215686274,-104,0.48901897156915763,WSH,MIA,2022 REG,8,2,10,3,5,18,0,1,-1,1,1,1,0,0,0,0,0,0,0,0.5109810284308424,0.48901897156915763
86729,0.4166666666666667,0.6226415094339623,140,-165,0.4002882599580712,0.5997117400419287,away,SF,over,9,0.5495495495495495,-122,0.5250401592387142,ARI,SF,2022 REG,9,6,6,2,8,15,1,0,4,-4,1,1,0,0,0,0,0,0,0,0.5250401592387142,0.47495984076128583
86729,0.4166666666666667,0.6226415094339623,140,-165,0.4002882599580712,0.5997117400419287,home,ARI,under,9,0.49504950495049505,102,0.47495984076128583,ARI,SF,2022 REG,9,6,6,2,8,15,1,0,4,-4,1,1,0,0,0,0,0,0,0,0.5250401592387142,0.47495984076128583
86730,0.5238095238095238,0.5327102803738317,-110,-114,0.49420391209443276,0.5057960879055672,away,TEX,over,7.5,0.5370370370370371,-116,0.5105975442470474,LAA,TEX,2022 REG,4,2,10,7,9,14,0,1,-5,5,1,1,0,0,0,0,0,0,0,0.5105975442470474,0.4894024557529526
86730,0.5238095238095238,0.5327102803738317,-110,-114,0.49420391209443276,0.5057960879055672,home,LAA,under,7.5,0.5121951219512195,-105,0.4894024557529526,LAA,TEX,2022 REG,4,2,10,7,9,14,0,1,-5,5,1,1,0,0,0,0,0,0,0,0.5105975442470474,0.4894024557529526
86731,0.4464285714285714,0.5918367346938775,124,-145,0.42934584548104954,0.5706541545189505,away,NYY,over,9,0.5238095238095238,-110,0.4988662131519274,BOS,NYY,2022 REG,8,2,6,3,5,14,0,1,-1,1,1,1,0,0,0,0,0,0,0,0.4988662131519274,0.5011337868480725
86731,0.4464285714285714,0.5918367346938775,124,-145,0.42934584548104954,0.5706541545189505,home,BOS,under,9,0.5238095238095238,-110,0.5011337868480725,BOS,NYY,2022 REG,8,2,6,3,5,14,0,1,-1,1,1,1,0,0,0,0,0,0,0,0.4988662131519274,0.5011337868480725
86732,0.41493775933609955,0.6240601503759399,141,-166,0.3987560540613944,0.6012439459386056,away,LAA,over,7.5,0.5238095238095238,-110,0.4988662131519274,DET,LAA,2022 REG,11,4,7,3,7,18,1,0,1,-1,1,1,1,0,0,0,0,0,0,0.4988662131519274,0.5011337868480725
86732,0.41493775933609955,0.6240601503759399,141,-166,0.3987560540613944,0.6012439459386056,home,DET,under,7.5,0.5238095238095238,-110,0.5011337868480725,DET,LAA,2022 REG,11,4,7,3,7,18,1,0,1,-1,1,1,1,0,0,0,0,0,0,0.4988662131519274,0.5011337868480725
86733,0.5348837209302326,0.5098039215686274,-115,-104,0.5109810284308424,0.48901897156915763,away,PHI,over,8.5,0.5412844036697247,-118,0.5149381613977361,MIL,PHI,2022 REG,7,2,9,3,5,16,0,1,-1,1,1,1,0,0,0,0,0,0,0,0.5149381613977361,0.48506183860226393
86733,0.5348837209302326,0.5098039215686274,-115,-104,0.5109810284308424,0.48901897156915763,home,MIL,under,8.5,0.5073891625615764,-103,0.48506183860226393,MIL,PHI,2022 REG,7,2,9,3,5,16,0,1,-1,1,1,1,0,0,0,0,0,0,0,0.5149381613977361,0.48506183860226393
86734,0.40485829959514175,0.6376811594202898,147,-176,0.3876358465524569,0.612364153447543,away,PHI,over,9,0.5454545454545454,-120,0.5206611570247933,CIN,PHI,2022 REG,9,4,18,11,15,27,0,1,-7,7,1,1,1,1,0,0,0,0,0,0.5206611570247933,0.4793388429752067
86734,0.40485829959514175,0.6376811594202898,147,-176,0.3876358465524569,0.612364153447543,home,CIN,under,9,0.5,100,0.4793388429752067,CIN,PHI,2022 REG,9,4,18,11,15,27,0,1,-7,7,1,1,1,1,0,0,0,0,0,0.5206611570247933,0.4793388429752067
86735,0.5145631067961165,0.5238095238095238,-106,-110,0.4948179667757384,0.5051820332242616,away,CWS,over,7.5,0.5121951219512195,-105,0.48808156828023186,MIN,CWS,2022 REG,5,2,6,1,3,11,1,0,1,-1,1,0,0,0,0,0,0,0,0,0.48808156828023186,0.5119184317197681
86735,0.5145631067961165,0.5238095238095238,-106,-110,0.4948179667757384,0.5051820332242616,home,MIN,under,7.5,0.5348837209302326,-115,0.5119184317197681,MIN,CWS,2022 REG,5,2,6,1,3,11,1,0,1,-1,1,0,0,0,0,0,0,0,0,0.48808156828023186,0.5119184317197681
86736,0.7118155619596541,0.32573289902280134,-247,207,0.6850879831047074,0.3149120168952926,away,CIN,over,8.5,0.5348837209302326,-115,0.5097020142727117,PHI,CIN,2022 REG,8,4,3,1,5,11,1,0,3,-3,1,0,0,0,0,0,0,0,0,0.5097020142727117,0.49029798572728833
86736,0.7118155619596541,0.32573289902280134,-247,207,0.6850879831047074,0.3149120168952926,home,PHI,under,8.5,0.5121951219512195,-105,0.49029798572728833,PHI,CIN,2022 REG,8,4,3,1,5,11,1,0,3,-3,1,0,0,0,0,0,0,0,0,0.5097020142727117,0.49029798572728833
86737,0.6000000000000001,0.4366812227074236,-150,129,0.5779912663755458,0.42200873362445424,away,DET,over,7.5,0.5238095238095238,-110,0.4988662131519274,MIN,DET,2022 REG,5,5,8,4,9,13,1,0,1,-1,1,1,1,1,0,0,0,0,0,0.4988662131519274,0.5011337868480725
86737,0.6000000000000001,0.4366812227074236,-150,129,0.5779912663755458,0.42200873362445424,home,MIN,under,7.5,0.5238095238095238,-110,0.5011337868480725,MIN,DET,2022 REG,5,5,8,4,9,13,1,0,1,-1,1,1,1,1,0,0,0,0,0,0.4988662131519274,0.5011337868480725
86738,0.5515695067264574,0.48780487804878053,-123,105,0.5298517967383217,0.4701482032616783,away,TOR,over,8,0.5391705069124424,-117,0.5140669063204599,TB,TOR,2022 REG,6,1,7,5,6,13,0,1,-4,4,1,0,0,0,0,0,0,0,0,0.5140669063204599,0.4859330936795401
86738,0.5515695067264574,0.48780487804878053,-123,105,0.5298517967383217,0.4701482032616783,home,TB,under,8,0.5073891625615764,-103,0.4859330936795401,TB,TOR,2022 REG,6,1,7,5,6,13,0,1,-4,4,1,0,0,0,0,0,0,0,0,0.5140669063204599,0.4859330936795401
86739,0.6666666666666666,0.37453183520599254,-200,167,0.6392009987515606,0.36079900124843944,away,BAL,over,8.5,0.5412844036697247,-118,0.5189377998484975,TB,BAL,2022 REG,11,8,6,0,8,17,1,0,8,-8,0,0,0,0,0,0,0,0,0,0.5189377998484975,0.4810622001515025
86739,0.6666666666666666,0.37453183520599254,-200,167,0.6392009987515606,0.36079900124843944,home,TB,under,8.5,0.5,100,0.4810622001515025,TB,BAL,2022 REG,11,8,6,0,8,17,1,0,8,-8,0,0,0,0,0,0,0,0,0,0.5189377998484975,0.4810622001515025
86740,0.6363636363636364,0.4,-175,150,0.6132231404958678,0.3867768595041322,away,TEX,over,8.5,0.5454545454545454,-120,0.5206611570247933,MIN,TEX,2022 REG,6,3,11,4,7,17,0,1,-1,1,1,1,1,0,0,0,0,0,0,0.5206611570247933,0.4793388429752067
86740,0.6363636363636364,0.4,-175,150,0.6132231404958678,0.3867768595041322,home,MIN,under,8.5,0.5,100,0.4793388429752067,MIN,TEX,2022 REG,6,3,11,4,7,17,0,1,-1,1,1,1,1,0,0,0,0,0,0,0.5206611570247933,0.4793388429752067
86741,0.646643109540636,0.3921568627450981,-183,155,0.6215533748116984,0.37844662518830163,away,PHI,over,8,0.5348837209302326,-115,0.5097020142727117,LAD,PHI,2022 REG,5,3,10,8,11,15,0,1,-5,5,1,1,1,0,0,0,0,0,0,0.5097020142727117,0.49029798572728833
86741,0.646643109540636,0.3921568627450981,-183,155,0.6215533748116984,0.37844662518830163,home,LAD,under,8,0.5121951219512195,-105,0.49029798572728833,LAD,PHI,2022 REG,5,3,10,8,11,15,0,1,-5,5,1,1,1,0,0,0,0,0,0,0.5097020142727117,0.49029798572728833
86742,0.49504950495049505,0.5433789954337899,102,-119,0.47602549485926493,0.5239745051407351,away,BOS,over,8,0.5283018867924528,-112,0.5044173060022736,DET,BOS,2022 REG,11,7,12,9,16,23,0,1,-2,2,1,1,1,1,1,1,1,0,0,0.5044173060022736,0.49558269399772636
86742,0.49504950495049505,0.5433789954337899,102,-119,0.47602549485926493,0.5239745051407351,home,DET,under,8,0.5169082125603864,-107,0.49558269399772636,DET,BOS,2022 REG,11,7,12,9,16,23,0,1,-2,2,1,1,1,1,1,1,1,0,0,0.5044173060022736,0.49558269399772636
86743,0.37735849056603776,0.6632996632996633,165,-197,0.36201579099407505,0.6379842090059249,away,LAD,over,8.5,0.5454545454545454,-120,0.5206611570247933,ARI,LAD,2022 REG,3,0,9,4,4,12,0,1,-4,4,0,0,0,0,0,0,0,0,0,0.5206611570247933,0.4793388429752067
86743,0.37735849056603776,0.6632996632996633,165,-197,0.36201579099407505,0.6379842090059249,home,ARI,under,8.5,0.5,100,0.4793388429752067,ARI,LAD,2022 REG,3,0,9,4,4,12,0,1,-4,4,0,0,0,0,0,0,0,0,0,0.5206611570247933,0.4793388429752067
86744,0.5454545454545454,0.49751243781094534,-120,101,0.5220180091279142,0.4779819908720858,away,PHI,over,7.5,0.5283018867924528,-112,0.5044173060022736,SD,PHI,2022 REG,4,2,7,4,6,11,0,1,-2,2,1,1,0,0,0,0,0,0,0,0.5044173060022736,0.49558269399772636
86744,0.5454545454545454,0.49751243781094534,-120,101,0.5220180091279142,0.4779819908720858,home,SD,under,7.5,0.5169082125603864,-107,0.49558269399772636,SD,PHI,2022 REG,4,2,7,4,6,11,0,1,-2,2,1,1,0,0,0,0,0,0,0,0.5044173060022736,0.49558269399772636
86745,0.4,0.6402877697841727,150,-178,0.383884892086331,0.6161151079136691,away,LAD,over,8.5,0.5073891625615764,-103,0.4837652908580103,CWS,LAD,2022 REG,4,1,6,4,5,10,0,1,-3,3,1,0,0,0,0,0,0,0,0,0.4837652908580103,0.5162347091419897
86745,0.4,0.6402877697841727,150,-178,0.383884892086331,0.6161151079136691,home,CWS,under,8.5,0.5391705069124424,-117,0.5162347091419897,CWS,LAD,2022 REG,4,1,6,4,5,10,0,1,-3,3,1,0,0,0,0,0,0,0,0,0.4837652908580103,0.5162347091419897
86746,0.5967741935483871,0.4444444444444444,-148,125,0.5721759741010521,0.42782402589894786,away,SD,over,6.5,0.5454545454545454,-120,0.5206611570247933,MIL,SD,2022 REG,1,0,13,7,7,14,0,1,-7,7,0,0,0,0,0,0,0,0,0,0.5206611570247933,0.4793388429752067
86746,0.5967741935483871,0.4444444444444444,-148,125,0.5721759741010521,0.42782402589894786,home,MIL,under,6.5,0.5,100,0.4793388429752067,MIL,SD,2022 REG,1,0,13,7,7,14,0,1,-7,7,0,0,0,0,0,0,0,0,0,0.5206611570247933,0.4793388429752067
86747,0.5967741935483871,0.4464285714285714,-148,124,0.5709918983202021,0.42900810167979786,away,ARI,over,10.5,0.5238095238095238,-110,0.4988662131519274,CIN,ARI,2022 REG,16,14,10,8,22,26,1,0,6,-6,1,1,1,1,1,1,1,1,0,0.4988662131519274,0.5011337868480725
86747,0.5967741935483871,0.4464285714285714,-148,124,0.5709918983202021,0.42900810167979786,home,CIN,under,10.5,0.5238095238095238,-110,0.5011337868480725,CIN,ARI,2022 REG,16,14,10,8,22,26,1,0,6,-6,1,1,1,1,1,1,1,1,0,0.4988662131519274,0.5011337868480725
86748,0.6226415094339623,0.4166666666666667,-165,140,0.5981666073335706,0.40183339266642937,away,CLE,over,8.5,0.5145631067961165,-106,0.4925063625223866,CWS,CLE,2022 REG,7,2,15,8,10,22,0,1,-6,6,1,1,0,0,0,0,0,0,0,0.4925063625223866,0.5074936374776133
86748,0.6226415094339623,0.4166666666666667,-165,140,0.5981666073335706,0.40183339266642937,home,CWS,under,8.5,0.5283018867924528,-112,0.5074936374776133,CWS,CLE,2022 REG,7,2,15,8,10,22,0,1,-6,6,1,1,0,0,0,0,0,0,0,0.4925063625223866,0.5074936374776133
86749,0.5454545454545454,0.48780487804878053,-120,105,0.5273130417254586,0.47268695827454144,away,MIN,over,7,0.5121951219512195,-105,0.48808156828023186,CLE,MIN,2022 REG,14,11,10,4,15,24,1,0,7,-7,1,1,1,1,0,0,0,0,0,0.48808156828023186,0.5119184317197681
86749,0.5454545454545454,0.48780487804878053,-120,105,0.5273130417254586,0.47268695827454144,home,CLE,under,7,0.5348837209302326,-115,0.5119184317197681,CLE,MIN,2022 REG,14,11,10,4,15,24,1,0,7,-7,1,1,1,1,0,0,0,0,0,0.48808156828023186,0.5119184317197681
86750,0.42016806722689076,0.613899613899614,138,-159,0.4058539154930652,0.5941460845069348,away,NYY,over,8.5,0.5327102803738317,-114,0.5075272610403079,BOS,NYY,2022 REG,6,6,8,7,13,14,0,1,-1,1,1,1,1,1,1,1,0,0,0,0.5075272610403079,0.4924727389596921
86750,0.42016806722689076,0.613899613899614,138,-159,0.4058539154930652,0.5941460845069348,home,BOS,under,8.5,0.5145631067961165,-106,0.4924727389596921,BOS,NYY,2022 REG,6,6,8,7,13,14,0,1,-1,1,1,1,1,1,1,1,0,0,0,0.5075272610403079,0.4924727389596921
86751,0.7058823529411764,0.3367003367003367,-240,197,0.6758239837824612,0.3241760162175388,away,LAA,over,7.5,0.5370370370370371,-116,0.5118817074154765,HOU,LAA,2022 REG,10,4,4,2,6,14,1,0,2,-2,1,1,0,0,0,0,0,0,0,0.5118817074154765,0.48811829258452355
86751,0.7058823529411764,0.3367003367003367,-240,197,0.6758239837824612,0.3241760162175388,home,HOU,under,7.5,0.5098039215686274,-104,0.48811829258452355,HOU,LAA,2022 REG,10,4,4,2,6,14,1,0,2,-2,1,1,0,0,0,0,0,0,0,0.5118817074154765,0.48811829258452355
86752,0.3389830508474576,0.7014925373134329,195,-235,0.3252625124878337,0.6747374875121663,away,LAD,over,9,0.5121951219512195,-105,0.48808156828023186,KC,LAD,2022 REG,8,4,3,0,4,11,1,0,4,-4,0,0,0,0,0,0,0,0,0,0.48808156828023186,0.5119184317197681
86752,0.3389830508474576,0.7014925373134329,195,-235,0.3252625124878337,0.6747374875121663,home,KC,under,9,0.5348837209302326,-115,0.5119184317197681,KC,LAD,2022 REG,8,4,3,0,4,11,1,0,4,-4,0,0,0,0,0,0,0,0,0,0.48808156828023186,0.5119184317197681
86753,0.6551724137931035,0.390625,-190,156,0.6251672116527942,0.3748327883472058,away,BAL,over,7.5,0.5,100,0.4772727272727273,CLE,BAL,2022 REG,2,0,7,3,3,9,0,1,-3,3,0,0,0,0,0,0,0,0,0,0.4772727272727273,0.5227272727272727
86753,0.6551724137931035,0.390625,-190,156,0.6251672116527942,0.3748327883472058,home,CLE,under,7.5,0.5454545454545454,-120,0.5227272727272727,CLE,BAL,2022 REG,2,0,7,3,3,9,0,1,-3,3,0,0,0,0,0,0,0,0,0,0.4772727272727273,0.5227272727272727
86754,0.3623188405797102,0.6794871794871794,176,-212,0.34717173185982264,0.6528282681401774,away,HOU,over,8.5,0.5073891625615764,-103,0.4826927225525911,CLE,HOU,2022 REG,8,3,14,9,12,22,0,1,-6,6,1,1,1,0,0,0,0,0,0,0.4826927225525911,0.5173072774474089
86754,0.3623188405797102,0.6794871794871794,176,-212,0.34717173185982264,0.6528282681401774,home,CLE,under,8.5,0.5412844036697247,-118,0.5173072774474089,CLE,HOU,2022 REG,8,3,14,9,12,22,0,1,-6,6,1,1,1,0,0,0,0,0,0,0.4826927225525911,0.5173072774474089
86755,0.5901639344262295,0.4484304932735426,-144,123,0.5673868951280033,0.43261310487199667,away,NYY,over,8,0.5169082125603864,-107,0.49353874091423283,CWS,NYY,2022 REG,8,7,15,15,22,23,0,1,-8,8,1,1,1,1,1,1,1,0,0,0.49353874091423283,0.5064612590857671
86755,0.5901639344262295,0.4484304932735426,-144,123,0.5673868951280033,0.43261310487199667,home,CWS,under,8,0.5283018867924528,-112,0.5064612590857671,CWS,NYY,2022 REG,8,7,15,15,22,23,0,1,-8,8,1,1,1,1,1,1,1,0,0,0.49353874091423283,0.5064612590857671
86756,0.3846153846153846,0.6527777777777778,160,-188,0.37023339907955294,0.629766600920447,away,SF,over,8.5,0.5238095238095238,-110,0.4988662131519274,ARI,SF,2022 REG,5,7,7,3,10,12,1,0,4,-4,1,1,1,0,0,0,0,0,0,0.4988662131519274,0.5011337868480725
86756,0.3846153846153846,0.6527777777777778,160,-188,0.37023339907955294,0.629766600920447,home,ARI,under,8.5,0.5238095238095238,-110,0.5011337868480725,ARI,SF,2022 REG,5,7,7,3,10,12,1,0,4,-4,1,1,1,0,0,0,0,0,0,0.4988662131519274,0.5011337868480725
86757,0.3968253968253968,0.6415770609318996,152,-179,0.3815863262867871,0.6184136737132129,away,MIL,over,7.5,0.5145631067961165,-106,0.4913668392989033,PIT,MIL,2022 REG,1,1,4,3,4,5,0,1,-2,2,1,0,0,0,0,0,0,0,0,0.4913668392989033,0.5086331607010968
86757,0.3968253968253968,0.6415770609318996,152,-179,0.3815863262867871,0.6184136737132129,home,PIT,under,7.5,0.5305164319248826,-113,0.5086331607010968,PIT,MIL,2022 REG,1,1,4,3,4,5,0,1,-2,2,1,0,0,0,0,0,0,0,0,0.4913668392989033,0.5086331607010968
86758,0.6453900709219857,0.3968253968253968,-182,152,0.6181446271984977,0.3818553728015023,away,KC,over,7.5,0.5,100,0.4772727272727273,TB,KC,2022 REG,9,3,4,2,5,13,1,0,1,-1,1,1,0,0,0,0,0,0,0,0.4772727272727273,0.5227272727272727
86758,0.6453900709219857,0.3968253968253968,-182,152,0.6181446271984977,0.3818553728015023,home,TB,under,7.5,0.5454545454545454,-120,0.5227272727272727,TB,KC,2022 REG,9,3,4,2,5,13,1,0,1,-1,1,1,0,0,0,0,0,0,0,0.4772727272727273,0.5227272727272727
86759,0.5,0.5433789954337899,100,-119,0.4783105022831051,0.5216894977168949,away,CIN,over,8,0.5121951219512195,-105,0.48919479393107135,PIT,CIN,2022 REG,5,3,4,1,4,9,1,0,2,-2,1,0,0,0,0,0,0,0,0,0.48919479393107135,0.5108052060689287
86759,0.5,0.5433789954337899,100,-119,0.4783105022831051,0.5216894977168949,home,PIT,under,8,0.5327102803738317,-114,0.5108052060689287,PIT,CIN,2022 REG,5,3,4,1,4,9,1,0,2,-2,1,0,0,0,0,0,0,0,0,0.48919479393107135,0.5108052060689287
86760,0.5535714285714286,0.49019607843137253,-124,104,0.5293429871948779,0.47065701280512207,away,PHI,over,9,0.5,100,0.4762443438914027,STL,PHI,2022 REG,2,0,5,1,1,7,0,1,-1,1,0,0,0,0,0,0,0,0,0,0.4762443438914027,0.5237556561085973
86760,0.5535714285714286,0.49019607843137253,-124,104,0.5293429871948779,0.47065701280512207,home,STL,under,9,0.5475113122171946,-121,0.5237556561085973,STL,PHI,2022 REG,2,0,5,1,1,7,0,1,-1,1,0,0,0,0,0,0,0,0,0,0.4762443438914027,0.5237556561085973
86761,0.5515695067264574,0.49019607843137253,-123,104,0.5285328835228112,0.47146711647718875,away,CLE,over,7,0.5,100,0.4772727272727273,TB,CLE,2022 REG,6,1,8,4,5,14,0,1,-3,3,1,0,0,0,0,0,0,0,0,0.4772727272727273,0.5227272727272727
86761,0.5515695067264574,0.49019607843137253,-123,104,0.5285328835228112,0.47146711647718875,home,TB,under,7,0.5454545454545454,-120,0.5227272727272727,TB,CLE,2022 REG,6,1,8,4,5,14,0,1,-3,3,1,0,0,0,0,0,0,0,0,0.4772727272727273,0.5227272727272727
86762,0.4504504504504505,0.5918367346938775,122,-145,0.43140216885390636,0.5685978311460936,away,NYM,over,8,0.5192307692307692,-108,0.49571111079951763,CHC,NYM,2022 REG,7,3,9,2,5,16,1,0,1,-1,1,1,0,0,0,0,0,0,0,0.49571111079951763,0.5042888892004824
86762,0.4504504504504505,0.5918367346938775,122,-145,0.43140216885390636,0.5685978311460936,home,CHC,under,8,0.5260663507109005,-111,0.5042888892004824,CHC,NYM,2022 REG,7,3,9,2,5,16,1,0,1,-1,1,1,0,0,0,0,0,0,0,0.49571111079951763,0.5042888892004824
86763,0.5348837209302326,0.5121951219512195,-115,-105,0.5097020142727117,0.49029798572728833,away,MIN,over,8.5,0.5238095238095238,-110,0.4988662131519274,CLE,MIN,2022 REG,5,3,6,2,5,11,1,0,1,-1,1,1,0,0,0,0,0,0,0,0.4988662131519274,0.5011337868480725
86763,0.5348837209302326,0.5121951219512195,-115,-105,0.5097020142727117,0.49029798572728833,home,CLE,under,8.5,0.5238095238095238,-110,0.5011337868480725,CLE,MIN,2022 REG,5,3,6,2,5,11,1,0,1,-1,1,1,0,0,0,0,0,0,0,0.4988662131519274,0.5011337868480725
86764,0.49504950495049505,0.5454545454545454,102,-120,0.47499799484898986,0.5250020051510101,away,CHC,over,9,0.5169082125603864,-107,0.49586088023391106,CIN,CHC,2022 REG,5,4,8,7,11,13,0,1,-3,3,1,1,1,1,0,0,0,0,0,0.49586088023391106,0.5041391197660889
86764,0.49504950495049505,0.5454545454545454,102,-120,0.47499799484898986,0.5250020051510101,home,CIN,under,9,0.5238095238095238,-110,0.5041391197660889,CIN,CHC,2022 REG,5,4,8,7,11,13,0,1,-3,3,1,1,1,1,0,0,0,0,0,0.49586088023391106,0.5041391197660889
86765,0.5412844036697247,0.5024875621890548,-118,-101,0.5175913212324037,0.4824086787675963,away,STL,over,8.5,0.5327102803738317,-114,0.508788710910954,MIL,STL,2022 REG,5,1,8,2,3,13,0,1,-1,1,1,0,0,0,0,0,0,0,0,0.508788710910954,0.491211289089046
86765,0.5412844036697247,0.5024875621890548,-118,-101,0.5175913212324037,0.4824086787675963,home,MIL,under,8.5,0.5121951219512195,-105,0.491211289089046,MIL,STL,2022 REG,5,1,8,2,3,13,0,1,-1,1,1,0,0,0,0,0,0,0,0,0.508788710910954,0.491211289089046
86766,0.726027397260274,0.3125,-265,220,0.6980554513041847,0.30194454869581533,away,BAL,over,8,0.5391705069124424,-117,0.5153817639191344,NYY,BAL,2022 REG,8,5,5,2,7,13,1,0,3,-3,1,1,0,0,0,0,0,0,0,0.5153817639191344,0.4846182360808656
86766,0.726027397260274,0.3125,-265,220,0.6980554513041847,0.30194454869581533,home,NYY,under,8,0.504950495049505,-102,0.4846182360808656,NYY,BAL,2022 REG,8,5,5,2,7,13,1,0,3,-3,1,1,0,0,0,0,0,0,0,0.5153817639191344,0.4846182360808656
86767,0.7032640949554896,0.3389830508474576,-237,195,0.6735531941979274,0.32644680580207264,away,SEA,over,8,0.504950495049505,-102,0.48160416005266615,TOR,SEA,2022 REG,7,1,10,5,6,17,0,1,-4,4,1,0,0,0,0,0,0,0,0,0.48160416005266615,0.5183958399473338
86767,0.7032640949554896,0.3389830508474576,-237,195,0.6735531941979274,0.32644680580207264,home,TOR,under,8,0.5412844036697247,-118,0.5183958399473338,TOR,SEA,2022 REG,7,1,10,5,6,17,0,1,-4,4,1,0,0,0,0,0,0,0,0,0.48160416005266615,0.5183958399473338
86768,0.7014925373134329,0.3412969283276451,-235,193,0.6714760464905872,0.32852395350941277,away,WSH,over,9,0.5238095238095238,-110,0.5012646084074657,PHI,WSH,2022 REG,7,5,11,4,9,18,1,0,1,-1,1,1,1,1,0,0,0,0,0,0.5012646084074657,0.4987353915925343
86768,0.7014925373134329,0.3412969283276451,-235,193,0.6714760464905872,0.32852395350941277,home,PHI,under,9,0.5192307692307692,-108,0.4987353915925343,PHI,WSH,2022 REG,7,5,11,4,9,18,1,0,1,-1,1,1,1,1,0,0,0,0,0,0.5012646084074657,0.4987353915925343
86769,0.4484304932735426,0.5884773662551441,123,-143,0.43187988361942303,0.5681201163805769,away,HOU,over,8.5,0.5412844036697247,-118,0.5162581740877563,LAA,HOU,2022 REG,7,2,7,4,6,14,0,1,-2,2,1,1,0,0,0,0,0,0,0,0.5162581740877563,0.4837418259122437
86769,0.4484304932735426,0.5884773662551441,123,-143,0.43187988361942303,0.5681201163805769,home,LAA,under,8.5,0.504950495049505,-102,0.4837418259122437,LAA,HOU,2022 REG,7,2,7,4,6,14,0,1,-2,2,1,1,0,0,0,0,0,0,0,0.5162581740877563,0.4837418259122437
86770,0.48780487804878053,0.5475113122171946,105,-121,0.470577468162939,0.529422531837061,away,BOS,over,9.5,0.5145631067961165,-106,0.4925063625223866,DET,BOS,2022 REG,8,3,4,1,4,12,1,0,2,-2,1,0,0,0,0,0,0,0,0,0.4925063625223866,0.5074936374776133
86770,0.48780487804878053,0.5475113122171946,105,-121,0.470577468162939,0.529422531837061,home,DET,under,9.5,0.5283018867924528,-112,0.5074936374776133,DET,BOS,2022 REG,8,3,4,1,4,12,1,0,2,-2,1,0,0,0,0,0,0,0,0,0.4925063625223866,0.5074936374776133
86771,0.4484304932735426,0.5934959349593496,123,-146,0.429629404379869,0.570370595620131,away,ATL,over,7,0.5495495495495495,-122,0.5236866555946829,MIA,ATL,2022 REG,12,3,8,4,7,20,0,1,-1,1,1,1,1,0,0,0,0,0,0,0.5236866555946829,0.47631334440531714
86771,0.4484304932735426,0.5934959349593496,123,-146,0.429629404379869,0.570370595620131,home,MIA,under,7,0.49751243781094534,101,0.47631334440531714,MIA,ATL,2022 REG,12,3,8,4,7,20,0,1,-1,1,1,1,1,0,0,0,0,0,0,0.5236866555946829,0.47631334440531714
86772,0.7630331753554502,0.27624309392265195,-322,262,0.7330640788920643,0.26693592110793574,away,WSH,over,8.5,0.5348837209302326,-115,0.5097020142727117,PHI,WSH,2022 REG,13,13,7,1,14,20,1,0,12,-12,1,0,0,0,0,0,0,0,0,0.5097020142727117,0.49029798572728833
86772,0.7630331753554502,0.27624309392265195,-322,262,0.7330640788920643,0.26693592110793574,home,PHI,under,8.5,0.5121951219512195,-105,0.49029798572728833,PHI,WSH,2022 REG,13,13,7,1,14,20,1,0,12,-12,1,0,0,0,0,0,0,0,0,0.5097020142727117,0.49029798572728833
86773,0.4444444444444444,0.5934959349593496,125,-146,0.42758205359831375,0.5724179464016863,away,NYM,over,8,0.5121951219512195,-105,0.48808156828023186,MIA,NYM,2022 REG,6,3,11,5,8,17,0,1,-2,2,1,1,1,0,0,0,0,0,0,0.48808156828023186,0.5119184317197681
86773,0.4444444444444444,0.5934959349593496,125,-146,0.42758205359831375,0.5724179464016863,home,MIA,under,8,0.5348837209302326,-115,0.5119184317197681,MIA,NYM,2022 REG,6,3,11,5,8,17,0,1,-2,2,1,1,1,0,0,0,0,0,0,0.48808156828023186,0.5119184317197681
86774,0.5555555555555556,0.4854368932038835,-125,106,0.5327819729114227,0.4672180270885773,away,MIA,over,7.5,0.5145631067961165,-106,0.4925063625223866,PHI,MIA,2022 REG,10,3,6,2,5,16,1,0,1,-1,1,1,0,0,0,0,0,0,0,0.4925063625223866,0.5074936374776133
86774,0.5555555555555556,0.4854368932038835,-125,106,0.5327819729114227,0.4672180270885773,home,PHI,under,7.5,0.5283018867924528,-112,0.5074936374776133,PHI,MIA,2022 REG,10,3,6,2,5,16,1,0,1,-1,1,1,0,0,0,0,0,0,0,0.4925063625223866,0.5074936374776133
86775,0.5495495495495495,0.49019607843137253,-122,104,0.5277073575960698,0.4722926424039302,away,KC,over,7,0.5327102803738317,-114,0.508788710910954,BAL,KC,2022 REG,8,4,7,2,6,15,1,0,2,-2,1,1,0,0,0,0,0,0,0,0.508788710910954,0.491211289089046
86775,0.5495495495495495,0.49019607843137253,-122,104,0.5277073575960698,0.4722926424039302,home,BAL,under,7,0.5121951219512195,-105,0.491211289089046,BAL,KC,2022 REG,8,4,7,2,6,15,1,0,2,-2,1,1,0,0,0,0,0,0,0,0.508788710910954,0.491211289089046
86776,0.42194092827004215,0.6168582375478928,137,-161,0.4055699722287194,0.5944300277712806,away,SEA,over,8.5,0.5348837209302326,-115,0.5097020142727117,DET,SEA,2022 REG,8,3,8,5,8,16,0,1,-2,2,1,1,1,0,0,0,0,0,0,0.5097020142727117,0.49029798572728833
86776,0.42194092827004215,0.6168582375478928,137,-161,0.4055699722287194,0.5944300277712806,home,DET,under,8.5,0.5121951219512195,-105,0.49029798572728833,DET,SEA,2022 REG,8,3,8,5,8,16,0,1,-2,2,1,1,1,0,0,0,0,0,0,0.5097020142727117,0.49029798572728833
86777,0.39840637450199207,0.6376811594202898,151,-176,0.3840288709472981,0.6159711290527019,away,LAD,over,7.5,0.5238095238095238,-110,0.4988662131519274,CHC,LAD,2022 REG,6,2,3,6,8,9,0,1,-4,4,1,1,0,0,0,0,0,0,0,0.4988662131519274,0.5011337868480725
86777,0.39840637450199207,0.6376811594202898,151,-176,0.3840288709472981,0.6159711290527019,home,CHC,under,7.5,0.5238095238095238,-110,0.5011337868480725,CHC,LAD,2022 REG,6,2,3,6,8,9,0,1,-4,4,1,1,0,0,0,0,0,0,0,0.4988662131519274,0.5011337868480725
86778,0.4,0.6402877697841727,150,-178,0.383884892086331,0.6161151079136691,away,SEA,over,8,0.5454545454545454,-120,0.5179608869977906,KC,SEA,2022 REG,9,5,11,6,11,20,0,1,-1,1,1,1,1,1,1,0,0,0,0,0.5179608869977906,0.48203911300220936
86778,0.4,0.6402877697841727,150,-178,0.383884892086331,0.6161151079136691,home,KC,under,8,0.504950495049505,-102,0.48203911300220936,KC,SEA,2022 REG,9,5,11,6,11,20,0,1,-1,1,1,1,1,1,1,0,0,0,0,0.5179608869977906,0.48203911300220936
86779,0.5495495495495495,0.49019607843137253,-122,104,0.5277073575960698,0.4722926424039302,away,MIA,over,6.5,0.5454545454545454,-120,0.5206611570247933,SD,MIA,2022 REG,5,3,6,2,5,11,1,0,1,-1,1,1,0,0,0,0,0,0,0,0.5206611570247933,0.4793388429752067
86779,0.5495495495495495,0.49019607843137253,-122,104,0.5277073575960698,0.4722926424039302,home,SD,under,6.5,0.5,100,0.4793388429752067,SD,MIA,2022 REG,5,3,6,2,5,11,1,0,1,-1,1,1,0,0,0,0,0,0,0,0.5206611570247933,0.4793388429752067
86780,0.6363636363636364,0.4081632653061224,-175,145,0.6080283353010626,0.3919716646989374,away,WSH,over,9.5,0.5073891625615764,-103,0.4837652908580103,NYM,WSH,2022 REG,17,10,7,0,10,24,1,0,10,-10,0,0,0,0,0,0,0,0,0,0.4837652908580103,0.5162347091419897
86780,0.6363636363636364,0.4081632653061224,-175,145,0.6080283353010626,0.3919716646989374,home,NYM,under,9.5,0.5391705069124424,-117,0.5162347091419897,NYM,WSH,2022 REG,17,10,7,0,10,24,1,0,10,-10,0,0,0,0,0,0,0,0,0,0.4837652908580103,0.5162347091419897
86781,0.646643109540636,0.3921568627450981,-183,155,0.6215533748116984,0.37844662518830163,away,OAK,over,8,0.5121951219512195,-105,0.48808156828023186,LAA,OAK,2022 REG,6,2,8,4,6,14,0,1,-2,2,1,1,0,0,0,0,0,0,0,0.48808156828023186,0.5119184317197681
86781,0.646643109540636,0.3921568627450981,-183,155,0.6215533748116984,0.37844662518830163,home,LAA,under,8,0.5348837209302326,-115,0.5119184317197681,LAA,OAK,2022 REG,6,2,8,4,6,14,0,1,-2,2,1,1,0,0,0,0,0,0,0,0.48808156828023186,0.5119184317197681
86782,0.45454545454545453,0.5850622406639003,120,-141,0.4365419567230205,0.5634580432769796,away,TB,over,7.5,0.5,100,0.47522522522522526,BOS,TB,2022 REG,9,4,5,3,7,14,1,0,1,-1,1,1,1,0,0,0,0,0,0,0.47522522522522526,0.5247747747747747
86782,0.45454545454545453,0.5850622406639003,120,-141,0.4365419567230205,0.5634580432769796,home,BOS,under,7.5,0.5495495495495495,-122,0.5247747747747747,BOS,TB,2022 REG,9,4,5,3,7,14,1,0,1,-1,1,1,1,0,0,0,0,0,0,0.47522522522522526,0.5247747747747747
86783,0.8,0.23255813953488372,-400,330,0.7739534883720931,0.2260465116279069,away,COL,over,8,0.5348837209302326,-115,0.5097020142727117,ATL,COL,2022 REG,5,3,2,0,3,7,1,0,3,-3,0,0,0,0,0,0,0,0,0,0.5097020142727117,0.49029798572728833
86783,0.8,0.23255813953488372,-400,330,0.7739534883720931,0.2260465116279069,home,ATL,under,8,0.5121951219512195,-105,0.49029798572728833,ATL,COL,2022 REG,5,3,2,0,3,7,1,0,3,-3,0,0,0,0,0,0,0,0,0,0.5097020142727117,0.49029798572728833
86785,0.5,0.5391705069124424,100,-117,0.4804147465437788,0.5195852534562212,away,BAL,over,9.5,0.5215311004784688,-109,0.49670754937970685,KC,BAL,2022 REG,10,4,10,6,10,20,0,1,-2,2,1,1,1,1,0,0,0,0,0,0.49670754937970685,0.5032924506202932
86785,0.5,0.5391705069124424,100,-117,0.4804147465437788,0.5195852534562212,home,KC,under,9.5,0.5260663507109005,-111,0.5032924506202932,KC,BAL,2022 REG,10,4,10,6,10,20,0,1,-2,2,1,1,1,1,0,0,0,0,0,0.49670754937970685,0.5032924506202932
86786,0.6254681647940076,0.4132231404958678,-167,142,0.6012679850808645,0.39873201491913546,away,NYM,over,8.5,0.5348837209302326,-115,0.5097020142727117,LAD,NYM,2022 REG,9,2,3,0,2,12,1,0,2,-2,0,0,0,0,0,0,0,0,0,0.5097020142727117,0.49029798572728833
86786,0.6254681647940076,0.4132231404958678,-167,142,0.6012679850808645,0.39873201491913546,home,LAD,under,8.5,0.5121951219512195,-105,0.49029798572728833,LAD,NYM,2022 REG,9,2,3,0,2,12,1,0,2,-2,0,0,0,0,0,0,0,0,0,0.5097020142727117,0.49029798572728833
86787,0.5145631067961165,0.5283018867924528,-106,-112,0.4925063625223866,0.5074936374776133,away,LAA,over,8.5,0.5454545454545454,-120,0.5206611570247933,SEA,LAA,2022 REG,5,0,7,3,3,12,0,1,-3,3,0,0,0,0,0,0,0,0,0,0.5206611570247933,0.4793388429752067
86787,0.5145631067961165,0.5283018867924528,-106,-112,0.4925063625223866,0.5074936374776133,home,SEA,under,8.5,0.5,100,0.4793388429752067,SEA,LAA,2022 REG,5,0,7,3,3,12,0,1,-3,3,0,0,0,0,0,0,0,0,0,0.5206611570247933,0.4793388429752067
86788,0.46511627906976744,0.5689655172413793,115,-132,0.4492642807855131,0.5507357192144868,away,NYM,over,9,0.49504950495049505,102,0.47499799484898986,MIL,NYM,2022 REG,7,6,4,0,6,11,1,0,6,-6,0,0,0,0,0,0,0,0,0,0.47499799484898986,0.5250020051510101
86788,0.46511627906976744,0.5689655172413793,115,-132,0.4492642807855131,0.5507357192144868,home,MIL,under,9,0.5454545454545454,-120,0.5250020051510101,MIL,NYM,2022 REG,7,6,4,0,6,11,1,0,6,-6,0,0,0,0,0,0,0,0,0,0.47499799484898986,0.5250020051510101
86789,0.5515695067264574,0.49019607843137253,-123,104,0.5285328835228112,0.47146711647718875,away,MIA,over,8.5,0.5145631067961165,-106,0.4925063625223866,ATL,MIA,2022 REG,5,1,8,4,5,13,0,1,-3,3,1,0,0,0,0,0,0,0,0,0.4925063625223866,0.5074936374776133
86789,0.5515695067264574,0.49019607843137253,-123,104,0.5285328835228112,0.47146711647718875,home,ATL,under,8.5,0.5283018867924528,-112,0.5074936374776133,ATL,MIA,2022 REG,5,1,8,4,5,13,0,1,-3,3,1,0,0,0,0,0,0,0,0,0.4925063625223866,0.5074936374776133
86790,0.6845425867507886,0.35714285714285715,-217,180,0.6560071251579774,0.34399287484202257,away,CIN,over,7.5,0.5121951219512195,-105,0.48919479393107135,SF,CIN,2022 REG,6,2,6,4,6,12,0,1,-2,2,1,1,0,0,0,0,0,0,0,0.48919479393107135,0.5108052060689287
86790,0.6845425867507886,0.35714285714285715,-217,180,0.6560071251579774,0.34399287484202257,home,SF,under,7.5,0.5327102803738317,-114,0.5108052060689287,SF,CIN,2022 REG,6,2,6,4,6,12,0,1,-2,2,1,1,0,0,0,0,0,0,0,0.48919479393107135,0.5108052060689287
86791,0.7811816192560176,0.25839793281653745,-357,287,0.7502628006785512,0.24973719932144878,away,COL,over,8.5,0.5098039215686274,-104,0.48375889301574193,LAD,COL,2022 REG,6,1,9,2,3,15,0,1,-1,1,1,0,0,0,0,0,0,0,0,0.48375889301574193,0.5162411069842581
86791,0.7811816192560176,0.25839793281653745,-357,287,0.7502628006785512,0.24973719932144878,home,LAD,under,8.5,0.5412844036697247,-118,0.5162411069842581,LAD,COL,2022 REG,6,1,9,2,3,15,0,1,-1,1,1,0,0,0,0,0,0,0,0,0.48375889301574193,0.5162411069842581
86792,0.4739336492890995,0.5726495726495727,111,-134,0.4518562929200606,0.5481437070799394,away,LAA,over,7,0.5238095238095238,-110,0.5012646084074657,OAK,LAA,2022 REG,5,1,9,4,5,14,0,1,-3,3,1,0,0,0,0,0,0,0,0,0.5012646084074657,0.4987353915925343
86792,0.4739336492890995,0.5726495726495727,111,-134,0.4518562929200606,0.5481437070799394,home,OAK,under,7,0.5192307692307692,-108,0.4987353915925343,OAK,LAA,2022 REG,5,1,9,4,5,14,0,1,-3,3,1,0,0,0,0,0,0,0,0,0.5012646084074657,0.4987353915925343
86793,0.5348837209302326,0.5098039215686274,-115,-104,0.5109810284308424,0.48901897156915763,away,CWS,over,8.5,0.5348837209302326,-115,0.5097020142727117,DET,CWS,2022 REG,4,0,22,13,13,26,0,1,-13,13,0,0,0,0,0,0,0,0,0,0.5097020142727117,0.49029798572728833
86793,0.5348837209302326,0.5098039215686274,-115,-104,0.5109810284308424,0.48901897156915763,home,DET,under,8.5,0.5121951219512195,-105,0.49029798572728833,DET,CWS,2022 REG,4,0,22,13,13,26,0,1,-13,13,0,0,0,0,0,0,0,0,0,0.5097020142727117,0.49029798572728833
86794,0.32573289902280134,0.7142857142857143,207,-250,0.31269752009494606,0.687302479905054,away,SEA,over,7,0.5454545454545454,-120,0.5206611570247933,OAK,SEA,2022 REG,9,5,11,9,14,20,0,1,-4,4,1,1,1,1,1,0,0,0,0,0.5206611570247933,0.4793388429752067
86794,0.32573289902280134,0.7142857142857143,207,-250,0.31269752009494606,0.687302479905054,home,OAK,under,7,0.5,100,0.4793388429752067,OAK,SEA,2022 REG,9,5,11,9,14,20,0,1,-4,4,1,1,1,1,1,0,0,0,0,0.5206611570247933,0.4793388429752067
86795,0.6774193548387096,0.35714285714285715,-210,180,0.6540062434963579,0.34599375650364206,away,BAL,over,8.5,0.5121951219512195,-105,0.48808156828023186,STL,BAL,2022 REG,6,2,8,3,5,14,0,1,-1,1,1,1,0,0,0,0,0,0,0,0.48808156828023186,0.5119184317197681
86795,0.6774193548387096,0.35714285714285715,-210,180,0.6540062434963579,0.34599375650364206,home,STL,under,8.5,0.5348837209302326,-115,0.5119184317197681,STL,BAL,2022 REG,6,2,8,3,5,14,0,1,-1,1,1,1,0,0,0,0,0,0,0,0.48808156828023186,0.5119184317197681
86796,0.425531914893617,0.6168582375478928,135,-161,0.407493552152549,0.592506447847451,away,MIL,over,7,0.5305164319248826,-113,0.5066009958897986,MIA,MIL,2022 REG,5,3,9,7,10,14,0,1,-4,4,1,1,1,0,0,0,0,0,0,0.5066009958897986,0.49339900411020143
86796,0.425531914893617,0.6168582375478928,135,-161,0.407493552152549,0.592506447847451,home,MIA,under,7,0.5145631067961165,-106,0.49339900411020143,MIA,MIL,2022 REG,5,3,9,7,10,14,0,1,-4,4,1,1,1,0,0,0,0,0,0,0.5066009958897986,0.49339900411020143
86797,0.6610169491525424,0.3802281368821293,-195,163,0.6337532482143695,0.3662467517856305,away,ARI,over,7.5,0.5,100,0.4772727272727273,SD,ARI,2022 REG,8,5,6,3,8,14,1,0,2,-2,1,1,1,0,0,0,0,0,0,0.4772727272727273,0.5227272727272727
86797,0.6610169491525424,0.3802281368821293,-195,163,0.6337532482143695,0.3662467517856305,home,SD,under,7.5,0.5454545454545454,-120,0.5227272727272727,SD,ARI,2022 REG,8,5,6,3,8,14,1,0,2,-2,1,1,1,0,0,0,0,0,0,0.4772727272727273,0.5227272727272727
86798,0.425531914893617,0.613899613899614,135,-159,0.40875254093905067,0.5912474590609493,away,NYY,over,7,0.5454545454545454,-120,0.5206611570247933,TB,NYY,2022 REG,10,4,7,5,9,17,0,1,-1,1,1,1,1,1,0,0,0,0,0,0.5206611570247933,0.4793388429752067
86798,0.425531914893617,0.613899613899614,135,-159,0.40875254093905067,0.5912474590609493,home,TB,under,7,0.5,100,0.4793388429752067,TB,NYY,2022 REG,10,4,7,5,9,17,0,1,-1,1,1,1,1,1,0,0,0,0,0,0.5206611570247933,0.4793388429752067
86799,0.4184100418410042,0.6153846153846154,139,-160,0.4042700178972303,0.5957299821027697,away,HOU,over,9,0.49751243781094534,101,0.476135829221149,TEX,HOU,2022 REG,5,2,9,9,11,14,0,1,-7,7,1,1,0,0,0,0,0,0,0,0.476135829221149,0.523864170778851
86799,0.4184100418410042,0.6153846153846154,139,-160,0.4042700178972303,0.5957299821027697,home,TEX,under,9,0.5454545454545454,-120,0.523864170778851,TEX,HOU,2022 REG,5,2,9,9,11,14,0,1,-7,7,1,1,0,0,0,0,0,0,0,0.476135829221149,0.523864170778851
86800,0.5901639344262295,0.4484304932735426,-144,123,0.5673868951280033,0.43261310487199667,away,NYM,over,9,0.5,100,0.4772727272727273,HOU,NYM,2022 REG,10,8,8,2,10,18,1,0,6,-6,1,1,0,0,0,0,0,0,0,0.4772727272727273,0.5227272727272727
86800,0.5901639344262295,0.4484304932735426,-144,123,0.5673868951280033,0.43261310487199667,home,HOU,under,9,0.5454545454545454,-120,0.5227272727272727,HOU,NYM,2022 REG,10,8,8,2,10,18,1,0,6,-6,1,1,0,0,0,0,0,0,0,0.4772727272727273,0.5227272727272727
86801,0.4081632653061224,0.6323529411764706,145,-172,0.39162603817037017,0.6083739618296298,away,NYY,over,8.5,0.5238095238095238,-110,0.4988662131519274,DET,NYY,2022 REG,7,3,7,0,3,14,1,0,3,-3,0,0,0,0,0,0,0,0,0,0.4988662131519274,0.5011337868480725
86801,0.4081632653061224,0.6323529411764706,145,-172,0.39162603817037017,0.6083739618296298,home,DET,under,8.5,0.5238095238095238,-110,0.5011337868480725,DET,NYY,2022 REG,7,3,7,0,3,14,1,0,3,-3,0,0,0,0,0,0,0,0,0,0.4988662131519274,0.5011337868480725
86802,0.6632996632996633,0.37593984962406013,-197,166,0.6372721075893149,0.36272789241068515,away,STL,over,7,0.5215311004784688,-109,0.4978845547971712,NYM,STL,2022 REG,11,11,10,4,15,21,1,0,7,-7,1,1,1,1,0,0,0,0,0,0.4978845547971712,0.5021154452028288
86802,0.6632996632996633,0.37593984962406013,-197,166,0.6372721075893149,0.36272789241068515,home,NYM,under,7,0.5238095238095238,-110,0.5021154452028288,NYM,STL,2022 REG,11,11,10,4,15,21,1,0,7,-7,1,1,1,1,0,0,0,0,0,0.4978845547971712,0.5021154452028288
86803,0.6742671009771988,0.36363636363636365,-207,175,0.6487100417752203,0.3512899582247797,away,OAK,over,8,0.5348837209302326,-115,0.5097020142727117,LAA,OAK,2022 REG,12,4,9,3,7,21,1,0,1,-1,1,1,1,0,0,0,0,0,0,0.5097020142727117,0.49029798572728833
86803,0.6742671009771988,0.36363636363636365,-207,175,0.6487100417752203,0.3512899582247797,home,LAA,under,8,0.5121951219512195,-105,0.49029798572728833,LAA,OAK,2022 REG,12,4,9,3,7,21,1,0,1,-1,1,1,1,0,0,0,0,0,0,0.5097020142727117,0.49029798572728833
86804,0.5475113122171946,0.49504950495049505,-121,102,0.5242087833606768,0.4757912166393232,away,COL,over,9,0.5145631067961165,-106,0.4913668392989033,WSH,COL,2022 REG,9,6,10,5,11,19,1,0,1,-1,1,1,1,1,1,0,0,0,0,0.4913668392989033,0.5086331607010968
86804,0.5475113122171946,0.49504950495049505,-121,102,0.5242087833606768,0.4757912166393232,home,WSH,under,9,0.5305164319248826,-113,0.5086331607010968,WSH,COL,2022 REG,9,6,10,5,11,19,1,0,1,-1,1,1,1,1,1,0,0,0,0,0.4913668392989033,0.5086331607010968
86805,0.6610169491525424,0.37037037037037035,-195,170,0.6402693989594307,0.3597306010405693,away,BAL,over,7.5,0.49504950495049505,102,0.47499799484898986,OAK,BAL,2022 REG,5,5,7,1,6,12,1,0,4,-4,1,0,0,0,0,0,0,0,0,0.47499799484898986,0.5250020051510101
86805,0.6610169491525424,0.37037037037037035,-195,170,0.6402693989594307,0.3597306010405693,home,OAK,under,7.5,0.5454545454545454,-120,0.5250020051510101,OAK,BAL,2022 REG,5,5,7,1,6,12,1,0,4,-4,1,0,0,0,0,0,0,0,0,0.47499799484898986,0.5250020051510101
86806,0.5454545454545454,0.5,-120,100,0.5206611570247933,0.4793388429752067,away,DET,over,8.5,0.5454545454545454,-120,0.5206611570247933,KC,DET,2022 REG,9,5,11,7,12,20,0,1,-2,2,1,1,1,1,1,0,0,0,0,0.5206611570247933,0.4793388429752067
86806,0.5454545454545454,0.5,-120,100,0.5206611570247933,0.4793388429752067,away,DET,over,11.5,0.3968253968253968,152,0.3707541392814177,KC,DET,2022 REG,9,5,11,7,12,20,0,1,-2,2,1,1,1,1,1,0,0,0,0,0.5206611570247933,0.4793388429752067
86806,0.5454545454545454,0.5,-120,100,0.5206611570247933,0.4793388429752067,home,KC,under,8.5,0.5,100,0.4793388429752067,KC,DET,2022 REG,9,5,11,7,12,20,0,1,-2,2,1,1,1,1,1,0,0,0,0,0.5206611570247933,0.4793388429752067
86806,0.5454545454545454,0.5,-120,100,0.5206611570247933,0.4793388429752067,home,KC,under,11.5,0.6688741721854304,-202,0.6292458607185822,KC,DET,2022 REG,9,5,11,7,12,20,0,1,-2,2,1,1,1,1,1,0,0,0,0,0.5206611570247933,0.4793388429752067
86807,0.5433789954337899,0.49751243781094534,-119,101,0.5211594495154178,0.4788405504845822,away,ARI,over,10,0.5238095238095238,-110,0.4988662131519274,CIN,ARI,2022 REG,12,7,1,0,7,13,1,0,7,-7,0,0,0,0,0,0,0,0,0,0.4988662131519274,0.5011337868480725
86807,0.5433789954337899,0.49751243781094534,-119,101,0.5211594495154178,0.4788405504845822,home,CIN,under,10,0.5238095238095238,-110,0.5011337868480725,CIN,ARI,2022 REG,12,7,1,0,7,13,1,0,7,-7,0,0,0,0,0,0,0,0,0,0.4988662131519274,0.5011337868480725
86808,0.4629629629629629,0.576271186440678,116,-136,0.4447990049057217,0.5552009950942782,away,MIN,over,9,0.5391705069124424,-117,0.5140669063204599,ARI,MIN,2022 REG,11,7,10,2,9,21,1,0,5,-5,1,1,0,0,0,0,0,0,0,0.5140669063204599,0.4859330936795401
86808,0.4629629629629629,0.576271186440678,116,-136,0.4447990049057217,0.5552009950942782,home,ARI,under,9,0.5073891625615764,-103,0.4859330936795401,ARI,MIN,2022 REG,11,7,10,2,9,21,1,0,5,-5,1,1,0,0,0,0,0,0,0,0.5140669063204599,0.4859330936795401
86809,0.4444444444444444,0.5951417004048584,125,-147,0.4268506022891988,0.5731493977108012,away,SD,over,10.5,0.5391705069124424,-117,0.5153817639191344,COL,SD,2022 REG,7,5,10,3,8,17,1,0,2,-2,1,1,1,0,0,0,0,0,0,0.5153817639191344,0.4846182360808656
86809,0.4444444444444444,0.5951417004048584,125,-147,0.4268506022891988,0.5731493977108012,away,SD,over,11.5,0.5215311004784688,-109,0.49907282342437215,COL,SD,2022 REG,7,5,10,3,8,17,1,0,2,-2,1,1,1,0,0,0,0,0,0,0.5153817639191344,0.4846182360808656
86809,0.4444444444444444,0.5951417004048584,125,-147,0.4268506022891988,0.5731493977108012,home,COL,under,10.5,0.504950495049505,-102,0.4846182360808656,COL,SD,2022 REG,7,5,10,3,8,17,1,0,2,-2,1,1,1,0,0,0,0,0,0,0.5153817639191344,0.4846182360808656
86809,0.4444444444444444,0.5951417004048584,125,-147,0.4268506022891988,0.5731493977108012,home,COL,under,11.5,0.5215311004784688,-109,0.5009271765756278,COL,SD,2022 REG,7,5,10,3,8,17,1,0,2,-2,1,1,1,0,0,0,0,0,0,0.5153817639191344,0.4846182360808656
86810,0.24390243902439027,0.7946611909650925,310,-387,0.23449667561232132,0.7655033243876787,away,NYM,over,7,0.5454545454545454,-120,0.5206611570247933,PIT,NYM,2022 REG,4,0,17,10,10,21,0,1,-10,10,0,0,0,0,0,0,0,0,0,0.5206611570247933,0.4793388429752067
86810,0.24390243902439027,0.7946611909650925,310,-387,0.23449667561232132,0.7655033243876787,home,PIT,under,7,0.5,100,0.4793388429752067,PIT,NYM,2022 REG,4,0,17,10,10,21,0,1,-10,10,0,0,0,0,0,0,0,0,0,0.5206611570247933,0.4793388429752067
86811,0.7340425531914894,0.30303030303030304,-276,230,0.706829499156344,0.29317050084365603,away,WSH,over,7.5,0.5327102803738317,-114,0.508788710910954,NYM,WSH,2022 REG,10,7,10,3,10,20,1,0,4,-4,1,1,1,0,0,0,0,0,0,0.508788710910954,0.491211289089046
86811,0.7340425531914894,0.30303030303030304,-276,230,0.706829499156344,0.29317050084365603,home,NYM,under,7.5,0.5121951219512195,-105,0.491211289089046,NYM,WSH,2022 REG,10,7,10,3,10,20,1,0,4,-4,1,1,1,0,0,0,0,0,0,0.508788710910954,0.491211289089046
86812,0.4484304932735426,0.5918367346938775,123,-145,0.43037344037335423,0.5696265596266458,away,HOU,over,6.5,0.5391705069124424,-117,0.5167097046779946,MIN,HOU,2022 REG,3,0,7,5,5,10,0,1,-5,5,0,0,0,0,0,0,0,0,0,0.5167097046779946,0.4832902953220054
86812,0.4484304932735426,0.5918367346938775,123,-145,0.43037344037335423,0.5696265596266458,home,MIN,under,6.5,0.5024875621890548,-101,0.4832902953220054,MIN,HOU,2022 REG,3,0,7,5,5,10,0,1,-5,5,0,0,0,0,0,0,0,0,0,0.5167097046779946,0.4832902953220054
86813,0.7014925373134329,0.3389830508474576,-235,195,0.6730992142751963,0.32690078572480374,away,CHC,over,8.5,0.5348837209302326,-115,0.5109810284308424,NYY,CHC,2022 REG,11,8,5,0,8,16,1,0,8,-8,0,0,0,0,0,0,0,0,0,0.5109810284308424,0.48901897156915763
86813,0.7014925373134329,0.3389830508474576,-235,195,0.6730992142751963,0.32690078572480374,home,NYY,under,8.5,0.5098039215686274,-104,0.48901897156915763,NYY,CHC,2022 REG,11,8,5,0,8,16,1,0,8,-8,0,0,0,0,0,0,0,0,0,0.5109810284308424,0.48901897156915763
86814,0.626865671641791,0.41152263374485604,-168,143,0.6028013608024003,0.3971986391975997,away,TEX,over,8.5,0.504950495049505,-102,0.4837488699364985,SEA,TEX,2022 REG,8,5,7,4,9,15,1,0,1,-1,1,1,1,1,0,0,0,0,0,0.4837488699364985,0.5162511300635015
86814,0.626865671641791,0.41152263374485604,-168,143,0.6028013608024003,0.3971986391975997,home,SEA,under,8.5,0.5370370370370371,-116,0.5162511300635015,SEA,TEX,2022 REG,8,5,7,4,9,15,1,0,1,-1,1,1,1,1,0,0,0,0,0,0.4837488699364985,0.5162511300635015
86815,0.7014925373134329,0.3389830508474576,-235,195,0.6730992142751963,0.32690078572480374,away,LAA,over,7,0.5412844036697247,-118,0.5189377998484975,TB,LAA,2022 REG,7,2,6,1,3,13,1,0,1,-1,1,0,0,0,0,0,0,0,0,0.5189377998484975,0.4810622001515025
86815,0.7014925373134329,0.3389830508474576,-235,195,0.6730992142751963,0.32690078572480374,home,TB,under,7,0.5,100,0.4810622001515025,TB,LAA,2022 REG,7,2,6,1,3,13,1,0,1,-1,1,0,0,0,0,0,0,0,0,0.5189377998484975,0.4810622001515025
86816,0.6000000000000001,0.43859649122807015,-150,128,0.5768421052631579,0.42315789473684207,away,BAL,over,8,0.5145631067961165,-106,0.4913668392989033,CHC,BAL,2022 REG,6,1,12,7,8,18,0,1,-6,6,1,0,0,0,0,0,0,0,0,0.4913668392989033,0.5086331607010968
86816,0.6000000000000001,0.43859649122807015,-150,128,0.5768421052631579,0.42315789473684207,home,CHC,under,8,0.5305164319248826,-113,0.5086331607010968,CHC,BAL,2022 REG,6,1,12,7,8,18,0,1,-6,6,1,0,0,0,0,0,0,0,0,0.4913668392989033,0.5086331607010968
86817,0.5780590717299579,0.4672897196261683,-137,114,0.55184479149456,0.44815520850544,away,BOS,over,7.5,0.5412844036697247,-118,0.5136310900085983,ATL,BOS,2022 REG,6,4,11,9,13,17,0,1,-5,5,1,1,1,1,0,0,0,0,0,0.5136310900085983,0.4863689099914017
86817,0.5780590717299579,0.4672897196261683,-137,114,0.55184479149456,0.44815520850544,home,ATL,under,7.5,0.5098039215686274,-104,0.4863689099914017,ATL,BOS,2022 REG,6,4,11,9,13,17,0,1,-5,5,1,1,1,1,0,0,0,0,0,0.5136310900085983,0.4863689099914017
86818,0.5983935742971888,0.4444444444444444,-149,125,0.5727595791465728,0.42724042085342717,away,MIA,over,8.5,0.5370370370370371,-116,0.5118817074154765,PHI,MIA,2022 REG,13,9,12,11,20,25,0,1,-2,2,1,1,1,1,1,1,1,1,1,0.5118817074154765,0.48811829258452355
86818,0.5983935742971888,0.4444444444444444,-149,125,0.5727595791465728,0.42724042085342717,home,PHI,under,8.5,0.5098039215686274,-104,0.48811829258452355,PHI,MIA,2022 REG,13,9,12,11,20,25,0,1,-2,2,1,1,1,1,1,1,1,1,1,0.5118817074154765,0.48811829258452355
86819,0.35714285714285715,0.6825396825396826,180,-215,0.34297052154195007,0.6570294784580499,away,MIL,over,8,0.5238095238095238,-110,0.4988662131519274,PIT,MIL,2022 REG,9,0,5,2,2,14,0,1,-2,2,0,0,0,0,0,0,0,0,0,0.4988662131519274,0.5011337868480725
86819,0.35714285714285715,0.6825396825396826,180,-215,0.34297052154195007,0.6570294784580499,home,PIT,under,8,0.5238095238095238,-110,0.5011337868480725,PIT,MIL,2022 REG,9,0,5,2,2,14,0,1,-2,2,0,0,0,0,0,0,0,0,0,0.4988662131519274,0.5011337868480725
86820,0.6845425867507886,0.35714285714285715,-217,180,0.6560071251579774,0.34399287484202257,away,CIN,over,6.5,0.5454545454545454,-120,0.5206611570247933,MIA,CIN,2022 REG,7,3,6,0,3,13,1,0,3,-3,0,0,0,0,0,0,0,0,0,0.5206611570247933,0.4793388429752067
86820,0.6845425867507886,0.35714285714285715,-217,180,0.6560071251579774,0.34399287484202257,home,MIA,under,6.5,0.5,100,0.4793388429752067,MIA,CIN,2022 REG,7,3,6,0,3,13,1,0,3,-3,0,0,0,0,0,0,0,0,0,0.5206611570247933,0.4793388429752067
86821,0.49751243781094534,0.5454545454545454,101,-120,0.476135829221149,0.523864170778851,away,NYM,over,6.5,0.5238095238095238,-110,0.5000596729920038,ATL,NYM,2022 REG,8,5,8,2,7,16,1,0,3,-3,1,1,0,0,0,0,0,0,0,0.5000596729920038,0.4999403270079962
86821,0.49751243781094534,0.5454545454545454,101,-120,0.476135829221149,0.523864170778851,home,ATL,under,6.5,0.5215311004784688,-109,0.4999403270079962,ATL,NYM,2022 REG,8,5,8,2,7,16,1,0,3,-3,1,1,0,0,0,0,0,0,0,0.5000596729920038,0.4999403270079962
86822,0.3597122302158273,0.6774193548387096,178,-210,0.3463555449444112,0.6536444550555889,away,LAD,over,8.5,0.5169082125603864,-107,0.49353874091423283,WSH,LAD,2022 REG,10,4,9,9,13,19,0,1,-5,5,1,1,1,1,0,0,0,0,0,0.49353874091423283,0.5064612590857671
86822,0.3597122302158273,0.6774193548387096,178,-210,0.3463555449444112,0.6536444550555889,home,WSH,under,8.5,0.5283018867924528,-112,0.5064612590857671,WSH,LAD,2022 REG,10,4,9,9,13,19,0,1,-5,5,1,1,1,1,0,0,0,0,0,0.49353874091423283,0.5064612590857671
86823,0.5652173913043479,0.47619047619047616,-130,110,0.5418129444594474,0.4581870555405526,away,TB,over,8,0.5348837209302326,-115,0.5109810284308424,TEX,TB,2022 REG,7,3,3,0,3,10,1,0,3,-3,0,0,0,0,0,0,0,0,0,0.5109810284308424,0.48901897156915763
86823,0.5652173913043479,0.47619047619047616,-130,110,0.5418129444594474,0.4581870555405526,home,TEX,under,8,0.5098039215686274,-104,0.48901897156915763,TEX,TB,2022 REG,7,3,3,0,3,10,1,0,3,-3,0,0,0,0,0,0,0,0,0,0.5109810284308424,0.48901897156915763
86824,0.5652173913043479,0.47619047619047616,-130,110,0.5418129444594474,0.4581870555405526,away,WSH,over,9.5,0.5,100,0.4772727272727273,BAL,WSH,2022 REG,4,0,6,3,3,10,0,1,-3,3,0,0,0,0,0,0,0,0,0,0.4772727272727273,0.5227272727272727
86824,0.5652173913043479,0.47619047619047616,-130,110,0.5418129444594474,0.4581870555405526,home,BAL,under,9.5,0.5454545454545454,-120,0.5227272727272727,BAL,WSH,2022 REG,4,0,6,3,3,10,0,1,-3,3,0,0,0,0,0,0,0,0,0,0.4772727272727273,0.5227272727272727
86825,0.6254681647940076,0.41152263374485604,-167,143,0.6023315979176397,0.3976684020823603,away,MIA,over,7.5,0.5121951219512195,-105,0.48919479393107135,PHI,MIA,2022 REG,8,4,10,3,7,18,1,0,1,-1,1,1,1,0,0,0,0,0,0,0.48919479393107135,0.5108052060689287
86825,0.6254681647940076,0.41152263374485604,-167,143,0.6023315979176397,0.3976684020823603,home,PHI,under,7.5,0.5327102803738317,-114,0.5108052060689287,PHI,MIA,2022 REG,8,4,10,3,7,18,1,0,1,-1,1,1,1,0,0,0,0,0,0,0.48919479393107135,0.5108052060689287
86826,0.4273504273504274,0.609375,134,-156,0.4116558002775952,0.5883441997224048,away,SD,over,8,0.5348837209302326,-115,0.5097020142727117,ARI,SD,2022 REG,4,1,8,6,7,12,0,1,-5,5,1,0,0,0,0,0,0,0,0,0.5097020142727117,0.49029798572728833
86826,0.4273504273504274,0.609375,134,-156,0.4116558002775952,0.5883441997224048,home,ARI,under,8,0.5121951219512195,-105,0.49029798572728833,ARI,SD,2022 REG,4,1,8,6,7,12,0,1,-5,5,1,0,0,0,0,0,0,0,0,0.5097020142727117,0.49029798572728833
86827,0.40485829959514175,0.6323529411764706,147,-172,0.3897930199305214,0.6102069800694786,away,BOS,over,8.5,0.5,100,0.47935779816513757,LAA,BOS,2022 REG,7,0,7,1,1,14,0,1,-1,1,0,0,0,0,0,0,0,0,0,0.47935779816513757,0.5206422018348624
86827,0.40485829959514175,0.6323529411764706,147,-172,0.3897930199305214,0.6102069800694786,home,LAA,under,8.5,0.5412844036697247,-118,0.5206422018348624,LAA,BOS,2022 REG,7,0,7,1,1,14,0,1,-1,1,0,0,0,0,0,0,0,0,0,0.47935779816513757,0.5206422018348624
86828,0.5652173913043479,0.47619047619047616,-130,110,0.5418129444594474,0.4581870555405526,away,TB,over,8.5,0.5283018867924528,-112,0.5044173060022736,NYY,TB,2022 REG,8,10,10,4,14,18,1,0,6,-6,1,1,1,1,0,0,0,0,0,0.5044173060022736,0.49558269399772636
86828,0.5652173913043479,0.47619047619047616,-130,110,0.5418129444594474,0.4581870555405526,home,NYY,under,8.5,0.5169082125603864,-107,0.49558269399772636,NYY,TB,2022 REG,8,10,10,4,14,18,1,0,6,-6,1,1,1,1,0,0,0,0,0,0.5044173060022736,0.49558269399772636
86829,0.5192307692307692,0.5215311004784688,-108,-109,0.49806595226635714,0.5019340477336429,away,COL,over,8.5,0.5391705069124424,-117,0.5140669063204599,WSH,COL,2022 REG,14,13,12,7,20,26,1,0,6,-6,1,1,1,1,1,1,1,0,0,0.5140669063204599,0.4859330936795401
86829,0.5192307692307692,0.5215311004784688,-108,-109,0.49806595226635714,0.5019340477336429,home,WSH,under,8.5,0.5073891625615764,-103,0.4859330936795401,WSH,COL,2022 REG,14,13,12,7,20,26,1,0,6,-6,1,1,1,1,1,1,1,0,0,0.5140669063204599,0.4859330936795401
86830,0.4608294930875576,0.576271186440678,117,-136,0.4437324057473569,0.5562675942526432,away,TB,over,9,0.5348837209302326,-115,0.5097020142727117,KC,TB,2022 REG,12,3,8,7,10,20,0,1,-4,4,1,1,1,0,0,0,0,0,0,0.5097020142727117,0.49029798572728833
86830,0.4608294930875576,0.576271186440678,117,-136,0.4437324057473569,0.5562675942526432,home,KC,under,9,0.5121951219512195,-105,0.49029798572728833,KC,TB,2022 REG,12,3,8,7,10,20,0,1,-4,4,1,1,1,0,0,0,0,0,0,0.5097020142727117,0.49029798572728833
86831,0.5633187772925764,0.47619047619047616,-129,110,0.5410624729287608,0.45893752707123925,away,MIL,over,7.5,0.5327102803738317,-114,0.508788710910954,NYM,MIL,2022 REG,7,5,11,4,9,18,1,0,1,-1,1,1,1,1,0,0,0,0,0,0.508788710910954,0.491211289089046
86831,0.5633187772925764,0.47619047619047616,-129,110,0.5410624729287608,0.45893752707123925,home,NYM,under,7.5,0.5121951219512195,-105,0.491211289089046,NYM,MIL,2022 REG,7,5,11,4,9,18,1,0,1,-1,1,1,1,1,0,0,0,0,0,0.508788710910954,0.491211289089046
86832,0.3921568627450981,0.6428571428571428,155,-180,0.37842588015598405,0.6215741198440159,away,HOU,over,7.5,0.5121951219512195,-105,0.48808156828023186,OAK,HOU,2022 REG,4,3,14,8,11,18,0,1,-5,5,1,1,1,0,0,0,0,0,0,0.48808156828023186,0.5119184317197681
86832,0.3921568627450981,0.6428571428571428,155,-180,0.37842588015598405,0.6215741198440159,home,OAK,under,7.5,0.5348837209302326,-115,0.5119184317197681,OAK,HOU,2022 REG,4,3,14,8,11,18,0,1,-5,5,1,1,1,0,0,0,0,0,0,0.48808156828023186,0.5119184317197681
86833,0.5433789954337899,0.49751243781094534,-119,101,0.5211594495154178,0.4788405504845822,away,SEA,over,8.5,0.5192307692307692,-108,0.49688292476754015,TEX,SEA,2022 REG,12,7,7,4,11,19,1,0,3,-3,1,1,1,1,0,0,0,0,0,0.49688292476754015,0.5031170752324599
86833,0.5433789954337899,0.49751243781094534,-119,101,0.5211594495154178,0.4788405504845822,home,TEX,under,8.5,0.5238095238095238,-110,0.5031170752324599,TEX,SEA,2022 REG,12,7,7,4,11,19,1,0,3,-3,1,1,1,1,0,0,0,0,0,0.49688292476754015,0.5031170752324599
86834,0.4629629629629629,0.576271186440678,116,-136,0.4447990049057217,0.5552009950942782,away,MIL,over,7.5,0.5,100,0.4772727272727273,CHC,MIL,2022 REG,4,4,5,5,9,9,0,1,-1,1,1,1,1,1,0,0,0,0,0,0.4772727272727273,0.5227272727272727
86834,0.4629629629629629,0.576271186440678,116,-136,0.4447990049057217,0.5552009950942782,home,CHC,under,7.5,0.5454545454545454,-120,0.5227272727272727,CHC,MIL,2022 REG,4,4,5,5,9,9,0,1,-1,1,1,1,1,1,0,0,0,0,0,0.4772727272727273,0.5227272727272727
86835,0.5689655172413793,0.4694835680751174,-132,113,0.5470893135268209,0.4529106864731791,away,TB,over,8.5,0.5454545454545454,-120,0.5206611570247933,TOR,TB,2022 REG,11,3,14,7,10,25,0,1,-4,4,1,1,1,0,0,0,0,0,0,0.5206611570247933,0.4793388429752067
86835,0.5689655172413793,0.4694835680751174,-132,113,0.5470893135268209,0.4529106864731791,home,TOR,under,8.5,0.5,100,0.4793388429752067,TOR,TB,2022 REG,11,3,14,7,10,25,0,1,-4,4,1,1,1,0,0,0,0,0,0,0.5206611570247933,0.4793388429752067
86836,0.6402877697841727,0.4166666666666667,-178,140,0.6038205406897503,0.39617945931024967,away,KC,over,9,0.5192307692307692,-108,0.49455035168025013,STL,KC,2022 REG,10,6,8,5,11,18,1,0,1,-1,1,1,1,1,1,0,0,0,0,0.49455035168025013,0.5054496483197499
86836,0.6402877697841727,0.4166666666666667,-178,140,0.6038205406897503,0.39617945931024967,home,STL,under,9,0.5283018867924528,-112,0.5054496483197499,STL,KC,2022 REG,10,6,8,5,11,18,1,0,1,-1,1,1,1,1,1,0,0,0,0,0.49455035168025013,0.5054496483197499
86837,0.5850622406639003,0.45454545454545453,-141,120,0.5618892737571823,0.43811072624281766,away,SEA,over,8.5,0.504950495049505,-102,0.47949844489399435,HOU,SEA,2022 REG,6,4,5,2,6,11,1,0,2,-2,1,1,0,0,0,0,0,0,0,0.47949844489399435,0.5205015551060057
86837,0.5850622406639003,0.45454545454545453,-141,120,0.5618892737571823,0.43811072624281766,home,HOU,under,8.5,0.5454545454545454,-120,0.5205015551060057,HOU,SEA,2022 REG,6,4,5,2,6,11,1,0,2,-2,1,1,0,0,0,0,0,0,0,0.47949844489399435,0.5205015551060057
86838,0.6000000000000001,0.43859649122807015,-150,128,0.5768421052631579,0.42315789473684207,away,PIT,over,9,0.5515695067264574,-123,0.527200976088429,WSH,PIT,2022 REG,16,7,9,8,15,25,0,1,-1,1,1,1,1,1,1,1,1,0,0,0.527200976088429,0.472799023911571
86838,0.6000000000000001,0.43859649122807015,-150,128,0.5768421052631579,0.42315789473684207,home,WSH,under,9,0.4926108374384236,103,0.472799023911571,WSH,PIT,2022 REG,16,7,9,8,15,25,0,1,-1,1,1,1,1,1,1,1,1,0,0,0.527200976088429,0.472799023911571
86839,0.5098039215686274,0.5238095238095238,-104,-110,0.49266765529741313,0.5073323447025868,away,SD,over,8.5,0.5215311004784688,-109,0.50027251771145,STL,SD,2022 REG,10,6,11,3,9,21,1,0,3,-3,1,1,1,0,0,0,0,0,0,0.50027251771145,0.49972748228855
86839,0.5098039215686274,0.5238095238095238,-104,-110,0.49266765529741313,0.5073323447025868,home,STL,under,8.5,0.5192307692307692,-108,0.49972748228855,STL,SD,2022 REG,10,6,11,3,9,21,1,0,3,-3,1,1,1,0,0,0,0,0,0,0.50027251771145,0.49972748228855
86840,0.6363636363636364,0.40485829959514175,-175,147,0.6101314952989593,0.38986850470104073,away,DET,over,8.5,0.5412844036697247,-118,0.5175913212324037,CWS,DET,2022 REG,5,2,14,7,9,19,0,1,-5,5,1,1,0,0,0,0,0,0,0,0.5175913212324037,0.4824086787675963
86840,0.6363636363636364,0.40485829959514175,-175,147,0.6101314952989593,0.38986850470104073,home,CWS,under,8.5,0.5024875621890548,-101,0.4824086787675963,CWS,DET,2022 REG,5,2,14,7,9,19,0,1,-5,5,1,1,0,0,0,0,0,0,0,0.5175913212324037,0.4824086787675963
86841,0.425531914893617,0.6153846153846154,135,-160,0.4081206254135181,0.5918793745864819,away,MIN,over,7,0.5348837209302326,-115,0.5097020142727117,DET,MIN,2022 REG,6,0,14,7,7,20,0,1,-7,7,0,0,0,0,0,0,0,0,0,0.5097020142727117,0.49029798572728833
86841,0.425531914893617,0.6153846153846154,135,-160,0.4081206254135181,0.5918793745864819,home,DET,under,7,0.5121951219512195,-105,0.49029798572728833,DET,MIN,2022 REG,6,0,14,7,7,20,0,1,-7,7,0,0,0,0,0,0,0,0,0,0.5097020142727117,0.49029798572728833
86842,0.4854368932038835,0.5535714285714286,106,-124,0.4665008146721786,0.5334991853278215,away,ATL,over,7.5,0.5370370370370371,-116,0.5131785224377817,MIA,ATL,2022 REG,5,1,10,3,4,15,0,1,-2,2,1,0,0,0,0,0,0,0,0,0.5131785224377817,0.4868214775622183
86842,0.4854368932038835,0.5535714285714286,106,-124,0.4665008146721786,0.5334991853278215,home,MIA,under,7.5,0.5073891625615764,-103,0.4868214775622183,MIA,ATL,2022 REG,5,1,10,3,4,15,0,1,-2,2,1,0,0,0,0,0,0,0,0,0.5131785224377817,0.4868214775622183
86843,0.425531914893617,0.6108949416342413,135,-157,0.41003112488176247,0.5899688751182375,away,HOU,over,9,0.5283018867924528,-112,0.5044173060022736,ARI,HOU,2022 REG,6,3,6,2,5,12,1,0,1,-1,1,1,0,0,0,0,0,0,0,0.5044173060022736,0.49558269399772636
86843,0.425531914893617,0.6108949416342413,135,-157,0.41003112488176247,0.5899688751182375,home,ARI,under,9,0.5169082125603864,-107,0.49558269399772636,ARI,HOU,2022 REG,6,3,6,2,5,12,1,0,1,-1,1,1,0,0,0,0,0,0,0,0.5044173060022736,0.49558269399772636
86844,0.36363636363636365,0.6742671009771988,175,-207,0.3498532855950683,0.6501467144049318,away,SF,over,8,0.5073891625615764,-103,0.4837652908580103,WSH,SF,2022 REG,7,3,15,12,15,22,0,1,-9,9,1,1,1,0,0,0,0,0,0,0.4837652908580103,0.5162347091419897
86844,0.36363636363636365,0.6742671009771988,175,-207,0.3498532855950683,0.6501467144049318,home,WSH,under,8,0.5391705069124424,-117,0.5162347091419897,WSH,SF,2022 REG,7,3,15,12,15,22,0,1,-9,9,1,1,1,0,0,0,0,0,0,0.4837652908580103,0.5162347091419897
86845,0.425531914893617,0.6183206106870228,135,-162,0.406871265710366,0.593128734289634,away,HOU,over,8.5,0.5192307692307692,-108,0.49455035168025013,CLE,HOU,2022 REG,10,4,6,1,5,16,1,0,3,-3,1,0,0,0,0,0,0,0,0,0.49455035168025013,0.5054496483197499
86845,0.425531914893617,0.6183206106870228,135,-162,0.406871265710366,0.593128734289634,home,CLE,under,8.5,0.5283018867924528,-112,0.5054496483197499,CLE,HOU,2022 REG,10,4,6,1,5,16,1,0,3,-3,1,0,0,0,0,0,0,0,0,0.49455035168025013,0.5054496483197499
86846,0.5867768595041323,0.4587155963302753,-142,118,0.5600829391384882,0.43991706086151183,away,TOR,over,7,0.5348837209302326,-115,0.5097020142727117,BAL,TOR,2022 REG,4,1,8,5,6,12,0,1,-4,4,1,0,0,0,0,0,0,0,0,0.5097020142727117,0.49029798572728833
86846,0.5867768595041323,0.4587155963302753,-142,118,0.5600829391384882,0.43991706086151183,home,BAL,under,7,0.5121951219512195,-105,0.49029798572728833,BAL,TOR,2022 REG,4,1,8,5,6,12,0,1,-4,4,1,0,0,0,0,0,0,0,0,0.5097020142727117,0.49029798572728833
86847,0.5495495495495495,0.49019607843137253,-122,104,0.5277073575960698,0.4722926424039302,away,CHC,over,10,0.5121951219512195,-105,0.4903184724049234,PHI,CHC,2022 REG,9,3,7,4,7,16,0,1,-1,1,1,1,1,0,0,0,0,0,0,0.4903184724049234,0.5096815275950766
86847,0.5495495495495495,0.49019607843137253,-122,104,0.5277073575960698,0.4722926424039302,home,PHI,under,10,0.5305164319248826,-113,0.5096815275950766,PHI,CHC,2022 REG,9,3,7,4,7,16,0,1,-1,1,1,1,1,0,0,0,0,0,0,0.4903184724049234,0.5096815275950766
86848,0.6987951807228916,0.3389830508474576,-232,195,0.6723959345652982,0.3276040654347018,away,ARI,over,8.5,0.5073891625615764,-103,0.4826927225525911,SD,ARI,2022 REG,10,6,6,3,9,16,1,0,3,-3,1,1,1,0,0,0,0,0,0,0.4826927225525911,0.5173072774474089
86848,0.6987951807228916,0.3389830508474576,-232,195,0.6723959345652982,0.3276040654347018,home,SD,under,8.5,0.5412844036697247,-118,0.5173072774474089,SD,ARI,2022 REG,10,6,6,3,9,16,1,0,3,-3,1,1,1,0,0,0,0,0,0,0.4826927225525911,0.5173072774474089
86849,0.6825396825396826,0.35460992907801414,-215,182,0.6571835984196672,0.3428164015803328,away,ARI,over,7,0.5024875621890548,-101,0.48049269377245407,LAD,ARI,2022 REG,6,3,4,2,5,10,1,0,1,-1,1,1,0,0,0,0,0,0,0,0.48049269377245407,0.5195073062275459
86849,0.6825396825396826,0.35460992907801414,-215,182,0.6571835984196672,0.3428164015803328,home,LAD,under,7,0.5412844036697247,-118,0.5195073062275459,LAD,ARI,2022 REG,6,3,4,2,5,10,1,0,1,-1,1,1,0,0,0,0,0,0,0,0.48049269377245407,0.5195073062275459
86850,0.49751243781094534,0.5454545454545454,101,-120,0.476135829221149,0.523864170778851,away,MIA,over,8,0.5,100,0.47935779816513757,PIT,MIA,2022 REG,9,1,5,0,1,14,1,0,1,-1,0,0,0,0,0,0,0,0,0,0.47935779816513757,0.5206422018348624
86850,0.49751243781094534,0.5454545454545454,101,-120,0.476135829221149,0.523864170778851,home,PIT,under,8,0.5412844036697247,-118,0.5206422018348624,PIT,MIA,2022 REG,9,1,5,0,1,14,1,0,1,-1,0,0,0,0,0,0,0,0,0,0.47935779816513757,0.5206422018348624
86851,0.7229916897506925,0.31746031746031744,-261,215,0.6937452247033973,0.3062547752966027,away,CIN,over,9.5,0.5145631067961165,-106,0.49023796582517226,PHI,CIN,2022 REG,16,7,10,5,12,26,1,0,2,-2,1,1,1,1,1,0,0,0,0,0.49023796582517226,0.5097620341748277
86851,0.7229916897506925,0.31746031746031744,-261,215,0.6937452247033973,0.3062547752966027,home,PHI,under,9.5,0.5327102803738317,-114,0.5097620341748277,PHI,CIN,2022 REG,16,7,10,5,12,26,1,0,2,-2,1,1,1,1,1,0,0,0,0,0.49023796582517226,0.5097620341748277
86852,0.5689655172413793,0.4672897196261683,-132,114,0.5483375376443265,0.45166246235567353,away,NYY,over,7.5,0.5098039215686274,-104,0.4870219861770517,TB,NYY,2022 REG,7,2,3,1,3,10,1,0,1,-1,1,0,0,0,0,0,0,0,0,0.4870219861770517,0.5129780138229483
86852,0.5689655172413793,0.4672897196261683,-132,114,0.5483375376443265,0.45166246235567353,home,TB,under,7.5,0.5348837209302326,-115,0.5129780138229483,TB,NYY,2022 REG,7,2,3,1,3,10,1,0,1,-1,1,0,0,0,0,0,0,0,0,0.4870219861770517,0.5129780138229483
86853,0.37453183520599254,0.6632996632996633,167,-197,0.3603627346420765,0.6396372653579234,away,NYY,over,8,0.5283018867924528,-112,0.5044173060022736,KC,NYY,2022 REG,11,4,8,6,10,19,0,1,-2,2,1,1,1,1,0,0,0,0,0,0.5044173060022736,0.49558269399772636
86853,0.37453183520599254,0.6632996632996633,167,-197,0.3603627346420765,0.6396372653579234,home,KC,under,8,0.5169082125603864,-107,0.49558269399772636,KC,NYY,2022 REG,11,4,8,6,10,19,0,1,-2,2,1,1,1,1,0,0,0,0,0,0.5044173060022736,0.49558269399772636
86854,0.390625,0.6539792387543253,156,-189,0.3732014692365917,0.6267985307634083,away,TB,over,7.5,0.5305164319248826,-113,0.5078572507605655,BAL,TB,2022 REG,5,5,12,3,8,17,1,0,2,-2,1,1,1,0,0,0,0,0,0,0.5078572507605655,0.49214274923943446
86854,0.390625,0.6539792387543253,156,-189,0.3732014692365917,0.6267985307634083,home,BAL,under,7.5,0.5121951219512195,-105,0.49214274923943446,BAL,TB,2022 REG,5,5,12,3,8,17,1,0,2,-2,1,1,1,0,0,0,0,0,0,0.5078572507605655,0.49214274923943446
86855,0.3436426116838488,0.7014925373134329,191,-235,0.3281322512036832,0.6718677487963167,away,ATL,over,9.5,0.5348837209302326,-115,0.5109810284308424,WSH,ATL,2022 REG,11,4,6,5,9,17,0,1,-1,1,1,1,1,1,0,0,0,0,0,0.5109810284308424,0.48901897156915763
86855,0.3436426116838488,0.7014925373134329,191,-235,0.3281322512036832,0.6718677487963167,home,WSH,under,9.5,0.5098039215686274,-104,0.48901897156915763,WSH,ATL,2022 REG,11,4,6,5,9,17,0,1,-1,1,1,1,1,1,0,0,0,0,0,0.5109810284308424,0.48901897156915763
86856,0.3968253968253968,0.646643109540636,152,-183,0.3795759895372886,0.6204240104627115,away,NYY,over,7.5,0.5121951219512195,-105,0.48808156828023186,DET,NYY,2022 REG,11,3,6,5,8,17,0,1,-2,2,1,1,1,0,0,0,0,0,0,0.48808156828023186,0.5119184317197681
86856,0.3968253968253968,0.646643109540636,152,-183,0.3795759895372886,0.6204240104627115,home,DET,under,7.5,0.5348837209302326,-115,0.5119184317197681,DET,NYY,2022 REG,11,3,6,5,8,17,0,1,-2,2,1,1,1,0,0,0,0,0,0,0.48808156828023186,0.5119184317197681
86857,0.5515695067264574,0.48780487804878053,-123,105,0.5298517967383217,0.4701482032616783,away,DET,over,8.5,0.5305164319248826,-113,0.5066009958897986,KC,DET,2022 REG,8,3,4,1,4,12,1,0,2,-2,1,0,0,0,0,0,0,0,0,0.5066009958897986,0.49339900411020143
86857,0.5515695067264574,0.48780487804878053,-123,105,0.5298517967383217,0.4701482032616783,home,KC,under,8.5,0.5145631067961165,-106,0.49339900411020143,KC,DET,2022 REG,8,3,4,1,4,12,1,0,2,-2,1,0,0,0,0,0,0,0,0,0.5066009958897986,0.49339900411020143
86858,0.6108949416342413,0.425531914893617,-157,135,0.5886419592417365,0.41135804075826354,away,TOR,over,7,0.5391705069124424,-117,0.5153817639191344,BAL,TOR,2022 REG,10,5,13,4,9,23,1,0,1,-1,1,1,1,1,0,0,0,0,0,0.5153817639191344,0.4846182360808656
86858,0.6108949416342413,0.425531914893617,-157,135,0.5886419592417365,0.41135804075826354,home,BAL,under,7,0.504950495049505,-102,0.4846182360808656,BAL,TOR,2022 REG,10,5,13,4,9,23,1,0,1,-1,1,1,1,1,0,0,0,0,0,0.5153817639191344,0.4846182360808656
86859,0.45248868778280543,0.5901639344262295,121,-144,0.4331888587289435,0.5668111412710565,away,ATL,over,7.5,0.5073891625615764,-103,0.4837652908580103,PHI,ATL,2022 REG,6,1,6,0,1,12,1,0,1,-1,0,0,0,0,0,0,0,0,0,0.4837652908580103,0.5162347091419897
86859,0.45248868778280543,0.5901639344262295,121,-144,0.4331888587289435,0.5668111412710565,home,PHI,under,7.5,0.5391705069124424,-117,0.5162347091419897,PHI,ATL,2022 REG,6,1,6,0,1,12,1,0,1,-1,0,0,0,0,0,0,0,0,0,0.4837652908580103,0.5162347091419897
86860,0.4366812227074236,0.601593625498008,129,-151,0.4199673151941347,0.5800326848058652,away,CLE,over,7,0.5327102803738317,-114,0.508788710910954,CWS,CLE,2022 REG,7,2,9,4,6,16,0,1,-2,2,1,1,0,0,0,0,0,0,0,0.508788710910954,0.491211289089046
86860,0.4366812227074236,0.601593625498008,129,-151,0.4199673151941347,0.5800326848058652,home,CWS,under,7,0.5121951219512195,-105,0.491211289089046,CWS,CLE,2022 REG,7,2,9,4,6,16,0,1,-2,2,1,1,0,0,0,0,0,0,0,0.508788710910954,0.491211289089046
86861,0.4166666666666667,0.6226415094339623,140,-165,0.4002882599580712,0.5997117400419287,away,NYY,over,7,0.5348837209302326,-115,0.5097020142727117,TB,NYY,2022 REG,8,5,5,4,9,13,1,0,1,-1,1,1,1,1,0,0,0,0,0,0.5097020142727117,0.49029798572728833
86861,0.4166666666666667,0.6226415094339623,140,-165,0.4002882599580712,0.5997117400419287,home,TB,under,7,0.5121951219512195,-105,0.49029798572728833,TB,NYY,2022 REG,8,5,5,4,9,13,1,0,1,-1,1,1,1,1,0,0,0,0,0,0.5097020142727117,0.49029798572728833
86862,0.6551724137931035,0.3846153846153846,-190,160,0.6291045458703008,0.37089545412969915,away,PIT,over,9.5,0.5,100,0.47935779816513757,STL,PIT,2022 REG,14,7,7,5,12,21,1,0,2,-2,1,1,1,1,1,0,0,0,0,0.47935779816513757,0.5206422018348624
86862,0.6551724137931035,0.3846153846153846,-190,160,0.6291045458703008,0.37089545412969915,home,STL,under,9.5,0.5412844036697247,-118,0.5206422018348624,STL,PIT,2022 REG,14,7,7,5,12,21,1,0,2,-2,1,1,1,1,1,0,0,0,0,0.47935779816513757,0.5206422018348624
86863,0.7354497354497355,0.30303030303030304,-278,230,0.7071496013294954,0.29285039867050455,away,CHC,over,8,0.5412844036697247,-118,0.5189377998484975,LAD,CHC,2022 REG,7,5,6,3,8,13,1,0,2,-2,1,1,1,0,0,0,0,0,0,0.5189377998484975,0.4810622001515025
86863,0.7354497354497355,0.30303030303030304,-278,230,0.7071496013294954,0.29285039867050455,home,LAD,under,8,0.5,100,0.4810622001515025,LAD,CHC,2022 REG,7,5,6,3,8,13,1,0,2,-2,1,1,1,0,0,0,0,0,0,0.5189377998484975,0.4810622001515025
86864,0.5260663507109005,0.5169082125603864,-111,-107,0.5034588790373798,0.49654112096262015,away,COL,over,8.5,0.5348837209302326,-115,0.5109810284308424,WSH,COL,2022 REG,9,7,8,3,10,17,1,0,4,-4,1,1,1,0,0,0,0,0,0,0.5109810284308424,0.48901897156915763
86864,0.5260663507109005,0.5169082125603864,-111,-107,0.5034588790373798,0.49654112096262015,home,WSH,under,8.5,0.5098039215686274,-104,0.48901897156915763,WSH,COL,2022 REG,9,7,8,3,10,17,1,0,4,-4,1,1,1,0,0,0,0,0,0,0.5109810284308424,0.48901897156915763
86865,0.7311827956989247,0.3105590062111801,-272,222,0.7006619082807836,0.29933809171921644,away,MIL,over,7.5,0.5348837209302326,-115,0.5109810284308424,LAD,MIL,2022 REG,8,0,5,4,4,13,0,1,-4,4,0,0,0,0,0,0,0,0,0,0.5109810284308424,0.48901897156915763
86865,0.7311827956989247,0.3105590062111801,-272,222,0.7006619082807836,0.29933809171921644,home,LAD,under,7.5,0.5098039215686274,-104,0.48901897156915763,LAD,MIL,2022 REG,8,0,5,4,4,13,0,1,-4,4,0,0,0,0,0,0,0,0,0,0.5109810284308424,0.48901897156915763
86866,0.7014925373134329,0.3389830508474576,-235,195,0.6730992142751963,0.32690078572480374,away,OAK,over,7,0.5215311004784688,-109,0.49670754937970685,LAA,OAK,2022 REG,6,1,8,3,4,14,0,1,-2,2,1,0,0,0,0,0,0,0,0,0.49670754937970685,0.5032924506202932
86866,0.7014925373134329,0.3389830508474576,-235,195,0.6730992142751963,0.32690078572480374,home,LAA,under,7,0.5260663507109005,-111,0.5032924506202932,LAA,OAK,2022 REG,6,1,8,3,4,14,0,1,-2,2,1,0,0,0,0,0,0,0,0,0.49670754937970685,0.5032924506202932
86867,0.7183098591549296,0.3225806451612903,-255,210,0.6889378067587716,0.3110621932412284,away,COL,over,8,0.5305164319248826,-113,0.5041247242695369,SF,COL,2022 REG,7,2,10,4,6,17,0,1,-2,2,1,1,0,0,0,0,0,0,0,0.5041247242695369,0.4958752757304631
86867,0.7183098591549296,0.3225806451612903,-255,210,0.6889378067587716,0.3110621932412284,home,SF,under,8,0.5192307692307692,-108,0.4958752757304631,SF,COL,2022 REG,7,2,10,4,6,17,0,1,-2,2,1,1,0,0,0,0,0,0,0,0.5041247242695369,0.4958752757304631
86868,0.4347826086956522,0.6047430830039526,130,-153,0.4175975253479979,0.5824024746520021,away,TEX,over,9,0.504950495049505,-102,0.4826715732667395,KC,TEX,2022 REG,7,3,13,8,11,20,0,1,-5,5,1,1,1,0,0,0,0,0,0,0.4826715732667395,0.5173284267332605
86868,0.4347826086956522,0.6047430830039526,130,-153,0.4175975253479979,0.5824024746520021,home,KC,under,9,0.5391705069124424,-117,0.5173284267332605,KC,TEX,2022 REG,7,3,13,8,11,20,0,1,-5,5,1,1,1,0,0,0,0,0,0,0.4826715732667395,0.5173284267332605
86869,0.46511627906976744,0.574468085106383,115,-135,0.44670494689481377,0.5532950531051862,away,NYM,over,7.5,0.5,100,0.4772727272727273,CHC,NYM,2022 REG,5,1,4,2,3,9,0,1,-1,1,1,0,0,0,0,0,0,0,0,0.4772727272727273,0.5227272727272727
86869,0.46511627906976744,0.574468085106383,115,-135,0.44670494689481377,0.5532950531051862,home,CHC,under,7.5,0.5454545454545454,-120,0.5227272727272727,CHC,NYM,2022 REG,5,1,4,2,3,9,0,1,-1,1,1,0,0,0,0,0,0,0,0,0.4772727272727273,0.5227272727272727
86870,0.5121951219512195,0.5348837209302326,-105,-115,0.48808156828023186,0.5119184317197681,away,CWS,over,11,0.5238095238095238,-110,0.4988662131519274,COL,CWS,2022 REG,9,1,9,2,3,18,0,1,-1,1,1,0,0,0,0,0,0,0,0,0.4988662131519274,0.5011337868480725
86870,0.5121951219512195,0.5348837209302326,-105,-115,0.48808156828023186,0.5119184317197681,home,COL,under,11,0.5238095238095238,-110,0.5011337868480725,COL,CWS,2022 REG,9,1,9,2,3,18,0,1,-1,1,1,0,0,0,0,0,0,0,0,0.4988662131519274,0.5011337868480725
86871,0.7076023391812866,0.3333333333333333,-242,200,0.6786361615539824,0.32136383844601757,away,COL,over,6.5,0.5454545454545454,-120,0.5233614270517961,SF,COL,2022 REG,11,8,11,5,13,22,1,0,3,-3,1,1,1,1,1,0,0,0,0,0.5233614270517961,0.4766385729482039
86871,0.7076023391812866,0.3333333333333333,-242,200,0.6786361615539824,0.32136383844601757,home,SF,under,6.5,0.49504950495049505,102,0.4766385729482039,SF,COL,2022 REG,11,8,11,5,13,22,1,0,3,-3,1,1,1,1,1,0,0,0,0,0.5233614270517961,0.4766385729482039
86872,0.6688741721854304,0.37037037037037035,-202,170,0.6426245112706233,0.35737548872937674,away,TEX,over,7.5,0.5,100,0.4772727272727273,SEA,TEX,2022 REG,5,0,7,5,5,12,0,1,-5,5,0,0,0,0,0,0,0,0,0,0.4772727272727273,0.5227272727272727
86872,0.6688741721854304,0.37037037037037035,-202,170,0.6426245112706233,0.35737548872937674,home,SEA,under,7.5,0.5454545454545454,-120,0.5227272727272727,SEA,TEX,2022 REG,5,0,7,5,5,12,0,1,-5,5,0,0,0,0,0,0,0,0,0,0.4772727272727273,0.5227272727272727
86873,0.9679897567221512,0.07407407407407407,-3024,1250,0.9272723993829113,0.07272760061708872,away,STL,over,10.5,0.09960159362549802,904,0.0950245493071743,MIL,STL,2022 REG,8,6,7,4,10,15,1,0,2,-2,1,1,1,1,0,0,0,0,0,0.0950245493071743,0.9049754506928257
86873,0.9679897567221512,0.07407407407407407,-3024,1250,0.9272723993829113,0.07272760061708872,home,MIL,under,10.5,0.9463519313304721,-1764,0.9049754506928257,MIL,STL,2022 REG,8,6,7,4,10,15,1,0,2,-2,1,1,1,1,0,0,0,0,0,0.0950245493071743,0.9049754506928257
86874,0.4424778761061947,0.5867768595041323,126,-142,0.42953330282728897,0.570466697172711,away,MIL,over,6.5,0.504950495049505,-102,0.48160416005266615,MIA,MIL,2022 REG,5,1,6,2,3,11,0,1,-1,1,1,0,0,0,0,0,0,0,0,0.48160416005266615,0.5183958399473338
86874,0.4424778761061947,0.5867768595041323,126,-142,0.42953330282728897,0.570466697172711,home,MIA,under,6.5,0.5412844036697247,-118,0.5183958399473338,MIA,MIL,2022 REG,5,1,6,2,3,11,0,1,-1,1,1,0,0,0,0,0,0,0,0,0.48160416005266615,0.5183958399473338
86875,0.6108949416342413,0.425531914893617,-157,135,0.5886419592417365,0.41135804075826354,away,MIL,over,7.5,0.5238095238095238,-110,0.5000596729920038,SF,MIL,2022 REG,12,9,9,5,14,21,1,0,4,-4,1,1,1,1,1,0,0,0,0,0.5000596729920038,0.4999403270079962
86875,0.6108949416342413,0.425531914893617,-157,135,0.5886419592417365,0.41135804075826354,home,SF,under,7.5,0.5215311004784688,-109,0.4999403270079962,SF,MIL,2022 REG,12,9,9,5,14,21,1,0,4,-4,1,1,1,1,1,0,0,0,0,0.5000596729920038,0.4999403270079962
86876,0.7382198952879581,0.30120481927710846,-282,232,0.709115786629977,0.290884213370023,away,WSH,over,7.5,0.5192307692307692,-108,0.49688292476754015,STL,WSH,2022 REG,11,6,18,11,17,29,0,1,-5,5,1,1,1,1,1,1,0,0,0,0.49688292476754015,0.5031170752324599
86876,0.7382198952879581,0.30120481927710846,-282,232,0.709115786629977,0.290884213370023,home,STL,under,7.5,0.5238095238095238,-110,0.5031170752324599,STL,WSH,2022 REG,11,6,18,11,17,29,0,1,-5,5,1,1,1,1,1,1,0,0,0,0.49688292476754015,0.5031170752324599
86877,0.6108949416342413,0.425531914893617,-157,135,0.5886419592417365,0.41135804075826354,away,TOR,over,8,0.5391705069124424,-117,0.5140669063204599,MIL,TOR,2022 REG,8,5,7,4,9,15,1,0,1,-1,1,1,1,1,0,0,0,0,0,0.5140669063204599,0.4859330936795401
86877,0.6108949416342413,0.425531914893617,-157,135,0.5886419592417365,0.41135804075826354,home,MIL,under,8,0.5073891625615764,-103,0.4859330936795401,MIL,TOR,2022 REG,8,5,7,4,9,15,1,0,1,-1,1,1,1,1,0,0,0,0,0,0.5140669063204599,0.4859330936795401
86878,0.5594713656387665,0.48309178743961345,-127,107,0.5356585002601133,0.4643414997398867,away,TB,over,7.5,0.5412844036697247,-118,0.5189377998484975,LAA,TB,2022 REG,11,11,10,3,14,21,1,0,8,-8,1,1,1,0,0,0,0,0,0,0.5189377998484975,0.4810622001515025
86878,0.5594713656387665,0.48309178743961345,-127,107,0.5356585002601133,0.4643414997398867,home,LAA,under,7.5,0.5,100,0.4810622001515025,LAA,TB,2022 REG,11,11,10,3,14,21,1,0,8,-8,1,1,1,0,0,0,0,0,0,0.5189377998484975,0.4810622001515025
86879,0.4739336492890995,0.5670995670995671,111,-131,0.4544866273039494,0.5455133726960506,away,MIL,over,7,0.5283018867924528,-112,0.5044173060022736,SF,MIL,2022 REG,11,8,6,5,13,17,1,0,3,-3,1,1,1,1,1,0,0,0,0,0.5044173060022736,0.49558269399772636
86879,0.4739336492890995,0.5670995670995671,111,-131,0.4544866273039494,0.5455133726960506,home,SF,under,7,0.5169082125603864,-107,0.49558269399772636,SF,MIL,2022 REG,11,8,6,5,13,17,1,0,3,-3,1,1,1,1,1,0,0,0,0,0.5044173060022736,0.49558269399772636
86880,0.3058103975535168,0.7333333333333333,227,-275,0.2938398376492813,0.7061601623507188,away,ATL,over,9.5,0.5412844036697247,-118,0.5175913212324037,CIN,ATL,2022 REG,6,1,12,9,10,18,0,1,-8,8,1,0,0,0,0,0,0,0,0,0.5175913212324037,0.4824086787675963
86880,0.3058103975535168,0.7333333333333333,227,-275,0.2938398376492813,0.7061601623507188,home,CIN,under,9.5,0.5024875621890548,-101,0.4824086787675963,CIN,ATL,2022 REG,6,1,12,9,10,18,0,1,-8,8,1,0,0,0,0,0,0,0,0,0.5175913212324037,0.4824086787675963
86882,0.4166666666666667,0.6153846153846154,140,-160,0.40331196581196577,0.5966880341880343,away,NYM,over,7.5,0.5098039215686274,-104,0.4870219861770517,MIA,NYM,2022 REG,10,6,7,3,9,17,1,0,3,-3,1,1,1,0,0,0,0,0,0,0.4870219861770517,0.5129780138229483
86882,0.4166666666666667,0.6153846153846154,140,-160,0.40331196581196577,0.5966880341880343,home,MIA,under,7.5,0.5348837209302326,-115,0.5129780138229483,MIA,NYM,2022 REG,10,6,7,3,9,17,1,0,3,-3,1,1,1,0,0,0,0,0,0,0.4870219861770517,0.5129780138229483
86883,0.4716981132075471,0.5670995670995671,112,-131,0.4533973206098518,0.5466026793901482,away,SEA,over,9,0.5073891625615764,-103,0.4826927225525911,TEX,SEA,2022 REG,7,2,10,6,8,17,0,1,-4,4,1,1,0,0,0,0,0,0,0,0.4826927225525911,0.5173072774474089
86883,0.4716981132075471,0.5670995670995671,112,-131,0.4533973206098518,0.5466026793901482,home,TEX,under,9,0.5412844036697247,-118,0.5173072774474089,TEX,SEA,2022 REG,7,2,10,6,8,17,0,1,-4,4,1,1,0,0,0,0,0,0,0,0.4826927225525911,0.5173072774474089
86884,0.5073891625615764,0.5348837209302326,-103,-115,0.4859403596076043,0.5140596403923957,away,CWS,over,8.5,0.5238095238095238,-110,0.4988662131519274,BAL,CWS,2022 REG,6,3,12,5,8,18,0,1,-2,2,1,1,1,0,0,0,0,0,0,0.4988662131519274,0.5011337868480725
86884,0.5073891625615764,0.5348837209302326,-103,-115,0.4859403596076043,0.5140596403923957,home,BAL,under,8.5,0.5238095238095238,-110,0.5011337868480725,BAL,CWS,2022 REG,6,3,12,5,8,18,0,1,-2,2,1,1,1,0,0,0,0,0,0,0.4988662131519274,0.5011337868480725
86885,0.5098039215686274,0.5348837209302326,-104,-115,0.4870219861770517,0.5129780138229483,away,CLE,over,9,0.5260663507109005,-111,0.5010269332605688,KC,CLE,2022 REG,11,5,5,1,6,16,1,0,4,-4,1,0,0,0,0,0,0,0,0,0.5010269332605688,0.4989730667394312
86885,0.5098039215686274,0.5348837209302326,-104,-115,0.4870219861770517,0.5129780138229483,home,KC,under,9,0.5215311004784688,-109,0.4989730667394312,KC,CLE,2022 REG,11,5,5,1,6,16,1,0,4,-4,1,0,0,0,0,0,0,0,0,0.5010269332605688,0.4989730667394312
86886,0.38167938931297707,0.6598639455782314,162,-194,0.36582315462167614,0.6341768453783239,away,NYY,over,9,0.5283018867924528,-112,0.5031902949311281,PIT,NYY,2022 REG,9,5,10,2,7,19,1,0,3,-3,1,1,0,0,0,0,0,0,0,0.5031902949311281,0.4968097050688719
86886,0.38167938931297707,0.6598639455782314,162,-194,0.36582315462167614,0.6341768453783239,home,PIT,under,9,0.5192307692307692,-108,0.4968097050688719,PIT,NYY,2022 REG,9,5,10,2,7,19,1,0,3,-3,1,1,0,0,0,0,0,0,0,0.5031902949311281,0.4968097050688719
86887,0.3846153846153846,0.6503496503496503,160,-186,0.3711672942442173,0.6288327057557828,away,PHI,over,11,0.5348837209302326,-115,0.5109810284308424,WSH,PHI,2022 REG,9,3,9,5,8,18,0,1,-2,2,1,1,1,0,0,0,0,0,0,0.5109810284308424,0.48901897156915763
86887,0.3846153846153846,0.6503496503496503,160,-186,0.3711672942442173,0.6288327057557828,home,WSH,under,11,0.5098039215686274,-104,0.48901897156915763,WSH,PHI,2022 REG,9,3,9,5,8,18,0,1,-2,2,1,1,1,0,0,0,0,0,0,0.5109810284308424,0.48901897156915763
86888,0.6666666666666666,0.37593984962406013,-200,166,0.6382623224728488,0.36173767752715125,away,KC,over,6.5,0.5454545454545454,-120,0.5206611570247933,CLE,KC,2022 REG,8,2,6,5,7,14,0,1,-3,3,1,1,0,0,0,0,0,0,0,0.5206611570247933,0.4793388429752067
86888,0.6666666666666666,0.37593984962406013,-200,166,0.6382623224728488,0.36173767752715125,home,CLE,under,6.5,0.5,100,0.4793388429752067,CLE,KC,2022 REG,8,2,6,5,7,14,0,1,-3,3,1,1,0,0,0,0,0,0,0,0.5206611570247933,0.4793388429752067
86889,0.4291845493562232,0.613899613899614,133,-159,0.41069349216487677,0.5893065078351232,away,ATL,over,12,0.5121951219512195,-105,0.48808156828023186,COL,ATL,2022 REG,3,2,10,6,8,13,0,1,-4,4,1,1,0,0,0,0,0,0,0,0.48808156828023186,0.5119184317197681
86889,0.4291845493562232,0.613899613899614,133,-159,0.41069349216487677,0.5893065078351232,home,COL,under,12,0.5348837209302326,-115,0.5119184317197681,COL,ATL,2022 REG,3,2,10,6,8,13,0,1,-4,4,1,1,0,0,0,0,0,0,0,0.48808156828023186,0.5119184317197681
86890,0.6491228070175439,0.390625,-185,156,0.6233215989535241,0.3766784010464759,away,SEA,over,7,0.5475113122171946,-121,0.5228602997583487,HOU,SEA,2022 REG,15,11,6,1,12,21,1,0,10,-10,1,0,0,0,0,0,0,0,0,0.5228602997583487,0.4771397002416513
86890,0.6491228070175439,0.390625,-185,156,0.6233215989535241,0.3766784010464759,home,HOU,under,7,0.49751243781094534,101,0.4771397002416513,HOU,SEA,2022 REG,15,11,6,1,12,21,1,0,10,-10,1,0,0,0,0,0,0,0,0,0.5228602997583487,0.4771397002416513
86891,0.5780590717299579,0.4608294930875576,-137,117,0.5555791840506346,0.44442081594936544,away,COL,over,9.5,0.5305164319248826,-113,0.5066009958897986,TEX,COL,2022 REG,9,4,14,6,10,23,0,1,-2,2,1,1,1,1,0,0,0,0,0,0.5066009958897986,0.49339900411020143
86891,0.5780590717299579,0.4608294930875576,-137,117,0.5555791840506346,0.44442081594936544,away,COL,over,10.5,0.5169082125603864,-107,0.49353874091423283,TEX,COL,2022 REG,9,4,14,6,10,23,0,1,-2,2,1,1,1,1,0,0,0,0,0,0.5066009958897986,0.49339900411020143
86891,0.5780590717299579,0.4608294930875576,-137,117,0.5555791840506346,0.44442081594936544,home,TEX,under,9.5,0.5145631067961165,-106,0.49339900411020143,TEX,COL,2022 REG,9,4,14,6,10,23,0,1,-2,2,1,1,1,1,0,0,0,0,0,0.5066009958897986,0.49339900411020143
86891,0.5780590717299579,0.4608294930875576,-137,117,0.5555791840506346,0.44442081594936544,home,TEX,under,10.5,0.5283018867924528,-112,0.5064612590857671,TEX,COL,2022 REG,9,4,14,6,10,23,0,1,-2,2,1,1,1,1,0,0,0,0,0,0.5066009958897986,0.49339900411020143
86892,0.7402597402597403,0.30120481927710846,-285,232,0.7095651961870081,0.2904348038129919,away,WSH,over,8.5,0.5121951219512195,-105,0.48808156828023186,SD,WSH,2022 REG,9,2,7,1,3,16,1,0,1,-1,1,0,0,0,0,0,0,0,0,0.48808156828023186,0.5119184317197681
86892,0.7402597402597403,0.30120481927710846,-285,232,0.7095651961870081,0.2904348038129919,home,SD,under,8.5,0.5348837209302326,-115,0.5119184317197681,SD,WSH,2022 REG,9,2,7,1,3,16,1,0,1,-1,1,0,0,0,0,0,0,0,0,0.48808156828023186,0.5119184317197681
86893,0.40322580645161293,0.6376811594202898,148,-176,0.38673106214842634,0.6132689378515737,away,CWS,over,7.5,0.5348837209302326,-115,0.5097020142727117,KC,CWS,2022 REG,8,5,14,3,8,22,1,0,2,-2,1,1,1,0,0,0,0,0,0,0.5097020142727117,0.49029798572728833
86893,0.40322580645161293,0.6376811594202898,148,-176,0.38673106214842634,0.6132689378515737,home,KC,under,7.5,0.5121951219512195,-105,0.49029798572728833,KC,CWS,2022 REG,8,5,14,3,8,22,1,0,2,-2,1,1,1,0,0,0,0,0,0,0.5097020142727117,0.49029798572728833
86894,0.5260663507109005,0.5121951219512195,-111,-105,0.5059382774147141,0.4940617225852859,away,MIL,over,9.5,0.5145631067961165,-106,0.49023796582517226,CIN,MIL,2022 REG,9,3,11,7,10,20,0,1,-4,4,1,1,1,0,0,0,0,0,0,0.49023796582517226,0.5097620341748277
86894,0.5260663507109005,0.5121951219512195,-111,-105,0.5059382774147141,0.4940617225852859,home,CIN,under,9.5,0.5327102803738317,-114,0.5097620341748277,CIN,MIL,2022 REG,9,3,11,7,10,20,0,1,-4,4,1,1,1,0,0,0,0,0,0,0.49023796582517226,0.5097620341748277
86895,0.46511627906976744,0.574468085106383,115,-135,0.44670494689481377,0.5532950531051862,away,NYM,over,10,0.5238095238095238,-110,0.5000596729920038,WSH,NYM,2022 REG,5,4,7,2,6,12,1,0,2,-2,1,1,0,0,0,0,0,0,0,0.5000596729920038,0.4999403270079962
86895,0.46511627906976744,0.574468085106383,115,-135,0.44670494689481377,0.5532950531051862,home,WSH,under,10,0.5215311004784688,-109,0.4999403270079962,WSH,NYM,2022 REG,5,4,7,2,6,12,1,0,2,-2,1,1,0,0,0,0,0,0,0,0.5000596729920038,0.4999403270079962
86896,0.726027397260274,0.3125,-265,220,0.6980554513041847,0.30194454869581533,away,OAK,over,6.5,0.5454545454545454,-120,0.5206611570247933,SF,OAK,2022 REG,7,8,5,2,10,12,1,0,6,-6,1,1,0,0,0,0,0,0,0,0.5206611570247933,0.4793388429752067
86896,0.726027397260274,0.3125,-265,220,0.6980554513041847,0.30194454869581533,home,SF,under,6.5,0.5,100,0.4793388429752067,SF,OAK,2022 REG,7,8,5,2,10,12,1,0,6,-6,1,1,0,0,0,0,0,0,0,0.5206611570247933,0.4793388429752067
86897,0.5454545454545454,0.49751243781094534,-120,101,0.5220180091279142,0.4779819908720858,away,CIN,over,8.5,0.5370370370370371,-116,0.5131785224377817,PIT,CIN,2022 REG,10,5,13,9,14,23,0,1,-4,4,1,1,1,1,1,0,0,0,0,0.5131785224377817,0.4868214775622183
86897,0.5454545454545454,0.49751243781094534,-120,101,0.5220180091279142,0.4779819908720858,home,PIT,under,8.5,0.5073891625615764,-103,0.4868214775622183,PIT,CIN,2022 REG,10,5,13,9,14,23,0,1,-4,4,1,1,1,1,1,0,0,0,0,0.5131785224377817,0.4868214775622183
86898,0.782608695652174,0.2531645569620253,-360,295,0.7546122370845398,0.24538776291546016,away,CIN,over,8,0.5391705069124424,-117,0.5140669063204599,PHI,CIN,2022 REG,7,4,5,0,4,12,1,0,4,-4,0,0,0,0,0,0,0,0,0,0.5140669063204599,0.4859330936795401
86898,0.782608695652174,0.2531645569620253,-360,295,0.7546122370845398,0.24538776291546016,home,PHI,under,8,0.5073891625615764,-103,0.4859330936795401,PHI,CIN,2022 REG,7,4,5,0,4,12,1,0,4,-4,0,0,0,0,0,0,0,0,0,0.5140669063204599,0.4859330936795401
86899,0.613899613899614,0.42372881355932196,-159,136,0.5907995368109236,0.40920046318907644,away,ARI,over,6.5,0.5283018867924528,-112,0.5044173060022736,MIA,ARI,2022 REG,8,4,9,5,9,17,0,1,-1,1,1,1,1,1,0,0,0,0,0,0.5044173060022736,0.49558269399772636
86899,0.613899613899614,0.42372881355932196,-159,136,0.5907995368109236,0.40920046318907644,home,MIA,under,6.5,0.5169082125603864,-107,0.49558269399772636,MIA,ARI,2022 REG,8,4,9,5,9,17,0,1,-1,1,1,1,1,1,0,0,0,0,0,0.5044173060022736,0.49558269399772636
86900,0.6376811594202898,0.4,-176,150,0.6136525939928585,0.38634740600714146,away,TB,over,7,0.5121951219512195,-105,0.48808156828023186,HOU,TB,2022 REG,7,3,10,7,10,17,0,1,-4,4,1,1,1,0,0,0,0,0,0,0.48808156828023186,0.5119184317197681
86900,0.6376811594202898,0.4,-176,150,0.6136525939928585,0.38634740600714146,home,HOU,under,7,0.5348837209302326,-115,0.5119184317197681,HOU,TB,2022 REG,7,3,10,7,10,17,0,1,-4,4,1,1,1,0,0,0,0,0,0,0.48808156828023186,0.5119184317197681
86902,0.6212121212121212,0.42372881355932196,-164,136,0.5932942677934975,0.4067057322065025,away,DET,over,8,0.5454545454545454,-120,0.5206611570247933,TEX,DET,2022 REG,11,7,7,6,13,18,1,0,1,-1,1,1,1,1,1,1,0,0,0,0.5206611570247933,0.4793388429752067
86902,0.6212121212121212,0.42372881355932196,-164,136,0.5932942677934975,0.4067057322065025,home,TEX,under,8,0.5,100,0.4793388429752067,TEX,DET,2022 REG,11,7,7,6,13,18,1,0,1,-1,1,1,1,1,1,1,0,0,0,0.5206611570247933,0.4793388429752067
86903,0.6666666666666666,0.37037037037037035,-200,170,0.6419753086419753,0.3580246913580247,away,CWS,over,7,0.5260663507109005,-111,0.5022370601254724,SEA,CWS,2022 REG,7,6,8,9,15,15,0,1,-3,3,1,1,1,1,1,1,0,0,0,0.5022370601254724,0.4977629398745276
86903,0.6666666666666666,0.37037037037037035,-200,170,0.6419753086419753,0.3580246913580247,home,SEA,under,7,0.5192307692307692,-108,0.4977629398745276,SEA,CWS,2022 REG,7,6,8,9,15,15,0,1,-3,3,1,1,1,1,1,1,0,0,0,0.5022370601254724,0.4977629398745276
86904,0.6389891696750902,0.4,-177,150,0.614075512518083,0.385924487481917,away,MIA,over,7,0.5238095238095238,-110,0.4988662131519274,MIL,MIA,2022 REG,7,3,10,4,7,17,0,1,-1,1,1,1,1,0,0,0,0,0,0,0.4988662131519274,0.5011337868480725
86904,0.6389891696750902,0.4,-177,150,0.614075512518083,0.385924487481917,home,MIL,under,7,0.5238095238095238,-110,0.5011337868480725,MIL,MIA,2022 REG,7,3,10,4,7,17,0,1,-1,1,1,1,1,0,0,0,0,0,0,0.4988662131519274,0.5011337868480725
86905,0.30120481927710846,0.7354497354497355,232,-278,0.29016429074492656,0.7098357092550734,away,SD,over,9,0.5073891625615764,-103,0.4837652908580103,WSH,SD,2022 REG,7,0,9,6,6,16,0,1,-6,6,0,0,0,0,0,0,0,0,0,0.4837652908580103,0.5162347091419897
86905,0.30120481927710846,0.7354497354497355,232,-278,0.29016429074492656,0.7098357092550734,home,WSH,under,9,0.5391705069124424,-117,0.5162347091419897,WSH,SD,2022 REG,7,0,9,6,6,16,0,1,-6,6,0,0,0,0,0,0,0,0,0,0.4837652908580103,0.5162347091419897
86906,0.4716981132075471,0.5614035087719298,112,-128,0.4560841405757184,0.5439158594242817,away,PHI,over,7.5,0.49504950495049505,102,0.47297076509898783,ARI,PHI,2022 REG,17,12,4,3,15,21,1,0,9,-9,1,1,1,0,0,0,0,0,0,0.47297076509898783,0.5270292349010122
86906,0.4716981132075471,0.5614035087719298,112,-128,0.4560841405757184,0.5439158594242817,home,ARI,under,7.5,0.5495495495495495,-122,0.5270292349010122,ARI,PHI,2022 REG,17,12,4,3,15,21,1,0,9,-9,1,1,1,0,0,0,0,0,0,0.47297076509898783,0.5270292349010122
86907,0.6677740863787376,0.373134328358209,-201,168,0.6404565071025706,0.3595434928974294,away,WSH,over,9,0.5260663507109005,-111,0.5010269332605688,PHI,WSH,2022 REG,9,7,3,2,9,12,1,0,5,-5,1,1,0,0,0,0,0,0,0,0.5010269332605688,0.4989730667394312
86907,0.6677740863787376,0.373134328358209,-201,168,0.6404565071025706,0.3595434928974294,home,PHI,under,9,0.5215311004784688,-109,0.4989730667394312,PHI,WSH,2022 REG,9,7,3,2,9,12,1,0,5,-5,1,1,0,0,0,0,0,0,0,0.5010269332605688,0.4989730667394312
86908,0.45454545454545453,0.5850622406639003,120,-141,0.4365419567230205,0.5634580432769796,away,ARI,over,7.5,0.5215311004784688,-109,0.49907282342437215,PIT,ARI,2022 REG,9,3,5,0,3,14,1,0,3,-3,0,0,0,0,0,0,0,0,0,0.49907282342437215,0.5009271765756278
86908,0.45454545454545453,0.5850622406639003,120,-141,0.4365419567230205,0.5634580432769796,home,PIT,under,7.5,0.5215311004784688,-109,0.5009271765756278,PIT,ARI,2022 REG,9,3,5,0,3,14,1,0,3,-3,0,0,0,0,0,0,0,0,0,0.49907282342437215,0.5009271765756278
86909,0.5215311004784688,0.5238095238095238,-109,-110,0.4978845547971712,0.5021154452028288,away,BOS,over,8.5,0.5169082125603864,-107,0.49353874091423283,BAL,BOS,2022 REG,8,4,21,17,21,29,0,1,-13,13,1,1,1,1,0,0,0,0,0,0.49353874091423283,0.5064612590857671
86909,0.5215311004784688,0.5238095238095238,-109,-110,0.4978845547971712,0.5021154452028288,home,BAL,under,8.5,0.5283018867924528,-112,0.5064612590857671,BAL,BOS,2022 REG,8,4,21,17,21,29,0,1,-13,13,1,1,1,1,0,0,0,0,0,0.49353874091423283,0.5064612590857671
86910,0.607843137254902,0.4347826086956522,-155,130,0.5819333701084867,0.41806662989151333,away,MIN,over,8.5,0.5348837209302326,-115,0.5097020142727117,CLE,MIN,2022 REG,3,5,7,3,8,10,1,0,2,-2,1,1,1,0,0,0,0,0,0,0.5097020142727117,0.49029798572728833
86910,0.607843137254902,0.4347826086956522,-155,130,0.5819333701084867,0.41806662989151333,home,CLE,under,8.5,0.5121951219512195,-105,0.49029798572728833,CLE,MIN,2022 REG,3,5,7,3,8,10,1,0,2,-2,1,1,1,0,0,0,0,0,0,0.5097020142727117,0.49029798572728833
86911,0.4166666666666667,0.6254681647940076,140,-167,0.3991104868913858,0.6008895131086143,away,SD,over,9.5,0.5169082125603864,-107,0.49586088023391106,ARI,SD,2022 REG,5,5,8,10,15,13,0,1,-5,5,1,1,1,1,1,0,0,0,0,0.49586088023391106,0.5041391197660889
86911,0.4166666666666667,0.6254681647940076,140,-167,0.3991104868913858,0.6008895131086143,home,ARI,under,9.5,0.5238095238095238,-110,0.5041391197660889,ARI,SD,2022 REG,5,5,8,10,15,13,0,1,-5,5,1,1,1,1,1,0,0,0,0,0.49586088023391106,0.5041391197660889
86912,0.47619047619047616,0.5555555555555556,110,-125,0.46107331821617537,0.5389266817838246,away,SF,over,7.5,0.5348837209302326,-115,0.5097020142727117,STL,SF,2022 REG,6,2,8,8,10,14,0,1,-6,6,1,1,0,0,0,0,0,0,0,0.5097020142727117,0.49029798572728833
86912,0.47619047619047616,0.5555555555555556,110,-125,0.46107331821617537,0.5389266817838246,home,STL,under,7.5,0.5121951219512195,-105,0.49029798572728833,STL,SF,2022 REG,6,2,8,8,10,14,0,1,-6,6,1,1,0,0,0,0,0,0,0,0.5097020142727117,0.49029798572728833
86913,0.5121951219512195,0.5348837209302326,-105,-115,0.48808156828023186,0.5119184317197681,away,NYY,over,9,0.5169082125603864,-107,0.49353874091423283,TOR,NYY,2022 REG,5,3,14,12,15,19,0,1,-9,9,1,1,1,0,0,0,0,0,0,0.49353874091423283,0.5064612590857671
86913,0.5121951219512195,0.5348837209302326,-105,-115,0.48808156828023186,0.5119184317197681,home,TOR,under,9,0.5283018867924528,-112,0.5064612590857671,TOR,NYY,2022 REG,5,3,14,12,15,19,0,1,-9,9,1,1,1,0,0,0,0,0,0,0.49353874091423283,0.5064612590857671
86914,0.7014925373134329,0.3389830508474576,-235,195,0.6730992142751963,0.32690078572480374,away,MIN,over,8,0.5327102803738317,-114,0.508788710910954,HOU,MIN,2022 REG,6,5,4,3,8,10,1,0,2,-2,1,1,1,0,0,0,0,0,0,0.508788710910954,0.491211289089046
86914,0.7014925373134329,0.3389830508474576,-235,195,0.6730992142751963,0.32690078572480374,home,HOU,under,8,0.5121951219512195,-105,0.491211289089046,HOU,MIN,2022 REG,6,5,4,3,8,10,1,0,2,-2,1,1,1,0,0,0,0,0,0,0.508788710910954,0.491211289089046
86915,0.5370370370370371,0.5024875621890548,-116,-101,0.5158108633785803,0.4841891366214197,away,ARI,over,11.5,0.5348837209302326,-115,0.5097020142727117,COL,ARI,2022 REG,6,3,11,9,12,17,0,1,-6,6,1,1,1,0,0,0,0,0,0,0.5097020142727117,0.49029798572728833
86915,0.5370370370370371,0.5024875621890548,-116,-101,0.5158108633785803,0.4841891366214197,home,COL,under,11.5,0.5121951219512195,-105,0.49029798572728833,COL,ARI,2022 REG,6,3,11,9,12,17,0,1,-6,6,1,1,1,0,0,0,0,0,0,0.5097020142727117,0.49029798572728833
86916,0.5391705069124424,0.5,-117,100,0.5180509248444435,0.4819490751555565,away,CWS,over,7,0.5,100,0.4772727272727273,TB,CWS,2022 REG,4,2,7,3,5,11,0,1,-1,1,1,1,0,0,0,0,0,0,0,0.4772727272727273,0.5227272727272727
86916,0.5391705069124424,0.5,-117,100,0.5180509248444435,0.4819490751555565,home,TB,under,7,0.5454545454545454,-120,0.5227272727272727,TB,CWS,2022 REG,4,2,7,3,5,11,0,1,-1,1,1,1,0,0,0,0,0,0,0,0.4772727272727273,0.5227272727272727
86917,0.3105590062111801,0.726027397260274,222,-265,0.29919676910824405,0.700803230891756,away,LAD,over,7,0.504950495049505,-102,0.4826715732667395,MIA,LAD,2022 REG,2,1,14,8,9,16,0,1,-7,7,1,0,0,0,0,0,0,0,0,0.4826715732667395,0.5173284267332605
86917,0.3105590062111801,0.726027397260274,222,-265,0.29919676910824405,0.700803230891756,home,MIA,under,7,0.5391705069124424,-117,0.5173284267332605,MIA,LAD,2022 REG,2,1,14,8,9,16,0,1,-7,7,1,0,0,0,0,0,0,0,0,0.4826715732667395,0.5173284267332605
86918,0.5555555555555556,0.4807692307692307,-125,108,0.5353751187084521,0.4646248812915479,away,BOS,over,7.5,0.49504950495049505,102,0.47499799484898986,TB,BOS,2022 REG,9,5,7,4,9,16,1,0,1,-1,1,1,1,1,0,0,0,0,0,0.47499799484898986,0.5250020051510101
86918,0.5555555555555556,0.4807692307692307,-125,108,0.5353751187084521,0.4646248812915479,home,TB,under,7.5,0.5454545454545454,-120,0.5250020051510101,TB,BOS,2022 REG,9,5,7,4,9,16,1,0,1,-1,1,1,1,1,0,0,0,0,0,0.47499799484898986,0.5250020051510101
86919,0.41493775933609955,0.6240601503759399,141,-166,0.3987560540613944,0.6012439459386056,away,LAD,over,8,0.5348837209302326,-115,0.5097020142727117,MIL,LAD,2022 REG,4,1,6,2,3,10,0,1,-1,1,1,0,0,0,0,0,0,0,0,0.5097020142727117,0.49029798572728833
86919,0.41493775933609955,0.6240601503759399,141,-166,0.3987560540613944,0.6012439459386056,home,MIL,under,8,0.5121951219512195,-105,0.49029798572728833,MIL,LAD,2022 REG,4,1,6,2,3,10,0,1,-1,1,1,0,0,0,0,0,0,0,0,0.5097020142727117,0.49029798572728833
86920,0.6309963099630996,0.40485829959514175,-171,147,0.6083721836366817,0.39162781636331834,away,OAK,over,9,0.504950495049505,-102,0.4826715732667395,TEX,OAK,2022 REG,6,2,9,7,9,15,0,1,-5,5,1,1,0,0,0,0,0,0,0,0.4826715732667395,0.5173284267332605
86920,0.6309963099630996,0.40485829959514175,-171,147,0.6083721836366817,0.39162781636331834,home,TEX,under,9,0.5391705069124424,-117,0.5173284267332605,TEX,OAK,2022 REG,6,2,9,7,9,15,0,1,-5,5,1,1,0,0,0,0,0,0,0,0.4826715732667395,0.5173284267332605
86921,0.5,0.5412844036697247,100,-118,0.47935779816513757,0.5206422018348624,away,ATL,over,8.5,0.5098039215686274,-104,0.48592421718142587,ARI,ATL,2022 REG,7,6,8,2,8,15,1,0,4,-4,1,1,0,0,0,0,0,0,0,0.48592421718142587,0.5140757828185741
86921,0.5,0.5412844036697247,100,-118,0.47935779816513757,0.5206422018348624,home,ARI,under,8.5,0.5370370370370371,-116,0.5140757828185741,ARI,ATL,2022 REG,7,6,8,2,8,15,1,0,4,-4,1,1,0,0,0,0,0,0,0,0.48592421718142587,0.5140757828185741
86922,0.6688741721854304,0.3663003663003663,-202,173,0.6453468318737386,0.35465316812626135,away,WSH,over,8.5,0.5412844036697247,-118,0.5189377998484975,PHI,WSH,2022 REG,13,5,10,3,8,23,1,0,2,-2,1,1,1,0,0,0,0,0,0,0.5189377998484975,0.4810622001515025
86922,0.6688741721854304,0.3663003663003663,-202,173,0.6453468318737386,0.35465316812626135,home,PHI,under,8.5,0.5,100,0.4810622001515025,PHI,WSH,2022 REG,13,5,10,3,8,23,1,0,2,-2,1,1,1,0,0,0,0,0,0,0.5189377998484975,0.4810622001515025
86923,0.4854368932038835,0.5495495495495495,106,-122,0.4684531831294015,0.5315468168705986,away,LAA,over,8.5,0.5169082125603864,-107,0.49353874091423283,CWS,LAA,2022 REG,12,5,8,6,11,20,0,1,-1,1,1,1,1,1,1,0,0,0,0,0.49353874091423283,0.5064612590857671
86923,0.4854368932038835,0.5495495495495495,106,-122,0.4684531831294015,0.5315468168705986,home,CWS,under,8.5,0.5283018867924528,-112,0.5064612590857671,CWS,LAA,2022 REG,12,5,8,6,11,20,0,1,-1,1,1,1,1,1,1,0,0,0,0,0.49353874091423283,0.5064612590857671
86924,0.48780487804878053,0.5495495495495495,105,-122,0.4695832060495952,0.5304167939504048,away,TB,over,7,0.5121951219512195,-105,0.48919479393107135,OAK,TB,2022 REG,4,0,6,3,3,10,0,1,-3,3,0,0,0,0,0,0,0,0,0,0.48919479393107135,0.5108052060689287
86924,0.48780487804878053,0.5495495495495495,105,-122,0.4695832060495952,0.5304167939504048,home,OAK,under,7,0.5327102803738317,-114,0.5108052060689287,OAK,TB,2022 REG,4,0,6,3,3,10,0,1,-3,3,0,0,0,0,0,0,0,0,0,0.48919479393107135,0.5108052060689287
86925,0.4739336492890995,0.5614035087719298,111,-128,0.45718618101373015,0.5428138189862699,away,HOU,over,7,0.5,100,0.4762443438914027,TB,HOU,2022 REG,7,2,10,5,7,17,0,1,-3,3,1,1,0,0,0,0,0,0,0,0.4762443438914027,0.5237556561085973
86925,0.4739336492890995,0.5614035087719298,111,-128,0.45718618101373015,0.5428138189862699,home,TB,under,7,0.5475113122171946,-121,0.5237556561085973,TB,HOU,2022 REG,7,2,10,5,7,17,0,1,-3,3,1,1,0,0,0,0,0,0,0,0.4762443438914027,0.5237556561085973
86926,0.6389891696750902,0.39840637450199207,-177,151,0.6150938219518283,0.38490617804817173,away,BAL,over,8,0.5,100,0.4772727272727273,NYY,BAL,2022 REG,4,1,5,2,3,9,0,1,-1,1,1,0,0,0,0,0,0,0,0,0.4772727272727273,0.5227272727272727
86926,0.6389891696750902,0.39840637450199207,-177,151,0.6150938219518283,0.38490617804817173,home,NYY,under,8,0.5454545454545454,-120,0.5227272727272727,NYY,BAL,2022 REG,4,1,5,2,3,9,0,1,-1,1,1,0,0,0,0,0,0,0,0,0.4772727272727273,0.5227272727272727
86927,0.4694835680751174,0.5708154506437768,113,-133,0.45056384097704505,0.549436159022955,away,SEA,over,9,0.5121951219512195,-105,0.48808156828023186,BAL,SEA,2022 REG,5,0,13,10,10,18,0,1,-10,10,0,0,0,0,0,0,0,0,0,0.48808156828023186,0.5119184317197681
86927,0.4694835680751174,0.5708154506437768,113,-133,0.45056384097704505,0.549436159022955,home,BAL,under,9,0.5348837209302326,-115,0.5119184317197681,BAL,SEA,2022 REG,5,0,13,10,10,18,0,1,-10,10,0,0,0,0,0,0,0,0,0,0.48808156828023186,0.5119184317197681
86928,0.5073891625615764,0.5327102803738317,-103,-114,0.487043139791394,0.512956860208606,away,TB,over,9,0.5283018867924528,-112,0.5044173060022736,CHC,TB,2022 REG,4,2,9,8,10,13,0,1,-6,6,1,1,0,0,0,0,0,0,0,0.5044173060022736,0.49558269399772636
86928,0.5073891625615764,0.5327102803738317,-103,-114,0.487043139791394,0.512956860208606,home,CHC,under,9,0.5169082125603864,-107,0.49558269399772636,CHC,TB,2022 REG,4,2,9,8,10,13,0,1,-6,6,1,1,0,0,0,0,0,0,0,0.5044173060022736,0.49558269399772636
86929,0.6721311475409836,0.36764705882352944,-205,172,0.6453949760500813,0.35460502394991866,away,DET,over,8.5,0.5121951219512195,-105,0.48808156828023186,CLE,DET,2022 REG,8,5,15,7,12,23,0,1,-2,2,1,1,1,1,1,0,0,0,0,0.48808156828023186,0.5119184317197681
86929,0.6721311475409836,0.36764705882352944,-205,172,0.6453949760500813,0.35460502394991866,home,CLE,under,8.5,0.5348837209302326,-115,0.5119184317197681,CLE,DET,2022 REG,8,5,15,7,12,23,0,1,-2,2,1,1,1,1,1,0,0,0,0,0.48808156828023186,0.5119184317197681
86930,0.6923076923076923,0.3448275862068966,-225,190,0.6665986533360538,0.33340134666394616,away,PHI,over,8,0.5412844036697247,-118,0.5189377998484975,LAD,PHI,2022 REG,12,10,15,12,22,27,0,1,-2,2,1,1,1,1,1,1,1,1,1,0.5189377998484975,0.4810622001515025
86930,0.6923076923076923,0.3448275862068966,-225,190,0.6665986533360538,0.33340134666394616,home,LAD,under,8,0.5,100,0.4810622001515025,LAD,PHI,2022 REG,12,10,15,12,22,27,0,1,-2,2,1,1,1,1,1,1,1,1,1,0.5189377998484975,0.4810622001515025
86931,0.6153846153846154,0.42194092827004215,-160,137,0.5924150500586723,0.40758494994132766,away,PIT,over,8.5,0.5433789954337899,-119,0.5198077604720502,CHC,PIT,2022 REG,13,9,3,0,9,16,1,0,9,-9,0,0,0,0,0,0,0,0,0,0.5198077604720502,0.48019223952794976
86931,0.6153846153846154,0.42194092827004215,-160,137,0.5924150500586723,0.40758494994132766,home,CHC,under,8.5,0.5,100,0.48019223952794976,CHC,PIT,2022 REG,13,9,3,0,9,16,1,0,9,-9,0,0,0,0,0,0,0,0,0,0.5198077604720502,0.48019223952794976
86932,0.7101449275362319,0.3278688524590164,-245,205,0.6831496344961281,0.3168503655038719,away,PHI,over,7,0.5024875621890548,-101,0.48049269377245407,NYM,PHI,2022 REG,5,1,10,2,3,15,0,1,-1,1,1,0,0,0,0,0,0,0,0,0.48049269377245407,0.5195073062275459
86932,0.7101449275362319,0.3278688524590164,-245,205,0.6831496344961281,0.3168503655038719,home,NYM,under,7,0.5412844036697247,-118,0.5195073062275459,NYM,PHI,2022 REG,5,1,10,2,3,15,0,1,-1,1,1,0,0,0,0,0,0,0,0,0.48049269377245407,0.5195073062275459
86933,0.6894409937888198,0.35714285714285715,-222,180,0.6573241773079742,0.3426758226920258,away,CIN,over,7.5,0.5,100,0.4772727272727273,SD,CIN,2022 REG,8,6,5,2,8,13,1,0,4,-4,1,1,0,0,0,0,0,0,0,0.4772727272727273,0.5227272727272727
86933,0.6894409937888198,0.35714285714285715,-222,180,0.6573241773079742,0.3426758226920258,home,SD,under,7.5,0.5454545454545454,-120,0.5227272727272727,SD,CIN,2022 REG,8,6,5,2,8,13,1,0,4,-4,1,1,0,0,0,0,0,0,0,0.4772727272727273,0.5227272727272727
86935,0.5594713656387665,0.4854368932038835,-127,106,0.53434648073561,0.46565351926439,away,MIL,over,8.5,0.5121951219512195,-105,0.48808156828023186,MIN,MIL,2022 REG,10,4,4,1,5,14,1,0,3,-3,1,0,0,0,0,0,0,0,0,0.48808156828023186,0.5119184317197681
86935,0.5594713656387665,0.4854368932038835,-127,106,0.53434648073561,0.46565351926439,home,MIN,under,8.5,0.5348837209302326,-115,0.5119184317197681,MIN,MIL,2022 REG,10,4,4,1,5,14,1,0,3,-3,1,0,0,0,0,0,0,0,0,0.48808156828023186,0.5119184317197681
86936,0.6428571428571428,0.3921568627450981,-180,155,0.6203481392557023,0.3796518607442977,away,CWS,over,8,0.5454545454545454,-120,0.5206611570247933,TOR,CWS,2022 REG,12,8,7,3,11,19,1,0,5,-5,1,1,1,0,0,0,0,0,0,0.5206611570247933,0.4793388429752067
86936,0.6428571428571428,0.3921568627450981,-180,155,0.6203481392557023,0.3796518607442977,home,TOR,under,8,0.5,100,0.4793388429752067,TOR,CWS,2022 REG,12,8,7,3,11,19,1,0,5,-5,1,1,1,0,0,0,0,0,0,0.5206611570247933,0.4793388429752067
86937,0.7311827956989247,0.3105590062111801,-272,222,0.7006619082807836,0.29933809171921644,away,CIN,over,8.5,0.5348837209302326,-115,0.5097020142727117,LAD,CIN,2022 REG,14,9,6,3,12,20,1,0,6,-6,1,1,1,0,0,0,0,0,0,0.5097020142727117,0.49029798572728833
86937,0.7311827956989247,0.3105590062111801,-272,222,0.7006619082807836,0.29933809171921644,home,LAD,under,8.5,0.5121951219512195,-105,0.49029798572728833,LAD,CIN,2022 REG,14,9,6,3,12,20,1,0,6,-6,1,1,1,0,0,0,0,0,0,0.5097020142727117,0.49029798572728833
86938,0.6240601503759399,0.4166666666666667,-166,140,0.5986441668079975,0.4013558331920025,away,STL,over,6.5,0.5454545454545454,-120,0.5206611570247933,TB,STL,2022 REG,3,2,2,1,3,5,1,0,1,-1,1,0,0,0,0,0,0,0,0,0.5206611570247933,0.4793388429752067
86938,0.6240601503759399,0.4166666666666667,-166,140,0.5986441668079975,0.4013558331920025,home,TB,under,6.5,0.5,100,0.4793388429752067,TB,STL,2022 REG,3,2,2,1,3,5,1,0,1,-1,1,0,0,0,0,0,0,0,0,0.5206611570247933,0.4793388429752067
86939,0.7275204359673024,0.31545741324921134,-267,217,0.6962531723683673,0.30374682763163274,away,TEX,over,7.5,0.5305164319248826,-113,0.5066009958897986,HOU,TEX,2022 REG,8,3,8,4,7,16,0,1,-1,1,1,1,1,0,0,0,0,0,0,0.5066009958897986,0.49339900411020143
86939,0.7275204359673024,0.31545741324921134,-267,217,0.6962531723683673,0.30374682763163274,home,HOU,under,7.5,0.5145631067961165,-106,0.49339900411020143,HOU,TEX,2022 REG,8,3,8,4,7,16,0,1,-1,1,1,1,1,0,0,0,0,0,0,0.5066009958897986,0.49339900411020143
86940,0.4504504504504505,0.6031746031746031,122,-152,0.4262950208896156,0.5737049791103844,away,LAA,over,7.5,0.5454545454545454,-120,0.5233614270517961,OAK,LAA,2022 REG,2,0,6,2,2,8,0,1,-2,2,0,0,0,0,0,0,0,0,0,0.5233614270517961,0.4766385729482039
86940,0.4504504504504505,0.6031746031746031,122,-152,0.4262950208896156,0.5737049791103844,home,OAK,under,7.5,0.49504950495049505,102,0.4766385729482039,OAK,LAA,2022 REG,2,0,6,2,2,8,0,1,-2,2,0,0,0,0,0,0,0,0,0,0.5233614270517961,0.4766385729482039
86941,0.5867768595041323,0.45454545454545453,-142,120,0.5625298818386723,0.43747011816132775,away,CHC,over,7,0.5,100,0.4772727272727273,MIA,CHC,2022 REG,14,10,6,3,13,20,1,0,7,-7,1,1,1,0,0,0,0,0,0,0.4772727272727273,0.5227272727272727
86941,0.5867768595041323,0.45454545454545453,-142,120,0.5625298818386723,0.43747011816132775,home,MIA,under,7,0.5454545454545454,-120,0.5227272727272727,MIA,CHC,2022 REG,14,10,6,3,13,20,1,0,7,-7,1,1,1,0,0,0,0,0,0,0.4772727272727273,0.5227272727272727
86942,0.7701149425287357,0.27027027027027023,-335,270,0.7390136866950185,0.26098631330498145,away,KC,over,9,0.5169082125603864,-107,0.4946943078742622,TOR,KC,2022 REG,7,4,7,2,6,14,1,0,2,-2,1,1,0,0,0,0,0,0,0,0.4946943078742622,0.5053056921257377
86942,0.7701149425287357,0.27027027027027023,-335,270,0.7390136866950185,0.26098631330498145,home,TOR,under,9,0.5260663507109005,-111,0.5053056921257377,TOR,KC,2022 REG,7,4,7,2,6,14,1,0,2,-2,1,1,0,0,0,0,0,0,0,0.4946943078742622,0.5053056921257377
86943,0.35714285714285715,0.6794871794871794,180,-212,0.3440607012035584,0.6559392987964416,away,TOR,over,8.5,0.5121951219512195,-105,0.48919479393107135,TEX,TOR,2022 REG,13,7,15,11,18,28,0,1,-4,4,1,1,1,1,1,1,1,0,0,0.48919479393107135,0.5108052060689287
86943,0.35714285714285715,0.6794871794871794,180,-212,0.3440607012035584,0.6559392987964416,home,TEX,under,8.5,0.5327102803738317,-114,0.5108052060689287,TEX,TOR,2022 REG,13,7,15,11,18,28,0,1,-4,4,1,1,1,1,1,1,1,0,0,0.48919479393107135,0.5108052060689287
86944,0.4291845493562232,0.6108949416342413,133,-157,0.4119830510770539,0.5880169489229461,away,LAD,over,9,0.5,100,0.4783105022831051,SF,LAD,2022 REG,10,7,6,2,9,16,1,0,5,-5,1,1,0,0,0,0,0,0,0,0.4783105022831051,0.5216894977168949
86944,0.4291845493562232,0.6108949416342413,133,-157,0.4119830510770539,0.5880169489229461,home,SF,under,9,0.5433789954337899,-119,0.5216894977168949,SF,LAD,2022 REG,10,7,6,2,9,16,1,0,5,-5,1,1,0,0,0,0,0,0,0,0.4783105022831051,0.5216894977168949
86945,0.6610169491525424,0.38167938931297707,-195,162,0.6327939457600804,0.3672060542399196,away,ARI,over,7.5,0.5327102803738317,-114,0.508788710910954,STL,ARI,2022 REG,9,7,7,5,12,16,1,0,2,-2,1,1,1,1,1,0,0,0,0,0.508788710910954,0.491211289089046
86945,0.6610169491525424,0.38167938931297707,-195,162,0.6327939457600804,0.3672060542399196,home,STL,under,7.5,0.5121951219512195,-105,0.491211289089046,STL,ARI,2022 REG,9,7,7,5,12,16,1,0,2,-2,1,1,1,1,1,0,0,0,0,0.508788710910954,0.491211289089046
86946,0.5098039215686274,0.5305164319248826,-104,-113,0.4892484472386027,0.5107515527613973,away,TB,over,8,0.5348837209302326,-115,0.5097020142727117,LAA,TB,2022 REG,18,12,0,0,12,18,1,0,12,-12,0,0,0,0,0,0,0,0,0,0.5097020142727117,0.49029798572728833
86946,0.5098039215686274,0.5305164319248826,-104,-113,0.4892484472386027,0.5107515527613973,home,LAA,under,8,0.5121951219512195,-105,0.49029798572728833,LAA,TB,2022 REG,18,12,0,0,12,18,1,0,12,-12,0,0,0,0,0,0,0,0,0,0.5097020142727117,0.49029798572728833
86947,0.601593625498008,0.44052863436123346,-151,127,0.5762531424751177,0.4237468575248823,away,MIL,over,8,0.5327102803738317,-114,0.508788710910954,PHI,MIL,2022 REG,5,0,3,1,1,8,0,1,-1,1,0,0,0,0,0,0,0,0,0,0.508788710910954,0.491211289089046
86947,0.601593625498008,0.44052863436123346,-151,127,0.5762531424751177,0.4237468575248823,home,PHI,under,8,0.5121951219512195,-105,0.491211289089046,PHI,MIL,2022 REG,5,0,3,1,1,8,0,1,-1,1,0,0,0,0,0,0,0,0,0,0.508788710910954,0.491211289089046
86948,0.726027397260274,0.3125,-265,220,0.6980554513041847,0.30194454869581533,away,OAK,over,8.5,0.5391705069124424,-117,0.5140669063204599,TOR,OAK,2022 REG,7,4,6,3,7,13,1,0,1,-1,1,1,1,0,0,0,0,0,0,0.5140669063204599,0.4859330936795401
86948,0.726027397260274,0.3125,-265,220,0.6980554513041847,0.30194454869581533,home,TOR,under,8.5,0.5073891625615764,-103,0.4859330936795401,TOR,OAK,2022 REG,7,4,6,3,7,13,1,0,1,-1,1,1,1,0,0,0,0,0,0,0.5140669063204599,0.4859330936795401
86949,0.5934959349593496,0.4484304932735426,-146,123,0.5686127702357632,0.4313872297642368,away,KC,over,7.5,0.49504950495049505,102,0.4739797934813417,DET,KC,2022 REG,9,4,11,7,11,20,0,1,-3,3,1,1,1,1,0,0,0,0,0,0.4739797934813417,0.5260202065186583
86949,0.5934959349593496,0.4484304932735426,-146,123,0.5686127702357632,0.4313872297642368,home,DET,under,7.5,0.5475113122171946,-121,0.5260202065186583,DET,KC,2022 REG,9,4,11,7,11,20,0,1,-3,3,1,1,1,1,0,0,0,0,0,0.4739797934813417,0.5260202065186583
86950,0.4166666666666667,0.6226415094339623,140,-165,0.4002882599580712,0.5997117400419287,away,CLE,over,7.5,0.5,100,0.4772727272727273,DET,CLE,2022 REG,9,8,8,2,10,17,1,0,6,-6,1,1,0,0,0,0,0,0,0,0.4772727272727273,0.5227272727272727
86950,0.4166666666666667,0.6226415094339623,140,-165,0.4002882599580712,0.5997117400419287,home,DET,under,7.5,0.5454545454545454,-120,0.5227272727272727,DET,CLE,2022 REG,9,8,8,2,10,17,1,0,6,-6,1,1,0,0,0,0,0,0,0,0.4772727272727273,0.5227272727272727
86951,0.49504950495049505,0.5495495495495495,102,-122,0.47297076509898783,0.5270292349010122,away,ATL,over,7,0.5121951219512195,-105,0.48808156828023186,SEA,ATL,2022 REG,6,3,3,1,4,9,1,0,2,-2,1,0,0,0,0,0,0,0,0,0.48808156828023186,0.5119184317197681
86951,0.49504950495049505,0.5495495495495495,102,-122,0.47297076509898783,0.5270292349010122,home,SEA,under,7,0.5348837209302326,-115,0.5119184317197681,SEA,ATL,2022 REG,6,3,3,1,4,9,1,0,2,-2,1,0,0,0,0,0,0,0,0,0.48808156828023186,0.5119184317197681
86952,0.6453900709219857,0.3921568627450981,-182,155,0.6211576527396834,0.3788423472603166,away,CLE,over,8,0.5215311004784688,-109,0.4978845547971712,HOU,CLE,2022 REG,7,2,4,1,3,11,1,0,1,-1,1,0,0,0,0,0,0,0,0,0.4978845547971712,0.5021154452028288
86952,0.6453900709219857,0.3921568627450981,-182,155,0.6211576527396834,0.3788423472603166,home,HOU,under,8,0.5238095238095238,-110,0.5021154452028288,HOU,CLE,2022 REG,7,2,4,1,3,11,1,0,1,-1,1,0,0,0,0,0,0,0,0,0.4978845547971712,0.5021154452028288
86953,0.46511627906976744,0.5708154506437768,115,-133,0.44840384664486316,0.5515961533551368,away,STL,over,8.5,0.5475113122171946,-121,0.5242087833606768,CHC,STL,2022 REG,7,3,16,13,16,23,0,1,-10,10,1,1,1,0,0,0,0,0,0,0.5242087833606768,0.4757912166393232
86953,0.46511627906976744,0.5708154506437768,115,-133,0.44840384664486316,0.5515961533551368,home,CHC,under,8.5,0.49504950495049505,102,0.4757912166393232,CHC,STL,2022 REG,7,3,16,13,16,23,0,1,-10,10,1,1,1,0,0,0,0,0,0,0.5242087833606768,0.4757912166393232
86954,0.4566210045662101,0.5815899581589958,119,-139,0.4391730763811846,0.5608269236188155,away,TOR,over,9.5,0.5238095238095238,-110,0.5000596729920038,BOS,TOR,2022 REG,9,3,13,9,12,22,0,1,-6,6,1,1,1,0,0,0,0,0,0,0.5000596729920038,0.4999403270079962
86954,0.4566210045662101,0.5815899581589958,119,-139,0.4391730763811846,0.5608269236188155,home,BOS,under,9.5,0.5215311004784688,-109,0.4999403270079962,BOS,TOR,2022 REG,9,3,13,9,12,22,0,1,-6,6,1,1,1,0,0,0,0,0,0,0.5000596729920038,0.4999403270079962
86955,0.5708154506437768,0.4672897196261683,-133,114,0.5490644307042802,0.45093556929571976,away,TEX,over,9,0.49751243781094534,101,0.476135829221149,NYM,TEX,2022 REG,9,3,10,7,10,19,0,1,-4,4,1,1,1,0,0,0,0,0,0,0.476135829221149,0.523864170778851
86955,0.5708154506437768,0.4672897196261683,-133,114,0.5490644307042802,0.45093556929571976,home,NYM,under,9,0.5454545454545454,-120,0.523864170778851,NYM,TEX,2022 REG,9,3,10,7,10,19,0,1,-4,4,1,1,1,0,0,0,0,0,0,0.476135829221149,0.523864170778851
86956,0.4347826086956522,0.6031746031746031,130,-152,0.418279473099889,0.581720526900111,away,TOR,over,9.5,0.5305164319248826,-113,0.5066009958897986,BOS,TOR,2022 REG,9,2,10,3,5,19,0,1,-1,1,1,1,0,0,0,0,0,0,0,0.5066009958897986,0.49339900411020143
86956,0.4347826086956522,0.6031746031746031,130,-152,0.418279473099889,0.581720526900111,home,BOS,under,9.5,0.5145631067961165,-106,0.49339900411020143,BOS,TOR,2022 REG,9,2,10,3,5,19,0,1,-1,1,1,1,0,0,0,0,0,0,0,0.5066009958897986,0.49339900411020143
86957,0.5391705069124424,0.5,-117,100,0.5180509248444435,0.4819490751555565,away,TB,over,8.5,0.5121951219512195,-105,0.48808156828023186,BAL,TB,2022 REG,9,4,11,6,10,20,0,1,-2,2,1,1,1,1,0,0,0,0,0,0.48808156828023186,0.5119184317197681
86957,0.5391705069124424,0.5,-117,100,0.5180509248444435,0.4819490751555565,home,BAL,under,8.5,0.5348837209302326,-115,0.5119184317197681,BAL,TB,2022 REG,9,4,11,6,10,20,0,1,-2,2,1,1,1,1,0,0,0,0,0,0.48808156828023186,0.5119184317197681
86958,0.3968253968253968,0.6415770609318996,152,-179,0.3815863262867871,0.6184136737132129,away,SEA,over,7.5,0.5121951219512195,-105,0.48808156828023186,KC,SEA,2022 REG,14,13,12,12,25,26,1,0,1,-1,1,1,1,1,1,1,1,1,1,0.48808156828023186,0.5119184317197681
86958,0.3968253968253968,0.6415770609318996,152,-179,0.3815863262867871,0.6184136737132129,home,KC,under,7.5,0.5348837209302326,-115,0.5119184317197681,KC,SEA,2022 REG,14,13,12,12,25,26,1,0,1,-1,1,1,1,1,1,1,1,1,1,0.48808156828023186,0.5119184317197681
86959,0.5098039215686274,0.5348837209302326,-104,-115,0.4870219861770517,0.5129780138229483,away,NYY,over,9.5,0.5073891625615764,-103,0.4837652908580103,BOS,NYY,2022 REG,8,3,9,2,5,17,1,0,1,-1,1,1,0,0,0,0,0,0,0,0.4837652908580103,0.5162347091419897
86959,0.5098039215686274,0.5348837209302326,-104,-115,0.4870219861770517,0.5129780138229483,home,BOS,under,9.5,0.5391705069124424,-117,0.5162347091419897,BOS,NYY,2022 REG,8,3,9,2,5,17,1,0,1,-1,1,1,0,0,0,0,0,0,0,0.4837652908580103,0.5162347091419897
86960,0.6376811594202898,0.4016064257028112,-176,149,0.6126282065881674,0.3873717934118326,away,PHI,over,6.5,0.5348837209302326,-115,0.5097020142727117,MIA,PHI,2022 REG,4,1,5,2,3,9,0,1,-1,1,1,0,0,0,0,0,0,0,0,0.5097020142727117,0.49029798572728833
86960,0.6376811594202898,0.4016064257028112,-176,149,0.6126282065881674,0.3873717934118326,home,MIA,under,6.5,0.5121951219512195,-105,0.49029798572728833,MIA,PHI,2022 REG,4,1,5,2,3,9,0,1,-1,1,1,0,0,0,0,0,0,0,0,0.5097020142727117,0.49029798572728833
86961,0.5121951219512195,0.5348837209302326,-105,-115,0.48808156828023186,0.5119184317197681,away,TOR,over,9,0.5121951219512195,-105,0.48919479393107135,MIN,TOR,2022 REG,11,7,7,3,10,18,1,0,4,-4,1,1,1,0,0,0,0,0,0,0.48919479393107135,0.5108052060689287
86961,0.5121951219512195,0.5348837209302326,-105,-115,0.48808156828023186,0.5119184317197681,home,MIN,under,9,0.5327102803738317,-114,0.5108052060689287,MIN,TOR,2022 REG,11,7,7,3,10,18,1,0,4,-4,1,1,1,0,0,0,0,0,0,0.48919479393107135,0.5108052060689287
86962,0.4484304932735426,0.5901639344262295,123,-144,0.43112357502252374,0.5688764249774763,away,SF,over,7.5,0.5215311004784688,-109,0.49907282342437215,MIA,SF,2022 REG,8,6,14,15,21,22,0,1,-9,9,1,1,1,1,1,1,0,0,0,0.49907282342437215,0.5009271765756278
86962,0.4484304932735426,0.5901639344262295,123,-144,0.43112357502252374,0.5688764249774763,home,MIA,under,7.5,0.5215311004784688,-109,0.5009271765756278,MIA,SF,2022 REG,8,6,14,15,21,22,0,1,-9,9,1,1,1,1,1,1,0,0,0,0.49907282342437215,0.5009271765756278
86963,0.35714285714285715,0.6875,180,-220,0.3411989795918367,0.6588010204081634,away,NYY,over,8.5,0.5169082125603864,-107,0.49353874091423283,BAL,NYY,2022 REG,3,2,11,6,8,14,0,1,-4,4,1,1,0,0,0,0,0,0,0,0.49353874091423283,0.5064612590857671
86963,0.35714285714285715,0.6875,180,-220,0.3411989795918367,0.6588010204081634,home,BAL,under,8.5,0.5283018867924528,-112,0.5064612590857671,BAL,NYY,2022 REG,3,2,11,6,8,14,0,1,-4,4,1,1,0,0,0,0,0,0,0,0.49353874091423283,0.5064612590857671
86964,0.5555555555555556,0.4854368932038835,-125,106,0.5327819729114227,0.4672180270885773,away,ARI,over,12,0.5283018867924528,-112,0.5044173060022736,COL,ARI,2022 REG,8,4,11,7,11,19,0,1,-3,3,1,1,1,1,0,0,0,0,0,0.5044173060022736,0.49558269399772636
86964,0.5555555555555556,0.4854368932038835,-125,106,0.5327819729114227,0.4672180270885773,home,COL,under,12,0.5169082125603864,-107,0.49558269399772636,COL,ARI,2022 REG,8,4,11,7,11,19,0,1,-3,3,1,1,1,1,0,0,0,0,0,0.5044173060022736,0.49558269399772636
86965,0.6551724137931035,0.38167938931297707,-190,162,0.6310281289994645,0.3689718710005355,away,OAK,over,8,0.5283018867924528,-112,0.5044173060022736,TEX,OAK,2022 REG,10,10,5,3,13,15,1,0,7,-7,1,1,1,0,0,0,0,0,0,0.5044173060022736,0.49558269399772636
86965,0.6551724137931035,0.38167938931297707,-190,162,0.6310281289994645,0.3689718710005355,home,TEX,under,8,0.5169082125603864,-107,0.49558269399772636,TEX,OAK,2022 REG,10,10,5,3,13,15,1,0,7,-7,1,1,1,0,0,0,0,0,0,0.5044173060022736,0.49558269399772636
86966,0.7014925373134329,0.3424657534246575,-235,192,0.6706561244076082,0.32934387559239175,away,OAK,over,9,0.5215311004784688,-109,0.50027251771145,TOR,OAK,2022 REG,10,5,9,7,12,19,0,1,-2,2,1,1,1,1,1,0,0,0,0,0.50027251771145,0.49972748228855
86966,0.7014925373134329,0.3424657534246575,-235,192,0.6706561244076082,0.32934387559239175,home,TOR,under,9,0.5192307692307692,-108,0.49972748228855,TOR,OAK,2022 REG,10,5,9,7,12,19,0,1,-2,2,1,1,1,1,1,0,0,0,0,0.50027251771145,0.49972748228855
86967,0.6183206106870228,0.42016806722689076,-162,138,0.5945222678547557,0.4054777321452443,away,LAA,over,8,0.5348837209302326,-115,0.5097020142727117,HOU,LAA,2022 REG,12,9,3,1,10,15,1,0,8,-8,1,0,0,0,0,0,0,0,0,0.5097020142727117,0.49029798572728833
86967,0.6183206106870228,0.42016806722689076,-162,138,0.5945222678547557,0.4054777321452443,home,HOU,under,8,0.5121951219512195,-105,0.49029798572728833,HOU,LAA,2022 REG,12,9,3,1,10,15,1,0,8,-8,1,0,0,0,0,0,0,0,0,0.5097020142727117,0.49029798572728833
86968,0.6047430830039526,0.4347826086956522,-153,130,0.5808401943476698,0.41915980565233024,away,WSH,over,7.5,0.5,100,0.4772727272727273,NYM,WSH,2022 REG,11,9,8,2,11,19,1,0,7,-7,1,1,0,0,0,0,0,0,0,0.4772727272727273,0.5227272727272727
86968,0.6047430830039526,0.4347826086956522,-153,130,0.5808401943476698,0.41915980565233024,home,NYM,under,7.5,0.5454545454545454,-120,0.5227272727272727,NYM,WSH,2022 REG,11,9,8,2,11,19,1,0,7,-7,1,1,0,0,0,0,0,0,0,0.4772727272727273,0.5227272727272727
86969,0.5024875621890548,0.5370370370370371,-101,-116,0.48262694267743644,0.5173730573225636,away,STL,over,9,0.5215311004784688,-109,0.4978845547971712,WSH,STL,2022 REG,5,0,7,5,5,12,0,1,-5,5,0,0,0,0,0,0,0,0,0,0.4978845547971712,0.5021154452028288
86969,0.5024875621890548,0.5370370370370371,-101,-116,0.48262694267743644,0.5173730573225636,home,WSH,under,9,0.5238095238095238,-110,0.5021154452028288,WSH,STL,2022 REG,5,0,7,5,5,12,0,1,-5,5,0,0,0,0,0,0,0,0,0,0.4978845547971712,0.5021154452028288
86970,0.5652173913043479,0.4739336492890995,-130,111,0.5430885422732689,0.45691145772673114,away,SD,over,7.5,0.5073891625615764,-103,0.4826927225525911,MIL,SD,2022 REG,8,4,9,6,10,17,0,1,-2,2,1,1,1,1,0,0,0,0,0,0.4826927225525911,0.5173072774474089
86970,0.5652173913043479,0.4739336492890995,-130,111,0.5430885422732689,0.45691145772673114,home,MIL,under,7.5,0.5412844036697247,-118,0.5173072774474089,MIL,SD,2022 REG,8,4,9,6,10,17,0,1,-2,2,1,1,1,1,0,0,0,0,0,0.4826927225525911,0.5173072774474089
86971,0.4444444444444444,0.5951417004048584,125,-147,0.4268506022891988,0.5731493977108012,away,CWS,over,8,0.5145631067961165,-106,0.4913668392989033,DET,CWS,2022 REG,5,3,5,4,7,10,0,1,-1,1,1,1,1,0,0,0,0,0,0,0.4913668392989033,0.5086331607010968
86971,0.4444444444444444,0.5951417004048584,125,-147,0.4268506022891988,0.5731493977108012,home,DET,under,8,0.5305164319248826,-113,0.5086331607010968,DET,CWS,2022 REG,5,3,5,4,7,10,0,1,-1,1,1,1,1,0,0,0,0,0,0,0.4913668392989033,0.5086331607010968
86972,0.5,0.5348837209302326,100,-115,0.4825581395348837,0.5174418604651163,away,MIA,over,10,0.5412844036697247,-118,0.5136310900085983,COL,MIA,2022 REG,17,13,13,12,25,30,1,0,1,-1,1,1,1,1,1,1,1,1,1,0.5136310900085983,0.4863689099914017
86972,0.5,0.5348837209302326,100,-115,0.4825581395348837,0.5174418604651163,home,COL,under,10,0.5098039215686274,-104,0.4863689099914017,COL,MIA,2022 REG,17,13,13,12,25,30,1,0,1,-1,1,1,1,1,1,1,1,1,1,0.5136310900085983,0.4863689099914017
86973,0.6503496503496503,0.3891050583657587,-186,157,0.6246902943319367,0.3753097056680633,away,COL,over,8.5,0.5370370370370371,-116,0.5118817074154765,PHI,COL,2022 REG,9,8,5,2,10,14,1,0,6,-6,1,1,0,0,0,0,0,0,0,0.5118817074154765,0.48811829258452355
86973,0.6503496503496503,0.3891050583657587,-186,157,0.6246902943319367,0.3753097056680633,home,PHI,under,8.5,0.5098039215686274,-104,0.48811829258452355,PHI,COL,2022 REG,9,8,5,2,10,14,1,0,6,-6,1,1,0,0,0,0,0,0,0,0.5118817074154765,0.48811829258452355
86974,0.5689655172413793,0.4694835680751174,-132,113,0.5470893135268209,0.4529106864731791,away,MIA,over,9,0.5348837209302326,-115,0.5097020142727117,CIN,MIA,2022 REG,16,11,7,2,13,23,1,0,9,-9,1,1,0,0,0,0,0,0,0,0.5097020142727117,0.49029798572728833
86974,0.5689655172413793,0.4694835680751174,-132,113,0.5470893135268209,0.4529106864731791,home,CIN,under,9,0.5121951219512195,-105,0.49029798572728833,CIN,MIA,2022 REG,16,11,7,2,13,23,1,0,9,-9,1,1,0,0,0,0,0,0,0,0.5097020142727117,0.49029798572728833
86975,0.7142857142857143,0.3225806451612903,-250,210,0.6879526003949967,0.3120473996050033,away,CHC,over,9,0.49751243781094534,101,0.476135829221149,NYY,CHC,2022 REG,6,2,9,1,3,15,1,0,1,-1,1,0,0,0,0,0,0,0,0,0.476135829221149,0.523864170778851
86975,0.7142857142857143,0.3225806451612903,-250,210,0.6879526003949967,0.3120473996050033,home,NYY,under,9,0.5454545454545454,-120,0.523864170778851,NYY,CHC,2022 REG,6,2,9,1,3,15,1,0,1,-1,1,0,0,0,0,0,0,0,0,0.476135829221149,0.523864170778851
86976,0.7333333333333333,0.3125,-275,220,0.6997222222222221,0.30027777777777787,away,OAK,over,9,0.5238095238095238,-110,0.5012646084074657,ATL,OAK,2022 REG,9,3,5,2,5,14,1,0,1,-1,1,1,0,0,0,0,0,0,0,0.5012646084074657,0.4987353915925343
86976,0.7333333333333333,0.3125,-275,220,0.6997222222222221,0.30027777777777787,home,ATL,under,9,0.5192307692307692,-108,0.4987353915925343,ATL,OAK,2022 REG,9,3,5,2,5,14,1,0,1,-1,1,1,0,0,0,0,0,0,0,0.5012646084074657,0.4987353915925343
86977,0.5238095238095238,0.5238095238095238,-110,-110,0.4988662131519274,0.5011337868480725,away,COL,over,8.5,0.5327102803738317,-114,0.5075272610403079,DET,COL,2022 REG,6,2,3,3,5,9,0,1,-1,1,1,1,0,0,0,0,0,0,0,0.5075272610403079,0.4924727389596921
86977,0.5238095238095238,0.5238095238095238,-110,-110,0.4988662131519274,0.5011337868480725,home,DET,under,8.5,0.5145631067961165,-106,0.4924727389596921,DET,COL,2022 REG,6,2,3,3,5,9,0,1,-1,1,1,1,0,0,0,0,0,0,0,0.5075272610403079,0.4924727389596921
86978,0.38314176245210724,0.6575342465753424,161,-192,0.3675570846638124,0.6324429153361877,away,STL,over,8.5,0.5283018867924528,-112,0.5056562298022652,CHC,STL,2022 REG,9,7,9,1,8,18,1,0,6,-6,1,0,0,0,0,0,0,0,0,0.5056562298022652,0.4943437701977348
86978,0.38314176245210724,0.6575342465753424,161,-192,0.3675570846638124,0.6324429153361877,home,CHC,under,8.5,0.5145631067961165,-106,0.4943437701977348,CHC,STL,2022 REG,9,7,9,1,8,18,1,0,6,-6,1,0,0,0,0,0,0,0,0,0.5056562298022652,0.4943437701977348
86979,0.7014925373134329,0.3389830508474576,-235,195,0.6730992142751963,0.32690078572480374,away,COL,over,7.5,0.5121951219512195,-105,0.48808156828023186,SD,COL,2022 REG,19,13,12,5,18,31,1,0,8,-8,1,1,1,1,1,0,0,0,0,0.48808156828023186,0.5119184317197681
86979,0.7014925373134329,0.3389830508474576,-235,195,0.6730992142751963,0.32690078572480374,home,SD,under,7.5,0.5348837209302326,-115,0.5119184317197681,SD,COL,2022 REG,19,13,12,5,18,31,1,0,8,-8,1,1,1,1,1,0,0,0,0,0.48808156828023186,0.5119184317197681
86980,0.4504504504504505,0.5934959349593496,122,-146,0.43065478134693697,0.569345218653063,away,NYM,over,7,0.5169082125603864,-107,0.49353874091423283,PHI,NYM,2022 REG,6,1,8,6,7,14,0,1,-5,5,1,0,0,0,0,0,0,0,0,0.49353874091423283,0.5064612590857671
86980,0.4504504504504505,0.5934959349593496,122,-146,0.43065478134693697,0.569345218653063,home,PHI,under,7,0.5283018867924528,-112,0.5064612590857671,PHI,NYM,2022 REG,6,1,8,6,7,14,0,1,-5,5,1,0,0,0,0,0,0,0,0,0.49353874091423283,0.5064612590857671
86981,0.6515679442508712,0.3861003861003861,-187,159,0.6270244676805398,0.37297553231946023,away,CLE,over,7.5,0.5348837209302326,-115,0.5097020142727117,NYY,CLE,2022 REG,9,5,4,4,9,13,1,0,1,-1,1,1,1,1,0,0,0,0,0,0.5097020142727117,0.49029798572728833
86981,0.6515679442508712,0.3861003861003861,-187,159,0.6270244676805398,0.37297553231946023,home,NYY,under,7.5,0.5121951219512195,-105,0.49029798572728833,NYY,CLE,2022 REG,9,5,4,4,9,13,1,0,1,-1,1,1,1,1,0,0,0,0,0,0.5097020142727117,0.49029798572728833
86982,0.6000000000000001,0.44052863436123346,-150,127,0.57568281938326,0.42431718061673995,away,ARI,over,7.5,0.504950495049505,-102,0.47949844489399435,CHC,ARI,2022 REG,10,6,11,7,13,21,0,1,-1,1,1,1,1,1,1,1,0,0,0,0.47949844489399435,0.5205015551060057
86982,0.6000000000000001,0.44052863436123346,-150,127,0.57568281938326,0.42431718061673995,home,CHC,under,7.5,0.5454545454545454,-120,0.5205015551060057,CHC,ARI,2022 REG,10,6,11,7,13,21,0,1,-1,1,1,1,1,1,1,1,0,0,0,0.47949844489399435,0.5205015551060057
86983,0.48309178743961345,0.5594713656387665,107,-127,0.46252987773991294,0.5374701222600871,away,TOR,over,7.5,0.5454545454545454,-120,0.5206611570247933,TB,TOR,2022 REG,6,3,4,2,5,10,1,0,1,-1,1,1,0,0,0,0,0,0,0,0.5206611570247933,0.4793388429752067
86983,0.48309178743961345,0.5594713656387665,107,-127,0.46252987773991294,0.5374701222600871,home,TB,under,7.5,0.5,100,0.4793388429752067,TB,TOR,2022 REG,6,3,4,2,5,10,1,0,1,-1,1,1,0,0,0,0,0,0,0,0.5206611570247933,0.4793388429752067
86984,0.45454545454545453,0.5833333333333333,120,-140,0.43732782369146006,0.5626721763085399,away,MIL,over,9,0.5,100,0.4772727272727273,PIT,MIL,2022 REG,11,8,12,7,15,23,1,0,1,-1,1,1,1,1,1,1,1,0,0,0.4772727272727273,0.5227272727272727
86984,0.45454545454545453,0.5833333333333333,120,-140,0.43732782369146006,0.5626721763085399,home,PIT,under,9,0.5454545454545454,-120,0.5227272727272727,PIT,MIL,2022 REG,11,8,12,7,15,23,1,0,1,-1,1,1,1,1,1,1,1,0,0,0.4772727272727273,0.5227272727272727
86985,0.6453900709219857,0.39840637450199207,-182,151,0.6171242799036738,0.3828757200963262,away,CHC,over,8.5,0.5327102803738317,-114,0.508788710910954,ATL,CHC,2022 REG,11,5,3,1,6,14,1,0,4,-4,1,0,0,0,0,0,0,0,0,0.508788710910954,0.491211289089046
86985,0.6453900709219857,0.39840637450199207,-182,151,0.6171242799036738,0.3828757200963262,home,ATL,under,8.5,0.5121951219512195,-105,0.491211289089046,ATL,CHC,2022 REG,11,5,3,1,6,14,1,0,4,-4,1,0,0,0,0,0,0,0,0,0.508788710910954,0.491211289089046
86986,0.6551724137931035,0.3861003861003861,-190,159,0.6281316138628862,0.3718683861371138,away,CIN,over,6.5,0.5348837209302326,-115,0.5097020142727117,CHC,CIN,2022 REG,12,8,7,1,9,19,1,0,7,-7,1,0,0,0,0,0,0,0,0,0.5097020142727117,0.49029798572728833
86986,0.6551724137931035,0.3861003861003861,-190,159,0.6281316138628862,0.3718683861371138,home,CHC,under,6.5,0.5121951219512195,-105,0.49029798572728833,CHC,CIN,2022 REG,12,8,7,1,9,19,1,0,7,-7,1,0,0,0,0,0,0,0,0,0.5097020142727117,0.49029798572728833
86987,0.4504504504504505,0.5901639344262295,122,-144,0.43215568248798203,0.567844317512018,away,ATL,over,9,0.504950495049505,-102,0.48054649490447493,PHI,ATL,2022 REG,10,7,5,2,9,15,1,0,5,-5,1,1,0,0,0,0,0,0,0,0.48054649490447493,0.5194535050955251
86987,0.4504504504504505,0.5901639344262295,122,-144,0.43215568248798203,0.567844317512018,home,PHI,under,9,0.5433789954337899,-119,0.5194535050955251,PHI,ATL,2022 REG,10,7,5,2,9,15,1,0,5,-5,1,1,0,0,0,0,0,0,0,0.48054649490447493,0.5194535050955251
86988,0.7530864197530864,0.2840909090909091,-305,252,0.7250886782779786,0.2749113217220214,away,WSH,over,8.5,0.5238095238095238,-110,0.5012646084074657,NYM,WSH,2022 REG,6,1,11,7,8,17,0,1,-6,6,1,0,0,0,0,0,0,0,0,0.5012646084074657,0.4987353915925343
86988,0.7530864197530864,0.2840909090909091,-305,252,0.7250886782779786,0.2749113217220214,home,NYM,under,8.5,0.5192307692307692,-108,0.4987353915925343,NYM,WSH,2022 REG,6,1,11,7,8,17,0,1,-6,6,1,0,0,0,0,0,0,0,0,0.5012646084074657,0.4987353915925343
86989,0.4464285714285714,0.5967741935483871,124,-148,0.42714162277814344,0.5728583772218565,away,NYY,over,7,0.5327102803738317,-114,0.508788710910954,TB,NYY,2022 REG,7,3,4,1,4,11,1,0,2,-2,1,0,0,0,0,0,0,0,0,0.508788710910954,0.491211289089046
86989,0.4464285714285714,0.5967741935483871,124,-148,0.42714162277814344,0.5728583772218565,home,TB,under,7,0.5121951219512195,-105,0.491211289089046,TB,NYY,2022 REG,7,3,4,1,4,11,1,0,2,-2,1,0,0,0,0,0,0,0,0,0.508788710910954,0.491211289089046
86990,0.6047430830039526,0.43859649122807015,-153,128,0.5785337752668005,0.4214662247331995,away,STL,over,8,0.5238095238095238,-110,0.4988662131519274,MIL,STL,2022 REG,9,5,5,1,6,14,1,0,4,-4,1,0,0,0,0,0,0,0,0,0.4988662131519274,0.5011337868480725
86990,0.6047430830039526,0.43859649122807015,-153,128,0.5785337752668005,0.4214662247331995,home,MIL,under,8,0.5238095238095238,-110,0.5011337868480725,MIL,STL,2022 REG,9,5,5,1,6,14,1,0,4,-4,1,0,0,0,0,0,0,0,0,0.4988662131519274,0.5011337868480725
86991,0.5391705069124424,0.504950495049505,-117,-102,0.5153817639191344,0.4846182360808656,away,CIN,over,11,0.5073891625615764,-103,0.4837652908580103,COL,CIN,2022 REG,14,10,12,4,14,26,1,0,6,-6,1,1,1,1,0,0,0,0,0,0.4837652908580103,0.5162347091419897
86991,0.5391705069124424,0.504950495049505,-117,-102,0.5153817639191344,0.4846182360808656,home,COL,under,11,0.5391705069124424,-117,0.5162347091419897,COL,CIN,2022 REG,14,10,12,4,14,26,1,0,6,-6,1,1,1,1,0,0,0,0,0,0.4837652908580103,0.5162347091419897
86992,0.44052863436123346,0.6000000000000001,127,-150,0.42267461041355353,0.5773253895864465,away,NYM,over,8.5,0.5,100,0.47935779816513757,MIA,NYM,2022 REG,6,3,5,2,5,11,1,0,1,-1,1,1,0,0,0,0,0,0,0,0.47935779816513757,0.5206422018348624
86992,0.44052863436123346,0.6000000000000001,127,-150,0.42267461041355353,0.5773253895864465,home,MIA,under,8.5,0.5412844036697247,-118,0.5206422018348624,MIA,NYM,2022 REG,6,3,5,2,5,11,1,0,1,-1,1,1,0,0,0,0,0,0,0,0.47935779816513757,0.5206422018348624
86993,0.7368421052631579,0.30303030303030304,-280,230,0.7074624359942919,0.2925375640057081,away,DET,over,9,0.5283018867924528,-112,0.5044173060022736,TOR,DET,2022 REG,4,5,10,3,8,14,1,0,2,-2,1,1,1,0,0,0,0,0,0,0.5044173060022736,0.49558269399772636
86993,0.7368421052631579,0.30303030303030304,-280,230,0.7074624359942919,0.2925375640057081,home,TOR,under,9,0.5169082125603864,-107,0.49558269399772636,TOR,DET,2022 REG,4,5,10,3,8,14,1,0,2,-2,1,1,1,0,0,0,0,0,0,0.5044173060022736,0.49558269399772636
86994,0.4291845493562232,0.607843137254902,133,-155,0.41329283836432396,0.586707161635676,away,BOS,over,8.5,0.5454545454545454,-120,0.5179608869977906,PIT,BOS,2022 REG,10,8,5,2,10,15,1,0,6,-6,1,1,0,0,0,0,0,0,0,0.5179608869977906,0.48203911300220936
86994,0.4291845493562232,0.607843137254902,133,-155,0.41329283836432396,0.586707161635676,home,PIT,under,8.5,0.504950495049505,-102,0.48203911300220936,PIT,BOS,2022 REG,10,8,5,2,10,15,1,0,6,-6,1,1,0,0,0,0,0,0,0,0.5179608869977906,0.48203911300220936
86995,0.7752808988764045,0.26595744680851063,-345,276,0.7433095971656275,0.2566904028343725,away,COL,over,8.5,0.5169082125603864,-107,0.49353874091423283,NYM,COL,2022 REG,10,7,11,6,13,21,1,0,1,-1,1,1,1,1,1,1,0,0,0,0.49353874091423283,0.5064612590857671
86995,0.7752808988764045,0.26595744680851063,-345,276,0.7433095971656275,0.2566904028343725,home,NYM,under,8.5,0.5283018867924528,-112,0.5064612590857671,NYM,COL,2022 REG,10,7,11,6,13,21,1,0,1,-1,1,1,1,1,1,1,0,0,0,0.49353874091423283,0.5064612590857671
86996,0.6539792387543253,0.38167938931297707,-189,162,0.6306592363158473,0.3693407636841527,away,KC,over,9,0.5192307692307692,-108,0.49455035168025013,CWS,KC,2022 REG,11,7,8,1,8,19,1,0,6,-6,1,0,0,0,0,0,0,0,0,0.49455035168025013,0.5054496483197499
86996,0.6539792387543253,0.38167938931297707,-189,162,0.6306592363158473,0.3693407636841527,home,CWS,under,9,0.5283018867924528,-112,0.5054496483197499,CWS,KC,2022 REG,11,7,8,1,8,19,1,0,6,-6,1,0,0,0,0,0,0,0,0,0.49455035168025013,0.5054496483197499
86997,0.6774193548387096,0.36101083032490977,-210,177,0.6513860035988384,0.34861399640116164,away,MIA,over,8,0.5283018867924528,-112,0.5044173060022736,ATL,MIA,2022 REG,11,6,7,3,9,18,1,0,3,-3,1,1,1,0,0,0,0,0,0,0.5044173060022736,0.49558269399772636
86997,0.6774193548387096,0.36101083032490977,-210,177,0.6513860035988384,0.34861399640116164,home,ATL,under,8,0.5169082125603864,-107,0.49558269399772636,ATL,MIA,2022 REG,11,6,7,3,9,18,1,0,3,-3,1,1,1,0,0,0,0,0,0,0.5044173060022736,0.49558269399772636
86998,0.35460992907801414,0.6875,182,-220,0.3396773301141794,0.6603226698858207,away,STL,over,9.5,0.5348837209302326,-115,0.5097020142727117,CIN,STL,2022 REG,7,4,14,13,17,21,0,1,-9,9,1,1,1,1,0,0,0,0,0,0.5097020142727117,0.49029798572728833
86998,0.35460992907801414,0.6875,182,-220,0.3396773301141794,0.6603226698858207,home,CIN,under,9.5,0.5121951219512195,-105,0.49029798572728833,CIN,STL,2022 REG,7,4,14,13,17,21,0,1,-9,9,1,1,1,1,0,0,0,0,0,0.5097020142727117,0.49029798572728833
86999,0.5412844036697247,0.5,-118,100,0.5189377998484975,0.4810622001515025,away,DET,over,8,0.5370370370370371,-116,0.5118817074154765,PIT,DET,2022 REG,4,1,9,3,4,13,0,1,-2,2,1,0,0,0,0,0,0,0,0,0.5118817074154765,0.48811829258452355
86999,0.5412844036697247,0.5,-118,100,0.5189377998484975,0.4810622001515025,home,PIT,under,8,0.5098039215686274,-104,0.48811829258452355,PIT,DET,2022 REG,4,1,9,3,4,13,0,1,-2,2,1,0,0,0,0,0,0,0,0,0.5118817074154765,0.48811829258452355
87000,0.48309178743961345,0.5575221238938054,107,-126,0.46347154041863814,0.5365284595813619,away,CHC,over,8.5,0.5454545454545454,-120,0.5206611570247933,CIN,CHC,2022 REG,7,2,13,15,17,20,0,1,-13,13,1,1,0,0,0,0,0,0,0,0.5206611570247933,0.4793388429752067
87000,0.48309178743961345,0.5575221238938054,107,-126,0.46347154041863814,0.5365284595813619,home,CIN,under,8.5,0.5,100,0.4793388429752067,CIN,CHC,2022 REG,7,2,13,15,17,20,0,1,-13,13,1,1,0,0,0,0,0,0,0,0.5206611570247933,0.4793388429752067
87001,0.5535714285714286,0.4854368932038835,-124,106,0.5319775361600951,0.46802246383990487,away,PHI,over,7,0.5370370370370371,-116,0.5131785224377817,MIA,PHI,2022 REG,4,1,8,2,3,12,0,1,-1,1,1,0,0,0,0,0,0,0,0,0.5131785224377817,0.4868214775622183
87001,0.5535714285714286,0.4854368932038835,-124,106,0.5319775361600951,0.46802246383990487,home,MIA,under,7,0.5073891625615764,-103,0.4868214775622183,MIA,PHI,2022 REG,4,1,8,2,3,12,0,1,-1,1,1,0,0,0,0,0,0,0,0,0.5131785224377817,0.4868214775622183
87002,0.7198879551820728,0.3205128205128205,-257,212,0.6908039233793066,0.30919607662069337,away,DET,over,8,0.5098039215686274,-104,0.48592421718142587,CWS,DET,2022 REG,4,1,5,2,3,9,0,1,-1,1,1,0,0,0,0,0,0,0,0,0.48592421718142587,0.5140757828185741
87002,0.7198879551820728,0.3205128205128205,-257,212,0.6908039233793066,0.30919607662069337,home,CWS,under,8,0.5370370370370371,-116,0.5140757828185741,CWS,DET,2022 REG,4,1,5,2,3,9,0,1,-1,1,1,0,0,0,0,0,0,0,0,0.48592421718142587,0.5140757828185741
87003,0.5169082125603864,0.5260663507109005,-107,-111,0.4946943078742622,0.5053056921257377,away,NYY,over,8,0.5238095238095238,-110,0.4988662131519274,SEA,NYY,2022 REG,6,4,13,9,13,19,0,1,-5,5,1,1,1,1,0,0,0,0,0,0.4988662131519274,0.5011337868480725
87003,0.5169082125603864,0.5260663507109005,-107,-111,0.4946943078742622,0.5053056921257377,home,SEA,under,8,0.5238095238095238,-110,0.5011337868480725,SEA,NYY,2022 REG,6,4,13,9,13,19,0,1,-5,5,1,1,1,1,0,0,0,0,0,0.4988662131519274,0.5011337868480725
87004,0.7455470737913487,0.29850746268656714,-293,235,0.7127023430330042,0.28729765696699583,away,OAK,over,8,0.5121951219512195,-105,0.48808156828023186,CWS,OAK,2022 REG,8,4,6,1,5,14,1,0,3,-3,1,0,0,0,0,0,0,0,0,0.48808156828023186,0.5119184317197681
87004,0.7455470737913487,0.29850746268656714,-293,235,0.7127023430330042,0.28729765696699583,home,CWS,under,8,0.5348837209302326,-115,0.5119184317197681,CWS,OAK,2022 REG,8,4,6,1,5,14,1,0,3,-3,1,0,0,0,0,0,0,0,0,0.48808156828023186,0.5119184317197681
87005,0.6153846153846154,0.42016806722689076,-160,138,0.5935060414698423,0.4064939585301577,away,NYM,over,8,0.5412844036697247,-118,0.5175913212324037,ATL,NYM,2022 REG,15,13,7,1,14,22,1,0,12,-12,1,0,0,0,0,0,0,0,0,0.5175913212324037,0.4824086787675963
87005,0.6153846153846154,0.42016806722689076,-160,138,0.5935060414698423,0.4064939585301577,home,ATL,under,8,0.5024875621890548,-101,0.4824086787675963,ATL,NYM,2022 REG,15,13,7,1,14,22,1,0,12,-12,1,0,0,0,0,0,0,0,0,0.5175913212324037,0.4824086787675963
87006,0.37037037037037035,0.6721311475409836,170,-205,0.35462906744023925,0.6453709325597607,away,NYY,over,8,0.5454545454545454,-120,0.5206611570247933,MIN,NYY,2022 REG,9,7,14,10,17,23,0,1,-3,3,1,1,1,1,1,1,1,0,0,0.5206611570247933,0.4793388429752067
87006,0.37037037037037035,0.6721311475409836,170,-205,0.35462906744023925,0.6453709325597607,home,MIN,under,8,0.5,100,0.4793388429752067,MIN,NYY,2022 REG,9,7,14,10,17,23,0,1,-3,3,1,1,1,1,1,1,1,0,0,0.5206611570247933,0.4793388429752067
87007,0.49751243781094534,0.5454545454545454,101,-120,0.476135829221149,0.523864170778851,away,CLE,over,7.5,0.5145631067961165,-106,0.4913668392989033,OAK,CLE,2022 REG,6,3,9,7,10,15,0,1,-4,4,1,1,1,0,0,0,0,0,0,0.4913668392989033,0.5086331607010968
87007,0.49751243781094534,0.5454545454545454,101,-120,0.476135829221149,0.523864170778851,home,OAK,under,7.5,0.5305164319248826,-113,0.5086331607010968,OAK,CLE,2022 REG,6,3,9,7,10,15,0,1,-4,4,1,1,1,0,0,0,0,0,0,0.4913668392989033,0.5086331607010968
87008,0.49504950495049505,0.5475113122171946,102,-121,0.4739797934813417,0.5260202065186583,away,TB,over,8.5,0.5098039215686274,-104,0.4881300146960012,BOS,TB,2022 REG,8,5,6,1,6,14,1,0,4,-4,1,0,0,0,0,0,0,0,0,0.4881300146960012,0.5118699853039987
87008,0.49504950495049505,0.5475113122171946,102,-121,0.4739797934813417,0.5260202065186583,home,BOS,under,8.5,0.5327102803738317,-114,0.5118699853039987,BOS,TB,2022 REG,8,5,6,1,6,14,1,0,4,-4,1,0,0,0,0,0,0,0,0,0.4881300146960012,0.5118699853039987
87009,0.5614035087719298,0.47619047619047616,-128,110,0.5402981137053159,0.4597018862946841,away,DET,over,7.5,0.5145631067961165,-106,0.49023796582517226,PIT,DET,2022 REG,6,3,11,5,8,17,0,1,-2,2,1,1,1,0,0,0,0,0,0,0.49023796582517226,0.5097620341748277
87009,0.5614035087719298,0.47619047619047616,-128,110,0.5402981137053159,0.4597018862946841,home,PIT,under,7.5,0.5327102803738317,-114,0.5097620341748277,PIT,DET,2022 REG,6,3,11,5,8,17,0,1,-2,2,1,1,1,0,0,0,0,0,0,0.49023796582517226,0.5097620341748277
87010,0.5652173913043479,0.47619047619047616,-130,110,0.5418129444594474,0.4581870555405526,away,BAL,over,7.5,0.5215311004784688,-109,0.49907282342437215,OAK,BAL,2022 REG,11,6,7,4,10,18,1,0,2,-2,1,1,1,1,0,0,0,0,0,0.49907282342437215,0.5009271765756278
87010,0.5652173913043479,0.47619047619047616,-130,110,0.5418129444594474,0.4581870555405526,home,OAK,under,7.5,0.5215311004784688,-109,0.5009271765756278,OAK,BAL,2022 REG,11,6,7,4,10,18,1,0,2,-2,1,1,1,1,0,0,0,0,0,0.49907282342437215,0.5009271765756278
87011,0.4504504504504505,0.5884773662551441,122,-143,0.4329153978803628,0.5670846021196372,away,STL,over,10,0.5283018867924528,-112,0.5056562298022652,CIN,STL,2022 REG,7,9,10,5,14,17,1,0,4,-4,1,1,1,1,1,0,0,0,0,0.5056562298022652,0.4943437701977348
87011,0.4504504504504505,0.5884773662551441,122,-143,0.4329153978803628,0.5670846021196372,home,CIN,under,10,0.5145631067961165,-106,0.4943437701977348,CIN,STL,2022 REG,7,9,10,5,14,17,1,0,4,-4,1,1,1,1,1,0,0,0,0,0.5056562298022652,0.4943437701977348
87012,0.47846889952153115,0.5652173913043479,109,-130,0.45756636802589523,0.5424336319741048,away,ATL,over,7.5,0.49751243781094534,101,0.476135829221149,MIA,ATL,2022 REG,10,3,9,5,8,19,0,1,-2,2,1,1,1,0,0,0,0,0,0,0.476135829221149,0.523864170778851
87012,0.47846889952153115,0.5652173913043479,109,-130,0.45756636802589523,0.5424336319741048,home,MIA,under,7.5,0.5454545454545454,-120,0.523864170778851,MIA,ATL,2022 REG,10,3,9,5,8,19,0,1,-2,2,1,1,1,0,0,0,0,0,0,0.476135829221149,0.523864170778851
87013,0.5391705069124424,0.5024875621890548,-117,-101,0.5167097046779946,0.4832902953220054,away,NYM,over,6.5,0.5433789954337899,-119,0.5171177654451503,MIL,NYM,2022 REG,4,2,10,7,9,14,0,1,-5,5,1,1,0,0,0,0,0,0,0,0.5171177654451503,0.4828822345548497
87013,0.5391705069124424,0.5024875621890548,-117,-101,0.5167097046779946,0.4832902953220054,home,MIL,under,6.5,0.504950495049505,-102,0.4828822345548497,MIL,NYM,2022 REG,4,2,10,7,9,14,0,1,-5,5,1,1,0,0,0,0,0,0,0,0.5171177654451503,0.4828822345548497
87014,0.504950495049505,0.5348837209302326,-102,-115,0.48483618797062755,0.5151638120293724,away,PHI,over,11.5,0.49504950495049505,102,0.47499799484898986,COL,PHI,2022 REG,11,6,12,9,15,23,0,1,-3,3,1,1,1,1,1,1,0,0,0,0.47499799484898986,0.5250020051510101
87014,0.504950495049505,0.5348837209302326,-102,-115,0.48483618797062755,0.5151638120293724,home,COL,under,11.5,0.5454545454545454,-120,0.5250020051510101,COL,PHI,2022 REG,11,6,12,9,15,23,0,1,-3,3,1,1,1,1,1,1,0,0,0,0.47499799484898986,0.5250020051510101
87015,0.7787610619469026,0.2638522427440633,-352,279,0.745575479532699,0.254424520467301,away,COL,over,7.5,0.5,100,0.47522522522522526,NYM,COL,2022 REG,3,0,7,1,1,10,0,1,-1,1,0,0,0,0,0,0,0,0,0,0.47522522522522526,0.5247747747747747
87015,0.7787610619469026,0.2638522427440633,-352,279,0.745575479532699,0.254424520467301,home,NYM,under,7.5,0.5495495495495495,-122,0.5247747747747747,NYM,COL,2022 REG,3,0,7,1,1,10,0,1,-1,1,0,0,0,0,0,0,0,0,0,0.47522522522522526,0.5247747747747747
87016,0.49751243781094534,0.5454545454545454,101,-120,0.476135829221149,0.523864170778851,away,NYM,over,7.5,0.5,100,0.4772727272727273,ATL,NYM,2022 REG,11,4,8,2,6,19,1,0,2,-2,1,1,0,0,0,0,0,0,0,0.4772727272727273,0.5227272727272727
87016,0.49751243781094534,0.5454545454545454,101,-120,0.476135829221149,0.523864170778851,home,ATL,under,7.5,0.5454545454545454,-120,0.5227272727272727,ATL,NYM,2022 REG,11,4,8,2,6,19,1,0,2,-2,1,1,0,0,0,0,0,0,0,0.4772727272727273,0.5227272727272727
87017,0.4,0.6402877697841727,150,-178,0.383884892086331,0.6161151079136691,away,SD,over,8,0.5,100,0.47935779816513757,DET,SD,2022 REG,11,4,6,6,10,17,0,1,-2,2,1,1,1,1,0,0,0,0,0,0.47935779816513757,0.5206422018348624
87017,0.4,0.6402877697841727,150,-178,0.383884892086331,0.6161151079136691,home,DET,under,8,0.5412844036697247,-118,0.5206422018348624,DET,SD,2022 REG,11,4,6,6,10,17,0,1,-2,2,1,1,1,1,0,0,0,0,0,0.47935779816513757,0.5206422018348624
87018,0.5348837209302326,0.5121951219512195,-115,-105,0.5097020142727117,0.49029798572728833,away,CIN,over,7,0.5169082125603864,-107,0.49353874091423283,PIT,CIN,2022 REG,7,4,6,1,5,13,1,0,3,-3,1,0,0,0,0,0,0,0,0,0.49353874091423283,0.5064612590857671
87018,0.5348837209302326,0.5121951219512195,-115,-105,0.5097020142727117,0.49029798572728833,home,PIT,under,7,0.5283018867924528,-112,0.5064612590857671,PIT,CIN,2022 REG,7,4,6,1,5,13,1,0,3,-3,1,0,0,0,0,0,0,0,0,0.49353874091423283,0.5064612590857671
87019,0.4166666666666667,0.6240601503759399,140,-166,0.39969715956558066,0.6003028404344193,away,SD,over,9,0.5412844036697247,-118,0.5189377998484975,ARI,SD,2022 REG,5,2,10,5,7,15,0,1,-3,3,1,1,0,0,0,0,0,0,0,0.5189377998484975,0.4810622001515025
87019,0.4166666666666667,0.6240601503759399,140,-166,0.39969715956558066,0.6003028404344193,home,ARI,under,9,0.5,100,0.4810622001515025,ARI,SD,2022 REG,5,2,10,5,7,15,0,1,-3,3,1,1,0,0,0,0,0,0,0,0.5189377998484975,0.4810622001515025
87020,0.5555555555555556,0.4854368932038835,-125,106,0.5327819729114227,0.4672180270885773,away,TEX,over,7,0.5283018867924528,-112,0.5056562298022652,SEA,TEX,2022 REG,13,10,12,9,19,25,1,0,1,-1,1,1,1,1,1,1,1,1,1,0.5056562298022652,0.4943437701977348
87020,0.5555555555555556,0.4854368932038835,-125,106,0.5327819729114227,0.4672180270885773,home,SEA,under,7,0.5145631067961165,-106,0.4943437701977348,SEA,TEX,2022 REG,13,10,12,9,19,25,1,0,1,-1,1,1,1,1,1,1,1,1,1,0.5056562298022652,0.4943437701977348
87021,0.40485829959514175,0.6363636363636364,147,-175,0.388169256696851,0.611830743303149,away,SF,over,8,0.5348837209302326,-115,0.5097020142727117,PIT,SF,2022 REG,8,5,10,7,12,18,0,1,-2,2,1,1,1,1,1,0,0,0,0,0.5097020142727117,0.49029798572728833
87021,0.40485829959514175,0.6363636363636364,147,-175,0.388169256696851,0.611830743303149,home,PIT,under,8,0.5121951219512195,-105,0.49029798572728833,PIT,SF,2022 REG,8,5,10,7,12,18,0,1,-2,2,1,1,1,1,1,0,0,0,0,0.5097020142727117,0.49029798572728833
87022,0.4807692307692307,0.5555555555555556,108,-125,0.4633053911900066,0.5366946088099934,away,ATL,over,8,0.5238095238095238,-110,0.4988662131519274,PHI,ATL,2022 REG,3,3,14,6,9,17,0,1,-3,3,1,1,1,0,0,0,0,0,0,0.4988662131519274,0.5011337868480725
87022,0.4807692307692307,0.5555555555555556,108,-125,0.4633053911900066,0.5366946088099934,home,PHI,under,8,0.5238095238095238,-110,0.5011337868480725,PHI,ATL,2022 REG,3,3,14,6,9,17,0,1,-3,3,1,1,1,0,0,0,0,0,0,0.4988662131519274,0.5011337868480725
87023,0.5884773662551441,0.45454545454545453,-143,120,0.5631594099815408,0.4368405900184592,away,PIT,over,8.5,0.5145631067961165,-106,0.4913668392989033,CHC,PIT,2022 REG,4,3,9,4,7,13,0,1,-1,1,1,1,1,0,0,0,0,0,0,0.4913668392989033,0.5086331607010968
87023,0.5884773662551441,0.45454545454545453,-143,120,0.5631594099815408,0.4368405900184592,home,CHC,under,8.5,0.5305164319248826,-113,0.5086331607010968,CHC,PIT,2022 REG,4,3,9,4,7,13,0,1,-1,1,1,1,1,0,0,0,0,0,0,0.4913668392989033,0.5086331607010968
87024,0.6688741721854304,0.37037037037037035,-202,170,0.6426245112706233,0.35737548872937674,away,COL,over,8.5,0.5238095238095238,-110,0.4988662131519274,MIN,COL,2022 REG,10,6,12,3,9,22,1,0,3,-3,1,1,1,0,0,0,0,0,0,0.4988662131519274,0.5011337868480725
87024,0.6688741721854304,0.37037037037037035,-202,170,0.6426245112706233,0.35737548872937674,home,MIN,under,8.5,0.5238095238095238,-110,0.5011337868480725,MIN,COL,2022 REG,10,6,12,3,9,22,1,0,3,-3,1,1,1,0,0,0,0,0,0,0.4988662131519274,0.5011337868480725
87025,0.6240601503759399,0.4166666666666667,-166,140,0.5986441668079975,0.4013558331920025,away,BAL,over,10,0.5215311004784688,-109,0.4978845547971712,BOS,BAL,2022 REG,4,0,14,10,10,18,0,1,-10,10,0,0,0,0,0,0,0,0,0,0.4978845547971712,0.5021154452028288
87025,0.6240601503759399,0.4166666666666667,-166,140,0.5986441668079975,0.4013558331920025,home,BOS,under,10,0.5238095238095238,-110,0.5021154452028288,BOS,BAL,2022 REG,4,0,14,10,10,18,0,1,-10,10,0,0,0,0,0,0,0,0,0,0.4978845547971712,0.5021154452028288
87026,0.48780487804878053,0.5555555555555556,105,-125,0.4666534470222751,0.5333465529777248,away,HOU,over,8.5,0.5121951219512195,-105,0.48808156828023186,SEA,HOU,2022 REG,7,2,10,5,7,17,0,1,-3,3,1,1,0,0,0,0,0,0,0,0.48808156828023186,0.5119184317197681
87026,0.48780487804878053,0.5555555555555556,105,-125,0.4666534470222751,0.5333465529777248,home,SEA,under,8.5,0.5348837209302326,-115,0.5119184317197681,SEA,HOU,2022 REG,7,2,10,5,7,17,0,1,-3,3,1,1,0,0,0,0,0,0,0,0.48808156828023186,0.5119184317197681
87027,0.38759689922480617,0.6575342465753424,158,-192,0.37010420705420594,0.629895792945794,away,HOU,over,9.5,0.5238095238095238,-110,0.5012646084074657,LAA,HOU,2022 REG,6,1,11,9,10,17,0,1,-8,8,1,0,0,0,0,0,0,0,0,0.5012646084074657,0.4987353915925343
87027,0.38759689922480617,0.6575342465753424,158,-192,0.37010420705420594,0.629895792945794,home,LAA,under,9.5,0.5192307692307692,-108,0.4987353915925343,LAA,HOU,2022 REG,6,1,11,9,10,17,0,1,-8,8,1,0,0,0,0,0,0,0,0,0.5012646084074657,0.4987353915925343
87028,0.5833333333333333,0.4587155963302753,-140,118,0.5588047910295616,0.4411952089704384,away,PIT,over,9.5,0.5,100,0.4762443438914027,CIN,PIT,2022 REG,1,0,3,1,1,4,0,1,-1,1,0,0,0,0,0,0,0,0,0,0.4762443438914027,0.5237556561085973
87028,0.5833333333333333,0.4587155963302753,-140,118,0.5588047910295616,0.4411952089704384,home,CIN,under,9.5,0.5475113122171946,-121,0.5237556561085973,CIN,PIT,2022 REG,1,0,3,1,1,4,0,1,-1,1,0,0,0,0,0,0,0,0,0,0.4762443438914027,0.5237556561085973
87029,0.47619047619047616,0.5652173913043479,110,-130,0.4564724440500838,0.5435275559499162,away,NYM,over,9,0.5412844036697247,-118,0.5175913212324037,PHI,NYM,2022 REG,11,4,3,1,5,14,1,0,3,-3,1,0,0,0,0,0,0,0,0,0.5175913212324037,0.4824086787675963
87029,0.47619047619047616,0.5652173913043479,110,-130,0.4564724440500838,0.5435275559499162,home,PHI,under,9,0.5024875621890548,-101,0.4824086787675963,PHI,NYM,2022 REG,11,4,3,1,5,14,1,0,3,-3,1,0,0,0,0,0,0,0,0,0.5175913212324037,0.4824086787675963
87030,0.5145631067961165,0.5305164319248826,-106,-113,0.4913668392989033,0.5086331607010968,away,MIN,over,9,0.5412844036697247,-118,0.5149381613977361,ARI,MIN,2022 REG,4,1,14,11,12,18,0,1,-10,10,1,0,0,0,0,0,0,0,0,0.5149381613977361,0.48506183860226393
87030,0.5145631067961165,0.5305164319248826,-106,-113,0.4913668392989033,0.5086331607010968,home,ARI,under,9,0.5073891625615764,-103,0.48506183860226393,ARI,MIN,2022 REG,4,1,14,11,12,18,0,1,-10,10,1,0,0,0,0,0,0,0,0,0.5149381613977361,0.48506183860226393
87031,0.5652173913043479,0.47619047619047616,-130,110,0.5418129444594474,0.4581870555405526,away,TOR,over,9.5,0.5,100,0.47935779816513757,NYY,TOR,2022 REG,7,4,5,0,4,12,1,0,4,-4,0,0,0,0,0,0,0,0,0,0.47935779816513757,0.5206422018348624
87031,0.5652173913043479,0.47619047619047616,-130,110,0.5418129444594474,0.4581870555405526,home,NYY,under,9.5,0.5412844036697247,-118,0.5206422018348624,NYY,TOR,2022 REG,7,4,5,0,4,12,1,0,4,-4,0,0,0,0,0,0,0,0,0,0.47935779816513757,0.5206422018348624
87032,0.6168582375478928,0.42016806722689076,-161,138,0.5940182564416087,0.40598174355839134,away,BAL,over,8,0.5283018867924528,-112,0.5031902949311281,STL,BAL,2022 REG,7,3,11,5,8,18,0,1,-2,2,1,1,1,0,0,0,0,0,0,0.5031902949311281,0.4968097050688719
87032,0.6168582375478928,0.42016806722689076,-161,138,0.5940182564416087,0.40598174355839134,home,STL,under,8,0.5192307692307692,-108,0.4968097050688719,STL,BAL,2022 REG,7,3,11,5,8,18,0,1,-2,2,1,1,1,0,0,0,0,0,0,0.5031902949311281,0.4968097050688719
87033,0.4854368932038835,0.5555555555555556,106,-125,0.465537646233282,0.534462353766718,away,SF,over,8,0.5238095238095238,-110,0.4988662131519274,MIA,SF,2022 REG,5,1,9,5,6,14,0,1,-4,4,1,0,0,0,0,0,0,0,0,0.4988662131519274,0.5011337868480725
87033,0.4854368932038835,0.5555555555555556,106,-125,0.465537646233282,0.534462353766718,home,MIA,under,8,0.5238095238095238,-110,0.5011337868480725,MIA,SF,2022 REG,5,1,9,5,6,14,0,1,-4,4,1,0,0,0,0,0,0,0,0,0.4988662131519274,0.5011337868480725
87034,0.5283018867924528,0.5169082125603864,-112,-107,0.5044173060022736,0.49558269399772636,away,CLE,over,8,0.5238095238095238,-110,0.4988662131519274,CIN,CLE,2022 REG,5,5,11,10,15,16,0,1,-5,5,1,1,1,1,1,0,0,0,0,0.4988662131519274,0.5011337868480725
87034,0.5283018867924528,0.5169082125603864,-112,-107,0.5044173060022736,0.49558269399772636,home,CIN,under,8,0.5238095238095238,-110,0.5011337868480725,CIN,CLE,2022 REG,5,5,11,10,15,16,0,1,-5,5,1,1,1,1,1,0,0,0,0,0.4988662131519274,0.5011337868480725
87035,0.5,0.5370370370370371,100,-116,0.4814814814814814,0.5185185185185186,away,TB,over,7.5,0.49751243781094534,101,0.4740985137509976,BOS,TB,2022 REG,5,6,2,0,6,7,1,0,6,-6,0,0,0,0,0,0,0,0,0,0.4740985137509976,0.5259014862490023
87035,0.5,0.5370370370370371,100,-116,0.4814814814814814,0.5185185185185186,home,BOS,under,7.5,0.5495495495495495,-122,0.5259014862490023,BOS,TB,2022 REG,5,6,2,0,6,7,1,0,6,-6,0,0,0,0,0,0,0,0,0,0.4740985137509976,0.5259014862490023
87036,0.7448979591836734,0.29850746268656714,-292,235,0.7125653490150249,0.2874346509849751,away,CIN,over,7.5,0.5,100,0.4772727272727273,MIL,CIN,2022 REG,5,2,7,4,6,12,0,1,-2,2,1,1,0,0,0,0,0,0,0,0.4772727272727273,0.5227272727272727
87036,0.7448979591836734,0.29850746268656714,-292,235,0.7125653490150249,0.2874346509849751,home,MIL,under,7.5,0.5454545454545454,-120,0.5227272727272727,MIL,CIN,2022 REG,5,2,7,4,6,12,0,1,-2,2,1,1,0,0,0,0,0,0,0,0.4772727272727273,0.5227272727272727
87037,0.576271186440678,0.4672897196261683,-136,114,0.5511682914191056,0.4488317085808944,away,WSH,over,11,0.5073891625615764,-103,0.4826927225525911,COL,WSH,2022 REG,10,9,15,7,16,25,1,0,2,-2,1,1,1,1,1,1,1,0,0,0.4826927225525911,0.5173072774474089
87037,0.576271186440678,0.4672897196261683,-136,114,0.5511682914191056,0.4488317085808944,home,COL,under,11,0.5412844036697247,-118,0.5173072774474089,COL,WSH,2022 REG,10,9,15,7,16,25,1,0,2,-2,1,1,1,1,1,1,1,0,0,0.4826927225525911,0.5173072774474089
87038,0.4608294930875576,0.5726495726495727,117,-134,0.44540135219487087,0.5545986478051291,away,MIA,over,8,0.5238095238095238,-110,0.5012646084074657,WSH,MIA,2022 REG,6,5,8,3,8,14,1,0,2,-2,1,1,1,0,0,0,0,0,0,0.5012646084074657,0.4987353915925343
87038,0.4608294930875576,0.5726495726495727,117,-134,0.44540135219487087,0.5545986478051291,home,WSH,under,8,0.5192307692307692,-108,0.4987353915925343,WSH,MIA,2022 REG,6,5,8,3,8,14,1,0,2,-2,1,1,1,0,0,0,0,0,0,0.5012646084074657,0.4987353915925343
87039,0.6610169491525424,0.37593984962406013,-195,166,0.6365878787747881,0.36341212122521194,away,CLE,over,9,0.5305164319248826,-113,0.5066009958897986,NYY,CLE,2022 REG,7,4,9,1,5,16,1,0,3,-3,1,0,0,0,0,0,0,0,0,0.5066009958897986,0.49339900411020143
87039,0.6610169491525424,0.37593984962406013,-195,166,0.6365878787747881,0.36341212122521194,home,NYY,under,9,0.5145631067961165,-106,0.49339900411020143,NYY,CLE,2022 REG,7,4,9,1,5,16,1,0,3,-3,1,0,0,0,0,0,0,0,0,0.5066009958897986,0.49339900411020143
87040,0.44052863436123346,0.601593625498008,127,-151,0.42197257274923283,0.5780274272507672,away,CWS,over,8.5,0.5121951219512195,-105,0.48808156828023186,DET,CWS,2022 REG,7,2,10,5,7,17,0,1,-3,3,1,1,0,0,0,0,0,0,0,0.48808156828023186,0.5119184317197681
87040,0.44052863436123346,0.601593625498008,127,-151,0.42197257274923283,0.5780274272507672,home,DET,under,8.5,0.5348837209302326,-115,0.5119184317197681,DET,CWS,2022 REG,7,2,10,5,7,17,0,1,-3,3,1,1,0,0,0,0,0,0,0,0.48808156828023186,0.5119184317197681
87041,0.5798319327731092,0.4608294930875576,-138,117,0.5562551396270082,0.44374486037299177,away,CHC,over,9,0.5121951219512195,-105,0.48919479393107135,MIL,CHC,2022 REG,5,3,11,8,11,16,0,1,-5,5,1,1,1,0,0,0,0,0,0,0.48919479393107135,0.5108052060689287
87041,0.5798319327731092,0.4608294930875576,-138,117,0.5562551396270082,0.44374486037299177,home,MIL,under,9,0.5327102803738317,-114,0.5108052060689287,MIL,CHC,2022 REG,5,3,11,8,11,16,0,1,-5,5,1,1,1,0,0,0,0,0,0,0.48919479393107135,0.5108052060689287
87042,0.504950495049505,0.5348837209302326,-102,-115,0.48483618797062755,0.5151638120293724,away,CIN,over,8,0.5121951219512195,-105,0.48808156828023186,PIT,CIN,2022 REG,13,5,7,4,9,20,1,0,1,-1,1,1,1,1,0,0,0,0,0,0.48808156828023186,0.5119184317197681
87042,0.504950495049505,0.5348837209302326,-102,-115,0.48483618797062755,0.5151638120293724,home,PIT,under,8,0.5348837209302326,-115,0.5119184317197681,PIT,CIN,2022 REG,13,5,7,4,9,20,1,0,1,-1,1,1,1,1,0,0,0,0,0,0.48808156828023186,0.5119184317197681
87043,0.48780487804878053,0.5495495495495495,105,-122,0.4695832060495952,0.5304167939504048,away,LAD,over,8.5,0.5121951219512195,-105,0.48808156828023186,CWS,LAD,2022 REG,7,4,5,0,4,12,1,0,4,-4,0,0,0,0,0,0,0,0,0,0.48808156828023186,0.5119184317197681
87043,0.48780487804878053,0.5495495495495495,105,-122,0.4695832060495952,0.5304167939504048,home,CWS,under,8.5,0.5348837209302326,-115,0.5119184317197681,CWS,LAD,2022 REG,7,4,5,0,4,12,1,0,4,-4,0,0,0,0,0,0,0,0,0,0.48808156828023186,0.5119184317197681
87044,0.5652173913043479,0.4739336492890995,-130,111,0.5430885422732689,0.45691145772673114,away,TOR,over,8.5,0.5370370370370371,-116,0.5118817074154765,HOU,TOR,2022 REG,11,8,10,7,15,21,1,0,1,-1,1,1,1,1,1,1,1,0,0,0.5118817074154765,0.48811829258452355
87044,0.5652173913043479,0.4739336492890995,-130,111,0.5430885422732689,0.45691145772673114,home,HOU,under,8.5,0.5098039215686274,-104,0.48811829258452355,HOU,TOR,2022 REG,11,8,10,7,15,21,1,0,1,-1,1,1,1,1,1,1,1,0,0,0.5118817074154765,0.48811829258452355
87045,0.5670995670995671,0.4716981132075471,-131,112,0.5450974193929352,0.4549025806070648,away,TEX,over,8.5,0.5121951219512195,-105,0.48808156828023186,LAA,TEX,2022 REG,8,2,5,5,7,13,0,1,-3,3,1,1,0,0,0,0,0,0,0,0.48808156828023186,0.5119184317197681
87045,0.5670995670995671,0.4716981132075471,-131,112,0.5450974193929352,0.4549025806070648,home,LAA,under,8.5,0.5348837209302326,-115,0.5119184317197681,LAA,TEX,2022 REG,8,2,5,5,7,13,0,1,-3,3,1,1,0,0,0,0,0,0,0,0.48808156828023186,0.5119184317197681
87046,0.6721311475409836,0.36363636363636365,-205,175,0.6480906892086682,0.3519093107913318,away,CIN,over,9,0.5169082125603864,-107,0.49586088023391106,BOS,CIN,2022 REG,8,7,7,1,8,15,1,0,6,-6,1,0,0,0,0,0,0,0,0,0.49586088023391106,0.5041391197660889
87046,0.6721311475409836,0.36363636363636365,-205,175,0.6480906892086682,0.3519093107913318,home,BOS,under,9,0.5238095238095238,-110,0.5041391197660889,BOS,CIN,2022 REG,8,7,7,1,8,15,1,0,6,-6,1,0,0,0,0,0,0,0,0,0.49586088023391106,0.5041391197660889
87047,0.6062992125984252,0.4347826086956522,-154,130,0.581391336695717,0.41860866330428304,away,LAA,over,7,0.5495495495495495,-122,0.5250401592387142,ATL,LAA,2022 REG,8,8,5,1,9,13,1,0,7,-7,1,0,0,0,0,0,0,0,0,0.5250401592387142,0.47495984076128583
87047,0.6062992125984252,0.4347826086956522,-154,130,0.581391336695717,0.41860866330428304,home,ATL,under,7,0.49504950495049505,102,0.47495984076128583,ATL,LAA,2022 REG,8,8,5,1,9,13,1,0,7,-7,1,0,0,0,0,0,0,0,0,0.5250401592387142,0.47495984076128583
87048,0.613899613899614,0.42194092827004215,-159,137,0.5918971188997093,0.4081028811002907,away,CIN,over,8,0.5238095238095238,-110,0.4988662131519274,STL,CIN,2022 REG,12,6,11,7,13,23,0,1,-1,1,1,1,1,1,1,1,0,0,0,0.4988662131519274,0.5011337868480725
87048,0.613899613899614,0.42194092827004215,-159,137,0.5918971188997093,0.4081028811002907,home,STL,under,8,0.5238095238095238,-110,0.5011337868480725,STL,CIN,2022 REG,12,6,11,7,13,23,0,1,-1,1,1,1,1,1,1,1,0,0,0,0.4988662131519274,0.5011337868480725
87049,0.45454545454545453,0.5850622406639003,120,-141,0.4365419567230205,0.5634580432769796,away,TOR,over,8.5,0.5238095238095238,-110,0.4988662131519274,MIL,TOR,2022 REG,8,4,13,9,13,21,0,1,-5,5,1,1,1,1,0,0,0,0,0,0.4988662131519274,0.5011337868480725
87049,0.45454545454545453,0.5850622406639003,120,-141,0.4365419567230205,0.5634580432769796,home,MIL,under,8.5,0.5238095238095238,-110,0.5011337868480725,MIL,TOR,2022 REG,8,4,13,9,13,21,0,1,-5,5,1,1,1,1,0,0,0,0,0,0.4988662131519274,0.5011337868480725
87050,0.45454545454545453,0.5884773662551441,120,-143,0.43498962690881876,0.5650103730911813,away,HOU,over,9,0.5238095238095238,-110,0.4988662131519274,BOS,HOU,2022 REG,5,5,2,1,6,7,1,0,4,-4,1,0,0,0,0,0,0,0,0,0.4988662131519274,0.5011337868480725
87050,0.45454545454545453,0.5884773662551441,120,-143,0.43498962690881876,0.5650103730911813,home,BOS,under,9,0.5238095238095238,-110,0.5011337868480725,BOS,HOU,2022 REG,5,5,2,1,6,7,1,0,4,-4,1,0,0,0,0,0,0,0,0,0.4988662131519274,0.5011337868480725
87051,0.49751243781094534,0.5454545454545454,101,-120,0.476135829221149,0.523864170778851,away,NYM,over,9,0.5348837209302326,-115,0.5109810284308424,WSH,NYM,2022 REG,6,1,12,5,6,18,0,1,-4,4,1,0,0,0,0,0,0,0,0,0.5109810284308424,0.48901897156915763
87051,0.49751243781094534,0.5454545454545454,101,-120,0.476135829221149,0.523864170778851,home,WSH,under,9,0.5098039215686274,-104,0.48901897156915763,WSH,NYM,2022 REG,6,1,12,5,6,18,0,1,-4,4,1,0,0,0,0,0,0,0,0,0.5109810284308424,0.48901897156915763
87052,0.6363636363636364,0.4,-175,150,0.6132231404958678,0.3867768595041322,away,BOS,over,8.5,0.5283018867924528,-112,0.5044173060022736,NYY,BOS,2022 REG,9,6,9,5,11,18,1,0,1,-1,1,1,1,1,1,0,0,0,0,0.5044173060022736,0.49558269399772636
87052,0.6363636363636364,0.4,-175,150,0.6132231404958678,0.3867768595041322,home,NYY,under,8.5,0.5169082125603864,-107,0.49558269399772636,NYY,BOS,2022 REG,9,6,9,5,11,18,1,0,1,-1,1,1,1,1,1,0,0,0,0,0.5044173060022736,0.49558269399772636
87053,0.4098360655737705,0.6240601503759399,144,-166,0.39594417379110225,0.6040558262088978,away,BAL,over,8.5,0.5238095238095238,-110,0.4988662131519274,WSH,BAL,2022 REG,8,3,11,4,7,19,0,1,-1,1,1,1,1,0,0,0,0,0,0,0.4988662131519274,0.5011337868480725
87053,0.4098360655737705,0.6240601503759399,144,-166,0.39594417379110225,0.6040558262088978,home,WSH,under,8.5,0.5238095238095238,-110,0.5011337868480725,WSH,BAL,2022 REG,8,3,11,4,7,19,0,1,-1,1,1,1,1,0,0,0,0,0,0,0.4988662131519274,0.5011337868480725
87054,0.6240601503759399,0.4098360655737705,-166,144,0.6029068727531882,0.3970931272468118,away,CLE,over,7.5,0.504950495049505,-102,0.4826715732667395,SD,CLE,2022 REG,6,0,13,7,7,19,0,1,-7,7,0,0,0,0,0,0,0,0,0,0.4826715732667395,0.5173284267332605
87054,0.6240601503759399,0.4098360655737705,-166,144,0.6029068727531882,0.3970931272468118,home,SD,under,7.5,0.5391705069124424,-117,0.5173284267332605,SD,CLE,2022 REG,6,0,13,7,7,19,0,1,-7,7,0,0,0,0,0,0,0,0,0,0.4826715732667395,0.5173284267332605
87055,0.6515679442508712,0.38314176245210724,-187,161,0.6289522120088608,0.37104778799113924,away,CIN,over,8.5,0.5073891625615764,-103,0.4837652908580103,STL,CIN,2022 REG,7,5,12,4,9,19,1,0,1,-1,1,1,1,1,0,0,0,0,0,0.4837652908580103,0.5162347091419897
87055,0.6515679442508712,0.38314176245210724,-187,161,0.6289522120088608,0.37104778799113924,home,STL,under,8.5,0.5391705069124424,-117,0.5162347091419897,STL,CIN,2022 REG,7,5,12,4,9,19,1,0,1,-1,1,1,1,1,0,0,0,0,0,0.4837652908580103,0.5162347091419897
87056,0.6336996336996338,0.4098360655737705,-173,144,0.60611107701722,0.39388892298278,away,STL,over,8.5,0.5348837209302326,-115,0.5097020142727117,ATL,STL,2022 REG,5,3,7,0,3,12,1,0,3,-3,0,0,0,0,0,0,0,0,0,0.5097020142727117,0.49029798572728833
87056,0.6336996336996338,0.4098360655737705,-173,144,0.60611107701722,0.39388892298278,home,ATL,under,8.5,0.5121951219512195,-105,0.49029798572728833,ATL,STL,2022 REG,5,3,7,0,3,12,1,0,3,-3,0,0,0,0,0,0,0,0,0,0.5097020142727117,0.49029798572728833
87057,0.5305164319248826,0.5098039215686274,-113,-104,0.5091258218555558,0.49087417814444423,away,SEA,over,9,0.5121951219512195,-105,0.48919479393107135,BOS,SEA,2022 REG,8,7,5,3,10,13,1,0,4,-4,1,1,1,0,0,0,0,0,0,0.48919479393107135,0.5108052060689287
87057,0.5305164319248826,0.5098039215686274,-113,-104,0.5091258218555558,0.49087417814444423,home,BOS,under,9,0.5327102803738317,-114,0.5108052060689287,BOS,SEA,2022 REG,8,7,5,3,10,13,1,0,4,-4,1,1,1,0,0,0,0,0,0,0.48919479393107135,0.5108052060689287
87058,0.4926108374384236,0.5495495495495495,103,-122,0.4718421738975501,0.5281578261024499,away,CWS,over,8,0.5,100,0.4772727272727273,KC,CWS,2022 REG,9,4,7,2,6,16,1,0,2,-2,1,1,0,0,0,0,0,0,0,0.4772727272727273,0.5227272727272727
87058,0.4926108374384236,0.5495495495495495,103,-122,0.4718421738975501,0.5281578261024499,home,KC,under,8,0.5454545454545454,-120,0.5227272727272727,KC,CWS,2022 REG,9,4,7,2,6,16,1,0,2,-2,1,1,0,0,0,0,0,0,0,0.4772727272727273,0.5227272727272727
87059,0.6453900709219857,0.3891050583657587,-182,157,0.6231272569845053,0.37687274301549467,away,CIN,over,7.5,0.5121951219512195,-105,0.48919479393107135,SD,CIN,2022 REG,7,4,6,1,5,13,1,0,3,-3,1,0,0,0,0,0,0,0,0,0.48919479393107135,0.5108052060689287
87059,0.6453900709219857,0.3891050583657587,-182,157,0.6231272569845053,0.37687274301549467,home,SD,under,7.5,0.5327102803738317,-114,0.5108052060689287,SD,CIN,2022 REG,7,4,6,1,5,13,1,0,3,-3,1,0,0,0,0,0,0,0,0,0.48919479393107135,0.5108052060689287
87060,0.4672897196261683,0.5726495726495727,114,-134,0.44862649893656975,0.5513735010634302,away,MIL,over,6.5,0.5238095238095238,-110,0.4988662131519274,SD,MIL,2022 REG,8,1,5,4,5,13,0,1,-3,3,1,0,0,0,0,0,0,0,0,0.4988662131519274,0.5011337868480725
87060,0.4672897196261683,0.5726495726495727,114,-134,0.44862649893656975,0.5513735010634302,home,SD,under,6.5,0.5238095238095238,-110,0.5011337868480725,SD,MIL,2022 REG,8,1,5,4,5,13,0,1,-3,3,1,0,0,0,0,0,0,0,0,0.4988662131519274,0.5011337868480725
87061,0.6491228070175439,0.3846153846153846,-185,160,0.6272225773610816,0.37277742263891844,away,OAK,over,7.5,0.5098039215686274,-104,0.4870219861770517,TB,OAK,2022 REG,8,2,5,4,6,13,0,1,-2,2,1,1,0,0,0,0,0,0,0,0.4870219861770517,0.5129780138229483
87061,0.6491228070175439,0.3846153846153846,-185,160,0.6272225773610816,0.37277742263891844,home,TB,under,7.5,0.5348837209302326,-115,0.5129780138229483,TB,OAK,2022 REG,8,2,5,4,6,13,0,1,-2,2,1,1,0,0,0,0,0,0,0,0.4870219861770517,0.5129780138229483
87062,0.5454545454545454,0.49751243781094534,-120,101,0.5220180091279142,0.4779819908720858,away,OAK,over,7.5,0.5073891625615764,-103,0.4826927225525911,DET,OAK,2022 REG,6,3,5,5,8,11,0,1,-2,2,1,1,1,0,0,0,0,0,0,0.4826927225525911,0.5173072774474089
87062,0.5454545454545454,0.49751243781094534,-120,101,0.5220180091279142,0.4779819908720858,home,DET,under,7.5,0.5412844036697247,-118,0.5173072774474089,DET,OAK,2022 REG,6,3,5,5,8,11,0,1,-2,2,1,1,1,0,0,0,0,0,0,0.4826927225525911,0.5173072774474089
87063,0.4347826086956522,0.6047430830039526,130,-153,0.4175975253479979,0.5824024746520021,away,TB,over,8.5,0.5348837209302326,-115,0.5097020142727117,KC,TB,2022 REG,14,4,5,2,6,19,1,0,2,-2,1,1,0,0,0,0,0,0,0,0.5097020142727117,0.49029798572728833
87063,0.4347826086956522,0.6047430830039526,130,-153,0.4175975253479979,0.5824024746520021,home,KC,under,8.5,0.5121951219512195,-105,0.49029798572728833,KC,TB,2022 REG,14,4,5,2,6,19,1,0,2,-2,1,1,0,0,0,0,0,0,0,0.5097020142727117,0.49029798572728833
87064,0.626865671641791,0.41152263374485604,-168,143,0.6028013608024003,0.3971986391975997,away,ARI,over,9,0.5169082125603864,-107,0.49353874091423283,CLE,ARI,2022 REG,10,6,9,5,11,19,1,0,1,-1,1,1,1,1,1,0,0,0,0,0.49353874091423283,0.5064612590857671
87064,0.626865671641791,0.41152263374485604,-168,143,0.6028013608024003,0.3971986391975997,home,CLE,under,9,0.5283018867924528,-112,0.5064612590857671,CLE,ARI,2022 REG,10,6,9,5,11,19,1,0,1,-1,1,1,1,1,1,0,0,0,0,0.49353874091423283,0.5064612590857671
87065,0.5815899581589958,0.4608294930875576,-139,117,0.5569192312833853,0.4430807687166147,away,MIA,over,8.5,0.5145631067961165,-106,0.4913668392989033,ATL,MIA,2022 REG,7,4,11,5,9,18,0,1,-1,1,1,1,1,1,0,0,0,0,0,0.4913668392989033,0.5086331607010968
87065,0.5815899581589958,0.4608294930875576,-139,117,0.5569192312833853,0.4430807687166147,home,ATL,under,8.5,0.5305164319248826,-113,0.5086331607010968,ATL,MIA,2022 REG,7,4,11,5,9,18,0,1,-1,1,1,1,1,1,0,0,0,0,0,0.4913668392989033,0.5086331607010968
87066,0.4184100418410042,0.6183206106870228,139,-162,0.40304156797990504,0.5969584320200949,away,SD,over,9,0.5215311004784688,-109,0.49907282342437215,ARI,SD,2022 REG,7,4,3,0,4,10,1,0,4,-4,0,0,0,0,0,0,0,0,0,0.49907282342437215,0.5009271765756278
87066,0.4184100418410042,0.6183206106870228,139,-162,0.40304156797990504,0.5969584320200949,home,ARI,under,9,0.5215311004784688,-109,0.5009271765756278,ARI,SD,2022 REG,7,4,3,0,4,10,1,0,4,-4,0,0,0,0,0,0,0,0,0,0.49907282342437215,0.5009271765756278
87067,0.7101449275362319,0.3333333333333333,-245,200,0.6792690611216132,0.3207309388783868,away,TB,over,7,0.5454545454545454,-120,0.5206611570247933,NYY,TB,2022 REG,7,0,7,4,4,14,0,1,-4,4,0,0,0,0,0,0,0,0,0,0.5206611570247933,0.4793388429752067
87067,0.7101449275362319,0.3333333333333333,-245,200,0.6792690611216132,0.3207309388783868,home,NYY,under,7,0.5,100,0.4793388429752067,NYY,TB,2022 REG,7,0,7,4,4,14,0,1,-4,4,0,0,0,0,0,0,0,0,0,0.5206611570247933,0.4793388429752067
87068,0.5934959349593496,0.4504504504504505,-146,122,0.5674139338624764,0.4325860661375236,away,CIN,over,8.5,0.5454545454545454,-120,0.5206611570247933,BOS,CIN,2022 REG,4,1,8,2,3,12,0,1,-1,1,1,0,0,0,0,0,0,0,0,0.5206611570247933,0.4793388429752067
87068,0.5934959349593496,0.4504504504504505,-146,122,0.5674139338624764,0.4325860661375236,home,BOS,under,8.5,0.5,100,0.4793388429752067,BOS,CIN,2022 REG,4,1,8,2,3,12,0,1,-1,1,1,0,0,0,0,0,0,0,0,0.5206611570247933,0.4793388429752067
87069,0.646643109540636,0.3921568627450981,-183,155,0.6215533748116984,0.37844662518830163,away,ARI,over,7.5,0.5,100,0.4772727272727273,STL,ARI,2022 REG,5,2,9,6,8,14,0,1,-4,4,1,1,0,0,0,0,0,0,0,0.4772727272727273,0.5227272727272727
87069,0.646643109540636,0.3921568627450981,-183,155,0.6215533748116984,0.37844662518830163,home,STL,under,7.5,0.5454545454545454,-120,0.5227272727272727,STL,ARI,2022 REG,5,2,9,6,8,14,0,1,-4,4,1,1,0,0,0,0,0,0,0,0.4772727272727273,0.5227272727272727
87070,0.4424778761061947,0.5934959349593496,126,-146,0.42656026059046714,0.5734397394095329,away,LAD,over,8,0.5098039215686274,-104,0.48592421718142587,SD,LAD,2022 REG,9,4,11,8,12,20,0,1,-4,4,1,1,1,1,0,0,0,0,0,0.48592421718142587,0.5140757828185741
87070,0.4424778761061947,0.5934959349593496,126,-146,0.42656026059046714,0.5734397394095329,home,SD,under,8,0.5370370370370371,-116,0.5140757828185741,SD,LAD,2022 REG,9,4,11,8,12,20,0,1,-4,4,1,1,1,1,0,0,0,0,0,0.48592421718142587,0.5140757828185741
87071,0.7142857142857143,0.3278688524590164,-250,205,0.6841753094680495,0.3158246905319505,away,KC,over,8.5,0.5454545454545454,-120,0.5206611570247933,NYY,KC,2022 REG,2,1,4,0,1,6,1,0,1,-1,0,0,0,0,0,0,0,0,0,0.5206611570247933,0.4793388429752067
87071,0.7142857142857143,0.3278688524590164,-250,205,0.6841753094680495,0.3158246905319505,home,NYY,under,8.5,0.5,100,0.4793388429752067,NYY,KC,2022 REG,2,1,4,0,1,6,1,0,1,-1,0,0,0,0,0,0,0,0,0,0.5206611570247933,0.4793388429752067
87072,0.5121951219512195,0.5348837209302326,-105,-115,0.48808156828023186,0.5119184317197681,away,MIL,over,8.5,0.5412844036697247,-118,0.5175913212324037,ARI,MIL,2022 REG,6,2,9,1,3,15,1,0,1,-1,1,0,0,0,0,0,0,0,0,0.5175913212324037,0.4824086787675963
87072,0.5121951219512195,0.5348837209302326,-105,-115,0.48808156828023186,0.5119184317197681,home,ARI,under,8.5,0.5024875621890548,-101,0.4824086787675963,ARI,MIL,2022 REG,6,2,9,1,3,15,1,0,1,-1,1,0,0,0,0,0,0,0,0,0.5175913212324037,0.4824086787675963
87073,0.6000000000000001,0.43859649122807015,-150,128,0.5768421052631579,0.42315789473684207,away,PIT,over,9.5,0.5215311004784688,-109,0.4978845547971712,WSH,PIT,2022 REG,10,3,7,2,5,17,1,0,1,-1,1,1,0,0,0,0,0,0,0,0.4978845547971712,0.5021154452028288
87073,0.6000000000000001,0.43859649122807015,-150,128,0.5768421052631579,0.42315789473684207,home,WSH,under,9.5,0.5238095238095238,-110,0.5021154452028288,WSH,PIT,2022 REG,10,3,7,2,5,17,1,0,1,-1,1,1,0,0,0,0,0,0,0,0.4978845547971712,0.5021154452028288
87074,0.6183206106870228,0.4166666666666667,-162,140,0.5966872559874133,0.40331274401258665,away,CIN,over,8,0.5238095238095238,-110,0.4988662131519274,CLE,CIN,2022 REG,5,4,9,5,9,14,0,1,-1,1,1,1,1,1,0,0,0,0,0,0.4988662131519274,0.5011337868480725
87074,0.6183206106870228,0.4166666666666667,-162,140,0.5966872559874133,0.40331274401258665,home,CLE,under,8,0.5238095238095238,-110,0.5011337868480725,CLE,CIN,2022 REG,5,4,9,5,9,14,0,1,-1,1,1,1,1,1,0,0,0,0,0,0.4988662131519274,0.5011337868480725
87075,0.5283018867924528,0.5121951219512195,-112,-105,0.5069072406637203,0.4930927593362797,away,BOS,over,9,0.5283018867924528,-112,0.5044173060022736,CWS,BOS,2022 REG,10,7,19,16,23,29,0,1,-9,9,1,1,1,1,1,1,1,0,0,0.5044173060022736,0.49558269399772636
87075,0.5283018867924528,0.5121951219512195,-112,-105,0.5069072406637203,0.4930927593362797,home,CWS,under,9,0.5169082125603864,-107,0.49558269399772636,CWS,BOS,2022 REG,10,7,19,16,23,29,0,1,-9,9,1,1,1,1,1,1,1,0,0,0.5044173060022736,0.49558269399772636
87076,0.4444444444444444,0.5967741935483871,125,-148,0.42612504978096366,0.5738749502190363,away,ATL,over,11,0.5098039215686274,-104,0.4870219861770517,COL,ATL,2022 REG,13,6,18,13,19,31,0,1,-7,7,1,1,1,1,1,1,0,0,0,0.4870219861770517,0.5129780138229483
87076,0.4444444444444444,0.5967741935483871,125,-148,0.42612504978096366,0.5738749502190363,home,COL,under,11,0.5348837209302326,-115,0.5129780138229483,COL,ATL,2022 REG,13,6,18,13,19,31,0,1,-7,7,1,1,1,1,1,1,0,0,0,0.4870219861770517,0.5129780138229483
87077,0.5594713656387665,0.47846889952153115,-127,109,0.5382448736768379,0.46175512632316207,away,CLE,over,8.5,0.5454545454545454,-120,0.5206611570247933,KC,CLE,2022 REG,10,4,9,3,7,19,1,0,1,-1,1,1,1,0,0,0,0,0,0,0.5206611570247933,0.4793388429752067
87077,0.5594713656387665,0.47846889952153115,-127,109,0.5382448736768379,0.46175512632316207,home,KC,under,8.5,0.5,100,0.4793388429752067,KC,CLE,2022 REG,10,4,9,3,7,19,1,0,1,-1,1,1,1,0,0,0,0,0,0,0.5206611570247933,0.4793388429752067
87078,0.6153846153846154,0.42194092827004215,-160,137,0.5924150500586723,0.40758494994132766,away,BAL,over,8.5,0.5348837209302326,-115,0.5109810284308424,CWS,BAL,2022 REG,9,0,10,4,4,19,0,1,-4,4,0,0,0,0,0,0,0,0,0,0.5109810284308424,0.48901897156915763
87078,0.6153846153846154,0.42194092827004215,-160,137,0.5924150500586723,0.40758494994132766,home,CWS,under,8.5,0.5098039215686274,-104,0.48901897156915763,CWS,BAL,2022 REG,9,0,10,4,4,19,0,1,-4,4,0,0,0,0,0,0,0,0,0,0.5109810284308424,0.48901897156915763
87079,0.6539792387543253,0.38759689922480617,-189,158,0.626789307688388,0.37321069231161197,away,LAA,over,9,0.5024875621890548,-101,0.47839724939301687,TOR,LAA,2022 REG,6,0,13,12,12,19,0,1,-12,12,0,0,0,0,0,0,0,0,0,0.47839724939301687,0.5216027506069831
87079,0.6539792387543253,0.38759689922480617,-189,158,0.626789307688388,0.37321069231161197,home,TOR,under,9,0.5454545454545454,-120,0.5216027506069831,TOR,LAA,2022 REG,6,0,13,12,12,19,0,1,-12,12,0,0,0,0,0,0,0,0,0,0.47839724939301687,0.5216027506069831
87080,0.42194092827004215,0.6183206106870228,137,-162,0.4049529371489177,0.5950470628510822,away,HOU,over,7.5,0.5348837209302326,-115,0.5097020142727117,SEA,HOU,2022 REG,3,0,8,4,4,11,0,1,-4,4,0,0,0,0,0,0,0,0,0,0.5097020142727117,0.49029798572728833
87080,0.42194092827004215,0.6183206106870228,137,-162,0.4049529371489177,0.5950470628510822,home,SEA,under,7.5,0.5121951219512195,-105,0.49029798572728833,SEA,HOU,2022 REG,3,0,8,4,4,11,0,1,-4,4,0,0,0,0,0,0,0,0,0,0.5097020142727117,0.49029798572728833
87081,0.33112582781456956,0.7142857142857143,202,-250,0.31608889334427687,0.6839111066557231,away,SF,over,7.5,0.5,100,0.4772727272727273,OAK,SF,2022 REG,10,3,11,7,10,21,0,1,-4,4,1,1,1,0,0,0,0,0,0,0.4772727272727273,0.5227272727272727
87081,0.33112582781456956,0.7142857142857143,202,-250,0.31608889334427687,0.6839111066557231,home,OAK,under,7.5,0.5454545454545454,-120,0.5227272727272727,OAK,SF,2022 REG,10,3,11,7,10,21,0,1,-4,4,1,1,1,0,0,0,0,0,0,0.4772727272727273,0.5227272727272727
87082,0.7142857142857143,0.32573289902280134,-250,207,0.6857009904939174,0.3142990095060826,away,PIT,over,8.5,0.5454545454545454,-120,0.5220180091279142,PHI,PIT,2022 REG,4,0,9,5,5,13,0,1,-5,5,0,0,0,0,0,0,0,0,0,0.5220180091279142,0.4779819908720858
87082,0.7142857142857143,0.32573289902280134,-250,207,0.6857009904939174,0.3142990095060826,home,PHI,under,8.5,0.49751243781094534,101,0.4779819908720858,PHI,PIT,2022 REG,4,0,9,5,5,13,0,1,-5,5,0,0,0,0,0,0,0,0,0,0.5220180091279142,0.4779819908720858
87083,0.6415770609318996,0.41152263374485604,-179,143,0.6075095148848054,0.3924904851151946,away,CHC,over,8,0.504950495049505,-102,0.47949844489399435,SD,CHC,2022 REG,12,5,9,7,12,21,0,1,-2,2,1,1,1,1,1,0,0,0,0,0.47949844489399435,0.5205015551060057
87083,0.6415770609318996,0.41152263374485604,-179,143,0.6075095148848054,0.3924904851151946,home,SD,under,8,0.5454545454545454,-120,0.5205015551060057,SD,CHC,2022 REG,12,5,9,7,12,21,0,1,-2,2,1,1,1,1,1,0,0,0,0,0.47949844489399435,0.5205015551060057
87084,0.6197718631178707,0.4166666666666667,-163,140,0.597188287624032,0.402811712375968,away,TEX,over,8.5,0.5121951219512195,-105,0.48808156828023186,LAA,TEX,2022 REG,11,4,5,1,5,16,1,0,3,-3,1,0,0,0,0,0,0,0,0,0.48808156828023186,0.5119184317197681
87084,0.6197718631178707,0.4166666666666667,-163,140,0.597188287624032,0.402811712375968,home,LAA,under,8.5,0.5348837209302326,-115,0.5119184317197681,LAA,TEX,2022 REG,11,4,5,1,5,16,1,0,3,-3,1,0,0,0,0,0,0,0,0,0.48808156828023186,0.5119184317197681
87085,0.6226415094339623,0.4166666666666667,-165,140,0.5981666073335706,0.40183339266642937,away,DET,over,8,0.5283018867924528,-112,0.5044173060022736,HOU,DET,2022 REG,8,3,9,2,5,17,1,0,1,-1,1,1,0,0,0,0,0,0,0,0.5044173060022736,0.49558269399772636
87085,0.6226415094339623,0.4166666666666667,-165,140,0.5981666073335706,0.40183339266642937,home,HOU,under,8,0.5169082125603864,-107,0.49558269399772636,HOU,DET,2022 REG,8,3,9,2,5,17,1,0,1,-1,1,1,0,0,0,0,0,0,0,0.5044173060022736,0.49558269399772636
87086,0.6453900709219857,0.3921568627450981,-182,155,0.6211576527396834,0.3788423472603166,away,CIN,over,8.5,0.5238095238095238,-110,0.5012646084074657,ATL,CIN,2022 REG,8,7,6,6,13,14,1,0,1,-1,1,1,1,1,1,1,0,0,0,0.5012646084074657,0.4987353915925343
87086,0.6453900709219857,0.3921568627450981,-182,155,0.6211576527396834,0.3788423472603166,home,ATL,under,8.5,0.5192307692307692,-108,0.4987353915925343,ATL,CIN,2022 REG,8,7,6,6,13,14,1,0,1,-1,1,1,1,1,1,1,0,0,0,0.5012646084074657,0.4987353915925343
87087,0.35460992907801414,0.6894409937888198,182,-222,0.33898903444438505,0.6610109655556149,away,MIL,over,8,0.504950495049505,-102,0.4826715732667395,CIN,MIL,2022 REG,4,2,13,10,12,17,0,1,-8,8,1,1,0,0,0,0,0,0,0,0.4826715732667395,0.5173284267332605
87087,0.35460992907801414,0.6894409937888198,182,-222,0.33898903444438505,0.6610109655556149,home,CIN,under,8,0.5391705069124424,-117,0.5173284267332605,CIN,MIL,2022 REG,4,2,13,10,12,17,0,1,-8,8,1,1,0,0,0,0,0,0,0,0.4826715732667395,0.5173284267332605
87088,0.5726495726495727,0.46511627906976744,-134,115,0.5510229738017454,0.44897702619825464,away,ATL,over,9,0.5192307692307692,-108,0.49455035168025013,NYM,ATL,2022 REG,13,8,12,5,13,25,1,0,3,-3,1,1,1,1,1,0,0,0,0,0.49455035168025013,0.5054496483197499
87088,0.5726495726495727,0.46511627906976744,-134,115,0.5510229738017454,0.44897702619825464,home,NYM,under,9,0.5283018867924528,-112,0.5054496483197499,NYM,ATL,2022 REG,13,8,12,5,13,25,1,0,3,-3,1,1,1,1,1,0,0,0,0,0.49455035168025013,0.5054496483197499
87089,0.7685185185185185,0.27027027027027023,-332,270,0.7387086160234309,0.26129138397656915,away,COL,over,8.5,0.5238095238095238,-110,0.4988662131519274,ATL,COL,2022 REG,5,3,6,2,5,11,1,0,1,-1,1,1,0,0,0,0,0,0,0,0.4988662131519274,0.5011337868480725
87089,0.7685185185185185,0.27027027027027023,-332,270,0.7387086160234309,0.26129138397656915,home,ATL,under,8.5,0.5238095238095238,-110,0.5011337868480725,ATL,COL,2022 REG,5,3,6,2,5,11,1,0,1,-1,1,1,0,0,0,0,0,0,0,0.4988662131519274,0.5011337868480725
87090,0.7435897435897436,0.29673590504451036,-290,237,0.7136040048617086,0.2863959951382914,away,LAA,over,7,0.5238095238095238,-110,0.4988662131519274,TB,LAA,2022 REG,5,4,7,3,7,12,1,0,1,-1,1,1,1,0,0,0,0,0,0,0.4988662131519274,0.5011337868480725
87090,0.7435897435897436,0.29673590504451036,-290,237,0.7136040048617086,0.2863959951382914,home,TB,under,7,0.5238095238095238,-110,0.5011337868480725,TB,LAA,2022 REG,5,4,7,3,7,12,1,0,1,-1,1,1,1,0,0,0,0,0,0,0.4988662131519274,0.5011337868480725
87091,0.5238095238095238,0.5238095238095238,-110,-110,0.4988662131519274,0.5011337868480725,away,CIN,over,8,0.5192307692307692,-108,0.49571111079951763,PIT,CIN,2022 REG,7,2,10,8,10,17,0,1,-6,6,1,1,0,0,0,0,0,0,0,0.49571111079951763,0.5042888892004824
87091,0.5238095238095238,0.5238095238095238,-110,-110,0.4988662131519274,0.5011337868480725,home,PIT,under,8,0.5260663507109005,-111,0.5042888892004824,PIT,CIN,2022 REG,7,2,10,8,10,17,0,1,-6,6,1,1,0,0,0,0,0,0,0,0.49571111079951763,0.5042888892004824
87092,0.5073891625615764,0.5305164319248826,-103,-113,0.4881562747186933,0.5118437252813067,away,ARI,over,8,0.5121951219512195,-105,0.48808156828023186,CWS,ARI,2022 REG,7,5,11,10,15,18,0,1,-5,5,1,1,1,1,1,0,0,0,0,0.48808156828023186,0.5119184317197681
87092,0.5073891625615764,0.5305164319248826,-103,-113,0.4881562747186933,0.5118437252813067,home,CWS,under,8,0.5348837209302326,-115,0.5119184317197681,CWS,ARI,2022 REG,7,5,11,10,15,18,0,1,-5,5,1,1,1,1,1,0,0,0,0,0.48808156828023186,0.5119184317197681
87093,0.5412844036697247,0.5024875621890548,-118,-101,0.5175913212324037,0.4824086787675963,away,SEA,over,8.5,0.5412844036697247,-118,0.5189377998484975,CWS,SEA,2022 REG,6,3,7,2,5,13,1,0,1,-1,1,1,0,0,0,0,0,0,0,0.5189377998484975,0.4810622001515025
87093,0.5412844036697247,0.5024875621890548,-118,-101,0.5175913212324037,0.4824086787675963,home,CWS,under,8.5,0.5,100,0.4810622001515025,CWS,SEA,2022 REG,6,3,7,2,5,13,1,0,1,-1,1,1,0,0,0,0,0,0,0,0.5189377998484975,0.4810622001515025
87094,0.6254681647940076,0.41493775933609955,-167,141,0.6001955455815435,0.39980445441845647,away,OAK,over,7,0.5495495495495495,-122,0.5277073575960698,SEA,OAK,2022 REG,8,7,12,6,13,20,1,0,1,-1,1,1,1,1,1,1,0,0,0,0.5277073575960698,0.4722926424039302
87094,0.6254681647940076,0.41493775933609955,-167,141,0.6001955455815435,0.39980445441845647,home,SEA,under,7,0.49019607843137253,104,0.4722926424039302,SEA,OAK,2022 REG,8,7,12,6,13,20,1,0,1,-1,1,1,1,1,1,1,0,0,0,0.5277073575960698,0.4722926424039302
87095,0.4166666666666667,0.6183206106870228,140,-162,0.40208863443596277,0.5979113655640372,away,TEX,over,8.5,0.5454545454545454,-120,0.5206611570247933,DET,TEX,2022 REG,8,1,4,3,4,12,0,1,-2,2,1,0,0,0,0,0,0,0,0,0.5206611570247933,0.4793388429752067
87095,0.4166666666666667,0.6183206106870228,140,-162,0.40208863443596277,0.5979113655640372,home,DET,under,8.5,0.5,100,0.4793388429752067,DET,TEX,2022 REG,8,1,4,3,4,12,0,1,-2,2,1,0,0,0,0,0,0,0,0,0.5206611570247933,0.4793388429752067
87096,0.5145631067961165,0.5238095238095238,-106,-110,0.4948179667757384,0.5051820332242616,away,CHC,over,7.5,0.5238095238095238,-110,0.5000596729920038,PIT,CHC,2022 REG,7,6,5,0,6,12,1,0,6,-6,0,0,0,0,0,0,0,0,0,0.5000596729920038,0.4999403270079962
87096,0.5145631067961165,0.5238095238095238,-106,-110,0.4948179667757384,0.5051820332242616,home,PIT,under,7.5,0.5215311004784688,-109,0.4999403270079962,PIT,CHC,2022 REG,7,6,5,0,6,12,1,0,6,-6,0,0,0,0,0,0,0,0,0,0.5000596729920038,0.4999403270079962
87097,0.6108949416342413,0.425531914893617,-157,135,0.5886419592417365,0.41135804075826354,away,STL,over,8,0.5238095238095238,-110,0.5000596729920038,SD,STL,2022 REG,6,4,8,5,9,14,0,1,-1,1,1,1,1,1,0,0,0,0,0,0.5000596729920038,0.4999403270079962
87097,0.6108949416342413,0.425531914893617,-157,135,0.5886419592417365,0.41135804075826354,home,SD,under,8,0.5215311004784688,-109,0.4999403270079962,SD,STL,2022 REG,6,4,8,5,9,14,0,1,-1,1,1,1,1,1,0,0,0,0,0,0.5000596729920038,0.4999403270079962
87098,0.5815899581589958,0.4587155963302753,-139,118,0.5581486524100054,0.44185134758999456,away,BOS,over,8.5,0.5121951219512195,-105,0.48919479393107135,TB,BOS,2022 REG,6,3,11,4,7,17,0,1,-1,1,1,1,1,0,0,0,0,0,0,0.48919479393107135,0.5108052060689287
87098,0.5815899581589958,0.4587155963302753,-139,118,0.5581486524100054,0.44185134758999456,home,TB,under,8.5,0.5327102803738317,-114,0.5108052060689287,TB,BOS,2022 REG,6,3,11,4,7,17,0,1,-1,1,1,1,1,0,0,0,0,0,0,0.48919479393107135,0.5108052060689287
87099,0.6124031007751938,0.4273504273504274,-158,134,0.5880579168843095,0.41194208311569047,away,BAL,over,8,0.5121951219512195,-105,0.48808156828023186,TEX,BAL,2022 REG,6,3,9,6,9,15,0,1,-3,3,1,1,1,0,0,0,0,0,0,0.48808156828023186,0.5119184317197681
87099,0.6124031007751938,0.4273504273504274,-158,134,0.5880579168843095,0.41194208311569047,home,TEX,under,8,0.5348837209302326,-115,0.5119184317197681,TEX,BAL,2022 REG,6,3,9,6,9,15,0,1,-3,3,1,1,1,0,0,0,0,0,0,0.48808156828023186,0.5119184317197681
87100,0.390625,0.6491228070175439,156,-185,0.37509851288377194,0.6249014871162281,away,TOR,over,8,0.5121951219512195,-105,0.48808156828023186,MIN,TOR,2022 REG,11,2,10,3,5,21,0,1,-1,1,1,1,0,0,0,0,0,0,0,0.48808156828023186,0.5119184317197681
87100,0.390625,0.6491228070175439,156,-185,0.37509851288377194,0.6249014871162281,home,MIN,under,8,0.5348837209302326,-115,0.5119184317197681,MIN,TOR,2022 REG,11,2,10,3,5,21,0,1,-1,1,1,1,0,0,0,0,0,0,0,0.48808156828023186,0.5119184317197681
87101,0.5098039215686274,0.5327102803738317,-104,-114,0.4881300146960012,0.5118699853039987,away,HOU,over,9.5,0.49504950495049505,102,0.47499799484898986,TEX,HOU,2022 REG,3,1,6,5,6,9,0,1,-4,4,1,0,0,0,0,0,0,0,0,0.47499799484898986,0.5250020051510101
87101,0.5098039215686274,0.5327102803738317,-104,-114,0.4881300146960012,0.5118699853039987,home,TEX,under,9.5,0.5454545454545454,-120,0.5250020051510101,TEX,HOU,2022 REG,3,1,6,5,6,9,0,1,-4,4,1,0,0,0,0,0,0,0,0,0.47499799484898986,0.5250020051510101
87102,0.574468085106383,0.4716981132075471,-135,112,0.547947077564338,0.452052922435662,away,SEA,over,9,0.5433789954337899,-119,0.5171177654451503,MIN,SEA,2022 REG,10,4,2,0,4,12,1,0,4,-4,0,0,0,0,0,0,0,0,0,0.5171177654451503,0.4828822345548497
87102,0.574468085106383,0.4716981132075471,-135,112,0.547947077564338,0.452052922435662,home,MIN,under,9,0.504950495049505,-102,0.4828822345548497,MIN,SEA,2022 REG,10,4,2,0,4,12,1,0,4,-4,0,0,0,0,0,0,0,0,0,0.5171177654451503,0.4828822345548497
87103,0.7014925373134329,0.3389830508474576,-235,195,0.6730992142751963,0.32690078572480374,away,ARI,over,9,0.49751243781094534,101,0.47511256217505476,LAD,ARI,2022 REG,9,5,5,4,9,14,1,0,1,-1,1,1,1,1,0,0,0,0,0,0.47511256217505476,0.5248874378249453
87103,0.7014925373134329,0.3389830508474576,-235,195,0.6730992142751963,0.32690078572480374,home,LAD,under,9,0.5475113122171946,-121,0.5248874378249453,LAD,ARI,2022 REG,9,5,5,4,9,14,1,0,1,-1,1,1,1,1,0,0,0,0,0,0.47511256217505476,0.5248874378249453
87104,0.3921568627450981,0.6428571428571428,155,-180,0.37842588015598405,0.6215741198440159,away,NYM,over,8,0.5348837209302326,-115,0.5097020142727117,WSH,NYM,2022 REG,10,8,10,3,11,20,1,0,5,-5,1,1,1,0,0,0,0,0,0,0.5097020142727117,0.49029798572728833
87104,0.3921568627450981,0.6428571428571428,155,-180,0.37842588015598405,0.6215741198440159,home,WSH,under,8,0.5121951219512195,-105,0.49029798572728833,WSH,NYM,2022 REG,10,8,10,3,11,20,1,0,5,-5,1,1,1,0,0,0,0,0,0,0.5097020142727117,0.49029798572728833
87105,0.5967741935483871,0.4424778761061947,-148,126,0.5733495713351688,0.42665042866483116,away,NYY,over,8.5,0.5121951219512195,-105,0.48808156828023186,TOR,NYY,2022 REG,5,0,8,4,4,13,0,1,-4,4,0,0,0,0,0,0,0,0,0,0.48808156828023186,0.5119184317197681
87105,0.5967741935483871,0.4424778761061947,-148,126,0.5733495713351688,0.42665042866483116,home,TOR,under,8.5,0.5348837209302326,-115,0.5119184317197681,TOR,NYY,2022 REG,5,0,8,4,4,13,0,1,-4,4,0,0,0,0,0,0,0,0,0,0.48808156828023186,0.5119184317197681
87106,0.7118155619596541,0.33112582781456956,-247,202,0.6812492124661865,0.3187507875338135,away,CLE,over,6.5,0.5454545454545454,-120,0.5206611570247933,TB,CLE,2022 REG,8,3,9,5,8,17,0,1,-2,2,1,1,1,0,0,0,0,0,0,0.5206611570247933,0.4793388429752067
87106,0.7118155619596541,0.33112582781456956,-247,202,0.6812492124661865,0.3187507875338135,home,TB,under,6.5,0.5,100,0.4793388429752067,TB,CLE,2022 REG,8,3,9,5,8,17,0,1,-2,2,1,1,1,0,0,0,0,0,0,0.5206611570247933,0.4793388429752067
87107,0.6428571428571428,0.390625,-180,156,0.6213329081632653,0.37866709183673475,away,CIN,over,8.5,0.5145631067961165,-106,0.4913668392989033,ATL,CIN,2022 REG,4,3,10,6,9,14,0,1,-3,3,1,1,1,0,0,0,0,0,0,0.4913668392989033,0.5086331607010968
87107,0.6428571428571428,0.390625,-180,156,0.6213329081632653,0.37866709183673475,home,ATL,under,8.5,0.5305164319248826,-113,0.5086331607010968,ATL,CIN,2022 REG,4,3,10,6,9,14,0,1,-3,3,1,1,1,0,0,0,0,0,0,0.4913668392989033,0.5086331607010968
87108,0.5708154506437768,0.4672897196261683,-133,114,0.5490644307042802,0.45093556929571976,away,MIN,over,8.5,0.5391705069124424,-117,0.5153817639191344,CLE,MIN,2022 REG,12,7,7,6,13,19,1,0,1,-1,1,1,1,1,1,1,0,0,0,0.5153817639191344,0.4846182360808656
87108,0.5708154506437768,0.4672897196261683,-133,114,0.5490644307042802,0.45093556929571976,home,CLE,under,8.5,0.504950495049505,-102,0.4846182360808656,CLE,MIN,2022 REG,12,7,7,6,13,19,1,0,1,-1,1,1,1,1,1,1,0,0,0,0.5153817639191344,0.4846182360808656
87109,0.6666666666666666,0.37037037037037035,-200,170,0.6419753086419753,0.3580246913580247,away,BAL,over,6.5,0.5370370370370371,-116,0.5118817074154765,TB,BAL,2022 REG,11,8,9,2,10,20,1,0,6,-6,1,1,0,0,0,0,0,0,0,0.5118817074154765,0.48811829258452355
87109,0.6666666666666666,0.37037037037037035,-200,170,0.6419753086419753,0.3580246913580247,home,TB,under,6.5,0.5098039215686274,-104,0.48811829258452355,TB,BAL,2022 REG,11,8,9,2,10,20,1,0,6,-6,1,1,0,0,0,0,0,0,0,0.5118817074154765,0.48811829258452355
87110,0.4854368932038835,0.5614035087719298,106,-128,0.46269883399232364,0.5373011660076763,away,MIN,over,7.5,0.5348837209302326,-115,0.5109810284308424,KC,MIN,2022 REG,10,5,7,2,7,17,1,0,3,-3,1,1,0,0,0,0,0,0,0,0.5109810284308424,0.48901897156915763
87110,0.4854368932038835,0.5614035087719298,106,-128,0.46269883399232364,0.5373011660076763,home,KC,under,7.5,0.5098039215686274,-104,0.48901897156915763,KC,MIN,2022 REG,10,5,7,2,7,17,1,0,3,-3,1,1,0,0,0,0,0,0,0,0.5109810284308424,0.48901897156915763
87111,0.45248868778280543,0.5850622406639003,121,-141,0.43549731744492953,0.5645026825550705,away,ATL,over,9,0.49751243781094534,101,0.476135829221149,TEX,ATL,2022 REG,6,3,9,6,9,15,0,1,-3,3,1,1,1,0,0,0,0,0,0,0.476135829221149,0.523864170778851
87111,0.45248868778280543,0.5850622406639003,121,-141,0.43549731744492953,0.5645026825550705,home,TEX,under,9,0.5454545454545454,-120,0.523864170778851,TEX,ATL,2022 REG,6,3,9,6,9,15,0,1,-3,3,1,1,1,0,0,0,0,0,0,0.476135829221149,0.523864170778851
87112,0.574468085106383,0.4629629629629629,-135,116,0.5529651425984609,0.44703485740153914,away,CIN,over,8.5,0.5215311004784688,-109,0.49907282342437215,WSH,CIN,2022 REG,8,2,12,6,8,20,0,1,-4,4,1,1,0,0,0,0,0,0,0,0.49907282342437215,0.5009271765756278
87112,0.574468085106383,0.4629629629629629,-135,116,0.5529651425984609,0.44703485740153914,home,WSH,under,8.5,0.5215311004784688,-109,0.5009271765756278,WSH,CIN,2022 REG,8,2,12,6,8,20,0,1,-4,4,1,1,0,0,0,0,0,0,0,0.49907282342437215,0.5009271765756278
87114,0.6551724137931035,0.3846153846153846,-190,160,0.6291045458703008,0.37089545412969915,away,KC,over,7.5,0.5327102803738317,-114,0.508788710910954,TB,KC,2022 REG,12,7,6,1,8,18,1,0,6,-6,1,0,0,0,0,0,0,0,0,0.508788710910954,0.491211289089046
87114,0.6551724137931035,0.3846153846153846,-190,160,0.6291045458703008,0.37089545412969915,home,TB,under,7.5,0.5121951219512195,-105,0.491211289089046,TB,KC,2022 REG,12,7,6,1,8,18,1,0,6,-6,1,0,0,0,0,0,0,0,0,0.508788710910954,0.491211289089046
87115,0.5934959349593496,0.4444444444444444,-146,125,0.5709784740123824,0.42902152598761756,away,LAA,over,7.5,0.5121951219512195,-105,0.48808156828023186,SEA,LAA,2022 REG,11,8,4,1,9,15,1,0,7,-7,1,0,0,0,0,0,0,0,0,0.48808156828023186,0.5119184317197681
87115,0.5934959349593496,0.4444444444444444,-146,125,0.5709784740123824,0.42902152598761756,home,SEA,under,7.5,0.5348837209302326,-115,0.5119184317197681,SEA,LAA,2022 REG,11,8,4,1,9,15,1,0,7,-7,1,0,0,0,0,0,0,0,0,0.48808156828023186,0.5119184317197681
87116,0.34965034965034963,0.6894409937888198,186,-222,0.3359820477485421,0.6640179522514579,away,SEA,over,6.5,0.5454545454545454,-120,0.5206611570247933,OAK,SEA,2022 REG,12,5,9,3,8,21,1,0,2,-2,1,1,1,0,0,0,0,0,0,0.5206611570247933,0.4793388429752067
87116,0.34965034965034963,0.6894409937888198,186,-222,0.3359820477485421,0.6640179522514579,home,OAK,under,6.5,0.5,100,0.4793388429752067,OAK,SEA,2022 REG,12,5,9,3,8,21,1,0,2,-2,1,1,1,0,0,0,0,0,0,0.5206611570247933,0.4793388429752067
87117,0.5260663507109005,0.5145631067961165,-111,-106,0.5046925602688205,0.4953074397311795,away,WSH,over,8.5,0.5121951219512195,-105,0.48808156828023186,TEX,WSH,2022 REG,6,3,6,2,5,12,1,0,1,-1,1,1,0,0,0,0,0,0,0,0.48808156828023186,0.5119184317197681
87117,0.5260663507109005,0.5145631067961165,-111,-106,0.5046925602688205,0.4953074397311795,home,TEX,under,8.5,0.5348837209302326,-115,0.5119184317197681,TEX,WSH,2022 REG,6,3,6,2,5,12,1,0,1,-1,1,1,0,0,0,0,0,0,0,0.48808156828023186,0.5119184317197681
87118,0.6575342465753424,0.38314176245210724,-192,161,0.6307883776257865,0.36921162237421346,away,NYY,over,7.5,0.5121951219512195,-105,0.48808156828023186,NYM,NYY,2022 REG,9,3,7,2,5,16,1,0,1,-1,1,1,0,0,0,0,0,0,0,0.48808156828023186,0.5119184317197681
87118,0.6575342465753424,0.38314176245210724,-192,161,0.6307883776257865,0.36921162237421346,home,NYM,under,7.5,0.5348837209302326,-115,0.5119184317197681,NYM,NYY,2022 REG,9,3,7,2,5,16,1,0,1,-1,1,1,0,0,0,0,0,0,0,0.48808156828023186,0.5119184317197681
87119,0.6226415094339623,0.4166666666666667,-165,140,0.5981666073335706,0.40183339266642937,away,PHI,over,7.5,0.5169082125603864,-107,0.49353874091423283,ATL,PHI,2022 REG,14,6,10,5,11,24,1,0,1,-1,1,1,1,1,1,0,0,0,0,0.49353874091423283,0.5064612590857671
87119,0.6226415094339623,0.4166666666666667,-165,140,0.5981666073335706,0.40183339266642937,home,ATL,under,7.5,0.5283018867924528,-112,0.5064612590857671,ATL,PHI,2022 REG,14,6,10,5,11,24,1,0,1,-1,1,1,1,1,1,0,0,0,0,0.49353874091423283,0.5064612590857671
87120,0.4347826086956522,0.6047430830039526,130,-153,0.4175975253479979,0.5824024746520021,away,BOS,over,9.5,0.5,100,0.4772727272727273,CHC,BOS,2022 REG,8,3,5,1,4,13,1,0,2,-2,1,0,0,0,0,0,0,0,0,0.4772727272727273,0.5227272727272727
87120,0.4347826086956522,0.6047430830039526,130,-153,0.4175975253479979,0.5824024746520021,home,CHC,under,9.5,0.5454545454545454,-120,0.5227272727272727,CHC,BOS,2022 REG,8,3,5,1,4,13,1,0,2,-2,1,0,0,0,0,0,0,0,0,0.4772727272727273,0.5227272727272727
87121,0.5884773662551441,0.45248868778280543,-143,121,0.5643697706690257,0.4356302293309743,away,CHC,over,7.5,0.5370370370370371,-116,0.5118817074154765,MIL,CHC,2022 REG,13,11,3,1,12,16,1,0,10,-10,1,0,0,0,0,0,0,0,0,0.5118817074154765,0.48811829258452355
87121,0.5884773662551441,0.45248868778280543,-143,121,0.5643697706690257,0.4356302293309743,home,MIL,under,7.5,0.5098039215686274,-104,0.48811829258452355,MIL,CHC,2022 REG,13,11,3,1,12,16,1,0,10,-10,1,0,0,0,0,0,0,0,0,0.5118817074154765,0.48811829258452355
87122,0.4016064257028112,0.6376811594202898,149,-176,0.38582827906702766,0.6141717209329723,away,CWS,over,7.5,0.5348837209302326,-115,0.5109810284308424,OAK,CWS,2022 REG,6,3,7,5,8,13,0,1,-2,2,1,1,1,0,0,0,0,0,0,0.5109810284308424,0.48901897156915763
87122,0.4016064257028112,0.6376811594202898,149,-176,0.38582827906702766,0.6141717209329723,home,OAK,under,7.5,0.5098039215686274,-104,0.48901897156915763,OAK,CWS,2022 REG,6,3,7,5,8,13,0,1,-2,2,1,1,1,0,0,0,0,0,0,0.5109810284308424,0.48901897156915763
87123,0.7101449275362319,0.33112582781456956,-245,202,0.6808367099682715,0.3191632900317285,away,PIT,over,8,0.5238095238095238,-110,0.4988662131519274,MIL,PIT,2022 REG,8,4,5,2,6,13,1,0,2,-2,1,1,0,0,0,0,0,0,0,0.4988662131519274,0.5011337868480725
87123,0.7101449275362319,0.33112582781456956,-245,202,0.6808367099682715,0.3191632900317285,home,MIL,under,8,0.5238095238095238,-110,0.5011337868480725,MIL,PIT,2022 REG,8,4,5,2,6,13,1,0,2,-2,1,1,0,0,0,0,0,0,0,0.4988662131519274,0.5011337868480725
87124,0.41493775933609955,0.6309963099630996,141,-171,0.39587797954390075,0.6041220204560993,away,TOR,over,8.5,0.5238095238095238,-110,0.4988662131519274,BAL,TOR,2022 REG,12,6,9,5,11,21,1,0,1,-1,1,1,1,1,1,0,0,0,0,0.4988662131519274,0.5011337868480725
87124,0.41493775933609955,0.6309963099630996,141,-171,0.39587797954390075,0.6041220204560993,home,BAL,under,8.5,0.5238095238095238,-110,0.5011337868480725,BAL,TOR,2022 REG,12,6,9,5,11,21,1,0,1,-1,1,1,1,1,1,0,0,0,0,0.4988662131519274,0.5011337868480725
87125,0.5,0.5327102803738317,100,-114,0.48364485981308414,0.5163551401869159,away,PHI,over,8,0.5145631067961165,-106,0.4913668392989033,ATL,PHI,2022 REG,8,4,9,3,7,17,1,0,1,-1,1,1,1,0,0,0,0,0,0,0.4913668392989033,0.5086331607010968
87125,0.5,0.5327102803738317,100,-114,0.48364485981308414,0.5163551401869159,home,ATL,under,8,0.5305164319248826,-113,0.5086331607010968,ATL,PHI,2022 REG,8,4,9,3,7,17,1,0,1,-1,1,1,1,0,0,0,0,0,0,0.4913668392989033,0.5086331607010968
87126,0.4132231404958678,0.6240601503759399,142,-166,0.39781682195379847,0.6021831780462015,away,PHI,over,9.5,0.5283018867924528,-112,0.5044173060022736,WSH,PHI,2022 REG,12,9,6,3,12,18,1,0,6,-6,1,1,1,0,0,0,0,0,0,0.5044173060022736,0.49558269399772636
87126,0.4132231404958678,0.6240601503759399,142,-166,0.39781682195379847,0.6021831780462015,home,WSH,under,9.5,0.5169082125603864,-107,0.49558269399772636,WSH,PHI,2022 REG,12,9,6,3,12,18,1,0,6,-6,1,1,1,0,0,0,0,0,0,0.5044173060022736,0.49558269399772636
87127,0.5327102803738317,0.5,-114,100,0.5152851777447812,0.4847148222552188,away,MIA,over,7.5,0.5,100,0.4783105022831051,ARI,MIA,2022 REG,4,3,15,11,14,19,0,1,-8,8,1,1,1,0,0,0,0,0,0,0.4783105022831051,0.5216894977168949
87127,0.5327102803738317,0.5,-114,100,0.5152851777447812,0.4847148222552188,home,ARI,under,7.5,0.5433789954337899,-119,0.5216894977168949,ARI,MIA,2022 REG,4,3,15,11,14,19,0,1,-8,8,1,1,1,0,0,0,0,0,0,0.4783105022831051,0.5216894977168949
87128,0.6108949416342413,0.43103448275862066,-157,132,0.5852804683670066,0.41471953163299335,away,MIL,over,9,0.5327102803738317,-114,0.5100625279371946,MIN,MIL,2022 REG,6,3,7,6,9,13,0,1,-3,3,1,1,1,0,0,0,0,0,0,0.5100625279371946,0.48993747206280536
87128,0.6108949416342413,0.43103448275862066,-157,132,0.5852804683670066,0.41471953163299335,home,MIN,under,9,0.5098039215686274,-104,0.48993747206280536,MIN,MIL,2022 REG,6,3,7,6,9,13,0,1,-3,3,1,1,1,0,0,0,0,0,0,0.5100625279371946,0.48993747206280536
87129,0.4739336492890995,0.5652173913043479,111,-130,0.4553786537471813,0.5446213462528187,away,LAA,over,8.5,0.5238095238095238,-110,0.5012646084074657,HOU,LAA,2022 REG,1,0,6,6,6,7,0,1,-6,6,0,0,0,0,0,0,0,0,0,0.5012646084074657,0.4987353915925343
87129,0.4739336492890995,0.5652173913043479,111,-130,0.4553786537471813,0.5446213462528187,home,HOU,under,8.5,0.5192307692307692,-108,0.4987353915925343,HOU,LAA,2022 REG,1,0,6,6,6,7,0,1,-6,6,0,0,0,0,0,0,0,0,0,0.5012646084074657,0.4987353915925343
87130,0.4629629629629629,0.5780590717299579,116,-137,0.4439712802347588,0.5560287197652412,away,NYM,over,7,0.5215311004784688,-109,0.4978845547971712,MIA,NYM,2022 REG,10,3,19,9,12,29,0,1,-6,6,1,1,1,0,0,0,0,0,0,0.4978845547971712,0.5021154452028288
87130,0.4629629629629629,0.5780590717299579,116,-137,0.4439712802347588,0.5560287197652412,home,MIA,under,7,0.5238095238095238,-110,0.5021154452028288,MIA,NYM,2022 REG,10,3,19,9,12,29,0,1,-6,6,1,1,1,0,0,0,0,0,0,0.4978845547971712,0.5021154452028288
87131,0.4081632653061224,0.635036496350365,145,-174,0.39053070952796426,0.6094692904720358,away,CLE,over,7,0.5454545454545454,-120,0.5206611570247933,DET,CLE,2022 REG,10,5,6,3,8,16,1,0,2,-2,1,1,1,0,0,0,0,0,0,0.5206611570247933,0.4793388429752067
87131,0.4081632653061224,0.635036496350365,145,-174,0.39053070952796426,0.6094692904720358,home,DET,under,7,0.5,100,0.4793388429752067,DET,CLE,2022 REG,10,5,6,3,8,16,1,0,2,-2,1,1,1,0,0,0,0,0,0,0.5206611570247933,0.4793388429752067
87132,0.4504504504504505,0.5867768595041323,122,-142,0.43368139191235017,0.5663186080876499,away,TOR,over,6.5,0.5327102803738317,-114,0.508788710910954,CLE,TOR,2022 REG,11,8,4,2,10,15,1,0,6,-6,1,1,0,0,0,0,0,0,0,0.508788710910954,0.491211289089046
87132,0.4504504504504505,0.5867768595041323,122,-142,0.43368139191235017,0.5663186080876499,home,CLE,under,6.5,0.5121951219512195,-105,0.491211289089046,CLE,TOR,2022 REG,11,8,4,2,10,15,1,0,6,-6,1,1,0,0,0,0,0,0,0,0.508788710910954,0.491211289089046
87133,0.626865671641791,0.41493775933609955,-168,141,0.6006605358049044,0.3993394641950956,away,PIT,over,8.5,0.5283018867924528,-112,0.5019750255927206,BAL,PIT,2022 REG,11,6,6,3,9,17,1,0,3,-3,1,1,1,0,0,0,0,0,0,0.5019750255927206,0.49802497440727944
87133,0.626865671641791,0.41493775933609955,-168,141,0.6006605358049044,0.3993394641950956,home,BAL,under,8.5,0.5215311004784688,-109,0.49802497440727944,BAL,PIT,2022 REG,11,6,6,3,9,17,1,0,3,-3,1,1,1,0,0,0,0,0,0,0.5019750255927206,0.49802497440727944
87134,0.6551724137931035,0.38314176245210724,-190,161,0.6300700224600344,0.3699299775399656,away,COL,over,8.5,0.5121951219512195,-105,0.48919479393107135,SD,COL,2022 REG,3,2,8,1,3,11,1,0,1,-1,1,0,0,0,0,0,0,0,0,0.48919479393107135,0.5108052060689287
87134,0.6551724137931035,0.38314176245210724,-190,161,0.6300700224600344,0.3699299775399656,home,SD,under,8.5,0.5327102803738317,-114,0.5108052060689287,SD,COL,2022 REG,3,2,8,1,3,11,1,0,1,-1,1,0,0,0,0,0,0,0,0,0.48919479393107135,0.5108052060689287
87135,0.47846889952153115,0.5594713656387665,109,-127,0.4603156626027285,0.5396843373972715,away,MIN,over,8,0.5121951219512195,-105,0.48808156828023186,CLE,MIN,2022 REG,5,1,14,11,12,19,0,1,-10,10,1,0,0,0,0,0,0,0,0,0.48808156828023186,0.5119184317197681
87135,0.47846889952153115,0.5594713656387665,109,-127,0.4603156626027285,0.5396843373972715,home,CLE,under,8,0.5348837209302326,-115,0.5119184317197681,CLE,MIN,2022 REG,5,1,14,11,12,19,0,1,-10,10,1,0,0,0,0,0,0,0,0,0.48808156828023186,0.5119184317197681
87136,0.45248868778280543,0.5867768595041323,121,-142,0.4347214718158653,0.5652785281841347,away,SD,over,12.5,0.5121951219512195,-105,0.48808156828023186,COL,SD,2022 REG,10,8,10,3,11,20,1,0,5,-5,1,1,1,0,0,0,0,0,0,0.48808156828023186,0.5119184317197681
87136,0.45248868778280543,0.5867768595041323,121,-142,0.4347214718158653,0.5652785281841347,home,COL,under,12.5,0.5348837209302326,-115,0.5119184317197681,COL,SD,2022 REG,10,8,10,3,11,20,1,0,5,-5,1,1,1,0,0,0,0,0,0,0.48808156828023186,0.5119184317197681
87137,0.5780590717299579,0.4587155963302753,-137,118,0.5568011412478822,0.44319885875211784,away,SEA,over,8.5,0.5121951219512195,-105,0.48808156828023186,HOU,SEA,2022 REG,8,3,10,6,9,18,0,1,-3,3,1,1,1,0,0,0,0,0,0,0.48808156828023186,0.5119184317197681
87137,0.5780590717299579,0.4587155963302753,-137,118,0.5568011412478822,0.44319885875211784,home,HOU,under,8.5,0.5348837209302326,-115,0.5119184317197681,HOU,SEA,2022 REG,8,3,10,6,9,18,0,1,-3,3,1,1,1,0,0,0,0,0,0,0.48808156828023186,0.5119184317197681
87138,0.504950495049505,0.5327102803738317,-102,-114,0.4859336678555429,0.5140663321444572,away,TOR,over,9,0.5215311004784688,-109,0.4978845547971712,CWS,TOR,2022 REG,13,5,13,9,14,26,0,1,-4,4,1,1,1,1,1,0,0,0,0,0.4978845547971712,0.5021154452028288
87138,0.504950495049505,0.5327102803738317,-102,-114,0.4859336678555429,0.5140663321444572,home,CWS,under,9,0.5238095238095238,-110,0.5021154452028288,CWS,TOR,2022 REG,13,5,13,9,14,26,0,1,-4,4,1,1,1,1,1,0,0,0,0,0.4978845547971712,0.5021154452028288
87139,0.7118155619596541,0.3333333333333333,-247,200,0.6796778756848186,0.32032212431518137,away,WSH,over,7.5,0.5121951219512195,-105,0.48808156828023186,SF,WSH,2022 REG,11,9,11,3,12,22,1,0,6,-6,1,1,1,0,0,0,0,0,0,0.48808156828023186,0.5119184317197681
87139,0.7118155619596541,0.3333333333333333,-247,200,0.6796778756848186,0.32032212431518137,home,SF,under,7.5,0.5348837209302326,-115,0.5119184317197681,SF,WSH,2022 REG,11,9,11,3,12,22,1,0,6,-6,1,1,1,0,0,0,0,0,0,0.48808156828023186,0.5119184317197681
87140,0.5348837209302326,0.5,-115,100,0.5162249864791779,0.4837750135208221,away,NYM,over,7.5,0.5238095238095238,-110,0.4988662131519274,SD,NYM,2022 REG,7,5,16,11,16,23,0,1,-6,6,1,1,1,1,1,0,0,0,0,0.4988662131519274,0.5011337868480725
87140,0.5348837209302326,0.5,-115,100,0.5162249864791779,0.4837750135208221,home,SD,under,7.5,0.5238095238095238,-110,0.5011337868480725,SD,NYM,2022 REG,7,5,16,11,16,23,0,1,-6,6,1,1,1,1,1,0,0,0,0,0.4988662131519274,0.5011337868480725
87141,0.4464285714285714,0.5934959349593496,124,-146,0.42860513107682097,0.571394868923179,away,CLE,over,7.5,0.5,100,0.4772727272727273,MIN,CLE,2022 REG,5,1,10,4,5,15,0,1,-3,3,1,0,0,0,0,0,0,0,0,0.4772727272727273,0.5227272727272727
87141,0.4464285714285714,0.5934959349593496,124,-146,0.42860513107682097,0.571394868923179,home,MIN,under,7.5,0.5454545454545454,-120,0.5227272727272727,MIN,CLE,2022 REG,5,1,10,4,5,15,0,1,-3,3,1,0,0,0,0,0,0,0,0,0.4772727272727273,0.5227272727272727
87142,0.5121951219512195,0.5238095238095238,-105,-110,0.4937537180249852,0.5062462819750149,away,OAK,over,8.5,0.5145631067961165,-106,0.4925063625223866,WSH,OAK,2022 REG,9,5,5,1,6,14,1,0,4,-4,1,0,0,0,0,0,0,0,0,0.4925063625223866,0.5074936374776133
87142,0.5121951219512195,0.5238095238095238,-105,-110,0.4937537180249852,0.5062462819750149,home,WSH,under,8.5,0.5283018867924528,-112,0.5074936374776133,WSH,OAK,2022 REG,9,5,5,1,6,14,1,0,4,-4,1,0,0,0,0,0,0,0,0,0.4925063625223866,0.5074936374776133
87143,0.4484304932735426,0.5918367346938775,123,-145,0.43037344037335423,0.5696265596266458,away,LAD,over,8.5,0.5121951219512195,-105,0.48808156828023186,SD,LAD,2022 REG,10,2,7,5,7,17,0,1,-3,3,1,1,0,0,0,0,0,0,0,0.48808156828023186,0.5119184317197681
87143,0.4484304932735426,0.5918367346938775,123,-145,0.43037344037335423,0.5696265596266458,home,SD,under,8.5,0.5348837209302326,-115,0.5119184317197681,SD,LAD,2022 REG,10,2,7,5,7,17,0,1,-3,3,1,1,0,0,0,0,0,0,0,0.48808156828023186,0.5119184317197681
87144,0.37735849056603776,0.6575342465753424,165,-192,0.36419141994664905,0.635808580053351,away,NYY,over,7.5,0.5327102803738317,-114,0.508788710910954,LAA,NYY,2022 REG,6,3,3,2,5,9,1,0,1,-1,1,1,0,0,0,0,0,0,0,0.508788710910954,0.491211289089046
87144,0.37735849056603776,0.6575342465753424,165,-192,0.36419141994664905,0.635808580053351,home,LAA,under,7.5,0.5121951219512195,-105,0.491211289089046,LAA,NYY,2022 REG,6,3,3,2,5,9,1,0,1,-1,1,1,0,0,0,0,0,0,0,0.508788710910954,0.491211289089046
87145,0.7142857142857143,0.3278688524590164,-250,205,0.6841753094680495,0.3158246905319505,away,COL,over,7,0.5348837209302326,-115,0.5097020142727117,SF,COL,2022 REG,9,6,7,4,10,16,1,0,2,-2,1,1,1,1,0,0,0,0,0,0.5097020142727117,0.49029798572728833
87145,0.7142857142857143,0.3278688524590164,-250,205,0.6841753094680495,0.3158246905319505,home,SF,under,7,0.5121951219512195,-105,0.49029798572728833,SF,COL,2022 REG,9,6,7,4,10,16,1,0,2,-2,1,1,1,1,0,0,0,0,0,0.5097020142727117,0.49029798572728833
87146,0.6575342465753424,0.3846153846153846,-192,160,0.6298194205869192,0.3701805794130808,away,TEX,over,8,0.5391705069124424,-117,0.5140669063204599,PHI,TEX,2022 REG,6,1,7,2,3,13,0,1,-1,1,1,0,0,0,0,0,0,0,0,0.5140669063204599,0.4859330936795401
87146,0.6575342465753424,0.3846153846153846,-192,160,0.6298194205869192,0.3701805794130808,home,PHI,under,8,0.5073891625615764,-103,0.4859330936795401,PHI,TEX,2022 REG,6,1,7,2,3,13,0,1,-1,1,1,0,0,0,0,0,0,0,0,0.5140669063204599,0.4859330936795401
87147,0.574468085106383,0.4629629629629629,-135,116,0.5529651425984609,0.44703485740153914,away,CWS,over,8,0.5412844036697247,-118,0.5162581740877563,SF,CWS,2022 REG,7,4,17,13,17,24,0,1,-9,9,1,1,1,1,0,0,0,0,0,0.5162581740877563,0.4837418259122437
87147,0.574468085106383,0.4629629629629629,-135,116,0.5529651425984609,0.44703485740153914,home,SF,under,8,0.504950495049505,-102,0.4837418259122437,SF,CWS,2022 REG,7,4,17,13,17,24,0,1,-9,9,1,1,1,1,0,0,0,0,0,0.5162581740877563,0.4837418259122437
87148,0.6721311475409836,0.3717472118959108,-205,169,0.642639135460448,0.35736086453955196,away,DET,over,7.5,0.5412844036697247,-118,0.5189377998484975,TB,DET,2022 REG,7,2,6,3,5,13,0,1,-1,1,1,1,0,0,0,0,0,0,0,0.5189377998484975,0.4810622001515025
87148,0.6721311475409836,0.3717472118959108,-205,169,0.642639135460448,0.35736086453955196,home,TB,under,7.5,0.5,100,0.4810622001515025,TB,DET,2022 REG,7,2,6,3,5,13,0,1,-1,1,1,1,0,0,0,0,0,0,0,0.5189377998484975,0.4810622001515025
87149,0.5918367346938775,0.4464285714285714,-145,124,0.5691899208663057,0.4308100791336943,away,MIA,over,9,0.5,100,0.47935779816513757,STL,MIA,2022 REG,11,5,6,3,8,17,1,0,2,-2,1,1,1,0,0,0,0,0,0,0.47935779816513757,0.5206422018348624
87149,0.5918367346938775,0.4464285714285714,-145,124,0.5691899208663057,0.4308100791336943,home,STL,under,9,0.5412844036697247,-118,0.5206422018348624,STL,MIA,2022 REG,11,5,6,3,8,17,1,0,2,-2,1,1,1,0,0,0,0,0,0,0.47935779816513757,0.5206422018348624
87150,0.6551724137931035,0.390625,-190,156,0.6251672116527942,0.3748327883472058,away,DET,over,8.5,0.5454545454545454,-120,0.5206611570247933,CWS,DET,2022 REG,7,4,5,2,6,12,1,0,2,-2,1,1,0,0,0,0,0,0,0,0.5206611570247933,0.4793388429752067
87150,0.6551724137931035,0.390625,-190,156,0.6251672116527942,0.3748327883472058,home,CWS,under,8.5,0.5,100,0.4793388429752067,CWS,DET,2022 REG,7,4,5,2,6,12,1,0,2,-2,1,1,0,0,0,0,0,0,0,0.5206611570247933,0.4793388429752067
87151,0.6183206106870228,0.42194092827004215,-162,137,0.5934260713318911,0.40657392866810893,away,HOU,over,8.5,0.5098039215686274,-104,0.4870219861770517,NYY,HOU,2022 REG,0,0,8,3,3,8,0,1,-3,3,0,0,0,0,0,0,0,0,0,0.4870219861770517,0.5129780138229483
87151,0.6183206106870228,0.42194092827004215,-162,137,0.5934260713318911,0.40657392866810893,home,NYY,under,8.5,0.5348837209302326,-115,0.5129780138229483,NYY,HOU,2022 REG,0,0,8,3,3,8,0,1,-3,3,0,0,0,0,0,0,0,0,0,0.4870219861770517,0.5129780138229483
87152,0.43103448275862066,0.6062992125984252,132,-154,0.41494237269092843,0.5850576273090715,away,NYM,over,7.5,0.5454545454545454,-120,0.5179608869977906,ATL,NYM,2022 REG,7,7,14,9,16,21,0,1,-2,2,1,1,1,1,1,1,1,0,0,0.5179608869977906,0.48203911300220936
87152,0.43103448275862066,0.6062992125984252,132,-154,0.41494237269092843,0.5850576273090715,home,ATL,under,7.5,0.504950495049505,-102,0.48203911300220936,ATL,NYM,2022 REG,7,7,14,9,16,21,0,1,-2,2,1,1,1,1,1,1,1,0,0,0.5179608869977906,0.48203911300220936
87153,0.7014925373134329,0.3389830508474576,-235,195,0.6730992142751963,0.32690078572480374,away,KC,over,6.5,0.5348837209302326,-115,0.5097020142727117,CLE,KC,2022 REG,10,7,12,5,12,22,1,0,2,-2,1,1,1,1,1,0,0,0,0,0.5097020142727117,0.49029798572728833
87153,0.7014925373134329,0.3389830508474576,-235,195,0.6730992142751963,0.32690078572480374,home,CLE,under,6.5,0.5121951219512195,-105,0.49029798572728833,CLE,KC,2022 REG,10,7,12,5,12,22,1,0,2,-2,1,1,1,1,1,0,0,0,0,0.5097020142727117,0.49029798572728833
87154,0.4166666666666667,0.6168582375478928,140,-161,0.40269795657726687,0.5973020434227332,away,PHI,over,11.5,0.5,100,0.4772727272727273,COL,PHI,2022 REG,9,4,5,1,5,14,1,0,3,-3,1,0,0,0,0,0,0,0,0,0.4772727272727273,0.5227272727272727
87154,0.4166666666666667,0.6168582375478928,140,-161,0.40269795657726687,0.5973020434227332,home,COL,under,11.5,0.5454545454545454,-120,0.5227272727272727,COL,PHI,2022 REG,9,4,5,1,5,14,1,0,3,-3,1,0,0,0,0,0,0,0,0,0.4772727272727273,0.5227272727272727
87155,0.6503496503496503,0.3921568627450981,-186,155,0.6227055544208978,0.3772944455791022,away,NYM,over,8.5,0.5327102803738317,-114,0.5075272610403079,LAD,NYM,2022 REG,9,4,8,5,9,17,0,1,-1,1,1,1,1,1,0,0,0,0,0,0.5075272610403079,0.4924727389596921
87155,0.6503496503496503,0.3921568627450981,-186,155,0.6227055544208978,0.3772944455791022,home,LAD,under,8.5,0.5145631067961165,-106,0.4924727389596921,LAD,NYM,2022 REG,9,4,8,5,9,17,0,1,-1,1,1,1,1,1,0,0,0,0,0,0.5075272610403079,0.4924727389596921
87156,0.5555555555555556,0.47619047619047616,-125,110,0.5379188712522047,0.4620811287477953,away,DET,over,8.5,0.5145631067961165,-106,0.4913668392989033,KC,DET,2022 REG,7,2,9,4,6,16,0,1,-2,2,1,1,0,0,0,0,0,0,0,0.4913668392989033,0.5086331607010968
87156,0.5555555555555556,0.47619047619047616,-125,110,0.5379188712522047,0.4620811287477953,home,KC,under,8.5,0.5305164319248826,-113,0.5086331607010968,KC,DET,2022 REG,7,2,9,4,6,16,0,1,-2,2,1,1,0,0,0,0,0,0,0,0.4913668392989033,0.5086331607010968
87157,0.48780487804878053,0.5475113122171946,105,-121,0.470577468162939,0.529422531837061,away,CLE,over,7.5,0.5,100,0.4772727272727273,KC,CLE,2022 REG,4,3,7,1,4,11,1,0,2,-2,1,0,0,0,0,0,0,0,0,0.4772727272727273,0.5227272727272727
87157,0.48780487804878053,0.5475113122171946,105,-121,0.470577468162939,0.529422531837061,home,KC,under,7.5,0.5454545454545454,-120,0.5227272727272727,KC,CLE,2022 REG,4,3,7,1,4,11,1,0,2,-2,1,0,0,0,0,0,0,0,0,0.4772727272727273,0.5227272727272727
87158,0.3448275862068966,0.6894409937888198,190,-222,0.3330108344842358,0.6669891655157643,away,SEA,over,7.5,0.49019607843137253,104,0.46874141813588177,OAK,SEA,2022 REG,6,2,4,1,3,10,1,0,1,-1,1,0,0,0,0,0,0,0,0,0.46874141813588177,0.5312585818641182
87158,0.3448275862068966,0.6894409937888198,190,-222,0.3330108344842358,0.6669891655157643,home,OAK,under,7.5,0.5535714285714286,-124,0.5312585818641182,OAK,SEA,2022 REG,6,2,4,1,3,10,1,0,1,-1,1,0,0,0,0,0,0,0,0,0.46874141813588177,0.5312585818641182
87159,0.5726495726495727,0.46511627906976744,-134,115,0.5510229738017454,0.44897702619825464,away,MIN,over,7.5,0.49504950495049505,102,0.4739797934813417,SD,MIN,2022 REG,8,4,9,7,11,17,0,1,-3,3,1,1,1,1,0,0,0,0,0,0.4739797934813417,0.5260202065186583
87159,0.5726495726495727,0.46511627906976744,-134,115,0.5510229738017454,0.44897702619825464,home,SD,under,7.5,0.5475113122171946,-121,0.5260202065186583,SD,MIN,2022 REG,8,4,9,7,11,17,0,1,-3,3,1,1,1,1,0,0,0,0,0,0.4739797934813417,0.5260202065186583
87160,0.6666666666666666,0.37593984962406013,-200,166,0.6382623224728488,0.36173767752715125,away,COL,over,7.5,0.5169082125603864,-107,0.49353874091423283,PHI,COL,2022 REG,4,7,5,1,8,9,1,0,6,-6,1,0,0,0,0,0,0,0,0,0.49353874091423283,0.5064612590857671
87160,0.6666666666666666,0.37593984962406013,-200,166,0.6382623224728488,0.36173767752715125,home,PHI,under,7.5,0.5283018867924528,-112,0.5064612590857671,PHI,COL,2022 REG,4,7,5,1,8,9,1,0,6,-6,1,0,0,0,0,0,0,0,0,0.49353874091423283,0.5064612590857671
87161,0.5850622406639003,0.4716981132075471,-141,112,0.5518539008469954,0.44814609915300463,away,SEA,over,7,0.5283018867924528,-112,0.5031902949311281,OAK,SEA,2022 REG,5,1,2,2,3,7,0,1,-1,1,1,0,0,0,0,0,0,0,0,0.5031902949311281,0.4968097050688719
87161,0.5850622406639003,0.4716981132075471,-141,112,0.5518539008469954,0.44814609915300463,home,OAK,under,7,0.5192307692307692,-108,0.4968097050688719,OAK,SEA,2022 REG,5,1,2,2,3,7,0,1,-1,1,1,0,0,0,0,0,0,0,0,0.5031902949311281,0.4968097050688719
87162,0.49504950495049505,0.5454545454545454,102,-120,0.47499799484898986,0.5250020051510101,away,CLE,over,8,0.5145631067961165,-106,0.4913668392989033,SEA,CLE,2022 REG,4,3,6,1,4,10,1,0,2,-2,1,0,0,0,0,0,0,0,0,0.4913668392989033,0.5086331607010968
87162,0.49504950495049505,0.5454545454545454,102,-120,0.47499799484898986,0.5250020051510101,home,SEA,under,8,0.5305164319248826,-113,0.5086331607010968,SEA,CLE,2022 REG,4,3,6,1,4,10,1,0,2,-2,1,0,0,0,0,0,0,0,0,0.4913668392989033,0.5086331607010968
87163,0.5951417004048584,0.4444444444444444,-147,125,0.5715823348467713,0.42841766515322866,away,TOR,over,9.5,0.5121951219512195,-105,0.48808156828023186,BOS,TOR,2022 REG,3,2,8,1,3,11,1,0,1,-1,1,0,0,0,0,0,0,0,0,0.48808156828023186,0.5119184317197681
87163,0.5951417004048584,0.4444444444444444,-147,125,0.5715823348467713,0.42841766515322866,home,BOS,under,9.5,0.5348837209302326,-115,0.5119184317197681,BOS,TOR,2022 REG,3,2,8,1,3,11,1,0,1,-1,1,0,0,0,0,0,0,0,0,0.48808156828023186,0.5119184317197681
87164,0.4504504504504505,0.5884773662551441,122,-143,0.4329153978803628,0.5670846021196372,away,MIA,over,7,0.5454545454545454,-120,0.5206611570247933,OAK,MIA,2022 REG,8,3,8,5,8,16,0,1,-2,2,1,1,1,0,0,0,0,0,0,0.5206611570247933,0.4793388429752067
87164,0.4504504504504505,0.5884773662551441,122,-143,0.4329153978803628,0.5670846021196372,home,OAK,under,7,0.5,100,0.4793388429752067,OAK,MIA,2022 REG,8,3,8,5,8,16,0,1,-2,2,1,1,1,0,0,0,0,0,0,0.5206611570247933,0.4793388429752067
87165,0.5652173913043479,0.47619047619047616,-130,110,0.5418129444594474,0.4581870555405526,away,TB,over,9,0.5192307692307692,-108,0.49455035168025013,BOS,TB,2022 REG,11,4,11,8,12,22,0,1,-4,4,1,1,1,1,0,0,0,0,0,0.49455035168025013,0.5054496483197499
87165,0.5652173913043479,0.47619047619047616,-130,110,0.5418129444594474,0.4581870555405526,home,BOS,under,9,0.5283018867924528,-112,0.5054496483197499,BOS,TB,2022 REG,11,4,11,8,12,22,0,1,-4,4,1,1,1,1,0,0,0,0,0,0.49455035168025013,0.5054496483197499
87166,0.5098039215686274,0.5305164319248826,-104,-113,0.4892484472386027,0.5107515527613973,away,MIL,over,10,0.5145631067961165,-106,0.4913668392989033,BOS,MIL,2022 REG,10,4,14,9,13,24,0,1,-5,5,1,1,1,1,0,0,0,0,0,0.4913668392989033,0.5086331607010968
87166,0.5098039215686274,0.5305164319248826,-104,-113,0.4892484472386027,0.5107515527613973,home,BOS,under,10,0.5305164319248826,-113,0.5086331607010968,BOS,MIL,2022 REG,10,4,14,9,13,24,0,1,-5,5,1,1,1,1,0,0,0,0,0,0.4913668392989033,0.5086331607010968
87167,0.4854368932038835,0.5535714285714286,106,-124,0.4665008146721786,0.5334991853278215,away,NYY,over,7,0.5370370370370371,-116,0.5118817074154765,SEA,NYY,2022 REG,5,4,4,3,7,9,1,0,1,-1,1,1,1,0,0,0,0,0,0,0.5118817074154765,0.48811829258452355
87167,0.4854368932038835,0.5535714285714286,106,-124,0.4665008146721786,0.5334991853278215,home,SEA,under,7,0.5098039215686274,-104,0.48811829258452355,SEA,NYY,2022 REG,5,4,4,3,7,9,1,0,1,-1,1,1,1,0,0,0,0,0,0,0.5118817074154765,0.48811829258452355
87168,0.6240601503759399,0.4132231404958678,-166,142,0.6007931342679697,0.39920686573203035,away,ARI,over,8.5,0.5121951219512195,-105,0.48808156828023186,CWS,ARI,2022 REG,6,2,6,7,9,12,0,1,-5,5,1,1,0,0,0,0,0,0,0,0.48808156828023186,0.5119184317197681
87168,0.6240601503759399,0.4132231404958678,-166,142,0.6007931342679697,0.39920686573203035,home,CWS,under,8.5,0.5348837209302326,-115,0.5119184317197681,CWS,ARI,2022 REG,6,2,6,7,9,12,0,1,-5,5,1,1,0,0,0,0,0,0,0,0.48808156828023186,0.5119184317197681
87169,0.6688741721854304,0.37037037037037035,-202,170,0.6426245112706233,0.35737548872937674,away,BAL,over,8,0.5121951219512195,-105,0.48808156828023186,TOR,BAL,2022 REG,6,4,9,5,9,15,0,1,-1,1,1,1,1,1,0,0,0,0,0,0.48808156828023186,0.5119184317197681
87169,0.6688741721854304,0.37037037037037035,-202,170,0.6426245112706233,0.35737548872937674,home,TOR,under,8,0.5348837209302326,-115,0.5119184317197681,TOR,BAL,2022 REG,6,4,9,5,9,15,0,1,-1,1,1,1,1,1,0,0,0,0,0,0.48808156828023186,0.5119184317197681
87170,0.33444816053511706,0.7014925373134329,199,-235,0.3224278602513211,0.6775721397486789,away,TOR,over,8.5,0.5454545454545454,-120,0.5206611570247933,KC,TOR,2022 REG,6,0,12,7,7,18,0,1,-7,7,0,0,0,0,0,0,0,0,0,0.5206611570247933,0.4793388429752067
87170,0.33444816053511706,0.7014925373134329,199,-235,0.3224278602513211,0.6775721397486789,home,KC,under,8.5,0.5,100,0.4793388429752067,KC,TOR,2022 REG,6,0,12,7,7,18,0,1,-7,7,0,0,0,0,0,0,0,0,0,0.5206611570247933,0.4793388429752067
87171,0.425531914893617,0.6183206106870228,135,-162,0.406871265710366,0.593128734289634,away,STL,over,9.5,0.5305164319248826,-113,0.5066009958897986,CIN,STL,2022 REG,7,6,3,3,9,10,1,0,3,-3,1,1,1,0,0,0,0,0,0,0.5066009958897986,0.49339900411020143
87171,0.425531914893617,0.6183206106870228,135,-162,0.406871265710366,0.593128734289634,home,CIN,under,9.5,0.5145631067961165,-106,0.49339900411020143,CIN,STL,2022 REG,7,6,3,3,9,10,1,0,3,-3,1,1,1,0,0,0,0,0,0,0.5066009958897986,0.49339900411020143
87172,0.46511627906976744,0.576271186440678,115,-136,0.44586629511142073,0.5541337048885793,away,LAD,over,7.5,0.5,100,0.47935779816513757,NYM,LAD,2022 REG,6,5,6,3,8,12,1,0,2,-2,1,1,1,0,0,0,0,0,0,0.47935779816513757,0.5206422018348624
87172,0.46511627906976744,0.576271186440678,115,-136,0.44586629511142073,0.5541337048885793,home,NYM,under,7.5,0.5412844036697247,-118,0.5206422018348624,NYM,LAD,2022 REG,6,5,6,3,8,12,1,0,2,-2,1,1,1,0,0,0,0,0,0,0.47935779816513757,0.5206422018348624
87173,0.6875,0.35335689045936397,-220,183,0.6594108878091872,0.3405891121908128,away,SEA,over,7.5,0.5348837209302326,-115,0.5097020142727117,HOU,SEA,2022 REG,10,7,5,2,9,15,1,0,5,-5,1,1,0,0,0,0,0,0,0,0.5097020142727117,0.49029798572728833
87173,0.6875,0.35335689045936397,-220,183,0.6594108878091872,0.3405891121908128,home,HOU,under,7.5,0.5121951219512195,-105,0.49029798572728833,HOU,SEA,2022 REG,10,7,5,2,9,15,1,0,5,-5,1,1,0,0,0,0,0,0,0,0.5097020142727117,0.49029798572728833
87174,0.8130841121495328,0.22727272727272727,-435,340,0.7802706071987233,0.21972939280127668,away,CHC,over,7,0.5073891625615764,-103,0.4859403596076043,NYM,CHC,2022 REG,4,1,9,4,5,13,0,1,-3,3,1,0,0,0,0,0,0,0,0,0.4859403596076043,0.5140596403923957
87174,0.8130841121495328,0.22727272727272727,-435,340,0.7802706071987233,0.21972939280127668,home,NYM,under,7,0.5348837209302326,-115,0.5140596403923957,NYM,CHC,2022 REG,4,1,9,4,5,13,0,1,-3,3,1,0,0,0,0,0,0,0,0,0.4859403596076043,0.5140596403923957
87175,0.4504504504504505,0.5918367346938775,122,-145,0.43140216885390636,0.5685978311460936,away,SF,over,7.5,0.5433789954337899,-119,0.5198077604720502,CHC,SF,2022 REG,5,4,3,2,6,8,1,0,2,-2,1,1,0,0,0,0,0,0,0,0.5198077604720502,0.48019223952794976
87175,0.4504504504504505,0.5918367346938775,122,-145,0.43140216885390636,0.5685978311460936,home,CHC,under,7.5,0.5,100,0.48019223952794976,CHC,SF,2022 REG,5,4,3,2,6,8,1,0,2,-2,1,1,0,0,0,0,0,0,0,0.5198077604720502,0.48019223952794976
87176,0.31545741324921134,0.7237569060773481,217,-262,0.3030869655121263,0.6969130344878737,away,PHI,over,7.5,0.5073891625615764,-103,0.4837652908580103,WSH,PHI,2022 REG,3,1,11,8,9,14,0,1,-7,7,1,0,0,0,0,0,0,0,0,0.4837652908580103,0.5162347091419897
87176,0.31545741324921134,0.7237569060773481,217,-262,0.3030869655121263,0.6969130344878737,home,WSH,under,7.5,0.5391705069124424,-117,0.5162347091419897,WSH,PHI,2022 REG,3,1,11,8,9,14,0,1,-7,7,1,0,0,0,0,0,0,0,0,0.4837652908580103,0.5162347091419897
87177,0.6197718631178707,0.4166666666666667,-163,140,0.597188287624032,0.402811712375968,away,HOU,over,7.5,0.5,100,0.47935779816513757,ATL,HOU,2022 REG,7,5,7,4,9,14,1,0,1,-1,1,1,1,1,0,0,0,0,0,0.47935779816513757,0.5206422018348624
87177,0.6197718631178707,0.4166666666666667,-163,140,0.597188287624032,0.402811712375968,home,ATL,under,7.5,0.5412844036697247,-118,0.5206422018348624,ATL,HOU,2022 REG,7,5,7,4,9,14,1,0,1,-1,1,1,1,1,0,0,0,0,0,0.47935779816513757,0.5206422018348624
87178,0.6688741721854304,0.36900369003690037,-202,171,0.6435386484473151,0.3564613515526849,away,CWS,over,8.5,0.5238095238095238,-110,0.4988662131519274,NYY,CWS,2022 REG,3,0,13,5,5,16,0,1,-5,5,0,0,0,0,0,0,0,0,0,0.4988662131519274,0.5011337868480725
87178,0.6688741721854304,0.36900369003690037,-202,171,0.6435386484473151,0.3564613515526849,home,NYY,under,8.5,0.5238095238095238,-110,0.5011337868480725,NYY,CWS,2022 REG,3,0,13,5,5,16,0,1,-5,5,0,0,0,0,0,0,0,0,0,0.4988662131519274,0.5011337868480725
87179,0.5867768595041323,0.45454545454545453,-142,120,0.5625298818386723,0.43747011816132775,away,SEA,over,8,0.5348837209302326,-115,0.5097020142727117,HOU,SEA,2022 REG,7,3,4,2,5,11,1,0,1,-1,1,1,0,0,0,0,0,0,0,0.5097020142727117,0.49029798572728833
87179,0.5867768595041323,0.45454545454545453,-142,120,0.5625298818386723,0.43747011816132775,home,HOU,under,8,0.5121951219512195,-105,0.49029798572728833,HOU,SEA,2022 REG,7,3,4,2,5,11,1,0,1,-1,1,1,0,0,0,0,0,0,0,0.5097020142727117,0.49029798572728833
87180,0.6047430830039526,0.4347826086956522,-153,130,0.5808401943476698,0.41915980565233024,away,SEA,over,9.5,0.5,100,0.4772727272727273,LAA,SEA,2022 REG,7,3,10,4,7,17,0,1,-1,1,1,1,1,0,0,0,0,0,0,0.4772727272727273,0.5227272727272727
87180,0.6047430830039526,0.4347826086956522,-153,130,0.5808401943476698,0.41915980565233024,home,LAA,under,9.5,0.5454545454545454,-120,0.5227272727272727,LAA,SEA,2022 REG,7,3,10,4,7,17,0,1,-1,1,1,1,1,0,0,0,0,0,0,0.4772727272727273,0.5227272727272727
87181,0.42372881355932196,0.6153846153846154,136,-160,0.4071553267186705,0.5928446732813295,away,SF,over,10.5,0.5238095238095238,-110,0.5000596729920038,COL,SF,2022 REG,8,5,8,3,8,16,1,0,2,-2,1,1,1,0,0,0,0,0,0,0.5000596729920038,0.4999403270079962
87181,0.42372881355932196,0.6153846153846154,136,-160,0.4071553267186705,0.5928446732813295,home,COL,under,10.5,0.5215311004784688,-109,0.4999403270079962,COL,SF,2022 REG,8,5,8,3,8,16,1,0,2,-2,1,1,1,0,0,0,0,0,0,0.5000596729920038,0.4999403270079962
87182,0.7118155619596541,0.33112582781456956,-247,202,0.6812492124661865,0.3187507875338135,away,TEX,over,9.5,0.5192307692307692,-108,0.49455035168025013,TOR,TEX,2022 REG,10,6,11,12,18,21,0,1,-6,6,1,1,1,1,1,1,0,0,0,0.49455035168025013,0.5054496483197499
87182,0.7118155619596541,0.33112582781456956,-247,202,0.6812492124661865,0.3187507875338135,home,TOR,under,9.5,0.5283018867924528,-112,0.5054496483197499,TOR,TEX,2022 REG,10,6,11,12,18,21,0,1,-6,6,1,1,1,1,1,1,0,0,0,0.49455035168025013,0.5054496483197499
87183,0.6363636363636364,0.40485829959514175,-175,147,0.6101314952989593,0.38986850470104073,away,ARI,over,7.5,0.5098039215686274,-104,0.48592421718142587,STL,ARI,2022 REG,15,8,6,3,11,21,1,0,5,-5,1,1,1,0,0,0,0,0,0,0.48592421718142587,0.5140757828185741
87183,0.6363636363636364,0.40485829959514175,-175,147,0.6101314952989593,0.38986850470104073,home,STL,under,7.5,0.5370370370370371,-116,0.5140757828185741,STL,ARI,2022 REG,15,8,6,3,11,21,1,0,5,-5,1,1,1,0,0,0,0,0,0,0.48592421718142587,0.5140757828185741
87184,0.6296296296296295,0.4098360655737705,-170,144,0.6047808585756369,0.3952191414243631,away,PIT,over,7.5,0.5073891625615764,-103,0.4837652908580103,MIA,PIT,2022 REG,5,1,11,5,6,16,0,1,-4,4,1,0,0,0,0,0,0,0,0,0.4837652908580103,0.5162347091419897
87184,0.6296296296296295,0.4098360655737705,-170,144,0.6047808585756369,0.3952191414243631,home,MIA,under,7.5,0.5391705069124424,-117,0.5162347091419897,MIA,PIT,2022 REG,5,1,11,5,6,16,0,1,-4,4,1,0,0,0,0,0,0,0,0,0.4837652908580103,0.5162347091419897
87185,0.4,0.6376811594202898,150,-176,0.384927536231884,0.615072463768116,away,ATL,over,8.5,0.5454545454545454,-120,0.5233614270517961,PHI,ATL,2022 REG,12,6,8,4,10,20,1,0,2,-2,1,1,1,1,0,0,0,0,0,0.5233614270517961,0.4766385729482039
87185,0.4,0.6376811594202898,150,-176,0.384927536231884,0.615072463768116,home,PHI,under,8.5,0.49504950495049505,102,0.4766385729482039,PHI,ATL,2022 REG,12,6,8,4,10,20,1,0,2,-2,1,1,1,1,0,0,0,0,0,0.5233614270517961,0.4766385729482039
87186,0.4484304932735426,0.5918367346938775,123,-145,0.43037344037335423,0.5696265596266458,away,MIA,over,7.5,0.5,100,0.47522522522522526,WSH,MIA,2022 REG,5,1,4,2,3,9,0,1,-1,1,1,0,0,0,0,0,0,0,0,0.47522522522522526,0.5247747747747747
87186,0.4484304932735426,0.5918367346938775,123,-145,0.43037344037335423,0.5696265596266458,home,WSH,under,7.5,0.5495495495495495,-122,0.5247747747747747,WSH,MIA,2022 REG,5,1,4,2,3,9,0,1,-1,1,1,0,0,0,0,0,0,0,0,0.47522522522522526,0.5247747747747747
87187,0.45454545454545453,0.5833333333333333,120,-140,0.43732782369146006,0.5626721763085399,away,SD,over,7,0.5454545454545454,-120,0.5206611570247933,DET,SD,2022 REG,9,4,5,3,7,14,1,0,1,-1,1,1,1,0,0,0,0,0,0,0.5206611570247933,0.4793388429752067
87187,0.45454545454545453,0.5833333333333333,120,-140,0.43732782369146006,0.5626721763085399,home,DET,under,7,0.5,100,0.4793388429752067,DET,SD,2022 REG,9,4,5,3,7,14,1,0,1,-1,1,1,1,0,0,0,0,0,0,0.5206611570247933,0.4793388429752067
87188,0.4608294930875576,0.5815899581589958,117,-139,0.44128135887255604,0.558718641127444,away,MIL,over,7,0.5260663507109005,-111,0.5022370601254724,MIA,MIL,2022 REG,11,9,8,3,12,19,1,0,6,-6,1,1,1,0,0,0,0,0,0,0.5022370601254724,0.4977629398745276
87188,0.4608294930875576,0.5815899581589958,117,-139,0.44128135887255604,0.558718641127444,home,MIA,under,7,0.5192307692307692,-108,0.4977629398745276,MIA,MIL,2022 REG,11,9,8,3,12,19,1,0,6,-6,1,1,1,0,0,0,0,0,0,0.5022370601254724,0.4977629398745276
87189,0.5348837209302326,0.5073891625615764,-115,-103,0.5122726437136835,0.48772735628631647,away,BOS,over,8.5,0.5305164319248826,-113,0.5066009958897986,CHC,BOS,2022 REG,9,2,10,4,6,19,0,1,-2,2,1,1,0,0,0,0,0,0,0,0.5066009958897986,0.49339900411020143
87189,0.5348837209302326,0.5073891625615764,-115,-103,0.5122726437136835,0.48772735628631647,home,CHC,under,8.5,0.5145631067961165,-106,0.49339900411020143,CHC,BOS,2022 REG,9,2,10,4,6,19,0,1,-2,2,1,1,0,0,0,0,0,0,0,0.5066009958897986,0.49339900411020143
87190,0.7142857142857143,0.32573289902280134,-250,207,0.6857009904939174,0.3142990095060826,away,CHC,over,8,0.5192307692307692,-108,0.49571111079951763,STL,CHC,2022 REG,9,8,7,0,8,16,1,0,8,-8,0,0,0,0,0,0,0,0,0,0.49571111079951763,0.5042888892004824
87190,0.7142857142857143,0.32573289902280134,-250,207,0.6857009904939174,0.3142990095060826,home,STL,under,8,0.5260663507109005,-111,0.5042888892004824,STL,CHC,2022 REG,9,8,7,0,8,16,1,0,8,-8,0,0,0,0,0,0,0,0,0,0.49571111079951763,0.5042888892004824
87191,0.6153846153846154,0.4166666666666667,-160,140,0.5956607495069033,0.4043392504930967,away,PIT,over,8,0.5283018867924528,-112,0.5044173060022736,DET,PIT,2022 REG,3,3,5,2,5,8,1,0,1,-1,1,1,0,0,0,0,0,0,0,0.5044173060022736,0.49558269399772636
87191,0.6153846153846154,0.4166666666666667,-160,140,0.5956607495069033,0.4043392504930967,home,DET,under,8,0.5169082125603864,-107,0.49558269399772636,DET,PIT,2022 REG,3,3,5,2,5,8,1,0,1,-1,1,1,0,0,0,0,0,0,0,0.5044173060022736,0.49558269399772636
87192,0.5535714285714286,0.4807692307692307,-124,108,0.5345614207221351,0.4654385792778649,away,COL,over,9,0.5454545454545454,-120,0.5193043049216726,CIN,COL,2022 REG,11,3,6,2,5,17,1,0,1,-1,1,1,0,0,0,0,0,0,0,0.5193043049216726,0.48069569507832743
87192,0.5535714285714286,0.4807692307692307,-124,108,0.5345614207221351,0.4654385792778649,home,CIN,under,9,0.5024875621890548,-101,0.48069569507832743,CIN,COL,2022 REG,11,3,6,2,5,17,1,0,1,-1,1,1,0,0,0,0,0,0,0,0.5193043049216726,0.48069569507832743
87193,0.7142857142857143,0.3278688524590164,-250,205,0.6841753094680495,0.3158246905319505,away,PHI,over,8.5,0.5327102803738317,-114,0.508788710910954,ATL,PHI,2022 REG,14,13,4,1,14,18,1,0,12,-12,1,0,0,0,0,0,0,0,0,0.508788710910954,0.491211289089046
87193,0.7142857142857143,0.3278688524590164,-250,205,0.6841753094680495,0.3158246905319505,home,ATL,under,8.5,0.5121951219512195,-105,0.491211289089046,ATL,PHI,2022 REG,14,13,4,1,14,18,1,0,12,-12,1,0,0,0,0,0,0,0,0,0.508788710910954,0.491211289089046
87194,0.6108949416342413,0.4273504273504274,-157,134,0.5875310391805721,0.41246896081942785,away,MIL,over,8,0.5238095238095238,-110,0.5000596729920038,NYM,MIL,2022 REG,8,4,3,0,4,11,1,0,4,-4,0,0,0,0,0,0,0,0,0,0.5000596729920038,0.4999403270079962
87194,0.6108949416342413,0.4273504273504274,-157,134,0.5875310391805721,0.41246896081942785,home,NYM,under,8,0.5215311004784688,-109,0.4999403270079962,NYM,MIL,2022 REG,8,4,3,0,4,11,1,0,4,-4,0,0,0,0,0,0,0,0,0,0.5000596729920038,0.4999403270079962
87195,0.7142857142857143,0.3225806451612903,-250,210,0.6879526003949967,0.3120473996050033,away,CIN,over,8,0.5238095238095238,-110,0.4988662131519274,TOR,CIN,2022 REG,7,3,7,1,4,14,1,0,2,-2,1,0,0,0,0,0,0,0,0,0.4988662131519274,0.5011337868480725
87195,0.7142857142857143,0.3225806451612903,-250,210,0.6879526003949967,0.3120473996050033,home,TOR,under,8,0.5238095238095238,-110,0.5011337868480725,TOR,CIN,2022 REG,7,3,7,1,4,14,1,0,2,-2,1,0,0,0,0,0,0,0,0,0.4988662131519274,0.5011337868480725
87196,0.49504950495049505,0.5454545454545454,102,-120,0.47499799484898986,0.5250020051510101,away,SEA,over,9.5,0.5024875621890548,-101,0.47839724939301687,WSH,SEA,2022 REG,6,1,7,2,3,13,0,1,-1,1,1,0,0,0,0,0,0,0,0,0.47839724939301687,0.5216027506069831
87196,0.49504950495049505,0.5454545454545454,102,-120,0.47499799484898986,0.5250020051510101,home,WSH,under,9.5,0.5454545454545454,-120,0.5216027506069831,WSH,SEA,2022 REG,6,1,7,2,3,13,0,1,-1,1,1,0,0,0,0,0,0,0,0,0.47839724939301687,0.5216027506069831
87197,0.6168582375478928,0.42372881355932196,-161,136,0.59182178073463,0.40817821926537,away,SF,over,7.5,0.5121951219512195,-105,0.48808156828023186,SD,SF,2022 REG,9,6,5,3,9,14,1,0,3,-3,1,1,1,0,0,0,0,0,0,0.48808156828023186,0.5119184317197681
87197,0.6168582375478928,0.42372881355932196,-161,136,0.59182178073463,0.40817821926537,home,SD,under,7.5,0.5348837209302326,-115,0.5119184317197681,SD,SF,2022 REG,9,6,5,3,9,14,1,0,3,-3,1,1,1,0,0,0,0,0,0,0.48808156828023186,0.5119184317197681
87198,0.42016806722689076,0.6183206106870228,138,-162,0.4039963538176834,0.5960036461823166,away,LAA,over,7.5,0.5327102803738317,-114,0.508788710910954,TEX,LAA,2022 REG,12,6,7,5,11,19,1,0,1,-1,1,1,1,1,1,0,0,0,0,0.508788710910954,0.491211289089046
87198,0.42016806722689076,0.6183206106870228,138,-162,0.4039963538176834,0.5960036461823166,home,TEX,under,7.5,0.5121951219512195,-105,0.491211289089046,TEX,LAA,2022 REG,12,6,7,5,11,19,1,0,1,-1,1,1,1,1,1,0,0,0,0,0.508788710910954,0.491211289089046
87199,0.6376811594202898,0.4,-176,150,0.6136525939928585,0.38634740600714146,away,CLE,over,7,0.5169082125603864,-107,0.49353874091423283,SEA,CLE,2022 REG,3,3,6,4,7,9,0,1,-1,1,1,1,1,0,0,0,0,0,0,0.49353874091423283,0.5064612590857671
87199,0.6376811594202898,0.4,-176,150,0.6136525939928585,0.38634740600714146,home,SEA,under,7,0.5283018867924528,-112,0.5064612590857671,SEA,CLE,2022 REG,3,3,6,4,7,9,0,1,-1,1,1,1,1,0,0,0,0,0,0,0.49353874091423283,0.5064612590857671
87200,0.5192307692307692,0.5238095238095238,-108,-110,0.49688292476754015,0.5031170752324599,away,TEX,over,9.5,0.5238095238095238,-110,0.5012646084074657,BAL,TEX,2022 REG,4,2,6,1,3,10,1,0,1,-1,1,0,0,0,0,0,0,0,0,0.5012646084074657,0.4987353915925343
87200,0.5192307692307692,0.5238095238095238,-108,-110,0.49688292476754015,0.5031170752324599,home,BAL,under,9.5,0.5192307692307692,-108,0.4987353915925343,BAL,TEX,2022 REG,4,2,6,1,3,10,1,0,1,-1,1,0,0,0,0,0,0,0,0,0.5012646084074657,0.4987353915925343
87201,0.425531914893617,0.6108949416342413,135,-157,0.41003112488176247,0.5899688751182375,away,MIN,over,7.5,0.5121951219512195,-105,0.48919479393107135,OAK,MIN,2022 REG,12,4,14,14,18,26,0,1,-10,10,1,1,1,1,0,0,0,0,0,0.48919479393107135,0.5108052060689287
87201,0.425531914893617,0.6108949416342413,135,-157,0.41003112488176247,0.5899688751182375,home,OAK,under,7.5,0.5327102803738317,-114,0.5108052060689287,OAK,MIN,2022 REG,12,4,14,14,18,26,0,1,-10,10,1,1,1,1,0,0,0,0,0,0.48919479393107135,0.5108052060689287
87202,0.4444444444444444,0.5983935742971888,125,-149,0.4254053250037185,0.5745946749962815,away,SF,over,11,0.5454545454545454,-120,0.5206611570247933,COL,SF,2022 REG,11,6,9,7,13,20,0,1,-1,1,1,1,1,1,1,1,0,0,0,0.5206611570247933,0.4793388429752067
87202,0.4444444444444444,0.5983935742971888,125,-149,0.4254053250037185,0.5745946749962815,home,COL,under,11,0.5,100,0.4793388429752067,COL,SF,2022 REG,11,6,9,7,13,20,0,1,-1,1,1,1,1,1,1,1,0,0,0,0.5206611570247933,0.4793388429752067
87203,0.7468354430379747,0.29411764705882354,-295,240,0.7162502238517583,0.2837497761482417,away,DET,over,8.5,0.5215311004784688,-109,0.49907282342437215,NYY,DET,2022 REG,4,3,1,0,3,5,1,0,3,-3,0,0,0,0,0,0,0,0,0,0.49907282342437215,0.5009271765756278
87203,0.7468354430379747,0.29411764705882354,-295,240,0.7162502238517583,0.2837497761482417,home,NYY,under,8.5,0.5215311004784688,-109,0.5009271765756278,NYY,DET,2022 REG,4,3,1,0,3,5,1,0,3,-3,0,0,0,0,0,0,0,0,0,0.49907282342437215,0.5009271765756278
87204,0.647887323943662,0.3968253968253968,-184,152,0.6189185189383564,0.38108148106164363,away,DET,over,6.5,0.5412844036697247,-118,0.5175913212324037,TB,DET,2022 REG,11,6,5,1,7,16,1,0,5,-5,1,0,0,0,0,0,0,0,0,0.5175913212324037,0.4824086787675963
87204,0.647887323943662,0.3968253968253968,-184,152,0.6189185189383564,0.38108148106164363,home,TB,under,6.5,0.5024875621890548,-101,0.4824086787675963,TB,DET,2022 REG,11,6,5,1,7,16,1,0,5,-5,1,0,0,0,0,0,0,0,0,0.5175913212324037,0.4824086787675963
87205,0.47619047619047616,0.5689655172413793,110,-132,0.4546876221753069,0.5453123778246931,away,SF,over,8.5,0.5238095238095238,-110,0.4988662131519274,WSH,SF,2022 REG,6,1,12,7,8,18,0,1,-6,6,1,0,0,0,0,0,0,0,0,0.5044173060022736,0.49558269399772636
87205,0.47619047619047616,0.5689655172413793,110,-132,0.4546876221753069,0.5453123778246931,away,SF,over,9.5,0.5283018867924528,-112,0.5044173060022736,WSH,SF,2022 REG,6,1,12,7,8,18,0,1,-6,6,1,0,0,0,0,0,0,0,0,0.5044173060022736,0.49558269399772636
87205,0.47619047619047616,0.5689655172413793,110,-132,0.4546876221753069,0.5453123778246931,home,WSH,under,8.5,0.5238095238095238,-110,0.5011337868480725,WSH,SF,2022 REG,6,1,12,7,8,18,0,1,-6,6,1,0,0,0,0,0,0,0,0,0.5044173060022736,0.49558269399772636
87205,0.47619047619047616,0.5689655172413793,110,-132,0.4546876221753069,0.5453123778246931,home,WSH,under,9.5,0.5169082125603864,-107,0.49558269399772636,WSH,SF,2022 REG,6,1,12,7,8,18,0,1,-6,6,1,0,0,0,0,0,0,0,0,0.5044173060022736,0.49558269399772636
87206,0.49504950495049505,0.5454545454545454,102,-120,0.47499799484898986,0.5250020051510101,away,CLE,over,9,0.5,100,0.4762443438914027,BAL,CLE,2022 REG,4,2,6,3,5,10,0,1,-1,1,1,1,0,0,0,0,0,0,0,0.4762443438914027,0.5237556561085973
87206,0.49504950495049505,0.5454545454545454,102,-120,0.47499799484898986,0.5250020051510101,home,BAL,under,9,0.5475113122171946,-121,0.5237556561085973,BAL,CLE,2022 REG,4,2,6,3,5,10,0,1,-1,1,1,1,0,0,0,0,0,0,0,0.4762443438914027,0.5237556561085973
87207,0.4694835680751174,0.5708154506437768,113,-133,0.45056384097704505,0.549436159022955,away,NYM,over,7.5,0.5454545454545454,-120,0.5206611570247933,CHC,NYM,2022 REG,8,0,12,8,8,20,0,1,-8,8,0,0,0,0,0,0,0,0,0,0.5206611570247933,0.4793388429752067
87207,0.4694835680751174,0.5708154506437768,113,-133,0.45056384097704505,0.549436159022955,home,CHC,under,7.5,0.5,100,0.4793388429752067,CHC,NYM,2022 REG,8,0,12,8,8,20,0,1,-8,8,0,0,0,0,0,0,0,0,0,0.5206611570247933,0.4793388429752067
87208,0.5815899581589958,0.45454545454545453,-139,120,0.5605739649961564,0.4394260350038436,away,MIN,over,7,0.5412844036697247,-118,0.5189377998484975,NYY,MIN,2022 REG,9,5,11,4,9,20,1,0,1,-1,1,1,1,1,0,0,0,0,0,0.5189377998484975,0.4810622001515025
87208,0.5815899581589958,0.45454545454545453,-139,120,0.5605739649961564,0.4394260350038436,home,NYY,under,7,0.5,100,0.4810622001515025,NYY,MIN,2022 REG,9,5,11,4,9,20,1,0,1,-1,1,1,1,1,0,0,0,0,0,0.5189377998484975,0.4810622001515025
87209,0.5121951219512195,0.5348837209302326,-105,-115,0.48808156828023186,0.5119184317197681,away,LAA,over,9,0.5098039215686274,-104,0.4870219861770517,BAL,LAA,2022 REG,8,4,6,1,5,14,1,0,3,-3,1,0,0,0,0,0,0,0,0,0.4870219861770517,0.5129780138229483
87209,0.5121951219512195,0.5348837209302326,-105,-115,0.48808156828023186,0.5119184317197681,home,BAL,under,9,0.5348837209302326,-115,0.5129780138229483,BAL,LAA,2022 REG,8,4,6,1,5,14,1,0,3,-3,1,0,0,0,0,0,0,0,0,0.4870219861770517,0.5129780138229483
87210,0.7802197802197802,0.2597402597402597,-355,285,0.7490421666245842,0.2509578333754158,away,DET,over,7.5,0.5238095238095238,-110,0.4988662131519274,NYY,DET,2022 REG,15,13,3,0,13,18,1,0,13,-13,0,0,0,0,0,0,0,0,0,0.4988662131519274,0.5011337868480725
87210,0.7802197802197802,0.2597402597402597,-355,285,0.7490421666245842,0.2509578333754158,home,NYY,under,7.5,0.5238095238095238,-110,0.5011337868480725,NYY,DET,2022 REG,15,13,3,0,13,18,1,0,13,-13,0,0,0,0,0,0,0,0,0,0.4988662131519274,0.5011337868480725
87211,0.33557046979865773,0.7101449275362319,198,-245,0.32022973243795655,0.6797702675620434,away,LAD,over,11.5,0.5348837209302326,-115,0.5097020142727117,COL,LAD,2022 REG,7,4,10,5,9,17,0,1,-1,1,1,1,1,1,0,0,0,0,0,0.5097020142727117,0.49029798572728833
87211,0.33557046979865773,0.7101449275362319,198,-245,0.32022973243795655,0.6797702675620434,home,COL,under,11.5,0.5121951219512195,-105,0.49029798572728833,COL,LAD,2022 REG,7,4,10,5,9,17,0,1,-1,1,1,1,1,1,0,0,0,0,0,0.5097020142727117,0.49029798572728833
87212,0.5475113122171946,0.49504950495049505,-121,102,0.5242087833606768,0.4757912166393232,away,OAK,over,7.5,0.5238095238095238,-110,0.4988662131519274,DET,OAK,2022 REG,7,0,11,9,9,18,0,1,-9,9,0,0,0,0,0,0,0,0,0,0.4988662131519274,0.5011337868480725
87212,0.5475113122171946,0.49504950495049505,-121,102,0.5242087833606768,0.4757912166393232,home,DET,under,7.5,0.5238095238095238,-110,0.5011337868480725,DET,OAK,2022 REG,7,0,11,9,9,18,0,1,-9,9,0,0,0,0,0,0,0,0,0,0.4988662131519274,0.5011337868480725
87213,0.37453183520599254,0.6632996632996633,167,-197,0.3603627346420765,0.6396372653579234,away,SD,over,9.5,0.5098039215686274,-104,0.4870219861770517,KC,SD,2022 REG,18,15,10,7,22,28,1,0,8,-8,1,1,1,1,1,1,1,0,0,0.4870219861770517,0.5129780138229483
87213,0.37453183520599254,0.6632996632996633,167,-197,0.3603627346420765,0.6396372653579234,home,KC,under,9.5,0.5348837209302326,-115,0.5129780138229483,KC,SD,2022 REG,18,15,10,7,22,28,1,0,8,-8,1,1,1,1,1,1,1,0,0,0.4870219861770517,0.5129780138229483
87214,0.45454545454545453,0.5867768595041323,120,-142,0.43576258452291505,0.564237415477085,away,HOU,over,7.5,0.5121951219512195,-105,0.48808156828023186,TEX,HOU,2022 REG,6,3,11,5,8,17,0,1,-2,2,1,1,1,0,0,0,0,0,0,0.48808156828023186,0.5119184317197681
87214,0.45454545454545453,0.5867768595041323,120,-142,0.43576258452291505,0.564237415477085,home,TEX,under,7.5,0.5348837209302326,-115,0.5119184317197681,TEX,HOU,2022 REG,6,3,11,5,8,17,0,1,-2,2,1,1,1,0,0,0,0,0,0,0.48808156828023186,0.5119184317197681
87215,0.7032640949554896,0.3389830508474576,-237,195,0.6735531941979274,0.32644680580207264,away,CIN,over,9,0.5,100,0.4772727272727273,MIL,CIN,2022 REG,6,5,1,1,6,7,1,0,4,-4,1,0,0,0,0,0,0,0,0,0.4772727272727273,0.5227272727272727
87215,0.7032640949554896,0.3389830508474576,-237,195,0.6735531941979274,0.32644680580207264,home,MIL,under,9,0.5454545454545454,-120,0.5227272727272727,MIL,CIN,2022 REG,6,5,1,1,6,7,1,0,4,-4,1,0,0,0,0,0,0,0,0,0.4772727272727273,0.5227272727272727
87216,0.7101449275362319,0.3278688524590164,-245,205,0.6831496344961281,0.3168503655038719,away,CWS,over,7.5,0.5327102803738317,-114,0.508788710910954,HOU,CWS,2022 REG,3,0,12,7,7,15,0,1,-7,7,0,0,0,0,0,0,0,0,0,0.508788710910954,0.491211289089046
87216,0.7101449275362319,0.3278688524590164,-245,205,0.6831496344961281,0.3168503655038719,home,HOU,under,7.5,0.5121951219512195,-105,0.491211289089046,HOU,CWS,2022 REG,3,0,12,7,7,15,0,1,-7,7,0,0,0,0,0,0,0,0,0,0.508788710910954,0.491211289089046
87217,0.6894409937888198,0.3508771929824561,-222,185,0.6616439830334682,0.33835601696653184,away,PIT,over,6.5,0.5145631067961165,-106,0.4913668392989033,TB,PIT,2022 REG,10,4,6,2,6,16,1,0,2,-2,1,1,0,0,0,0,0,0,0,0.4913668392989033,0.5086331607010968
87217,0.6894409937888198,0.3508771929824561,-222,185,0.6616439830334682,0.33835601696653184,home,TB,under,6.5,0.5305164319248826,-113,0.5086331607010968,TB,PIT,2022 REG,10,4,6,2,6,16,1,0,2,-2,1,1,0,0,0,0,0,0,0,0.4913668392989033,0.5086331607010968
87218,0.6503496503496503,0.3846153846153846,-186,160,0.6276101520856765,0.3723898479143235,away,BAL,over,8.5,0.5327102803738317,-114,0.508788710910954,LAA,BAL,2022 REG,8,3,8,5,8,16,0,1,-2,2,1,1,1,0,0,0,0,0,0,0.508788710910954,0.491211289089046
87218,0.6503496503496503,0.3846153846153846,-186,160,0.6276101520856765,0.3723898479143235,home,LAA,under,8.5,0.5121951219512195,-105,0.491211289089046,LAA,BAL,2022 REG,8,3,8,5,8,16,0,1,-2,2,1,1,1,0,0,0,0,0,0,0.508788710910954,0.491211289089046
87219,0.43859649122807015,0.6000000000000001,128,-150,0.4216682056017235,0.5783317943982764,away,ARI,over,11,0.5454545454545454,-120,0.5206611570247933,COL,ARI,2022 REG,3,0,11,6,6,14,0,1,-6,6,0,0,0,0,0,0,0,0,0,0.5206611570247933,0.4793388429752067
87219,0.43859649122807015,0.6000000000000001,128,-150,0.4216682056017235,0.5783317943982764,home,COL,under,11,0.5,100,0.4793388429752067,COL,ARI,2022 REG,3,0,11,6,6,14,0,1,-6,6,0,0,0,0,0,0,0,0,0,0.5206611570247933,0.4793388429752067
87220,0.576271186440678,0.46511627906976744,-136,115,0.552420782587201,0.44757921741279905,away,HOU,over,8,0.5348837209302326,-115,0.5097020142727117,NYY,HOU,2022 REG,6,7,11,6,13,17,1,0,1,-1,1,1,1,1,1,1,0,0,0,0.5097020142727117,0.49029798572728833
87220,0.576271186440678,0.46511627906976744,-136,115,0.552420782587201,0.44757921741279905,home,NYY,under,8,0.5121951219512195,-105,0.49029798572728833,NYY,HOU,2022 REG,6,7,11,6,13,17,1,0,1,-1,1,1,1,1,1,1,0,0,0,0.5097020142727117,0.49029798572728833
87221,0.3225806451612903,0.7159090909090909,210,-252,0.3101646012676189,0.6898353987323811,away,ATL,over,9.5,0.5,100,0.4762443438914027,WSH,ATL,2022 REG,6,0,6,8,8,12,0,1,-8,8,0,0,0,0,0,0,0,0,0,0.4762443438914027,0.5237556561085973
87221,0.3225806451612903,0.7159090909090909,210,-252,0.3101646012676189,0.6898353987323811,home,WSH,under,9.5,0.5475113122171946,-121,0.5237556561085973,WSH,ATL,2022 REG,6,0,6,8,8,12,0,1,-8,8,0,0,0,0,0,0,0,0,0,0.4762443438914027,0.5237556561085973
87222,0.5169082125603864,0.5283018867924528,-107,-112,0.49353874091423283,0.5064612590857671,away,CWS,over,7.5,0.5348837209302326,-115,0.5097020142727117,MIN,CWS,2022 REG,9,6,9,4,10,18,1,0,2,-2,1,1,1,1,0,0,0,0,0,0.5097020142727117,0.49029798572728833
87222,0.5169082125603864,0.5283018867924528,-107,-112,0.49353874091423283,0.5064612590857671,home,MIN,under,7.5,0.5121951219512195,-105,0.49029798572728833,MIN,CWS,2022 REG,9,6,9,4,10,18,1,0,2,-2,1,1,1,1,0,0,0,0,0,0.5097020142727117,0.49029798572728833
87223,0.6415770609318996,0.3968253968253968,-179,152,0.616938924951412,0.383061075048588,away,STL,over,9.5,0.5,100,0.4772727272727273,ATL,STL,2022 REG,10,6,9,3,9,19,1,0,3,-3,1,1,1,0,0,0,0,0,0,0.4772727272727273,0.5227272727272727
87223,0.6415770609318996,0.3968253968253968,-179,152,0.616938924951412,0.383061075048588,home,ATL,under,9.5,0.5454545454545454,-120,0.5227272727272727,ATL,STL,2022 REG,10,6,9,3,9,19,1,0,3,-3,1,1,1,0,0,0,0,0,0,0.4772727272727273,0.5227272727272727
87224,0.6282527881040892,0.4132231404958678,-169,142,0.60219542032196,0.39780457967803995,away,TB,over,8.5,0.5348837209302326,-115,0.5109810284308424,TOR,TB,2022 REG,6,3,6,2,5,12,1,0,1,-1,1,1,0,0,0,0,0,0,0,0.5109810284308424,0.48901897156915763
87224,0.6282527881040892,0.4132231404958678,-169,142,0.60219542032196,0.39780457967803995,home,TOR,under,8.5,0.5098039215686274,-104,0.48901897156915763,TOR,TB,2022 REG,6,3,6,2,5,12,1,0,1,-1,1,1,0,0,0,0,0,0,0,0.5109810284308424,0.48901897156915763
87225,0.7727272727272727,0.27027027027027023,-340,270,0.7395018985928078,0.2604981014071922,away,DET,over,8,0.5215311004784688,-109,0.4978845547971712,LAD,DET,2022 REG,4,1,10,5,6,14,0,1,-4,4,1,0,0,0,0,0,0,0,0,0.4978845547971712,0.5021154452028288
87225,0.7727272727272727,0.27027027027027023,-340,270,0.7395018985928078,0.2604981014071922,home,LAD,under,8,0.5238095238095238,-110,0.5021154452028288,LAD,DET,2022 REG,4,1,10,5,6,14,0,1,-4,4,1,0,0,0,0,0,0,0,0,0.4978845547971712,0.5021154452028288
87226,0.37037037037037035,0.6666666666666666,170,-200,0.35665294924554186,0.6433470507544581,away,MIL,over,8.5,0.5121951219512195,-105,0.48919479393107135,CIN,MIL,2022 REG,6,4,9,5,9,15,0,1,-1,1,1,1,1,1,0,0,0,0,0,0.48919479393107135,0.5108052060689287
87226,0.37037037037037035,0.6666666666666666,170,-200,0.35665294924554186,0.6433470507544581,home,CIN,under,8.5,0.5327102803738317,-114,0.5108052060689287,CIN,MIL,2022 REG,6,4,9,5,9,15,0,1,-1,1,1,1,1,1,0,0,0,0,0,0.48919479393107135,0.5108052060689287
87227,0.425531914893617,0.6124031007751938,135,-158,0.4093893550345486,0.5906106449654513,away,ATL,over,12,0.5260663507109005,-111,0.5022370601254724,COL,ATL,2022 REG,12,7,11,8,15,23,0,1,-1,1,1,1,1,1,1,1,1,0,0,0.5022370601254724,0.4977629398745276
87227,0.425531914893617,0.6124031007751938,135,-158,0.4093893550345486,0.5906106449654513,home,COL,under,12,0.5192307692307692,-108,0.4977629398745276,COL,ATL,2022 REG,12,7,11,8,15,23,0,1,-1,1,1,1,1,1,1,1,1,0,0,0.5022370601254724,0.4977629398745276
87228,0.3921568627450981,0.6610169491525424,155,-195,0.3713043874911215,0.6286956125088785,away,MIA,over,7.5,0.5348837209302326,-115,0.5059387610766736,WSH,MIA,2022 REG,7,1,6,3,4,13,0,1,-2,2,1,0,0,0,0,0,0,0,0,0.5059387610766736,0.49406123892332643
87228,0.3921568627450981,0.6610169491525424,155,-195,0.3713043874911215,0.6286956125088785,home,WSH,under,7.5,0.5192307692307692,-108,0.49406123892332643,WSH,MIA,2022 REG,7,1,6,3,4,13,0,1,-2,2,1,0,0,0,0,0,0,0,0,0.5059387610766736,0.49406123892332643
87229,0.613899613899614,0.42372881355932196,-159,136,0.5907995368109236,0.40920046318907644,away,BOS,over,8.5,0.5121951219512195,-105,0.48919479393107135,NYY,BOS,2022 REG,8,7,9,5,12,17,1,0,2,-2,1,1,1,1,1,0,0,0,0,0.48919479393107135,0.5108052060689287
87229,0.613899613899614,0.42372881355932196,-159,136,0.5907995368109236,0.40920046318907644,home,NYY,under,8.5,0.5327102803738317,-114,0.5108052060689287,NYY,BOS,2022 REG,8,7,9,5,12,17,1,0,2,-2,1,1,1,1,1,0,0,0,0,0.48919479393107135,0.5108052060689287
87230,0.6632996632996633,0.37037037037037035,-197,170,0.6409663413030415,0.35903365869695847,away,KC,over,7.5,0.5,100,0.4783105022831051,MIN,KC,2022 REG,8,4,5,0,4,13,1,0,4,-4,0,0,0,0,0,0,0,0,0,0.4783105022831051,0.5216894977168949
87230,0.6632996632996633,0.37037037037037035,-197,170,0.6409663413030415,0.35903365869695847,home,MIN,under,7.5,0.5433789954337899,-119,0.5216894977168949,MIN,KC,2022 REG,8,4,5,0,4,13,1,0,4,-4,0,0,0,0,0,0,0,0,0,0.4783105022831051,0.5216894977168949
87231,0.5555555555555556,0.48309178743961345,-125,107,0.5340848094471283,0.46591519055287167,away,COL,over,8.5,0.5145631067961165,-106,0.4913668392989033,PIT,COL,2022 REG,9,2,7,1,3,16,1,0,1,-1,1,0,0,0,0,0,0,0,0,0.4913668392989033,0.5086331607010968
87231,0.5555555555555556,0.48309178743961345,-125,107,0.5340848094471283,0.46591519055287167,home,PIT,under,8.5,0.5305164319248826,-113,0.5086331607010968,PIT,COL,2022 REG,9,2,7,1,3,16,1,0,1,-1,1,0,0,0,0,0,0,0,0,0.4913668392989033,0.5086331607010968
87232,0.6774193548387096,0.36363636363636365,-210,175,0.6496074165168858,0.3503925834831142,away,WSH,over,7.5,0.5305164319248826,-113,0.5066009958897986,MIA,WSH,2022 REG,9,2,7,1,3,16,1,0,1,-1,1,0,0,0,0,0,0,0,0,0.5066009958897986,0.49339900411020143
87232,0.6774193548387096,0.36363636363636365,-210,175,0.6496074165168858,0.3503925834831142,home,MIA,under,7.5,0.5145631067961165,-106,0.49339900411020143,MIA,WSH,2022 REG,9,2,7,1,3,16,1,0,1,-1,1,0,0,0,0,0,0,0,0,0.5066009958897986,0.49339900411020143
87233,0.5555555555555556,0.4854368932038835,-125,106,0.5327819729114227,0.4672180270885773,away,BOS,over,9,0.5121951219512195,-105,0.48919479393107135,LAA,BOS,2022 REG,3,0,6,1,1,9,0,1,-1,1,0,0,0,0,0,0,0,0,0,0.48919479393107135,0.5108052060689287
87233,0.5555555555555556,0.4854368932038835,-125,106,0.5327819729114227,0.4672180270885773,home,LAA,under,9,0.5327102803738317,-114,0.5108052060689287,LAA,BOS,2022 REG,3,0,6,1,1,9,0,1,-1,1,0,0,0,0,0,0,0,0,0,0.48919479393107135,0.5108052060689287
87234,0.5652173913043479,0.4739336492890995,-130,111,0.5430885422732689,0.45691145772673114,away,NYY,over,6.5,0.5391705069124424,-117,0.5140669063204599,TB,NYY,2022 REG,2,4,9,2,6,11,1,0,2,-2,1,1,0,0,0,0,0,0,0,0.5140669063204599,0.4859330936795401
87234,0.5652173913043479,0.4739336492890995,-130,111,0.5430885422732689,0.45691145772673114,home,TB,under,6.5,0.5073891625615764,-103,0.4859330936795401,TB,NYY,2022 REG,2,4,9,2,6,11,1,0,2,-2,1,1,0,0,0,0,0,0,0,0.5140669063204599,0.4859330936795401
87235,0.6527777777777778,0.3861003861003861,-188,159,0.6273989763573097,0.3726010236426903,away,BAL,over,8,0.5391705069124424,-117,0.5140669063204599,HOU,BAL,2022 REG,4,1,6,3,4,10,0,1,-2,2,1,0,0,0,0,0,0,0,0,0.5140669063204599,0.4859330936795401
87235,0.6527777777777778,0.3861003861003861,-188,159,0.6273989763573097,0.3726010236426903,home,HOU,under,8,0.5073891625615764,-103,0.4859330936795401,HOU,BAL,2022 REG,4,1,6,3,4,10,0,1,-2,2,1,0,0,0,0,0,0,0,0,0.5140669063204599,0.4859330936795401
87236,0.5884773662551441,0.45248868778280543,-143,121,0.5643697706690257,0.4356302293309743,away,ATL,over,6.5,0.5327102803738317,-114,0.508788710910954,MIL,ATL,2022 REG,10,7,10,6,13,20,1,0,1,-1,1,1,1,1,1,1,0,0,0,0.508788710910954,0.491211289089046
87236,0.5884773662551441,0.45248868778280543,-143,121,0.5643697706690257,0.4356302293309743,home,MIL,under,6.5,0.5121951219512195,-105,0.491211289089046,MIL,ATL,2022 REG,10,7,10,6,13,20,1,0,1,-1,1,1,1,1,1,1,0,0,0,0.508788710910954,0.491211289089046
87237,0.4366812227074236,0.6000000000000001,129,-150,0.42066322152514246,0.5793367784748575,away,PHI,over,7.5,0.5348837209302326,-115,0.5097020142727117,MIA,PHI,2022 REG,13,11,8,3,14,21,1,0,8,-8,1,1,1,0,0,0,0,0,0,0.5097020142727117,0.49029798572728833
87237,0.4366812227074236,0.6000000000000001,129,-150,0.42066322152514246,0.5793367784748575,home,MIA,under,7.5,0.5121951219512195,-105,0.49029798572728833,MIA,PHI,2022 REG,13,11,8,3,14,21,1,0,8,-8,1,1,1,0,0,0,0,0,0,0.5097020142727117,0.49029798572728833
87238,0.5412844036697247,0.5,-118,100,0.5189377998484975,0.4810622001515025,away,PHI,over,7.5,0.5098039215686274,-104,0.48592421718142587,MIA,PHI,2022 REG,11,7,8,1,8,19,1,0,6,-6,1,0,0,0,0,0,0,0,0,0.48592421718142587,0.5140757828185741
87238,0.5412844036697247,0.5,-118,100,0.5189377998484975,0.4810622001515025,home,MIA,under,7.5,0.5370370370370371,-116,0.5140757828185741,MIA,PHI,2022 REG,11,7,8,1,8,19,1,0,6,-6,1,0,0,0,0,0,0,0,0,0.48592421718142587,0.5140757828185741
87239,0.504950495049505,0.5391705069124424,-102,-117,0.4826715732667395,0.5173284267332605,away,CIN,over,8.5,0.5121951219512195,-105,0.48919479393107135,WSH,CIN,2022 REG,6,3,5,2,5,11,1,0,1,-1,1,1,0,0,0,0,0,0,0,0.48919479393107135,0.5108052060689287
87239,0.504950495049505,0.5391705069124424,-102,-117,0.4826715732667395,0.5173284267332605,home,WSH,under,8.5,0.5327102803738317,-114,0.5108052060689287,WSH,CIN,2022 REG,6,3,5,2,5,11,1,0,1,-1,1,1,0,0,0,0,0,0,0,0.48919479393107135,0.5108052060689287
87240,0.48780487804878053,0.5555555555555556,105,-125,0.4666534470222751,0.5333465529777248,away,STL,over,9,0.5348837209302326,-115,0.5097020142727117,MIL,STL,2022 REG,4,2,11,6,8,15,0,1,-4,4,1,1,0,0,0,0,0,0,0,0.5097020142727117,0.49029798572728833
87240,0.48780487804878053,0.5555555555555556,105,-125,0.4666534470222751,0.5333465529777248,home,MIL,under,9,0.5121951219512195,-105,0.49029798572728833,MIL,STL,2022 REG,4,2,11,6,8,15,0,1,-4,4,1,1,0,0,0,0,0,0,0,0.5097020142727117,0.49029798572728833
87241,0.5555555555555556,0.48780487804878053,-125,105,0.5314664257753688,0.46853357422463116,away,ATL,over,7.5,0.49751243781094534,101,0.47511256217505476,PHI,ATL,2022 REG,8,3,8,5,8,16,0,1,-2,2,1,1,1,0,0,0,0,0,0,0.47511256217505476,0.5248874378249453
87241,0.5555555555555556,0.48780487804878053,-125,105,0.5314664257753688,0.46853357422463116,home,PHI,under,7.5,0.5475113122171946,-121,0.5248874378249453,PHI,ATL,2022 REG,8,3,8,5,8,16,0,1,-2,2,1,1,1,0,0,0,0,0,0,0.47511256217505476,0.5248874378249453
87242,0.607843137254902,0.43103448275862066,-155,132,0.5842116427368785,0.41578835726312147,away,SD,over,9,0.5,100,0.4772727272727273,LAD,SD,2022 REG,10,8,6,3,11,16,1,0,5,-5,1,1,1,0,0,0,0,0,0,0.4772727272727273,0.5227272727272727
87242,0.607843137254902,0.43103448275862066,-155,132,0.5842116427368785,0.41578835726312147,home,LAD,under,9,0.5454545454545454,-120,0.5227272727272727,LAD,SD,2022 REG,10,8,6,3,11,16,1,0,5,-5,1,1,1,0,0,0,0,0,0,0.4772727272727273,0.5227272727272727
87243,0.5918367346938775,0.4484304932735426,-145,123,0.5680051099784656,0.43199489002153435,away,SF,over,7,0.504950495049505,-102,0.48054649490447493,SD,SF,2022 REG,8,2,2,1,3,10,1,0,1,-1,1,0,0,0,0,0,0,0,0,0.48054649490447493,0.5194535050955251
87243,0.5918367346938775,0.4484304932735426,-145,123,0.5680051099784656,0.43199489002153435,home,SD,under,7,0.5433789954337899,-119,0.5194535050955251,SD,SF,2022 REG,8,2,2,1,3,10,1,0,1,-1,1,0,0,0,0,0,0,0,0,0.48054649490447493,0.5194535050955251
87244,0.5780590717299579,0.4629629629629629,-137,116,0.5543459124348938,0.44565408756510616,away,DET,over,8.5,0.5073891625615764,-103,0.4837652908580103,MIN,DET,2022 REG,12,5,5,3,8,17,1,0,2,-2,1,1,1,0,0,0,0,0,0,0.4837652908580103,0.5162347091419897
87244,0.5780590717299579,0.4629629629629629,-137,116,0.5543459124348938,0.44565408756510616,home,MIN,under,8.5,0.5391705069124424,-117,0.5162347091419897,MIN,DET,2022 REG,12,5,5,3,8,17,1,0,2,-2,1,1,1,0,0,0,0,0,0,0.4837652908580103,0.5162347091419897
87245,0.5535714285714286,0.48309178743961345,-124,107,0.5332757197081732,0.4667242802918268,away,LAA,over,7.5,0.5215311004784688,-109,0.49907282342437215,NYY,LAA,2022 REG,13,6,7,1,7,20,1,0,5,-5,1,0,0,0,0,0,0,0,0,0.49907282342437215,0.5009271765756278
87245,0.5535714285714286,0.48309178743961345,-124,107,0.5332757197081732,0.4667242802918268,home,NYY,under,7.5,0.5215311004784688,-109,0.5009271765756278,NYY,LAA,2022 REG,13,6,7,1,7,20,1,0,5,-5,1,0,0,0,0,0,0,0,0,0.49907282342437215,0.5009271765756278
87246,0.5594713656387665,0.47846889952153115,-127,109,0.5382448736768379,0.46175512632316207,away,LAA,over,7.5,0.5215311004784688,-109,0.49907282342437215,CWS,LAA,2022 REG,7,3,2,0,3,9,1,0,3,-3,0,0,0,0,0,0,0,0,0,0.49907282342437215,0.5009271765756278
87246,0.5594713656387665,0.47846889952153115,-127,109,0.5382448736768379,0.46175512632316207,home,CWS,under,7.5,0.5215311004784688,-109,0.5009271765756278,CWS,LAA,2022 REG,7,3,2,0,3,9,1,0,3,-3,0,0,0,0,0,0,0,0,0,0.49907282342437215,0.5009271765756278
87247,0.5024875621890548,0.5391705069124424,-101,-117,0.4815549006007403,0.5184450993992598,away,NYM,over,8,0.5327102803738317,-114,0.508788710910954,MIL,NYM,2022 REG,11,5,4,7,12,15,0,1,-2,2,1,1,1,1,1,0,0,0,0,0.508788710910954,0.491211289089046
87247,0.5024875621890548,0.5391705069124424,-101,-117,0.4815549006007403,0.5184450993992598,home,MIL,under,8,0.5121951219512195,-105,0.491211289089046,MIL,NYM,2022 REG,11,5,4,7,12,15,0,1,-2,2,1,1,1,1,1,0,0,0,0,0.508788710910954,0.491211289089046
87248,0.5833333333333333,0.4608294930875576,-140,117,0.5575716845878136,0.4424283154121864,away,SD,over,7.5,0.5169082125603864,-107,0.49353874091423283,SF,SD,2022 REG,4,1,17,10,11,21,0,1,-9,9,1,0,0,0,0,0,0,0,0,0.49353874091423283,0.5064612590857671
87248,0.5833333333333333,0.4608294930875576,-140,117,0.5575716845878136,0.4424283154121864,home,SF,under,7.5,0.5283018867924528,-112,0.5064612590857671,SF,SD,2022 REG,4,1,17,10,11,21,0,1,-9,9,1,0,0,0,0,0,0,0,0,0.49353874091423283,0.5064612590857671
87249,0.6254681647940076,0.4132231404958678,-167,142,0.6012679850808645,0.39873201491913546,away,BOS,over,7.5,0.5169082125603864,-107,0.49353874091423283,CWS,BOS,2022 REG,6,3,19,16,19,25,0,1,-13,13,1,1,1,0,0,0,0,0,0,0.49353874091423283,0.5064612590857671
87249,0.6254681647940076,0.4132231404958678,-167,142,0.6012679850808645,0.39873201491913546,home,CWS,under,7.5,0.5283018867924528,-112,0.5064612590857671,CWS,BOS,2022 REG,6,3,19,16,19,25,0,1,-13,13,1,1,1,0,0,0,0,0,0,0.49353874091423283,0.5064612590857671
87250,0.47619047619047616,0.5614035087719298,110,-128,0.4582885785893304,0.5417114214106695,away,SF,over,8,0.5073891625615764,-103,0.4837652908580103,CLE,SF,2022 REG,6,1,11,8,9,17,0,1,-7,7,1,0,0,0,0,0,0,0,0,0.4837652908580103,0.5162347091419897
87250,0.47619047619047616,0.5614035087719298,110,-128,0.4582885785893304,0.5417114214106695,home,CLE,under,8,0.5391705069124424,-117,0.5162347091419897,CLE,SF,2022 REG,6,1,11,8,9,17,0,1,-7,7,1,0,0,0,0,0,0,0,0,0.4837652908580103,0.5162347091419897
87251,0.7762863534675616,0.2631578947368421,-347,280,0.7456663218636956,0.25433367813630436,away,PIT,over,7.5,0.5238095238095238,-110,0.4988662131519274,MIL,PIT,2022 REG,11,7,10,5,12,21,1,0,2,-2,1,1,1,1,1,0,0,0,0,0.4988662131519274,0.5011337868480725
87251,0.7762863534675616,0.2631578947368421,-347,280,0.7456663218636956,0.25433367813630436,home,MIL,under,7.5,0.5238095238095238,-110,0.5011337868480725,MIL,PIT,2022 REG,11,7,10,5,12,21,1,0,2,-2,1,1,1,1,1,0,0,0,0,0.4988662131519274,0.5011337868480725
87252,0.5024875621890548,0.5412844036697247,-101,-118,0.48049269377245407,0.5195073062275459,away,WSH,over,8.5,0.5121951219512195,-105,0.48919479393107135,PIT,WSH,2022 REG,7,5,8,3,8,15,1,0,2,-2,1,1,1,0,0,0,0,0,0,0.48919479393107135,0.5108052060689287
87252,0.5024875621890548,0.5412844036697247,-101,-118,0.48049269377245407,0.5195073062275459,home,PIT,under,8.5,0.5327102803738317,-114,0.5108052060689287,PIT,WSH,2022 REG,7,5,8,3,8,15,1,0,2,-2,1,1,1,0,0,0,0,0,0,0.48919479393107135,0.5108052060689287
87253,0.7101449275362319,0.33112582781456956,-245,202,0.6808367099682715,0.3191632900317285,away,PIT,over,9,0.5145631067961165,-106,0.4913668392989033,ATL,PIT,2022 REG,8,10,6,4,14,14,1,0,6,-6,1,1,1,1,0,0,0,0,0,0.4913668392989033,0.5086331607010968
87253,0.7101449275362319,0.33112582781456956,-245,202,0.6808367099682715,0.3191632900317285,home,ATL,under,9,0.5305164319248826,-113,0.5086331607010968,ATL,PIT,2022 REG,8,10,6,4,14,14,1,0,6,-6,1,1,1,1,0,0,0,0,0,0.4913668392989033,0.5086331607010968
87254,0.5495495495495495,0.48780487804878053,-122,105,0.529021440689206,0.470978559310794,away,BOS,over,7.5,0.5024875621890548,-101,0.4794401874631478,OAK,BOS,2022 REG,7,2,7,5,7,14,0,1,-3,3,1,1,0,0,0,0,0,0,0,0.4794401874631478,0.5205598125368522
87254,0.5495495495495495,0.48780487804878053,-122,105,0.529021440689206,0.470978559310794,home,OAK,under,7.5,0.5433789954337899,-119,0.5205598125368522,OAK,BOS,2022 REG,7,2,7,5,7,14,0,1,-3,3,1,1,0,0,0,0,0,0,0,0.4794401874631478,0.5205598125368522
87255,0.4184100418410042,0.6226415094339623,139,-165,0.40123366055440735,0.5987663394455927,away,ATL,over,9.5,0.5283018867924528,-112,0.5044173060022736,BOS,ATL,2022 REG,11,7,13,9,16,24,0,1,-2,2,1,1,1,1,1,1,1,0,0,0.5044173060022736,0.49558269399772636
87255,0.4184100418410042,0.6226415094339623,139,-165,0.40123366055440735,0.5987663394455927,home,BOS,under,9.5,0.5169082125603864,-107,0.49558269399772636,BOS,ATL,2022 REG,11,7,13,9,16,24,0,1,-2,2,1,1,1,1,1,1,1,0,0,0.5044173060022736,0.49558269399772636
87256,0.5833333333333333,0.4629629629629629,-140,116,0.5563271604938271,0.44367283950617287,away,KC,over,8,0.5238095238095238,-110,0.5012646084074657,TEX,KC,2022 REG,10,6,7,4,10,17,1,0,2,-2,1,1,1,1,0,0,0,0,0,0.5012646084074657,0.4987353915925343
87256,0.5833333333333333,0.4629629629629629,-140,116,0.5563271604938271,0.44367283950617287,home,TEX,under,8,0.5192307692307692,-108,0.4987353915925343,TEX,KC,2022 REG,10,6,7,4,10,17,1,0,2,-2,1,1,1,1,0,0,0,0,0,0.5012646084074657,0.4987353915925343
87257,0.45454545454545453,0.5850622406639003,120,-141,0.4365419567230205,0.5634580432769796,away,NYY,over,7.5,0.5,100,0.4783105022831051,HOU,NYY,2022 REG,3,2,5,1,3,8,1,0,1,-1,1,0,0,0,0,0,0,0,0,0.4783105022831051,0.5216894977168949
87257,0.45454545454545453,0.5850622406639003,120,-141,0.4365419567230205,0.5634580432769796,home,HOU,under,7.5,0.5433789954337899,-119,0.5216894977168949,HOU,NYY,2022 REG,3,2,5,1,3,8,1,0,1,-1,1,0,0,0,0,0,0,0,0,0.4783105022831051,0.5216894977168949
87258,0.6153846153846154,0.425531914893617,-160,135,0.5902052121364724,0.40979478786352763,away,KC,over,7,0.5391705069124424,-117,0.5153817639191344,OAK,KC,2022 REG,5,1,11,5,6,16,0,1,-4,4,1,0,0,0,0,0,0,0,0,0.5153817639191344,0.4846182360808656
87258,0.6153846153846154,0.425531914893617,-160,135,0.5902052121364724,0.40979478786352763,home,OAK,under,7,0.504950495049505,-102,0.4846182360808656,OAK,KC,2022 REG,5,1,11,5,6,16,0,1,-4,4,1,0,0,0,0,0,0,0,0,0.5153817639191344,0.4846182360808656
87259,0.5652173913043479,0.47619047619047616,-130,110,0.5418129444594474,0.4581870555405526,away,LAA,over,8.5,0.5327102803738317,-114,0.508788710910954,KC,LAA,2022 REG,7,0,9,4,4,16,0,1,-4,4,0,0,0,0,0,0,0,0,0,0.508788710910954,0.491211289089046
87259,0.5652173913043479,0.47619047619047616,-130,110,0.5418129444594474,0.4581870555405526,home,KC,under,8.5,0.5121951219512195,-105,0.491211289089046,KC,LAA,2022 REG,7,0,9,4,4,16,0,1,-4,4,0,0,0,0,0,0,0,0,0,0.508788710910954,0.491211289089046
87260,0.6875,0.35714285714285715,-220,180,0.6568080357142857,0.3431919642857143,away,CIN,over,7.5,0.5391705069124424,-117,0.5140669063204599,MIL,CIN,2022 REG,12,10,9,5,15,21,1,0,5,-5,1,1,1,1,1,0,0,0,0,0.5140669063204599,0.4859330936795401
87260,0.6875,0.35714285714285715,-220,180,0.6568080357142857,0.3431919642857143,home,MIL,under,7.5,0.5073891625615764,-103,0.4859330936795401,MIL,CIN,2022 REG,12,10,9,5,15,21,1,0,5,-5,1,1,1,1,1,0,0,0,0,0.5140669063204599,0.4859330936795401
87261,0.5283018867924528,0.5121951219512195,-112,-105,0.5069072406637203,0.4930927593362797,away,TB,over,10,0.5145631067961165,-106,0.4913668392989033,KC,TB,2022 REG,13,6,8,3,9,21,1,0,3,-3,1,1,1,0,0,0,0,0,0,0.4913668392989033,0.5086331607010968
87261,0.5283018867924528,0.5121951219512195,-112,-105,0.5069072406637203,0.4930927593362797,home,KC,under,10,0.5305164319248826,-113,0.5086331607010968,KC,TB,2022 REG,13,6,8,3,9,21,1,0,3,-3,1,1,1,0,0,0,0,0,0,0.4913668392989033,0.5086331607010968
87262,0.37037037037037035,0.6666666666666666,170,-200,0.35665294924554186,0.6433470507544581,away,ATL,over,9,0.5121951219512195,-105,0.48808156828023186,PIT,ATL,2022 REG,5,1,4,2,3,9,0,1,-1,1,1,0,0,0,0,0,0,0,0,0.48808156828023186,0.5119184317197681
87262,0.37037037037037035,0.6666666666666666,170,-200,0.35665294924554186,0.6433470507544581,home,PIT,under,9,0.5348837209302326,-115,0.5119184317197681,PIT,ATL,2022 REG,5,1,4,2,3,9,0,1,-1,1,1,0,0,0,0,0,0,0,0,0.48808156828023186,0.5119184317197681
87263,0.3067484662576687,0.7333333333333333,226,-275,0.2944534357082816,0.7055465642917185,away,ATL,over,7.5,0.5348837209302326,-115,0.5109810284308424,PIT,ATL,2022 REG,3,1,10,6,7,13,0,1,-5,5,1,0,0,0,0,0,0,0,0,0.5109810284308424,0.48901897156915763
87263,0.3067484662576687,0.7333333333333333,226,-275,0.2944534357082816,0.7055465642917185,home,PIT,under,7.5,0.5098039215686274,-104,0.48901897156915763,PIT,ATL,2022 REG,3,1,10,6,7,13,0,1,-5,5,1,0,0,0,0,0,0,0,0,0.5109810284308424,0.48901897156915763
87264,0.5475113122171946,0.4926108374384236,-121,103,0.5255439814102724,0.47445601858972763,away,CHC,over,9,0.5121951219512195,-105,0.48808156828023186,CIN,CHC,2022 REG,7,2,9,7,9,16,0,1,-5,5,1,1,0,0,0,0,0,0,0,0.48808156828023186,0.5119184317197681
87264,0.5475113122171946,0.4926108374384236,-121,103,0.5255439814102724,0.47445601858972763,home,CIN,under,9,0.5348837209302326,-115,0.5119184317197681,CIN,CHC,2022 REG,7,2,9,7,9,16,0,1,-5,5,1,1,0,0,0,0,0,0,0,0.48808156828023186,0.5119184317197681
87265,0.45454545454545453,0.5850622406639003,120,-141,0.4365419567230205,0.5634580432769796,away,HOU,over,8.5,0.5145631067961165,-106,0.4925063625223866,TEX,HOU,2022 REG,11,6,8,2,8,19,1,0,4,-4,1,1,0,0,0,0,0,0,0,0.4925063625223866,0.5074936374776133
87265,0.45454545454545453,0.5850622406639003,120,-141,0.4365419567230205,0.5634580432769796,home,TEX,under,8.5,0.5283018867924528,-112,0.5074936374776133,TEX,HOU,2022 REG,11,6,8,2,8,19,1,0,4,-4,1,1,0,0,0,0,0,0,0,0.4925063625223866,0.5074936374776133
87266,0.4587155963302753,0.5850622406639003,118,-141,0.4386340197274424,0.5613659802725576,away,CWS,over,8.5,0.5192307692307692,-108,0.49688292476754015,DET,CWS,2022 REG,2,1,13,10,11,15,0,1,-9,9,1,0,0,0,0,0,0,0,0,0.49688292476754015,0.5031170752324599
87266,0.4587155963302753,0.5850622406639003,118,-141,0.4386340197274424,0.5613659802725576,home,DET,under,8.5,0.5238095238095238,-110,0.5031170752324599,DET,CWS,2022 REG,2,1,13,10,11,15,0,1,-9,9,1,0,0,0,0,0,0,0,0,0.49688292476754015,0.5031170752324599
87267,0.6031746031746031,0.4347826086956522,-152,130,0.5802797769671475,0.4197202230328525,away,BAL,over,8.5,0.5348837209302326,-115,0.5097020142727117,BOS,BAL,2022 REG,9,5,9,3,8,18,1,0,2,-2,1,1,1,0,0,0,0,0,0,0.5097020142727117,0.49029798572728833
87267,0.6031746031746031,0.4347826086956522,-152,130,0.5802797769671475,0.4197202230328525,home,BOS,under,8.5,0.5121951219512195,-105,0.49029798572728833,BOS,BAL,2022 REG,9,5,9,3,8,18,1,0,2,-2,1,1,1,0,0,0,0,0,0,0.5097020142727117,0.49029798572728833
87268,0.5,0.5454545454545454,100,-120,0.4772727272727273,0.5227272727272727,away,CLE,over,6.5,0.5555555555555556,-125,0.5314664257753688,SEA,CLE,2022 REG,8,3,9,2,5,17,1,0,1,-1,1,1,0,0,0,0,0,0,0,0.5314664257753688,0.46853357422463116
87268,0.5,0.5454545454545454,100,-120,0.4772727272727273,0.5227272727272727,home,SEA,under,6.5,0.48780487804878053,105,0.46853357422463116,SEA,CLE,2022 REG,8,3,9,2,5,17,1,0,1,-1,1,1,0,0,0,0,0,0,0,0.5314664257753688,0.46853357422463116
87269,0.5726495726495727,0.46511627906976744,-134,115,0.5510229738017454,0.44897702619825464,away,CHC,over,8,0.5348837209302326,-115,0.5097020142727117,PIT,CHC,2022 REG,6,3,10,8,11,16,0,1,-5,5,1,1,1,0,0,0,0,0,0,0.5097020142727117,0.49029798572728833
87269,0.5726495726495727,0.46511627906976744,-134,115,0.5510229738017454,0.44897702619825464,home,PIT,under,8,0.5121951219512195,-105,0.49029798572728833,PIT,CHC,2022 REG,6,3,10,8,11,16,0,1,-5,5,1,1,1,0,0,0,0,0,0,0.5097020142727117,0.49029798572728833
87270,0.5215311004784688,0.5238095238095238,-109,-110,0.4978845547971712,0.5021154452028288,away,HOU,over,9.5,0.5370370370370371,-116,0.5118817074154765,LAA,HOU,2022 REG,7,1,7,4,5,14,0,1,-3,3,1,0,0,0,0,0,0,0,0,0.5118817074154765,0.48811829258452355
87270,0.5215311004784688,0.5238095238095238,-109,-110,0.4978845547971712,0.5021154452028288,home,LAA,under,9.5,0.5098039215686274,-104,0.48811829258452355,LAA,HOU,2022 REG,7,1,7,4,5,14,0,1,-3,3,1,0,0,0,0,0,0,0,0,0.5118817074154765,0.48811829258452355
87271,0.574468085106383,0.46511627906976744,-135,115,0.5517281312179562,0.44827186878204384,away,LAA,over,7,0.5454545454545454,-120,0.5193043049216726,MIN,LAA,2022 REG,11,8,7,4,12,18,1,0,4,-4,1,1,1,1,0,0,0,0,0,0.5193043049216726,0.48069569507832743
87271,0.574468085106383,0.46511627906976744,-135,115,0.5517281312179562,0.44827186878204384,home,MIN,under,7,0.5024875621890548,-101,0.48069569507832743,MIN,LAA,2022 REG,11,8,7,4,12,18,1,0,4,-4,1,1,1,1,0,0,0,0,0,0.5193043049216726,0.48069569507832743
87272,0.574468085106383,0.4672897196261683,-135,114,0.550479558983428,0.44952044101657196,away,LAA,over,7.5,0.5391705069124424,-117,0.5140669063204599,OAK,LAA,2022 REG,7,4,6,5,9,13,0,1,-1,1,1,1,1,1,0,0,0,0,0,0.5140669063204599,0.4859330936795401
87272,0.574468085106383,0.4672897196261683,-135,114,0.550479558983428,0.44952044101657196,home,OAK,under,7.5,0.5073891625615764,-103,0.4859330936795401,OAK,LAA,2022 REG,7,4,6,5,9,13,0,1,-1,1,1,1,1,1,0,0,0,0,0,0.5140669063204599,0.4859330936795401
87273,0.4504504504504505,0.5884773662551441,122,-143,0.4329153978803628,0.5670846021196372,away,STL,over,8.5,0.5370370370370371,-116,0.5131785224377817,CIN,STL,2022 REG,8,4,7,1,5,15,1,0,3,-3,1,0,0,0,0,0,0,0,0,0.5131785224377817,0.4868214775622183
87273,0.4504504504504505,0.5884773662551441,122,-143,0.4329153978803628,0.5670846021196372,home,CIN,under,8.5,0.5073891625615764,-103,0.4868214775622183,CIN,STL,2022 REG,8,4,7,1,5,15,1,0,3,-3,1,0,0,0,0,0,0,0,0,0.5131785224377817,0.4868214775622183
87274,0.6666666666666666,0.37037037037037035,-200,170,0.6419753086419753,0.3580246913580247,away,ARI,over,9,0.5215311004784688,-109,0.49907282342437215,LAD,ARI,2022 REG,10,12,11,3,15,21,1,0,9,-9,1,1,1,0,0,0,0,0,0,0.49907282342437215,0.5009271765756278
87274,0.6666666666666666,0.37037037037037035,-200,170,0.6419753086419753,0.3580246913580247,home,LAD,under,9,0.5215311004784688,-109,0.5009271765756278,LAD,ARI,2022 REG,10,12,11,3,15,21,1,0,9,-9,1,1,1,0,0,0,0,0,0,0.49907282342437215,0.5009271765756278
87275,0.35714285714285715,0.6825396825396826,180,-215,0.34297052154195007,0.6570294784580499,away,HOU,over,9,0.5283018867924528,-112,0.5044173060022736,KC,HOU,2022 REG,7,4,12,7,11,19,0,1,-3,3,1,1,1,1,0,0,0,0,0,0.5044173060022736,0.49558269399772636
87275,0.35714285714285715,0.6825396825396826,180,-215,0.34297052154195007,0.6570294784580499,home,KC,under,9,0.5169082125603864,-107,0.49558269399772636,KC,HOU,2022 REG,7,4,12,7,11,19,0,1,-3,3,1,1,1,1,0,0,0,0,0,0.5044173060022736,0.49558269399772636
87276,0.607843137254902,0.4291845493562232,-155,133,0.5853361120599043,0.4146638879400957,away,CIN,over,7.5,0.5283018867924528,-112,0.5056562298022652,CHC,CIN,2022 REG,9,9,4,3,12,13,1,0,6,-6,1,1,1,0,0,0,0,0,0,0.5056562298022652,0.4943437701977348
87276,0.607843137254902,0.4291845493562232,-155,133,0.5853361120599043,0.4146638879400957,home,CHC,under,7.5,0.5145631067961165,-106,0.4943437701977348,CHC,CIN,2022 REG,9,9,4,3,12,13,1,0,6,-6,1,1,1,0,0,0,0,0,0,0.5056562298022652,0.4943437701977348
87277,0.5215311004784688,0.5238095238095238,-109,-110,0.4978845547971712,0.5021154452028288,away,MIL,over,6.5,0.5121951219512195,-105,0.48808156828023186,SF,MIL,2022 REG,4,2,13,3,5,17,0,1,-1,1,1,1,0,0,0,0,0,0,0,0.48808156828023186,0.5119184317197681
87277,0.5215311004784688,0.5238095238095238,-109,-110,0.4978845547971712,0.5021154452028288,home,SF,under,6.5,0.5348837209302326,-115,0.5119184317197681,SF,MIL,2022 REG,4,2,13,3,5,17,0,1,-1,1,1,1,0,0,0,0,0,0,0,0.48808156828023186,0.5119184317197681
87278,0.6240601503759399,0.41493775933609955,-166,141,0.5997231089766972,0.40027689102330277,away,ARI,over,7.5,0.5192307692307692,-108,0.49688292476754015,STL,ARI,2022 REG,2,0,5,2,2,7,0,1,-2,2,0,0,0,0,0,0,0,0,0,0.49688292476754015,0.5031170752324599
87278,0.6240601503759399,0.41493775933609955,-166,141,0.5997231089766972,0.40027689102330277,home,STL,under,7.5,0.5238095238095238,-110,0.5031170752324599,STL,ARI,2022 REG,2,0,5,2,2,7,0,1,-2,2,0,0,0,0,0,0,0,0,0,0.49688292476754015,0.5031170752324599
87279,0.4926108374384236,0.5495495495495495,103,-122,0.4718421738975501,0.5281578261024499,away,MIA,over,8.5,0.5283018867924528,-112,0.5044173060022736,ARI,MIA,2022 REG,7,4,9,3,7,16,1,0,1,-1,1,1,1,0,0,0,0,0,0,0.5044173060022736,0.49558269399772636
87279,0.4926108374384236,0.5495495495495495,103,-122,0.4718421738975501,0.5281578261024499,home,ARI,under,8.5,0.5169082125603864,-107,0.49558269399772636,ARI,MIA,2022 REG,7,4,9,3,7,16,1,0,1,-1,1,1,1,0,0,0,0,0,0,0.5044173060022736,0.49558269399772636
87280,0.40322580645161293,0.6376811594202898,148,-176,0.38673106214842634,0.6132689378515737,away,ATL,over,8.5,0.5327102803738317,-114,0.508788710910954,CIN,ATL,2022 REG,7,4,9,3,7,16,1,0,1,-1,1,1,1,0,0,0,0,0,0,0.508788710910954,0.491211289089046
87280,0.40322580645161293,0.6376811594202898,148,-176,0.38673106214842634,0.6132689378515737,home,CIN,under,8.5,0.5121951219512195,-105,0.491211289089046,CIN,ATL,2022 REG,7,4,9,3,7,16,1,0,1,-1,1,1,1,0,0,0,0,0,0,0.508788710910954,0.491211289089046
87281,0.5495495495495495,0.4926108374384236,-122,103,0.5263803278714742,0.47361967212852585,away,TB,over,9,0.5169082125603864,-107,0.49353874091423283,MIN,TB,2022 REG,13,9,6,4,13,19,1,0,5,-5,1,1,1,1,0,0,0,0,0,0.49353874091423283,0.5064612590857671
87281,0.5495495495495495,0.4926108374384236,-122,103,0.5263803278714742,0.47361967212852585,home,MIN,under,9,0.5283018867924528,-112,0.5064612590857671,MIN,TB,2022 REG,13,9,6,4,13,19,1,0,5,-5,1,1,1,1,0,0,0,0,0,0.49353874091423283,0.5064612590857671
87282,0.4,0.6389891696750902,150,-177,0.3844043321299639,0.6155956678700361,away,ATL,over,11,0.5215311004784688,-109,0.50027251771145,COL,ATL,2022 REG,3,1,8,3,4,11,0,1,-2,2,1,0,0,0,0,0,0,0,0,0.50027251771145,0.49972748228855
87282,0.4,0.6389891696750902,150,-177,0.3844043321299639,0.6155956678700361,home,COL,under,11,0.5192307692307692,-108,0.49972748228855,COL,ATL,2022 REG,3,1,8,3,4,11,0,1,-2,2,1,0,0,0,0,0,0,0,0,0.50027251771145,0.49972748228855
87283,0.5833333333333333,0.4566210045662101,-140,119,0.5600266362252664,0.4399733637747336,away,KC,over,8.5,0.5370370370370371,-116,0.514488177212783,CWS,KC,2022 REG,12,4,4,1,5,16,1,0,3,-3,1,0,0,0,0,0,0,0,0,0.514488177212783,0.48551182278721705
87283,0.5833333333333333,0.4566210045662101,-140,119,0.5600266362252664,0.4399733637747336,home,CWS,under,8.5,0.504950495049505,-102,0.48551182278721705,CWS,KC,2022 REG,12,4,4,1,5,16,1,0,3,-3,1,0,0,0,0,0,0,0,0,0.514488177212783,0.48551182278721705
87284,0.4807692307692307,0.5575221238938054,108,-126,0.46235992564277106,0.5376400743572289,away,MIN,over,9,0.5121951219512195,-105,0.48808156828023186,ARI,MIN,2022 REG,8,7,5,1,8,13,1,0,6,-6,1,0,0,0,0,0,0,0,0,0.48808156828023186,0.5119184317197681
87284,0.4807692307692307,0.5575221238938054,108,-126,0.46235992564277106,0.5376400743572289,home,ARI,under,9,0.5348837209302326,-115,0.5119184317197681,ARI,MIN,2022 REG,8,7,5,1,8,13,1,0,6,-6,1,0,0,0,0,0,0,0,0,0.48808156828023186,0.5119184317197681
87285,0.6453900709219857,0.39370078740157477,-182,154,0.6201612190961417,0.37983878090385825,away,CWS,over,9,0.5098039215686274,-104,0.4881300146960012,NYY,CWS,2022 REG,8,1,8,3,4,16,0,1,-2,2,1,0,0,0,0,0,0,0,0,0.4881300146960012,0.5118699853039987
87285,0.6453900709219857,0.39370078740157477,-182,154,0.6201612190961417,0.37983878090385825,home,NYY,under,9,0.5327102803738317,-114,0.5118699853039987,NYY,CWS,2022 REG,8,1,8,3,4,16,0,1,-2,2,1,0,0,0,0,0,0,0,0,0.4881300146960012,0.5118699853039987
87286,0.3968253968253968,0.6453900709219857,152,-182,0.380073227084372,0.6199267729156279,away,SD,over,10.5,0.5391705069124424,-117,0.5140669063204599,COL,SD,2022 REG,18,10,11,6,16,29,1,0,4,-4,1,1,1,1,1,1,0,0,0,0.5140669063204599,0.4859330936795401
87286,0.3968253968253968,0.6453900709219857,152,-182,0.380073227084372,0.6199267729156279,home,COL,under,10.5,0.5073891625615764,-103,0.4859330936795401,COL,SD,2022 REG,18,10,11,6,16,29,1,0,4,-4,1,1,1,1,1,1,0,0,0,0.5140669063204599,0.4859330936795401
87287,0.45248868778280543,0.5850622406639003,121,-141,0.43549731744492953,0.5645026825550705,away,CWS,over,6.5,0.5454545454545454,-120,0.5206611570247933,CHC,CWS,2022 REG,6,1,7,3,4,13,0,1,-2,2,1,0,0,0,0,0,0,0,0,0.5206611570247933,0.4793388429752067
87287,0.45248868778280543,0.5850622406639003,121,-141,0.43549731744492953,0.5645026825550705,home,CHC,under,6.5,0.5,100,0.4793388429752067,CHC,CWS,2022 REG,6,1,7,3,4,13,0,1,-2,2,1,0,0,0,0,0,0,0,0,0.5206611570247933,0.4793388429752067
87288,0.5515695067264574,0.48780487804878053,-123,105,0.5298517967383217,0.4701482032616783,away,ATL,over,7.5,0.5024875621890548,-101,0.47839724939301687,MIA,ATL,2022 REG,13,12,15,9,21,28,1,0,3,-3,1,1,1,1,1,1,1,1,1,0.47839724939301687,0.5216027506069831
87288,0.5515695067264574,0.48780487804878053,-123,105,0.5298517967383217,0.4701482032616783,home,MIA,under,7.5,0.5454545454545454,-120,0.5216027506069831,MIA,ATL,2022 REG,13,12,15,9,21,28,1,0,3,-3,1,1,1,1,1,1,1,1,1,0.47839724939301687,0.5216027506069831
87289,0.5327102803738317,0.5073891625615764,-114,-103,0.511348894884876,0.488651105115124,away,STL,over,8.5,0.5475113122171946,-121,0.5214983313199976,CHC,STL,2022 REG,13,6,5,1,7,18,1,0,5,-5,1,0,0,0,0,0,0,0,0,0.5214983313199976,0.47850166868000243
87289,0.5327102803738317,0.5073891625615764,-114,-103,0.511348894884876,0.488651105115124,home,CHC,under,8.5,0.5,100,0.47850166868000243,CHC,STL,2022 REG,13,6,5,1,7,18,1,0,5,-5,1,0,0,0,0,0,0,0,0,0.5214983313199976,0.47850166868000243
87290,0.4098360655737705,0.6336996336996338,144,-173,0.3919935658715556,0.6080064341284444,away,MIA,over,7,0.5192307692307692,-108,0.49688292476754015,PIT,MIA,2022 REG,6,5,11,6,11,17,0,1,-1,1,1,1,1,1,1,0,0,0,0,0.49688292476754015,0.5031170752324599
87290,0.4098360655737705,0.6336996336996338,144,-173,0.3919935658715556,0.6080064341284444,home,PIT,under,7,0.5238095238095238,-110,0.5031170752324599,PIT,MIA,2022 REG,6,5,11,6,11,17,0,1,-1,1,1,1,1,1,1,0,0,0,0,0.49688292476754015,0.5031170752324599
87291,0.607843137254902,0.425531914893617,-155,135,0.5875563408509002,0.41244365914909975,away,SF,over,9.5,0.5238095238095238,-110,0.4988662131519274,ATL,SF,2022 REG,10,7,14,6,13,24,1,0,1,-1,1,1,1,1,1,1,0,0,0,0.4988662131519274,0.5011337868480725
87291,0.607843137254902,0.425531914893617,-155,135,0.5875563408509002,0.41244365914909975,home,ATL,under,9.5,0.5238095238095238,-110,0.5011337868480725,ATL,SF,2022 REG,10,7,14,6,13,24,1,0,1,-1,1,1,1,1,1,1,0,0,0,0.4988662131519274,0.5011337868480725
87292,0.7481108312342569,0.2898550724637681,-297,245,0.7197081274601677,0.28029187253983234,away,CHC,over,8,0.5238095238095238,-110,0.4988662131519274,NYM,CHC,2022 REG,8,2,7,5,7,15,0,1,-3,3,1,1,0,0,0,0,0,0,0,0.4988662131519274,0.5011337868480725
87292,0.7481108312342569,0.2898550724637681,-297,245,0.7197081274601677,0.28029187253983234,home,NYM,under,8,0.5238095238095238,-110,0.5011337868480725,NYM,CHC,2022 REG,8,2,7,5,7,15,0,1,-3,3,1,1,0,0,0,0,0,0,0,0.4988662131519274,0.5011337868480725
87293,0.36764705882352944,0.6688741721854304,172,-202,0.3542201356584706,0.6457798643415293,away,NYY,over,8,0.5192307692307692,-108,0.49688292476754015,BAL,NYY,2022 REG,11,9,10,6,15,21,1,0,3,-3,1,1,1,1,1,1,0,0,0,0.49688292476754015,0.5031170752324599
87293,0.36764705882352944,0.6688741721854304,172,-202,0.3542201356584706,0.6457798643415293,home,BAL,under,8,0.5238095238095238,-110,0.5031170752324599,BAL,NYY,2022 REG,11,9,10,6,15,21,1,0,3,-3,1,1,1,1,1,1,0,0,0,0.49688292476754015,0.5031170752324599
87294,0.5594713656387665,0.4807692307692307,-127,108,0.5369579042122659,0.46304209578773414,away,MIN,over,9,0.49751243781094534,101,0.47511256217505476,CLE,MIN,2022 REG,10,7,11,6,13,21,1,0,1,-1,1,1,1,1,1,1,0,0,0,0.47511256217505476,0.5248874378249453
87294,0.5594713656387665,0.4807692307692307,-127,108,0.5369579042122659,0.46304209578773414,home,CLE,under,9,0.5475113122171946,-121,0.5248874378249453,CLE,MIN,2022 REG,10,7,11,6,13,21,1,0,1,-1,1,1,1,1,1,1,0,0,0,0.47511256217505476,0.5248874378249453
87295,0.5495495495495495,0.48780487804878053,-122,105,0.529021440689206,0.470978559310794,away,SD,over,8.5,0.5073891625615764,-103,0.4837652908580103,MIL,SD,2022 REG,9,5,9,4,9,18,1,0,1,-1,1,1,1,1,0,0,0,0,0,0.4837652908580103,0.5162347091419897
87295,0.5495495495495495,0.48780487804878053,-122,105,0.529021440689206,0.470978559310794,home,MIL,under,8.5,0.5391705069124424,-117,0.5162347091419897,MIL,SD,2022 REG,9,5,9,4,9,18,1,0,1,-1,1,1,1,1,0,0,0,0,0,0.4837652908580103,0.5162347091419897
87296,0.5555555555555556,0.48780487804878053,-125,105,0.5314664257753688,0.46853357422463116,away,TEX,over,9,0.5238095238095238,-110,0.4988662131519274,CLE,TEX,2022 REG,9,6,8,3,9,17,1,0,3,-3,1,1,1,0,0,0,0,0,0,0.4988662131519274,0.5011337868480725
87296,0.5555555555555556,0.48780487804878053,-125,105,0.5314664257753688,0.46853357422463116,home,CLE,under,9,0.5238095238095238,-110,0.5011337868480725,CLE,TEX,2022 REG,9,6,8,3,9,17,1,0,3,-3,1,1,1,0,0,0,0,0,0,0.4988662131519274,0.5011337868480725
87297,0.39840637450199207,0.6363636363636364,151,-175,0.3845537805316222,0.6154462194683779,away,LAA,over,3,0.5726495726495727,-134,0.5338817247931236,OAK,LAA,2022 REG,7,1,9,9,10,16,0,1,-8,8,1,0,0,0,0,0,0,0,0,0.5338817247931236,0.46611827520687643
87297,0.39840637450199207,0.6363636363636364,151,-175,0.3845537805316222,0.6154462194683779,home,OAK,under,3,0.49504950495049505,102,0.46611827520687643,OAK,LAA,2022 REG,7,1,9,9,10,16,0,1,-8,8,1,0,0,0,0,0,0,0,0,0.5338817247931236,0.46611827520687643
87298,0.4807692307692307,0.5594713656387665,108,-127,0.46142279018846283,0.5385772098115371,away,LAA,over,8.5,0.5305164319248826,-113,0.5066009958897986,BOS,LAA,2022 REG,9,4,3,0,4,12,1,0,4,-4,0,0,0,0,0,0,0,0,0,0.5066009958897986,0.49339900411020143
87298,0.4807692307692307,0.5594713656387665,108,-127,0.46142279018846283,0.5385772098115371,home,BOS,under,8.5,0.5145631067961165,-106,0.49339900411020143,BOS,LAA,2022 REG,9,4,3,0,4,12,1,0,4,-4,0,0,0,0,0,0,0,0,0,0.5066009958897986,0.49339900411020143
87299,0.5850622406639003,0.4566210045662101,-141,119,0.5606749478114291,0.4393250521885709,away,SEA,over,9,0.5169082125603864,-107,0.49353874091423283,LAA,SEA,2022 REG,6,2,6,1,3,12,1,0,1,-1,1,0,0,0,0,0,0,0,0,0.49353874091423283,0.5064612590857671
87299,0.5850622406639003,0.4566210045662101,-141,119,0.5606749478114291,0.4393250521885709,home,LAA,under,9,0.5283018867924528,-112,0.5064612590857671,LAA,SEA,2022 REG,6,2,6,1,3,12,1,0,1,-1,1,0,0,0,0,0,0,0,0,0.49353874091423283,0.5064612590857671
87300,0.6666666666666666,0.3717472118959108,-200,169,0.641057414291615,0.358942585708385,away,WSH,over,8,0.5260663507109005,-111,0.5010269332605688,CHC,WSH,2022 REG,11,6,8,3,9,19,1,0,3,-3,1,1,1,0,0,0,0,0,0,0.5010269332605688,0.4989730667394312
87300,0.6666666666666666,0.3717472118959108,-200,169,0.641057414291615,0.358942585708385,home,CHC,under,8,0.5215311004784688,-109,0.4989730667394312,CHC,WSH,2022 REG,11,6,8,3,9,19,1,0,3,-3,1,1,1,0,0,0,0,0,0,0.5010269332605688,0.4989730667394312
87301,0.4098360655737705,0.6363636363636364,144,-175,0.3909017615010627,0.6090982384989373,away,TB,over,8,0.5305164319248826,-113,0.5066009958897986,BAL,TB,2022 REG,10,6,14,7,13,24,0,1,-1,1,1,1,1,1,1,1,0,0,0,0.5066009958897986,0.49339900411020143
87301,0.4098360655737705,0.6363636363636364,144,-175,0.3909017615010627,0.6090982384989373,home,BAL,under,8,0.5145631067961165,-106,0.49339900411020143,BAL,TB,2022 REG,10,6,14,7,13,24,0,1,-1,1,1,1,1,1,1,1,0,0,0,0.5066009958897986,0.49339900411020143
87302,0.5967741935483871,0.4444444444444444,-148,125,0.5721759741010521,0.42782402589894786,away,SD,over,7,0.5073891625615764,-103,0.4859403596076043,SF,SD,2022 REG,6,1,6,2,3,12,0,1,-1,1,1,0,0,0,0,0,0,0,0,0.4859403596076043,0.5140596403923957
87302,0.5967741935483871,0.4444444444444444,-148,125,0.5721759741010521,0.42782402589894786,home,SF,under,7,0.5348837209302326,-115,0.5140596403923957,SF,SD,2022 REG,6,1,6,2,3,12,0,1,-1,1,1,0,0,0,0,0,0,0,0,0.4859403596076043,0.5140596403923957
87303,0.6031746031746031,0.4366812227074236,-152,129,0.5791345812140156,0.4208654187859844,away,CLE,over,7,0.5454545454545454,-120,0.5206611570247933,TOR,CLE,2022 REG,8,2,13,7,9,21,0,1,-5,5,1,1,0,0,0,0,0,0,0,0.5206611570247933,0.4793388429752067
87303,0.6031746031746031,0.4366812227074236,-152,129,0.5791345812140156,0.4208654187859844,home,TOR,under,7,0.5,100,0.4793388429752067,TOR,CLE,2022 REG,8,2,13,7,9,21,0,1,-5,5,1,1,0,0,0,0,0,0,0,0.5206611570247933,0.4793388429752067
87304,0.6610169491525424,0.37735849056603776,-195,165,0.6356501330673793,0.3643498669326207,away,CIN,over,8.5,0.5169082125603864,-107,0.49353874091423283,SD,CIN,2022 REG,6,6,5,0,6,11,1,0,6,-6,0,0,0,0,0,0,0,0,0,0.49353874091423283,0.5064612590857671
87304,0.6610169491525424,0.37735849056603776,-195,165,0.6356501330673793,0.3643498669326207,home,SD,under,8.5,0.5283018867924528,-112,0.5064612590857671,SD,CIN,2022 REG,6,6,5,0,6,11,1,0,6,-6,0,0,0,0,0,0,0,0,0,0.49353874091423283,0.5064612590857671
87305,0.43103448275862066,0.607843137254902,132,-155,0.4142768879252058,0.5857231120747942,away,BOS,over,7,0.5495495495495495,-122,0.5223196169142115,OAK,BOS,2022 REG,6,2,10,7,9,16,0,1,-5,5,1,1,0,0,0,0,0,0,0,0.5223196169142115,0.47768038308578853
87305,0.43103448275862066,0.607843137254902,132,-155,0.4142768879252058,0.5857231120747942,home,OAK,under,7,0.5,100,0.47768038308578853,OAK,BOS,2022 REG,6,2,10,7,9,16,0,1,-5,5,1,1,0,0,0,0,0,0,0,0.5223196169142115,0.47768038308578853
87306,0.5495495495495495,0.4854368932038835,-122,106,0.5303227656940593,0.46967723430594066,away,SEA,over,8.5,0.5454545454545454,-120,0.5206611570247933,TEX,SEA,2022 REG,5,3,4,2,5,9,1,0,1,-1,1,1,0,0,0,0,0,0,0,0.5206611570247933,0.4793388429752067
87306,0.5495495495495495,0.4854368932038835,-122,106,0.5303227656940593,0.46967723430594066,home,TEX,under,8.5,0.5,100,0.4793388429752067,TEX,SEA,2022 REG,5,3,4,2,5,9,1,0,1,-1,1,1,0,0,0,0,0,0,0,0.5206611570247933,0.4793388429752067
87307,0.5098039215686274,0.5283018867924528,-104,-112,0.4903774310316062,0.5096225689683938,away,BOS,over,9,0.5454545454545454,-120,0.5206611570247933,CLE,BOS,2022 REG,8,3,15,8,11,23,0,1,-5,5,1,1,1,0,0,0,0,0,0,0.5206611570247933,0.4793388429752067
87307,0.5098039215686274,0.5283018867924528,-104,-112,0.4903774310316062,0.5096225689683938,home,CLE,under,9,0.5,100,0.4793388429752067,CLE,BOS,2022 REG,8,3,15,8,11,23,0,1,-5,5,1,1,1,0,0,0,0,0,0,0.5206611570247933,0.4793388429752067
87308,0.5,0.5370370370370371,100,-116,0.4814814814814814,0.5185185185185186,away,STL,over,8,0.5169082125603864,-107,0.49353874091423283,MIA,STL,2022 REG,8,1,8,5,6,16,0,1,-4,4,1,0,0,0,0,0,0,0,0,0.49353874091423283,0.5064612590857671
87308,0.5,0.5370370370370371,100,-116,0.4814814814814814,0.5185185185185186,home,MIA,under,8,0.5283018867924528,-112,0.5064612590857671,MIA,STL,2022 REG,8,1,8,5,6,16,0,1,-4,4,1,0,0,0,0,0,0,0,0,0.49353874091423283,0.5064612590857671
87309,0.6000000000000001,0.4366812227074236,-150,129,0.5779912663755458,0.42200873362445424,away,SF,over,7.5,0.5,100,0.4772727272727273,SD,SF,2022 REG,14,6,4,2,8,18,1,0,4,-4,1,1,0,0,0,0,0,0,0,0.4772727272727273,0.5227272727272727
87309,0.6000000000000001,0.4366812227074236,-150,129,0.5779912663755458,0.42200873362445424,home,SD,under,7.5,0.5454545454545454,-120,0.5227272727272727,SD,SF,2022 REG,14,6,4,2,8,18,1,0,4,-4,1,1,0,0,0,0,0,0,0,0.4772727272727273,0.5227272727272727
87310,0.5145631067961165,0.5215311004784688,-106,-109,0.4959903593635629,0.5040096406364372,away,SD,over,8.5,0.5121951219512195,-105,0.48919479393107135,CIN,SD,2022 REG,8,5,11,7,12,19,0,1,-2,2,1,1,1,1,1,0,0,0,0,0.48919479393107135,0.5108052060689287
87310,0.5145631067961165,0.5215311004784688,-106,-109,0.4959903593635629,0.5040096406364372,home,CIN,under,8.5,0.5327102803738317,-114,0.5108052060689287,CIN,SD,2022 REG,8,5,11,7,12,19,0,1,-2,2,1,1,1,1,1,0,0,0,0,0.48919479393107135,0.5108052060689287
87311,0.6183206106870228,0.4184100418410042,-162,139,0.5956092911849603,0.4043907088150397,away,KC,over,9,0.5,100,0.4772727272727273,MIN,KC,2022 REG,11,3,11,7,10,22,0,1,-4,4,1,1,1,0,0,0,0,0,0,0.4772727272727273,0.5227272727272727
87311,0.6183206106870228,0.4184100418410042,-162,139,0.5956092911849603,0.4043907088150397,home,MIN,under,9,0.5454545454545454,-120,0.5227272727272727,MIN,KC,2022 REG,11,3,11,7,10,22,0,1,-4,4,1,1,1,0,0,0,0,0,0,0.4772727272727273,0.5227272727272727
87312,0.23809523809523808,0.8134328358208955,320,-436,0.2258266490675872,0.7741733509324128,away,SF,over,7.5,0.5348837209302326,-115,0.5097020142727117,OAK,SF,2022 REG,9,4,9,6,10,18,0,1,-2,2,1,1,1,1,0,0,0,0,0,0.5097020142727117,0.49029798572728833
87312,0.23809523809523808,0.8134328358208955,320,-436,0.2258266490675872,0.7741733509324128,home,OAK,under,7.5,0.5121951219512195,-105,0.49029798572728833,OAK,SF,2022 REG,9,4,9,6,10,18,0,1,-2,2,1,1,1,1,0,0,0,0,0,0.5097020142727117,0.49029798572728833
87313,0.613899613899614,0.4273504273504274,-159,134,0.5885762295028705,0.4114237704971295,away,TOR,over,7.5,0.5,100,0.4772727272727273,NYY,TOR,2022 REG,5,6,7,5,11,12,1,0,1,-1,1,1,1,1,1,0,0,0,0,0.4772727272727273,0.5227272727272727
87313,0.613899613899614,0.4273504273504274,-159,134,0.5885762295028705,0.4114237704971295,home,NYY,under,7.5,0.5454545454545454,-120,0.5227272727272727,NYY,TOR,2022 REG,5,6,7,5,11,12,1,0,1,-1,1,1,1,1,1,0,0,0,0,0.4772727272727273,0.5227272727272727
87314,0.37037037037037035,0.6632996632996633,170,-197,0.3578999875296171,0.6421000124703828,away,NYY,over,8.5,0.5145631067961165,-106,0.4913668392989033,BAL,NYY,2022 REG,9,5,4,0,5,13,1,0,5,-5,0,0,0,0,0,0,0,0,0,0.4913668392989033,0.5086331607010968
87314,0.37037037037037035,0.6632996632996633,170,-197,0.3578999875296171,0.6421000124703828,home,BAL,under,8.5,0.5305164319248826,-113,0.5086331607010968,BAL,NYY,2022 REG,9,5,4,0,5,13,1,0,5,-5,0,0,0,0,0,0,0,0,0,0.4913668392989033,0.5086331607010968
87315,0.7311827956989247,0.3105590062111801,-272,222,0.7006619082807836,0.29933809171921644,away,OAK,over,7,0.5238095238095238,-110,0.5000596729920038,SEA,OAK,2022 REG,5,3,12,10,13,17,0,1,-7,7,1,1,1,0,0,0,0,0,0,0.5000596729920038,0.4999403270079962
87315,0.7311827956989247,0.3105590062111801,-272,222,0.7006619082807836,0.29933809171921644,home,SEA,under,7,0.5215311004784688,-109,0.4999403270079962,SEA,OAK,2022 REG,5,3,12,10,13,17,0,1,-7,7,1,1,1,0,0,0,0,0,0,0.5000596729920038,0.4999403270079962
87316,0.6336996336996338,0.4081632653061224,-173,145,0.6071711299340814,0.3928288700659186,away,WSH,over,8.5,0.5327102803738317,-114,0.5075272610403079,LAA,WSH,2022 REG,7,3,10,7,10,17,0,1,-4,4,1,1,1,0,0,0,0,0,0,0.5075272610403079,0.4924727389596921
87316,0.6336996336996338,0.4081632653061224,-173,145,0.6071711299340814,0.3928288700659186,home,LAA,under,8.5,0.5145631067961165,-106,0.4924727389596921,LAA,WSH,2022 REG,7,3,10,7,10,17,0,1,-4,4,1,1,1,0,0,0,0,0,0,0.5075272610403079,0.4924727389596921
87317,0.609375,0.43103448275862066,-156,132,0.5847504714439656,0.41524952855603436,away,WSH,over,9,0.5121951219512195,-105,0.48808156828023186,BAL,WSH,2022 REG,11,7,3,0,7,14,1,0,7,-7,0,0,0,0,0,0,0,0,0,0.48808156828023186,0.5119184317197681
87317,0.609375,0.43103448275862066,-156,132,0.5847504714439656,0.41524952855603436,home,BAL,under,9,0.5348837209302326,-115,0.5119184317197681,BAL,WSH,2022 REG,11,7,3,0,7,14,1,0,7,-7,0,0,0,0,0,0,0,0,0,0.48808156828023186,0.5119184317197681
87318,0.6254681647940076,0.4065040650406504,-167,146,0.6054705528749518,0.3945294471250482,away,ARI,over,8,0.5121951219512195,-105,0.48808156828023186,NYM,ARI,2022 REG,5,2,9,3,5,14,0,1,-1,1,1,1,0,0,0,0,0,0,0,0.48808156828023186,0.5119184317197681
87318,0.6254681647940076,0.4065040650406504,-167,146,0.6054705528749518,0.3945294471250482,home,NYM,under,8,0.5348837209302326,-115,0.5119184317197681,NYM,ARI,2022 REG,5,2,9,3,5,14,0,1,-1,1,1,1,0,0,0,0,0,0,0,0.48808156828023186,0.5119184317197681
87319,0.26881720430107525,0.7752808988764045,272,-345,0.25696287548992475,0.7430371245100753,away,SD,over,9,0.5073891625615764,-103,0.4837652908580103,WSH,SD,2022 REG,10,4,8,3,7,18,1,0,1,-1,1,1,1,0,0,0,0,0,0,0.4837652908580103,0.5162347091419897
87319,0.26881720430107525,0.7752808988764045,272,-345,0.25696287548992475,0.7430371245100753,home,WSH,under,9,0.5391705069124424,-117,0.5162347091419897,WSH,SD,2022 REG,10,4,8,3,7,18,1,0,1,-1,1,1,1,0,0,0,0,0,0,0.4837652908580103,0.5162347091419897
87320,0.6875,0.35714285714285715,-220,180,0.6568080357142857,0.3431919642857143,away,MIA,over,7,0.5192307692307692,-108,0.49571111079951763,NYM,MIA,2022 REG,7,4,11,6,10,18,0,1,-2,2,1,1,1,1,0,0,0,0,0,0.49571111079951763,0.5042888892004824
87320,0.6875,0.35714285714285715,-220,180,0.6568080357142857,0.3431919642857143,home,NYM,under,7,0.5260663507109005,-111,0.5042888892004824,NYM,MIA,2022 REG,7,4,11,6,10,18,0,1,-2,2,1,1,1,1,0,0,0,0,0,0.49571111079951763,0.5042888892004824
87321,0.613899613899614,0.42372881355932196,-159,136,0.5907995368109236,0.40920046318907644,away,PIT,over,11,0.5145631067961165,-106,0.4913668392989033,COL,PIT,2022 REG,17,13,6,2,15,23,1,0,11,-11,1,1,0,0,0,0,0,0,0,0.4913668392989033,0.5086331607010968
87321,0.613899613899614,0.42372881355932196,-159,136,0.5907995368109236,0.40920046318907644,home,COL,under,11,0.5305164319248826,-113,0.5086331607010968,COL,PIT,2022 REG,17,13,6,2,15,23,1,0,11,-11,1,1,0,0,0,0,0,0,0,0.4913668392989033,0.5086331607010968
87322,0.45248868778280543,0.5901639344262295,121,-144,0.4331888587289435,0.5668111412710565,away,TEX,over,7,0.5391705069124424,-117,0.5140669063204599,OAK,TEX,2022 REG,12,8,16,11,19,28,0,1,-3,3,1,1,1,1,1,1,1,1,0,0.5140669063204599,0.4859330936795401
87322,0.45248868778280543,0.5901639344262295,121,-144,0.4331888587289435,0.5668111412710565,home,OAK,under,7,0.5073891625615764,-103,0.4859330936795401,OAK,TEX,2022 REG,12,8,16,11,19,28,0,1,-3,3,1,1,1,1,1,1,1,1,0,0.5140669063204599,0.4859330936795401
87323,0.7340425531914894,0.303951367781155,-276,229,0.7061533984349738,0.2938466015650262,away,PIT,over,7.5,0.5121951219512195,-105,0.48808156828023186,MIL,PIT,2022 REG,9,3,5,4,7,14,0,1,-1,1,1,1,1,0,0,0,0,0,0,0.48808156828023186,0.5119184317197681
87323,0.7340425531914894,0.303951367781155,-276,229,0.7061533984349738,0.2938466015650262,home,MIL,under,7.5,0.5348837209302326,-115,0.5119184317197681,MIL,PIT,2022 REG,9,3,5,4,7,14,0,1,-1,1,1,1,1,0,0,0,0,0,0,0.48808156828023186,0.5119184317197681
87324,0.6183206106870228,0.4166666666666667,-162,140,0.5966872559874133,0.40331274401258665,away,LAD,over,6.5,0.5454545454545454,-120,0.5206611570247933,NYM,LAD,2022 REG,8,2,3,1,3,11,1,0,1,-1,1,0,0,0,0,0,0,0,0,0.5206611570247933,0.4793388429752067
87324,0.6183206106870228,0.4166666666666667,-162,140,0.5966872559874133,0.40331274401258665,home,NYM,under,6.5,0.5,100,0.4793388429752067,NYM,LAD,2022 REG,8,2,3,1,3,11,1,0,1,-1,1,0,0,0,0,0,0,0,0,0.5206611570247933,0.4793388429752067
87325,0.5348837209302326,0.5098039215686274,-115,-104,0.5109810284308424,0.48901897156915763,away,SD,over,7,0.5391705069124424,-117,0.5153817639191344,ARI,SD,2022 REG,5,0,5,2,2,10,0,1,-2,2,0,0,0,0,0,0,0,0,0,0.5153817639191344,0.4846182360808656
87325,0.5348837209302326,0.5098039215686274,-115,-104,0.5109810284308424,0.48901897156915763,home,ARI,under,7,0.504950495049505,-102,0.4846182360808656,ARI,SD,2022 REG,5,0,5,2,2,10,0,1,-2,2,0,0,0,0,0,0,0,0,0,0.5153817639191344,0.4846182360808656
87326,0.5594713656387665,0.47619047619047616,-127,110,0.5395195862893665,0.46048041371063353,away,HOU,over,8.5,0.5145631067961165,-106,0.4913668392989033,ATL,HOU,2022 REG,12,6,7,2,8,19,1,0,4,-4,1,1,0,0,0,0,0,0,0,0.4913668392989033,0.5086331607010968
87326,0.5594713656387665,0.47619047619047616,-127,110,0.5395195862893665,0.46048041371063353,home,ATL,under,8.5,0.5305164319248826,-113,0.5086331607010968,ATL,HOU,2022 REG,12,6,7,2,8,19,1,0,4,-4,1,1,0,0,0,0,0,0,0,0.4913668392989033,0.5086331607010968
87327,0.6453900709219857,0.3921568627450981,-182,155,0.6211576527396834,0.3788423472603166,away,SF,over,9,0.5305164319248826,-113,0.5066009958897986,ATL,SF,2022 REG,12,10,14,12,22,26,0,1,-2,2,1,1,1,1,1,1,1,1,1,0.5066009958897986,0.49339900411020143
87327,0.6453900709219857,0.3921568627450981,-182,155,0.6211576527396834,0.3788423472603166,home,ATL,under,9,0.5145631067961165,-106,0.49339900411020143,ATL,SF,2022 REG,12,10,14,12,22,26,0,1,-2,2,1,1,1,1,1,1,1,1,1,0.5066009958897986,0.49339900411020143
87328,0.5348837209302326,0.5098039215686274,-115,-104,0.5109810284308424,0.48901897156915763,away,HOU,over,7,0.49019607843137253,104,0.46776880686915284,LAA,HOU,2022 REG,12,7,4,1,8,16,1,0,6,-6,1,0,0,0,0,0,0,0,0,0.46776880686915284,0.5322311931308472
87328,0.5348837209302326,0.5098039215686274,-115,-104,0.5109810284308424,0.48901897156915763,home,LAA,under,7,0.5555555555555556,-125,0.5322311931308472,LAA,HOU,2022 REG,12,7,4,1,8,16,1,0,6,-6,1,0,0,0,0,0,0,0,0,0.46776880686915284,0.5322311931308472
87329,0.6197718631178707,0.42016806722689076,-163,138,0.5950182180753,0.4049817819247,away,OAK,over,8,0.5348837209302326,-115,0.5097020142727117,CLE,OAK,2022 REG,7,3,5,2,5,12,1,0,1,-1,1,1,0,0,0,0,0,0,0,0.5097020142727117,0.49029798572728833
87329,0.6197718631178707,0.42016806722689076,-163,138,0.5950182180753,0.4049817819247,home,CLE,under,8,0.5121951219512195,-105,0.49029798572728833,CLE,OAK,2022 REG,7,3,5,2,5,12,1,0,1,-1,1,1,0,0,0,0,0,0,0,0.5097020142727117,0.49029798572728833
87330,0.425531914893617,0.6108949416342413,135,-157,0.41003112488176247,0.5899688751182375,away,PHI,over,7.5,0.5238095238095238,-110,0.4988662131519274,PIT,PHI,2022 REG,4,1,6,2,3,10,0,1,-1,1,1,0,0,0,0,0,0,0,0,0.4988662131519274,0.5011337868480725
87330,0.425531914893617,0.6108949416342413,135,-157,0.41003112488176247,0.5899688751182375,home,PIT,under,7.5,0.5238095238095238,-110,0.5011337868480725,PIT,PHI,2022 REG,4,1,6,2,3,10,0,1,-1,1,1,0,0,0,0,0,0,0,0,0.4988662131519274,0.5011337868480725
87331,0.5918367346938775,0.4464285714285714,-145,124,0.5691899208663057,0.4308100791336943,away,NYM,over,8.5,0.5238095238095238,-110,0.4988662131519274,PHI,NYM,2022 REG,6,0,3,2,2,9,0,1,-2,2,0,0,0,0,0,0,0,0,0,0.4988662131519274,0.5011337868480725
87331,0.5918367346938775,0.4464285714285714,-145,124,0.5691899208663057,0.4308100791336943,home,PHI,under,8.5,0.5238095238095238,-110,0.5011337868480725,PHI,NYM,2022 REG,6,0,3,2,2,9,0,1,-2,2,0,0,0,0,0,0,0,0,0,0.4988662131519274,0.5011337868480725
87332,0.46511627906976744,0.574468085106383,115,-135,0.44670494689481377,0.5532950531051862,away,NYY,over,6.5,0.5454545454545454,-120,0.5153135634419057,SEA,NYY,2022 REG,7,1,3,0,1,10,1,0,1,-1,0,0,0,0,0,0,0,0,0,0.5153135634419057,0.4846864365580943
87332,0.46511627906976744,0.574468085106383,115,-135,0.44670494689481377,0.5532950531051862,home,SEA,under,6.5,0.5098039215686274,-104,0.4846864365580943,SEA,NYY,2022 REG,7,1,3,0,1,10,1,0,1,-1,0,0,0,0,0,0,0,0,0,0.5153135634419057,0.4846864365580943
87333,0.4444444444444444,0.5983935742971888,125,-149,0.4254053250037185,0.5745946749962815,away,TB,over,8.5,0.5305164319248826,-113,0.5066009958897986,MIN,TB,2022 REG,11,6,13,5,11,24,1,0,1,-1,1,1,1,1,1,0,0,0,0,0.5066009958897986,0.49339900411020143
87333,0.4444444444444444,0.5983935742971888,125,-149,0.4254053250037185,0.5745946749962815,home,MIN,under,8.5,0.5145631067961165,-106,0.49339900411020143,MIN,TB,2022 REG,11,6,13,5,11,24,1,0,1,-1,1,1,1,1,1,0,0,0,0,0.5066009958897986,0.49339900411020143
87334,0.5121951219512195,0.5327102803738317,-105,-114,0.48919479393107135,0.5108052060689287,away,BAL,over,9.5,0.5121951219512195,-105,0.48808156828023186,KC,BAL,2022 REG,12,8,4,1,9,16,1,0,7,-7,1,0,0,0,0,0,0,0,0,0.48808156828023186,0.5119184317197681
87334,0.5121951219512195,0.5327102803738317,-105,-114,0.48919479393107135,0.5108052060689287,home,KC,under,9.5,0.5348837209302326,-115,0.5119184317197681,KC,BAL,2022 REG,12,8,4,1,9,16,1,0,7,-7,1,0,0,0,0,0,0,0,0,0.48808156828023186,0.5119184317197681
87335,0.5833333333333333,0.4587155963302753,-140,118,0.5588047910295616,0.4411952089704384,away,MIA,over,9.5,0.5283018867924528,-112,0.5044173060022736,CHC,MIA,2022 REG,2,0,8,3,3,10,0,1,-3,3,0,0,0,0,0,0,0,0,0,0.5044173060022736,0.49558269399772636
87335,0.5833333333333333,0.4587155963302753,-140,118,0.5588047910295616,0.4411952089704384,home,CHC,under,9.5,0.5169082125603864,-107,0.49558269399772636,CHC,MIA,2022 REG,2,0,8,3,3,10,0,1,-3,3,0,0,0,0,0,0,0,0,0,0.5044173060022736,0.49558269399772636
87336,0.40322580645161293,0.626865671641791,148,-168,0.3910921459300791,0.6089078540699209,away,MIN,over,7,0.5192307692307692,-108,0.49688292476754015,BAL,MIN,2022 REG,7,2,10,7,9,17,0,1,-5,5,1,1,0,0,0,0,0,0,0,0.49688292476754015,0.5031170752324599
87336,0.40322580645161293,0.626865671641791,148,-168,0.3910921459300791,0.6089078540699209,home,BAL,under,7,0.5238095238095238,-110,0.5031170752324599,BAL,MIN,2022 REG,7,2,10,7,9,17,0,1,-5,5,1,1,0,0,0,0,0,0,0,0.49688292476754015,0.5031170752324599
87337,0.6503496503496503,0.3846153846153846,-186,160,0.6276101520856765,0.3723898479143235,away,CLE,over,7.5,0.5,100,0.4783105022831051,CWS,CLE,2022 REG,9,4,7,1,5,16,1,0,3,-3,1,0,0,0,0,0,0,0,0,0.4783105022831051,0.5216894977168949
87337,0.6503496503496503,0.3846153846153846,-186,160,0.6276101520856765,0.3723898479143235,home,CWS,under,7.5,0.5433789954337899,-119,0.5216894977168949,CWS,CLE,2022 REG,9,4,7,1,5,16,1,0,3,-3,1,0,0,0,0,0,0,0,0,0.4783105022831051,0.5216894977168949
87338,0.39525691699604737,0.6491228070175439,153,-185,0.37771552410529985,0.6222844758947002,away,LAD,over,8.5,0.5348837209302326,-115,0.5097020142727117,PIT,LAD,2022 REG,8,5,5,3,8,13,1,0,2,-2,1,1,1,0,0,0,0,0,0,0.5097020142727117,0.49029798572728833
87338,0.39525691699604737,0.6491228070175439,153,-185,0.37771552410529985,0.6222844758947002,home,PIT,under,8.5,0.5121951219512195,-105,0.49029798572728833,PIT,LAD,2022 REG,8,5,5,3,8,13,1,0,2,-2,1,1,1,0,0,0,0,0,0,0.5097020142727117,0.49029798572728833
87339,0.5815899581589958,0.45454545454545453,-139,120,0.5605739649961564,0.4394260350038436,away,TB,over,7,0.5454545454545454,-120,0.5206611570247933,TOR,TB,2022 REG,5,2,13,6,8,18,0,1,-4,4,1,1,0,0,0,0,0,0,0,0.5206611570247933,0.4793388429752067
87339,0.5815899581589958,0.45454545454545453,-139,120,0.5605739649961564,0.4394260350038436,home,TOR,under,7,0.5,100,0.4793388429752067,TOR,TB,2022 REG,5,2,13,6,8,18,0,1,-4,4,1,1,0,0,0,0,0,0,0,0.5206611570247933,0.4793388429752067
87340,0.6845425867507886,0.36101083032490977,-217,177,0.6533593327904526,0.34664066720954745,away,OAK,over,9.5,0.5024875621890548,-101,0.48049269377245407,PHI,OAK,2022 REG,3,1,9,4,5,12,0,1,-3,3,1,0,0,0,0,0,0,0,0,0.48049269377245407,0.5195073062275459
87340,0.6845425867507886,0.36101083032490977,-217,177,0.6533593327904526,0.34664066720954745,home,PHI,under,9.5,0.5412844036697247,-118,0.5195073062275459,PHI,OAK,2022 REG,3,1,9,4,5,12,0,1,-3,3,1,0,0,0,0,0,0,0,0,0.48049269377245407,0.5195073062275459
87341,0.5,0.5454545454545454,100,-120,0.4772727272727273,0.5227272727272727,away,TOR,over,8.5,0.5121951219512195,-105,0.48808156828023186,HOU,TOR,2022 REG,8,2,8,3,5,16,0,1,-1,1,1,1,0,0,0,0,0,0,0,0.48808156828023186,0.5119184317197681
87341,0.5,0.5454545454545454,100,-120,0.4772727272727273,0.5227272727272727,home,HOU,under,8.5,0.5348837209302326,-115,0.5119184317197681,HOU,TOR,2022 REG,8,2,8,3,5,16,0,1,-1,1,1,1,0,0,0,0,0,0,0,0.48808156828023186,0.5119184317197681
87342,0.5098039215686274,0.5327102803738317,-104,-114,0.4881300146960012,0.5118699853039987,away,MIA,over,8.5,0.5348837209302326,-115,0.5122726437136835,CIN,MIA,2022 REG,2,1,11,2,3,13,0,1,-1,1,1,0,0,0,0,0,0,0,0,0.5122726437136835,0.48772735628631647
87342,0.5098039215686274,0.5327102803738317,-104,-114,0.4881300146960012,0.5118699853039987,home,CIN,under,8.5,0.5073891625615764,-103,0.48772735628631647,CIN,MIA,2022 REG,2,1,11,2,3,13,0,1,-1,1,1,0,0,0,0,0,0,0,0,0.5122726437136835,0.48772735628631647
87343,0.6610169491525424,0.3717472118959108,-195,169,0.6393592833747512,0.36064071662524877,away,BOS,over,6.5,0.5391705069124424,-117,0.5153817639191344,TB,BOS,2022 REG,5,4,5,1,5,10,1,0,3,-3,1,0,0,0,0,0,0,0,0,0.5153817639191344,0.4846182360808656
87343,0.6610169491525424,0.3717472118959108,-195,169,0.6393592833747512,0.36064071662524877,home,TB,under,6.5,0.504950495049505,-102,0.4846182360808656,TB,BOS,2022 REG,5,4,5,1,5,10,1,0,3,-3,1,0,0,0,0,0,0,0,0,0.5153817639191344,0.4846182360808656
87344,0.5454545454545454,0.49751243781094534,-120,101,0.5220180091279142,0.4779819908720858,away,BAL,over,10,0.5283018867924528,-112,0.5044173060022736,BOS,BAL,2022 REG,8,4,8,3,7,16,1,0,1,-1,1,1,1,0,0,0,0,0,0,0.5044173060022736,0.49558269399772636
87344,0.5454545454545454,0.49751243781094534,-120,101,0.5220180091279142,0.4779819908720858,home,BOS,under,10,0.5169082125603864,-107,0.49558269399772636,BOS,BAL,2022 REG,8,4,8,3,7,16,1,0,1,-1,1,1,1,0,0,0,0,0,0,0.5044173060022736,0.49558269399772636
87345,0.635036496350365,0.40322580645161293,-174,148,0.6107385376367002,0.38926146236329984,away,STL,over,8,0.5121951219512195,-105,0.48919479393107135,MIL,STL,2022 REG,6,2,3,0,2,9,1,0,2,-2,0,0,0,0,0,0,0,0,0,0.48919479393107135,0.5108052060689287
87345,0.635036496350365,0.40322580645161293,-174,148,0.6107385376367002,0.38926146236329984,home,MIL,under,8,0.5327102803738317,-114,0.5108052060689287,MIL,STL,2022 REG,6,2,3,0,2,9,1,0,2,-2,0,0,0,0,0,0,0,0,0,0.48919479393107135,0.5108052060689287
87346,0.6742671009771988,0.36363636363636365,-207,175,0.6487100417752203,0.3512899582247797,away,PIT,over,8,0.5260663507109005,-111,0.5022370601254724,STL,PIT,2022 REG,7,4,15,9,13,22,0,1,-5,5,1,1,1,1,0,0,0,0,0,0.5022370601254724,0.4977629398745276
87346,0.6742671009771988,0.36363636363636365,-207,175,0.6487100417752203,0.3512899582247797,home,STL,under,8,0.5192307692307692,-108,0.4977629398745276,STL,PIT,2022 REG,7,4,15,9,13,22,0,1,-5,5,1,1,1,1,0,0,0,0,0,0.5022370601254724,0.4977629398745276
87347,0.7032640949554896,0.3367003367003367,-237,197,0.6751585450966444,0.3248414549033556,away,WSH,over,9.5,0.5121951219512195,-105,0.48919479393107135,ATL,WSH,2022 REG,4,2,15,11,13,19,0,1,-9,9,1,1,0,0,0,0,0,0,0,0.48919479393107135,0.5108052060689287
87347,0.7032640949554896,0.3367003367003367,-237,197,0.6751585450966444,0.3248414549033556,home,ATL,under,9.5,0.5327102803738317,-114,0.5108052060689287,ATL,WSH,2022 REG,4,2,15,11,13,19,0,1,-9,9,1,1,0,0,0,0,0,0,0,0.48919479393107135,0.5108052060689287
87348,0.47619047619047616,0.5614035087719298,110,-128,0.4582885785893304,0.5417114214106695,away,BOS,over,9,0.5024875621890548,-101,0.4794401874631478,BAL,BOS,2022 REG,8,3,12,4,7,20,0,1,-1,1,1,1,1,0,0,0,0,0,0,0.4794401874631478,0.5205598125368522
87348,0.47619047619047616,0.5614035087719298,110,-128,0.4582885785893304,0.5417114214106695,home,BAL,under,9,0.5433789954337899,-119,0.5205598125368522,BAL,BOS,2022 REG,8,3,12,4,7,20,0,1,-1,1,1,1,1,0,0,0,0,0,0,0.4794401874631478,0.5205598125368522
87349,0.6254681647940076,0.4098360655737705,-167,144,0.6033864926164085,0.39661350738359147,away,STL,over,7.5,0.5192307692307692,-108,0.49455035168025013,LAD,STL,2022 REG,9,6,7,2,8,16,1,0,4,-4,1,1,0,0,0,0,0,0,0,0.49455035168025013,0.5054496483197499
87349,0.6254681647940076,0.4098360655737705,-167,144,0.6033864926164085,0.39661350738359147,home,LAD,under,7.5,0.5283018867924528,-112,0.5054496483197499,LAD,STL,2022 REG,9,6,7,2,8,16,1,0,4,-4,1,1,0,0,0,0,0,0,0,0.49455035168025013,0.5054496483197499
87350,0.7118155619596541,0.3333333333333333,-247,200,0.6796778756848186,0.32032212431518137,away,CIN,over,8.5,0.5098039215686274,-104,0.48375889301574193,TOR,CIN,2022 REG,4,2,6,3,5,10,0,1,-1,1,1,1,0,0,0,0,0,0,0,0.48375889301574193,0.5162411069842581
87350,0.7118155619596541,0.3333333333333333,-247,200,0.6796778756848186,0.32032212431518137,home,TOR,under,8.5,0.5412844036697247,-118,0.5162411069842581,TOR,CIN,2022 REG,4,2,6,3,5,10,0,1,-1,1,1,1,0,0,0,0,0,0,0,0.48375889301574193,0.5162411069842581
87351,0.43103448275862066,0.607843137254902,132,-155,0.4142768879252058,0.5857231120747942,away,SD,over,7.5,0.5391705069124424,-117,0.5127649394825569,SF,SD,2022 REG,6,4,9,5,9,15,0,1,-1,1,1,1,1,1,0,0,0,0,0,0.5127649394825569,0.48723506051744314
87351,0.43103448275862066,0.607843137254902,132,-155,0.4142768879252058,0.5857231120747942,home,SF,under,7.5,0.5098039215686274,-104,0.48723506051744314,SF,SD,2022 REG,6,4,9,5,9,15,0,1,-1,1,1,1,1,1,0,0,0,0,0,0.5127649394825569,0.48723506051744314
87352,0.6336996336996338,0.4081632653061224,-173,145,0.6071711299340814,0.3928288700659186,away,STL,over,8,0.5215311004784688,-109,0.4978845547971712,PHI,STL,2022 REG,9,4,4,0,4,13,1,0,4,-4,0,0,0,0,0,0,0,0,0,0.4978845547971712,0.5021154452028288
87352,0.6336996336996338,0.4081632653061224,-173,145,0.6071711299340814,0.3928288700659186,home,PHI,under,8,0.5238095238095238,-110,0.5021154452028288,PHI,STL,2022 REG,9,4,4,0,4,13,1,0,4,-4,0,0,0,0,0,0,0,0,0,0.4978845547971712,0.5021154452028288
87353,0.46511627906976744,0.574468085106383,115,-135,0.44670494689481377,0.5532950531051862,away,NYM,over,6.5,0.5348837209302326,-115,0.5097020142727117,ATL,NYM,2022 REG,6,3,6,2,5,12,1,0,1,-1,1,1,0,0,0,0,0,0,0,0.5097020142727117,0.49029798572728833
87353,0.46511627906976744,0.574468085106383,115,-135,0.44670494689481377,0.5532950531051862,home,ATL,under,6.5,0.5121951219512195,-105,0.49029798572728833,ATL,NYM,2022 REG,6,3,6,2,5,12,1,0,1,-1,1,1,0,0,0,0,0,0,0,0.5097020142727117,0.49029798572728833
87354,0.5689655172413793,0.4716981132075471,-132,112,0.5458293137100936,0.4541706862899064,away,KC,over,9,0.5192307692307692,-108,0.49688292476754015,DET,KC,2022 REG,7,4,6,3,7,13,1,0,1,-1,1,1,1,0,0,0,0,0,0,0.49688292476754015,0.5031170752324599
87354,0.5689655172413793,0.4716981132075471,-132,112,0.5458293137100936,0.4541706862899064,home,DET,under,9,0.5238095238095238,-110,0.5031170752324599,DET,KC,2022 REG,7,4,6,3,7,13,1,0,1,-1,1,1,1,0,0,0,0,0,0,0.49688292476754015,0.5031170752324599
87355,0.609375,0.425531914893617,-156,135,0.5881035987367021,0.41189640126329785,away,PIT,over,7.5,0.5348837209302326,-115,0.5097020142727117,CIN,PIT,2022 REG,8,4,12,10,14,20,0,1,-6,6,1,1,1,1,0,0,0,0,0,0.5097020142727117,0.49029798572728833
87355,0.609375,0.425531914893617,-156,135,0.5881035987367021,0.41189640126329785,home,CIN,under,7.5,0.5121951219512195,-105,0.49029798572728833,CIN,PIT,2022 REG,8,4,12,10,14,20,0,1,-6,6,1,1,1,1,0,0,0,0,0,0.5097020142727117,0.49029798572728833
87356,0.5515695067264574,0.48780487804878053,-123,105,0.5298517967383217,0.4701482032616783,away,BAL,over,9,0.5391705069124424,-117,0.5153817639191344,CHC,BAL,2022 REG,7,2,8,4,6,15,0,1,-2,2,1,1,0,0,0,0,0,0,0,0.5153817639191344,0.4846182360808656
87356,0.5515695067264574,0.48780487804878053,-123,105,0.5298517967383217,0.4701482032616783,home,CHC,under,9,0.504950495049505,-102,0.4846182360808656,CHC,BAL,2022 REG,7,2,8,4,6,15,0,1,-2,2,1,1,0,0,0,0,0,0,0,0.5153817639191344,0.4846182360808656
87357,0.5238095238095238,0.5238095238095238,-110,-110,0.4988662131519274,0.5011337868480725,away,SEA,over,6.5,0.5454545454545454,-120,0.5206611570247933,LAA,SEA,2022 REG,8,2,9,6,8,17,0,1,-4,4,1,1,0,0,0,0,0,0,0,0.5206611570247933,0.4793388429752067
87357,0.5238095238095238,0.5238095238095238,-110,-110,0.4988662131519274,0.5011337868480725,home,LAA,under,6.5,0.5,100,0.4793388429752067,LAA,SEA,2022 REG,8,2,9,6,8,17,0,1,-4,4,1,1,0,0,0,0,0,0,0,0.5206611570247933,0.4793388429752067
87358,0.5689655172413793,0.4716981132075471,-132,112,0.5458293137100936,0.4541706862899064,away,SD,over,7.5,0.5327102803738317,-114,0.5100625279371946,LAD,SD,2022 REG,5,3,7,1,4,12,1,0,2,-2,1,0,0,0,0,0,0,0,0,0.5100625279371946,0.48993747206280536
87358,0.5689655172413793,0.4716981132075471,-132,112,0.5458293137100936,0.4541706862899064,home,LAD,under,7.5,0.5098039215686274,-104,0.48993747206280536,LAD,SD,2022 REG,5,3,7,1,4,12,1,0,2,-2,1,0,0,0,0,0,0,0,0,0.5100625279371946,0.48993747206280536
87359,0.3968253968253968,0.6389891696750902,152,-177,0.3826132672617115,0.6173867327382885,away,TOR,over,9,0.5283018867924528,-112,0.5044173060022736,BOS,TOR,2022 REG,15,5,13,6,11,28,0,1,-1,1,1,1,1,1,1,0,0,0,0,0.5044173060022736,0.49558269399772636
87359,0.3968253968253968,0.6389891696750902,152,-177,0.3826132672617115,0.6173867327382885,home,BOS,under,9,0.5169082125603864,-107,0.49558269399772636,BOS,TOR,2022 REG,15,5,13,6,11,28,0,1,-1,1,1,1,1,1,1,0,0,0,0,0.5044173060022736,0.49558269399772636
87360,0.4716981132075471,0.5708154506437768,112,-133,0.4516445453531491,0.548355454646851,away,NYY,over,8,0.5238095238095238,-110,0.4988662131519274,TOR,NYY,2022 REG,4,2,5,1,3,9,1,0,1,-1,1,0,0,0,0,0,0,0,0,0.4988662131519274,0.5011337868480725
87360,0.4716981132075471,0.5708154506437768,112,-133,0.4516445453531491,0.548355454646851,home,TOR,under,8,0.5238095238095238,-110,0.5011337868480725,TOR,NYY,2022 REG,4,2,5,1,3,9,1,0,1,-1,1,0,0,0,0,0,0,0,0,0.4988662131519274,0.5011337868480725
87361,0.5073891625615764,0.5327102803738317,-103,-114,0.487043139791394,0.512956860208606,away,HOU,over,7,0.5215311004784688,-109,0.4978845547971712,SEA,HOU,2022 REG,9,5,12,8,13,21,0,1,-3,3,1,1,1,1,1,0,0,0,0,0.4978845547971712,0.5021154452028288
87361,0.5073891625615764,0.5327102803738317,-103,-114,0.487043139791394,0.512956860208606,home,SEA,under,7,0.5238095238095238,-110,0.5021154452028288,SEA,HOU,2022 REG,9,5,12,8,13,21,0,1,-3,3,1,1,1,1,1,0,0,0,0,0.4978845547971712,0.5021154452028288
87362,0.3484320557491289,0.6923076923076923,187,-225,0.33423702158298907,0.6657629784170109,away,SD,over,10.5,0.5283018867924528,-112,0.5044173060022736,COL,SD,2022 REG,7,3,10,9,12,17,0,1,-6,6,1,1,1,0,0,0,0,0,0,0.5044173060022736,0.49558269399772636
87362,0.3484320557491289,0.6923076923076923,187,-225,0.33423702158298907,0.6657629784170109,home,COL,under,10.5,0.5169082125603864,-107,0.49558269399772636,COL,SD,2022 REG,7,3,10,9,12,17,0,1,-6,6,1,1,1,0,0,0,0,0,0,0.5044173060022736,0.49558269399772636
87363,0.44052863436123346,0.6000000000000001,127,-150,0.42267461041355353,0.5773253895864465,away,LAA,over,7.5,0.5412844036697247,-118,0.5189377998484975,DET,LAA,2022 REG,4,0,3,1,1,7,0,1,-1,1,0,0,0,0,0,0,0,0,0,0.5189377998484975,0.4810622001515025
87363,0.44052863436123346,0.6000000000000001,127,-150,0.42267461041355353,0.5773253895864465,home,DET,under,7.5,0.5,100,0.4810622001515025,DET,LAA,2022 REG,4,0,3,1,1,7,0,1,-1,1,0,0,0,0,0,0,0,0,0,0.5189377998484975,0.4810622001515025
87364,0.5495495495495495,0.48780487804878053,-122,105,0.529021440689206,0.470978559310794,away,CWS,over,8,0.5283018867924528,-112,0.5056562298022652,CLE,CWS,2022 REG,11,11,5,1,12,16,1,0,10,-10,1,0,0,0,0,0,0,0,0,0.5056562298022652,0.4943437701977348
87364,0.5495495495495495,0.48780487804878053,-122,105,0.529021440689206,0.470978559310794,home,CLE,under,8,0.5145631067961165,-106,0.4943437701977348,CLE,CWS,2022 REG,11,11,5,1,12,16,1,0,10,-10,1,0,0,0,0,0,0,0,0,0.5056562298022652,0.4943437701977348
87365,0.5475113122171946,0.49019607843137253,-121,104,0.5268660892829112,0.47313391071708877,away,CIN,over,9.5,0.49504950495049505,102,0.4739797934813417,CHC,CIN,2022 REG,10,3,12,5,8,22,0,1,-2,2,1,1,1,0,0,0,0,0,0,0.4739797934813417,0.5260202065186583
87365,0.5475113122171946,0.49019607843137253,-121,104,0.5268660892829112,0.47313391071708877,home,CHC,under,9.5,0.5475113122171946,-121,0.5260202065186583,CHC,CIN,2022 REG,10,3,12,5,8,22,0,1,-2,2,1,1,1,0,0,0,0,0,0,0.4739797934813417,0.5260202065186583
87366,0.576271186440678,0.4629629629629629,-136,116,0.553661676614851,0.446338323385149,away,SF,over,7.5,0.5,100,0.47935779816513757,MIN,SF,2022 REG,9,3,4,2,5,13,1,0,1,-1,1,1,0,0,0,0,0,0,0,0.47935779816513757,0.5206422018348624
87366,0.576271186440678,0.4629629629629629,-136,116,0.553661676614851,0.446338323385149,home,MIN,under,7.5,0.5412844036697247,-118,0.5206422018348624,MIN,SF,2022 REG,9,3,4,2,5,13,1,0,1,-1,1,1,0,0,0,0,0,0,0,0.47935779816513757,0.5206422018348624
87367,0.5726495726495727,0.4672897196261683,-134,114,0.5497783539959433,0.4502216460040567,away,PIT,over,7.5,0.5391705069124424,-117,0.5153817639191344,DET,PIT,2022 REG,8,2,11,7,9,19,0,1,-5,5,1,1,0,0,0,0,0,0,0,0.5153817639191344,0.4846182360808656
87367,0.5726495726495727,0.4672897196261683,-134,114,0.5497783539959433,0.4502216460040567,home,DET,under,7.5,0.504950495049505,-102,0.4846182360808656,DET,PIT,2022 REG,8,2,11,7,9,19,0,1,-5,5,1,1,0,0,0,0,0,0,0,0.5153817639191344,0.4846182360808656
87368,0.6226415094339623,0.425531914893617,-165,135,0.5926467357960356,0.40735326420396445,away,PIT,over,8.5,0.5348837209302326,-115,0.5097020142727117,ARI,PIT,2022 REG,11,6,7,4,10,18,1,0,2,-2,1,1,1,1,0,0,0,0,0,0.5097020142727117,0.49029798572728833
87368,0.6226415094339623,0.425531914893617,-165,135,0.5926467357960356,0.40735326420396445,home,ARI,under,8.5,0.5121951219512195,-105,0.49029798572728833,ARI,PIT,2022 REG,11,6,7,4,10,18,1,0,2,-2,1,1,1,1,0,0,0,0,0,0.5097020142727117,0.49029798572728833
87369,0.5454545454545454,0.49751243781094534,-120,101,0.5220180091279142,0.4779819908720858,away,STL,over,10,0.5283018867924528,-112,0.5044173060022736,BOS,STL,2022 REG,5,2,14,11,13,19,0,1,-9,9,1,1,0,0,0,0,0,0,0,0.5044173060022736,0.49558269399772636
87369,0.5454545454545454,0.49751243781094534,-120,101,0.5220180091279142,0.4779819908720858,home,BOS,under,10,0.5169082125603864,-107,0.49558269399772636,BOS,STL,2022 REG,5,2,14,11,13,19,0,1,-9,9,1,1,0,0,0,0,0,0,0,0.5044173060022736,0.49558269399772636
87370,0.3861003861003861,0.6551724137931035,159,-190,0.37016494212606577,0.6298350578739342,away,PHI,over,7.5,0.5391705069124424,-117,0.5153817639191344,CHC,PHI,2022 REG,7,2,6,0,2,13,1,0,2,-2,0,0,0,0,0,0,0,0,0,0.5153817639191344,0.4846182360808656
87370,0.3861003861003861,0.6551724137931035,159,-190,0.37016494212606577,0.6298350578739342,home,CHC,under,7.5,0.504950495049505,-102,0.4846182360808656,CHC,PHI,2022 REG,7,2,6,0,2,13,1,0,2,-2,0,0,0,0,0,0,0,0,0,0.5153817639191344,0.4846182360808656
87371,0.6389891696750902,0.3968253968253968,-177,152,0.6161040495646708,0.3838959504353292,away,OAK,over,8.5,0.5121951219512195,-105,0.48808156828023186,BAL,OAK,2022 REG,6,0,11,5,5,17,0,1,-5,5,0,0,0,0,0,0,0,0,0,0.48808156828023186,0.5119184317197681
87371,0.6389891696750902,0.3968253968253968,-177,152,0.6161040495646708,0.3838959504353292,home,BAL,under,8.5,0.5348837209302326,-115,0.5119184317197681,BAL,OAK,2022 REG,6,0,11,5,5,17,0,1,-5,5,0,0,0,0,0,0,0,0,0,0.48808156828023186,0.5119184317197681
87372,0.4739336492890995,0.5670995670995671,111,-131,0.4544866273039494,0.5455133726960506,away,MIN,over,8.5,0.5,100,0.47935779816513757,DET,MIN,2022 REG,6,3,10,2,5,16,1,0,1,-1,1,1,0,0,0,0,0,0,0,0.47935779816513757,0.5206422018348624
87372,0.4739336492890995,0.5670995670995671,111,-131,0.4544866273039494,0.5455133726960506,home,DET,under,8.5,0.5412844036697247,-118,0.5206422018348624,DET,MIN,2022 REG,6,3,10,2,5,16,1,0,1,-1,1,1,0,0,0,0,0,0,0,0.47935779816513757,0.5206422018348624
87373,0.6062992125984252,0.4347826086956522,-154,130,0.581391336695717,0.41860866330428304,away,CWS,over,7.5,0.5348837209302326,-115,0.5097020142727117,SF,CWS,2022 REG,3,0,6,1,1,9,0,1,-1,1,0,0,0,0,0,0,0,0,0,0.5097020142727117,0.49029798572728833
87373,0.6062992125984252,0.4347826086956522,-154,130,0.581391336695717,0.41860866330428304,home,SF,under,7.5,0.5121951219512195,-105,0.49029798572728833,SF,CWS,2022 REG,3,0,6,1,1,9,0,1,-1,1,0,0,0,0,0,0,0,0,0,0.5097020142727117,0.49029798572728833
87374,0.47619047619047616,0.5652173913043479,110,-130,0.4564724440500838,0.5435275559499162,away,NYM,over,9,0.5169082125603864,-107,0.4912600060678196,LAA,NYM,2022 REG,15,11,10,6,17,25,1,0,5,-5,1,1,1,1,1,1,0,0,0,0.4912600060678196,0.5087399939321804
87374,0.47619047619047616,0.5652173913043479,110,-130,0.4564724440500838,0.5435275559499162,home,LAA,under,9,0.5327102803738317,-114,0.5087399939321804,LAA,NYM,2022 REG,15,11,10,6,17,25,1,0,5,-5,1,1,1,1,1,1,0,0,0,0.4912600060678196,0.5087399939321804
87375,0.5652173913043479,0.47619047619047616,-130,110,0.5418129444594474,0.4581870555405526,away,COL,over,8,0.5283018867924528,-112,0.5031902949311281,MIA,COL,2022 REG,9,3,12,2,5,21,1,0,1,-1,1,1,0,0,0,0,0,0,0,0.5031902949311281,0.4968097050688719
87375,0.5652173913043479,0.47619047619047616,-130,110,0.5418129444594474,0.4581870555405526,home,MIA,under,8,0.5192307692307692,-108,0.4968097050688719,MIA,COL,2022 REG,9,3,12,2,5,21,1,0,1,-1,1,1,0,0,0,0,0,0,0,0.5031902949311281,0.4968097050688719
87376,0.6941896024464832,0.3448275862068966,-227,190,0.667104275766614,0.332895724233386,away,PIT,over,6.5,0.5412844036697247,-118,0.5162581740877563,STL,PIT,2022 REG,8,13,7,3,16,15,1,0,10,-10,1,1,1,0,0,0,0,0,0,0.5162581740877563,0.4837418259122437
87376,0.6941896024464832,0.3448275862068966,-227,190,0.667104275766614,0.332895724233386,home,STL,under,6.5,0.504950495049505,-102,0.4837418259122437,STL,PIT,2022 REG,8,13,7,3,16,15,1,0,10,-10,1,1,1,0,0,0,0,0,0,0.5162581740877563,0.4837418259122437
87377,0.5454545454545454,0.49504950495049505,-120,102,0.5233614270517961,0.4766385729482039,away,PHI,over,7,0.5348837209302326,-115,0.5109810284308424,NYM,PHI,2022 REG,10,3,0,0,3,10,1,0,3,-3,0,0,0,0,0,0,0,0,0,0.5109810284308424,0.48901897156915763
87377,0.5454545454545454,0.49504950495049505,-120,102,0.5233614270517961,0.4766385729482039,home,NYM,under,7,0.5098039215686274,-104,0.48901897156915763,NYM,PHI,2022 REG,10,3,0,0,3,10,1,0,3,-3,0,0,0,0,0,0,0,0,0,0.5109810284308424,0.48901897156915763
87378,0.7229916897506925,0.31746031746031744,-261,215,0.6937452247033973,0.3062547752966027,away,COL,over,8.5,0.5121951219512195,-105,0.48808156828023186,LAD,COL,2022 REG,10,6,8,4,10,18,1,0,2,-2,1,1,1,1,0,0,0,0,0,0.48808156828023186,0.5119184317197681
87378,0.7229916897506925,0.31746031746031744,-261,215,0.6937452247033973,0.3062547752966027,home,LAD,under,8.5,0.5348837209302326,-115,0.5119184317197681,LAD,COL,2022 REG,10,6,8,4,10,18,1,0,2,-2,1,1,1,1,0,0,0,0,0,0.48808156828023186,0.5119184317197681
87379,0.6923076923076923,0.35211267605633806,-225,184,0.6615551295941329,0.3384448704058671,away,LAA,over,9,0.5192307692307692,-108,0.49688292476754015,ATL,LAA,2022 REG,6,1,13,9,10,19,0,1,-8,8,1,0,0,0,0,0,0,0,0,0.49688292476754015,0.5031170752324599
87379,0.6923076923076923,0.35211267605633806,-225,184,0.6615551295941329,0.3384448704058671,home,ATL,under,9,0.5238095238095238,-110,0.5031170752324599,ATL,LAA,2022 REG,6,1,13,9,10,19,0,1,-8,8,1,0,0,0,0,0,0,0,0,0.49688292476754015,0.5031170752324599
87380,0.5594713656387665,0.47619047619047616,-127,110,0.5395195862893665,0.46048041371063353,away,COL,over,8,0.5348837209302326,-115,0.5097020142727117,PIT,COL,2022 REG,9,10,13,5,15,22,1,0,5,-5,1,1,1,1,1,0,0,0,0,0.5097020142727117,0.49029798572728833
87380,0.5594713656387665,0.47619047619047616,-127,110,0.5395195862893665,0.46048041371063353,home,PIT,under,8,0.5121951219512195,-105,0.49029798572728833,PIT,COL,2022 REG,9,10,13,5,15,22,1,0,5,-5,1,1,1,1,1,0,0,0,0,0.5097020142727117,0.49029798572728833
87381,0.6923076923076923,0.35460992907801414,-225,182,0.6598262621175878,0.34017373788241223,away,ARI,over,8,0.5121951219512195,-105,0.48808156828023186,SF,ARI,2022 REG,14,13,8,0,13,22,1,0,13,-13,0,0,0,0,0,0,0,0,0,0.48808156828023186,0.5119184317197681
87381,0.6923076923076923,0.35460992907801414,-225,182,0.6598262621175878,0.34017373788241223,home,SF,under,8,0.5348837209302326,-115,0.5119184317197681,SF,ARI,2022 REG,14,13,8,0,13,22,1,0,13,-13,0,0,0,0,0,0,0,0,0,0.48808156828023186,0.5119184317197681
87382,0.6774193548387096,0.36363636363636365,-210,175,0.6496074165168858,0.3503925834831142,away,WSH,over,9,0.5169082125603864,-107,0.49353874091423283,ATL,WSH,2022 REG,3,1,7,3,4,10,0,1,-2,2,1,0,0,0,0,0,0,0,0,0.49353874091423283,0.5064612590857671
87382,0.6774193548387096,0.36363636363636365,-210,175,0.6496074165168858,0.3503925834831142,home,ATL,under,9,0.5283018867924528,-112,0.5064612590857671,ATL,WSH,2022 REG,3,1,7,3,4,10,0,1,-2,2,1,0,0,0,0,0,0,0,0,0.49353874091423283,0.5064612590857671
87383,0.3484320557491289,0.6923076923076923,187,-225,0.33423702158298907,0.6657629784170109,away,NYM,over,9,0.5370370370370371,-116,0.5118817074154765,CIN,NYM,2022 REG,4,1,6,0,1,10,1,0,1,-1,0,0,0,0,0,0,0,0,0,0.5118817074154765,0.48811829258452355
87383,0.3484320557491289,0.6923076923076923,187,-225,0.33423702158298907,0.6657629784170109,home,CIN,under,9,0.5098039215686274,-104,0.48811829258452355,CIN,NYM,2022 REG,4,1,6,0,1,10,1,0,1,-1,0,0,0,0,0,0,0,0,0,0.5118817074154765,0.48811829258452355
87384,0.43859649122807015,0.6047430830039526,128,-153,0.4195879060385864,0.5804120939614136,away,TB,over,8.5,0.5348837209302326,-115,0.5109810284308424,BAL,TB,2022 REG,6,1,9,6,7,15,0,1,-5,5,1,0,0,0,0,0,0,0,0,0.5109810284308424,0.48901897156915763
87384,0.43859649122807015,0.6047430830039526,128,-153,0.4195879060385864,0.5804120939614136,home,BAL,under,8.5,0.5098039215686274,-104,0.48901897156915763,BAL,TB,2022 REG,6,1,9,6,7,15,0,1,-5,5,1,0,0,0,0,0,0,0,0,0.5109810284308424,0.48901897156915763
87385,0.609375,0.425531914893617,-156,135,0.5881035987367021,0.41189640126329785,away,CWS,over,7,0.5475113122171946,-121,0.5214983313199976,HOU,CWS,2022 REG,8,4,6,3,7,14,1,0,1,-1,1,1,1,0,0,0,0,0,0,0.5214983313199976,0.47850166868000243
87385,0.609375,0.425531914893617,-156,135,0.5881035987367021,0.41189640126329785,home,HOU,under,7,0.5,100,0.47850166868000243,HOU,CWS,2022 REG,8,4,6,3,7,14,1,0,1,-1,1,1,1,0,0,0,0,0,0,0.5214983313199976,0.47850166868000243
87386,0.5169082125603864,0.5215311004784688,-107,-109,0.49703861596542265,0.5029613840345774,away,SF,over,7,0.5121951219512195,-105,0.48808156828023186,MIA,SF,2022 REG,6,5,5,4,9,11,1,0,1,-1,1,1,1,1,0,0,0,0,0,0.48808156828023186,0.5119184317197681
87386,0.5169082125603864,0.5215311004784688,-107,-109,0.49703861596542265,0.5029613840345774,home,MIA,under,7,0.5348837209302326,-115,0.5119184317197681,MIA,SF,2022 REG,6,5,5,4,9,11,1,0,1,-1,1,1,1,1,0,0,0,0,0,0.48808156828023186,0.5119184317197681
87387,0.4608294930875576,0.5780590717299579,117,-137,0.44290849547579936,0.5570915045242006,away,LAA,over,7.5,0.49751243781094534,101,0.47511256217505476,SEA,LAA,2022 REG,4,1,10,4,5,14,0,1,-3,3,1,0,0,0,0,0,0,0,0,0.47511256217505476,0.5248874378249453
87387,0.4608294930875576,0.5780590717299579,117,-137,0.44290849547579936,0.5570915045242006,home,SEA,under,7.5,0.5475113122171946,-121,0.5248874378249453,SEA,LAA,2022 REG,4,1,10,4,5,14,0,1,-3,3,1,0,0,0,0,0,0,0,0,0.47511256217505476,0.5248874378249453
87388,0.6923076923076923,0.3508771929824561,-225,185,0.6624104640298972,0.33758953597010277,away,TB,over,7.5,0.5348837209302326,-115,0.5097020142727117,NYY,TB,2022 REG,5,2,7,0,2,12,1,0,2,-2,0,0,0,0,0,0,0,0,0,0.5097020142727117,0.49029798572728833
87388,0.6923076923076923,0.3508771929824561,-225,185,0.6624104640298972,0.33758953597010277,home,NYY,under,7.5,0.5121951219512195,-105,0.49029798572728833,NYY,TB,2022 REG,5,2,7,0,2,12,1,0,2,-2,0,0,0,0,0,0,0,0,0,0.5097020142727117,0.49029798572728833
87389,0.6197718631178707,0.42016806722689076,-163,138,0.5950182180753,0.4049817819247,away,CLE,over,8.5,0.5370370370370371,-116,0.5118817074154765,TOR,CLE,2022 REG,3,0,14,8,8,17,0,1,-8,8,0,0,0,0,0,0,0,0,0,0.5118817074154765,0.48811829258452355
87389,0.6197718631178707,0.42016806722689076,-163,138,0.5950182180753,0.4049817819247,home,TOR,under,8.5,0.5098039215686274,-104,0.48811829258452355,TOR,CLE,2022 REG,3,0,14,8,8,17,0,1,-8,8,0,0,0,0,0,0,0,0,0,0.5118817074154765,0.48811829258452355
87390,0.4,0.6363636363636364,150,-175,0.3854545454545455,0.6145454545454545,away,LAA,over,6.5,0.5370370370370371,-116,0.5118817074154765,MIN,LAA,2022 REG,5,2,8,4,6,13,0,1,-2,2,1,1,0,0,0,0,0,0,0,0.5118817074154765,0.48811829258452355
87390,0.4,0.6363636363636364,150,-175,0.3854545454545455,0.6145454545454545,home,MIN,under,6.5,0.5098039215686274,-104,0.48811829258452355,MIN,LAA,2022 REG,5,2,8,4,6,13,0,1,-2,2,1,1,0,0,0,0,0,0,0,0.5118817074154765,0.48811829258452355
87391,0.5708154506437768,0.46511627906976744,-133,115,0.5503050641549297,0.44969493584507025,away,DET,over,8.5,0.5327102803738317,-114,0.508788710910954,KC,DET,2022 REG,6,2,17,10,12,23,0,1,-8,8,1,1,0,0,0,0,0,0,0,0.508788710910954,0.491211289089046
87391,0.5708154506437768,0.46511627906976744,-133,115,0.5503050641549297,0.44969493584507025,home,KC,under,8.5,0.5121951219512195,-105,0.491211289089046,KC,DET,2022 REG,6,2,17,10,12,23,0,1,-8,8,1,1,0,0,0,0,0,0,0,0.508788710910954,0.491211289089046
87392,0.42194092827004215,0.6183206106870228,137,-162,0.4049529371489177,0.5950470628510822,away,LAD,over,8.5,0.5412844036697247,-118,0.5189377998484975,STL,LAD,2022 REG,13,7,10,6,13,23,1,0,1,-1,1,1,1,1,1,1,0,0,0,0.5189377998484975,0.4810622001515025
87392,0.42194092827004215,0.6183206106870228,137,-162,0.4049529371489177,0.5950470628510822,home,STL,under,8.5,0.5,100,0.4810622001515025,STL,LAD,2022 REG,13,7,10,6,13,23,1,0,1,-1,1,1,1,1,1,1,0,0,0,0.5189377998484975,0.4810622001515025
87393,0.3921568627450981,0.6491228070175439,155,-185,0.37596875695582666,0.6240312430441733,away,TB,over,8,0.5433789954337899,-119,0.5171177654451503,DET,TB,2022 REG,6,2,12,6,8,18,0,1,-4,4,1,1,0,0,0,0,0,0,0,0.5171177654451503,0.4828822345548497
87393,0.3921568627450981,0.6491228070175439,155,-185,0.37596875695582666,0.6240312430441733,home,DET,under,8,0.504950495049505,-102,0.4828822345548497,DET,TB,2022 REG,6,2,12,6,8,18,0,1,-4,4,1,1,0,0,0,0,0,0,0,0.5171177654451503,0.4828822345548497
87394,0.6610169491525424,0.37735849056603776,-195,165,0.6356501330673793,0.3643498669326207,away,KC,over,9,0.5215311004784688,-109,0.4978845547971712,LAA,KC,2022 REG,7,2,12,6,8,19,0,1,-4,4,1,1,0,0,0,0,0,0,0,0.4978845547971712,0.5021154452028288
87394,0.6610169491525424,0.37735849056603776,-195,165,0.6356501330673793,0.3643498669326207,home,LAA,under,9,0.5238095238095238,-110,0.5021154452028288,LAA,KC,2022 REG,7,2,12,6,8,19,0,1,-4,4,1,1,0,0,0,0,0,0,0,0.4978845547971712,0.5021154452028288
87395,0.7198879551820728,0.3225806451612903,-257,210,0.6893153213214445,0.31068467867855554,away,COL,over,7.5,0.5121951219512195,-105,0.48919479393107135,SD,COL,2022 REG,14,9,5,0,9,19,1,0,9,-9,0,0,0,0,0,0,0,0,0,0.48919479393107135,0.5108052060689287
87395,0.7198879551820728,0.3225806451612903,-257,210,0.6893153213214445,0.31068467867855554,home,SD,under,7.5,0.5327102803738317,-114,0.5108052060689287,SD,COL,2022 REG,14,9,5,0,9,19,1,0,9,-9,0,0,0,0,0,0,0,0,0,0.48919479393107135,0.5108052060689287
87396,0.6197718631178707,0.41493775933609955,-163,141,0.5982598157414557,0.4017401842585443,away,OAK,over,8.5,0.5454545454545454,-120,0.5206611570247933,TEX,OAK,2022 REG,10,7,10,8,15,20,0,1,-1,1,1,1,1,1,1,1,1,0,0,0.5206611570247933,0.4793388429752067
87396,0.6197718631178707,0.41493775933609955,-163,141,0.5982598157414557,0.4017401842585443,home,TEX,under,8.5,0.5,100,0.4793388429752067,TEX,OAK,2022 REG,10,7,10,8,15,20,0,1,-1,1,1,1,1,1,1,1,1,0,0,0.5206611570247933,0.4793388429752067
87397,0.6309963099630996,0.4065040650406504,-171,146,0.6073337117135009,0.3926662882864991,away,OAK,over,8.5,0.5348837209302326,-115,0.5097020142727117,CLE,OAK,2022 REG,10,6,8,3,9,18,1,0,3,-3,1,1,1,0,0,0,0,0,0,0.5097020142727117,0.49029798572728833
87397,0.6309963099630996,0.4065040650406504,-171,146,0.6073337117135009,0.3926662882864991,home,CLE,under,8.5,0.5121951219512195,-105,0.49029798572728833,CLE,OAK,2022 REG,10,6,8,3,9,18,1,0,3,-3,1,1,1,0,0,0,0,0,0,0.5097020142727117,0.49029798572728833
87398,0.5192307692307692,0.5145631067961165,-108,-106,0.5016839489860401,0.4983160510139599,away,TOR,over,6.5,0.5370370370370371,-116,0.514488177212783,TB,TOR,2022 REG,7,1,5,3,4,12,0,1,-2,2,1,0,0,0,0,0,0,0,0,0.514488177212783,0.48551182278721705
87398,0.5192307692307692,0.5145631067961165,-108,-106,0.5016839489860401,0.4983160510139599,home,TB,under,6.5,0.504950495049505,-102,0.48551182278721705,TB,TOR,2022 REG,7,1,5,3,4,12,0,1,-2,2,1,0,0,0,0,0,0,0,0,0.514488177212783,0.48551182278721705
87399,0.6894409937888198,0.3508771929824561,-222,185,0.6616439830334682,0.33835601696653184,away,CWS,over,7.5,0.5238095238095238,-110,0.4988662131519274,SD,CWS,2022 REG,7,1,8,3,4,15,0,1,-2,2,1,0,0,0,0,0,0,0,0,0.4988662131519274,0.5011337868480725
87399,0.6894409937888198,0.3508771929824561,-222,185,0.6616439830334682,0.33835601696653184,home,SD,under,7.5,0.5238095238095238,-110,0.5011337868480725,SD,CWS,2022 REG,7,1,8,3,4,15,0,1,-2,2,1,0,0,0,0,0,0,0,0,0.4988662131519274,0.5011337868480725
87400,0.6000000000000001,0.4424778761061947,-150,126,0.5745132743362832,0.4254867256637168,away,BAL,over,7.5,0.5283018867924528,-112,0.5031902949311281,DET,BAL,2022 REG,6,4,8,2,6,14,1,0,2,-2,1,1,0,0,0,0,0,0,0,0.5031902949311281,0.4968097050688719
87400,0.6000000000000001,0.4424778761061947,-150,126,0.5745132743362832,0.4254867256637168,home,DET,under,7.5,0.5192307692307692,-108,0.4968097050688719,DET,BAL,2022 REG,6,4,8,2,6,14,1,0,2,-2,1,1,0,0,0,0,0,0,0,0.5031902949311281,0.4968097050688719
87401,0.5594713656387665,0.47619047619047616,-127,110,0.5395195862893665,0.46048041371063353,away,WSH,over,9.5,0.5348837209302326,-115,0.5109810284308424,CIN,WSH,2022 REG,6,5,12,8,13,18,0,1,-3,3,1,1,1,1,1,0,0,0,0,0.5109810284308424,0.48901897156915763
87401,0.5594713656387665,0.47619047619047616,-127,110,0.5395195862893665,0.46048041371063353,home,CIN,under,9.5,0.5098039215686274,-104,0.48901897156915763,CIN,WSH,2022 REG,6,5,12,8,13,18,0,1,-3,3,1,1,1,1,1,0,0,0,0,0.5109810284308424,0.48901897156915763
87402,0.6575342465753424,0.37735849056603776,-192,165,0.6345910769481337,0.36540892305186634,away,ARI,over,9.5,0.5121951219512195,-105,0.48919479393107135,PHI,ARI,2022 REG,7,1,12,13,14,19,0,1,-12,12,1,0,0,0,0,0,0,0,0,0.48919479393107135,0.5108052060689287
87402,0.6575342465753424,0.37735849056603776,-192,165,0.6345910769481337,0.36540892305186634,home,PHI,under,9.5,0.5327102803738317,-114,0.5108052060689287,PHI,ARI,2022 REG,7,1,12,13,14,19,0,1,-12,12,1,0,0,0,0,0,0,0,0,0.48919479393107135,0.5108052060689287
87403,0.574468085106383,0.46511627906976744,-135,115,0.5517281312179562,0.44827186878204384,away,TB,over,8.5,0.5121951219512195,-105,0.48808156828023186,NYY,TB,2022 REG,10,8,9,7,15,19,1,0,1,-1,1,1,1,1,1,1,1,0,0,0.48808156828023186,0.5119184317197681
87403,0.574468085106383,0.46511627906976744,-135,115,0.5517281312179562,0.44827186878204384,home,NYY,under,8.5,0.5348837209302326,-115,0.5119184317197681,NYY,TB,2022 REG,10,8,9,7,15,19,1,0,1,-1,1,1,1,1,1,1,1,0,0,0.48808156828023186,0.5119184317197681
87404,0.43859649122807015,0.6000000000000001,128,-150,0.4216682056017235,0.5783317943982764,away,NYY,over,9,0.5121951219512195,-105,0.48808156828023186,BAL,NYY,2022 REG,9,6,9,7,13,18,0,1,-1,1,1,1,1,1,1,1,0,0,0,0.48808156828023186,0.5119184317197681
87404,0.43859649122807015,0.6000000000000001,128,-150,0.4216682056017235,0.5783317943982764,home,BAL,under,9,0.5348837209302326,-115,0.5119184317197681,BAL,NYY,2022 REG,9,6,9,7,13,18,0,1,-1,1,1,1,1,1,1,1,0,0,0,0.48808156828023186,0.5119184317197681
87405,0.5121951219512195,0.5260663507109005,-105,-111,0.4925977822950117,0.5074022177049883,away,TOR,over,9,0.5024875621890548,-101,0.47839724939301687,SEA,TOR,2022 REG,10,8,10,3,11,20,1,0,5,-5,1,1,1,0,0,0,0,0,0,0.47839724939301687,0.5216027506069831
87405,0.5121951219512195,0.5260663507109005,-105,-111,0.4925977822950117,0.5074022177049883,home,SEA,under,9,0.5454545454545454,-120,0.5216027506069831,SEA,TOR,2022 REG,10,8,10,3,11,20,1,0,5,-5,1,1,1,0,0,0,0,0,0,0.47839724939301687,0.5216027506069831
87406,0.5884773662551441,0.4504504504504505,-143,122,0.5655692272061728,0.43443077279382725,away,PIT,over,8.5,0.5,100,0.47935779816513757,CHC,PIT,2022 REG,9,3,8,2,5,17,1,0,1,-1,1,1,0,0,0,0,0,0,0,0.47935779816513757,0.5206422018348624
87406,0.5884773662551441,0.4504504504504505,-143,122,0.5655692272061728,0.43443077279382725,home,CHC,under,8.5,0.5412844036697247,-118,0.5206422018348624,CHC,PIT,2022 REG,9,3,8,2,5,17,1,0,1,-1,1,1,0,0,0,0,0,0,0,0.47935779816513757,0.5206422018348624
87407,0.49019607843137253,0.5515695067264574,104,-123,0.4697227523736127,0.5302772476263873,away,TOR,over,9,0.5098039215686274,-104,0.48375889301574193,CWS,TOR,2022 REG,13,8,8,7,15,21,1,0,1,-1,1,1,1,1,1,1,1,0,0,0.48375889301574193,0.5162411069842581
87407,0.49019607843137253,0.5515695067264574,104,-123,0.4697227523736127,0.5302772476263873,home,CWS,under,9,0.5412844036697247,-118,0.5162411069842581,CWS,TOR,2022 REG,13,8,8,7,15,21,1,0,1,-1,1,1,1,1,1,1,1,0,0,0.48375889301574193,0.5162411069842581
87408,0.6197718631178707,0.4166666666666667,-163,140,0.597188287624032,0.402811712375968,away,MIA,over,6.5,0.5327102803738317,-114,0.508788710910954,SD,MIA,2022 REG,8,3,5,2,5,13,1,0,1,-1,1,1,0,0,0,0,0,0,0,0.508788710910954,0.491211289089046
87408,0.6197718631178707,0.4166666666666667,-163,140,0.597188287624032,0.402811712375968,home,SD,under,6.5,0.5121951219512195,-105,0.491211289089046,SD,MIA,2022 REG,8,3,5,2,5,13,1,0,1,-1,1,1,0,0,0,0,0,0,0,0.508788710910954,0.491211289089046
87409,0.6551724137931035,0.3861003861003861,-190,159,0.6281316138628862,0.3718683861371138,away,SEA,over,9,0.5348837209302326,-115,0.5097020142727117,NYY,SEA,2022 REG,10,7,7,2,9,17,1,0,5,-5,1,1,0,0,0,0,0,0,0,0.5097020142727117,0.49029798572728833
87409,0.6551724137931035,0.3861003861003861,-190,159,0.6281316138628862,0.3718683861371138,home,NYY,under,9,0.5121951219512195,-105,0.49029798572728833,NYY,SEA,2022 REG,10,7,7,2,9,17,1,0,5,-5,1,1,0,0,0,0,0,0,0,0.5097020142727117,0.49029798572728833
87410,0.574468085106383,0.46511627906976744,-135,115,0.5517281312179562,0.44827186878204384,away,STL,over,7.5,0.5283018867924528,-112,0.5044173060022736,MIA,STL,2022 REG,5,0,5,2,2,10,0,1,-2,2,0,0,0,0,0,0,0,0,0,0.5044173060022736,0.49558269399772636
87410,0.574468085106383,0.46511627906976744,-135,115,0.5517281312179562,0.44827186878204384,home,MIA,under,7.5,0.5169082125603864,-107,0.49558269399772636,MIA,STL,2022 REG,5,0,5,2,2,10,0,1,-2,2,0,0,0,0,0,0,0,0,0,0.5044173060022736,0.49558269399772636
87411,0.4629629629629629,0.576271186440678,116,-136,0.4447990049057217,0.5552009950942782,away,MIL,over,10.5,0.5305164319248826,-113,0.5066009958897986,CHC,MIL,2022 REG,6,1,3,3,4,9,0,1,-2,2,1,0,0,0,0,0,0,0,0,0.5066009958897986,0.49339900411020143
87411,0.4629629629629629,0.576271186440678,116,-136,0.4447990049057217,0.5552009950942782,home,CHC,under,10.5,0.5145631067961165,-106,0.49339900411020143,CHC,MIL,2022 REG,6,1,3,3,4,9,0,1,-2,2,1,0,0,0,0,0,0,0,0,0.5066009958897986,0.49339900411020143
87412,0.7368421052631579,0.303951367781155,-280,229,0.7067837567041905,0.29321624329580953,away,KC,over,8.5,0.5121951219512195,-105,0.4903184724049234,NYY,KC,2022 REG,7,6,9,8,14,16,0,1,-2,2,1,1,1,1,1,1,0,0,0,0.4903184724049234,0.5096815275950766
87412,0.7368421052631579,0.303951367781155,-280,229,0.7067837567041905,0.29321624329580953,home,NYY,under,8.5,0.5305164319248826,-113,0.5096815275950766,NYY,KC,2022 REG,7,6,9,8,14,16,0,1,-2,2,1,1,1,1,1,1,0,0,0,0.4903184724049234,0.5096815275950766
87413,0.6551724137931035,0.3802281368821293,-190,163,0.6319789495576061,0.36802105044239386,away,CHC,over,7.5,0.5412844036697247,-118,0.5149381613977361,MIL,CHC,2022 REG,12,7,5,0,7,17,1,0,7,-7,0,0,0,0,0,0,0,0,0,0.5149381613977361,0.48506183860226393
87413,0.6551724137931035,0.3802281368821293,-190,163,0.6319789495576061,0.36802105044239386,home,MIL,under,7.5,0.5073891625615764,-103,0.48506183860226393,MIL,CHC,2022 REG,12,7,5,0,7,17,1,0,7,-7,0,0,0,0,0,0,0,0,0,0.5149381613977361,0.48506183860226393
87414,0.5850622406639003,0.45248868778280543,-141,121,0.5630926103278608,0.43690738967213916,away,MIA,over,6.5,0.5305164319248826,-113,0.5078572507605655,NYM,MIA,2022 REG,6,2,8,6,8,14,0,1,-4,4,1,1,0,0,0,0,0,0,0,0.5078572507605655,0.49214274923943446
87414,0.5850622406639003,0.45248868778280543,-141,121,0.5630926103278608,0.43690738967213916,home,NYM,under,6.5,0.5121951219512195,-105,0.49214274923943446,NYM,MIA,2022 REG,6,2,8,6,8,14,0,1,-4,4,1,1,0,0,0,0,0,0,0,0.5078572507605655,0.49214274923943446
87415,0.6108949416342413,0.4273504273504274,-157,134,0.5875310391805721,0.41246896081942785,away,CIN,over,8.5,0.5433789954337899,-119,0.5198077604720502,ARI,CIN,2022 REG,10,4,8,5,9,18,0,1,-1,1,1,1,1,1,0,0,0,0,0,0.5198077604720502,0.48019223952794976
87415,0.6108949416342413,0.4273504273504274,-157,134,0.5875310391805721,0.41246896081942785,home,ARI,under,8.5,0.5,100,0.48019223952794976,ARI,CIN,2022 REG,10,4,8,5,9,18,0,1,-1,1,1,1,1,1,0,0,0,0,0,0.5198077604720502,0.48019223952794976
87416,0.49019607843137253,0.5515695067264574,104,-123,0.4697227523736127,0.5302772476263873,away,HOU,over,8,0.5283018867924528,-112,0.5044173060022736,LAA,HOU,2022 REG,2,5,8,6,11,10,0,1,-1,1,1,1,1,1,1,0,0,0,0,0.5044173060022736,0.49558269399772636
87416,0.49019607843137253,0.5515695067264574,104,-123,0.4697227523736127,0.5302772476263873,home,LAA,under,8,0.5169082125603864,-107,0.49558269399772636,LAA,HOU,2022 REG,2,5,8,6,11,10,0,1,-1,1,1,1,1,1,1,0,0,0,0,0.5044173060022736,0.49558269399772636
87417,0.47619047619047616,0.5652173913043479,110,-130,0.4564724440500838,0.5435275559499162,away,TOR,over,8.5,0.5391705069124424,-117,0.5153817639191344,BAL,TOR,2022 REG,10,4,11,8,12,21,0,1,-4,4,1,1,1,1,0,0,0,0,0,0.5153817639191344,0.4846182360808656
87417,0.47619047619047616,0.5652173913043479,110,-130,0.4564724440500838,0.5435275559499162,home,BAL,under,8.5,0.504950495049505,-102,0.4846182360808656,BAL,TOR,2022 REG,10,4,11,8,12,21,0,1,-4,4,1,1,1,1,0,0,0,0,0,0.5153817639191344,0.4846182360808656
87418,0.6183206106870228,0.4166666666666667,-162,140,0.5966872559874133,0.40331274401258665,away,TEX,over,8,0.5305164319248826,-113,0.5066009958897986,CWS,TEX,2022 REG,15,9,15,11,20,30,0,1,-2,2,1,1,1,1,1,1,1,1,1,0.5066009958897986,0.49339900411020143
87418,0.6183206106870228,0.4166666666666667,-162,140,0.5966872559874133,0.40331274401258665,home,CWS,under,8,0.5145631067961165,-106,0.49339900411020143,CWS,TEX,2022 REG,15,9,15,11,20,30,0,1,-2,2,1,1,1,1,1,1,1,1,1,0.5066009958897986,0.49339900411020143
87419,0.7014925373134329,0.3412969283276451,-235,193,0.6714760464905872,0.32852395350941277,away,TEX,over,7.5,0.5169082125603864,-107,0.49353874091423283,LAA,TEX,2022 REG,5,0,10,2,2,15,0,1,-2,2,0,0,0,0,0,0,0,0,0,0.49353874091423283,0.5064612590857671
87419,0.7014925373134329,0.3412969283276451,-235,193,0.6714760464905872,0.32852395350941277,home,LAA,under,7.5,0.5283018867924528,-112,0.5064612590857671,LAA,TEX,2022 REG,5,0,10,2,2,15,0,1,-2,2,0,0,0,0,0,0,0,0,0,0.49353874091423283,0.5064612590857671
87420,0.42372881355932196,0.6197718631178707,136,-163,0.4052963234418675,0.5947036765581325,away,MIL,over,9.5,0.5098039215686274,-104,0.48483656587239576,BAL,MIL,2022 REG,7,4,9,5,9,16,0,1,-1,1,1,1,1,1,0,0,0,0,0,0.48483656587239576,0.5151634341276042
87420,0.42372881355932196,0.6197718631178707,136,-163,0.4052963234418675,0.5947036765581325,home,BAL,under,9.5,0.5391705069124424,-117,0.5151634341276042,BAL,MIL,2022 REG,7,4,9,5,9,16,0,1,-1,1,1,1,1,1,0,0,0,0,0,0.48483656587239576,0.5151634341276042
87421,0.4484304932735426,0.5901639344262295,123,-144,0.43112357502252374,0.5688764249774763,away,LAD,over,8,0.5169082125603864,-107,0.4946943078742622,SF,LAD,2022 REG,5,2,11,8,10,16,0,1,-6,6,1,1,0,0,0,0,0,0,0,0.4946943078742622,0.5053056921257377
87421,0.4484304932735426,0.5901639344262295,123,-144,0.43112357502252374,0.5688764249774763,home,SF,under,8,0.5260663507109005,-111,0.5053056921257377,SF,LAD,2022 REG,5,2,11,8,10,16,0,1,-6,6,1,1,0,0,0,0,0,0,0,0.4946943078742622,0.5053056921257377
87422,0.42016806722689076,0.6197718631178707,138,-163,0.4033865838887557,0.5966134161112443,away,LAD,over,8,0.5238095238095238,-110,0.5012646084074657,STL,LAD,2022 REG,9,6,12,7,13,21,0,1,-1,1,1,1,1,1,1,1,0,0,0,0.5012646084074657,0.4987353915925343
87422,0.42016806722689076,0.6197718631178707,138,-163,0.4033865838887557,0.5966134161112443,home,STL,under,8,0.5192307692307692,-108,0.4987353915925343,STL,LAD,2022 REG,9,6,12,7,13,21,0,1,-1,1,1,1,1,1,1,1,0,0,0,0.5012646084074657,0.4987353915925343
87423,0.6575342465753424,0.3846153846153846,-192,160,0.6298194205869192,0.3701805794130808,away,CIN,over,8.5,0.5098039215686274,-104,0.4870219861770517,TOR,CIN,2022 REG,9,2,8,1,3,17,1,0,1,-1,1,0,0,0,0,0,0,0,0,0.4870219861770517,0.5129780138229483
87423,0.6575342465753424,0.3846153846153846,-192,160,0.6298194205869192,0.3701805794130808,home,TOR,under,8.5,0.5348837209302326,-115,0.5129780138229483,TOR,CIN,2022 REG,9,2,8,1,3,17,1,0,1,-1,1,0,0,0,0,0,0,0,0,0.4870219861770517,0.5129780138229483
87424,0.4166666666666667,0.6363636363636364,140,-175,0.3945707070707071,0.6054292929292928,away,ATL,over,9.5,0.5121951219512195,-105,0.48808156828023186,WSH,ATL,2022 REG,8,4,12,8,12,20,0,1,-4,4,1,1,1,1,0,0,0,0,0,0.48808156828023186,0.5119184317197681
87424,0.4166666666666667,0.6363636363636364,140,-175,0.3945707070707071,0.6054292929292928,home,WSH,under,9.5,0.5348837209302326,-115,0.5119184317197681,WSH,ATL,2022 REG,8,4,12,8,12,20,0,1,-4,4,1,1,1,1,0,0,0,0,0,0.48808156828023186,0.5119184317197681
87425,0.5652173913043479,0.47619047619047616,-130,110,0.5418129444594474,0.4581870555405526,away,BAL,over,8,0.504950495049505,-102,0.4826715732667395,SEA,BAL,2022 REG,11,9,8,3,12,19,1,0,6,-6,1,1,1,0,0,0,0,0,0,0.4826715732667395,0.5173284267332605
87425,0.5652173913043479,0.47619047619047616,-130,110,0.5418129444594474,0.4581870555405526,home,SEA,under,8,0.5391705069124424,-117,0.5173284267332605,SEA,BAL,2022 REG,11,9,8,3,12,19,1,0,6,-6,1,1,1,0,0,0,0,0,0,0.4826715732667395,0.5173284267332605
87426,0.5370370370370371,0.504950495049505,-116,-102,0.514488177212783,0.48551182278721705,away,COL,over,7.5,0.5391705069124424,-117,0.5140669063204599,PIT,COL,2022 REG,5,1,7,2,3,12,0,1,-1,1,1,0,0,0,0,0,0,0,0,0.5140669063204599,0.4859330936795401
87426,0.5370370370370371,0.504950495049505,-116,-102,0.514488177212783,0.48551182278721705,home,PIT,under,7.5,0.5073891625615764,-103,0.4859330936795401,PIT,COL,2022 REG,5,1,7,2,3,12,0,1,-1,1,1,0,0,0,0,0,0,0,0,0.5140669063204599,0.4859330936795401
87427,0.6047430830039526,0.4587155963302753,-153,118,0.5663668856200124,0.43363311437998764,away,TEX,over,9,0.5073891625615764,-103,0.4774741727257759,CLE,TEX,2022 REG,5,3,12,6,9,17,0,1,-3,3,1,1,1,0,0,0,0,0,0,0.4774741727257759,0.5225258272742241
87427,0.6047430830039526,0.4587155963302753,-153,118,0.5663668856200124,0.43363311437998764,home,CLE,under,9,0.5515695067264574,-123,0.5225258272742241,CLE,TEX,2022 REG,5,3,12,6,9,17,0,1,-3,3,1,1,1,0,0,0,0,0,0,0.4774741727257759,0.5225258272742241
87428,0.6551724137931035,0.38167938931297707,-190,162,0.6310281289994645,0.3689718710005355,away,WSH,over,9,0.5454545454545454,-120,0.5206611570247933,LAA,WSH,2022 REG,5,3,4,0,3,9,1,0,3,-3,0,0,0,0,0,0,0,0,0,0.5206611570247933,0.4793388429752067
87428,0.6551724137931035,0.38167938931297707,-190,162,0.6310281289994645,0.3689718710005355,home,LAA,under,9,0.5,100,0.4793388429752067,LAA,WSH,2022 REG,5,3,4,0,3,9,1,0,3,-3,0,0,0,0,0,0,0,0,0,0.5206611570247933,0.4793388429752067
87429,0.4273504273504274,0.609375,134,-156,0.4116558002775952,0.5883441997224048,away,LAD,over,8,0.5121951219512195,-105,0.48808156828023186,SF,LAD,2022 REG,7,5,13,9,14,20,0,1,-4,4,1,1,1,1,1,0,0,0,0,0.48808156828023186,0.5119184317197681
87429,0.4273504273504274,0.609375,134,-156,0.4116558002775952,0.5883441997224048,home,SF,under,8,0.5348837209302326,-115,0.5119184317197681,SF,LAD,2022 REG,7,5,13,9,14,20,0,1,-4,4,1,1,1,1,1,0,0,0,0,0.48808156828023186,0.5119184317197681
87430,0.6108949416342413,0.43103448275862066,-157,132,0.5852804683670066,0.41471953163299335,away,TEX,over,8.5,0.5145631067961165,-106,0.4913668392989033,SEA,TEX,2022 REG,8,4,6,3,7,14,1,0,1,-1,1,1,1,0,0,0,0,0,0,0.4913668392989033,0.5086331607010968
87430,0.6108949416342413,0.43103448275862066,-157,132,0.5852804683670066,0.41471953163299335,home,SEA,under,8.5,0.5305164319248826,-113,0.5086331607010968,SEA,TEX,2022 REG,8,4,6,3,7,14,1,0,1,-1,1,1,1,0,0,0,0,0,0,0.4913668392989033,0.5086331607010968
87431,0.5670995670995671,0.4739336492890995,-131,111,0.5438296478488513,0.45617035215114865,away,STL,over,7,0.5454545454545454,-120,0.5206611570247933,SF,STL,2022 REG,10,1,12,7,8,22,0,1,-6,6,1,0,0,0,0,0,0,0,0,0.5206611570247933,0.4793388429752067
87431,0.5670995670995671,0.4739336492890995,-131,111,0.5438296478488513,0.45617035215114865,home,SF,under,7,0.5,100,0.4793388429752067,SF,STL,2022 REG,10,1,12,7,8,22,0,1,-6,6,1,0,0,0,0,0,0,0,0,0.5206611570247933,0.4793388429752067
87432,0.7685185185185185,0.273972602739726,-332,265,0.7358633049589418,0.2641366950410582,away,PIT,over,8,0.5215311004784688,-109,0.49907282342437215,NYY,PIT,2022 REG,11,9,10,8,17,21,1,0,1,-1,1,1,1,1,1,1,1,1,0,0.49907282342437215,0.5009271765756278
87432,0.7685185185185185,0.273972602739726,-332,265,0.7358633049589418,0.2641366950410582,home,NYY,under,8,0.5215311004784688,-109,0.5009271765756278,NYY,PIT,2022 REG,11,9,10,8,17,21,1,0,1,-1,1,1,1,1,1,1,1,1,0,0.49907282342437215,0.5009271765756278
87433,0.7542997542997544,0.2898550724637681,-307,245,0.720993779320881,0.27900622067911895,away,CIN,over,8,0.5348837209302326,-115,0.5097020142727117,NYY,CIN,2022 REG,9,3,7,4,7,16,0,1,-1,1,1,1,1,0,0,0,0,0,0,0.5097020142727117,0.49029798572728833
87433,0.7542997542997544,0.2898550724637681,-307,245,0.720993779320881,0.27900622067911895,home,NYY,under,8,0.5121951219512195,-105,0.49029798572728833,NYY,CIN,2022 REG,9,3,7,4,7,16,0,1,-1,1,1,1,1,0,0,0,0,0,0,0.5097020142727117,0.49029798572728833
87434,0.7333333333333333,0.3067484662576687,-275,226,0.7039400136332651,0.2960599863667349,away,OAK,over,7,0.5391705069124424,-117,0.5127649394825569,LAA,OAK,2022 REG,13,4,3,2,6,16,1,0,2,-2,1,1,0,0,0,0,0,0,0,0.5127649394825569,0.48723506051744314
87434,0.7333333333333333,0.3067484662576687,-275,226,0.7039400136332651,0.2960599863667349,home,LAA,under,7,0.5098039215686274,-104,0.48723506051744314,LAA,OAK,2022 REG,13,4,3,2,6,16,1,0,2,-2,1,1,0,0,0,0,0,0,0,0.5127649394825569,0.48723506051744314
87435,0.6031746031746031,0.4329004329004329,-152,131,0.5814150576055337,0.4185849423944663,away,SF,over,8,0.5391705069124424,-117,0.5140669063204599,ATL,SF,2022 REG,9,2,8,1,3,17,1,0,1,-1,1,0,0,0,0,0,0,0,0,0.5140669063204599,0.4859330936795401
87435,0.6031746031746031,0.4329004329004329,-152,131,0.5814150576055337,0.4185849423944663,home,ATL,under,8,0.5073891625615764,-103,0.4859330936795401,ATL,SF,2022 REG,9,2,8,1,3,17,1,0,1,-1,1,0,0,0,0,0,0,0,0,0.5140669063204599,0.4859330936795401
87436,0.626865671641791,0.4132231404958678,-168,142,0.6017353714957959,0.3982646285042041,away,MIA,over,7,0.5495495495495495,-122,0.5250401592387142,NYM,MIA,2022 REG,5,2,10,5,7,15,0,1,-3,3,1,1,0,0,0,0,0,0,0,0.5250401592387142,0.47495984076128583
87436,0.626865671641791,0.4132231404958678,-168,142,0.6017353714957959,0.3982646285042041,home,NYM,under,7,0.49504950495049505,102,0.47495984076128583,NYM,MIA,2022 REG,5,2,10,5,7,15,0,1,-3,3,1,1,0,0,0,0,0,0,0,0.5250401592387142,0.47495984076128583
87437,0.4424778761061947,0.6031746031746031,126,-152,0.4222776640350453,0.5777223359649547,away,SEA,over,8.5,0.5475113122171946,-121,0.5242087833606768,BAL,SEA,2022 REG,10,9,8,2,11,18,1,0,7,-7,1,1,0,0,0,0,0,0,0,0.5242087833606768,0.4757912166393232
87437,0.4424778761061947,0.6031746031746031,126,-152,0.4222776640350453,0.5777223359649547,home,BAL,under,8.5,0.49504950495049505,102,0.4757912166393232,BAL,SEA,2022 REG,10,9,8,2,11,18,1,0,7,-7,1,1,0,0,0,0,0,0,0,0.5242087833606768,0.4757912166393232
87438,0.5515695067264574,0.48780487804878053,-123,105,0.5298517967383217,0.4701482032616783,away,COL,over,NA,NA,NA,NA,WSH,COL,2022 REG,8,2,10,3,5,18,0,1,-1,1,1,1,0,0,0,0,0,0,0,NA,NA
87438,0.5515695067264574,0.48780487804878053,-123,105,0.5298517967383217,0.4701482032616783,home,WSH,under,NA,NA,NA,NA,WSH,COL,2022 REG,8,2,10,3,5,18,0,1,-1,1,1,1,0,0,0,0,0,0,0,NA,NA
87439,0.49504950495049505,0.5433789954337899,102,-119,0.47602549485926493,0.5239745051407351,away,NYY,over,7.5,0.5412844036697247,-118,0.5189377998484975,CWS,NYY,2022 REG,4,1,2,5,6,6,0,1,-4,4,1,0,0,0,0,0,0,0,0,0.5189377998484975,0.4810622001515025
87439,0.49504950495049505,0.5433789954337899,102,-119,0.47602549485926493,0.5239745051407351,home,CWS,under,7.5,0.5,100,0.4810622001515025,CWS,NYY,2022 REG,4,1,2,5,6,6,0,1,-4,4,1,0,0,0,0,0,0,0,0,0.5189377998484975,0.4810622001515025
87440,0.49504950495049505,0.5454545454545454,102,-120,0.47499799484898986,0.5250020051510101,away,TOR,over,9,0.5121951219512195,-105,0.48808156828023186,BOS,TOR,2022 REG,10,5,29,28,33,39,0,1,-23,23,1,1,1,1,1,0,0,0,0,0.48808156828023186,0.5119184317197681
87440,0.49504950495049505,0.5454545454545454,102,-120,0.47499799484898986,0.5250020051510101,home,BOS,under,9,0.5348837209302326,-115,0.5119184317197681,BOS,TOR,2022 REG,10,5,29,28,33,39,0,1,-23,23,1,1,1,1,1,0,0,0,0,0.48808156828023186,0.5119184317197681
87441,0.5535714285714286,0.4854368932038835,-124,106,0.5319775361600951,0.46802246383990487,away,HOU,over,8.5,0.5454545454545454,-120,0.5220180091279142,LAA,HOU,2022 REG,4,1,8,3,4,12,0,1,-2,2,1,0,0,0,0,0,0,0,0,0.5220180091279142,0.4779819908720858
87441,0.5535714285714286,0.4854368932038835,-124,106,0.5319775361600951,0.46802246383990487,home,LAA,under,8.5,0.49751243781094534,101,0.4779819908720858,LAA,HOU,2022 REG,4,1,8,3,4,12,0,1,-2,2,1,0,0,0,0,0,0,0,0,0.5220180091279142,0.4779819908720858
87442,0.6923076923076923,0.35460992907801414,-225,182,0.6598262621175878,0.34017373788241223,away,WSH,over,7.5,0.5348837209302326,-115,0.5097020142727117,CHC,WSH,2022 REG,15,5,9,6,11,24,0,1,-1,1,1,1,1,1,1,0,0,0,0,0.5097020142727117,0.49029798572728833
87442,0.6923076923076923,0.35460992907801414,-225,182,0.6598262621175878,0.34017373788241223,home,CHC,under,7.5,0.5121951219512195,-105,0.49029798572728833,CHC,WSH,2022 REG,15,5,9,6,11,24,0,1,-1,1,1,1,1,1,1,0,0,0,0,0.5097020142727117,0.49029798572728833
87443,0.5535714285714286,0.48309178743961345,-124,107,0.5332757197081732,0.4667242802918268,away,HOU,over,8.5,0.5412844036697247,-118,0.5162581740877563,BOS,HOU,2022 REG,8,6,7,3,9,15,1,0,3,-3,1,1,1,0,0,0,0,0,0,0.5162581740877563,0.4837418259122437
87443,0.5535714285714286,0.48309178743961345,-124,107,0.5332757197081732,0.4667242802918268,home,BOS,under,8.5,0.504950495049505,-102,0.4837418259122437,BOS,HOU,2022 REG,8,6,7,3,9,15,1,0,3,-3,1,1,1,0,0,0,0,0,0,0.5162581740877563,0.4837418259122437
87444,0.6254681647940076,0.41152263374485604,-167,143,0.6023315979176397,0.3976684020823603,away,TB,over,7.5,0.5,100,0.4772727272727273,HOU,TB,2022 REG,10,3,6,1,4,16,1,0,2,-2,1,0,0,0,0,0,0,0,0,0.4772727272727273,0.5227272727272727
87444,0.6254681647940076,0.41152263374485604,-167,143,0.6023315979176397,0.3976684020823603,home,HOU,under,7.5,0.5454545454545454,-120,0.5227272727272727,HOU,TB,2022 REG,10,3,6,1,4,16,1,0,2,-2,1,0,0,0,0,0,0,0,0,0.4772727272727273,0.5227272727272727
87445,0.5780590717299579,0.4587155963302753,-137,118,0.5568011412478822,0.44319885875211784,away,CIN,over,6.5,0.5145631067961165,-106,0.4913668392989033,CHC,CIN,2022 REG,3,2,4,1,3,7,1,0,1,-1,1,0,0,0,0,0,0,0,0,0.4913668392989033,0.5086331607010968
87445,0.5780590717299579,0.4587155963302753,-137,118,0.5568011412478822,0.44319885875211784,home,CHC,under,6.5,0.5305164319248826,-113,0.5086331607010968,CHC,CIN,2022 REG,3,2,4,1,3,7,1,0,1,-1,1,0,0,0,0,0,0,0,0,0.4913668392989033,0.5086331607010968
87446,0.425531914893617,0.6108949416342413,135,-157,0.41003112488176247,0.5899688751182375,away,TB,over,9,0.5348837209302326,-115,0.5109810284308424,BAL,TB,2022 REG,10,7,12,6,13,22,1,0,1,-1,1,1,1,1,1,1,0,0,0,0.5109810284308424,0.48901897156915763
87446,0.425531914893617,0.6108949416342413,135,-157,0.41003112488176247,0.5899688751182375,home,BAL,under,9,0.5098039215686274,-104,0.48901897156915763,BAL,TB,2022 REG,10,7,12,6,13,22,1,0,1,-1,1,1,1,1,1,1,0,0,0,0.5109810284308424,0.48901897156915763
87447,0.4166666666666667,0.6226415094339623,140,-165,0.4002882599580712,0.5997117400419287,away,STL,over,10.5,0.5098039215686274,-104,0.4870219861770517,CIN,STL,2022 REG,6,3,13,6,9,19,0,1,-3,3,1,1,1,0,0,0,0,0,0,0.4870219861770517,0.5129780138229483
87447,0.4166666666666667,0.6226415094339623,140,-165,0.4002882599580712,0.5997117400419287,home,CIN,under,10.5,0.5348837209302326,-115,0.5129780138229483,CIN,STL,2022 REG,6,3,13,6,9,19,0,1,-3,3,1,1,1,0,0,0,0,0,0,0.4870219861770517,0.5129780138229483
87448,0.5121951219512195,0.5348837209302326,-105,-115,0.48808156828023186,0.5119184317197681,away,ARI,over,8,0.5098039215686274,-104,0.4870219861770517,CHC,ARI,2022 REG,4,1,6,3,4,10,0,1,-2,2,1,0,0,0,0,0,0,0,0,0.4870219861770517,0.5129780138229483
87448,0.5121951219512195,0.5348837209302326,-105,-115,0.48808156828023186,0.5119184317197681,home,CHC,under,8,0.5348837209302326,-115,0.5129780138229483,CHC,ARI,2022 REG,4,1,6,3,4,10,0,1,-2,2,1,0,0,0,0,0,0,0,0,0.4870219861770517,0.5129780138229483
87449,0.4081632653061224,0.6363636363636364,145,-175,0.3899890197266291,0.6100109802733709,away,SD,over,8.5,0.5169082125603864,-107,0.49353874091423283,CIN,SD,2022 REG,10,5,8,8,13,18,0,1,-3,3,1,1,1,1,1,0,0,0,0,0.49353874091423283,0.5064612590857671
87449,0.4081632653061224,0.6363636363636364,145,-175,0.3899890197266291,0.6100109802733709,home,CIN,under,8.5,0.5283018867924528,-112,0.5064612590857671,CIN,SD,2022 REG,10,5,8,8,13,18,0,1,-3,3,1,1,1,1,1,0,0,0,0,0.49353874091423283,0.5064612590857671
87450,0.7630331753554502,0.2801120448179272,-322,257,0.7301119410051481,0.2698880589948519,away,WSH,over,8.5,0.5121951219512195,-105,0.48808156828023186,LAD,WSH,2022 REG,8,1,8,4,5,16,0,1,-3,3,1,0,0,0,0,0,0,0,0,0.48808156828023186,0.5119184317197681
87450,0.7630331753554502,0.2801120448179272,-322,257,0.7301119410051481,0.2698880589948519,home,LAD,under,8.5,0.5348837209302326,-115,0.5119184317197681,LAD,WSH,2022 REG,8,1,8,4,5,16,0,1,-3,3,1,0,0,0,0,0,0,0,0,0.48808156828023186,0.5119184317197681
87451,0.5348837209302326,0.5073891625615764,-115,-103,0.5122726437136835,0.48772735628631647,away,TEX,over,10.5,0.5169082125603864,-107,0.49353874091423283,COL,TEX,2022 REG,12,7,9,6,13,21,1,0,1,-1,1,1,1,1,1,1,0,0,0,0.49353874091423283,0.5064612590857671
87451,0.5348837209302326,0.5073891625615764,-115,-103,0.5122726437136835,0.48772735628631647,home,COL,under,10.5,0.5283018867924528,-112,0.5064612590857671,COL,TEX,2022 REG,12,7,9,6,13,21,1,0,1,-1,1,1,1,1,1,1,0,0,0,0.49353874091423283,0.5064612590857671
87452,0.3484320557491289,0.6941896024464832,187,-227,0.3335813037645951,0.6664186962354048,away,LAD,over,11,0.5391705069124424,-117,0.5064419904850848,COL,LAD,2022 REG,10,5,7,3,8,17,1,0,2,-2,1,1,1,0,0,0,0,0,0,0.5064419904850848,0.49355800951491524
87452,0.3484320557491289,0.6941896024464832,187,-227,0.3335813037645951,0.6664186962354048,home,COL,under,11,0.5215311004784688,-109,0.49355800951491524,COL,LAD,2022 REG,10,5,7,3,8,17,1,0,2,-2,1,1,1,0,0,0,0,0,0,0.5064419904850848,0.49355800951491524
87453,0.4926108374384236,0.5495495495495495,103,-122,0.4718421738975501,0.5281578261024499,away,HOU,over,8.5,0.5121951219512195,-105,0.48808156828023186,CWS,HOU,2022 REG,9,4,7,2,6,16,1,0,2,-2,1,1,0,0,0,0,0,0,0,0.48808156828023186,0.5119184317197681
87453,0.4926108374384236,0.5495495495495495,103,-122,0.4718421738975501,0.5281578261024499,home,CWS,under,8.5,0.5348837209302326,-115,0.5119184317197681,CWS,HOU,2022 REG,9,4,7,2,6,16,1,0,2,-2,1,1,0,0,0,0,0,0,0,0.48808156828023186,0.5119184317197681
87454,0.36764705882352944,0.6666666666666666,172,-200,0.35503171856978094,0.6449682814302191,away,LAD,over,6.5,0.5283018867924528,-112,0.5044173060022736,MIA,LAD,2022 REG,5,2,6,1,3,11,1,0,1,-1,1,0,0,0,0,0,0,0,0,0.5044173060022736,0.49558269399772636
87454,0.36764705882352944,0.6666666666666666,172,-200,0.35503171856978094,0.6449682814302191,home,MIA,under,6.5,0.5169082125603864,-107,0.49558269399772636,MIA,LAD,2022 REG,5,2,6,1,3,11,1,0,1,-1,1,0,0,0,0,0,0,0,0,0.5044173060022736,0.49558269399772636
87455,0.390625,0.6503496503496503,156,-186,0.3746192772071678,0.6253807227928322,away,NYM,over,8.5,0.5348837209302326,-115,0.5097020142727117,WSH,NYM,2022 REG,8,2,8,4,6,16,0,1,-2,2,1,1,0,0,0,0,0,0,0,0.5097020142727117,0.49029798572728833
87455,0.390625,0.6503496503496503,156,-186,0.3746192772071678,0.6253807227928322,home,WSH,under,8.5,0.5121951219512195,-105,0.49029798572728833,WSH,NYM,2022 REG,8,2,8,4,6,16,0,1,-2,2,1,1,0,0,0,0,0,0,0,0.5097020142727117,0.49029798572728833
87456,0.607843137254902,0.4347826086956522,-155,130,0.5819333701084867,0.41806662989151333,away,TB,over,7.5,0.49504950495049505,102,0.4739797934813417,MIL,TB,2022 REG,7,4,5,3,7,12,1,0,1,-1,1,1,1,0,0,0,0,0,0,0.4739797934813417,0.5260202065186583
87456,0.607843137254902,0.4347826086956522,-155,130,0.5819333701084867,0.41806662989151333,home,MIL,under,7.5,0.5475113122171946,-121,0.5260202065186583,MIL,TB,2022 REG,7,4,5,3,7,12,1,0,1,-1,1,1,1,0,0,0,0,0,0,0.4739797934813417,0.5260202065186583
87457,0.6666666666666666,0.37037037037037035,-200,170,0.6419753086419753,0.3580246913580247,away,MIN,over,9,0.5121951219512195,-105,0.48919479393107135,LAD,MIN,2022 REG,10,8,8,5,13,18,1,0,3,-3,1,1,1,1,1,0,0,0,0,0.48919479393107135,0.5108052060689287
87457,0.6666666666666666,0.37037037037037035,-200,170,0.6419753086419753,0.3580246913580247,home,LAD,under,9,0.5327102803738317,-114,0.5108052060689287,LAD,MIN,2022 REG,10,8,8,5,13,18,1,0,3,-3,1,1,1,1,1,0,0,0,0,0.48919479393107135,0.5108052060689287
87458,0.41152263374485604,0.6296296296296295,143,-170,0.39458754593642575,0.6054124540635742,away,MIL,over,9,0.5348837209302326,-115,0.5097020142727117,BOS,MIL,2022 REG,7,1,8,4,5,15,0,1,-3,3,1,0,0,0,0,0,0,0,0,0.5097020142727117,0.49029798572728833
87458,0.41152263374485604,0.6296296296296295,143,-170,0.39458754593642575,0.6054124540635742,home,BOS,under,9,0.5121951219512195,-105,0.49029798572728833,BOS,MIL,2022 REG,7,1,8,4,5,15,0,1,-3,3,1,0,0,0,0,0,0,0,0,0.5097020142727117,0.49029798572728833
87459,0.6551724137931035,0.3846153846153846,-190,160,0.6291045458703008,0.37089545412969915,away,BAL,over,9,0.5121951219512195,-105,0.48808156828023186,LAA,BAL,2022 REG,7,7,9,6,13,16,1,0,1,-1,1,1,1,1,1,1,0,0,0,0.48808156828023186,0.5119184317197681
87459,0.6551724137931035,0.3846153846153846,-190,160,0.6291045458703008,0.37089545412969915,home,LAA,under,9,0.5348837209302326,-115,0.5119184317197681,LAA,BAL,2022 REG,7,7,9,6,13,16,1,0,1,-1,1,1,1,1,1,1,0,0,0,0.48808156828023186,0.5119184317197681
87460,0.425531914893617,0.609375,135,-156,0.4106779085559077,0.5893220914440923,away,STL,over,7,0.5348837209302326,-115,0.5097020142727117,PIT,STL,2022 REG,5,3,7,2,5,12,1,0,1,-1,1,1,0,0,0,0,0,0,0,0.5097020142727117,0.49029798572728833
87460,0.425531914893617,0.609375,135,-156,0.4106779085559077,0.5893220914440923,home,PIT,under,7,0.5121951219512195,-105,0.49029798572728833,PIT,STL,2022 REG,5,3,7,2,5,12,1,0,1,-1,1,1,0,0,0,0,0,0,0,0.5097020142727117,0.49029798572728833
87461,0.6240601503759399,0.4132231404958678,-166,142,0.6007931342679697,0.39920686573203035,away,CLE,over,8.5,0.5098039215686274,-104,0.48592421718142587,LAA,CLE,2022 REG,6,4,4,1,5,10,1,0,3,-3,1,0,0,0,0,0,0,0,0,0.48592421718142587,0.5140757828185741
87461,0.6240601503759399,0.4132231404958678,-166,142,0.6007931342679697,0.39920686573203035,home,LAA,under,8.5,0.5370370370370371,-116,0.5140757828185741,LAA,CLE,2022 REG,6,4,4,1,5,10,1,0,3,-3,1,0,0,0,0,0,0,0,0,0.48592421718142587,0.5140757828185741
87462,0.4081632653061224,0.6363636363636364,145,-175,0.3899890197266291,0.6100109802733709,away,HOU,over,8,0.5238095238095238,-110,0.4988662131519274,TEX,HOU,2022 REG,5,2,3,3,5,8,0,1,-1,1,1,1,0,0,0,0,0,0,0,0.4988662131519274,0.5011337868480725
87462,0.4081632653061224,0.6363636363636364,145,-175,0.3899890197266291,0.6100109802733709,home,TEX,under,8,0.5238095238095238,-110,0.5011337868480725,TEX,HOU,2022 REG,5,2,3,3,5,8,0,1,-1,1,1,1,0,0,0,0,0,0,0,0.4988662131519274,0.5011337868480725
87463,0.5833333333333333,0.45454545454545453,-140,120,0.5612373737373737,0.4387626262626263,away,MIN,over,7.5,0.5348837209302326,-115,0.5097020142727117,CWS,MIN,2022 REG,8,8,3,3,11,11,1,0,5,-5,1,1,1,0,0,0,0,0,0,0.5097020142727117,0.49029798572728833
87463,0.5833333333333333,0.45454545454545453,-140,120,0.5612373737373737,0.4387626262626263,home,CWS,under,7.5,0.5121951219512195,-105,0.49029798572728833,CWS,MIN,2022 REG,8,8,3,3,11,11,1,0,5,-5,1,1,1,0,0,0,0,0,0,0.5097020142727117,0.49029798572728833
87464,0.6282527881040892,0.41152263374485604,-169,143,0.603263768429473,0.39673623157052695,away,SD,over,8.5,0.5348837209302326,-115,0.5097020142727117,LAD,SD,2022 REG,12,8,4,1,9,16,1,0,7,-7,1,0,0,0,0,0,0,0,0,0.5097020142727117,0.49029798572728833
87464,0.6282527881040892,0.41152263374485604,-169,143,0.603263768429473,0.39673623157052695,home,LAD,under,8.5,0.5121951219512195,-105,0.49029798572728833,LAD,SD,2022 REG,12,8,4,1,9,16,1,0,7,-7,1,0,0,0,0,0,0,0,0,0.5097020142727117,0.49029798572728833
87465,0.6666666666666666,0.37453183520599254,-200,167,0.6392009987515606,0.36079900124843944,away,OAK,over,8,0.5391705069124424,-117,0.5153817639191344,CWS,OAK,2022 REG,6,3,9,7,10,15,0,1,-4,4,1,1,1,0,0,0,0,0,0,0.5153817639191344,0.4846182360808656
87465,0.6666666666666666,0.37453183520599254,-200,167,0.6392009987515606,0.36079900124843944,home,CWS,under,8,0.504950495049505,-102,0.4846182360808656,CWS,OAK,2022 REG,6,3,9,7,10,15,0,1,-4,4,1,1,1,0,0,0,0,0,0,0.5153817639191344,0.4846182360808656
87466,0.6551724137931035,0.3846153846153846,-190,160,0.6291045458703008,0.37089545412969915,away,KC,over,8.5,0.5098039215686274,-104,0.48592421718142587,MIN,KC,2022 REG,11,4,8,2,6,19,1,0,2,-2,1,1,0,0,0,0,0,0,0,0.48592421718142587,0.5140757828185741
87466,0.6551724137931035,0.3846153846153846,-190,160,0.6291045458703008,0.37089545412969915,home,MIN,under,8.5,0.5370370370370371,-116,0.5140757828185741,MIN,KC,2022 REG,11,4,8,2,6,19,1,0,2,-2,1,1,0,0,0,0,0,0,0,0.48592421718142587,0.5140757828185741
87467,0.4166666666666667,0.6226415094339623,140,-165,0.4002882599580712,0.5997117400419287,away,PHI,over,8,0.5412844036697247,-118,0.5189377998484975,CIN,PHI,2022 REG,6,1,5,0,1,11,1,0,1,-1,0,0,0,0,0,0,0,0,0,0.5189377998484975,0.4810622001515025
87467,0.4166666666666667,0.6226415094339623,140,-165,0.4002882599580712,0.5997117400419287,home,CIN,under,8,0.5,100,0.4810622001515025,CIN,PHI,2022 REG,6,1,5,0,1,11,1,0,1,-1,0,0,0,0,0,0,0,0,0,0.5189377998484975,0.4810622001515025
87468,0.5475113122171946,0.49751243781094534,-121,101,0.5228602997583487,0.4771397002416513,away,PHI,over,7.5,0.5,100,0.4772727272727273,HOU,PHI,2022 REG,2,0,9,3,3,11,0,1,-3,3,0,0,0,0,0,0,0,0,0,0.4772727272727273,0.5227272727272727
87468,0.5475113122171946,0.49751243781094534,-121,101,0.5228602997583487,0.4771397002416513,home,HOU,under,7.5,0.5454545454545454,-120,0.5227272727272727,HOU,PHI,2022 REG,2,0,9,3,3,11,0,1,-3,3,0,0,0,0,0,0,0,0,0,0.4772727272727273,0.5227272727272727
87469,0.48780487804878053,0.5555555555555556,105,-125,0.4666534470222751,0.5333465529777248,away,HOU,over,9,0.5121951219512195,-105,0.48808156828023186,TEX,HOU,2022 REG,8,3,5,4,7,13,0,1,-1,1,1,1,1,0,0,0,0,0,0,0.48808156828023186,0.5119184317197681
87469,0.48780487804878053,0.5555555555555556,105,-125,0.4666534470222751,0.5333465529777248,home,TEX,under,9,0.5348837209302326,-115,0.5119184317197681,TEX,HOU,2022 REG,8,3,5,4,7,13,0,1,-1,1,1,1,1,0,0,0,0,0,0,0.48808156828023186,0.5119184317197681
87470,0.607843137254902,0.4366812227074236,-155,129,0.5807793106111354,0.4192206893888646,away,NYM,over,9,0.5454545454545454,-120,0.5206611570247933,PHI,NYM,2022 REG,8,5,7,4,9,15,1,0,1,-1,1,1,1,1,0,0,0,0,0,0.5206611570247933,0.4793388429752067
87470,0.607843137254902,0.4366812227074236,-155,129,0.5807793106111354,0.4192206893888646,home,PHI,under,9,0.5,100,0.4793388429752067,PHI,NYM,2022 REG,8,5,7,4,9,15,1,0,1,-1,1,1,1,1,0,0,0,0,0,0.5206611570247933,0.4793388429752067
87471,0.7142857142857143,0.3225806451612903,-250,210,0.6879526003949967,0.3120473996050033,away,PHI,over,8,0.5121951219512195,-105,0.48919479393107135,ATL,PHI,2022 REG,10,5,4,2,7,14,1,0,3,-3,1,1,0,0,0,0,0,0,0,0.48919479393107135,0.5108052060689287
87471,0.7142857142857143,0.3225806451612903,-250,210,0.6879526003949967,0.3120473996050033,home,ATL,under,8,0.5327102803738317,-114,0.5108052060689287,ATL,PHI,2022 REG,10,5,4,2,7,14,1,0,3,-3,1,1,0,0,0,0,0,0,0,0.48919479393107135,0.5108052060689287
87472,0.5433789954337899,0.49751243781094534,-119,101,0.5211594495154178,0.4788405504845822,away,PHI,over,7.5,0.5145631067961165,-106,0.4913668392989033,SEA,PHI,2022 REG,4,0,17,9,9,21,0,1,-9,9,0,0,0,0,0,0,0,0,0,0.4913668392989033,0.5086331607010968
87472,0.5433789954337899,0.49751243781094534,-119,101,0.5211594495154178,0.4788405504845822,home,SEA,under,7.5,0.5305164319248826,-113,0.5086331607010968,SEA,PHI,2022 REG,4,0,17,9,9,21,0,1,-9,9,0,0,0,0,0,0,0,0,0,0.4913668392989033,0.5086331607010968
87473,0.5283018867924528,0.5121951219512195,-112,-105,0.5069072406637203,0.4930927593362797,away,SF,over,9,0.504950495049505,-102,0.4826715732667395,MIN,SF,2022 REG,11,8,10,3,11,21,1,0,5,-5,1,1,1,0,0,0,0,0,0,0.4826715732667395,0.5173284267332605
87473,0.5283018867924528,0.5121951219512195,-112,-105,0.5069072406637203,0.4930927593362797,home,MIN,under,9,0.5391705069124424,-117,0.5173284267332605,MIN,SF,2022 REG,11,8,10,3,11,21,1,0,5,-5,1,1,1,0,0,0,0,0,0,0.4826715732667395,0.5173284267332605
87474,0.5475113122171946,0.49019607843137253,-121,104,0.5268660892829112,0.47313391071708877,away,MIL,over,8,0.5327102803738317,-114,0.508788710910954,PHI,MIL,2022 REG,10,4,5,2,6,15,1,0,2,-2,1,1,0,0,0,0,0,0,0,0.508788710910954,0.491211289089046
87474,0.5475113122171946,0.49019607843137253,-121,104,0.5268660892829112,0.47313391071708877,home,PHI,under,8,0.5121951219512195,-105,0.491211289089046,PHI,MIL,2022 REG,10,4,5,2,6,15,1,0,2,-2,1,1,0,0,0,0,0,0,0,0.508788710910954,0.491211289089046
87475,0.47619047619047616,0.5652173913043479,110,-130,0.4564724440500838,0.5435275559499162,away,CLE,over,8,0.5121951219512195,-105,0.48808156828023186,TEX,CLE,2022 REG,7,2,6,4,6,13,0,1,-2,2,1,1,0,0,0,0,0,0,0,0.48808156828023186,0.5119184317197681
87475,0.47619047619047616,0.5652173913043479,110,-130,0.4564724440500838,0.5435275559499162,home,TEX,under,8,0.5348837209302326,-115,0.5119184317197681,TEX,CLE,2022 REG,7,2,6,4,6,13,0,1,-2,2,1,1,0,0,0,0,0,0,0,0.48808156828023186,0.5119184317197681
87476,0.4854368932038835,0.5594713656387665,106,-127,0.4636367675521117,0.5363632324478883,away,NYM,over,8.5,0.5121951219512195,-105,0.48808156828023186,ARI,NYM,2022 REG,8,5,9,6,11,17,0,1,-1,1,1,1,1,1,1,0,0,0,0,0.48808156828023186,0.5119184317197681
87476,0.4854368932038835,0.5594713656387665,106,-127,0.4636367675521117,0.5363632324478883,home,ARI,under,8.5,0.5348837209302326,-115,0.5119184317197681,ARI,NYM,2022 REG,8,5,9,6,11,17,0,1,-1,1,1,1,1,1,1,0,0,0,0,0.48808156828023186,0.5119184317197681
87477,0.6183206106870228,0.41493775933609955,-162,141,0.5977562750238709,0.40224372497612915,away,CHC,over,7,0.5192307692307692,-108,0.49688292476754015,SD,CHC,2022 REG,3,0,11,6,6,14,0,1,-6,6,0,0,0,0,0,0,0,0,0,0.49688292476754015,0.5031170752324599
87477,0.6183206106870228,0.41493775933609955,-162,141,0.5977562750238709,0.40224372497612915,home,SD,under,7,0.5238095238095238,-110,0.5031170752324599,SD,CHC,2022 REG,3,0,11,6,6,14,0,1,-6,6,0,0,0,0,0,0,0,0,0,0.49688292476754015,0.5031170752324599
87478,0.42194092827004215,0.6108949416342413,137,-157,0.40808613084207446,0.5919138691579255,away,NYM,over,6.5,0.5370370370370371,-116,0.5118817074154765,STL,NYM,2022 REG,5,2,9,5,7,14,0,1,-3,3,1,1,0,0,0,0,0,0,0,0.5118817074154765,0.48811829258452355
87478,0.42194092827004215,0.6108949416342413,137,-157,0.40808613084207446,0.5919138691579255,home,STL,under,6.5,0.5098039215686274,-104,0.48811829258452355,STL,NYM,2022 REG,5,2,9,5,7,14,0,1,-3,3,1,1,0,0,0,0,0,0,0,0.5118817074154765,0.48811829258452355
87479,0.7014925373134329,0.3412969283276451,-235,193,0.6714760464905872,0.32852395350941277,away,ARI,over,8.5,0.5073891625615764,-103,0.4837652908580103,SD,ARI,2022 REG,4,0,7,5,5,11,0,1,-5,5,0,0,0,0,0,0,0,0,0,0.4837652908580103,0.5162347091419897
87479,0.7014925373134329,0.3412969283276451,-235,193,0.6714760464905872,0.32852395350941277,home,SD,under,8.5,0.5391705069124424,-117,0.5162347091419897,SD,ARI,2022 REG,4,0,7,5,5,11,0,1,-5,5,0,0,0,0,0,0,0,0,0,0.4837652908580103,0.5162347091419897
87480,0.4716981132075471,0.5689655172413793,112,-132,0.45251715544861953,0.5474828445513804,away,SF,over,8.5,0.5145631067961165,-106,0.4913668392989033,ARI,SF,2022 REG,8,5,6,7,12,14,0,1,-2,2,1,1,1,1,1,0,0,0,0,0.4913668392989033,0.5086331607010968
87480,0.4716981132075471,0.5689655172413793,112,-132,0.45251715544861953,0.5474828445513804,home,ARI,under,8.5,0.5305164319248826,-113,0.5086331607010968,ARI,SF,2022 REG,8,5,6,7,12,14,0,1,-2,2,1,1,1,1,1,0,0,0,0,0.4913668392989033,0.5086331607010968
87481,0.4166666666666667,0.6226415094339623,140,-165,0.4002882599580712,0.5997117400419287,away,LAA,over,7,0.5098039215686274,-104,0.48592421718142587,MIA,LAA,2022 REG,3,2,9,5,7,12,0,1,-3,3,1,1,0,0,0,0,0,0,0,0.48592421718142587,0.5140757828185741
87481,0.4166666666666667,0.6226415094339623,140,-165,0.4002882599580712,0.5997117400419287,home,MIA,under,7,0.5370370370370371,-116,0.5140757828185741,MIA,LAA,2022 REG,3,2,9,5,7,12,0,1,-3,3,1,1,0,0,0,0,0,0,0,0.48592421718142587,0.5140757828185741
87482,0.4444444444444444,0.5967741935483871,125,-148,0.42612504978096366,0.5738749502190363,away,HOU,over,8,0.5145631067961165,-106,0.4925063625223866,SEA,HOU,2022 REG,5,1,6,2,3,11,0,1,-1,1,1,0,0,0,0,0,0,0,0,0.4925063625223866,0.5074936374776133
87482,0.4444444444444444,0.5967741935483871,125,-148,0.42612504978096366,0.5738749502190363,home,SEA,under,8,0.5283018867924528,-112,0.5074936374776133,SEA,HOU,2022 REG,5,1,6,2,3,11,0,1,-1,1,1,0,0,0,0,0,0,0,0,0.4925063625223866,0.5074936374776133
87483,0.6254681647940076,0.41493775933609955,-167,141,0.6001955455815435,0.39980445441845647,away,CIN,over,10,0.5305164319248826,-113,0.5066009958897986,ATL,CIN,2022 REG,8,2,3,1,3,11,1,0,1,-1,1,0,0,0,0,0,0,0,0,0.5066009958897986,0.49339900411020143
87483,0.6254681647940076,0.41493775933609955,-167,141,0.6001955455815435,0.39980445441845647,home,ATL,under,10,0.5145631067961165,-106,0.49339900411020143,ATL,CIN,2022 REG,8,2,3,1,3,11,1,0,1,-1,1,0,0,0,0,0,0,0,0,0.5066009958897986,0.49339900411020143
87484,0.6875,0.35714285714285715,-220,180,0.6568080357142857,0.3431919642857143,away,CIN,over,7.5,0.5348837209302326,-115,0.5109810284308424,STL,CIN,2022 REG,5,1,3,0,1,8,1,0,1,-1,0,0,0,0,0,0,0,0,0,0.5109810284308424,0.48901897156915763
87484,0.6875,0.35714285714285715,-220,180,0.6568080357142857,0.3431919642857143,home,STL,under,7.5,0.5098039215686274,-104,0.48901897156915763,STL,CIN,2022 REG,5,1,3,0,1,8,1,0,1,-1,0,0,0,0,0,0,0,0,0,0.5109810284308424,0.48901897156915763
87485,0.6845425867507886,0.3508771929824561,-217,185,0.6602962391100501,0.3397037608899499,away,KC,over,8,0.5098039215686274,-104,0.4870219861770517,LAA,KC,2022 REG,8,5,2,0,5,10,1,0,5,-5,0,0,0,0,0,0,0,0,0,0.4870219861770517,0.5129780138229483
87485,0.6845425867507886,0.3508771929824561,-217,185,0.6602962391100501,0.3397037608899499,home,LAA,under,8,0.5348837209302326,-115,0.5129780138229483,LAA,KC,2022 REG,8,5,2,0,5,10,1,0,5,-5,0,0,0,0,0,0,0,0,0,0.4870219861770517,0.5129780138229483
87486,0.29673590504451036,0.7402597402597403,237,-285,0.28575796875244786,0.7142420312475521,away,LAD,over,7.5,0.5454545454545454,-120,0.5206611570247933,MIA,LAD,2022 REG,8,6,16,10,16,24,0,1,-4,4,1,1,1,1,1,1,0,0,0,0.5206611570247933,0.4793388429752067
87486,0.29673590504451036,0.7402597402597403,237,-285,0.28575796875244786,0.7142420312475521,home,MIA,under,7.5,0.5,100,0.4793388429752067,MIA,LAD,2022 REG,8,6,16,10,16,24,0,1,-4,4,1,1,1,1,1,1,0,0,0,0.5206611570247933,0.4793388429752067
87487,0.7118155619596541,0.3278688524590164,-247,205,0.6835675782091883,0.31643242179081166,away,WSH,over,8,0.504950495049505,-102,0.4837488699364985,STL,WSH,2022 REG,8,4,7,1,5,15,1,0,3,-3,1,0,0,0,0,0,0,0,0,0.4837488699364985,0.5162511300635015
87487,0.7118155619596541,0.3278688524590164,-247,205,0.6835675782091883,0.31643242179081166,home,STL,under,8,0.5370370370370371,-116,0.5162511300635015,STL,WSH,2022 REG,8,4,7,1,5,15,1,0,3,-3,1,0,0,0,0,0,0,0,0,0.4837488699364985,0.5162511300635015
87488,0.7142857142857143,0.32573289902280134,-250,207,0.6857009904939174,0.3142990095060826,away,PIT,over,8.5,0.5391705069124424,-117,0.5140669063204599,LAD,PIT,2022 REG,12,4,9,8,12,21,0,1,-4,4,1,1,1,1,0,0,0,0,0,0.5140669063204599,0.4859330936795401
87488,0.7142857142857143,0.32573289902280134,-250,207,0.6857009904939174,0.3142990095060826,home,LAD,under,8.5,0.5073891625615764,-103,0.4859330936795401,LAD,PIT,2022 REG,12,4,9,8,12,21,0,1,-4,4,1,1,1,1,0,0,0,0,0,0.5140669063204599,0.4859330936795401
87489,0.4166666666666667,0.6183206106870228,140,-162,0.40208863443596277,0.5979113655640372,away,CWS,over,7.5,0.5238095238095238,-110,0.5012646084074657,OAK,CWS,2022 REG,14,10,4,3,13,18,1,0,7,-7,1,1,1,0,0,0,0,0,0,0.5012646084074657,0.4987353915925343
87489,0.4166666666666667,0.6183206106870228,140,-162,0.40208863443596277,0.5979113655640372,home,OAK,under,7.5,0.5192307692307692,-108,0.4987353915925343,OAK,CWS,2022 REG,14,10,4,3,13,18,1,0,7,-7,1,1,1,0,0,0,0,0,0,0.5012646084074657,0.4987353915925343
87490,0.6000000000000001,0.4347826086956522,-150,130,0.5791304347826086,0.4208695652173914,away,NYM,over,8.5,0.5238095238095238,-110,0.5012646084074657,PHI,NYM,2022 REG,7,2,10,8,10,17,0,1,-6,6,1,1,0,0,0,0,0,0,0,0.5012646084074657,0.4987353915925343
87490,0.6000000000000001,0.4347826086956522,-150,130,0.5791304347826086,0.4208695652173914,home,PHI,under,8.5,0.5192307692307692,-108,0.4987353915925343,PHI,NYM,2022 REG,7,2,10,8,10,17,0,1,-6,6,1,1,0,0,0,0,0,0,0,0.5012646084074657,0.4987353915925343
87491,0.3861003861003861,0.6587030716723549,159,-193,0.36880175375569846,0.6311982462443015,away,LAD,over,8,0.5327102803738317,-114,0.508788710910954,ARI,LAD,2022 REG,2,3,5,1,4,7,1,0,2,-2,1,0,0,0,0,0,0,0,0,0.508788710910954,0.491211289089046
87491,0.3861003861003861,0.6587030716723549,159,-193,0.36880175375569846,0.6311982462443015,home,ARI,under,8,0.5121951219512195,-105,0.491211289089046,ARI,LAD,2022 REG,2,3,5,1,4,7,1,0,2,-2,1,0,0,0,0,0,0,0,0,0.508788710910954,0.491211289089046
87492,0.4,0.6363636363636364,150,-175,0.3854545454545455,0.6145454545454545,away,SF,over,8,0.5412844036697247,-118,0.5175913212324037,ARI,SF,2022 REG,11,5,10,6,11,21,0,1,-1,1,1,1,1,1,1,0,0,0,0,0.5175913212324037,0.4824086787675963
87492,0.4,0.6363636363636364,150,-175,0.3854545454545455,0.6145454545454545,home,ARI,under,8,0.5024875621890548,-101,0.4824086787675963,ARI,SF,2022 REG,11,5,10,6,11,21,0,1,-1,1,1,1,1,1,1,0,0,0,0,0.5175913212324037,0.4824086787675963
87493,0.3921568627450981,0.6453900709219857,155,-182,0.37743257503251615,0.6225674249674839,away,NYY,over,9,0.5475113122171946,-121,0.5228602997583487,BAL,NYY,2022 REG,8,0,13,6,6,21,0,1,-6,6,0,0,0,0,0,0,0,0,0,0.5228602997583487,0.4771397002416513
87493,0.3921568627450981,0.6453900709219857,155,-182,0.37743257503251615,0.6225674249674839,home,BAL,under,9,0.49751243781094534,101,0.4771397002416513,BAL,NYY,2022 REG,8,0,13,6,6,21,0,1,-6,6,0,0,0,0,0,0,0,0,0,0.5228602997583487,0.4771397002416513
87494,0.5348837209302326,0.5121951219512195,-115,-105,0.5097020142727117,0.49029798572728833,away,ATL,over,7,0.5238095238095238,-110,0.4988662131519274,NYM,ATL,2022 REG,9,3,7,0,3,16,1,0,3,-3,0,0,0,0,0,0,0,0,0,0.4988662131519274,0.5011337868480725
87494,0.5348837209302326,0.5121951219512195,-115,-105,0.5097020142727117,0.49029798572728833,home,NYM,under,7,0.5238095238095238,-110,0.5011337868480725,NYM,ATL,2022 REG,9,3,7,0,3,16,1,0,3,-3,0,0,0,0,0,0,0,0,0,0.4988662131519274,0.5011337868480725
87495,0.5689655172413793,0.4716981132075471,-132,112,0.5458293137100936,0.4541706862899064,away,SF,over,7.5,0.5121951219512195,-105,0.48919479393107135,NYM,SF,2022 REG,12,6,4,2,8,16,1,0,4,-4,1,1,0,0,0,0,0,0,0,0.48919479393107135,0.5108052060689287
87495,0.5689655172413793,0.4716981132075471,-132,112,0.5458293137100936,0.4541706862899064,home,NYM,under,7.5,0.5327102803738317,-114,0.5108052060689287,NYM,SF,2022 REG,12,6,4,2,8,16,1,0,4,-4,1,1,0,0,0,0,0,0,0,0.48919479393107135,0.5108052060689287
87496,0.6183206106870228,0.4166666666666667,-162,140,0.5966872559874133,0.40331274401258665,away,KC,over,10.5,0.5348837209302326,-115,0.5084354177277668,COL,KC,2022 REG,10,10,5,4,14,15,1,0,6,-6,1,1,1,1,0,0,0,0,0,0.5084354177277668,0.4915645822722332
87496,0.6183206106870228,0.4166666666666667,-162,140,0.5966872559874133,0.40331274401258665,away,KC,over,11.5,0.5121951219512195,-105,0.48808156828023186,COL,KC,2022 REG,10,10,5,4,14,15,1,0,6,-6,1,1,1,1,0,0,0,0,0,0.5084354177277668,0.4915645822722332
87496,0.6183206106870228,0.4166666666666667,-162,140,0.5966872559874133,0.40331274401258665,home,COL,under,10.5,0.5145631067961165,-106,0.4915645822722332,COL,KC,2022 REG,10,10,5,4,14,15,1,0,6,-6,1,1,1,1,0,0,0,0,0,0.5084354177277668,0.4915645822722332
87496,0.6183206106870228,0.4166666666666667,-162,140,0.5966872559874133,0.40331274401258665,home,COL,under,11.5,0.5348837209302326,-115,0.5119184317197681,COL,KC,2022 REG,10,10,5,4,14,15,1,0,6,-6,1,1,1,1,0,0,0,0,0,0.5084354177277668,0.4915645822722332
87497,0.40322580645161293,0.6363636363636364,148,-175,0.387262321445464,0.612737678554536,away,TOR,over,8.5,0.5121951219512195,-105,0.48808156828023186,BAL,TOR,2022 REG,8,3,14,7,10,22,0,1,-4,4,1,1,1,0,0,0,0,0,0,0.48808156828023186,0.5119184317197681
87497,0.40322580645161293,0.6363636363636364,148,-175,0.387262321445464,0.612737678554536,home,BAL,under,8.5,0.5348837209302326,-115,0.5119184317197681,BAL,TOR,2022 REG,8,3,14,7,10,22,0,1,-4,4,1,1,1,0,0,0,0,0,0,0.48808156828023186,0.5119184317197681
87498,0.726027397260274,0.3125,-265,220,0.6980554513041847,0.30194454869581533,away,CIN,over,7,0.5283018867924528,-112,0.5056562298022652,MIL,CIN,2022 REG,6,6,6,3,9,12,1,0,3,-3,1,1,1,0,0,0,0,0,0,0.5056562298022652,0.4943437701977348
87498,0.726027397260274,0.3125,-265,220,0.6980554513041847,0.30194454869581533,home,MIL,under,7,0.5145631067961165,-106,0.4943437701977348,MIL,CIN,2022 REG,6,6,6,3,9,12,1,0,3,-3,1,1,1,0,0,0,0,0,0,0.5056562298022652,0.4943437701977348
87499,0.601593625498008,0.4366812227074236,-151,129,0.5785677208007165,0.4214322791992835,away,OAK,over,9.5,0.5,100,0.4772727272727273,KC,OAK,2022 REG,8,3,6,1,4,14,1,0,2,-2,1,0,0,0,0,0,0,0,0,0.4772727272727273,0.5227272727272727
87499,0.601593625498008,0.4366812227074236,-151,129,0.5785677208007165,0.4214322791992835,home,KC,under,9.5,0.5454545454545454,-120,0.5227272727272727,KC,OAK,2022 REG,8,3,6,1,4,14,1,0,2,-2,1,0,0,0,0,0,0,0,0,0.4772727272727273,0.5227272727272727
87500,0.4081632653061224,0.6323529411764706,145,-172,0.39162603817037017,0.6083739618296298,away,STL,over,8,0.5192307692307692,-108,0.49455035168025013,CHC,STL,2022 REG,1,0,4,1,1,5,0,1,-1,1,0,0,0,0,0,0,0,0,0,0.49455035168025013,0.5054496483197499
87500,0.4081632653061224,0.6323529411764706,145,-172,0.39162603817037017,0.6083739618296298,home,CHC,under,8,0.5283018867924528,-112,0.5054496483197499,CHC,STL,2022 REG,1,0,4,1,1,5,0,1,-1,1,0,0,0,0,0,0,0,0,0,0.49455035168025013,0.5054496483197499
87501,0.5348837209302326,0.504950495049505,-115,-102,0.5135770472666521,0.4864229527333479,away,ARI,over,7.5,0.5412844036697247,-118,0.5189377998484975,PIT,ARI,2022 REG,10,6,10,8,14,20,0,1,-2,2,1,1,1,1,1,1,0,0,0,0.5189377998484975,0.4810622001515025
87501,0.5348837209302326,0.504950495049505,-115,-102,0.5135770472666521,0.4864229527333479,home,PIT,under,7.5,0.5,100,0.4810622001515025,PIT,ARI,2022 REG,10,6,10,8,14,20,0,1,-2,2,1,1,1,1,1,1,0,0,0,0.5189377998484975,0.4810622001515025
87502,0.3861003861003861,0.6539792387543253,159,-189,0.37062562746922334,0.6293743725307767,away,STL,over,7.5,0.5238095238095238,-110,0.5000596729920038,PIT,STL,2022 REG,10,5,11,7,12,21,0,1,-2,2,1,1,1,1,1,0,0,0,0,0.5000596729920038,0.4999403270079962
87502,0.3861003861003861,0.6539792387543253,159,-189,0.37062562746922334,0.6293743725307767,home,PIT,under,7.5,0.5215311004784688,-109,0.4999403270079962,PIT,STL,2022 REG,10,5,11,7,12,21,0,1,-2,2,1,1,1,1,1,0,0,0,0,0.5000596729920038,0.4999403270079962
87503,0.4807692307692307,0.5555555555555556,108,-125,0.4633053911900066,0.5366946088099934,away,CHC,over,8.5,0.5098039215686274,-104,0.48592421718142587,PIT,CHC,2022 REG,8,6,6,2,8,14,1,0,4,-4,1,1,0,0,0,0,0,0,0,0.48592421718142587,0.5140757828185741
87503,0.4807692307692307,0.5555555555555556,108,-125,0.4633053911900066,0.5366946088099934,home,PIT,under,8.5,0.5370370370370371,-116,0.5140757828185741,PIT,CHC,2022 REG,8,6,6,2,8,14,1,0,4,-4,1,1,0,0,0,0,0,0,0,0.48592421718142587,0.5140757828185741
87504,0.7142857142857143,0.3205128205128205,-250,212,0.6894296180010466,0.31057038199895337,away,COL,over,8.5,0.5238095238095238,-110,0.5000596729920038,NYM,COL,2022 REG,7,3,5,0,3,12,1,0,3,-3,0,0,0,0,0,0,0,0,0,0.5000596729920038,0.4999403270079962
87504,0.7142857142857143,0.3205128205128205,-250,212,0.6894296180010466,0.31057038199895337,home,NYM,under,8.5,0.5215311004784688,-109,0.4999403270079962,NYM,COL,2022 REG,7,3,5,0,3,12,1,0,3,-3,0,0,0,0,0,0,0,0,0,0.5000596729920038,0.4999403270079962
87505,0.5884773662551441,0.4587155963302753,-143,118,0.5607053759270989,0.4392946240729011,away,ARI,over,7.5,0.5391705069124424,-117,0.5114756747601454,CLE,ARI,2022 REG,6,3,9,6,9,15,0,1,-3,3,1,1,1,0,0,0,0,0,0,0.5114756747601454,0.48852432523985456
87505,0.5884773662551441,0.4587155963302753,-143,118,0.5607053759270989,0.4392946240729011,home,CLE,under,7.5,0.5121951219512195,-105,0.48852432523985456,CLE,ARI,2022 REG,6,3,9,6,9,15,0,1,-3,3,1,1,1,0,0,0,0,0,0,0.5114756747601454,0.48852432523985456
87506,0.5555555555555556,0.4854368932038835,-125,106,0.5327819729114227,0.4672180270885773,away,TOR,over,7.5,0.5412844036697247,-118,0.5136310900085983,SEA,TOR,2022 REG,7,6,10,5,11,17,1,0,1,-1,1,1,1,1,1,0,0,0,0,0.5136310900085983,0.4863689099914017
87506,0.5555555555555556,0.4854368932038835,-125,106,0.5327819729114227,0.4672180270885773,home,SEA,under,7.5,0.5098039215686274,-104,0.4863689099914017,SEA,TOR,2022 REG,7,6,10,5,11,17,1,0,1,-1,1,1,1,1,1,0,0,0,0,0.5136310900085983,0.4863689099914017
87507,0.5,0.5454545454545454,100,-120,0.4772727272727273,0.5227272727272727,away,STL,over,8.5,0.5238095238095238,-110,0.5012646084074657,MIL,STL,2022 REG,6,2,9,6,8,15,0,1,-4,4,1,1,0,0,0,0,0,0,0,0.5012646084074657,0.4987353915925343
87507,0.5,0.5454545454545454,100,-120,0.4772727272727273,0.5227272727272727,home,MIL,under,8.5,0.5192307692307692,-108,0.4987353915925343,MIL,STL,2022 REG,6,2,9,6,8,15,0,1,-4,4,1,1,0,0,0,0,0,0,0,0.5012646084074657,0.4987353915925343
87508,0.5145631067961165,0.5260663507109005,-106,-111,0.49365668691386505,0.506343313086135,away,TEX,over,7.5,0.5,100,0.4772727272727273,OAK,TEX,2022 REG,9,5,7,4,9,16,1,0,1,-1,1,1,1,1,0,0,0,0,0,0.4772727272727273,0.5227272727272727
87508,0.5145631067961165,0.5260663507109005,-106,-111,0.49365668691386505,0.506343313086135,home,OAK,under,7.5,0.5454545454545454,-120,0.5227272727272727,OAK,TEX,2022 REG,9,5,7,4,9,16,1,0,1,-1,1,1,1,1,0,0,0,0,0,0.4772727272727273,0.5227272727272727
87509,0.5575221238938054,0.4807692307692307,-126,108,0.5361738465152985,0.46382615348470146,away,MIA,over,6.5,0.5391705069124424,-117,0.5140669063204599,SD,MIA,2022 REG,5,0,10,8,8,15,0,1,-8,8,0,0,0,0,0,0,0,0,0,0.5140669063204599,0.4859330936795401
87509,0.5575221238938054,0.4807692307692307,-126,108,0.5361738465152985,0.46382615348470146,home,SD,under,6.5,0.5073891625615764,-103,0.4859330936795401,SD,MIA,2022 REG,5,0,10,8,8,15,0,1,-8,8,0,0,0,0,0,0,0,0,0,0.5140669063204599,0.4859330936795401
87510,0.7685185185185185,0.26881720430107525,-332,272,0.7398253241293864,0.2601746758706136,away,MIA,over,7.5,0.5260663507109005,-111,0.5022370601254724,LAD,MIA,2022 REG,12,7,3,0,7,15,1,0,7,-7,0,0,0,0,0,0,0,0,0,0.5022370601254724,0.4977629398745276
87510,0.7685185185185185,0.26881720430107525,-332,272,0.7398253241293864,0.2601746758706136,home,LAD,under,7.5,0.5192307692307692,-108,0.4977629398745276,LAD,MIA,2022 REG,12,7,3,0,7,15,1,0,7,-7,0,0,0,0,0,0,0,0,0,0.5022370601254724,0.4977629398745276
87511,0.5215311004784688,0.5169082125603864,-109,-107,0.5014838032476784,0.4985161967523216,away,STL,over,8.5,0.5238095238095238,-110,0.4988662131519274,CIN,STL,2022 REG,3,0,10,5,5,13,0,1,-5,5,0,0,0,0,0,0,0,0,0,0.4988662131519274,0.5011337868480725
87511,0.5215311004784688,0.5169082125603864,-109,-107,0.5014838032476784,0.4985161967523216,home,CIN,under,8.5,0.5238095238095238,-110,0.5011337868480725,CIN,STL,2022 REG,3,0,10,5,5,13,0,1,-5,5,0,0,0,0,0,0,0,0,0,0.4988662131519274,0.5011337868480725
87512,0.5884773662551441,0.45248868778280543,-143,121,0.5643697706690257,0.4356302293309743,away,PHI,over,7.5,0.5454545454545454,-120,0.5206611570247933,SD,PHI,2022 REG,5,5,13,8,13,18,0,1,-3,3,1,1,1,1,1,0,0,0,0,0.5206611570247933,0.4793388429752067
87512,0.5884773662551441,0.45248868778280543,-143,121,0.5643697706690257,0.4356302293309743,home,SD,under,7.5,0.5,100,0.4793388429752067,SD,PHI,2022 REG,5,5,13,8,13,18,0,1,-3,3,1,1,1,1,1,0,0,0,0,0.5206611570247933,0.4793388429752067
87513,0.5850622406639003,0.45248868778280543,-141,121,0.5630926103278608,0.43690738967213916,away,PHI,over,8.5,0.5283018867924528,-112,0.5056562298022652,LAD,PHI,2022 REG,7,5,8,4,9,15,1,0,1,-1,1,1,1,1,0,0,0,0,0,0.5056562298022652,0.4943437701977348
87513,0.5850622406639003,0.45248868778280543,-141,121,0.5630926103278608,0.43690738967213916,home,LAD,under,8.5,0.5145631067961165,-106,0.4943437701977348,LAD,PHI,2022 REG,7,5,8,4,9,15,1,0,1,-1,1,1,1,1,0,0,0,0,0,0.5056562298022652,0.4943437701977348
87514,0.646643109540636,0.3921568627450981,-183,155,0.6215533748116984,0.37844662518830163,away,BOS,over,7,0.5238095238095238,-110,0.5000596729920038,TB,BOS,2022 REG,4,1,6,0,1,10,1,0,1,-1,0,0,0,0,0,0,0,0,0,0.5000596729920038,0.4999403270079962
87514,0.646643109540636,0.3921568627450981,-183,155,0.6215533748116984,0.37844662518830163,home,TB,under,7,0.5215311004784688,-109,0.4999403270079962,TB,BOS,2022 REG,4,1,6,0,1,10,1,0,1,-1,0,0,0,0,0,0,0,0,0,0.5000596729920038,0.4999403270079962
87515,0.6845425867507886,0.35460992907801414,-217,182,0.6577410222875387,0.3422589777124613,away,LAA,over,8.5,0.5,100,0.47935779816513757,HOU,LAA,2022 REG,6,4,5,3,7,11,1,0,1,-1,1,1,1,0,0,0,0,0,0,0.47935779816513757,0.5206422018348624
87515,0.6845425867507886,0.35460992907801414,-217,182,0.6577410222875387,0.3422589777124613,home,HOU,under,8.5,0.5412844036697247,-118,0.5206422018348624,HOU,LAA,2022 REG,6,4,5,3,7,11,1,0,1,-1,1,1,1,0,0,0,0,0,0,0.47935779816513757,0.5206422018348624
87516,0.49751243781094534,0.5454545454545454,101,-120,0.476135829221149,0.523864170778851,away,HOU,over,8,0.5192307692307692,-108,0.49688292476754015,SEA,HOU,2022 REG,10,7,4,2,9,14,1,0,5,-5,1,1,0,0,0,0,0,0,0,0.49688292476754015,0.5031170752324599
87516,0.49751243781094534,0.5454545454545454,101,-120,0.476135829221149,0.523864170778851,home,SEA,under,8,0.5238095238095238,-110,0.5031170752324599,SEA,HOU,2022 REG,10,7,4,2,9,14,1,0,5,-5,1,1,0,0,0,0,0,0,0,0.49688292476754015,0.5031170752324599
87517,0.3921568627450981,0.6453900709219857,155,-182,0.37743257503251615,0.6225674249674839,away,NYY,over,8,0.5169082125603864,-107,0.49353874091423283,MIL,NYY,2022 REG,12,8,16,12,20,28,0,1,-4,4,1,1,1,1,1,1,1,1,0,0.49353874091423283,0.5064612590857671
87517,0.3921568627450981,0.6453900709219857,155,-182,0.37743257503251615,0.6225674249674839,home,MIL,under,8,0.5283018867924528,-112,0.5064612590857671,MIL,NYY,2022 REG,12,8,16,12,20,28,0,1,-4,4,1,1,1,1,1,1,1,1,0,0.49353874091423283,0.5064612590857671
87518,0.7601918465227817,0.2777777777777778,-317,260,0.731327647713963,0.26867235228603703,away,OAK,over,8,0.5215311004784688,-109,0.4978845547971712,HOU,OAK,2022 REG,9,5,3,2,7,12,1,0,3,-3,1,1,0,0,0,0,0,0,0,0.4978845547971712,0.5021154452028288
87518,0.7601918465227817,0.2777777777777778,-317,260,0.731327647713963,0.26867235228603703,home,HOU,under,8,0.5238095238095238,-110,0.5021154452028288,HOU,OAK,2022 REG,9,5,3,2,7,12,1,0,3,-3,1,1,0,0,0,0,0,0,0,0.4978845547971712,0.5021154452028288
87519,0.5475113122171946,0.4926108374384236,-121,103,0.5255439814102724,0.47445601858972763,away,LAD,over,8,0.5370370370370371,-116,0.514488177212783,MIL,LAD,2022 REG,5,5,8,4,9,13,1,0,1,-1,1,1,1,1,0,0,0,0,0,0.514488177212783,0.48551182278721705
87519,0.5475113122171946,0.4926108374384236,-121,103,0.5255439814102724,0.47445601858972763,home,MIL,under,8,0.504950495049505,-102,0.48551182278721705,MIL,LAD,2022 REG,5,5,8,4,9,13,1,0,1,-1,1,1,1,1,0,0,0,0,0,0.514488177212783,0.48551182278721705
87520,0.36101083032490977,0.6825396825396826,177,-215,0.3452886235145876,0.6547113764854124,away,SF,over,8,0.5121951219512195,-105,0.48808156828023186,CIN,SF,2022 REG,9,5,6,1,6,15,1,0,4,-4,1,0,0,0,0,0,0,0,0,0.48808156828023186,0.5119184317197681
87520,0.36101083032490977,0.6825396825396826,177,-215,0.3452886235145876,0.6547113764854124,home,CIN,under,8,0.5348837209302326,-115,0.5119184317197681,CIN,SF,2022 REG,9,5,6,1,6,15,1,0,4,-4,1,0,0,0,0,0,0,0,0,0.48808156828023186,0.5119184317197681
87521,0.5454545454545454,0.49751243781094534,-120,101,0.5220180091279142,0.4779819908720858,away,MIN,over,8.5,0.5121951219512195,-105,0.48919479393107135,CWS,MIN,2022 REG,14,9,14,8,17,28,1,0,1,-1,1,1,1,1,1,1,1,1,0,0.48919479393107135,0.5108052060689287
87521,0.5454545454545454,0.49751243781094534,-120,101,0.5220180091279142,0.4779819908720858,home,CWS,under,8.5,0.5327102803738317,-114,0.5108052060689287,CWS,MIN,2022 REG,14,9,14,8,17,28,1,0,1,-1,1,1,1,1,1,1,1,1,0,0.48919479393107135,0.5108052060689287
87522,0.5260663507109005,0.5121951219512195,-111,-105,0.5059382774147141,0.4940617225852859,away,CLE,over,7.5,0.5260663507109005,-111,0.5010269332605688,MIN,CLE,2022 REG,14,6,15,7,13,29,0,1,-1,1,1,1,1,1,1,1,0,0,0,0.5010269332605688,0.4989730667394312
87522,0.5260663507109005,0.5121951219512195,-111,-105,0.5059382774147141,0.4940617225852859,home,MIN,under,7.5,0.5215311004784688,-109,0.4989730667394312,MIN,CLE,2022 REG,14,6,15,7,13,29,0,1,-1,1,1,1,1,1,1,1,0,0,0,0.5010269332605688,0.4989730667394312
87523,0.3968253968253968,0.6428571428571428,152,-180,0.3810783572688335,0.6189216427311666,away,MIL,over,8.5,0.5238095238095238,-110,0.5012646084074657,WSH,MIL,2022 REG,19,11,7,5,16,26,1,0,6,-6,1,1,1,1,1,0,0,0,0,0.5012646084074657,0.4987353915925343
87523,0.3968253968253968,0.6428571428571428,152,-180,0.3810783572688335,0.6189216427311666,home,WSH,under,8.5,0.5192307692307692,-108,0.4987353915925343,WSH,MIL,2022 REG,19,11,7,5,16,26,1,0,6,-6,1,1,1,1,1,0,0,0,0,0.5012646084074657,0.4987353915925343
87524,0.38314176245210724,0.6551724137931035,161,-190,0.3684620014386165,0.6315379985613835,away,STL,over,9,0.5073891625615764,-103,0.4837652908580103,ARI,STL,2022 REG,4,1,12,5,6,16,0,1,-4,4,1,0,0,0,0,0,0,0,0,0.4837652908580103,0.5162347091419897
87524,0.38314176245210724,0.6551724137931035,161,-190,0.3684620014386165,0.6315379985613835,home,ARI,under,9,0.5391705069124424,-117,0.5162347091419897,ARI,STL,2022 REG,4,1,12,5,6,16,0,1,-4,4,1,0,0,0,0,0,0,0,0,0.4837652908580103,0.5162347091419897
87525,0.5391705069124424,0.5,-117,100,0.5180509248444435,0.4819490751555565,away,MIN,over,10,0.5348837209302326,-115,0.5097020142727117,BOS,MIN,2022 REG,8,4,9,8,12,17,0,1,-4,4,1,1,1,1,0,0,0,0,0,0.5097020142727117,0.49029798572728833
87525,0.5391705069124424,0.5,-117,100,0.5180509248444435,0.4819490751555565,home,BOS,under,10,0.5121951219512195,-105,0.49029798572728833,BOS,MIN,2022 REG,8,4,9,8,12,17,0,1,-4,4,1,1,1,1,0,0,0,0,0,0.5097020142727117,0.49029798572728833
87526,0.5348837209302326,0.5098039215686274,-115,-104,0.5109810284308424,0.48901897156915763,away,PHI,over,7.5,0.5215311004784688,-109,0.4978845547971712,MIA,PHI,2022 REG,6,4,11,3,7,17,1,0,1,-1,1,1,1,0,0,0,0,0,0,0.4978845547971712,0.5021154452028288
87526,0.5348837209302326,0.5098039215686274,-115,-104,0.5109810284308424,0.48901897156915763,home,MIA,under,7.5,0.5238095238095238,-110,0.5021154452028288,MIA,PHI,2022 REG,6,4,11,3,7,17,1,0,1,-1,1,1,1,0,0,0,0,0,0,0.4978845547971712,0.5021154452028288
87527,0.6441281138790036,0.39840637450199207,-181,151,0.6167304541033445,0.3832695458966555,away,PIT,over,8.5,0.5238095238095238,-110,0.5012646084074657,STL,PIT,2022 REG,10,6,9,2,8,19,1,0,4,-4,1,1,0,0,0,0,0,0,0,0.5012646084074657,0.4987353915925343
87527,0.6441281138790036,0.39840637450199207,-181,151,0.6167304541033445,0.3832695458966555,home,STL,under,8.5,0.5192307692307692,-108,0.4987353915925343,STL,PIT,2022 REG,10,6,9,2,8,19,1,0,4,-4,1,1,0,0,0,0,0,0,0,0.5012646084074657,0.4987353915925343
87528,0.5967741935483871,0.4444444444444444,-148,125,0.5721759741010521,0.42782402589894786,away,DET,over,7.5,0.5238095238095238,-110,0.4988662131519274,SEA,DET,2022 REG,9,5,8,4,9,17,1,0,1,-1,1,1,1,1,0,0,0,0,0,0.4988662131519274,0.5011337868480725
87528,0.5967741935483871,0.4444444444444444,-148,125,0.5721759741010521,0.42782402589894786,home,SEA,under,7.5,0.5238095238095238,-110,0.5011337868480725,SEA,DET,2022 REG,9,5,8,4,9,17,1,0,1,-1,1,1,1,1,0,0,0,0,0,0.4988662131519274,0.5011337868480725
87529,0.6575342465753424,0.38167938931297707,-192,162,0.6317499380460364,0.3682500619539636,away,MIA,over,6.5,0.5495495495495495,-122,0.5223196169142115,NYM,MIA,2022 REG,7,5,7,4,9,14,1,0,1,-1,1,1,1,1,0,0,0,0,0,0.5223196169142115,0.47768038308578853
87529,0.6575342465753424,0.38167938931297707,-192,162,0.6317499380460364,0.3682500619539636,home,NYM,under,6.5,0.5,100,0.47768038308578853,NYM,MIA,2022 REG,7,5,7,4,9,14,1,0,1,-1,1,1,1,1,0,0,0,0,0,0.5223196169142115,0.47768038308578853
87530,0.425531914893617,0.6124031007751938,135,-158,0.4093893550345486,0.5906106449654513,away,SEA,over,7.5,0.5238095238095238,-110,0.4988662131519274,TEX,SEA,2022 REG,6,3,10,8,11,16,0,1,-5,5,1,1,1,0,0,0,0,0,0,0.4988662131519274,0.5011337868480725
87530,0.425531914893617,0.6124031007751938,135,-158,0.4093893550345486,0.5906106449654513,home,TEX,under,7.5,0.5238095238095238,-110,0.5011337868480725,TEX,SEA,2022 REG,6,3,10,8,11,16,0,1,-5,5,1,1,1,0,0,0,0,0,0,0.4988662131519274,0.5011337868480725
87531,0.626865671641791,0.4081632653061224,-168,145,0.6049072335550394,0.3950927664449606,away,PIT,over,7.5,0.504950495049505,-102,0.4837488699364985,ARI,PIT,2022 REG,9,9,5,3,12,14,1,0,6,-6,1,1,1,0,0,0,0,0,0,0.4837488699364985,0.5162511300635015
87531,0.626865671641791,0.4081632653061224,-168,145,0.6049072335550394,0.3950927664449606,home,ARI,under,7.5,0.5370370370370371,-116,0.5162511300635015,ARI,PIT,2022 REG,9,9,5,3,12,14,1,0,6,-6,1,1,1,0,0,0,0,0,0,0.4837488699364985,0.5162511300635015
87532,0.696969696969697,0.3389830508474576,-230,195,0.6719117212183469,0.32808827878165314,away,MIA,over,7,0.49019607843137253,104,0.4707129274603323,PHI,MIA,2022 REG,6,3,6,2,5,12,1,0,1,-1,1,1,0,0,0,0,0,0,0,0.4707129274603323,0.5292870725396677
87532,0.696969696969697,0.3389830508474576,-230,195,0.6719117212183469,0.32808827878165314,home,PHI,under,7,0.5495495495495495,-122,0.5292870725396677,PHI,MIA,2022 REG,6,3,6,2,5,12,1,0,1,-1,1,1,0,0,0,0,0,0,0,0.4707129274603323,0.5292870725396677
87533,0.5689655172413793,0.4716981132075471,-132,112,0.5458293137100936,0.4541706862899064,away,MIL,over,8,0.504950495049505,-102,0.4826715732667395,SF,MIL,2022 REG,4,2,5,1,3,9,1,0,1,-1,1,0,0,0,0,0,0,0,0,0.4826715732667395,0.5173284267332605
87533,0.5689655172413793,0.4716981132075471,-132,112,0.5458293137100936,0.4541706862899064,home,SF,under,8,0.5391705069124424,-117,0.5173284267332605,SF,MIL,2022 REG,4,2,5,1,3,9,1,0,1,-1,1,0,0,0,0,0,0,0,0,0.4826715732667395,0.5173284267332605
87534,0.46511627906976744,0.576271186440678,115,-136,0.44586629511142073,0.5541337048885793,away,MIL,over,7,0.5238095238095238,-110,0.5000596729920038,STL,MIL,2022 REG,4,0,13,8,8,17,0,1,-8,8,0,0,0,0,0,0,0,0,0,0.5000596729920038,0.4999403270079962
87534,0.46511627906976744,0.576271186440678,115,-136,0.44586629511142073,0.5541337048885793,home,STL,under,7,0.5215311004784688,-109,0.4999403270079962,STL,MIL,2022 REG,4,0,13,8,8,17,0,1,-8,8,0,0,0,0,0,0,0,0,0,0.5000596729920038,0.4999403270079962
87535,0.5594713656387665,0.47846889952153115,-127,109,0.5382448736768379,0.46175512632316207,away,BAL,over,8.5,0.5454545454545454,-120,0.5206611570247933,CIN,BAL,2022 REG,7,3,6,2,5,13,1,0,1,-1,1,1,0,0,0,0,0,0,0,0.5206611570247933,0.4793388429752067
87535,0.5594713656387665,0.47846889952153115,-127,109,0.5382448736768379,0.46175512632316207,home,CIN,under,8.5,0.5,100,0.4793388429752067,CIN,BAL,2022 REG,7,3,6,2,5,13,1,0,1,-1,1,1,0,0,0,0,0,0,0,0.5206611570247933,0.4793388429752067
87536,0.5348837209302326,0.5121951219512195,-115,-105,0.5097020142727117,0.49029798572728833,away,DET,over,6.5,0.5169082125603864,-107,0.49353874091423283,OAK,DET,2022 REG,4,0,12,6,6,16,0,1,-6,6,0,0,0,0,0,0,0,0,0,0.49353874091423283,0.5064612590857671
87536,0.5348837209302326,0.5121951219512195,-115,-105,0.5097020142727117,0.49029798572728833,home,OAK,under,6.5,0.5283018867924528,-112,0.5064612590857671,OAK,DET,2022 REG,4,0,12,6,6,16,0,1,-6,6,0,0,0,0,0,0,0,0,0,0.49353874091423283,0.5064612590857671
87537,0.5098039215686274,0.5305164319248826,-104,-113,0.4892484472386027,0.5107515527613973,away,SF,over,6.5,0.5238095238095238,-110,0.4988662131519274,NYM,SF,2022 REG,9,2,8,5,7,17,0,1,-3,3,1,1,0,0,0,0,0,0,0,0.4988662131519274,0.5011337868480725
87537,0.5098039215686274,0.5305164319248826,-104,-113,0.4892484472386027,0.5107515527613973,home,NYM,under,6.5,0.5238095238095238,-110,0.5011337868480725,NYM,SF,2022 REG,9,2,8,5,7,17,0,1,-3,3,1,1,0,0,0,0,0,0,0,0.4988662131519274,0.5011337868480725
87538,0.6108949416342413,0.4273504273504274,-157,134,0.5875310391805721,0.41246896081942785,away,TOR,over,7.5,0.5238095238095238,-110,0.4988662131519274,LAA,TOR,2022 REG,10,3,7,6,9,17,0,1,-3,3,1,1,1,0,0,0,0,0,0,0.4988662131519274,0.5011337868480725
87538,0.6108949416342413,0.4273504273504274,-157,134,0.5875310391805721,0.41246896081942785,home,LAA,under,7.5,0.5238095238095238,-110,0.5011337868480725,LAA,TOR,2022 REG,10,3,7,6,9,17,0,1,-3,3,1,1,1,0,0,0,0,0,0,0.4988662131519274,0.5011337868480725
87539,0.3846153846153846,0.646643109540636,160,-183,0.37259288686306896,0.627407113136931,away,ATL,over,6.5,0.5495495495495495,-122,0.5250401592387142,SF,ATL,2022 REG,10,3,10,2,5,20,1,0,1,-1,1,1,0,0,0,0,0,0,0,0.5250401592387142,0.47495984076128583
87539,0.3846153846153846,0.646643109540636,160,-183,0.37259288686306896,0.627407113136931,home,SF,under,6.5,0.49504950495049505,102,0.47495984076128583,SF,ATL,2022 REG,10,3,10,2,5,20,1,0,1,-1,1,1,0,0,0,0,0,0,0,0.5250401592387142,0.47495984076128583
87540,0.6987951807228916,0.3412969283276451,-232,193,0.67077900813336,0.32922099186664,away,SF,over,7.5,0.5348837209302326,-115,0.5109810284308424,LAD,SF,2022 REG,12,7,7,4,11,19,1,0,3,-3,1,1,1,1,0,0,0,0,0,0.5109810284308424,0.48901897156915763
87540,0.6987951807228916,0.3412969283276451,-232,193,0.67077900813336,0.32922099186664,home,LAD,under,7.5,0.5098039215686274,-104,0.48901897156915763,LAD,SF,2022 REG,12,7,7,4,11,19,1,0,3,-3,1,1,1,1,0,0,0,0,0,0.5109810284308424,0.48901897156915763
87541,0.5454545454545454,0.5,-120,100,0.5206611570247933,0.4793388429752067,away,TEX,over,8,0.5098039215686274,-104,0.48483656587239576,DET,TEX,2022 REG,5,0,12,7,7,17,0,1,-7,7,0,0,0,0,0,0,0,0,0,0.48483656587239576,0.5151634341276042
87541,0.5454545454545454,0.5,-120,100,0.5206611570247933,0.4793388429752067,home,DET,under,8,0.5391705069124424,-117,0.5151634341276042,DET,TEX,2022 REG,5,0,12,7,7,17,0,1,-7,7,0,0,0,0,0,0,0,0,0,0.48483656587239576,0.5151634341276042
87542,0.5726495726495727,0.46511627906976744,-134,115,0.5510229738017454,0.44897702619825464,away,TOR,over,8.5,0.5238095238095238,-110,0.4988662131519274,NYY,TOR,2022 REG,8,3,5,0,3,13,1,0,3,-3,0,0,0,0,0,0,0,0,0,0.4988662131519274,0.5011337868480725
87542,0.5726495726495727,0.46511627906976744,-134,115,0.5510229738017454,0.44897702619825464,home,NYY,under,8.5,0.5238095238095238,-110,0.5011337868480725,NYY,TOR,2022 REG,8,3,5,0,3,13,1,0,3,-3,0,0,0,0,0,0,0,0,0,0.4988662131519274,0.5011337868480725
87543,0.5652173913043479,0.47619047619047616,-130,110,0.5418129444594474,0.4581870555405526,away,COL,over,9,0.5098039215686274,-104,0.4870219861770517,ARI,COL,2022 REG,12,9,7,2,11,19,1,0,7,-7,1,1,0,0,0,0,0,0,0,0.4870219861770517,0.5129780138229483
87543,0.5652173913043479,0.47619047619047616,-130,110,0.5418129444594474,0.4581870555405526,home,ARI,under,9,0.5348837209302326,-115,0.5129780138229483,ARI,COL,2022 REG,12,9,7,2,11,19,1,0,7,-7,1,1,0,0,0,0,0,0,0,0.4870219861770517,0.5129780138229483
87544,0.4016064257028112,0.6402877697841727,149,-178,0.3847814475955888,0.6152185524044111,away,STL,over,11,0.5412844036697247,-118,0.5149381613977361,COL,STL,2022 REG,22,16,8,5,21,30,1,0,11,-11,1,1,1,1,1,0,0,0,0,0.5149381613977361,0.48506183860226393
87544,0.4016064257028112,0.6402877697841727,149,-178,0.3847814475955888,0.6152185524044111,home,COL,under,11,0.5073891625615764,-103,0.48506183860226393,COL,STL,2022 REG,22,16,8,5,21,30,1,0,11,-11,1,1,1,1,1,0,0,0,0,0.5149381613977361,0.48506183860226393
87545,0.6415770609318996,0.4,-179,150,0.6149021723770248,0.3850978276229752,away,WSH,over,8.5,0.5238095238095238,-110,0.5000596729920038,NYM,WSH,2022 REG,16,13,10,5,18,26,1,0,8,-8,1,1,1,1,1,0,0,0,0,0.5000596729920038,0.4999403270079962
87545,0.6415770609318996,0.4,-179,150,0.6149021723770248,0.3850978276229752,home,NYM,under,8.5,0.5215311004784688,-109,0.4999403270079962,NYM,WSH,2022 REG,16,13,10,5,18,26,1,0,8,-8,1,1,1,1,1,0,0,0,0,0.5000596729920038,0.4999403270079962
87546,0.6491228070175439,0.38759689922480617,-185,158,0.6252872082286499,0.3747127917713501,away,MIA,over,7,0.49504950495049505,102,0.47297076509898783,ATL,MIA,2022 REG,11,8,5,1,9,16,1,0,7,-7,1,0,0,0,0,0,0,0,0,0.47297076509898783,0.5270292349010122
87546,0.6491228070175439,0.38759689922480617,-185,158,0.6252872082286499,0.3747127917713501,home,ATL,under,7,0.5495495495495495,-122,0.5270292349010122,ATL,MIA,2022 REG,11,8,5,1,9,16,1,0,7,-7,1,0,0,0,0,0,0,0,0,0.47297076509898783,0.5270292349010122
87547,0.5901639344262295,0.45248868778280543,-144,121,0.5649918950897499,0.4350081049102501,away,CWS,over,8.5,0.5098039215686274,-104,0.4870219861770517,BOS,CWS,2022 REG,9,2,6,3,5,15,0,1,-1,1,1,1,0,0,0,0,0,0,0,0.4870219861770517,0.5129780138229483
87547,0.5901639344262295,0.45248868778280543,-144,121,0.5649918950897499,0.4350081049102501,home,BOS,under,8.5,0.5348837209302326,-115,0.5129780138229483,BOS,CWS,2022 REG,9,2,6,3,5,15,0,1,-1,1,1,1,0,0,0,0,0,0,0,0.4870219861770517,0.5129780138229483
87548,0.6124031007751938,0.425531914893617,-158,135,0.5891715795516586,0.41082842044834145,away,CLE,over,8.5,0.5098039215686274,-104,0.48592421718142587,MIN,CLE,2022 REG,12,10,15,11,21,27,0,1,-1,1,1,1,1,1,1,1,1,1,1,0.48592421718142587,0.5140757828185741
87548,0.6124031007751938,0.425531914893617,-158,135,0.5891715795516586,0.41082842044834145,home,MIN,under,8.5,0.5370370370370371,-116,0.5140757828185741,MIN,CLE,2022 REG,12,10,15,11,21,27,0,1,-1,1,1,1,1,1,1,1,1,1,1,0.48592421718142587,0.5140757828185741
87549,0.5391705069124424,0.5,-117,100,0.5180509248444435,0.4819490751555565,away,KC,over,8.5,0.5192307692307692,-108,0.49571111079951763,DET,KC,2022 REG,6,1,10,3,4,16,0,1,-2,2,1,0,0,0,0,0,0,0,0,0.49571111079951763,0.5042888892004824
87549,0.5391705069124424,0.5,-117,100,0.5180509248444435,0.4819490751555565,home,DET,under,8.5,0.5260663507109005,-111,0.5042888892004824,DET,KC,2022 REG,6,1,10,3,4,16,0,1,-2,2,1,0,0,0,0,0,0,0,0,0.49571111079951763,0.5042888892004824
87550,0.5594713656387665,0.47846889952153115,-127,109,0.5382448736768379,0.46175512632316207,away,CLE,over,9.5,0.5260663507109005,-111,0.5022370601254724,CIN,CLE,2022 REG,7,3,13,7,10,20,0,1,-4,4,1,1,1,0,0,0,0,0,0,0.5022370601254724,0.4977629398745276
87550,0.5594713656387665,0.47846889952153115,-127,109,0.5382448736768379,0.46175512632316207,home,CIN,under,9.5,0.5192307692307692,-108,0.4977629398745276,CIN,CLE,2022 REG,7,3,13,7,10,20,0,1,-4,4,1,1,1,0,0,0,0,0,0,0.5022370601254724,0.4977629398745276
87551,0.6845425867507886,0.35460992907801414,-217,182,0.6577410222875387,0.3422589777124613,away,PIT,over,8,0.5391705069124424,-117,0.5127649394825569,ATL,PIT,2022 REG,10,4,8,2,6,18,1,0,2,-2,1,1,0,0,0,0,0,0,0,0.5127649394825569,0.48723506051744314
87551,0.6845425867507886,0.35460992907801414,-217,182,0.6577410222875387,0.3422589777124613,home,ATL,under,8,0.5098039215686274,-104,0.48723506051744314,ATL,PIT,2022 REG,10,4,8,2,6,18,1,0,2,-2,1,1,0,0,0,0,0,0,0,0.5127649394825569,0.48723506051744314
87552,0.7435897435897436,0.29940119760479045,-290,234,0.7116221206502183,0.28837787934978165,away,OAK,over,8,0.5145631067961165,-106,0.4925063625223866,HOU,OAK,2022 REG,10,5,10,8,13,20,0,1,-3,3,1,1,1,1,1,0,0,0,0,0.4925063625223866,0.5074936374776133
87552,0.7435897435897436,0.29940119760479045,-290,234,0.7116221206502183,0.28837787934978165,home,HOU,under,8,0.5283018867924528,-112,0.5074936374776133,HOU,OAK,2022 REG,10,5,10,8,13,20,0,1,-3,3,1,1,1,1,1,0,0,0,0,0.4925063625223866,0.5074936374776133
87553,0.5815899581589958,0.4629629629629629,-139,116,0.5556784266278149,0.44432157337218514,away,WSH,over,9.5,0.5121951219512195,-105,0.48919479393107135,CIN,WSH,2022 REG,10,8,15,10,18,25,0,1,-2,2,1,1,1,1,1,1,1,1,0,0.48919479393107135,0.5108052060689287
87553,0.5815899581589958,0.4629629629629629,-139,116,0.5556784266278149,0.44432157337218514,home,CIN,under,9.5,0.5327102803738317,-114,0.5108052060689287,CIN,WSH,2022 REG,10,8,15,10,18,25,0,1,-2,2,1,1,1,1,1,1,1,1,0,0.48919479393107135,0.5108052060689287
87554,0.5348837209302326,0.5121951219512195,-115,-105,0.5097020142727117,0.49029798572728833,away,STL,over,10,0.5327102803738317,-114,0.508788710910954,CHC,STL,2022 REG,8,3,16,8,11,24,0,1,-5,5,1,1,1,0,0,0,0,0,0,0.508788710910954,0.491211289089046
87554,0.5348837209302326,0.5121951219512195,-115,-105,0.5097020142727117,0.49029798572728833,home,CHC,under,10,0.5121951219512195,-105,0.491211289089046,CHC,STL,2022 REG,8,3,16,8,11,24,0,1,-5,5,1,1,1,0,0,0,0,0,0,0.508788710910954,0.491211289089046
87555,0.7542997542997544,0.2857142857142857,-307,250,0.7241171737486234,0.2758828262513766,away,COL,over,8.5,0.5121951219512195,-105,0.48808156828023186,SD,COL,2022 REG,10,9,6,1,10,16,1,0,8,-8,1,0,0,0,0,0,0,0,0,0.48808156828023186,0.5119184317197681
87555,0.7542997542997544,0.2857142857142857,-307,250,0.7241171737486234,0.2758828262513766,home,SD,under,8.5,0.5348837209302326,-115,0.5119184317197681,SD,COL,2022 REG,10,9,6,1,10,16,1,0,8,-8,1,0,0,0,0,0,0,0,0,0.48808156828023186,0.5119184317197681
87556,0.5815899581589958,0.4566210045662101,-139,119,0.5593668459464284,0.4406331540535716,away,TEX,over,9,0.5215311004784688,-109,0.49907282342437215,CWS,TEX,2022 REG,11,8,6,3,11,17,1,0,5,-5,1,1,1,0,0,0,0,0,0,0.49907282342437215,0.5009271765756278
87556,0.5815899581589958,0.4566210045662101,-139,119,0.5593668459464284,0.4406331540535716,home,CWS,under,9,0.5215311004784688,-109,0.5009271765756278,CWS,TEX,2022 REG,11,8,6,3,11,17,1,0,5,-5,1,1,1,0,0,0,0,0,0,0.49907282342437215,0.5009271765756278
87557,0.6515679442508712,0.390625,-187,156,0.6240763743034393,0.3759236256965607,away,COL,over,8,0.5238095238095238,-110,0.4988662131519274,ARI,COL,2022 REG,10,2,8,3,5,18,0,1,-1,1,1,1,0,0,0,0,0,0,0,0.4988662131519274,0.5011337868480725
87557,0.6515679442508712,0.390625,-187,156,0.6240763743034393,0.3759236256965607,home,ARI,under,8,0.5238095238095238,-110,0.5011337868480725,ARI,COL,2022 REG,10,2,8,3,5,18,0,1,-1,1,1,1,0,0,0,0,0,0,0,0.4988662131519274,0.5011337868480725
87558,0.6491228070175439,0.3921568627450981,-185,155,0.6223272319084604,0.3776727680915396,away,WSH,over,9,0.5098039215686274,-104,0.4881300146960012,MIA,WSH,2022 REG,14,12,8,2,14,22,1,0,10,-10,1,1,0,0,0,0,0,0,0,0.4881300146960012,0.5118699853039987
87558,0.6491228070175439,0.3921568627450981,-185,155,0.6223272319084604,0.3776727680915396,home,MIA,under,9,0.5327102803738317,-114,0.5118699853039987,MIA,WSH,2022 REG,14,12,8,2,14,22,1,0,10,-10,1,1,0,0,0,0,0,0,0,0.4881300146960012,0.5118699853039987
87559,0.6742671009771988,0.36363636363636365,-207,175,0.6487100417752203,0.3512899582247797,away,DET,over,8.5,0.5098039215686274,-104,0.4870219861770517,CWS,DET,2022 REG,8,2,3,0,2,11,1,0,2,-2,0,0,0,0,0,0,0,0,0,0.4870219861770517,0.5129780138229483
87559,0.6742671009771988,0.36363636363636365,-207,175,0.6487100417752203,0.3512899582247797,home,CWS,under,8.5,0.5348837209302326,-115,0.5129780138229483,CWS,DET,2022 REG,8,2,3,0,2,11,1,0,2,-2,0,0,0,0,0,0,0,0,0,0.4870219861770517,0.5129780138229483
87560,0.6323529411764706,0.4065040650406504,-172,146,0.6077815990097617,0.3922184009902383,away,CLE,over,9.5,0.5,100,0.47935779816513757,CWS,CLE,2022 REG,8,5,8,4,9,16,1,0,1,-1,1,1,1,1,0,0,0,0,0,0.47935779816513757,0.5206422018348624
87560,0.6323529411764706,0.4065040650406504,-172,146,0.6077815990097617,0.3922184009902383,home,CWS,under,9.5,0.5412844036697247,-118,0.5206422018348624,CWS,CLE,2022 REG,8,5,8,4,9,16,1,0,1,-1,1,1,1,1,0,0,0,0,0,0.47935779816513757,0.5206422018348624
87561,0.5348837209302326,0.5073891625615764,-115,-103,0.5122726437136835,0.48772735628631647,away,BOS,over,8.5,0.5454545454545454,-120,0.5206611570247933,MIN,BOS,2022 REG,7,4,10,2,6,17,1,0,2,-2,1,1,0,0,0,0,0,0,0,0.5206611570247933,0.4793388429752067
87561,0.5348837209302326,0.5073891625615764,-115,-103,0.5122726437136835,0.48772735628631647,home,MIN,under,8.5,0.5,100,0.4793388429752067,MIN,BOS,2022 REG,7,4,10,2,6,17,1,0,2,-2,1,1,0,0,0,0,0,0,0,0.5206611570247933,0.4793388429752067
87562,0.5689655172413793,0.46511627906976744,-132,115,0.5495741503746924,0.45042584962530763,away,SEA,over,7.5,0.5,100,0.4772727272727273,NYM,SEA,2022 REG,9,7,16,8,15,25,0,1,-1,1,1,1,1,1,1,1,1,0,0,0.4772727272727273,0.5227272727272727
87562,0.5689655172413793,0.46511627906976744,-132,115,0.5495741503746924,0.45042584962530763,home,NYM,under,7.5,0.5454545454545454,-120,0.5227272727272727,NYM,SEA,2022 REG,9,7,16,8,15,25,0,1,-1,1,1,1,1,1,1,1,1,0,0,0.4772727272727273,0.5227272727272727
87563,0.46511627906976744,0.576271186440678,115,-136,0.44586629511142073,0.5541337048885793,away,CWS,over,9.5,0.5121951219512195,-105,0.48808156828023186,KC,CWS,2022 REG,5,2,8,3,5,13,0,1,-1,1,1,1,0,0,0,0,0,0,0,0.48808156828023186,0.5119184317197681
87563,0.46511627906976744,0.576271186440678,115,-136,0.44586629511142073,0.5541337048885793,home,KC,under,9.5,0.5348837209302326,-115,0.5119184317197681,KC,CWS,2022 REG,5,2,8,3,5,13,0,1,-1,1,1,1,0,0,0,0,0,0,0,0.48808156828023186,0.5119184317197681
87564,0.7118155619596541,0.3367003367003367,-247,197,0.6772811902910151,0.3227188097089849,away,MIA,over,7.5,0.5370370370370371,-116,0.5118817074154765,HOU,MIA,2022 REG,14,9,3,4,13,17,1,0,5,-5,1,1,1,1,0,0,0,0,0,0.5118817074154765,0.48811829258452355
87564,0.7118155619596541,0.3367003367003367,-247,197,0.6772811902910151,0.3227188097089849,home,HOU,under,7.5,0.5098039215686274,-104,0.48811829258452355,HOU,MIA,2022 REG,14,9,3,4,13,17,1,0,5,-5,1,1,1,1,0,0,0,0,0,0.5118817074154765,0.48811829258452355
87565,0.6923076923076923,0.3472222222222222,-225,188,0.6649408284023669,0.3350591715976331,away,ARI,over,10,0.5283018867924528,-112,0.5044173060022736,ATL,ARI,2022 REG,11,6,4,2,8,15,1,0,4,-4,1,1,0,0,0,0,0,0,0,0.5044173060022736,0.49558269399772636
87565,0.6923076923076923,0.3472222222222222,-225,188,0.6649408284023669,0.3350591715976331,home,ATL,under,10,0.5169082125603864,-107,0.49558269399772636,ATL,ARI,2022 REG,11,6,4,2,8,15,1,0,4,-4,1,1,0,0,0,0,0,0,0,0.5044173060022736,0.49558269399772636
87566,0.6183206106870228,0.4166666666666667,-162,140,0.5966872559874133,0.40331274401258665,away,COL,over,8,0.5260663507109005,-111,0.5022370601254724,PHI,COL,2022 REG,11,10,6,3,13,17,1,0,7,-7,1,1,1,0,0,0,0,0,0,0.5022370601254724,0.4977629398745276
87566,0.6183206106870228,0.4166666666666667,-162,140,0.5966872559874133,0.40331274401258665,home,PHI,under,8,0.5192307692307692,-108,0.4977629398745276,PHI,COL,2022 REG,11,10,6,3,13,17,1,0,7,-7,1,1,1,0,0,0,0,0,0,0.5022370601254724,0.4977629398745276
87567,0.5983935742971888,0.4464285714285714,-149,124,0.5715722903086816,0.4284277096913184,away,CIN,over,8.5,0.5327102803738317,-114,0.508788710910954,STL,CIN,2022 REG,8,7,10,3,10,18,1,0,4,-4,1,1,1,0,0,0,0,0,0,0.508788710910954,0.491211289089046
87567,0.5983935742971888,0.4464285714285714,-149,124,0.5715722903086816,0.4284277096913184,home,STL,under,8.5,0.5121951219512195,-105,0.491211289089046,STL,CIN,2022 REG,8,7,10,3,10,18,1,0,4,-4,1,1,1,0,0,0,0,0,0,0.508788710910954,0.491211289089046
87568,0.5555555555555556,0.4854368932038835,-125,106,0.5327819729114227,0.4672180270885773,away,ARI,over,8.5,0.5327102803738317,-114,0.508788710910954,PIT,ARI,2022 REG,5,2,4,1,3,9,1,0,1,-1,1,0,0,0,0,0,0,0,0,0.508788710910954,0.491211289089046
87568,0.5555555555555556,0.4854368932038835,-125,106,0.5327819729114227,0.4672180270885773,home,PIT,under,8.5,0.5121951219512195,-105,0.491211289089046,PIT,ARI,2022 REG,5,2,4,1,3,9,1,0,1,-1,1,0,0,0,0,0,0,0,0,0.508788710910954,0.491211289089046
87569,0.696969696969697,0.3484320557491289,-230,187,0.6653260511353638,0.3346739488646362,away,OAK,over,8.5,0.5348837209302326,-115,0.5097020142727117,TB,OAK,2022 REG,8,2,13,13,15,21,0,1,-11,11,1,1,0,0,0,0,0,0,0,0.5097020142727117,0.49029798572728833
87569,0.696969696969697,0.3484320557491289,-230,187,0.6653260511353638,0.3346739488646362,home,TB,under,8.5,0.5121951219512195,-105,0.49029798572728833,TB,OAK,2022 REG,8,2,13,13,15,21,0,1,-11,11,1,1,0,0,0,0,0,0,0,0.5097020142727117,0.49029798572728833
87570,0.613899613899614,0.42194092827004215,-159,137,0.5918971188997093,0.4081028811002907,away,CIN,over,7.5,0.5370370370370371,-116,0.5118817074154765,PIT,CIN,2022 REG,13,8,5,3,11,18,1,0,5,-5,1,1,1,0,0,0,0,0,0,0.5118817074154765,0.48811829258452355
87570,0.613899613899614,0.42194092827004215,-159,137,0.5918971188997093,0.4081028811002907,home,PIT,under,7.5,0.5098039215686274,-104,0.48811829258452355,PIT,CIN,2022 REG,13,8,5,3,11,18,1,0,5,-5,1,1,1,0,0,0,0,0,0,0.5118817074154765,0.48811829258452355
87571,0.6000000000000001,0.4424778761061947,-150,126,0.5745132743362832,0.4254867256637168,away,PHI,over,8,0.5121951219512195,-105,0.48808156828023186,LAD,PHI,2022 REG,12,7,12,9,16,24,0,1,-2,2,1,1,1,1,1,1,1,0,0,0.48808156828023186,0.5119184317197681
87571,0.6000000000000001,0.4424778761061947,-150,126,0.5745132743362832,0.4254867256637168,home,LAD,under,8,0.5348837209302326,-115,0.5119184317197681,LAD,PHI,2022 REG,12,7,12,9,16,24,0,1,-2,2,1,1,1,1,1,1,1,0,0,0.48808156828023186,0.5119184317197681
87572,0.5884773662551441,0.4444444444444444,-143,125,0.5691036258022998,0.4308963741977002,away,LAA,over,8.5,0.5391705069124424,-117,0.5140669063204599,TEX,LAA,2022 REG,10,7,5,2,9,15,1,0,5,-5,1,1,0,0,0,0,0,0,0,0.5140669063204599,0.4859330936795401
87572,0.5884773662551441,0.4444444444444444,-143,125,0.5691036258022998,0.4308963741977002,home,TEX,under,8.5,0.5073891625615764,-103,0.4859330936795401,TEX,LAA,2022 REG,10,7,5,2,9,15,1,0,5,-5,1,1,0,0,0,0,0,0,0,0.5140669063204599,0.4859330936795401
87573,0.5815899581589958,0.45454545454545453,-139,120,0.5605739649961564,0.4394260350038436,away,OAK,over,7.5,0.5305164319248826,-113,0.5078572507605655,DET,OAK,2022 REG,7,1,8,4,5,15,0,1,-3,3,1,0,0,0,0,0,0,0,0,0.5078572507605655,0.49214274923943446
87573,0.5815899581589958,0.45454545454545453,-139,120,0.5605739649961564,0.4394260350038436,home,DET,under,7.5,0.5121951219512195,-105,0.49214274923943446,DET,OAK,2022 REG,7,1,8,4,5,15,0,1,-3,3,1,0,0,0,0,0,0,0,0,0.5078572507605655,0.49214274923943446
87574,0.6453900709219857,0.3921568627450981,-182,155,0.6211576527396834,0.3788423472603166,away,OAK,over,7.5,0.5,100,0.47935779816513757,MIN,OAK,2022 REG,8,2,4,1,3,12,1,0,1,-1,1,0,0,0,0,0,0,0,0,0.47935779816513757,0.5206422018348624
87574,0.6453900709219857,0.3921568627450981,-182,155,0.6211576527396834,0.3788423472603166,home,MIN,under,7.5,0.5412844036697247,-118,0.5206422018348624,MIN,OAK,2022 REG,8,2,4,1,3,12,1,0,1,-1,1,0,0,0,0,0,0,0,0,0.47935779816513757,0.5206422018348624
87575,0.47619047619047616,0.5633187772925764,110,-129,0.45737654596045113,0.5426234540395489,away,TEX,over,7,0.5348837209302326,-115,0.5097020142727117,OAK,TEX,2022 REG,5,5,13,8,13,18,0,1,-3,3,1,1,1,1,1,0,0,0,0,0.5097020142727117,0.49029798572728833
87575,0.47619047619047616,0.5633187772925764,110,-129,0.45737654596045113,0.5426234540395489,home,OAK,under,7,0.5121951219512195,-105,0.49029798572728833,OAK,TEX,2022 REG,5,5,13,8,13,18,0,1,-3,3,1,1,1,1,1,0,0,0,0,0.5097020142727117,0.49029798572728833
87576,0.6688741721854304,0.36363636363636365,-202,175,0.6471287144503232,0.35287128554967684,away,SF,over,7.5,0.5391705069124424,-117,0.5140669063204599,MIL,SF,2022 REG,3,2,3,1,3,6,1,0,1,-1,1,0,0,0,0,0,0,0,0,0.5140669063204599,0.4859330936795401
87576,0.6688741721854304,0.36363636363636365,-202,175,0.6471287144503232,0.35287128554967684,home,MIL,under,7.5,0.5073891625615764,-103,0.4859330936795401,MIL,SF,2022 REG,3,2,3,1,3,6,1,0,1,-1,1,0,0,0,0,0,0,0,0,0.5140669063204599,0.4859330936795401
87577,0.6323529411764706,0.4016064257028112,-172,149,0.610878635649866,0.389121364350134,away,MIA,over,7.5,0.5454545454545454,-120,0.5206611570247933,MIL,MIA,2022 REG,10,2,5,4,6,15,0,1,-2,2,1,1,0,0,0,0,0,0,0,0.5206611570247933,0.4793388429752067
87577,0.6323529411764706,0.4016064257028112,-172,149,0.610878635649866,0.389121364350134,home,MIL,under,7.5,0.5,100,0.4793388429752067,MIL,MIA,2022 REG,10,2,5,4,6,15,0,1,-2,2,1,1,0,0,0,0,0,0,0,0.5206611570247933,0.4793388429752067
87578,0.5652173913043479,0.46511627906976744,-130,115,0.5480722732668045,0.4519277267331955,away,NYM,over,9,0.5121951219512195,-105,0.48808156828023186,NYY,NYM,2022 REG,8,4,9,2,6,17,1,0,2,-2,1,1,0,0,0,0,0,0,0,0.48808156828023186,0.5119184317197681
87578,0.5652173913043479,0.46511627906976744,-130,115,0.5480722732668045,0.4519277267331955,home,NYY,under,9,0.5348837209302326,-115,0.5119184317197681,NYY,NYM,2022 REG,8,4,9,2,6,17,1,0,2,-2,1,1,0,0,0,0,0,0,0,0.48808156828023186,0.5119184317197681
87579,0.5934959349593496,0.4444444444444444,-146,125,0.5709784740123824,0.42902152598761756,away,PIT,over,11.5,0.5283018867924528,-112,0.5044173060022736,COL,PIT,2022 REG,8,2,6,0,2,14,1,0,2,-2,0,0,0,0,0,0,0,0,0,0.5044173060022736,0.49558269399772636
87579,0.5934959349593496,0.4444444444444444,-146,125,0.5709784740123824,0.42902152598761756,home,COL,under,11.5,0.5169082125603864,-107,0.49558269399772636,COL,PIT,2022 REG,8,2,6,0,2,14,1,0,2,-2,0,0,0,0,0,0,0,0,0,0.5044173060022736,0.49558269399772636
87580,0.3663003663003663,0.6666666666666666,173,-200,0.3542245300487059,0.6457754699512941,away,STL,over,8,0.5348837209302326,-115,0.5097020142727117,PIT,STL,2022 REG,15,8,6,2,10,21,1,0,6,-6,1,1,0,0,0,0,0,0,0,0.5097020142727117,0.49029798572728833
87580,0.3663003663003663,0.6666666666666666,173,-200,0.3542245300487059,0.6457754699512941,home,PIT,under,8,0.5121951219512195,-105,0.49029798572728833,PIT,STL,2022 REG,15,8,6,2,10,21,1,0,6,-6,1,1,0,0,0,0,0,0,0,0.5097020142727117,0.49029798572728833
87581,0.5614035087719298,0.48309178743961345,-128,107,0.536423693354923,0.463576306645077,away,TEX,over,6.5,0.5555555555555556,-125,0.5314664257753688,OAK,TEX,2022 REG,5,1,7,4,5,12,0,1,-3,3,1,0,0,0,0,0,0,0,0,0.5314664257753688,0.46853357422463116
87581,0.5614035087719298,0.48309178743961345,-128,107,0.536423693354923,0.463576306645077,home,OAK,under,6.5,0.48780487804878053,105,0.46853357422463116,OAK,TEX,2022 REG,5,1,7,4,5,12,0,1,-3,3,1,0,0,0,0,0,0,0,0,0.5314664257753688,0.46853357422463116
87582,0.5726495726495727,0.46511627906976744,-134,115,0.5510229738017454,0.44897702619825464,away,ATL,over,8.5,0.5283018867924528,-112,0.5044173060022736,LAD,ATL,2022 REG,8,5,3,1,6,11,1,0,4,-4,1,0,0,0,0,0,0,0,0,0.5044173060022736,0.49558269399772636
87582,0.5726495726495727,0.46511627906976744,-134,115,0.5510229738017454,0.44897702619825464,home,LAD,under,8.5,0.5169082125603864,-107,0.49558269399772636,LAD,ATL,2022 REG,8,5,3,1,6,11,1,0,4,-4,1,0,0,0,0,0,0,0,0,0.5044173060022736,0.49558269399772636
87583,0.5305164319248826,0.5073891625615764,-113,-103,0.5104068911879349,0.4895931088120651,away,SF,over,9,0.5305164319248826,-113,0.5066009958897986,CHC,SF,2022 REG,12,2,8,4,6,20,0,1,-2,2,1,1,0,0,0,0,0,0,0,0.5066009958897986,0.49339900411020143
87583,0.5305164319248826,0.5073891625615764,-113,-103,0.5104068911879349,0.4895931088120651,home,CHC,under,9,0.5145631067961165,-106,0.49339900411020143,CHC,SF,2022 REG,12,2,8,4,6,20,0,1,-2,2,1,1,0,0,0,0,0,0,0,0.5066009958897986,0.49339900411020143
87584,0.4444444444444444,0.5967741935483871,125,-148,0.42612504978096366,0.5738749502190363,away,BOS,over,8,0.5412844036697247,-118,0.5189377998484975,CHC,BOS,2022 REG,6,6,11,5,11,17,1,0,1,-1,1,1,1,1,1,0,0,0,0,0.5189377998484975,0.4810622001515025
87584,0.4444444444444444,0.5967741935483871,125,-148,0.42612504978096366,0.5738749502190363,home,CHC,under,8,0.5,100,0.4810622001515025,CHC,BOS,2022 REG,6,6,11,5,11,17,1,0,1,-1,1,1,1,1,1,0,0,0,0,0.5189377998484975,0.4810622001515025
87585,0.7777777777777779,0.2617801047120419,-350,282,0.7470105358412514,0.25298946415874857,away,OAK,over,7.5,0.5073891625615764,-103,0.4826927225525911,HOU,OAK,2022 REG,15,11,5,2,13,20,1,0,9,-9,1,1,0,0,0,0,0,0,0,0.4826927225525911,0.5173072774474089
87585,0.7777777777777779,0.2617801047120419,-350,282,0.7470105358412514,0.25298946415874857,home,HOU,under,7.5,0.5412844036697247,-118,0.5173072774474089,HOU,OAK,2022 REG,15,11,5,2,13,20,1,0,9,-9,1,1,0,0,0,0,0,0,0,0.4826927225525911,0.5173072774474089
87586,0.5454545454545454,0.49751243781094534,-120,101,0.5220180091279142,0.4779819908720858,away,CLE,over,8,0.5121951219512195,-105,0.48919479393107135,LAA,CLE,2022 REG,8,3,3,0,3,11,1,0,3,-3,0,0,0,0,0,0,0,0,0,0.48919479393107135,0.5108052060689287
87586,0.5454545454545454,0.49751243781094534,-120,101,0.5220180091279142,0.4779819908720858,home,LAA,under,8,0.5327102803738317,-114,0.5108052060689287,LAA,CLE,2022 REG,8,3,3,0,3,11,1,0,3,-3,0,0,0,0,0,0,0,0,0,0.48919479393107135,0.5108052060689287
87587,0.5815899581589958,0.45454545454545453,-139,120,0.5605739649961564,0.4394260350038436,away,CIN,over,8,0.5121951219512195,-105,0.48919479393107135,STL,CIN,2022 REG,6,2,4,0,2,10,1,0,2,-2,0,0,0,0,0,0,0,0,0,0.48919479393107135,0.5108052060689287
87587,0.5815899581589958,0.45454545454545453,-139,120,0.5605739649961564,0.4394260350038436,home,STL,under,8,0.5327102803738317,-114,0.5108052060689287,STL,CIN,2022 REG,6,2,4,0,2,10,1,0,2,-2,0,0,0,0,0,0,0,0,0,0.48919479393107135,0.5108052060689287
87588,0.6539792387543253,0.390625,-189,156,0.6248089926485555,0.3751910073514445,away,OAK,over,7.5,0.5098039215686274,-104,0.4870219861770517,TEX,OAK,2022 REG,4,5,4,2,7,8,1,0,3,-3,1,1,0,0,0,0,0,0,0,0.4870219861770517,0.5129780138229483
87588,0.6539792387543253,0.390625,-189,156,0.6248089926485555,0.3751910073514445,home,TEX,under,7.5,0.5348837209302326,-115,0.5129780138229483,TEX,OAK,2022 REG,4,5,4,2,7,8,1,0,3,-3,1,1,0,0,0,0,0,0,0,0.4870219861770517,0.5129780138229483
87589,0.5850622406639003,0.4566210045662101,-141,119,0.5606749478114291,0.4393250521885709,away,TOR,over,6.5,0.5305164319248826,-113,0.5066009958897986,TB,TOR,2022 REG,7,1,10,7,8,17,0,1,-6,6,1,0,0,0,0,0,0,0,0,0.5066009958897986,0.49339900411020143
87589,0.5850622406639003,0.4566210045662101,-141,119,0.5606749478114291,0.4393250521885709,home,TB,under,6.5,0.5145631067961165,-106,0.49339900411020143,TB,TOR,2022 REG,7,1,10,7,8,17,0,1,-6,6,1,0,0,0,0,0,0,0,0,0.5066009958897986,0.49339900411020143
87590,0.6183206106870228,0.42016806722689076,-162,138,0.5945222678547557,0.4054777321452443,away,TOR,over,8.5,0.5238095238095238,-110,0.5012646084074657,HOU,TOR,2022 REG,7,3,7,4,7,14,0,1,-1,1,1,1,1,0,0,0,0,0,0,0.5012646084074657,0.4987353915925343
87590,0.6183206106870228,0.42016806722689076,-162,138,0.5945222678547557,0.4054777321452443,home,HOU,under,8.5,0.5192307692307692,-108,0.4987353915925343,HOU,TOR,2022 REG,7,3,7,4,7,14,0,1,-1,1,1,1,1,0,0,0,0,0,0,0.5012646084074657,0.4987353915925343
87591,0.4132231404958678,0.6226415094339623,142,-165,0.3984030372190785,0.6015969627809215,away,ARI,over,10.5,0.5238095238095238,-110,0.4988662131519274,COL,ARI,2022 REG,6,6,15,12,18,21,0,1,-6,6,1,1,1,1,1,1,0,0,0,0.4988662131519274,0.5011337868480725
87591,0.4132231404958678,0.6226415094339623,142,-165,0.3984030372190785,0.6015969627809215,home,COL,under,10.5,0.5238095238095238,-110,0.5011337868480725,COL,ARI,2022 REG,6,6,15,12,18,21,0,1,-6,6,1,1,1,1,1,1,0,0,0,0.4988662131519274,0.5011337868480725
87592,0.5,0.5433789954337899,100,-119,0.4783105022831051,0.5216894977168949,away,LAA,over,9.5,0.5145631067961165,-106,0.4913668392989033,TEX,LAA,2022 REG,7,3,10,8,11,17,0,1,-5,5,1,1,1,0,0,0,0,0,0,0.4913668392989033,0.5086331607010968
87592,0.5,0.5433789954337899,100,-119,0.4783105022831051,0.5216894977168949,home,TEX,under,9.5,0.5305164319248826,-113,0.5086331607010968,TEX,LAA,2022 REG,7,3,10,8,11,17,0,1,-5,5,1,1,1,0,0,0,0,0,0,0.4913668392989033,0.5086331607010968
87593,0.36363636363636365,0.6774193548387096,175,-210,0.3487070114636097,0.6512929885363903,away,LAD,over,9,0.5192307692307692,-108,0.49688292476754015,WSH,LAD,2022 REG,7,1,12,10,11,19,0,1,-9,9,1,0,0,0,0,0,0,0,0,0.49688292476754015,0.5031170752324599
87593,0.36363636363636365,0.6774193548387096,175,-210,0.3487070114636097,0.6512929885363903,home,WSH,under,9,0.5238095238095238,-110,0.5031170752324599,WSH,LAD,2022 REG,7,1,12,10,11,19,0,1,-9,9,1,0,0,0,0,0,0,0,0,0.49688292476754015,0.5031170752324599
87594,0.6336996336996338,0.4016064257028112,-173,149,0.6113261967889269,0.38867380321107314,away,CWS,over,7.5,0.5238095238095238,-110,0.5000596729920038,CLE,CWS,2022 REG,5,0,5,2,2,10,0,1,-2,2,0,0,0,0,0,0,0,0,0,0.5000596729920038,0.4999403270079962
87594,0.6336996336996338,0.4016064257028112,-173,149,0.6113261967889269,0.38867380321107314,home,CLE,under,7.5,0.5215311004784688,-109,0.4999403270079962,CLE,CWS,2022 REG,5,0,5,2,2,10,0,1,-2,2,0,0,0,0,0,0,0,0,0,0.5000596729920038,0.4999403270079962
87595,0.2777777777777778,0.7647058823529411,260,-325,0.26597676107480034,0.7340232389251997,away,NYM,over,6.5,0.5454545454545454,-120,0.5206611570247933,OAK,NYM,2022 REG,8,4,19,13,17,27,0,1,-9,9,1,1,1,1,0,0,0,0,0,0.5206611570247933,0.4793388429752067
87595,0.2777777777777778,0.7647058823529411,260,-325,0.26597676107480034,0.7340232389251997,home,OAK,under,6.5,0.5,100,0.4793388429752067,OAK,NYM,2022 REG,8,4,19,13,17,27,0,1,-9,9,1,1,1,1,0,0,0,0,0,0.5206611570247933,0.4793388429752067
87596,0.5454545454545454,0.5,-120,100,0.5206611570247933,0.4793388429752067,away,TB,over,8.5,0.5454545454545454,-120,0.5206611570247933,BOS,TB,2022 REG,6,1,10,7,8,16,0,1,-6,6,1,0,0,0,0,0,0,0,0,0.5206611570247933,0.4793388429752067
87596,0.5454545454545454,0.5,-120,100,0.5206611570247933,0.4793388429752067,home,BOS,under,8.5,0.5,100,0.4793388429752067,BOS,TB,2022 REG,6,1,10,7,8,16,0,1,-6,6,1,0,0,0,0,0,0,0,0,0.5206611570247933,0.4793388429752067
87597,0.5708154506437768,0.4672897196261683,-133,114,0.5490644307042802,0.45093556929571976,away,CWS,over,9,0.5121951219512195,-105,0.48808156828023186,MIN,CWS,2022 REG,10,6,9,3,9,19,1,0,3,-3,1,1,1,0,0,0,0,0,0,0.48808156828023186,0.5119184317197681
87597,0.5708154506437768,0.4672897196261683,-133,114,0.5490644307042802,0.45093556929571976,home,MIN,under,9,0.5348837209302326,-115,0.5119184317197681,MIN,CWS,2022 REG,10,6,9,3,9,19,1,0,3,-3,1,1,1,0,0,0,0,0,0,0.48808156828023186,0.5119184317197681
87598,0.6491228070175439,0.390625,-185,156,0.6233215989535241,0.3766784010464759,away,ARI,over,7.5,0.5238095238095238,-110,0.4988662131519274,CWS,ARI,2022 REG,7,2,3,3,5,10,0,1,-1,1,1,1,0,0,0,0,0,0,0,0.4988662131519274,0.5011337868480725
87598,0.6491228070175439,0.390625,-185,156,0.6233215989535241,0.3766784010464759,home,CWS,under,7.5,0.5238095238095238,-110,0.5011337868480725,CWS,ARI,2022 REG,7,2,3,3,5,10,0,1,-1,1,1,1,0,0,0,0,0,0,0,0.4988662131519274,0.5011337868480725
87599,0.46511627906976744,0.574468085106383,115,-135,0.44670494689481377,0.5532950531051862,away,HOU,over,8,0.5238095238095238,-110,0.4988662131519274,MIN,HOU,2022 REG,7,0,9,5,5,16,0,1,-5,5,0,0,0,0,0,0,0,0,0,0.4988662131519274,0.5011337868480725
87599,0.46511627906976744,0.574468085106383,115,-135,0.44670494689481377,0.5532950531051862,home,MIN,under,8,0.5238095238095238,-110,0.5011337868480725,MIN,HOU,2022 REG,7,0,9,5,5,16,0,1,-5,5,0,0,0,0,0,0,0,0,0,0.4988662131519274,0.5011337868480725
87600,0.7701149425287357,0.27027027027027023,-335,270,0.7390136866950185,0.26098631330498145,away,WSH,over,8,0.5215311004784688,-109,0.4978845547971712,SEA,WSH,2022 REG,5,1,10,3,4,15,0,1,-2,2,1,0,0,0,0,0,0,0,0,0.4978845547971712,0.5021154452028288
87600,0.7701149425287357,0.27027027027027023,-335,270,0.7390136866950185,0.26098631330498145,home,SEA,under,8,0.5238095238095238,-110,0.5021154452028288,SEA,WSH,2022 REG,5,1,10,3,4,15,0,1,-2,2,1,0,0,0,0,0,0,0,0,0.4978845547971712,0.5021154452028288
87601,0.4081632653061224,0.6254681647940076,145,-167,0.39443615097953877,0.6055638490204612,away,NYY,over,8,0.5283018867924528,-112,0.5044173060022736,LAA,NYY,2022 REG,9,4,6,3,7,15,1,0,1,-1,1,1,1,0,0,0,0,0,0,0.5044173060022736,0.49558269399772636
87601,0.4081632653061224,0.6254681647940076,145,-167,0.39443615097953877,0.6055638490204612,home,LAA,under,8,0.5169082125603864,-107,0.49558269399772636,LAA,NYY,2022 REG,9,4,6,3,7,15,1,0,1,-1,1,1,1,0,0,0,0,0,0,0.5044173060022736,0.49558269399772636
87602,0.4587155963302753,0.5798319327731092,118,-138,0.4410332435305576,0.5589667564694424,away,MIN,over,8,0.5238095238095238,-110,0.5012646084074657,CWS,MIN,2022 REG,11,4,8,3,7,19,1,0,1,-1,1,1,1,0,0,0,0,0,0,0.5012646084074657,0.4987353915925343
87602,0.4587155963302753,0.5798319327731092,118,-138,0.4410332435305576,0.5589667564694424,home,CWS,under,8,0.5192307692307692,-108,0.4987353915925343,CWS,MIN,2022 REG,11,4,8,3,7,19,1,0,1,-1,1,1,1,0,0,0,0,0,0,0.5012646084074657,0.4987353915925343
87603,0.7737556561085973,0.27027027027027023,-342,270,0.7396903465575279,0.26030965344247214,away,PIT,over,8.5,0.5073891625615764,-103,0.4837652908580103,LAD,PIT,2022 REG,4,3,11,5,8,15,0,1,-2,2,1,1,1,0,0,0,0,0,0,0.4837652908580103,0.5162347091419897
87603,0.7737556561085973,0.27027027027027023,-342,270,0.7396903465575279,0.26030965344247214,home,LAD,under,8.5,0.5391705069124424,-117,0.5162347091419897,LAD,PIT,2022 REG,4,3,11,5,8,15,0,1,-2,2,1,1,1,0,0,0,0,0,0,0.4837652908580103,0.5162347091419897
87604,0.5348837209302326,0.5121951219512195,-115,-105,0.5097020142727117,0.49029798572728833,away,STL,over,8,0.504950495049505,-102,0.4826715732667395,NYM,STL,2022 REG,8,3,6,1,4,14,1,0,2,-2,1,0,0,0,0,0,0,0,0,0.4826715732667395,0.5173284267332605
87604,0.5348837209302326,0.5121951219512195,-115,-105,0.5097020142727117,0.49029798572728833,home,NYM,under,8,0.5391705069124424,-117,0.5173284267332605,NYM,STL,2022 REG,8,3,6,1,4,14,1,0,2,-2,1,0,0,0,0,0,0,0,0,0.4826715732667395,0.5173284267332605
87605,0.7701149425287357,0.273972602739726,-335,265,0.7361624651380813,0.26383753486191874,away,COL,over,7.5,0.5348837209302326,-115,0.5109810284308424,LAD,COL,2022 REG,8,6,2,1,7,10,1,0,5,-5,1,0,0,0,0,0,0,0,0,0.5109810284308424,0.48901897156915763
87605,0.7701149425287357,0.273972602739726,-335,265,0.7361624651380813,0.26383753486191874,home,LAD,under,7.5,0.5098039215686274,-104,0.48901897156915763,LAD,COL,2022 REG,8,6,2,1,7,10,1,0,5,-5,1,0,0,0,0,0,0,0,0,0.5109810284308424,0.48901897156915763
87606,0.607843137254902,0.43103448275862066,-155,132,0.5842116427368785,0.41578835726312147,away,TEX,over,8,0.5121951219512195,-105,0.48808156828023186,SEA,TEX,2022 REG,9,4,8,2,6,17,1,0,2,-2,1,1,0,0,0,0,0,0,0,0.48808156828023186,0.5119184317197681
87606,0.607843137254902,0.43103448275862066,-155,132,0.5842116427368785,0.41578835726312147,home,SEA,under,8,0.5348837209302326,-115,0.5119184317197681,SEA,TEX,2022 REG,9,4,8,2,6,17,1,0,2,-2,1,1,0,0,0,0,0,0,0,0.48808156828023186,0.5119184317197681
87607,0.6226415094339623,0.4166666666666667,-165,140,0.5981666073335706,0.40183339266642937,away,BOS,over,8,0.5348837209302326,-115,0.5097020142727117,NYY,BOS,2022 REG,9,4,9,5,9,18,0,1,-1,1,1,1,1,1,0,0,0,0,0,0.5097020142727117,0.49029798572728833
87607,0.6226415094339623,0.4166666666666667,-165,140,0.5981666073335706,0.40183339266642937,home,NYY,under,8,0.5121951219512195,-105,0.49029798572728833,NYY,BOS,2022 REG,9,4,9,5,9,18,0,1,-1,1,1,1,1,1,0,0,0,0,0,0.5097020142727117,0.49029798572728833
87608,0.613899613899614,0.425531914893617,-159,135,0.589692613597978,0.410307386402022,away,LAA,over,8,0.5192307692307692,-108,0.49688292476754015,HOU,LAA,2022 REG,6,2,13,7,9,19,0,1,-5,5,1,1,0,0,0,0,0,0,0,0.49688292476754015,0.5031170752324599
87608,0.613899613899614,0.425531914893617,-159,135,0.589692613597978,0.410307386402022,home,HOU,under,8,0.5238095238095238,-110,0.5031170752324599,HOU,LAA,2022 REG,6,2,13,7,9,19,0,1,-5,5,1,1,0,0,0,0,0,0,0,0.49688292476754015,0.5031170752324599
87609,0.601593625498008,0.4347826086956522,-151,130,0.5797099148874794,0.42029008511252064,away,CHC,over,7.5,0.504950495049505,-102,0.4826715732667395,MIL,CHC,2022 REG,7,3,2,4,7,9,0,1,-1,1,1,1,1,0,0,0,0,0,0,0.4826715732667395,0.5173284267332605
87609,0.601593625498008,0.4347826086956522,-151,130,0.5797099148874794,0.42029008511252064,home,MIL,under,7.5,0.5391705069124424,-117,0.5173284267332605,MIL,CHC,2022 REG,7,3,2,4,7,9,0,1,-1,1,1,1,1,0,0,0,0,0,0,0.4826715732667395,0.5173284267332605
87610,0.38759689922480617,0.6551724137931035,158,-190,0.37101964611708926,0.6289803538829107,away,TB,over,8.5,0.5121951219512195,-105,0.48919479393107135,DET,TB,2022 REG,3,0,9,7,7,12,0,1,-7,7,0,0,0,0,0,0,0,0,0,0.48919479393107135,0.5108052060689287
87610,0.38759689922480617,0.6551724137931035,158,-190,0.37101964611708926,0.6289803538829107,home,DET,under,8.5,0.5327102803738317,-114,0.5108052060689287,DET,TB,2022 REG,3,0,9,7,7,12,0,1,-7,7,0,0,0,0,0,0,0,0,0,0.48919479393107135,0.5108052060689287
87611,0.5708154506437768,0.4694835680751174,-133,113,0.5478121481132493,0.4521878518867507,away,KC,over,8,0.5121951219512195,-105,0.48919479393107135,CWS,KC,2022 REG,12,7,13,9,16,25,0,1,-2,2,1,1,1,1,1,1,1,0,0,0.48919479393107135,0.5108052060689287
87611,0.5708154506437768,0.4694835680751174,-133,113,0.5478121481132493,0.4521878518867507,home,CWS,under,8,0.5327102803738317,-114,0.5108052060689287,CWS,KC,2022 REG,12,7,13,9,16,25,0,1,-2,2,1,1,1,1,1,1,1,0,0,0.48919479393107135,0.5108052060689287
87612,0.6212121212121212,0.4166666666666667,-164,140,0.5976813590449954,0.4023186409550046,away,ARI,over,7,0.5391705069124424,-117,0.5140669063204599,SD,ARI,2022 REG,6,6,10,5,11,16,1,0,1,-1,1,1,1,1,1,0,0,0,0,0.5140669063204599,0.4859330936795401
87612,0.6212121212121212,0.4166666666666667,-164,140,0.5976813590449954,0.4023186409550046,home,SD,under,7,0.5073891625615764,-103,0.4859330936795401,SD,ARI,2022 REG,6,6,10,5,11,16,1,0,1,-1,1,1,1,1,1,0,0,0,0,0.5140669063204599,0.4859330936795401
87613,0.5833333333333333,0.45454545454545453,-140,120,0.5612373737373737,0.4387626262626263,away,SEA,over,8,0.5348837209302326,-115,0.5097020142727117,TOR,SEA,2022 REG,6,3,6,0,3,12,1,0,3,-3,0,0,0,0,0,0,0,0,0,0.5097020142727117,0.49029798572728833
87613,0.5833333333333333,0.45454545454545453,-140,120,0.5612373737373737,0.4387626262626263,home,TOR,under,8,0.5121951219512195,-105,0.49029798572728833,TOR,SEA,2022 REG,6,3,6,0,3,12,1,0,3,-3,0,0,0,0,0,0,0,0,0,0.5097020142727117,0.49029798572728833
87614,0.2898550724637681,0.7481108312342569,245,-297,0.2788504626962246,0.7211495373037754,away,LAD,over,9.5,0.5215311004784688,-109,0.4978845547971712,KC,LAD,2022 REG,10,3,16,13,16,26,0,1,-10,10,1,1,1,0,0,0,0,0,0,0.4978845547971712,0.5021154452028288
87614,0.2898550724637681,0.7481108312342569,245,-297,0.2788504626962246,0.7211495373037754,home,KC,under,9.5,0.5238095238095238,-110,0.5021154452028288,KC,LAD,2022 REG,10,3,16,13,16,26,0,1,-10,10,1,1,1,0,0,0,0,0,0,0.4978845547971712,0.5021154452028288
87615,0.6240601503759399,0.41493775933609955,-166,141,0.5997231089766972,0.40027689102330277,away,COL,over,8,0.5348837209302326,-115,0.5097020142727117,SF,COL,2022 REG,9,6,4,3,9,13,1,0,3,-3,1,1,1,0,0,0,0,0,0,0.5097020142727117,0.49029798572728833
87615,0.6240601503759399,0.41493775933609955,-166,141,0.5997231089766972,0.40027689102330277,home,SF,under,8,0.5121951219512195,-105,0.49029798572728833,SF,COL,2022 REG,9,6,4,3,9,13,1,0,3,-3,1,1,1,0,0,0,0,0,0,0.5097020142727117,0.49029798572728833
87616,0.6309963099630996,0.41152263374485604,-171,143,0.6041670133798509,0.3958329866201491,away,WSH,over,9.5,0.5098039215686274,-104,0.4870219861770517,PHI,WSH,2022 REG,13,11,3,0,11,16,1,0,11,-11,0,0,0,0,0,0,0,0,0,0.4870219861770517,0.5129780138229483
87616,0.6309963099630996,0.41152263374485604,-171,143,0.6041670133798509,0.3958329866201491,home,PHI,under,9.5,0.5348837209302326,-115,0.5129780138229483,PHI,WSH,2022 REG,13,11,3,0,11,16,1,0,11,-11,0,0,0,0,0,0,0,0,0,0.4870219861770517,0.5129780138229483
87617,0.4,0.6415770609318996,150,-179,0.38336917562724016,0.6166308243727598,away,LAA,over,6.5,0.5391705069124424,-117,0.5127649394825569,OAK,LAA,2022 REG,6,1,10,5,6,16,0,1,-4,4,1,0,0,0,0,0,0,0,0,0.5127649394825569,0.48723506051744314
87617,0.4,0.6415770609318996,150,-179,0.38336917562724016,0.6166308243727598,home,OAK,under,6.5,0.5098039215686274,-104,0.48723506051744314,OAK,LAA,2022 REG,6,1,10,5,6,16,0,1,-4,4,1,0,0,0,0,0,0,0,0,0.5127649394825569,0.48723506051744314
87618,0.6721311475409836,0.36363636363636365,-205,175,0.6480906892086682,0.3519093107913318,away,OAK,over,9.5,0.49504950495049505,102,0.47297076509898783,PHI,OAK,2022 REG,7,4,5,2,6,12,1,0,2,-2,1,1,0,0,0,0,0,0,0,0.47297076509898783,0.5270292349010122
87618,0.6721311475409836,0.36363636363636365,-205,175,0.6480906892086682,0.3519093107913318,home,PHI,under,9.5,0.5495495495495495,-122,0.5270292349010122,PHI,OAK,2022 REG,7,4,5,2,6,12,1,0,2,-2,1,1,0,0,0,0,0,0,0,0.47297076509898783,0.5270292349010122
87619,0.5121951219512195,0.5348837209302326,-105,-115,0.48808156828023186,0.5119184317197681,away,MIA,over,9.5,0.5391705069124424,-117,0.5140669063204599,WSH,MIA,2022 REG,7,3,7,5,8,14,0,1,-2,2,1,1,1,0,0,0,0,0,0,0.5140669063204599,0.4859330936795401
87619,0.5121951219512195,0.5348837209302326,-105,-115,0.48808156828023186,0.5119184317197681,home,WSH,under,9.5,0.5073891625615764,-103,0.4859330936795401,WSH,MIA,2022 REG,7,3,7,5,8,14,0,1,-2,2,1,1,1,0,0,0,0,0,0,0.5140669063204599,0.4859330936795401
87620,0.5121951219512195,0.5283018867924528,-105,-112,0.49145275161909474,0.5085472483809053,away,TEX,over,7.5,0.5348837209302326,-115,0.5109810284308424,OAK,TEX,2022 REG,10,4,18,11,15,28,0,1,-7,7,1,1,1,1,0,0,0,0,0,0.5109810284308424,0.48901897156915763
87620,0.5121951219512195,0.5283018867924528,-105,-112,0.49145275161909474,0.5085472483809053,home,OAK,under,7.5,0.5098039215686274,-104,0.48901897156915763,OAK,TEX,2022 REG,10,4,18,11,15,28,0,1,-7,7,1,1,1,1,0,0,0,0,0,0.5109810284308424,0.48901897156915763
87621,0.36363636363636365,0.6721311475409836,175,-205,0.3506299959355101,0.6493700040644899,away,LAD,over,9.5,0.5215311004784688,-109,0.49907282342437215,ARI,LAD,2022 REG,8,1,4,3,4,12,0,1,-2,2,1,0,0,0,0,0,0,0,0,0.49907282342437215,0.5009271765756278
87621,0.36363636363636365,0.6721311475409836,175,-205,0.3506299959355101,0.6493700040644899,home,ARI,under,9.5,0.5215311004784688,-109,0.5009271765756278,ARI,LAD,2022 REG,8,1,4,3,4,12,0,1,-2,2,1,0,0,0,0,0,0,0,0,0.49907282342437215,0.5009271765756278
87622,0.37735849056603776,0.6644295302013422,165,-198,0.36158942612551703,0.638410573874483,away,TOR,over,7.5,0.5145631067961165,-106,0.4913668392989033,CLE,TOR,2022 REG,9,4,4,3,7,13,1,0,1,-1,1,1,1,0,0,0,0,0,0,0.4913668392989033,0.5086331607010968
87622,0.37735849056603776,0.6644295302013422,165,-198,0.36158942612551703,0.638410573874483,home,CLE,under,7.5,0.5305164319248826,-113,0.5086331607010968,CLE,TOR,2022 REG,9,4,4,3,7,13,1,0,1,-1,1,1,1,0,0,0,0,0,0,0.4913668392989033,0.5086331607010968
87623,0.5454545454545454,0.49751243781094534,-120,101,0.5220180091279142,0.4779819908720858,away,BOS,over,7.5,0.49504950495049505,102,0.47297076509898783,ATL,BOS,2022 REG,8,5,7,3,8,15,1,0,2,-2,1,1,1,0,0,0,0,0,0,0.47297076509898783,0.5270292349010122
87623,0.5454545454545454,0.49751243781094534,-120,101,0.5220180091279142,0.4779819908720858,home,ATL,under,7.5,0.5495495495495495,-122,0.5270292349010122,ATL,BOS,2022 REG,8,5,7,3,8,15,1,0,2,-2,1,1,1,0,0,0,0,0,0,0.47297076509898783,0.5270292349010122
87624,0.5689655172413793,0.4694835680751174,-132,113,0.5470893135268209,0.4529106864731791,away,PHI,over,8,0.5073891625615764,-103,0.4837652908580103,TEX,PHI,2022 REG,11,7,6,0,7,17,1,0,7,-7,0,0,0,0,0,0,0,0,0,0.4837652908580103,0.5162347091419897
87624,0.5689655172413793,0.4694835680751174,-132,113,0.5470893135268209,0.4529106864731791,home,TEX,under,8,0.5391705069124424,-117,0.5162347091419897,TEX,PHI,2022 REG,11,7,6,0,7,17,1,0,7,-7,0,0,0,0,0,0,0,0,0,0.4837652908580103,0.5162347091419897
87625,0.45248868778280543,0.5833333333333333,121,-140,0.4362796284542359,0.5637203715457642,away,LAA,over,8,0.5238095238095238,-110,0.4988662131519274,TEX,LAA,2022 REG,8,7,9,4,11,17,1,0,3,-3,1,1,1,1,0,0,0,0,0,0.4988662131519274,0.5011337868480725
87625,0.45248868778280543,0.5833333333333333,121,-140,0.4362796284542359,0.5637203715457642,home,TEX,under,8,0.5238095238095238,-110,0.5011337868480725,TEX,LAA,2022 REG,8,7,9,4,11,17,1,0,3,-3,1,1,1,1,0,0,0,0,0,0.4988662131519274,0.5011337868480725
87626,0.6363636363636364,0.40322580645161293,-175,148,0.6111703545721141,0.3888296454278859,away,MIA,over,8.5,0.5098039215686274,-104,0.48592421718142587,NYM,MIA,2022 REG,12,10,2,0,10,14,1,0,10,-10,0,0,0,0,0,0,0,0,0,0.48592421718142587,0.5140757828185741
87626,0.6363636363636364,0.40322580645161293,-175,148,0.6111703545721141,0.3888296454278859,home,NYM,under,8.5,0.5370370370370371,-116,0.5140757828185741,NYM,MIA,2022 REG,12,10,2,0,10,14,1,0,10,-10,0,0,0,0,0,0,0,0,0,0.48592421718142587,0.5140757828185741
87627,0.38167938931297707,0.6551724137931035,162,-190,0.3676138156083661,0.6323861843916339,away,LAD,over,11.5,0.5327102803738317,-114,0.508788710910954,COL,LAD,2022 REG,11,4,3,0,4,14,1,0,4,-4,0,0,0,0,0,0,0,0,0,0.508788710910954,0.491211289089046
87627,0.38167938931297707,0.6551724137931035,162,-190,0.3676138156083661,0.6323861843916339,home,COL,under,11.5,0.5121951219512195,-105,0.491211289089046,COL,LAD,2022 REG,11,4,3,0,4,14,1,0,4,-4,0,0,0,0,0,0,0,0,0,0.508788710910954,0.491211289089046
87628,0.5633187772925764,0.47619047619047616,-129,110,0.5410624729287608,0.45893752707123925,away,SEA,over,8.5,0.5169082125603864,-107,0.49353874091423283,HOU,SEA,2022 REG,8,3,5,0,3,13,1,0,3,-3,0,0,0,0,0,0,0,0,0,0.49353874091423283,0.5064612590857671
87628,0.5633187772925764,0.47619047619047616,-129,110,0.5410624729287608,0.45893752707123925,home,HOU,under,8.5,0.5283018867924528,-112,0.5064612590857671,HOU,SEA,2022 REG,8,3,5,0,3,13,1,0,3,-3,0,0,0,0,0,0,0,0,0,0.49353874091423283,0.5064612590857671
87629,0.6428571428571428,0.3921568627450981,-180,155,0.6203481392557023,0.3796518607442977,away,DET,over,8.5,0.5145631067961165,-106,0.4913668392989033,HOU,DET,2022 REG,5,5,1,0,5,6,1,0,5,-5,0,0,0,0,0,0,0,0,0,0.4913668392989033,0.5086331607010968
87629,0.6428571428571428,0.3921568627450981,-180,155,0.6203481392557023,0.3796518607442977,home,HOU,under,8.5,0.5305164319248826,-113,0.5086331607010968,HOU,DET,2022 REG,5,5,1,0,5,6,1,0,5,-5,0,0,0,0,0,0,0,0,0,0.4913668392989033,0.5086331607010968
87630,0.46511627906976744,0.5726495726495727,115,-134,0.4475507666421673,0.5524492333578327,away,SF,over,11,0.5121951219512195,-105,0.48919479393107135,COL,SF,2022 REG,11,8,10,9,17,21,0,1,-1,1,1,1,1,1,1,1,1,1,0,0.48919479393107135,0.5108052060689287
87630,0.46511627906976744,0.5726495726495727,115,-134,0.4475507666421673,0.5524492333578327,home,COL,under,11,0.5327102803738317,-114,0.5108052060689287,COL,SF,2022 REG,11,8,10,9,17,21,0,1,-1,1,1,1,1,1,1,1,1,1,0,0.48919479393107135,0.5108052060689287
87631,0.5780590717299579,0.4587155963302753,-137,118,0.5568011412478822,0.44319885875211784,away,DET,over,8,0.5145631067961165,-106,0.4913668392989033,BOS,DET,2022 REG,9,6,5,2,8,14,1,0,4,-4,1,1,0,0,0,0,0,0,0,0.4913668392989033,0.5086331607010968
87631,0.5780590717299579,0.4587155963302753,-137,118,0.5568011412478822,0.44319885875211784,home,BOS,under,8,0.5305164319248826,-113,0.5086331607010968,BOS,DET,2022 REG,9,6,5,2,8,14,1,0,4,-4,1,1,0,0,0,0,0,0,0,0.4913668392989033,0.5086331607010968
87632,0.5951417004048584,0.4464285714285714,-147,124,0.5704014981396188,0.4295985018603812,away,KC,over,9.5,0.5098039215686274,-104,0.4870219861770517,CLE,KC,2022 REG,12,8,7,3,11,19,1,0,5,-5,1,1,1,0,0,0,0,0,0,0.4870219861770517,0.5129780138229483
87632,0.5951417004048584,0.4464285714285714,-147,124,0.5704014981396188,0.4295985018603812,home,CLE,under,9.5,0.5348837209302326,-115,0.5129780138229483,CLE,KC,2022 REG,12,8,7,3,11,19,1,0,5,-5,1,1,1,0,0,0,0,0,0,0.4870219861770517,0.5129780138229483
87633,0.42194092827004215,0.6226415094339623,137,-165,0.40312977312067316,0.5968702268793269,away,CWS,over,8,0.5169082125603864,-107,0.4946943078742622,KC,CWS,2022 REG,9,0,5,3,3,14,0,1,-3,3,0,0,0,0,0,0,0,0,0,0.4946943078742622,0.5053056921257377
87633,0.42194092827004215,0.6226415094339623,137,-165,0.40312977312067316,0.5968702268793269,home,KC,under,8,0.5260663507109005,-111,0.5053056921257377,KC,CWS,2022 REG,9,0,5,3,3,14,0,1,-3,3,0,0,0,0,0,0,0,0,0,0.4946943078742622,0.5053056921257377
87634,0.5260663507109005,0.5238095238095238,-111,-110,0.49982833141342614,0.5001716685865738,away,PIT,over,9,0.5475113122171946,-121,0.5174526812297228,CIN,PIT,2022 REG,8,2,7,4,6,15,0,1,-2,2,1,1,0,0,0,0,0,0,0,0.5174526812297228,0.48254731877027723
87634,0.5260663507109005,0.5238095238095238,-111,-110,0.49982833141342614,0.5001716685865738,home,CIN,under,9,0.5073891625615764,-103,0.48254731877027723,CIN,PIT,2022 REG,8,2,7,4,6,15,0,1,-2,2,1,1,0,0,0,0,0,0,0,0.5174526812297228,0.48254731877027723
87635,0.4608294930875576,0.5798319327731092,117,-138,0.4420915088199692,0.5579084911800307,away,STL,over,9.5,0.5283018867924528,-112,0.5044173060022736,WSH,STL,2022 REG,8,7,10,6,13,18,1,0,1,-1,1,1,1,1,1,1,0,0,0,0.5044173060022736,0.49558269399772636
87635,0.4608294930875576,0.5798319327731092,117,-138,0.4420915088199692,0.5579084911800307,home,WSH,under,9.5,0.5169082125603864,-107,0.49558269399772636,WSH,STL,2022 REG,8,7,10,6,13,18,1,0,1,-1,1,1,1,1,1,1,0,0,0,0.5044173060022736,0.49558269399772636
87636,0.574468085106383,0.46511627906976744,-135,115,0.5517281312179562,0.44827186878204384,away,CIN,over,8,0.5145631067961165,-106,0.4913668392989033,CLE,CIN,2022 REG,3,2,8,4,6,11,0,1,-2,2,1,1,0,0,0,0,0,0,0,0.4913668392989033,0.5086331607010968
87636,0.574468085106383,0.46511627906976744,-135,115,0.5517281312179562,0.44827186878204384,home,CLE,under,8,0.5305164319248826,-113,0.5086331607010968,CLE,CIN,2022 REG,3,2,8,4,6,11,0,1,-2,2,1,1,0,0,0,0,0,0,0,0.4913668392989033,0.5086331607010968
87637,0.47619047619047616,0.5652173913043479,110,-130,0.4564724440500838,0.5435275559499162,away,TOR,over,8.5,0.5121951219512195,-105,0.48808156828023186,DET,TOR,2022 REG,2,0,11,6,6,13,0,1,-6,6,0,0,0,0,0,0,0,0,0,0.48808156828023186,0.5119184317197681
87637,0.47619047619047616,0.5652173913043479,110,-130,0.4564724440500838,0.5435275559499162,home,DET,under,8.5,0.5348837209302326,-115,0.5119184317197681,DET,TOR,2022 REG,2,0,11,6,6,13,0,1,-6,6,0,0,0,0,0,0,0,0,0,0.48808156828023186,0.5119184317197681
87638,0.6197718631178707,0.4184100418410042,-163,139,0.5961077927441193,0.4038922072558807,away,CHC,over,8.5,0.5348837209302326,-115,0.5097020142727117,STL,CHC,2022 REG,11,6,7,0,6,18,1,0,6,-6,0,0,0,0,0,0,0,0,0,0.5097020142727117,0.49029798572728833
87638,0.6197718631178707,0.4184100418410042,-163,139,0.5961077927441193,0.4038922072558807,home,STL,under,8.5,0.5121951219512195,-105,0.49029798572728833,STL,CHC,2022 REG,11,6,7,0,6,18,1,0,6,-6,0,0,0,0,0,0,0,0,0,0.5097020142727117,0.49029798572728833
87639,0.5614035087719298,0.4854368932038835,-128,106,0.5351071427504206,0.4648928572495794,away,STL,over,7,0.5305164319248826,-113,0.5066009958897986,SF,STL,2022 REG,7,2,6,3,5,13,0,1,-1,1,1,1,0,0,0,0,0,0,0,0.5066009958897986,0.49339900411020143
87639,0.5614035087719298,0.4854368932038835,-128,106,0.5351071427504206,0.4648928572495794,home,SF,under,7,0.5145631067961165,-106,0.49339900411020143,SF,STL,2022 REG,7,2,6,3,5,13,0,1,-1,1,1,1,0,0,0,0,0,0,0,0.5066009958897986,0.49339900411020143
87640,0.3436426116838488,0.6923076923076923,191,-225,0.33128855532936735,0.6687114446706326,away,NYM,over,7,0.5348837209302326,-115,0.5097020142727117,OAK,NYM,2022 REG,6,2,13,9,11,19,0,1,-7,7,1,1,0,0,0,0,0,0,0,0.5097020142727117,0.49029798572728833
87640,0.3436426116838488,0.6923076923076923,191,-225,0.33128855532936735,0.6687114446706326,home,OAK,under,7,0.5121951219512195,-105,0.49029798572728833,OAK,NYM,2022 REG,6,2,13,9,11,19,0,1,-7,7,1,1,0,0,0,0,0,0,0,0.5097020142727117,0.49029798572728833
87641,0.5,0.5433789954337899,100,-119,0.4783105022831051,0.5216894977168949,away,MIL,over,8,0.5121951219512195,-105,0.48919479393107135,CHC,MIL,2022 REG,7,4,8,3,7,15,1,0,1,-1,1,1,1,0,0,0,0,0,0,0.48919479393107135,0.5108052060689287
87641,0.5,0.5433789954337899,100,-119,0.4783105022831051,0.5216894977168949,home,CHC,under,8,0.5327102803738317,-114,0.5108052060689287,CHC,MIL,2022 REG,7,4,8,3,7,15,1,0,1,-1,1,1,1,0,0,0,0,0,0,0.48919479393107135,0.5108052060689287
87642,0.4716981132075471,0.5652173913043479,112,-130,0.4542851393811816,0.5457148606188185,away,TB,over,6.5,0.5454545454545454,-120,0.5206611570247933,SEA,TB,2022 REG,5,3,7,4,7,12,0,1,-1,1,1,1,1,0,0,0,0,0,0,0.5206611570247933,0.4793388429752067
87642,0.4716981132075471,0.5652173913043479,112,-130,0.4542851393811816,0.5457148606188185,home,SEA,under,6.5,0.5,100,0.4793388429752067,SEA,TB,2022 REG,5,3,7,4,7,12,0,1,-1,1,1,1,1,0,0,0,0,0,0,0.5206611570247933,0.4793388429752067
87643,0.5780590717299579,0.4566210045662101,-137,119,0.558011939018671,0.44198806098132903,away,DET,over,8.5,0.5121951219512195,-105,0.48919479393107135,LAA,DET,2022 REG,7,5,8,4,9,15,1,0,1,-1,1,1,1,1,0,0,0,0,0,0.48919479393107135,0.5108052060689287
87643,0.5780590717299579,0.4566210045662101,-137,119,0.558011939018671,0.44198806098132903,home,LAA,under,8.5,0.5327102803738317,-114,0.5108052060689287,LAA,DET,2022 REG,7,5,8,4,9,15,1,0,1,-1,1,1,1,1,0,0,0,0,0,0.48919479393107135,0.5108052060689287
87644,0.5348837209302326,0.5098039215686274,-115,-104,0.5109810284308424,0.48901897156915763,away,BOS,over,8.5,0.5283018867924528,-112,0.5056562298022652,TEX,BOS,2022 REG,6,7,7,1,8,13,1,0,6,-6,1,0,0,0,0,0,0,0,0,0.5056562298022652,0.4943437701977348
87644,0.5348837209302326,0.5098039215686274,-115,-104,0.5109810284308424,0.48901897156915763,home,TEX,under,8.5,0.5145631067961165,-106,0.4943437701977348,TEX,BOS,2022 REG,6,7,7,1,8,13,1,0,6,-6,1,0,0,0,0,0,0,0,0,0.5056562298022652,0.4943437701977348
87645,0.4424778761061947,0.5934959349593496,126,-146,0.42656026059046714,0.5734397394095329,away,TB,over,8.5,0.5454545454545454,-120,0.5233614270517961,BAL,TB,2022 REG,5,1,8,0,1,13,1,0,1,-1,0,0,0,0,0,0,0,0,0,0.5233614270517961,0.4766385729482039
87645,0.4424778761061947,0.5934959349593496,126,-146,0.42656026059046714,0.5734397394095329,home,BAL,under,8.5,0.49504950495049505,102,0.4766385729482039,BAL,TB,2022 REG,5,1,8,0,1,13,1,0,1,-1,0,0,0,0,0,0,0,0,0,0.5233614270517961,0.4766385729482039
87646,0.5967741935483871,0.4444444444444444,-148,125,0.5721759741010521,0.42782402589894786,away,MIA,over,7.5,0.5121951219512195,-105,0.48808156828023186,SF,MIA,2022 REG,5,1,5,2,3,10,0,1,-1,1,1,0,0,0,0,0,0,0,0,0.48808156828023186,0.5119184317197681
87646,0.5967741935483871,0.4444444444444444,-148,125,0.5721759741010521,0.42782402589894786,home,SF,under,7.5,0.5348837209302326,-115,0.5119184317197681,SF,MIA,2022 REG,5,1,5,2,3,10,0,1,-1,1,1,0,0,0,0,0,0,0,0,0.48808156828023186,0.5119184317197681
87647,0.5633187772925764,0.47619047619047616,-129,110,0.5410624729287608,0.45893752707123925,away,MIA,over,8.5,0.5098039215686274,-104,0.4870219861770517,SF,MIA,2022 REG,6,3,11,2,5,17,1,0,1,-1,1,1,0,0,0,0,0,0,0,0.4870219861770517,0.5129780138229483
87647,0.5633187772925764,0.47619047619047616,-129,110,0.5410624729287608,0.45893752707123925,home,SF,under,8.5,0.5348837209302326,-115,0.5129780138229483,SF,MIA,2022 REG,6,3,11,2,5,17,1,0,1,-1,1,1,0,0,0,0,0,0,0,0.4870219861770517,0.5129780138229483
87648,0.43103448275862066,0.609375,132,-156,0.41361660225921526,0.5863833977407847,away,MIN,over,7.5,0.5305164319248826,-113,0.5066009958897986,BAL,MIN,2022 REG,4,1,7,2,3,11,0,1,-1,1,1,0,0,0,0,0,0,0,0,0.5066009958897986,0.49339900411020143
87648,0.43103448275862066,0.609375,132,-156,0.41361660225921526,0.5863833977407847,home,BAL,under,7.5,0.5145631067961165,-106,0.49339900411020143,BAL,MIN,2022 REG,4,1,7,2,3,11,0,1,-1,1,1,0,0,0,0,0,0,0,0,0.5066009958897986,0.49339900411020143
87649,0.6000000000000001,0.4347826086956522,-150,130,0.5791304347826086,0.4208695652173914,away,SD,over,8,0.5121951219512195,-105,0.48919479393107135,LAD,SD,2022 REG,8,7,10,2,9,18,1,0,5,-5,1,1,0,0,0,0,0,0,0,0.48919479393107135,0.5108052060689287
87649,0.6000000000000001,0.4347826086956522,-150,130,0.5791304347826086,0.4208695652173914,home,LAD,under,8,0.5327102803738317,-114,0.5108052060689287,LAD,SD,2022 REG,8,7,10,2,9,18,1,0,5,-5,1,1,0,0,0,0,0,0,0,0.48919479393107135,0.5108052060689287
87650,0.5901639344262295,0.45248868778280543,-144,121,0.5649918950897499,0.4350081049102501,away,CLE,over,6.5,0.5215311004784688,-109,0.4978845547971712,OAK,CLE,2022 REG,10,8,11,9,17,21,0,1,-1,1,1,1,1,1,1,1,1,1,0,0.4978845547971712,0.5021154452028288
87650,0.5901639344262295,0.45248868778280543,-144,121,0.5649918950897499,0.4350081049102501,home,OAK,under,6.5,0.5238095238095238,-110,0.5021154452028288,OAK,CLE,2022 REG,10,8,11,9,17,21,0,1,-1,1,1,1,1,1,1,1,1,1,0,0.4978845547971712,0.5021154452028288
87651,0.5327102803738317,0.5098039215686274,-114,-104,0.5100625279371946,0.48993747206280536,away,CHC,over,6.5,0.5495495495495495,-122,0.5250401592387142,MIA,CHC,2022 REG,6,3,4,4,7,10,0,1,-1,1,1,1,1,0,0,0,0,0,0,0.5250401592387142,0.47495984076128583
87651,0.5327102803738317,0.5098039215686274,-114,-104,0.5100625279371946,0.48993747206280536,home,MIA,under,6.5,0.49504950495049505,102,0.47495984076128583,MIA,CHC,2022 REG,6,3,4,4,7,10,0,1,-1,1,1,1,1,0,0,0,0,0,0,0.5250401592387142,0.47495984076128583
87652,0.4484304932735426,0.5951417004048584,123,-147,0.4288913929693269,0.5711086070306731,away,CLE,over,8.5,0.5433789954337899,-119,0.5171177654451503,DET,CLE,2022 REG,10,4,2,1,5,12,1,0,3,-3,1,0,0,0,0,0,0,0,0,0.5171177654451503,0.4828822345548497
87652,0.4484304932735426,0.5951417004048584,123,-147,0.4288913929693269,0.5711086070306731,home,DET,under,8.5,0.504950495049505,-102,0.4828822345548497,DET,CLE,2022 REG,10,4,2,1,5,12,1,0,3,-3,1,0,0,0,0,0,0,0,0,0.5171177654451503,0.4828822345548497
87653,0.5475113122171946,0.49504950495049505,-121,102,0.5242087833606768,0.4757912166393232,away,LAA,over,9,0.5,100,0.4772727272727273,PHI,LAA,2022 REG,10,10,5,0,10,15,1,0,10,-10,0,0,0,0,0,0,0,0,0,0.4772727272727273,0.5227272727272727
87653,0.5475113122171946,0.49504950495049505,-121,102,0.5242087833606768,0.4757912166393232,home,PHI,under,9,0.5454545454545454,-120,0.5227272727272727,PHI,LAA,2022 REG,10,10,5,0,10,15,1,0,10,-10,0,0,0,0,0,0,0,0,0,0.4772727272727273,0.5227272727272727
87654,0.4347826086956522,0.6062992125984252,130,-154,0.4169209472634447,0.5830790527365552,away,LAD,over,9,0.5348837209302326,-115,0.5109810284308424,STL,LAD,2022 REG,5,0,8,4,4,13,0,1,-4,4,0,0,0,0,0,0,0,0,0,0.5109810284308424,0.48901897156915763
87654,0.4347826086956522,0.6062992125984252,130,-154,0.4169209472634447,0.5830790527365552,home,STL,under,9,0.5098039215686274,-104,0.48901897156915763,STL,LAD,2022 REG,5,0,8,4,4,13,0,1,-4,4,0,0,0,0,0,0,0,0,0,0.5109810284308424,0.48901897156915763
87655,0.6875,0.3508771929824561,-220,185,0.6611156798245614,0.33888432017543857,away,ARI,over,8.5,0.504950495049505,-102,0.48160416005266615,NYM,ARI,2022 REG,12,10,3,3,13,15,1,0,7,-7,1,1,1,0,0,0,0,0,0,0.48160416005266615,0.5183958399473338
87655,0.6875,0.3508771929824561,-220,185,0.6611156798245614,0.33888432017543857,home,NYM,under,8.5,0.5412844036697247,-118,0.5183958399473338,NYM,ARI,2022 REG,12,10,3,3,13,15,1,0,7,-7,1,1,1,0,0,0,0,0,0,0.48160416005266615,0.5183958399473338
87656,0.5024875621890548,0.5391705069124424,-101,-117,0.4815549006007403,0.5184450993992598,away,CHC,over,8.5,0.5283018867924528,-112,0.5056562298022652,CIN,CHC,2022 REG,20,20,8,5,25,28,1,0,15,-15,1,1,1,1,1,0,0,0,0,0.5056562298022652,0.4943437701977348
87656,0.5024875621890548,0.5391705069124424,-101,-117,0.4815549006007403,0.5184450993992598,home,CIN,under,8.5,0.5145631067961165,-106,0.4943437701977348,CIN,CHC,2022 REG,20,20,8,5,25,28,1,0,15,-15,1,1,1,1,1,0,0,0,0,0.5056562298022652,0.4943437701977348
87657,0.6323529411764706,0.40485829959514175,-172,147,0.6088223036297157,0.3911776963702843,away,KC,over,9.5,0.5098039215686274,-104,0.48592421718142587,LAA,KC,2022 REG,10,11,14,12,23,24,0,1,-1,1,1,1,1,1,1,1,1,1,1,0.48592421718142587,0.5140757828185741
87657,0.6323529411764706,0.40485829959514175,-172,147,0.6088223036297157,0.3911776963702843,home,LAA,under,9.5,0.5370370370370371,-116,0.5140757828185741,LAA,KC,2022 REG,10,11,14,12,23,24,0,1,-1,1,1,1,1,1,1,1,1,1,1,0.48592421718142587,0.5140757828185741
87658,0.607843137254902,0.4291845493562232,-155,133,0.5853361120599043,0.4146638879400957,away,STL,over,9,0.5348837209302326,-115,0.5097020142727117,BOS,STL,2022 REG,9,6,7,4,10,16,1,0,2,-2,1,1,1,1,0,0,0,0,0,0.5097020142727117,0.49029798572728833
87658,0.607843137254902,0.4291845493562232,-155,133,0.5853361120599043,0.4146638879400957,home,BOS,under,9,0.5121951219512195,-105,0.49029798572728833,BOS,STL,2022 REG,9,6,7,4,10,16,1,0,2,-2,1,1,1,1,0,0,0,0,0,0.5097020142727117,0.49029798572728833
87659,0.4184100418410042,0.6197718631178707,139,-163,0.4024343493895921,0.5975656506104079,away,LAD,over,7.5,0.5,100,0.4783105022831051,SF,LAD,2022 REG,8,0,6,3,3,14,0,1,-3,3,0,0,0,0,0,0,0,0,0,0.4783105022831051,0.5216894977168949
87659,0.4184100418410042,0.6197718631178707,139,-163,0.4024343493895921,0.5975656506104079,home,SF,under,7.5,0.5433789954337899,-119,0.5216894977168949,SF,LAD,2022 REG,8,0,6,3,3,14,0,1,-3,3,0,0,0,0,0,0,0,0,0,0.4783105022831051,0.5216894977168949
87660,0.6428571428571428,0.39525691699604737,-180,153,0.6183552472372348,0.3816447527627652,away,CHC,over,7.5,0.5169082125603864,-107,0.49353874091423283,SF,CHC,2022 REG,9,4,4,0,4,13,1,0,4,-4,0,0,0,0,0,0,0,0,0,0.49353874091423283,0.5064612590857671
87660,0.6428571428571428,0.39525691699604737,-180,153,0.6183552472372348,0.3816447527627652,home,SF,under,7.5,0.5283018867924528,-112,0.5064612590857671,SF,CHC,2022 REG,9,4,4,0,4,13,1,0,4,-4,0,0,0,0,0,0,0,0,0,0.49353874091423283,0.5064612590857671
87661,0.48309178743961345,0.5555555555555556,107,-125,0.4644215734322854,0.5355784265677146,away,TB,over,8,0.5145631067961165,-106,0.4913668392989033,TEX,TB,2022 REG,10,3,6,4,7,16,0,1,-1,1,1,1,1,0,0,0,0,0,0,0.4913668392989033,0.5086331607010968
87661,0.48309178743961345,0.5555555555555556,107,-125,0.4644215734322854,0.5355784265677146,home,TEX,under,8,0.5305164319248826,-113,0.5086331607010968,TEX,TB,2022 REG,10,3,6,4,7,16,0,1,-1,1,1,1,1,0,0,0,0,0,0,0.4913668392989033,0.5086331607010968
87662,0.5652173913043479,0.47619047619047616,-130,110,0.5418129444594474,0.4581870555405526,away,KC,over,7.5,0.5145631067961165,-106,0.4925063625223866,BAL,KC,2022 REG,9,6,6,1,7,15,1,0,5,-5,1,0,0,0,0,0,0,0,0,0.4925063625223866,0.5074936374776133
87662,0.5652173913043479,0.47619047619047616,-130,110,0.5418129444594474,0.4581870555405526,home,BAL,under,7.5,0.5283018867924528,-112,0.5074936374776133,BAL,KC,2022 REG,9,6,6,1,7,15,1,0,5,-5,1,0,0,0,0,0,0,0,0,0.4925063625223866,0.5074936374776133
87663,0.626865671641791,0.4098360655737705,-168,144,0.6038586124917376,0.39614138750826244,away,WSH,over,8.5,0.5121951219512195,-105,0.48808156828023186,MIA,WSH,2022 REG,11,5,7,1,6,18,1,0,4,-4,1,0,0,0,0,0,0,0,0,0.48808156828023186,0.5119184317197681
87663,0.626865671641791,0.4098360655737705,-168,144,0.6038586124917376,0.39614138750826244,home,MIA,under,8.5,0.5348837209302326,-115,0.5119184317197681,MIA,WSH,2022 REG,11,5,7,1,6,18,1,0,4,-4,1,0,0,0,0,0,0,0,0,0.48808156828023186,0.5119184317197681
87664,0.5121951219512195,0.5327102803738317,-105,-114,0.48919479393107135,0.5108052060689287,away,PHI,over,8,0.5073891625615764,-103,0.4837652908580103,ATL,PHI,2022 REG,11,3,10,7,10,21,0,1,-4,4,1,1,1,0,0,0,0,0,0,0.4837652908580103,0.5162347091419897
87664,0.5121951219512195,0.5327102803738317,-105,-114,0.48919479393107135,0.5108052060689287,home,ATL,under,8,0.5391705069124424,-117,0.5162347091419897,ATL,PHI,2022 REG,11,3,10,7,10,21,0,1,-4,4,1,1,1,0,0,0,0,0,0,0.4837652908580103,0.5162347091419897
87665,0.5370370370370371,0.504950495049505,-116,-102,0.514488177212783,0.48551182278721705,away,CHC,over,8.5,0.5145631067961165,-106,0.4913668392989033,PIT,CHC,2022 REG,11,12,10,1,13,21,1,0,11,-11,1,0,0,0,0,0,0,0,0,0.4913668392989033,0.5086331607010968
87665,0.5370370370370371,0.504950495049505,-116,-102,0.514488177212783,0.48551182278721705,home,PIT,under,8.5,0.5305164319248826,-113,0.5086331607010968,PIT,CHC,2022 REG,11,12,10,1,13,21,1,0,11,-11,1,0,0,0,0,0,0,0,0,0.4913668392989033,0.5086331607010968
87666,0.6226415094339623,0.4166666666666667,-165,140,0.5981666073335706,0.40183339266642937,away,DET,over,7,0.49504950495049505,102,0.4739797934813417,OAK,DET,2022 REG,10,5,5,0,5,15,1,0,5,-5,0,0,0,0,0,0,0,0,0,0.4739797934813417,0.5260202065186583
87666,0.6226415094339623,0.4166666666666667,-165,140,0.5981666073335706,0.40183339266642937,home,OAK,under,7,0.5475113122171946,-121,0.5260202065186583,OAK,DET,2022 REG,10,5,5,0,5,15,1,0,5,-5,0,0,0,0,0,0,0,0,0,0.4739797934813417,0.5260202065186583
87667,0.5726495726495727,0.4694835680751174,-134,113,0.5485220476191947,0.45147795238080535,away,ARI,over,11.5,0.5238095238095238,-110,0.4988662131519274,CHC,ARI,2022 REG,8,6,12,10,16,20,0,1,-4,4,1,1,1,1,1,1,0,0,0,0.4988662131519274,0.5011337868480725
87667,0.5726495726495727,0.4694835680751174,-134,113,0.5485220476191947,0.45147795238080535,home,CHC,under,11.5,0.5238095238095238,-110,0.5011337868480725,CHC,ARI,2022 REG,8,6,12,10,16,20,0,1,-4,4,1,1,1,1,1,1,0,0,0,0.4988662131519274,0.5011337868480725
87668,0.75,0.29239766081871343,-300,242,0.718201754385965,0.281798245614035,away,MIN,over,7.5,0.5348837209302326,-115,0.5097020142727117,HOU,MIN,2022 REG,12,4,6,2,6,18,1,0,2,-2,1,1,0,0,0,0,0,0,0,0.5097020142727117,0.49029798572728833
87668,0.75,0.29239766081871343,-300,242,0.718201754385965,0.281798245614035,home,HOU,under,7.5,0.5121951219512195,-105,0.49029798572728833,HOU,MIN,2022 REG,12,4,6,2,6,18,1,0,2,-2,1,1,0,0,0,0,0,0,0,0.5097020142727117,0.49029798572728833
87669,0.6941896024464832,0.3484320557491289,-227,187,0.6646020904880614,0.3353979095119386,away,ARI,over,8.5,0.5412844036697247,-118,0.5175913212324037,CLE,ARI,2022 REG,9,7,9,4,11,18,1,0,3,-3,1,1,1,1,0,0,0,0,0,0.5175913212324037,0.4824086787675963
87669,0.6941896024464832,0.3484320557491289,-227,187,0.6646020904880614,0.3353979095119386,home,CLE,under,8.5,0.5024875621890548,-101,0.4824086787675963,CLE,ARI,2022 REG,9,7,9,4,11,18,1,0,3,-3,1,1,1,1,0,0,0,0,0,0.5175913212324037,0.4824086787675963
87670,0.576271186440678,0.4629629629629629,-136,116,0.553661676614851,0.446338323385149,away,MIN,over,7.5,0.5412844036697247,-118,0.5149381613977361,SD,MIN,2022 REG,9,10,5,1,11,14,1,0,9,-9,1,0,0,0,0,0,0,0,0,0.5149381613977361,0.48506183860226393
87670,0.576271186440678,0.4629629629629629,-136,116,0.553661676614851,0.446338323385149,home,SD,under,7.5,0.5073891625615764,-103,0.48506183860226393,SD,MIN,2022 REG,9,10,5,1,11,14,1,0,9,-9,1,0,0,0,0,0,0,0,0,0.5149381613977361,0.48506183860226393
87671,0.5934959349593496,0.4444444444444444,-146,125,0.5709784740123824,0.42902152598761756,away,TB,over,9.5,0.5098039215686274,-104,0.48592421718142587,TOR,TB,2022 REG,9,4,5,1,5,14,1,0,3,-3,1,0,0,0,0,0,0,0,0,0.48592421718142587,0.5140757828185741
87671,0.5934959349593496,0.4444444444444444,-146,125,0.5709784740123824,0.42902152598761756,home,TOR,under,9.5,0.5370370370370371,-116,0.5140757828185741,TOR,TB,2022 REG,9,4,5,1,5,14,1,0,3,-3,1,0,0,0,0,0,0,0,0,0.48592421718142587,0.5140757828185741
87672,0.5535714285714286,0.4854368932038835,-124,106,0.5319775361600951,0.46802246383990487,away,LAA,over,7,0.5121951219512195,-105,0.48808156828023186,CWS,LAA,2022 REG,3,1,13,5,6,16,0,1,-4,4,1,0,0,0,0,0,0,0,0,0.48808156828023186,0.5119184317197681
87672,0.5535714285714286,0.4854368932038835,-124,106,0.5319775361600951,0.46802246383990487,home,CWS,under,7,0.5348837209302326,-115,0.5119184317197681,CWS,LAA,2022 REG,3,1,13,5,6,16,0,1,-4,4,1,0,0,0,0,0,0,0,0,0.48808156828023186,0.5119184317197681
87673,0.5348837209302326,0.504950495049505,-115,-102,0.5135770472666521,0.4864229527333479,away,HOU,over,9,0.5098039215686274,-104,0.4870219861770517,BOS,HOU,2022 REG,13,4,15,13,17,28,0,1,-9,9,1,1,1,1,0,0,0,0,0,0.4870219861770517,0.5129780138229483
87673,0.5348837209302326,0.504950495049505,-115,-102,0.5135770472666521,0.4864229527333479,home,BOS,under,9,0.5348837209302326,-115,0.5129780138229483,BOS,HOU,2022 REG,13,4,15,13,17,28,0,1,-9,9,1,1,1,1,0,0,0,0,0,0.4870219861770517,0.5129780138229483
87674,0.5884773662551441,0.45454545454545453,-143,120,0.5631594099815408,0.4368405900184592,away,CHC,over,8,0.5238095238095238,-110,0.4988662131519274,SF,CHC,2022 REG,7,4,3,2,6,10,1,0,2,-2,1,1,0,0,0,0,0,0,0,0.4988662131519274,0.5011337868480725
87674,0.5884773662551441,0.45454545454545453,-143,120,0.5631594099815408,0.4368405900184592,home,SF,under,8,0.5238095238095238,-110,0.5011337868480725,SF,CHC,2022 REG,7,4,3,2,6,10,1,0,2,-2,1,1,0,0,0,0,0,0,0,0.4988662131519274,0.5011337868480725
87675,0.5614035087719298,0.47619047619047616,-128,110,0.5402981137053159,0.4597018862946841,away,TB,over,6,0.5454545454545454,-120,0.5206611570247933,CLE,TB,2022 REG,5,2,6,1,3,11,1,0,1,-1,1,0,0,0,0,0,0,0,0,0.5206611570247933,0.4793388429752067
87675,0.5614035087719298,0.47619047619047616,-128,110,0.5402981137053159,0.4597018862946841,home,CLE,under,6,0.5,100,0.4793388429752067,CLE,TB,2022 REG,5,2,6,1,3,11,1,0,1,-1,1,0,0,0,0,0,0,0,0,0.5206611570247933,0.4793388429752067
87676,0.5515695067264574,0.4926108374384236,-123,103,0.527200976088429,0.472799023911571,away,NYY,over,7.5,0.5,100,0.4772727272727273,HOU,NYY,2022 REG,10,3,5,2,5,15,1,0,1,-1,1,1,0,0,0,0,0,0,0,0.4772727272727273,0.5227272727272727
87676,0.5515695067264574,0.4926108374384236,-123,103,0.527200976088429,0.472799023911571,home,HOU,under,7.5,0.5454545454545454,-120,0.5227272727272727,HOU,NYY,2022 REG,10,3,5,2,5,15,1,0,1,-1,1,1,0,0,0,0,0,0,0,0.4772727272727273,0.5227272727272727
87677,0.6226415094339623,0.4166666666666667,-165,140,0.5981666073335706,0.40183339266642937,away,ATL,over,7,0.5238095238095238,-110,0.4988662131519274,PHI,ATL,2022 REG,10,9,6,1,10,16,1,0,8,-8,1,0,0,0,0,0,0,0,0,0.4988662131519274,0.5011337868480725
87677,0.6226415094339623,0.4166666666666667,-165,140,0.5981666073335706,0.40183339266642937,home,PHI,under,7,0.5238095238095238,-110,0.5011337868480725,PHI,ATL,2022 REG,10,9,6,1,10,16,1,0,8,-8,1,0,0,0,0,0,0,0,0,0.4988662131519274,0.5011337868480725
87678,0.45454545454545453,0.5850622406639003,120,-141,0.4365419567230205,0.5634580432769796,away,CWS,over,8,0.5391705069124424,-117,0.5140669063204599,CLE,CWS,2022 REG,13,6,8,3,9,21,1,0,3,-3,1,1,1,0,0,0,0,0,0,0.5140669063204599,0.4859330936795401
87678,0.45454545454545453,0.5850622406639003,120,-141,0.4365419567230205,0.5634580432769796,home,CLE,under,8,0.5073891625615764,-103,0.4859330936795401,CLE,CWS,2022 REG,13,6,8,3,9,21,1,0,3,-3,1,1,1,0,0,0,0,0,0,0.5140669063204599,0.4859330936795401
87679,0.6183206106870228,0.42016806722689076,-162,138,0.5945222678547557,0.4054777321452443,away,WSH,over,9,0.5391705069124424,-117,0.5140669063204599,CIN,WSH,2022 REG,13,4,7,5,9,20,0,1,-1,1,1,1,1,1,0,0,0,0,0,0.5140669063204599,0.4859330936795401
87679,0.6183206106870228,0.42016806722689076,-162,138,0.5945222678547557,0.4054777321452443,home,CIN,under,9,0.5073891625615764,-103,0.4859330936795401,CIN,WSH,2022 REG,13,4,7,5,9,20,0,1,-1,1,1,1,1,1,0,0,0,0,0,0.5140669063204599,0.4859330936795401
87680,0.37037037037037035,0.6666666666666666,170,-200,0.35665294924554186,0.6433470507544581,away,HOU,over,7,0.5348837209302326,-115,0.5097020142727117,SEA,HOU,2022 REG,10,6,9,1,7,19,1,0,5,-5,1,0,0,0,0,0,0,0,0,0.5097020142727117,0.49029798572728833
87680,0.37037037037037035,0.6666666666666666,170,-200,0.35665294924554186,0.6433470507544581,home,SEA,under,7,0.5121951219512195,-105,0.49029798572728833,SEA,HOU,2022 REG,10,6,9,1,7,19,1,0,5,-5,1,0,0,0,0,0,0,0,0,0.5097020142727117,0.49029798572728833
87681,0.5098039215686274,0.5348837209302326,-104,-115,0.4870219861770517,0.5129780138229483,away,MIN,over,8,0.5348837209302326,-115,0.5097020142727117,LAA,MIN,2022 REG,8,5,10,3,8,18,1,0,2,-2,1,1,1,0,0,0,0,0,0,0.5097020142727117,0.49029798572728833
87681,0.5098039215686274,0.5348837209302326,-104,-115,0.4870219861770517,0.5129780138229483,home,LAA,under,8,0.5121951219512195,-105,0.49029798572728833,LAA,MIN,2022 REG,8,5,10,3,8,18,1,0,2,-2,1,1,1,0,0,0,0,0,0,0.5097020142727117,0.49029798572728833
87682,0.4132231404958678,0.6254681647940076,142,-167,0.3972349978141011,0.6027650021858989,away,PHI,over,8,0.5192307692307692,-108,0.49571111079951763,WSH,PHI,2022 REG,5,1,5,2,3,10,0,1,-1,1,1,0,0,0,0,0,0,0,0,0.49571111079951763,0.5042888892004824
87682,0.4132231404958678,0.6254681647940076,142,-167,0.3972349978141011,0.6027650021858989,home,WSH,under,8,0.5260663507109005,-111,0.5042888892004824,WSH,PHI,2022 REG,5,1,5,2,3,10,0,1,-1,1,1,0,0,0,0,0,0,0,0,0.49571111079951763,0.5042888892004824
87683,0.5689655172413793,0.47619047619047616,-132,110,0.5432733140818753,0.4567266859181247,away,LAA,over,9,0.5238095238095238,-110,0.4988662131519274,NYY,LAA,2022 REG,13,9,7,1,10,20,1,0,8,-8,1,0,0,0,0,0,0,0,0,0.4988662131519274,0.5011337868480725
87683,0.5689655172413793,0.47619047619047616,-132,110,0.5432733140818753,0.4567266859181247,home,NYY,under,9,0.5238095238095238,-110,0.5011337868480725,NYY,LAA,2022 REG,13,9,7,1,10,20,1,0,8,-8,1,0,0,0,0,0,0,0,0,0.4988662131519274,0.5011337868480725
87684,0.5555555555555556,0.48309178743961345,-125,107,0.5340848094471283,0.46591519055287167,away,SEA,over,8,0.5391705069124424,-117,0.5140669063204599,TEX,SEA,2022 REG,9,5,12,6,11,21,0,1,-1,1,1,1,1,1,1,0,0,0,0,0.5140669063204599,0.4859330936795401
87684,0.5555555555555556,0.48309178743961345,-125,107,0.5340848094471283,0.46591519055287167,home,TEX,under,8,0.5073891625615764,-103,0.4859330936795401,TEX,SEA,2022 REG,9,5,12,6,11,21,0,1,-1,1,1,1,1,1,1,0,0,0,0,0.5140669063204599,0.4859330936795401
87685,0.3921568627450981,0.6515679442508712,155,-187,0.3750098796094239,0.6249901203905761,away,NYY,over,8.5,0.5192307692307692,-108,0.49688292476754015,CLE,NYY,2022 REG,7,1,7,6,7,14,0,1,-5,5,1,0,0,0,0,0,0,0,0,0.49688292476754015,0.5031170752324599
87685,0.3921568627450981,0.6515679442508712,155,-187,0.3750098796094239,0.6249901203905761,home,CLE,under,8.5,0.5238095238095238,-110,0.5031170752324599,CLE,NYY,2022 REG,7,1,7,6,7,14,0,1,-5,5,1,0,0,0,0,0,0,0,0,0.49688292476754015,0.5031170752324599
87686,0.47619047619047616,0.5555555555555556,110,-125,0.46107331821617537,0.5389266817838246,away,CLE,over,8,0.5238095238095238,-110,0.5012646084074657,BAL,CLE,2022 REG,4,5,5,4,9,9,1,0,1,-1,1,1,1,1,0,0,0,0,0,0.5012646084074657,0.4987353915925343
87686,0.47619047619047616,0.5555555555555556,110,-125,0.46107331821617537,0.5389266817838246,home,BAL,under,8,0.5192307692307692,-108,0.4987353915925343,BAL,CLE,2022 REG,4,5,5,4,9,9,1,0,1,-1,1,1,1,1,0,0,0,0,0,0.5012646084074657,0.4987353915925343
87687,0.5433789954337899,0.5,-119,100,0.5198077604720502,0.48019223952794976,away,CLE,over,8.5,0.5260663507109005,-111,0.5010269332605688,TOR,CLE,2022 REG,6,2,6,1,3,12,1,0,1,-1,1,0,0,0,0,0,0,0,0,0.5010269332605688,0.4989730667394312
87687,0.5433789954337899,0.5,-119,100,0.5198077604720502,0.48019223952794976,home,TOR,under,8.5,0.5215311004784688,-109,0.4989730667394312,TOR,CLE,2022 REG,6,2,6,1,3,12,1,0,1,-1,1,0,0,0,0,0,0,0,0,0.5010269332605688,0.4989730667394312
87688,0.6183206106870228,0.42194092827004215,-162,137,0.5934260713318911,0.40657392866810893,away,WSH,over,7.5,0.5215311004784688,-109,0.49907282342437215,CHC,WSH,2022 REG,9,4,9,2,6,18,1,0,2,-2,1,1,0,0,0,0,0,0,0,0.49907282342437215,0.5009271765756278
87688,0.6183206106870228,0.42194092827004215,-162,137,0.5934260713318911,0.40657392866810893,home,CHC,under,7.5,0.5215311004784688,-109,0.5009271765756278,CHC,WSH,2022 REG,9,4,9,2,6,18,1,0,2,-2,1,1,0,0,0,0,0,0,0,0.49907282342437215,0.5009271765756278
87689,0.4672897196261683,0.5726495726495727,114,-134,0.44862649893656975,0.5513735010634302,away,ATL,over,9,0.5121951219512195,-105,0.48808156828023186,PHI,ATL,2022 REG,4,1,8,4,5,12,0,1,-3,3,1,0,0,0,0,0,0,0,0,0.48808156828023186,0.5119184317197681
87689,0.4672897196261683,0.5726495726495727,114,-134,0.44862649893656975,0.5513735010634302,home,PHI,under,9,0.5348837209302326,-115,0.5119184317197681,PHI,ATL,2022 REG,4,1,8,4,5,12,0,1,-3,3,1,0,0,0,0,0,0,0,0,0.48808156828023186,0.5119184317197681
87690,0.42372881355932196,0.609375,136,-156,0.40970177391554147,0.5902982260844585,away,CHC,over,9,0.504950495049505,-102,0.4826715732667395,WSH,CHC,2022 REG,6,2,5,3,5,11,0,1,-1,1,1,1,0,0,0,0,0,0,0,0.4826715732667395,0.5173284267332605
87690,0.42372881355932196,0.609375,136,-156,0.40970177391554147,0.5902982260844585,home,WSH,under,9,0.5391705069124424,-117,0.5173284267332605,WSH,CHC,2022 REG,6,2,5,3,5,11,0,1,-1,1,1,1,0,0,0,0,0,0,0,0.4826715732667395,0.5173284267332605
87691,0.3225806451612903,0.7142857142857143,210,-250,0.3106882711461275,0.6893117288538725,away,NYY,over,7.5,0.5412844036697247,-118,0.5189377998484975,BAL,NYY,2022 REG,7,2,6,3,5,13,0,1,-1,1,1,1,0,0,0,0,0,0,0,0.5189377998484975,0.4810622001515025
87691,0.3225806451612903,0.7142857142857143,210,-250,0.3106882711461275,0.6893117288538725,home,BAL,under,7.5,0.5,100,0.4810622001515025,BAL,NYY,2022 REG,7,2,6,3,5,13,0,1,-1,1,1,1,0,0,0,0,0,0,0,0.5189377998484975,0.4810622001515025
87692,0.49019607843137253,0.5495495495495495,104,-122,0.4707129274603323,0.5292870725396677,away,BOS,over,7.5,0.504950495049505,-102,0.4826715732667395,OAK,BOS,2022 REG,4,0,14,8,8,18,0,1,-8,8,0,0,0,0,0,0,0,0,0,0.4826715732667395,0.5173284267332605
87692,0.49019607843137253,0.5495495495495495,104,-122,0.4707129274603323,0.5292870725396677,home,OAK,under,7.5,0.5391705069124424,-117,0.5173284267332605,OAK,BOS,2022 REG,4,0,14,8,8,18,0,1,-8,8,0,0,0,0,0,0,0,0,0,0.4826715732667395,0.5173284267332605
87693,0.574468085106383,0.4672897196261683,-135,114,0.550479558983428,0.44952044101657196,away,ATL,over,8.5,0.5192307692307692,-108,0.49455035168025013,NYM,ATL,2022 REG,12,6,14,9,15,26,0,1,-3,3,1,1,1,1,1,1,0,0,0,0.49455035168025013,0.5054496483197499
87693,0.574468085106383,0.4672897196261683,-135,114,0.550479558983428,0.44952044101657196,home,NYM,under,8.5,0.5283018867924528,-112,0.5054496483197499,NYM,ATL,2022 REG,12,6,14,9,15,26,0,1,-3,3,1,1,1,1,1,1,0,0,0,0.49455035168025013,0.5054496483197499
87694,0.5145631067961165,0.5238095238095238,-106,-110,0.4948179667757384,0.5051820332242616,away,TOR,over,7.5,0.5391705069124424,-117,0.5140669063204599,LAA,TOR,2022 REG,7,3,11,4,7,18,0,1,-1,1,1,1,1,0,0,0,0,0,0,0.5140669063204599,0.4859330936795401
87694,0.5145631067961165,0.5238095238095238,-106,-110,0.4948179667757384,0.5051820332242616,home,LAA,under,7.5,0.5073891625615764,-103,0.4859330936795401,LAA,TOR,2022 REG,7,3,11,4,7,18,0,1,-1,1,1,1,1,0,0,0,0,0,0,0.5140669063204599,0.4859330936795401
87695,0.6845425867507886,0.35714285714285715,-217,180,0.6560071251579774,0.34399287484202257,away,BOS,over,7.5,0.5,100,0.4772727272727273,TOR,BOS,2022 REG,9,6,8,3,9,17,1,0,3,-3,1,1,1,0,0,0,0,0,0,0.4772727272727273,0.5227272727272727
87695,0.6845425867507886,0.35714285714285715,-217,180,0.6560071251579774,0.34399287484202257,home,TOR,under,7.5,0.5454545454545454,-120,0.5227272727272727,TOR,BOS,2022 REG,9,6,8,3,9,17,1,0,3,-3,1,1,1,0,0,0,0,0,0,0.4772727272727273,0.5227272727272727
87696,0.6031746031746031,0.4347826086956522,-152,130,0.5802797769671475,0.4197202230328525,away,DET,over,8.5,0.5098039215686274,-104,0.4870219861770517,BAL,DET,2022 REG,9,8,3,1,9,12,1,0,7,-7,1,0,0,0,0,0,0,0,0,0.4870219861770517,0.5129780138229483
87696,0.6031746031746031,0.4347826086956522,-152,130,0.5802797769671475,0.4197202230328525,home,BAL,under,8.5,0.5348837209302326,-115,0.5129780138229483,BAL,DET,2022 REG,9,8,3,1,9,12,1,0,7,-7,1,0,0,0,0,0,0,0,0,0.4870219861770517,0.5129780138229483
87697,0.626865671641791,0.4132231404958678,-168,142,0.6017353714957959,0.3982646285042041,away,KC,over,7.5,0.5073891625615764,-103,0.4826927225525911,STL,KC,2022 REG,4,1,5,0,1,9,1,0,1,-1,0,0,0,0,0,0,0,0,0,0.4826927225525911,0.5173072774474089
87697,0.626865671641791,0.4132231404958678,-168,142,0.6017353714957959,0.3982646285042041,home,STL,under,7.5,0.5412844036697247,-118,0.5173072774474089,STL,KC,2022 REG,4,1,5,0,1,9,1,0,1,-1,0,0,0,0,0,0,0,0,0,0.4826927225525911,0.5173072774474089
87698,0.7101449275362319,0.3389830508474576,-245,195,0.6752569428869452,0.32474305711305484,away,DET,over,8.5,0.5,100,0.47935779816513757,CLE,DET,2022 REG,10,4,5,0,4,15,1,0,4,-4,0,0,0,0,0,0,0,0,0,0.47935779816513757,0.5206422018348624
87698,0.7101449275362319,0.3389830508474576,-245,195,0.6752569428869452,0.32474305711305484,home,CLE,under,8.5,0.5412844036697247,-118,0.5206422018348624,CLE,DET,2022 REG,10,4,5,0,4,15,1,0,4,-4,0,0,0,0,0,0,0,0,0,0.47935779816513757,0.5206422018348624
87699,0.425531914893617,0.6168582375478928,135,-161,0.407493552152549,0.592506447847451,away,HOU,over,8.5,0.5121951219512195,-105,0.48808156828023186,BAL,HOU,2022 REG,8,3,9,6,9,17,0,1,-3,3,1,1,1,0,0,0,0,0,0,0.48808156828023186,0.5119184317197681
87699,0.425531914893617,0.6168582375478928,135,-161,0.407493552152549,0.592506447847451,home,BAL,under,8.5,0.5348837209302326,-115,0.5119184317197681,BAL,HOU,2022 REG,8,3,9,6,9,17,0,1,-3,3,1,1,1,0,0,0,0,0,0,0.48808156828023186,0.5119184317197681
87700,0.6666666666666666,0.37037037037037035,-200,170,0.6419753086419753,0.3580246913580247,away,BOS,over,8,0.5121951219512195,-105,0.48808156828023186,TOR,BOS,2022 REG,13,9,3,0,9,16,1,0,9,-9,0,0,0,0,0,0,0,0,0,0.48808156828023186,0.5119184317197681
87700,0.6666666666666666,0.37037037037037035,-200,170,0.6419753086419753,0.3580246913580247,home,TOR,under,8,0.5348837209302326,-115,0.5119184317197681,TOR,BOS,2022 REG,13,9,3,0,9,16,1,0,9,-9,0,0,0,0,0,0,0,0,0,0.48808156828023186,0.5119184317197681
87701,0.5918367346938775,0.4484304932735426,-145,123,0.5680051099784656,0.43199489002153435,away,ARI,over,8.5,0.5327102803738317,-114,0.5062779990911175,PHI,ARI,2022 REG,12,7,7,5,12,19,1,0,2,-2,1,1,1,1,1,0,0,0,0,0.5062779990911175,0.4937220009088825
87701,0.5918367346938775,0.4484304932735426,-145,123,0.5680051099784656,0.43199489002153435,home,PHI,under,8.5,0.5169082125603864,-107,0.4937220009088825,PHI,ARI,2022 REG,12,7,7,5,12,19,1,0,2,-2,1,1,1,1,1,0,0,0,0,0.5062779990911175,0.4937220009088825
87702,0.646643109540636,0.3921568627450981,-183,155,0.6215533748116984,0.37844662518830163,away,CLE,over,7.5,0.5169082125603864,-107,0.49586088023391106,CWS,CLE,2022 REG,7,9,12,12,21,19,0,1,-3,3,1,1,1,1,1,1,1,1,1,0.49586088023391106,0.5041391197660889
87702,0.646643109540636,0.3921568627450981,-183,155,0.6215533748116984,0.37844662518830163,home,CWS,under,7.5,0.5238095238095238,-110,0.5041391197660889,CWS,CLE,2022 REG,7,9,12,12,21,19,0,1,-3,3,1,1,1,1,1,1,1,1,1,0.49586088023391106,0.5041391197660889
87703,0.5555555555555556,0.4854368932038835,-125,106,0.5327819729114227,0.4672180270885773,away,SD,over,8,0.5305164319248826,-113,0.5066009958897986,PHI,SD,2022 REG,8,0,10,2,2,18,0,1,-2,2,0,0,0,0,0,0,0,0,0,0.5066009958897986,0.49339900411020143
87703,0.5555555555555556,0.4854368932038835,-125,106,0.5327819729114227,0.4672180270885773,home,PHI,under,8,0.5145631067961165,-106,0.49339900411020143,PHI,SD,2022 REG,8,0,10,2,2,18,0,1,-2,2,0,0,0,0,0,0,0,0,0,0.5066009958897986,0.49339900411020143
87704,0.37593984962406013,0.6666666666666666,166,-200,0.35992236229671926,0.6400776377032807,away,PHI,over,7.5,0.5454545454545454,-120,0.5206611570247933,PIT,PHI,2022 REG,7,7,15,8,15,22,0,1,-1,1,1,1,1,1,1,1,1,0,0,0.5206611570247933,0.4793388429752067
87704,0.37593984962406013,0.6666666666666666,166,-200,0.35992236229671926,0.6400776377032807,home,PIT,under,7.5,0.5,100,0.4793388429752067,PIT,PHI,2022 REG,7,7,15,8,15,22,0,1,-1,1,1,1,1,1,1,1,1,0,0,0.5206611570247933,0.4793388429752067
87705,0.7701149425287357,0.27027027027027023,-335,270,0.7390136866950185,0.26098631330498145,away,ARI,over,8.5,0.5391705069124424,-117,0.5140669063204599,LAD,ARI,2022 REG,3,1,7,6,7,10,0,1,-5,5,1,0,0,0,0,0,0,0,0,0.5140669063204599,0.4859330936795401
87705,0.7701149425287357,0.27027027027027023,-335,270,0.7390136866950185,0.26098631330498145,home,LAD,under,8.5,0.5073891625615764,-103,0.4859330936795401,LAD,ARI,2022 REG,3,1,7,6,7,10,0,1,-5,5,1,0,0,0,0,0,0,0,0,0.5140669063204599,0.4859330936795401
87706,0.6515679442508712,0.3861003861003861,-187,159,0.6270244676805398,0.37297553231946023,away,CHC,over,8.5,0.5348837209302326,-115,0.5097020142727117,STL,CHC,2022 REG,8,5,11,6,11,19,0,1,-1,1,1,1,1,1,1,0,0,0,0,0.5097020142727117,0.49029798572728833
87706,0.6515679442508712,0.3861003861003861,-187,159,0.6270244676805398,0.37297553231946023,home,STL,under,8.5,0.5121951219512195,-105,0.49029798572728833,STL,CHC,2022 REG,8,5,11,6,11,19,0,1,-1,1,1,1,1,1,1,0,0,0,0,0.5097020142727117,0.49029798572728833
87707,0.6666666666666666,0.37735849056603776,-200,165,0.6373165618448637,0.36268343815513626,away,LAA,over,8.5,0.5391705069124424,-117,0.5153817639191344,LAD,LAA,2022 REG,3,2,3,0,2,6,1,0,2,-2,0,0,0,0,0,0,0,0,0,0.5153817639191344,0.4846182360808656
87707,0.6666666666666666,0.37735849056603776,-200,165,0.6373165618448637,0.36268343815513626,home,LAD,under,8.5,0.504950495049505,-102,0.4846182360808656,LAD,LAA,2022 REG,3,2,3,0,2,6,1,0,2,-2,0,0,0,0,0,0,0,0,0,0.5153817639191344,0.4846182360808656
87708,0.38759689922480617,0.6503496503496503,158,-186,0.3728889342734665,0.6271110657265335,away,SF,over,8.5,0.5305164319248826,-113,0.5066009958897986,PIT,SF,2022 REG,8,4,4,3,7,12,1,0,1,-1,1,1,1,0,0,0,0,0,0,0.5066009958897986,0.49339900411020143
87708,0.38759689922480617,0.6503496503496503,158,-186,0.3728889342734665,0.6271110657265335,home,PIT,under,8.5,0.5145631067961165,-106,0.49339900411020143,PIT,SF,2022 REG,8,4,4,3,7,12,1,0,1,-1,1,1,1,0,0,0,0,0,0,0.5066009958897986,0.49339900411020143
87709,0.574468085106383,0.46511627906976744,-135,115,0.5517281312179562,0.44827186878204384,away,COL,over,8.5,0.5169082125603864,-107,0.4912600060678196,ARI,COL,2022 REG,8,6,12,5,11,20,1,0,1,-1,1,1,1,1,1,0,0,0,0,0.4912600060678196,0.5087399939321804
87709,0.574468085106383,0.46511627906976744,-135,115,0.5517281312179562,0.44827186878204384,home,ARI,under,8.5,0.5327102803738317,-114,0.5087399939321804,ARI,COL,2022 REG,8,6,12,5,11,20,1,0,1,-1,1,1,1,1,1,0,0,0,0,0.4912600060678196,0.5087399939321804
87710,0.7347480106100795,0.30303030303030304,-277,230,0.7069904698186048,0.2930095301813952,away,MIA,over,8,0.5215311004784688,-109,0.4978845547971712,LAD,MIA,2022 REG,6,2,5,1,3,11,1,0,1,-1,1,0,0,0,0,0,0,0,0,0.4978845547971712,0.5021154452028288
87710,0.7347480106100795,0.30303030303030304,-277,230,0.7069904698186048,0.2930095301813952,home,LAD,under,8,0.5238095238095238,-110,0.5021154452028288,LAD,MIA,2022 REG,6,2,5,1,3,11,1,0,1,-1,1,0,0,0,0,0,0,0,0,0.4978845547971712,0.5021154452028288
87711,0.5454545454545454,0.5,-120,100,0.5206611570247933,0.4793388429752067,away,CIN,over,7.5,0.5348837209302326,-115,0.5109810284308424,PIT,CIN,2022 REG,9,4,7,3,7,16,1,0,1,-1,1,1,1,0,0,0,0,0,0,0.5109810284308424,0.48901897156915763
87711,0.5454545454545454,0.5,-120,100,0.5206611570247933,0.4793388429752067,home,PIT,under,7.5,0.5098039215686274,-104,0.48901897156915763,PIT,CIN,2022 REG,9,4,7,3,7,16,1,0,1,-1,1,1,1,0,0,0,0,0,0,0.5109810284308424,0.48901897156915763
87712,0.41152263374485604,0.6254681647940076,143,-167,0.39630008290581753,0.6036999170941825,away,SD,over,8.5,0.5238095238095238,-110,0.4988662131519274,DET,SD,2022 REG,13,12,10,4,16,23,1,0,8,-8,1,1,1,1,0,0,0,0,0,0.4988662131519274,0.5011337868480725
87712,0.41152263374485604,0.6254681647940076,143,-167,0.39630008290581753,0.6036999170941825,home,DET,under,8.5,0.5238095238095238,-110,0.5011337868480725,DET,SD,2022 REG,13,12,10,4,16,23,1,0,8,-8,1,1,1,1,0,0,0,0,0,0.4988662131519274,0.5011337868480725
87713,0.6296296296296295,0.4081632653061224,-170,145,0.6058341031886005,0.39416589681139946,away,BAL,over,9,0.5098039215686274,-104,0.48592421718142587,CWS,BAL,2022 REG,1,1,5,4,5,6,0,1,-3,3,1,0,0,0,0,0,0,0,0,0.48592421718142587,0.5140757828185741
87713,0.6296296296296295,0.4081632653061224,-170,145,0.6058341031886005,0.39416589681139946,home,CWS,under,9,0.5370370370370371,-116,0.5140757828185741,CWS,BAL,2022 REG,1,1,5,4,5,6,0,1,-3,3,1,0,0,0,0,0,0,0,0,0.48592421718142587,0.5140757828185741
87714,0.7237569060773481,0.3125,-262,220,0.6975157199108697,0.3024842800891303,away,KC,over,9,0.5121951219512195,-105,0.48808156828023186,HOU,KC,2022 REG,7,7,11,6,13,18,1,0,1,-1,1,1,1,1,1,1,0,0,0,0.48808156828023186,0.5119184317197681
87714,0.7237569060773481,0.3125,-262,220,0.6975157199108697,0.3024842800891303,home,HOU,under,9,0.5348837209302326,-115,0.5119184317197681,HOU,KC,2022 REG,7,7,11,6,13,18,1,0,1,-1,1,1,1,1,1,1,0,0,0,0.48808156828023186,0.5119184317197681
87715,0.48780487804878053,0.5475113122171946,105,-121,0.470577468162939,0.529422531837061,away,NYY,over,8,0.5238095238095238,-110,0.5012646084074657,MIL,NYY,2022 REG,10,7,11,6,13,21,1,0,1,-1,1,1,1,1,1,1,0,0,0,0.5012646084074657,0.4987353915925343
87715,0.48780487804878053,0.5475113122171946,105,-121,0.470577468162939,0.529422531837061,home,MIL,under,8,0.5192307692307692,-108,0.4987353915925343,MIL,NYY,2022 REG,10,7,11,6,13,21,1,0,1,-1,1,1,1,1,1,1,0,0,0,0.5012646084074657,0.4987353915925343
87716,0.5652173913043479,0.47619047619047616,-130,110,0.5418129444594474,0.4581870555405526,away,ARI,over,7.5,0.5238095238095238,-110,0.4988662131519274,SF,ARI,2022 REG,9,4,8,3,7,17,1,0,1,-1,1,1,1,0,0,0,0,0,0,0.4988662131519274,0.5011337868480725
87716,0.5652173913043479,0.47619047619047616,-130,110,0.5418129444594474,0.4581870555405526,home,SF,under,7.5,0.5238095238095238,-110,0.5011337868480725,SF,ARI,2022 REG,9,4,8,3,7,17,1,0,1,-1,1,1,1,0,0,0,0,0,0,0.4988662131519274,0.5011337868480725
87717,0.5,0.5412844036697247,100,-118,0.47935779816513757,0.5206422018348624,away,ATL,over,7.5,0.5327102803738317,-114,0.508788710910954,NYM,ATL,2022 REG,8,5,5,4,9,13,1,0,1,-1,1,1,1,1,0,0,0,0,0,0.508788710910954,0.491211289089046
87717,0.5,0.5412844036697247,100,-118,0.47935779816513757,0.5206422018348624,home,NYM,under,7.5,0.5121951219512195,-105,0.491211289089046,NYM,ATL,2022 REG,8,5,5,4,9,13,1,0,1,-1,1,1,1,1,0,0,0,0,0,0.508788710910954,0.491211289089046
87718,0.696969696969697,0.3412969283276451,-230,193,0.6702990187321556,0.3297009812678444,away,CHC,over,9.5,0.5238095238095238,-110,0.5000596729920038,TOR,CHC,2022 REG,7,5,10,7,12,17,0,1,-2,2,1,1,1,1,1,0,0,0,0,0.5000596729920038,0.4999403270079962
87718,0.696969696969697,0.3412969283276451,-230,193,0.6702990187321556,0.3297009812678444,home,TOR,under,9.5,0.5215311004784688,-109,0.4999403270079962,TOR,CHC,2022 REG,7,5,10,7,12,17,0,1,-2,2,1,1,1,1,1,0,0,0,0,0.5000596729920038,0.4999403270079962
87719,0.6153846153846154,0.425531914893617,-160,135,0.5902052121364724,0.40979478786352763,away,BOS,over,8,0.5121951219512195,-105,0.48808156828023186,TOR,BOS,2022 REG,21,10,5,0,10,26,1,0,10,-10,0,0,0,0,0,0,0,0,0,0.48808156828023186,0.5119184317197681
87719,0.6153846153846154,0.425531914893617,-160,135,0.5902052121364724,0.40979478786352763,home,TOR,under,8,0.5348837209302326,-115,0.5119184317197681,TOR,BOS,2022 REG,21,10,5,0,10,26,1,0,10,-10,0,0,0,0,0,0,0,0,0,0.48808156828023186,0.5119184317197681
87720,0.425531914893617,0.6168582375478928,135,-161,0.407493552152549,0.592506447847451,away,BOS,over,9.5,0.5145631067961165,-106,0.4913668392989033,KC,BOS,2022 REG,11,13,10,5,18,21,1,0,8,-8,1,1,1,1,1,0,0,0,0,0.4913668392989033,0.5086331607010968
87720,0.425531914893617,0.6168582375478928,135,-161,0.407493552152549,0.592506447847451,home,KC,under,9.5,0.5305164319248826,-113,0.5086331607010968,KC,BOS,2022 REG,11,13,10,5,18,21,1,0,8,-8,1,1,1,1,1,0,0,0,0,0.4913668392989033,0.5086331607010968
87721,0.5934959349593496,0.4424778761061947,-146,126,0.5721456243269534,0.4278543756730466,away,STL,over,9.5,0.5260663507109005,-111,0.5010269332605688,ATL,STL,2022 REG,12,7,9,1,8,21,1,0,6,-6,1,0,0,0,0,0,0,0,0,0.5010269332605688,0.4989730667394312
87721,0.5934959349593496,0.4424778761061947,-146,126,0.5721456243269534,0.4278543756730466,home,ATL,under,9.5,0.5215311004784688,-109,0.4989730667394312,ATL,STL,2022 REG,12,7,9,1,8,21,1,0,6,-6,1,0,0,0,0,0,0,0,0,0.5010269332605688,0.4989730667394312
87722,0.5934959349593496,0.4444444444444444,-146,125,0.5709784740123824,0.42902152598761756,away,WSH,over,8.5,0.5145631067961165,-106,0.4913668392989033,MIA,WSH,2022 REG,10,7,9,4,11,19,1,0,3,-3,1,1,1,1,0,0,0,0,0,0.4913668392989033,0.5086331607010968
87722,0.5934959349593496,0.4444444444444444,-146,125,0.5709784740123824,0.42902152598761756,home,MIA,under,8.5,0.5305164319248826,-113,0.5086331607010968,MIA,WSH,2022 REG,10,7,9,4,11,19,1,0,3,-3,1,1,1,1,0,0,0,0,0,0.4913668392989033,0.5086331607010968
87723,0.574468085106383,0.4694835680751174,-135,113,0.5492192630659467,0.4507807369340533,away,TEX,over,6.5,0.5348837209302326,-115,0.5097020142727117,MIA,TEX,2022 REG,7,0,11,8,8,18,0,1,-8,8,0,0,0,0,0,0,0,0,0,0.5097020142727117,0.49029798572728833
87723,0.574468085106383,0.4694835680751174,-135,113,0.5492192630659467,0.4507807369340533,home,MIA,under,6.5,0.5121951219512195,-105,0.49029798572728833,MIA,TEX,2022 REG,7,0,11,8,8,18,0,1,-8,8,0,0,0,0,0,0,0,0,0,0.5097020142727117,0.49029798572728833
87724,0.5726495726495727,0.4716981132075471,-134,112,0.5472538892954956,0.45274611070450443,away,TEX,over,7.5,0.5,-100,0.4783105022831051,OAK,TEX,2022 REG,3,0,5,2,2,8,0,1,-2,2,0,0,0,0,0,0,0,0,0,0.4783105022831051,0.5216894977168949
87724,0.5726495726495727,0.4716981132075471,-134,112,0.5472538892954956,0.45274611070450443,home,OAK,under,7.5,0.5433789954337899,-119,0.5216894977168949,OAK,TEX,2022 REG,3,0,5,2,2,8,0,1,-2,2,0,0,0,0,0,0,0,0,0,0.4783105022831051,0.5216894977168949
87725,0.6197718631178707,0.4166666666666667,-163,140,0.597188287624032,0.402811712375968,away,TOR,over,8.5,0.5454545454545454,-120,0.5206611570247933,NYY,TOR,2022 REG,7,2,13,9,11,20,0,1,-7,7,1,1,0,0,0,0,0,0,0,0.5206611570247933,0.4793388429752067
87725,0.6197718631178707,0.4166666666666667,-163,140,0.597188287624032,0.402811712375968,home,NYY,under,8.5,0.5,100,0.4793388429752067,NYY,TOR,2022 REG,7,2,13,9,11,20,0,1,-7,7,1,1,0,0,0,0,0,0,0,0.5206611570247933,0.4793388429752067
87726,0.7118155619596541,0.3278688524590164,-247,205,0.6835675782091883,0.31643242179081166,away,OAK,over,9.5,0.5073891625615764,-103,0.4826927225525911,ATL,OAK,2022 REG,13,13,8,2,15,21,1,0,11,-11,1,1,0,0,0,0,0,0,0,0.4826927225525911,0.5173072774474089
87726,0.7118155619596541,0.3278688524590164,-247,205,0.6835675782091883,0.31643242179081166,home,ATL,under,9.5,0.5412844036697247,-118,0.5173072774474089,ATL,OAK,2022 REG,13,13,8,2,15,21,1,0,11,-11,1,1,0,0,0,0,0,0,0,0.4826927225525911,0.5173072774474089
87727,0.5098039215686274,0.5348837209302326,-104,-115,0.4870219861770517,0.5129780138229483,away,BOS,over,9,0.5454545454545454,-120,0.5206611570247933,KC,BOS,2022 REG,9,4,13,7,11,22,0,1,-3,3,1,1,1,1,0,0,0,0,0,0.5206611570247933,0.4793388429752067
87727,0.5098039215686274,0.5348837209302326,-104,-115,0.4870219861770517,0.5129780138229483,home,KC,under,9,0.5,100,0.4793388429752067,KC,BOS,2022 REG,9,4,13,7,11,22,0,1,-3,3,1,1,1,1,0,0,0,0,0,0.5206611570247933,0.4793388429752067
87728,0.5215311004784688,0.5238095238095238,-109,-110,0.4978845547971712,0.5021154452028288,away,SF,over,6.5,0.5454545454545454,-120,0.5206611570247933,SD,SF,2022 REG,3,1,7,3,4,10,0,1,-2,2,1,0,0,0,0,0,0,0,0,0.5206611570247933,0.4793388429752067
87728,0.5215311004784688,0.5238095238095238,-109,-110,0.4978845547971712,0.5021154452028288,home,SD,under,6.5,0.5,100,0.4793388429752067,SD,SF,2022 REG,3,1,7,3,4,10,0,1,-2,2,1,0,0,0,0,0,0,0,0,0.5206611570247933,0.4793388429752067
87729,0.5073891625615764,0.5348837209302326,-103,-115,0.4859403596076043,0.5140596403923957,away,TOR,over,9,0.5412844036697247,-118,0.5175913212324037,BOS,TOR,2022 REG,8,2,9,3,5,17,0,1,-1,1,1,1,0,0,0,0,0,0,0,0.5175913212324037,0.4824086787675963
87729,0.5073891625615764,0.5348837209302326,-103,-115,0.4859403596076043,0.5140596403923957,home,BOS,under,9,0.5024875621890548,-101,0.4824086787675963,BOS,TOR,2022 REG,8,2,9,3,5,17,0,1,-1,1,1,1,0,0,0,0,0,0,0,0.5175913212324037,0.4824086787675963
87730,0.5670995670995671,0.4807692307692307,-131,108,0.5399531925505952,0.46004680744940485,away,NYM,over,7,0.5475113122171946,-121,0.5242087833606768,SF,NYM,2022 REG,19,13,18,12,25,37,1,0,1,-1,1,1,1,1,1,1,1,1,1,0.5242087833606768,0.4757912166393232
87730,0.5670995670995671,0.4807692307692307,-131,108,0.5399531925505952,0.46004680744940485,home,SF,under,7,0.49504950495049505,102,0.4757912166393232,SF,NYM,2022 REG,19,13,18,12,25,37,1,0,1,-1,1,1,1,1,1,1,1,1,1,0.5242087833606768,0.4757912166393232
87731,0.6666666666666666,0.37735849056603776,-200,165,0.6373165618448637,0.36268343815513626,away,TEX,over,7.5,0.5327102803738317,-114,0.508788710910954,NYY,TEX,2022 REG,5,2,6,1,3,11,1,0,1,-1,1,0,0,0,0,0,0,0,0,0.508788710910954,0.491211289089046
87731,0.6666666666666666,0.37735849056603776,-200,165,0.6373165618448637,0.36268343815513626,home,NYY,under,7.5,0.5121951219512195,-105,0.491211289089046,NYY,TEX,2022 REG,5,2,6,1,3,11,1,0,1,-1,1,0,0,0,0,0,0,0,0,0.508788710910954,0.491211289089046
87732,0.4444444444444444,0.5918367346938775,125,-145,0.42831947593852354,0.5716805240614764,away,TB,over,8,0.5348837209302326,-115,0.5097020142727117,CHC,TB,2022 REG,7,4,6,2,6,13,1,0,2,-2,1,1,0,0,0,0,0,0,0,0.5097020142727117,0.49029798572728833
87732,0.4444444444444444,0.5918367346938775,125,-145,0.42831947593852354,0.5716805240614764,home,CHC,under,8,0.5121951219512195,-105,0.49029798572728833,CHC,TB,2022 REG,7,4,6,2,6,13,1,0,2,-2,1,1,0,0,0,0,0,0,0,0.5097020142727117,0.49029798572728833
87733,0.5967741935483871,0.4444444444444444,-148,125,0.5721759741010521,0.42782402589894786,away,KC,over,8.5,0.5412844036697247,-118,0.5189377998484975,CWS,KC,2022 REG,5,0,6,6,6,11,0,1,-6,6,0,0,0,0,0,0,0,0,0,0.5189377998484975,0.4810622001515025
87733,0.5967741935483871,0.4444444444444444,-148,125,0.5721759741010521,0.42782402589894786,home,CWS,under,8.5,0.5,100,0.4810622001515025,CWS,KC,2022 REG,5,0,6,6,6,11,0,1,-6,6,0,0,0,0,0,0,0,0,0,0.5189377998484975,0.4810622001515025
87734,0.7701149425287357,0.26525198938992045,-335,277,0.742878339786782,0.25712166021321803,away,KC,over,7.5,0.5348837209302326,-115,0.5097020142727117,HOU,KC,2022 REG,8,5,8,2,7,16,1,0,3,-3,1,1,0,0,0,0,0,0,0,0.5097020142727117,0.49029798572728833
87734,0.7701149425287357,0.26525198938992045,-335,277,0.742878339786782,0.25712166021321803,home,HOU,under,7.5,0.5121951219512195,-105,0.49029798572728833,HOU,KC,2022 REG,8,5,8,2,7,16,1,0,3,-3,1,1,0,0,0,0,0,0,0,0.5097020142727117,0.49029798572728833
87735,0.635036496350365,0.40322580645161293,-174,148,0.6107385376367002,0.38926146236329984,away,SEA,over,7,0.5433789954337899,-119,0.5198077604720502,NYY,SEA,2022 REG,5,3,10,7,10,15,0,1,-4,4,1,1,1,0,0,0,0,0,0,0.5198077604720502,0.48019223952794976
87735,0.635036496350365,0.40322580645161293,-174,148,0.6107385376367002,0.38926146236329984,home,NYY,under,7,0.5,100,0.48019223952794976,NYY,SEA,2022 REG,5,3,10,7,10,15,0,1,-4,4,1,1,1,0,0,0,0,0,0,0.5198077604720502,0.48019223952794976
87736,0.5708154506437768,0.4694835680751174,-133,113,0.5478121481132493,0.4521878518867507,away,LAA,over,9,0.5391705069124424,-117,0.5140669063204599,BOS,LAA,2022 REG,8,5,8,10,15,16,0,1,-5,5,1,1,1,1,1,0,0,0,0,0.5140669063204599,0.4859330936795401
87736,0.5708154506437768,0.4694835680751174,-133,113,0.5478121481132493,0.4521878518867507,home,BOS,under,9,0.5073891625615764,-103,0.4859330936795401,BOS,LAA,2022 REG,8,5,8,10,15,16,0,1,-5,5,1,1,1,1,1,0,0,0,0,0.5140669063204599,0.4859330936795401
87737,0.7530864197530864,0.2881844380403458,-305,247,0.7220058972172918,0.2779941027827082,away,COL,over,8,0.5348837209302326,-115,0.5097020142727117,LAD,COL,2022 REG,8,5,8,3,8,16,1,0,2,-2,1,1,1,0,0,0,0,0,0,0.5097020142727117,0.49029798572728833
87737,0.7530864197530864,0.2881844380403458,-305,247,0.7220058972172918,0.2779941027827082,home,LAD,under,8,0.5121951219512195,-105,0.49029798572728833,LAD,COL,2022 REG,8,5,8,3,8,16,1,0,2,-2,1,1,1,0,0,0,0,0,0,0.5097020142727117,0.49029798572728833
87738,0.6774193548387096,0.35714285714285715,-210,180,0.6540062434963579,0.34599375650364206,away,LAA,over,7.5,0.5348837209302326,-115,0.5097020142727117,SEA,LAA,2022 REG,4,2,7,1,3,11,1,0,1,-1,1,0,0,0,0,0,0,0,0,0.5097020142727117,0.49029798572728833
87738,0.6774193548387096,0.35714285714285715,-210,180,0.6540062434963579,0.34599375650364206,home,SEA,under,7.5,0.5121951219512195,-105,0.49029798572728833,SEA,LAA,2022 REG,4,2,7,1,3,11,1,0,1,-1,1,0,0,0,0,0,0,0,0,0.5097020142727117,0.49029798572728833
87739,0.5145631067961165,0.5238095238095238,-106,-110,0.4948179667757384,0.5051820332242616,away,TOR,over,8.5,0.5121951219512195,-105,0.48808156828023186,SEA,TOR,2022 REG,9,5,12,2,7,21,1,0,3,-3,1,1,0,0,0,0,0,0,0,0.48808156828023186,0.5119184317197681
87739,0.5145631067961165,0.5238095238095238,-106,-110,0.4948179667757384,0.5051820332242616,home,SEA,under,8.5,0.5348837209302326,-115,0.5119184317197681,SEA,TOR,2022 REG,9,5,12,2,7,21,1,0,3,-3,1,1,0,0,0,0,0,0,0,0.48808156828023186,0.5119184317197681
87740,0.48780487804878053,0.5475113122171946,105,-121,0.470577468162939,0.529422531837061,away,MIN,over,7.5,0.5121951219512195,-105,0.48808156828023186,DET,MIN,2022 REG,9,5,2,0,5,11,1,0,5,-5,0,0,0,0,0,0,0,0,0,0.48808156828023186,0.5119184317197681
87740,0.48780487804878053,0.5475113122171946,105,-121,0.470577468162939,0.529422531837061,home,DET,under,7.5,0.5348837209302326,-115,0.5119184317197681,DET,MIN,2022 REG,9,5,2,0,5,11,1,0,5,-5,0,0,0,0,0,0,0,0,0,0.48808156828023186,0.5119184317197681
87741,0.7368421052631579,0.30120481927710846,-280,232,0.7088075292861195,0.29119247071388055,away,COL,over,8.5,0.5121951219512195,-105,0.48808156828023186,MIL,COL,2022 REG,12,9,7,4,13,19,1,0,5,-5,1,1,1,1,0,0,0,0,0,0.48808156828023186,0.5119184317197681
87741,0.7368421052631579,0.30120481927710846,-280,232,0.7088075292861195,0.29119247071388055,home,MIL,under,8.5,0.5348837209302326,-115,0.5119184317197681,MIL,COL,2022 REG,12,9,7,4,13,19,1,0,5,-5,1,1,1,1,0,0,0,0,0,0.48808156828023186,0.5119184317197681
87742,0.4854368932038835,0.5495495495495495,106,-122,0.4684531831294015,0.5315468168705986,away,SEA,over,7.5,0.5121951219512195,-105,0.48697865027430753,CLE,SEA,2022 REG,9,3,9,6,9,18,0,1,-3,3,1,1,1,0,0,0,0,0,0,0.48697865027430753,0.5130213497256925
87742,0.4854368932038835,0.5495495495495495,106,-122,0.4684531831294015,0.5315468168705986,home,CLE,under,7.5,0.5370370370370371,-116,0.5130213497256925,CLE,SEA,2022 REG,9,3,9,6,9,18,0,1,-3,3,1,1,1,0,0,0,0,0,0,0.48697865027430753,0.5130213497256925
87743,0.7311827956989247,0.3125,-272,220,0.69924268701584,0.30075731298416,away,PIT,over,7.5,0.5024875621890548,-101,0.48049269377245407,MIL,PIT,2022 REG,3,5,4,2,7,7,1,0,3,-3,1,1,0,0,0,0,0,0,0,0.48049269377245407,0.5195073062275459
87743,0.7311827956989247,0.3125,-272,220,0.69924268701584,0.30075731298416,home,MIL,under,7.5,0.5412844036697247,-118,0.5195073062275459,MIL,PIT,2022 REG,3,5,4,2,7,7,1,0,3,-3,1,1,0,0,0,0,0,0,0,0.48049269377245407,0.5195073062275459
87744,0.7402597402597403,0.29850746268656714,-285,235,0.7115619406761102,0.2884380593238898,away,PIT,over,7.5,0.5348837209302326,-115,0.5109810284308424,NYY,PIT,2022 REG,11,14,4,2,16,15,1,0,12,-12,1,1,0,0,0,0,0,0,0,0.5109810284308424,0.48901897156915763
87744,0.7402597402597403,0.29850746268656714,-285,235,0.7115619406761102,0.2884380593238898,home,NYY,under,7.5,0.5098039215686274,-104,0.48901897156915763,NYY,PIT,2022 REG,11,14,4,2,16,15,1,0,12,-12,1,1,0,0,0,0,0,0,0,0.5109810284308424,0.48901897156915763
87745,0.5391705069124424,0.5,-117,100,0.5180509248444435,0.4819490751555565,away,KC,over,7.5,0.5454545454545454,-120,0.5206611570247933,DET,KC,2022 REG,8,4,8,3,7,16,1,0,1,-1,1,1,1,0,0,0,0,0,0,0.5206611570247933,0.4793388429752067
87745,0.5391705069124424,0.5,-117,100,0.5180509248444435,0.4819490751555565,home,DET,under,7.5,0.5,100,0.4793388429752067,DET,KC,2022 REG,8,4,8,3,7,16,1,0,1,-1,1,1,1,0,0,0,0,0,0,0.5206611570247933,0.4793388429752067
87746,0.574468085106383,0.46511627906976744,-135,115,0.5517281312179562,0.44827186878204384,away,SEA,over,7.5,0.49504950495049505,102,0.4739797934813417,SD,SEA,2022 REG,8,2,11,6,8,19,0,1,-4,4,1,1,0,0,0,0,0,0,0,0.4739797934813417,0.5260202065186583
87746,0.574468085106383,0.46511627906976744,-135,115,0.5517281312179562,0.44827186878204384,home,SD,under,7.5,0.5475113122171946,-121,0.5260202065186583,SD,SEA,2022 REG,8,2,11,6,8,19,0,1,-4,4,1,1,0,0,0,0,0,0,0,0.4739797934813417,0.5260202065186583
87747,0.5535714285714286,0.49019607843137253,-124,104,0.5293429871948779,0.47065701280512207,away,ARI,over,12,0.5305164319248826,-113,0.5078572507605655,COL,ARI,2022 REG,6,5,5,3,8,11,1,0,2,-2,1,1,1,0,0,0,0,0,0,0.5078572507605655,0.49214274923943446
87747,0.5535714285714286,0.49019607843137253,-124,104,0.5293429871948779,0.47065701280512207,home,COL,under,12,0.5121951219512195,-105,0.49214274923943446,COL,ARI,2022 REG,6,5,5,3,8,11,1,0,2,-2,1,1,1,0,0,0,0,0,0,0.5078572507605655,0.49214274923943446
87748,0.3802281368821293,0.6632996632996633,163,-197,0.36367764251642876,0.6363223574835712,away,MIL,over,9,0.5305164319248826,-113,0.5066009958897986,CIN,MIL,2022 REG,14,14,15,11,25,29,1,0,3,-3,1,1,1,1,1,1,1,1,1,0.5066009958897986,0.49339900411020143
87748,0.3802281368821293,0.6632996632996633,163,-197,0.36367764251642876,0.6363223574835712,home,CIN,under,9,0.5145631067961165,-106,0.49339900411020143,CIN,MIL,2022 REG,14,14,15,11,25,29,1,0,3,-3,1,1,1,1,1,1,1,1,1,0.5066009958897986,0.49339900411020143
87749,0.39525691699604737,0.6402877697841727,153,-178,0.3812076336837074,0.6187923663162926,away,SEA,over,8.5,0.5169082125603864,-107,0.4946943078742622,LAA,SEA,2022 REG,10,7,10,11,18,20,0,1,-4,4,1,1,1,1,1,1,1,0,0,0.4946943078742622,0.5053056921257377
87749,0.39525691699604737,0.6402877697841727,153,-178,0.3812076336837074,0.6187923663162926,home,LAA,under,8.5,0.5260663507109005,-111,0.5053056921257377,LAA,SEA,2022 REG,10,7,10,11,18,20,0,1,-4,4,1,1,1,1,1,1,1,0,0,0.4946943078742622,0.5053056921257377
87750,0.3278688524590164,0.7101449275362319,205,-245,0.31540531803434485,0.6845946819656552,away,NYY,over,6.5,0.5348837209302326,-115,0.5097020142727117,OAK,NYY,2022 REG,5,2,9,3,5,14,0,1,-1,1,1,1,0,0,0,0,0,0,0,0.5097020142727117,0.49029798572728833
87750,0.3278688524590164,0.7101449275362319,205,-245,0.31540531803434485,0.6845946819656552,home,OAK,under,6.5,0.5121951219512195,-105,0.49029798572728833,OAK,NYY,2022 REG,5,2,9,3,5,14,0,1,-1,1,1,1,0,0,0,0,0,0,0,0.5097020142727117,0.49029798572728833
87751,0.5215311004784688,0.5215311004784688,-109,-109,0.49907282342437215,0.5009271765756278,away,ATL,over,9,0.5,100,0.47935779816513757,TEX,ATL,2022 REG,4,3,4,1,4,8,1,0,2,-2,1,0,0,0,0,0,0,0,0,0.47935779816513757,0.5206422018348624
87751,0.5215311004784688,0.5215311004784688,-109,-109,0.49907282342437215,0.5009271765756278,home,TEX,under,9,0.5412844036697247,-118,0.5206422018348624,TEX,ATL,2022 REG,4,3,4,1,4,8,1,0,2,-2,1,0,0,0,0,0,0,0,0,0.47935779816513757,0.5206422018348624
87752,0.36101083032490977,0.6742671009771988,177,-207,0.3482751150533904,0.6517248849466095,away,PHI,over,9.5,0.5238095238095238,-110,0.4988662131519274,WSH,PHI,2022 REG,5,1,11,10,11,16,0,1,-9,9,1,0,0,0,0,0,0,0,0,0.4988662131519274,0.5011337868480725
87752,0.36101083032490977,0.6742671009771988,177,-207,0.3482751150533904,0.6517248849466095,home,WSH,under,9.5,0.5238095238095238,-110,0.5011337868480725,WSH,PHI,2022 REG,5,1,11,10,11,16,0,1,-9,9,1,0,0,0,0,0,0,0,0,0.4988662131519274,0.5011337868480725
87753,0.6226415094339623,0.4166666666666667,-165,140,0.5981666073335706,0.40183339266642937,away,DET,over,7.5,0.5121951219512195,-105,0.48919479393107135,KC,DET,2022 REG,7,4,4,0,4,11,1,0,4,-4,0,0,0,0,0,0,0,0,0,0.48919479393107135,0.5108052060689287
87753,0.6226415094339623,0.4166666666666667,-165,140,0.5981666073335706,0.40183339266642937,home,KC,under,7.5,0.5327102803738317,-114,0.5108052060689287,KC,DET,2022 REG,7,4,4,0,4,11,1,0,4,-4,0,0,0,0,0,0,0,0,0,0.48919479393107135,0.5108052060689287
87754,0.5594713656387665,0.47619047619047616,-127,110,0.5395195862893665,0.46048041371063353,away,BAL,over,8,0.5215311004784688,-109,0.49670754937970685,OAK,BAL,2022 REG,7,2,8,1,3,15,1,0,1,-1,1,0,0,0,0,0,0,0,0,0.49670754937970685,0.5032924506202932
87754,0.5594713656387665,0.47619047619047616,-127,110,0.5395195862893665,0.46048041371063353,home,OAK,under,8,0.5260663507109005,-111,0.5032924506202932,OAK,BAL,2022 REG,7,2,8,1,3,15,1,0,1,-1,1,0,0,0,0,0,0,0,0,0.49670754937970685,0.5032924506202932
87755,0.5670995670995671,0.4716981132075471,-131,112,0.5450974193929352,0.4549025806070648,away,KC,over,8.5,0.5305164319248826,-113,0.5066009958897986,TEX,KC,2022 REG,6,2,8,8,10,14,0,1,-6,6,1,1,0,0,0,0,0,0,0,0.5066009958897986,0.49339900411020143
87755,0.5670995670995671,0.4716981132075471,-131,112,0.5450974193929352,0.4549025806070648,home,TEX,under,8.5,0.5145631067961165,-106,0.49339900411020143,TEX,KC,2022 REG,6,2,8,8,10,14,0,1,-6,6,1,1,0,0,0,0,0,0,0,0.5066009958897986,0.49339900411020143
87756,0.6376811594202898,0.4,-176,150,0.6136525939928585,0.38634740600714146,away,KC,over,7.5,0.5,100,0.4772727272727273,CLE,KC,2022 REG,8,1,12,7,8,20,0,1,-6,6,1,0,0,0,0,0,0,0,0,0.4772727272727273,0.5227272727272727
87756,0.6376811594202898,0.4,-176,150,0.6136525939928585,0.38634740600714146,home,CLE,under,7.5,0.5454545454545454,-120,0.5227272727272727,CLE,KC,2022 REG,8,1,12,7,8,20,0,1,-6,6,1,0,0,0,0,0,0,0,0,0.4772727272727273,0.5227272727272727
87757,0.6941896024464832,0.3448275862068966,-227,190,0.667104275766614,0.332895724233386,away,ATL,over,8,0.5327102803738317,-114,0.508788710910954,LAD,ATL,2022 REG,7,7,10,4,11,17,1,0,3,-3,1,1,1,1,0,0,0,0,0,0.508788710910954,0.491211289089046
87757,0.6941896024464832,0.3448275862068966,-227,190,0.667104275766614,0.332895724233386,home,LAD,under,8,0.5121951219512195,-105,0.491211289089046,LAD,ATL,2022 REG,7,7,10,4,11,17,1,0,3,-3,1,1,1,1,0,0,0,0,0,0.508788710910954,0.491211289089046
87758,0.6389891696750902,0.4,-177,150,0.614075512518083,0.385924487481917,away,SEA,over,8,0.5238095238095238,-110,0.4988662131519274,HOU,SEA,2022 REG,10,4,7,7,11,17,0,1,-3,3,1,1,1,1,0,0,0,0,0,0.4988662131519274,0.5011337868480725
87758,0.6389891696750902,0.4,-177,150,0.614075512518083,0.385924487481917,home,HOU,under,8,0.5238095238095238,-110,0.5011337868480725,HOU,SEA,2022 REG,10,4,7,7,11,17,0,1,-3,3,1,1,1,1,0,0,0,0,0,0.4988662131519274,0.5011337868480725
87759,0.5934959349593496,0.4444444444444444,-146,125,0.5709784740123824,0.42902152598761756,away,TEX,over,7.5,0.5412844036697247,-118,0.5136310900085983,CWS,TEX,2022 REG,8,6,11,8,14,19,0,1,-2,2,1,1,1,1,1,1,0,0,0,0.5136310900085983,0.4863689099914017
87759,0.5934959349593496,0.4444444444444444,-146,125,0.5709784740123824,0.42902152598761756,home,CWS,under,7.5,0.5098039215686274,-104,0.4863689099914017,CWS,TEX,2022 REG,8,6,11,8,14,19,0,1,-2,2,1,1,1,1,1,1,0,0,0,0.5136310900085983,0.4863689099914017
87760,0.2857142857142857,0.7560975609756098,250,-310,0.27376804380288694,0.7262319561971131,away,NYM,over,9,0.5348837209302326,-115,0.5097020142727117,WSH,NYM,2022 REG,13,5,14,9,14,27,0,1,-4,4,1,1,1,1,1,0,0,0,0,0.5097020142727117,0.49029798572728833
87760,0.2857142857142857,0.7560975609756098,250,-310,0.27376804380288694,0.7262319561971131,home,WSH,under,9,0.5121951219512195,-105,0.49029798572728833,WSH,NYM,2022 REG,13,5,14,9,14,27,0,1,-4,4,1,1,1,1,1,0,0,0,0,0.5097020142727117,0.49029798572728833
87761,0.6515679442508712,0.3891050583657587,-187,157,0.6250667195494433,0.37493328045055674,away,WSH,over,7,0.5535714285714286,-124,0.5293429871948779,MIA,WSH,2022 REG,7,4,9,5,9,16,0,1,-1,1,1,1,1,1,0,0,0,0,0,0.5293429871948779,0.47065701280512207
87761,0.6515679442508712,0.3891050583657587,-187,157,0.6250667195494433,0.37493328045055674,home,MIA,under,7,0.49019607843137253,104,0.47065701280512207,MIA,WSH,2022 REG,7,4,9,5,9,16,0,1,-1,1,1,1,1,1,0,0,0,0,0,0.5293429871948779,0.47065701280512207
87762,0.6296296296296295,0.41493775933609955,-170,141,0.6015686810215778,0.3984313189784222,away,TEX,over,8.5,0.5238095238095238,-110,0.5012646084074657,LAA,TEX,2022 REG,6,2,10,7,9,16,0,1,-5,5,1,1,0,0,0,0,0,0,0,0.5012646084074657,0.4987353915925343
87762,0.6296296296296295,0.41493775933609955,-170,141,0.6015686810215778,0.3984313189784222,home,LAA,under,8.5,0.5192307692307692,-108,0.4987353915925343,LAA,TEX,2022 REG,6,2,10,7,9,16,0,1,-5,5,1,1,0,0,0,0,0,0,0,0.5012646084074657,0.4987353915925343
87763,0.4291845493562232,0.607843137254902,133,-155,0.41329283836432396,0.586707161635676,away,LAD,over,7.5,0.49504950495049505,102,0.47297076509898783,SD,LAD,2022 REG,8,2,8,10,12,16,0,1,-8,8,1,1,0,0,0,0,0,0,0,0.47297076509898783,0.5270292349010122
87763,0.4291845493562232,0.607843137254902,133,-155,0.41329283836432396,0.586707161635676,home,SD,under,7.5,0.5495495495495495,-122,0.5270292349010122,SD,LAD,2022 REG,8,2,8,10,12,16,0,1,-8,8,1,1,0,0,0,0,0,0,0,0.47297076509898783,0.5270292349010122
87764,0.7159090909090909,0.32573289902280134,-252,207,0.6860972117533044,0.3139027882466956,away,MIN,over,8,0.5348837209302326,-115,0.5097020142727117,LAD,MIN,2022 REG,15,10,7,3,13,22,1,0,7,-7,1,1,1,0,0,0,0,0,0,0.5097020142727117,0.49029798572728833
87764,0.7159090909090909,0.32573289902280134,-252,207,0.6860972117533044,0.3139027882466956,home,LAD,under,8,0.5121951219512195,-105,0.49029798572728833,LAD,MIN,2022 REG,15,10,7,3,13,22,1,0,7,-7,1,1,1,0,0,0,0,0,0,0.5097020142727117,0.49029798572728833
87765,0.6197718631178707,0.42016806722689076,-163,138,0.5950182180753,0.4049817819247,away,WSH,over,9.5,0.5145631067961165,-106,0.4913668392989033,TEX,WSH,2022 REG,8,4,10,6,10,18,0,1,-2,2,1,1,1,1,0,0,0,0,0,0.4913668392989033,0.5086331607010968
87765,0.6197718631178707,0.42016806722689076,-163,138,0.5950182180753,0.4049817819247,home,TEX,under,9.5,0.5305164319248826,-113,0.5086331607010968,TEX,WSH,2022 REG,8,4,10,6,10,18,0,1,-2,2,1,1,1,1,0,0,0,0,0,0.4913668392989033,0.5086331607010968
87766,0.6688741721854304,0.373134328358209,-202,168,0.6407757711595524,0.3592242288404476,away,COL,over,7.5,0.5192307692307692,-108,0.49688292476754015,SF,COL,2022 REG,10,7,4,1,8,14,1,0,6,-6,1,0,0,0,0,0,0,0,0,0.49688292476754015,0.5031170752324599
87766,0.6688741721854304,0.373134328358209,-202,168,0.6407757711595524,0.3592242288404476,home,SF,under,7.5,0.5238095238095238,-110,0.5031170752324599,SF,COL,2022 REG,10,7,4,1,8,14,1,0,6,-6,1,0,0,0,0,0,0,0,0,0.49688292476754015,0.5031170752324599
87767,0.5884773662551441,0.45248868778280543,-143,121,0.5643697706690257,0.4356302293309743,away,SD,over,12,0.5145631067961165,-106,0.4913668392989033,CHC,SD,2022 REG,11,5,21,19,24,32,0,1,-14,14,1,1,1,1,1,0,0,0,0,0.4913668392989033,0.5086331607010968
87767,0.5884773662551441,0.45248868778280543,-143,121,0.5643697706690257,0.4356302293309743,home,CHC,under,12,0.5305164319248826,-113,0.5086331607010968,CHC,SD,2022 REG,11,5,21,19,24,32,0,1,-14,14,1,1,1,1,1,0,0,0,0,0.4913668392989033,0.5086331607010968
87768,0.7560975609756098,0.2857142857142857,-310,250,0.7244837256734936,0.2755162743265064,away,BAL,over,9.5,0.5,100,0.4772727272727273,TOR,BAL,2022 REG,13,7,6,6,13,19,1,0,1,-1,1,1,1,1,1,1,0,0,0,0.4772727272727273,0.5227272727272727
87768,0.7560975609756098,0.2857142857142857,-310,250,0.7244837256734936,0.2755162743265064,home,TOR,under,9.5,0.5454545454545454,-120,0.5227272727272727,TOR,BAL,2022 REG,13,7,6,6,13,19,1,0,1,-1,1,1,1,1,1,1,0,0,0,0.4772727272727273,0.5227272727272727
87769,0.35714285714285715,0.6875,180,-220,0.3411989795918367,0.6588010204081634,away,LAD,over,8.5,0.5327102803738317,-114,0.508788710910954,WSH,LAD,2022 REG,6,1,6,0,1,12,1,0,1,-1,0,0,0,0,0,0,0,0,0,0.508788710910954,0.491211289089046
87769,0.35714285714285715,0.6875,180,-220,0.3411989795918367,0.6588010204081634,home,WSH,under,8.5,0.5121951219512195,-105,0.491211289089046,WSH,LAD,2022 REG,6,1,6,0,1,12,1,0,1,-1,0,0,0,0,0,0,0,0,0,0.508788710910954,0.491211289089046
87770,0.4464285714285714,0.5918367346938775,124,-145,0.42934584548104954,0.5706541545189505,away,LAD,over,9,0.5454545454545454,-120,0.5206611570247933,MIN,LAD,2022 REG,5,2,9,7,9,14,0,1,-5,5,1,1,0,0,0,0,0,0,0,0.5206611570247933,0.4793388429752067
87770,0.4464285714285714,0.5918367346938775,124,-145,0.42934584548104954,0.5706541545189505,home,MIN,under,9,0.5,100,0.4793388429752067,MIN,LAD,2022 REG,5,2,9,7,9,14,0,1,-5,5,1,1,0,0,0,0,0,0,0,0.5206611570247933,0.4793388429752067
87771,0.5238095238095238,0.5145631067961165,-110,-106,0.5037095744446646,0.4962904255553354,away,LAD,over,8.5,0.5391705069124424,-117,0.5140669063204599,ATL,LAD,2022 REG,8,3,12,5,8,20,0,1,-2,2,1,1,1,0,0,0,0,0,0,0.5140669063204599,0.4859330936795401
87771,0.5238095238095238,0.5145631067961165,-110,-106,0.5037095744446646,0.4962904255553354,home,ATL,under,8.5,0.5073891625615764,-103,0.4859330936795401,ATL,LAD,2022 REG,8,3,12,5,8,20,0,1,-2,2,1,1,1,0,0,0,0,0,0,0.5140669063204599,0.4859330936795401
87772,0.6894409937888198,0.35460992907801414,-222,182,0.6590704817501952,0.3409295182498048,away,WSH,over,7,0.5475113122171946,-121,0.5228602997583487,MIA,WSH,2022 REG,16,8,5,2,10,21,1,0,6,-6,1,1,0,0,0,0,0,0,0,0.5228602997583487,0.4771397002416513
87772,0.6894409937888198,0.35460992907801414,-222,182,0.6590704817501952,0.3409295182498048,home,MIA,under,7,0.49751243781094534,101,0.4771397002416513,MIA,WSH,2022 REG,16,8,5,2,10,21,1,0,6,-6,1,1,0,0,0,0,0,0,0,0.5228602997583487,0.4771397002416513
87773,0.5708154506437768,0.4672897196261683,-133,114,0.5490644307042802,0.45093556929571976,away,ARI,over,8,0.5370370370370371,-116,0.5118817074154765,SF,ARI,2022 REG,6,4,13,3,7,19,1,0,1,-1,1,1,1,0,0,0,0,0,0,0.5118817074154765,0.48811829258452355
87773,0.5708154506437768,0.4672897196261683,-133,114,0.5490644307042802,0.45093556929571976,home,SF,under,8,0.5098039215686274,-104,0.48811829258452355,SF,ARI,2022 REG,6,4,13,3,7,19,1,0,1,-1,1,1,1,0,0,0,0,0,0,0.5118817074154765,0.48811829258452355
87774,0.5121951219512195,0.5283018867924528,-105,-112,0.49145275161909474,0.5085472483809053,away,MIN,over,7.5,0.5348837209302326,-115,0.5109810284308424,DET,MIN,2022 REG,6,5,3,2,7,9,1,0,3,-3,1,1,0,0,0,0,0,0,0,0.5109810284308424,0.48901897156915763
87774,0.5121951219512195,0.5283018867924528,-105,-112,0.49145275161909474,0.5085472483809053,home,DET,under,7.5,0.5098039215686274,-104,0.48901897156915763,DET,MIN,2022 REG,6,5,3,2,7,9,1,0,3,-3,1,1,0,0,0,0,0,0,0,0.5109810284308424,0.48901897156915763
87775,0.35714285714285715,0.6825396825396826,180,-215,0.34297052154195007,0.6570294784580499,away,NYY,over,7.5,0.5145631067961165,-106,0.4925063625223866,KC,NYY,2022 REG,7,0,8,3,3,15,0,1,-3,3,0,0,0,0,0,0,0,0,0,0.4925063625223866,0.5074936374776133
87775,0.35714285714285715,0.6825396825396826,180,-215,0.34297052154195007,0.6570294784580499,home,KC,under,7.5,0.5283018867924528,-112,0.5074936374776133,KC,NYY,2022 REG,7,0,8,3,3,15,0,1,-3,3,0,0,0,0,0,0,0,0,0,0.4925063625223866,0.5074936374776133
87776,0.35714285714285715,0.6774193548387096,180,-210,0.3447992100065833,0.6552007899934167,away,LAD,over,12,0.5215311004784688,-109,0.49907282342437215,COL,LAD,2022 REG,7,0,14,13,13,21,0,1,-13,13,0,0,0,0,0,0,0,0,0,0.49907282342437215,0.5009271765756278
87776,0.35714285714285715,0.6774193548387096,180,-210,0.3447992100065833,0.6552007899934167,home,COL,under,12,0.5215311004784688,-109,0.5009271765756278,COL,LAD,2022 REG,7,0,14,13,13,21,0,1,-13,13,0,0,0,0,0,0,0,0,0,0.49907282342437215,0.5009271765756278
87777,0.4608294930875576,0.5815899581589958,117,-139,0.44128135887255604,0.558718641127444,away,STL,over,8.5,0.5145631067961165,-106,0.4913668392989033,CHC,STL,2022 REG,11,3,11,5,8,22,0,1,-2,2,1,1,1,0,0,0,0,0,0,0.4913668392989033,0.5086331607010968
87777,0.4608294930875576,0.5815899581589958,117,-139,0.44128135887255604,0.558718641127444,home,CHC,under,8.5,0.5305164319248826,-113,0.5086331607010968,CHC,STL,2022 REG,11,3,11,5,8,22,0,1,-2,2,1,1,1,0,0,0,0,0,0,0.4913668392989033,0.5086331607010968
87778,0.4424778761061947,0.5967741935483871,126,-148,0.4251097036926629,0.5748902963073371,away,SF,over,9.5,0.49504950495049505,102,0.4739797934813417,CIN,SF,2022 REG,8,4,6,6,10,14,0,1,-2,2,1,1,1,1,0,0,0,0,0,0.4739797934813417,0.5260202065186583
87778,0.4424778761061947,0.5967741935483871,126,-148,0.4251097036926629,0.5748902963073371,home,CIN,under,9.5,0.5475113122171946,-121,0.5260202065186583,CIN,SF,2022 REG,8,4,6,6,10,14,0,1,-2,2,1,1,1,1,0,0,0,0,0,0.4739797934813417,0.5260202065186583
87779,0.5412844036697247,0.5,-118,100,0.5189377998484975,0.4810622001515025,away,TB,over,7.5,0.5,100,0.4772727272727273,TOR,TB,2022 REG,11,5,7,1,6,18,1,0,4,-4,1,0,0,0,0,0,0,0,0,0.4772727272727273,0.5227272727272727
87779,0.5412844036697247,0.5,-118,100,0.5189377998484975,0.4810622001515025,home,TOR,under,7.5,0.5454545454545454,-120,0.5227272727272727,TOR,TB,2022 REG,11,5,7,1,6,18,1,0,4,-4,1,0,0,0,0,0,0,0,0,0.4772727272727273,0.5227272727272727
87780,0.5780590717299579,0.4566210045662101,-137,119,0.558011939018671,0.44198806098132903,away,BOS,over,7.5,0.5412844036697247,-118,0.5189377998484975,TB,BOS,2022 REG,13,8,6,4,12,19,1,0,4,-4,1,1,1,1,0,0,0,0,0,0.5189377998484975,0.4810622001515025
87780,0.5780590717299579,0.4566210045662101,-137,119,0.558011939018671,0.44198806098132903,home,TB,under,7.5,0.5,100,0.4810622001515025,TB,BOS,2022 REG,13,8,6,4,12,19,1,0,4,-4,1,1,1,1,0,0,0,0,0,0.5189377998484975,0.4810622001515025
87781,0.390625,0.6539792387543253,156,-189,0.3732014692365917,0.6267985307634083,away,MIL,over,7.5,0.5412844036697247,-118,0.5162581740877563,BAL,MIL,2022 REG,5,2,7,4,6,12,0,1,-2,2,1,1,0,0,0,0,0,0,0,0.5162581740877563,0.4837418259122437
87781,0.390625,0.6539792387543253,156,-189,0.3732014692365917,0.6267985307634083,home,BAL,under,7.5,0.504950495049505,-102,0.4837418259122437,BAL,MIL,2022 REG,5,2,7,4,6,12,0,1,-2,2,1,1,0,0,0,0,0,0,0,0.5162581740877563,0.4837418259122437
87782,0.45454545454545453,0.5867768595041323,120,-142,0.43576258452291505,0.564237415477085,away,BOS,over,8.5,0.47619047619047616,110,0.4564724440500838,BAL,BOS,2022 REG,5,1,6,3,4,11,0,1,-2,2,1,0,0,0,0,0,0,0,0,0.4564724440500838,0.5435275559499162
87782,0.45454545454545453,0.5867768595041323,120,-142,0.43576258452291505,0.564237415477085,home,BAL,under,8.5,0.5652173913043479,-130,0.5435275559499162,BAL,BOS,2022 REG,5,1,6,3,4,11,0,1,-2,2,1,0,0,0,0,0,0,0,0,0.4564724440500838,0.5435275559499162
87783,0.7142857142857143,0.3225806451612903,-250,210,0.6879526003949967,0.3120473996050033,away,PIT,over,7.5,0.5348837209302326,-115,0.5097020142727117,SF,PIT,2022 REG,5,2,5,0,2,10,1,0,2,-2,0,0,0,0,0,0,0,0,0,0.5097020142727117,0.49029798572728833
87783,0.7142857142857143,0.3225806451612903,-250,210,0.6879526003949967,0.3120473996050033,home,SF,under,7.5,0.5121951219512195,-105,0.49029798572728833,SF,PIT,2022 REG,5,2,5,0,2,10,1,0,2,-2,0,0,0,0,0,0,0,0,0,0.5097020142727117,0.49029798572728833
87784,0.574468085106383,0.46511627906976744,-135,115,0.5517281312179562,0.44827186878204384,away,NYM,over,7.5,0.49019607843137253,104,0.4707129274603323,ATL,NYM,2022 REG,5,1,9,4,5,14,0,1,-3,3,1,0,0,0,0,0,0,0,0,0.4707129274603323,0.5292870725396677
87784,0.574468085106383,0.46511627906976744,-135,115,0.5517281312179562,0.44827186878204384,home,ATL,under,7.5,0.5495495495495495,-122,0.5292870725396677,ATL,NYM,2022 REG,5,1,9,4,5,14,0,1,-3,3,1,0,0,0,0,0,0,0,0,0.4707129274603323,0.5292870725396677
87785,0.6794871794871794,0.3623188405797102,-212,176,0.651080524826344,0.34891947517365596,away,CLE,over,8,0.5327102803738317,-114,0.5075272610403079,HOU,CLE,2022 REG,9,7,7,3,10,16,1,0,4,-4,1,1,1,0,0,0,0,0,0,0.5075272610403079,0.4924727389596921
87785,0.6794871794871794,0.3623188405797102,-212,176,0.651080524826344,0.34891947517365596,home,HOU,under,8,0.5145631067961165,-106,0.4924727389596921,HOU,CLE,2022 REG,9,7,7,3,10,16,1,0,4,-4,1,1,1,0,0,0,0,0,0,0.5075272610403079,0.4924727389596921
87786,0.41152263374485604,0.6240601503759399,143,-166,0.3968795127074915,0.6031204872925084,away,MIN,over,8.5,0.5370370370370371,-116,0.514488177212783,DET,MIN,2022 REG,13,7,10,5,12,23,1,0,2,-2,1,1,1,1,1,0,0,0,0,0.514488177212783,0.48551182278721705
87786,0.41152263374485604,0.6240601503759399,143,-166,0.3968795127074915,0.6031204872925084,home,DET,under,8.5,0.504950495049505,-102,0.48551182278721705,DET,MIN,2022 REG,13,7,10,5,12,23,1,0,2,-2,1,1,1,1,1,0,0,0,0,0.514488177212783,0.48551182278721705
87787,0.5951417004048584,0.4444444444444444,-147,125,0.5715823348467713,0.42841766515322866,away,MIN,over,9,0.5121951219512195,-105,0.48808156828023186,BOS,MIN,2022 REG,11,3,9,8,11,20,0,1,-5,5,1,1,1,0,0,0,0,0,0,0.48808156828023186,0.5119184317197681
87787,0.5951417004048584,0.4444444444444444,-147,125,0.5715823348467713,0.42841766515322866,home,BOS,under,9,0.5348837209302326,-115,0.5119184317197681,BOS,MIN,2022 REG,11,3,9,8,11,20,0,1,-5,5,1,1,1,0,0,0,0,0,0,0.48808156828023186,0.5119184317197681
87788,0.37037037037037035,0.6666666666666666,170,-200,0.35665294924554186,0.6433470507544581,away,TB,over,8,0.5238095238095238,-110,0.4988662131519274,DET,TB,2022 REG,9,3,7,5,8,16,0,1,-2,2,1,1,1,0,0,0,0,0,0,0.4988662131519274,0.5011337868480725
87788,0.37037037037037035,0.6666666666666666,170,-200,0.35665294924554186,0.6433470507544581,home,DET,under,8,0.5238095238095238,-110,0.5011337868480725,DET,TB,2022 REG,9,3,7,5,8,16,0,1,-2,2,1,1,1,0,0,0,0,0,0,0.4988662131519274,0.5011337868480725
87789,0.4854368932038835,0.5555555555555556,106,-125,0.465537646233282,0.534462353766718,away,PHI,over,8,0.5327102803738317,-114,0.5075272610403079,PIT,PHI,2022 REG,7,2,11,4,6,18,0,1,-2,2,1,1,0,0,0,0,0,0,0,0.5075272610403079,0.4924727389596921
87789,0.4854368932038835,0.5555555555555556,106,-125,0.465537646233282,0.534462353766718,home,PIT,under,8,0.5145631067961165,-106,0.4924727389596921,PIT,PHI,2022 REG,7,2,11,4,6,18,0,1,-2,2,1,1,0,0,0,0,0,0,0,0.5075272610403079,0.4924727389596921
87790,0.4608294930875576,0.576271186440678,117,-136,0.4437324057473569,0.5562675942526432,away,SEA,over,7.5,0.5348837209302326,-115,0.5097020142727117,OAK,SEA,2022 REG,6,2,14,10,12,20,0,1,-8,8,1,1,0,0,0,0,0,0,0,0.5097020142727117,0.49029798572728833
87790,0.4608294930875576,0.576271186440678,117,-136,0.4437324057473569,0.5562675942526432,home,OAK,under,7.5,0.5121951219512195,-105,0.49029798572728833,OAK,SEA,2022 REG,6,2,14,10,12,20,0,1,-8,8,1,1,0,0,0,0,0,0,0,0.5097020142727117,0.49029798572728833
87791,0.46511627906976744,0.574468085106383,115,-135,0.44670494689481377,0.5532950531051862,away,MIL,over,9.5,0.5169082125603864,-107,0.49353874091423283,CIN,MIL,2022 REG,6,3,8,6,9,14,0,1,-3,3,1,1,1,0,0,0,0,0,0,0.49353874091423283,0.5064612590857671
87791,0.46511627906976744,0.574468085106383,115,-135,0.44670494689481377,0.5532950531051862,home,CIN,under,9.5,0.5283018867924528,-112,0.5064612590857671,CIN,MIL,2022 REG,6,3,8,6,9,14,0,1,-3,3,1,1,1,0,0,0,0,0,0,0.49353874091423283,0.5064612590857671
87792,0.4854368932038835,0.5594713656387665,106,-127,0.4636367675521117,0.5363632324478883,away,HOU,over,8.5,0.5454545454545454,-120,0.5206611570247933,SEA,HOU,2022 REG,13,11,5,1,12,18,1,0,10,-10,1,0,0,0,0,0,0,0,0,0.5206611570247933,0.4793388429752067
87792,0.4854368932038835,0.5594713656387665,106,-127,0.4636367675521117,0.5363632324478883,home,SEA,under,8.5,0.5,100,0.4793388429752067,SEA,HOU,2022 REG,13,11,5,1,12,18,1,0,10,-10,1,0,0,0,0,0,0,0,0,0.5206611570247933,0.4793388429752067
87793,0.4739336492890995,0.5652173913043479,111,-130,0.4553786537471813,0.5446213462528187,away,CLE,over,8,0.5305164319248826,-113,0.5078572507605655,TEX,CLE,2022 REG,6,4,11,10,14,17,0,1,-6,6,1,1,1,1,0,0,0,0,0,0.5078572507605655,0.49214274923943446
87793,0.4739336492890995,0.5652173913043479,111,-130,0.4553786537471813,0.5446213462528187,home,TEX,under,8,0.5121951219512195,-105,0.49214274923943446,TEX,CLE,2022 REG,6,4,11,10,14,17,0,1,-6,6,1,1,1,1,0,0,0,0,0,0.5078572507605655,0.49214274923943446
87794,0.47619047619047616,0.5652173913043479,110,-130,0.4564724440500838,0.5435275559499162,away,TOR,over,6.5,0.5555555555555556,-125,0.5314664257753688,TB,TOR,2022 REG,7,5,6,2,7,13,1,0,3,-3,1,1,0,0,0,0,0,0,0,0.5314664257753688,0.46853357422463116
87794,0.47619047619047616,0.5652173913043479,110,-130,0.4564724440500838,0.5435275559499162,home,TB,under,6.5,0.48780487804878053,105,0.46853357422463116,TB,TOR,2022 REG,7,5,6,2,7,13,1,0,3,-3,1,1,0,0,0,0,0,0,0,0.5314664257753688,0.46853357422463116
87795,0.5726495726495727,0.4629629629629629,-134,116,0.5522560693500865,0.44774393064991347,away,ATL,over,8,0.504950495049505,-102,0.48160416005266615,SD,ATL,2022 REG,3,2,4,1,3,7,1,0,1,-1,1,0,0,0,0,0,0,0,0,0.48160416005266615,0.5183958399473338
87795,0.5726495726495727,0.4629629629629629,-134,116,0.5522560693500865,0.44774393064991347,home,SD,under,8,0.5412844036697247,-118,0.5183958399473338,SD,ATL,2022 REG,3,2,4,1,3,7,1,0,1,-1,1,0,0,0,0,0,0,0,0,0.48160416005266615,0.5183958399473338
87796,0.574468085106383,0.46511627906976744,-135,115,0.5517281312179562,0.44827186878204384,away,KC,over,7.5,0.5348837209302326,-115,0.5097020142727117,DET,KC,2022 REG,6,2,10,1,3,16,1,0,1,-1,1,0,0,0,0,0,0,0,0,0.5097020142727117,0.49029798572728833
87796,0.574468085106383,0.46511627906976744,-135,115,0.5517281312179562,0.44827186878204384,home,DET,under,7.5,0.5121951219512195,-105,0.49029798572728833,DET,KC,2022 REG,6,2,10,1,3,16,1,0,1,-1,1,0,0,0,0,0,0,0,0,0.5097020142727117,0.49029798572728833
87797,0.5555555555555556,0.4854368932038835,-125,106,0.5327819729114227,0.4672180270885773,away,MIN,over,9.5,0.5348837209302326,-115,0.5097020142727117,BOS,MIN,2022 REG,11,8,4,1,9,15,1,0,7,-7,1,0,0,0,0,0,0,0,0,0.5097020142727117,0.49029798572728833
87797,0.5555555555555556,0.4854368932038835,-125,106,0.5327819729114227,0.4672180270885773,home,BOS,under,9.5,0.5121951219512195,-105,0.49029798572728833,BOS,MIN,2022 REG,11,8,4,1,9,15,1,0,7,-7,1,0,0,0,0,0,0,0,0,0.5097020142727117,0.49029798572728833
87798,0.7752808988764045,0.26666666666666666,-345,275,0.7427597525564954,0.2572402474435046,away,CIN,over,9,0.504950495049505,-102,0.48160416005266615,NYM,CIN,2022 REG,13,10,6,2,12,19,1,0,8,-8,1,1,0,0,0,0,0,0,0,0.48160416005266615,0.5183958399473338
87798,0.7752808988764045,0.26666666666666666,-345,275,0.7427597525564954,0.2572402474435046,home,NYM,under,9,0.5412844036697247,-118,0.5183958399473338,NYM,CIN,2022 REG,13,10,6,2,12,19,1,0,8,-8,1,1,0,0,0,0,0,0,0,0.48160416005266615,0.5183958399473338
87799,0.4854368932038835,0.5594713656387665,106,-127,0.4636367675521117,0.5363632324478883,away,HOU,over,8.5,0.5024875621890548,-101,0.48049269377245407,MIN,HOU,2022 REG,10,3,15,11,14,25,0,1,-8,8,1,1,1,0,0,0,0,0,0,0.48049269377245407,0.5195073062275459
87799,0.4854368932038835,0.5594713656387665,106,-127,0.4636367675521117,0.5363632324478883,home,MIN,under,8.5,0.5412844036697247,-118,0.5195073062275459,MIN,HOU,2022 REG,10,3,15,11,14,25,0,1,-8,8,1,1,1,0,0,0,0,0,0,0.48049269377245407,0.5195073062275459
87800,0.7076023391812866,0.3389830508474576,-242,195,0.6746384082252745,0.32536159177472546,away,DET,over,8,0.5370370370370371,-116,0.5118817074154765,CWS,DET,2022 REG,6,1,11,4,5,17,0,1,-3,3,1,0,0,0,0,0,0,0,0,0.5118817074154765,0.48811829258452355
87800,0.7076023391812866,0.3389830508474576,-242,195,0.6746384082252745,0.32536159177472546,home,CWS,under,8,0.5098039215686274,-104,0.48811829258452355,CWS,DET,2022 REG,6,1,11,4,5,17,0,1,-3,3,1,0,0,0,0,0,0,0,0,0.5118817074154765,0.48811829258452355
87801,0.8058252427184467,0.2331002331002331,-415,329,0.774458111718928,0.22554188828107202,away,KC,over,8.5,0.5433789954337899,-119,0.5198077604720502,TOR,KC,2022 REG,7,1,12,3,4,19,0,1,-2,2,1,0,0,0,0,0,0,0,0,0.5198077604720502,0.48019223952794976
87801,0.8058252427184467,0.2331002331002331,-415,329,0.774458111718928,0.22554188828107202,home,TOR,under,8.5,0.5,100,0.48019223952794976,TOR,KC,2022 REG,7,1,12,3,4,19,0,1,-2,2,1,0,0,0,0,0,0,0,0,0.5198077604720502,0.48019223952794976
87802,0.6031746031746031,0.43859649122807015,-152,128,0.5779793398841018,0.4220206601158982,away,BAL,over,7,0.5495495495495495,-122,0.5250401592387142,TB,BAL,2022 REG,10,7,10,5,12,20,1,0,2,-2,1,1,1,1,1,0,0,0,0,0.5250401592387142,0.47495984076128583
87802,0.6031746031746031,0.43859649122807015,-152,128,0.5779793398841018,0.4220206601158982,home,TB,under,7,0.49504950495049505,102,0.47495984076128583,TB,BAL,2022 REG,10,7,10,5,12,20,1,0,2,-2,1,1,1,1,1,0,0,0,0,0.5250401592387142,0.47495984076128583
87803,0.7311827956989247,0.3125,-272,220,0.69924268701584,0.30075731298416,away,CLE,over,8,0.5121951219512195,-105,0.48808156828023186,LAD,CLE,2022 REG,11,7,2,1,8,13,1,0,6,-6,1,0,0,0,0,0,0,0,0,0.48808156828023186,0.5119184317197681
87803,0.7311827956989247,0.3125,-272,220,0.69924268701584,0.30075731298416,home,LAD,under,8,0.5348837209302326,-115,0.5119184317197681,LAD,CLE,2022 REG,11,7,2,1,8,13,1,0,6,-6,1,0,0,0,0,0,0,0,0,0.48808156828023186,0.5119184317197681
87804,0.49751243781094534,0.5454545454545454,101,-120,0.476135829221149,0.523864170778851,away,TOR,over,7.5,0.5215311004784688,-109,0.4978845547971712,TB,TOR,2022 REG,12,10,8,5,15,20,1,0,5,-5,1,1,1,1,1,0,0,0,0,0.4978845547971712,0.5021154452028288
87804,0.49751243781094534,0.5454545454545454,101,-120,0.476135829221149,0.523864170778851,home,TB,under,7.5,0.5238095238095238,-110,0.5021154452028288,TB,TOR,2022 REG,12,10,8,5,15,20,1,0,5,-5,1,1,1,1,1,0,0,0,0,0.4978845547971712,0.5021154452028288
87805,0.6721311475409836,0.36764705882352944,-205,172,0.6453949760500813,0.35460502394991866,away,PIT,over,7,0.5215311004784688,-109,0.4978845547971712,TB,PIT,2022 REG,7,4,8,3,7,15,1,0,1,-1,1,1,1,0,0,0,0,0,0,0.4978845547971712,0.5021154452028288
87805,0.6721311475409836,0.36764705882352944,-205,172,0.6453949760500813,0.35460502394991866,home,TB,under,7,0.5238095238095238,-110,0.5021154452028288,TB,PIT,2022 REG,7,4,8,3,7,15,1,0,1,-1,1,1,1,0,0,0,0,0,0,0.4978845547971712,0.5021154452028288
87806,0.5412844036697247,0.5,-118,100,0.5189377998484975,0.4810622001515025,away,CLE,over,8.5,0.5495495495495495,-122,0.5250401592387142,KC,CLE,2022 REG,7,3,22,17,20,29,0,1,-14,14,1,1,1,0,0,0,0,0,0,0.5250401592387142,0.47495984076128583
87806,0.5412844036697247,0.5,-118,100,0.5189377998484975,0.4810622001515025,home,KC,under,8.5,0.49504950495049505,102,0.47495984076128583,KC,CLE,2022 REG,7,3,22,17,20,29,0,1,-14,14,1,1,1,0,0,0,0,0,0,0.5250401592387142,0.47495984076128583
87807,0.5238095238095238,0.5215311004784688,-110,-109,0.5000596729920038,0.4999403270079962,away,NYY,over,8.5,0.5121951219512195,-105,0.48808156828023186,TOR,NYY,2022 REG,8,2,11,5,7,19,0,1,-3,3,1,1,0,0,0,0,0,0,0,0.48808156828023186,0.5119184317197681
87807,0.5238095238095238,0.5215311004784688,-110,-109,0.5000596729920038,0.4999403270079962,home,TOR,under,8.5,0.5348837209302326,-115,0.5119184317197681,TOR,NYY,2022 REG,8,2,11,5,7,19,0,1,-3,3,1,1,0,0,0,0,0,0,0,0.48808156828023186,0.5119184317197681
87808,0.6515679442508712,0.3921568627450981,-187,155,0.6230782616437414,0.37692173835625864,away,SF,over,7.5,0.5145631067961165,-106,0.49023796582517226,SD,SF,2022 REG,8,7,5,4,11,13,1,0,3,-3,1,1,1,1,0,0,0,0,0,0.49023796582517226,0.5097620341748277
87808,0.6515679442508712,0.3921568627450981,-187,155,0.6230782616437414,0.37692173835625864,home,SD,under,7.5,0.5327102803738317,-114,0.5097620341748277,SD,SF,2022 REG,8,7,5,4,11,13,1,0,3,-3,1,1,1,1,0,0,0,0,0,0.49023796582517226,0.5097620341748277
87809,0.609375,0.43103448275862066,-156,132,0.5847504714439656,0.41524952855603436,away,SD,over,7,0.5391705069124424,-117,0.5114756747601454,ATL,SD,2022 REG,12,6,16,11,17,28,0,1,-5,5,1,1,1,1,1,1,0,0,0,0.5114756747601454,0.48852432523985456
87809,0.609375,0.43103448275862066,-156,132,0.5847504714439656,0.41524952855603436,home,ATL,under,7,0.5121951219512195,-105,0.48852432523985456,ATL,SD,2022 REG,12,6,16,11,17,28,0,1,-5,5,1,1,1,1,1,1,0,0,0,0.5114756747601454,0.48852432523985456
87810,0.4629629629629629,0.576271186440678,116,-136,0.4447990049057217,0.5552009950942782,away,LAD,over,8.5,0.5454545454545454,-120,0.5206611570247933,NYM,LAD,2022 REG,10,3,7,4,7,17,0,1,-1,1,1,1,1,0,0,0,0,0,0,0.5206611570247933,0.4793388429752067
87810,0.4629629629629629,0.576271186440678,116,-136,0.4447990049057217,0.5552009950942782,home,NYM,under,8.5,0.5,100,0.4793388429752067,NYM,LAD,2022 REG,10,3,7,4,7,17,0,1,-1,1,1,1,1,0,0,0,0,0,0,0.5206611570247933,0.4793388429752067
87811,0.3205128205128205,0.7222222222222222,212,-260,0.30681569143107607,0.693184308568924,away,NYM,over,7,0.5024875621890548,-101,0.47839724939301687,CHC,NYM,2022 REG,10,3,7,4,7,17,0,1,-1,1,1,1,1,0,0,0,0,0,0,0.47839724939301687,0.5216027506069831
87811,0.3205128205128205,0.7222222222222222,212,-260,0.30681569143107607,0.693184308568924,home,CHC,under,7,0.5454545454545454,-120,0.5216027506069831,CHC,NYM,2022 REG,10,3,7,4,7,17,0,1,-1,1,1,1,1,0,0,0,0,0,0,0.47839724939301687,0.5216027506069831
87812,0.5726495726495727,0.4672897196261683,-134,114,0.5497783539959433,0.4502216460040567,away,STL,over,8.5,0.5098039215686274,-104,0.4870219861770517,NYM,STL,2022 REG,5,3,11,4,7,16,0,1,-1,1,1,1,1,0,0,0,0,0,0,0.4870219861770517,0.5129780138229483
87812,0.5726495726495727,0.4672897196261683,-134,114,0.5497783539959433,0.4502216460040567,home,NYM,under,8.5,0.5348837209302326,-115,0.5129780138229483,NYM,STL,2022 REG,5,3,11,4,7,16,0,1,-1,1,1,1,1,0,0,0,0,0,0,0.4870219861770517,0.5129780138229483
87813,0.5283018867924528,0.5121951219512195,-112,-105,0.5069072406637203,0.4930927593362797,away,LAD,over,7.5,0.5348837209302326,-115,0.5097020142727117,SD,LAD,2022 REG,6,4,6,3,7,12,1,0,1,-1,1,1,1,0,0,0,0,0,0,0.5097020142727117,0.49029798572728833
87813,0.5283018867924528,0.5121951219512195,-112,-105,0.5069072406637203,0.4930927593362797,home,SD,under,7.5,0.5121951219512195,-105,0.49029798572728833,SD,LAD,2022 REG,6,4,6,3,7,12,1,0,1,-1,1,1,1,0,0,0,0,0,0,0.5097020142727117,0.49029798572728833
87814,0.5391705069124424,0.5,-117,100,0.5180509248444435,0.4819490751555565,away,TB,over,7.5,0.49504950495049505,102,0.47499799484898986,LAA,TB,2022 REG,6,2,5,4,6,11,0,1,-2,2,1,1,0,0,0,0,0,0,0,0.47499799484898986,0.5250020051510101
87814,0.5391705069124424,0.5,-117,100,0.5180509248444435,0.4819490751555565,home,LAA,under,7.5,0.5454545454545454,-120,0.5250020051510101,LAA,TB,2022 REG,6,2,5,4,6,11,0,1,-2,2,1,1,0,0,0,0,0,0,0,0.47499799484898986,0.5250020051510101
87815,0.576271186440678,0.4608294930875576,-136,117,0.5548911338311863,0.44510886616881373,away,PIT,over,9,0.5305164319248826,-113,0.5066009958897986,CIN,PIT,2022 REG,9,3,10,6,9,19,0,1,-3,3,1,1,1,0,0,0,0,0,0,0.5066009958897986,0.49339900411020143
87815,0.576271186440678,0.4608294930875576,-136,117,0.5548911338311863,0.44510886616881373,home,CIN,under,9,0.5145631067961165,-106,0.49339900411020143,CIN,PIT,2022 REG,9,3,10,6,9,19,0,1,-3,3,1,1,1,0,0,0,0,0,0,0.5066009958897986,0.49339900411020143
87816,0.3921568627450981,0.6491228070175439,155,-185,0.37596875695582666,0.6240312430441733,away,ATL,over,8,0.5121951219512195,-105,0.48808156828023186,MIA,ATL,2022 REG,5,2,10,6,8,15,0,1,-4,4,1,1,0,0,0,0,0,0,0,0.48808156828023186,0.5119184317197681
87816,0.3921568627450981,0.6491228070175439,155,-185,0.37596875695582666,0.6240312430441733,home,MIA,under,8,0.5348837209302326,-115,0.5119184317197681,MIA,ATL,2022 REG,5,2,10,6,8,15,0,1,-4,4,1,1,0,0,0,0,0,0,0,0.48808156828023186,0.5119184317197681
87817,0.5073891625615764,0.5348837209302326,-103,-115,0.4859403596076043,0.5140596403923957,away,BOS,over,9,0.504950495049505,-102,0.4826715732667395,CLE,BOS,2022 REG,12,3,12,6,9,24,0,1,-3,3,1,1,1,0,0,0,0,0,0,0.4826715732667395,0.5173284267332605
87817,0.5073891625615764,0.5348837209302326,-103,-115,0.4859403596076043,0.5140596403923957,home,CLE,under,9,0.5391705069124424,-117,0.5173284267332605,CLE,BOS,2022 REG,12,3,12,6,9,24,0,1,-3,3,1,1,1,0,0,0,0,0,0,0.4826715732667395,0.5173284267332605
87818,0.7142857142857143,0.3225806451612903,-250,210,0.6879526003949967,0.3120473996050033,away,WSH,over,9,0.5098039215686274,-104,0.48592421718142587,PHI,WSH,2022 REG,9,8,11,5,13,20,1,0,3,-3,1,1,1,1,1,0,0,0,0,0.48592421718142587,0.5140757828185741
87818,0.7142857142857143,0.3225806451612903,-250,210,0.6879526003949967,0.3120473996050033,home,PHI,under,9,0.5370370370370371,-116,0.5140757828185741,PHI,WSH,2022 REG,9,8,11,5,13,20,1,0,3,-3,1,1,1,1,1,0,0,0,0,0.48592421718142587,0.5140757828185741
87819,0.7267759562841529,0.3125,-266,220,0.6982311355967631,0.3017688644032369,away,CHC,over,8.5,0.504950495049505,-102,0.48160416005266615,LAD,CHC,2022 REG,14,11,8,9,20,22,1,0,2,-2,1,1,1,1,1,1,1,1,1,0.48160416005266615,0.5183958399473338
87819,0.7267759562841529,0.3125,-266,220,0.6982311355967631,0.3017688644032369,home,LAD,under,8.5,0.5412844036697247,-118,0.5183958399473338,LAD,CHC,2022 REG,14,11,8,9,20,22,1,0,2,-2,1,1,1,1,1,1,1,1,1,0.48160416005266615,0.5183958399473338
87820,0.4444444444444444,0.5951417004048584,125,-147,0.4268506022891988,0.5731493977108012,away,TOR,over,8,0.5073891625615764,-103,0.48484779035144243,CLE,TOR,2022 REG,11,6,9,5,11,20,1,0,1,-1,1,1,1,1,1,0,0,0,0,0.48484779035144243,0.5151522096485576
87820,0.4444444444444444,0.5951417004048584,125,-147,0.4268506022891988,0.5731493977108012,home,CLE,under,8,0.5370370370370371,-116,0.5151522096485576,CLE,TOR,2022 REG,11,6,9,5,11,20,1,0,1,-1,1,1,1,1,1,0,0,0,0,0.48484779035144243,0.5151522096485576
87821,0.42016806722689076,0.6197718631178707,138,-163,0.4033865838887557,0.5966134161112443,away,STL,over,12.5,0.5238095238095238,-110,0.5000596729920038,COL,STL,2022 REG,13,5,18,9,14,31,0,1,-4,4,1,1,1,1,1,0,0,0,0,0.5000596729920038,0.4999403270079962
87821,0.42016806722689076,0.6197718631178707,138,-163,0.4033865838887557,0.5966134161112443,home,COL,under,12.5,0.5215311004784688,-109,0.4999403270079962,COL,STL,2022 REG,13,5,18,9,14,31,0,1,-4,4,1,1,1,1,1,0,0,0,0,0.5000596729920038,0.4999403270079962
87822,0.36101083032490977,0.6825396825396826,177,-215,0.3452886235145876,0.6547113764854124,away,SEA,over,7,0.5,100,0.4772727272727273,OAK,SEA,2022 REG,7,4,1,1,5,8,1,0,3,-3,1,0,0,0,0,0,0,0,0,0.4772727272727273,0.5227272727272727
87822,0.36101083032490977,0.6825396825396826,177,-215,0.3452886235145876,0.6547113764854124,home,OAK,under,7,0.5454545454545454,-120,0.5227272727272727,OAK,SEA,2022 REG,7,4,1,1,5,8,1,0,3,-3,1,0,0,0,0,0,0,0,0,0.4772727272727273,0.5227272727272727
87823,0.5726495726495727,0.4716981132075471,-134,112,0.5472538892954956,0.45274611070450443,away,KC,over,11,0.5098039215686274,-104,0.48592421718142587,COL,KC,2022 REG,9,7,9,8,15,18,0,1,-1,1,1,1,1,1,1,1,1,0,0,0.48592421718142587,0.5140757828185741
87823,0.5726495726495727,0.4716981132075471,-134,112,0.5472538892954956,0.45274611070450443,home,COL,under,11,0.5370370370370371,-116,0.5140757828185741,COL,KC,2022 REG,9,7,9,8,15,18,0,1,-1,1,1,1,1,1,1,1,1,0,0,0.48592421718142587,0.5140757828185741
87824,0.5238095238095238,0.5169082125603864,-110,-107,0.5024811857109994,0.4975188142890006,away,CWS,over,7,0.5454545454545454,-120,0.5206611570247933,SD,CWS,2022 REG,9,5,6,2,7,15,1,0,3,-3,1,1,0,0,0,0,0,0,0,0.5206611570247933,0.4793388429752067
87824,0.5238095238095238,0.5169082125603864,-110,-107,0.5024811857109994,0.4975188142890006,home,SD,under,7,0.5,100,0.4793388429752067,SD,CWS,2022 REG,9,5,6,2,7,15,1,0,3,-3,1,1,0,0,0,0,0,0,0,0.5206611570247933,0.4793388429752067
87825,0.732620320855615,0.3058103975535168,-274,227,0.7044651956040051,0.2955348043959949,away,CLE,over,8,0.5192307692307692,-108,0.49688292476754015,LAD,CLE,2022 REG,8,1,6,2,3,14,0,1,-1,1,1,0,0,0,0,0,0,0,0,0.49688292476754015,0.5031170752324599
87825,0.732620320855615,0.3058103975535168,-274,227,0.7044651956040051,0.2955348043959949,home,LAD,under,8,0.5238095238095238,-110,0.5031170752324599,LAD,CLE,2022 REG,8,1,6,2,3,14,0,1,-1,1,1,0,0,0,0,0,0,0,0,0.49688292476754015,0.5031170752324599
87826,0.6428571428571428,0.4,-180,150,0.6153061224489796,0.38469387755102036,away,WSH,over,9.5,0.5348837209302326,-115,0.5097020142727117,PHI,WSH,2022 REG,8,5,8,3,8,16,1,0,2,-2,1,1,1,0,0,0,0,0,0,0.5097020142727117,0.49029798572728833
87826,0.6428571428571428,0.4,-180,150,0.6153061224489796,0.38469387755102036,home,PHI,under,9.5,0.5121951219512195,-105,0.49029798572728833,PHI,WSH,2022 REG,8,5,8,3,8,16,1,0,2,-2,1,1,1,0,0,0,0,0,0,0.5097020142727117,0.49029798572728833
87827,0.7762863534675616,0.2597402597402597,-347,285,0.7483193852726757,0.2516806147273243,away,OAK,over,8.5,0.5024875621890548,-101,0.47839724939301687,NYY,OAK,2022 REG,6,5,9,3,8,15,1,0,2,-2,1,1,1,0,0,0,0,0,0,0.47839724939301687,0.5216027506069831
87827,0.7762863534675616,0.2597402597402597,-347,285,0.7483193852726757,0.2516806147273243,home,NYY,under,8.5,0.5454545454545454,-120,0.5216027506069831,NYY,OAK,2022 REG,6,5,9,3,8,15,1,0,2,-2,1,1,1,0,0,0,0,0,0,0.47839724939301687,0.5216027506069831
87828,0.6168582375478928,0.42372881355932196,-161,136,0.59182178073463,0.40817821926537,away,PIT,over,7.5,0.5169082125603864,-107,0.49353874091423283,MIA,PIT,2022 REG,9,3,6,2,5,15,1,0,1,-1,1,1,0,0,0,0,0,0,0,0.49353874091423283,0.5064612590857671
87828,0.6168582375478928,0.42372881355932196,-161,136,0.59182178073463,0.40817821926537,home,MIA,under,7.5,0.5283018867924528,-112,0.5064612590857671,MIA,PIT,2022 REG,9,3,6,2,5,15,1,0,1,-1,1,1,0,0,0,0,0,0,0,0.49353874091423283,0.5064612590857671
87829,0.48780487804878053,0.5495495495495495,105,-122,0.4695832060495952,0.5304167939504048,away,SEA,over,7.5,0.5238095238095238,-110,0.4988662131519274,TEX,SEA,2022 REG,8,5,4,3,8,12,1,0,2,-2,1,1,1,0,0,0,0,0,0,0.4988662131519274,0.5011337868480725
87829,0.48780487804878053,0.5495495495495495,105,-122,0.4695832060495952,0.5304167939504048,home,TEX,under,7.5,0.5238095238095238,-110,0.5011337868480725,TEX,SEA,2022 REG,8,5,4,3,8,12,1,0,2,-2,1,1,1,0,0,0,0,0,0,0.4988662131519274,0.5011337868480725
87830,0.726027397260274,0.3125,-265,220,0.6980554513041847,0.30194454869581533,away,DET,over,7.5,0.5348837209302326,-115,0.5097020142727117,LAD,DET,2022 REG,8,6,10,3,9,18,1,0,3,-3,1,1,1,0,0,0,0,0,0,0.5097020142727117,0.49029798572728833
87830,0.726027397260274,0.3125,-265,220,0.6980554513041847,0.30194454869581533,home,LAD,under,7.5,0.5121951219512195,-105,0.49029798572728833,LAD,DET,2022 REG,8,6,10,3,9,18,1,0,3,-3,1,1,1,0,0,0,0,0,0,0.5097020142727117,0.49029798572728833
87831,0.4504504504504505,0.5884773662551441,122,-143,0.4329153978803628,0.5670846021196372,away,MIL,over,7.5,0.5,100,0.4772727272727273,STL,MIL,2022 REG,6,2,4,3,5,10,0,1,-1,1,1,1,0,0,0,0,0,0,0,0.4772727272727273,0.5227272727272727
87831,0.4504504504504505,0.5884773662551441,122,-143,0.4329153978803628,0.5670846021196372,home,STL,under,7.5,0.5454545454545454,-120,0.5227272727272727,STL,MIL,2022 REG,6,2,4,3,5,10,0,1,-1,1,1,1,0,0,0,0,0,0,0,0.4772727272727273,0.5227272727272727
87832,0.5780590717299579,0.46511627906976744,-137,115,0.5531011685250534,0.4468988314749466,away,MIA,over,9.5,0.5169082125603864,-107,0.49353874091423283,LAA,MIA,2022 REG,7,6,3,2,8,10,1,0,4,-4,1,1,0,0,0,0,0,0,0,0.49353874091423283,0.5064612590857671
87832,0.5780590717299579,0.46511627906976744,-137,115,0.5531011685250534,0.4468988314749466,home,LAA,under,9.5,0.5283018867924528,-112,0.5064612590857671,LAA,MIA,2022 REG,7,6,3,2,8,10,1,0,4,-4,1,1,0,0,0,0,0,0,0,0.49353874091423283,0.5064612590857671
87833,0.5391705069124424,0.49504950495049505,-117,102,0.5207200857697526,0.4792799142302474,away,TB,over,9,0.5348837209302326,-115,0.5097020142727117,BOS,TB,2022 REG,16,9,9,8,17,25,1,0,1,-1,1,1,1,1,1,1,1,1,0,0.5097020142727117,0.49029798572728833
87833,0.5391705069124424,0.49504950495049505,-117,102,0.5207200857697526,0.4792799142302474,home,BOS,under,9,0.5121951219512195,-105,0.49029798572728833,BOS,TB,2022 REG,16,9,9,8,17,25,1,0,1,-1,1,1,1,1,1,1,1,1,0,0.5097020142727117,0.49029798572728833
87834,0.5555555555555556,0.4807692307692307,-125,108,0.5353751187084521,0.4646248812915479,away,SD,over,7.5,0.5215311004784688,-109,0.49907282342437215,MIL,SD,2022 REG,6,0,6,4,4,12,0,1,-4,4,0,0,0,0,0,0,0,0,0,0.49907282342437215,0.5009271765756278
87834,0.5555555555555556,0.4807692307692307,-125,108,0.5353751187084521,0.4646248812915479,home,MIL,under,7.5,0.5215311004784688,-109,0.5009271765756278,MIL,SD,2022 REG,6,0,6,4,4,12,0,1,-4,4,0,0,0,0,0,0,0,0,0,0.49907282342437215,0.5009271765756278
87835,0.6515679442508712,0.39370078740157477,-187,154,0.6220722898292427,0.3779277101707573,away,BAL,over,7.5,0.5283018867924528,-112,0.5044173060022736,TB,BAL,2022 REG,8,2,7,1,3,15,1,0,1,-1,1,0,0,0,0,0,0,0,0,0.5044173060022736,0.49558269399772636
87835,0.6515679442508712,0.39370078740157477,-187,154,0.6220722898292427,0.3779277101707573,home,TB,under,7.5,0.5169082125603864,-107,0.49558269399772636,TB,BAL,2022 REG,8,2,7,1,3,15,1,0,1,-1,1,0,0,0,0,0,0,0,0,0.5044173060022736,0.49558269399772636
87836,0.4854368932038835,0.5555555555555556,106,-125,0.465537646233282,0.534462353766718,away,HOU,over,7.5,0.49504950495049505,102,0.4739797934813417,SEA,HOU,2022 REG,13,6,5,0,6,18,1,0,6,-6,0,0,0,0,0,0,0,0,0,0.4739797934813417,0.5260202065186583
87836,0.4854368932038835,0.5555555555555556,106,-125,0.465537646233282,0.534462353766718,home,SEA,under,7.5,0.5475113122171946,-121,0.5260202065186583,SEA,HOU,2022 REG,13,6,5,0,6,18,1,0,6,-6,0,0,0,0,0,0,0,0,0,0.4739797934813417,0.5260202065186583
87837,0.3448275862068966,0.7014925373134329,190,-235,0.3288551298205761,0.6711448701794239,away,LAD,over,8,0.5215311004784688,-109,0.4978845547971712,PIT,LAD,2022 REG,4,1,15,11,12,19,0,1,-10,10,1,0,0,0,0,0,0,0,0,0.4978845547971712,0.5021154452028288
87837,0.3448275862068966,0.7014925373134329,190,-235,0.3288551298205761,0.6711448701794239,home,PIT,under,8,0.5238095238095238,-110,0.5021154452028288,PIT,LAD,2022 REG,4,1,15,11,12,19,0,1,-10,10,1,0,0,0,0,0,0,0,0,0.4978845547971712,0.5021154452028288
87838,0.574468085106383,0.46511627906976744,-135,115,0.5517281312179562,0.44827186878204384,away,TEX,over,8,0.5145631067961165,-106,0.4913668392989033,NYM,TEX,2022 REG,7,4,7,1,5,14,1,0,3,-3,1,0,0,0,0,0,0,0,0,0.4913668392989033,0.5086331607010968
87838,0.574468085106383,0.46511627906976744,-135,115,0.5517281312179562,0.44827186878204384,home,NYM,under,8,0.5305164319248826,-113,0.5086331607010968,NYM,TEX,2022 REG,7,4,7,1,5,14,1,0,3,-3,1,0,0,0,0,0,0,0,0,0.4913668392989033,0.5086331607010968
87839,0.45454545454545453,0.5884773662551441,120,-143,0.43498962690881876,0.5650103730911813,away,TB,over,8,0.5412844036697247,-118,0.5189377998484975,BAL,TB,2022 REG,11,8,10,6,14,21,1,0,2,-2,1,1,1,1,1,1,0,0,0,0.5189377998484975,0.4810622001515025
87839,0.45454545454545453,0.5884773662551441,120,-143,0.43498962690881876,0.5650103730911813,home,BAL,under,8,0.5,100,0.4810622001515025,BAL,TB,2022 REG,11,8,10,6,14,21,1,0,2,-2,1,1,1,1,1,1,0,0,0,0.5189377998484975,0.4810622001515025
87840,0.6124031007751938,0.425531914893617,-158,135,0.5891715795516586,0.41082842044834145,away,BOS,over,8.5,0.5121951219512195,-105,0.48808156828023186,CLE,BOS,2022 REG,7,2,10,4,6,17,0,1,-2,2,1,1,0,0,0,0,0,0,0,0.48808156828023186,0.5119184317197681
87840,0.6124031007751938,0.425531914893617,-158,135,0.5891715795516586,0.41082842044834145,home,CLE,under,8.5,0.5348837209302326,-115,0.5119184317197681,CLE,BOS,2022 REG,7,2,10,4,6,17,0,1,-2,2,1,1,0,0,0,0,0,0,0,0.48808156828023186,0.5119184317197681
87841,0.6197718631178707,0.4132231404958678,-163,142,0.5993224882546031,0.4006775117453969,away,OAK,over,8,0.5121951219512195,-105,0.48919479393107135,BAL,OAK,2022 REG,9,5,6,2,7,15,1,0,3,-3,1,1,0,0,0,0,0,0,0,0.48919479393107135,0.5108052060689287
87841,0.6197718631178707,0.4132231404958678,-163,142,0.5993224882546031,0.4006775117453969,home,BAL,under,8,0.5327102803738317,-114,0.5108052060689287,BAL,OAK,2022 REG,9,5,6,2,7,15,1,0,3,-3,1,1,0,0,0,0,0,0,0,0.48919479393107135,0.5108052060689287
87842,0.613899613899614,0.425531914893617,-159,135,0.589692613597978,0.410307386402022,away,COL,over,9,0.5305164319248826,-113,0.5066009958897986,MIN,COL,2022 REG,3,0,5,1,1,8,0,1,-1,1,0,0,0,0,0,0,0,0,0,0.5066009958897986,0.49339900411020143
87842,0.613899613899614,0.425531914893617,-159,135,0.589692613597978,0.410307386402022,home,MIN,under,9,0.5145631067961165,-106,0.49339900411020143,MIN,COL,2022 REG,3,0,5,1,1,8,0,1,-1,1,0,0,0,0,0,0,0,0,0,0.5066009958897986,0.49339900411020143
87843,0.601593625498008,0.4424778761061947,-151,126,0.5750804910667944,0.4249195089332056,away,LAA,over,7,0.4926108374384236,103,0.46986095270450623,MIA,LAA,2022 REG,8,2,3,1,3,11,1,0,1,-1,1,0,0,0,0,0,0,0,0,0.46986095270450623,0.5301390472954938
87843,0.601593625498008,0.4424778761061947,-151,126,0.5750804910667944,0.4249195089332056,home,MIA,under,7,0.5535714285714286,-124,0.5301390472954938,MIA,LAA,2022 REG,8,2,3,1,3,11,1,0,1,-1,1,0,0,0,0,0,0,0,0,0.46986095270450623,0.5301390472954938
87844,0.33783783783783783,0.7014925373134329,196,-235,0.32455054893538154,0.6754494510646185,away,HOU,over,8,0.5305164319248826,-113,0.5078572507605655,DET,HOU,2022 REG,6,3,12,6,9,18,0,1,-3,3,1,1,1,0,0,0,0,0,0,0.5078572507605655,0.49214274923943446
87844,0.33783783783783783,0.7014925373134329,196,-235,0.32455054893538154,0.6754494510646185,home,DET,under,8,0.5121951219512195,-105,0.49214274923943446,DET,HOU,2022 REG,6,3,12,6,9,18,0,1,-3,3,1,1,1,0,0,0,0,0,0,0.5078572507605655,0.49214274923943446
87845,0.6721311475409836,0.36764705882352944,-205,172,0.6453949760500813,0.35460502394991866,away,PIT,over,7.5,0.5238095238095238,-110,0.4988662131519274,SD,PIT,2022 REG,8,4,5,2,6,13,1,0,2,-2,1,1,0,0,0,0,0,0,0,0.4988662131519274,0.5011337868480725
87845,0.6721311475409836,0.36764705882352944,-205,172,0.6453949760500813,0.35460502394991866,home,SD,under,7.5,0.5238095238095238,-110,0.5011337868480725,SD,PIT,2022 REG,8,4,5,2,6,13,1,0,2,-2,1,1,0,0,0,0,0,0,0,0.4988662131519274,0.5011337868480725
87846,0.6309963099630996,0.4081632653061224,-171,145,0.6062867624684983,0.39371323753150167,away,BAL,over,7.5,0.5121951219512195,-105,0.48808156828023186,SEA,BAL,2022 REG,6,2,1,0,2,7,1,0,2,-2,0,0,0,0,0,0,0,0,0,0.48808156828023186,0.5119184317197681
87846,0.6309963099630996,0.4081632653061224,-171,145,0.6062867624684983,0.39371323753150167,home,SEA,under,7.5,0.5348837209302326,-115,0.5119184317197681,SEA,BAL,2022 REG,6,2,1,0,2,7,1,0,2,-2,0,0,0,0,0,0,0,0,0,0.48808156828023186,0.5119184317197681
87847,0.4166666666666667,0.6226415094339623,140,-165,0.4002882599580712,0.5997117400419287,away,MIL,over,8.5,0.5370370370370371,-116,0.5118817074154765,CIN,MIL,2022 REG,7,3,11,5,8,18,0,1,-2,2,1,1,1,0,0,0,0,0,0,0.5118817074154765,0.48811829258452355
87847,0.4166666666666667,0.6226415094339623,140,-165,0.4002882599580712,0.5997117400419287,home,CIN,under,8.5,0.5098039215686274,-104,0.48811829258452355,CIN,MIL,2022 REG,7,3,11,5,8,18,0,1,-2,2,1,1,1,0,0,0,0,0,0,0.5118817074154765,0.48811829258452355
87848,0.6363636363636364,0.40485829959514175,-175,147,0.6101314952989593,0.38986850470104073,away,OAK,over,7,0.5495495495495495,-122,0.5250401592387142,SEA,OAK,2022 REG,5,2,9,4,6,14,0,1,-2,2,1,1,0,0,0,0,0,0,0,0.5250401592387142,0.47495984076128583
87848,0.6363636363636364,0.40485829959514175,-175,147,0.6101314952989593,0.38986850470104073,home,SEA,under,7,0.49504950495049505,102,0.47495984076128583,SEA,OAK,2022 REG,5,2,9,4,6,14,0,1,-2,2,1,1,0,0,0,0,0,0,0,0.5250401592387142,0.47495984076128583
87849,0.5689655172413793,0.4672897196261683,-132,114,0.5483375376443265,0.45166246235567353,away,KC,over,7.5,0.5283018867924528,-112,0.5044173060022736,SEA,KC,2022 REG,8,4,8,1,5,16,1,0,3,-3,1,0,0,0,0,0,0,0,0,0.5044173060022736,0.49558269399772636
87849,0.5689655172413793,0.4672897196261683,-132,114,0.5483375376443265,0.45166246235567353,home,SEA,under,7.5,0.5169082125603864,-107,0.49558269399772636,SEA,KC,2022 REG,8,4,8,1,5,16,1,0,3,-3,1,0,0,0,0,0,0,0,0,0.5044173060022736,0.49558269399772636
87850,0.46511627906976744,0.576271186440678,115,-136,0.44586629511142073,0.5541337048885793,away,MIN,over,8,0.5121951219512195,-105,0.48808156828023186,LAA,MIN,2022 REG,4,0,9,4,4,13,0,1,-4,4,0,0,0,0,0,0,0,0,0,0.48808156828023186,0.5119184317197681
87850,0.46511627906976744,0.576271186440678,115,-136,0.44586629511142073,0.5541337048885793,home,LAA,under,8,0.5348837209302326,-115,0.5119184317197681,LAA,MIN,2022 REG,4,0,9,4,4,13,0,1,-4,4,0,0,0,0,0,0,0,0,0,0.48808156828023186,0.5119184317197681
87851,0.45454545454545453,0.5780590717299579,120,-137,0.439725215329358,0.560274784670642,away,CLE,over,7.5,0.5098039215686274,-104,0.48375889301574193,KC,CLE,2022 REG,7,5,12,6,11,19,0,1,-1,1,1,1,1,1,1,0,0,0,0,0.48375889301574193,0.5162411069842581
87851,0.45454545454545453,0.5780590717299579,120,-137,0.439725215329358,0.560274784670642,home,KC,under,7.5,0.5412844036697247,-118,0.5162411069842581,KC,CLE,2022 REG,7,5,12,6,11,19,0,1,-1,1,1,1,1,1,1,0,0,0,0,0.48375889301574193,0.5162411069842581
87852,0.6515679442508712,0.390625,-187,156,0.6240763743034393,0.3759236256965607,away,TEX,over,7.5,0.5348837209302326,-115,0.5097020142727117,HOU,TEX,2022 REG,7,7,7,5,12,14,1,0,2,-2,1,1,1,1,1,0,0,0,0,0.5097020142727117,0.49029798572728833
87852,0.6515679442508712,0.390625,-187,156,0.6240763743034393,0.3759236256965607,home,HOU,under,7.5,0.5121951219512195,-105,0.49029798572728833,HOU,TEX,2022 REG,7,7,7,5,12,14,1,0,2,-2,1,1,1,1,1,0,0,0,0,0.5097020142727117,0.49029798572728833
87853,0.607843137254902,0.43103448275862066,-155,132,0.5842116427368785,0.41578835726312147,away,MIA,over,6.5,0.5098039215686274,-104,0.48592421718142587,TB,MIA,2022 REG,10,4,5,0,4,15,1,0,4,-4,0,0,0,0,0,0,0,0,0,0.48592421718142587,0.5140757828185741
87853,0.607843137254902,0.43103448275862066,-155,132,0.5842116427368785,0.41578835726312147,home,TB,under,6.5,0.5370370370370371,-116,0.5140757828185741,TB,MIA,2022 REG,10,4,5,0,4,15,1,0,4,-4,0,0,0,0,0,0,0,0,0,0.48592421718142587,0.5140757828185741
87854,0.5967741935483871,0.4444444444444444,-148,125,0.5721759741010521,0.42782402589894786,away,STL,over,6.5,0.5391705069124424,-117,0.5140669063204599,SF,STL,2022 REG,9,13,14,7,20,23,1,0,6,-6,1,1,1,1,1,1,1,0,0,0.5140669063204599,0.4859330936795401
87854,0.5967741935483871,0.4444444444444444,-148,125,0.5721759741010521,0.42782402589894786,home,SF,under,6.5,0.5073891625615764,-103,0.4859330936795401,SF,STL,2022 REG,9,13,14,7,20,23,1,0,6,-6,1,1,1,1,1,1,1,0,0,0.5140669063204599,0.4859330936795401
87855,0.6031746031746031,0.4347826086956522,-152,130,0.5802797769671475,0.4197202230328525,away,MIL,over,7,0.5391705069124424,-117,0.5153817639191344,LAD,MIL,2022 REG,11,10,4,1,11,15,1,0,9,-9,1,0,0,0,0,0,0,0,0,0.5153817639191344,0.4846182360808656
87855,0.6031746031746031,0.4347826086956522,-152,130,0.5802797769671475,0.4197202230328525,home,LAD,under,7,0.504950495049505,-102,0.4846182360808656,LAD,MIL,2022 REG,11,10,4,1,11,15,1,0,9,-9,1,0,0,0,0,0,0,0,0,0.5153817639191344,0.4846182360808656
87856,0.5024875621890548,0.5370370370370371,-101,-116,0.48262694267743644,0.5173730573225636,away,TB,over,8.5,0.5098039215686274,-104,0.4870219861770517,BAL,TB,2022 REG,8,5,8,1,6,16,1,0,4,-4,1,0,0,0,0,0,0,0,0,0.4870219861770517,0.5129780138229483
87856,0.5024875621890548,0.5370370370370371,-101,-116,0.48262694267743644,0.5173730573225636,home,BAL,under,8.5,0.5348837209302326,-115,0.5129780138229483,BAL,TB,2022 REG,8,5,8,1,6,16,1,0,4,-4,1,0,0,0,0,0,0,0,0,0.4870219861770517,0.5129780138229483
87857,0.4672897196261683,0.5708154506437768,114,-133,0.44948356529441824,0.5505164347055818,away,LAD,over,8,0.5238095238095238,-110,0.5012646084074657,SF,LAD,2022 REG,5,2,5,0,2,10,1,0,2,-2,0,0,0,0,0,0,0,0,0,0.5012646084074657,0.4987353915925343
87857,0.4672897196261683,0.5708154506437768,114,-133,0.44948356529441824,0.5505164347055818,home,SF,under,8,0.5192307692307692,-108,0.4987353915925343,SF,LAD,2022 REG,5,2,5,0,2,10,1,0,2,-2,0,0,0,0,0,0,0,0,0,0.5012646084074657,0.4987353915925343
87858,0.5238095238095238,0.5145631067961165,-110,-106,0.5037095744446646,0.4962904255553354,away,SD,over,7.5,0.5238095238095238,-110,0.5000596729920038,SF,SD,2022 REG,10,7,11,8,15,21,0,1,-1,1,1,1,1,1,1,1,1,0,0,0.5000596729920038,0.4999403270079962
87858,0.5238095238095238,0.5145631067961165,-110,-106,0.5037095744446646,0.4962904255553354,home,SF,under,7.5,0.5215311004784688,-109,0.4999403270079962,SF,SD,2022 REG,10,7,11,8,15,21,0,1,-1,1,1,1,1,1,1,1,1,0,0,0.5000596729920038,0.4999403270079962
87859,0.5652173913043479,0.4716981132075471,-130,112,0.5443521061454507,0.4556478938545493,away,OAK,over,8,0.5391705069124424,-117,0.5140669063204599,TEX,OAK,2022 REG,9,1,11,5,6,20,0,1,-4,4,1,0,0,0,0,0,0,0,0,0.5140669063204599,0.4859330936795401
87859,0.5652173913043479,0.4716981132075471,-130,112,0.5443521061454507,0.4556478938545493,home,TEX,under,8,0.5073891625615764,-103,0.4859330936795401,TEX,OAK,2022 REG,9,1,11,5,6,20,0,1,-4,4,1,0,0,0,0,0,0,0,0,0.5140669063204599,0.4859330936795401
87860,0.5670995670995671,0.4716981132075471,-131,112,0.5450974193929352,0.4549025806070648,away,HOU,over,7.5,0.5145631067961165,-106,0.4913668392989033,LAA,HOU,2022 REG,4,2,7,1,3,11,1,0,1,-1,1,0,0,0,0,0,0,0,0,0.4913668392989033,0.5086331607010968
87860,0.5670995670995671,0.4716981132075471,-131,112,0.5450974193929352,0.4549025806070648,home,LAA,under,7.5,0.5305164319248826,-113,0.5086331607010968,LAA,HOU,2022 REG,4,2,7,1,3,11,1,0,1,-1,1,0,0,0,0,0,0,0,0,0.4913668392989033,0.5086331607010968
87861,0.6031746031746031,0.425531914893617,-152,135,0.5858595605302799,0.4141404394697201,away,MIN,over,7.5,0.5260663507109005,-111,0.5022370601254724,CLE,MIN,2022 REG,8,4,8,3,7,16,1,0,1,-1,1,1,1,0,0,0,0,0,0,0.5022370601254724,0.4977629398745276
87861,0.6031746031746031,0.425531914893617,-152,135,0.5858595605302799,0.4141404394697201,home,CLE,under,7.5,0.5192307692307692,-108,0.4977629398745276,CLE,MIN,2022 REG,8,4,8,3,7,16,1,0,1,-1,1,1,1,0,0,0,0,0,0,0.5022370601254724,0.4977629398745276
87862,0.3436426116838488,0.696969696969697,191,-230,0.3296864918716338,0.6703135081283662,away,LAA,over,6.5,0.5454545454545454,-120,0.5206611570247933,OAK,LAA,2022 REG,4,3,6,2,5,10,1,0,1,-1,1,1,0,0,0,0,0,0,0,0.5206611570247933,0.4793388429752067
87862,0.3436426116838488,0.696969696969697,191,-230,0.3296864918716338,0.6703135081283662,home,OAK,under,6.5,0.5,100,0.4793388429752067,OAK,LAA,2022 REG,4,3,6,2,5,10,1,0,1,-1,1,1,0,0,0,0,0,0,0,0.5206611570247933,0.4793388429752067
87863,0.5192307692307692,0.5215311004784688,-108,-109,0.49806595226635714,0.5019340477336429,away,STL,over,11.5,0.5348837209302326,-115,0.5109810284308424,COL,STL,2022 REG,9,8,12,6,14,21,1,0,2,-2,1,1,1,1,1,1,0,0,0,0.5109810284308424,0.48901897156915763
87863,0.5192307692307692,0.5215311004784688,-108,-109,0.49806595226635714,0.5019340477336429,home,COL,under,11.5,0.5098039215686274,-104,0.48901897156915763,COL,STL,2022 REG,9,8,12,6,14,21,1,0,2,-2,1,1,1,1,1,1,0,0,0,0.5109810284308424,0.48901897156915763
87864,0.6453900709219857,0.3921568627450981,-182,155,0.6211576527396834,0.3788423472603166,away,DET,over,9.5,0.49504950495049505,102,0.47297076509898783,BOS,DET,2022 REG,9,5,10,2,7,19,1,0,3,-3,1,1,0,0,0,0,0,0,0,0.47297076509898783,0.5270292349010122
87864,0.6453900709219857,0.3921568627450981,-182,155,0.6211576527396834,0.3788423472603166,home,BOS,under,9.5,0.5495495495495495,-122,0.5270292349010122,BOS,DET,2022 REG,9,5,10,2,7,19,1,0,3,-3,1,1,0,0,0,0,0,0,0,0.47297076509898783,0.5270292349010122
87865,0.75,0.29411764705882354,-300,240,0.7169117647058822,0.28308823529411775,away,ARI,over,7.5,0.5098039215686274,-104,0.4870219861770517,LAD,ARI,2022 REG,9,5,7,2,7,16,1,0,3,-3,1,1,0,0,0,0,0,0,0,0.4870219861770517,0.5129780138229483
87865,0.75,0.29411764705882354,-300,240,0.7169117647058822,0.28308823529411775,home,LAD,under,7.5,0.5348837209302326,-115,0.5129780138229483,LAD,ARI,2022 REG,9,5,7,2,7,16,1,0,3,-3,1,1,0,0,0,0,0,0,0,0.4870219861770517,0.5129780138229483
87866,0.6363636363636364,0.40322580645161293,-175,148,0.6111703545721141,0.3888296454278859,away,PIT,over,9.5,0.5215311004784688,-109,0.49907282342437215,CHC,PIT,2022 REG,23,21,3,0,21,26,1,0,21,-21,0,0,0,0,0,0,0,0,0,0.49907282342437215,0.5009271765756278
87866,0.6363636363636364,0.40322580645161293,-175,148,0.6111703545721141,0.3888296454278859,home,CHC,under,9.5,0.5215311004784688,-109,0.5009271765756278,CHC,PIT,2022 REG,23,21,3,0,21,26,1,0,21,-21,0,0,0,0,0,0,0,0,0,0.49907282342437215,0.5009271765756278
87867,0.5833333333333333,0.45454545454545453,-140,120,0.5612373737373737,0.4387626262626263,away,NYM,over,8,0.5305164319248826,-113,0.5066009958897986,HOU,NYM,2022 REG,7,5,8,3,8,15,1,0,2,-2,1,1,1,0,0,0,0,0,0,0.5066009958897986,0.49339900411020143
87867,0.5833333333333333,0.45454545454545453,-140,120,0.5612373737373737,0.4387626262626263,home,HOU,under,8,0.5145631067961165,-106,0.49339900411020143,HOU,NYM,2022 REG,7,5,8,3,8,15,1,0,2,-2,1,1,1,0,0,0,0,0,0,0.5066009958897986,0.49339900411020143
87868,0.7076023391812866,0.3389830508474576,-242,195,0.6746384082252745,0.32536159177472546,away,PHI,over,6,0.5192307692307692,-108,0.49571111079951763,NYM,PHI,2022 REG,4,1,3,0,1,7,1,0,1,-1,0,0,0,0,0,0,0,0,0,0.49571111079951763,0.5042888892004824
87868,0.7076023391812866,0.3389830508474576,-242,195,0.6746384082252745,0.32536159177472546,home,NYM,under,6,0.5260663507109005,-111,0.5042888892004824,NYM,PHI,2022 REG,4,1,3,0,1,7,1,0,1,-1,0,0,0,0,0,0,0,0,0,0.49571111079951763,0.5042888892004824
87869,0.7222222222222222,0.31545741324921134,-260,217,0.6950091521595202,0.3049908478404798,away,BAL,over,8.5,0.5121951219512195,-105,0.48808156828023186,TOR,BAL,2022 REG,8,2,13,10,12,21,0,1,-8,8,1,1,0,0,0,0,0,0,0,0.48808156828023186,0.5119184317197681
87869,0.7222222222222222,0.31545741324921134,-260,217,0.6950091521595202,0.3049908478404798,home,TOR,under,8.5,0.5348837209302326,-115,0.5119184317197681,TOR,BAL,2022 REG,8,2,13,10,12,21,0,1,-8,8,1,1,0,0,0,0,0,0,0,0.48808156828023186,0.5119184317197681
87870,0.5967741935483871,0.44052863436123346,-148,127,0.5745128285055491,0.4254871714944509,away,BAL,over,8,0.5348837209302326,-115,0.5109810284308424,CLE,BAL,2022 REG,9,5,1,1,6,10,1,0,4,-4,1,0,0,0,0,0,0,0,0,0.5109810284308424,0.48901897156915763
87870,0.5967741935483871,0.44052863436123346,-148,127,0.5745128285055491,0.4254871714944509,home,CLE,under,8,0.5098039215686274,-104,0.48901897156915763,CLE,BAL,2022 REG,9,5,1,1,6,10,1,0,4,-4,1,0,0,0,0,0,0,0,0,0.5109810284308424,0.48901897156915763
87871,0.574468085106383,0.4672897196261683,-135,114,0.550479558983428,0.44952044101657196,away,CWS,over,9,0.5260663507109005,-111,0.5010269332605688,MIN,CWS,2022 REG,7,2,8,6,8,15,0,1,-4,4,1,1,0,0,0,0,0,0,0,0.5010269332605688,0.4989730667394312
87871,0.574468085106383,0.4672897196261683,-135,114,0.550479558983428,0.44952044101657196,home,MIN,under,9,0.5215311004784688,-109,0.4989730667394312,MIN,CWS,2022 REG,7,2,8,6,8,15,0,1,-4,4,1,1,0,0,0,0,0,0,0,0.5010269332605688,0.4989730667394312
87872,0.5260663507109005,0.5192307692307692,-111,-108,0.5022370601254724,0.4977629398745276,away,SF,over,8.5,0.5215311004784688,-109,0.4978845547971712,PHI,SF,2022 REG,5,4,6,5,9,11,0,1,-1,1,1,1,1,1,0,0,0,0,0,0.4978845547971712,0.5021154452028288
87872,0.5260663507109005,0.5192307692307692,-111,-108,0.5022370601254724,0.4977629398745276,home,PHI,under,8.5,0.5238095238095238,-110,0.5021154452028288,PHI,SF,2022 REG,5,4,6,5,9,11,0,1,-1,1,1,1,1,1,0,0,0,0,0,0.4978845547971712,0.5021154452028288
87873,0.576271186440678,0.46511627906976744,-136,115,0.552420782587201,0.44757921741279905,away,CWS,over,8,0.5348837209302326,-115,0.5097020142727117,TOR,CWS,2022 REG,10,7,9,3,10,19,1,0,4,-4,1,1,1,0,0,0,0,0,0,0.5097020142727117,0.49029798572728833
87873,0.576271186440678,0.46511627906976744,-136,115,0.552420782587201,0.44757921741279905,home,TOR,under,8,0.5121951219512195,-105,0.49029798572728833,TOR,CWS,2022 REG,10,7,9,3,10,19,1,0,4,-4,1,1,1,0,0,0,0,0,0,0.5097020142727117,0.49029798572728833
87874,0.5614035087719298,0.47846889952153115,-128,109,0.5390189988527938,0.4609810011472062,away,PHI,over,8.5,0.5305164319248826,-113,0.5066009958897986,NYM,PHI,2022 REG,10,8,7,2,10,17,1,0,6,-6,1,1,0,0,0,0,0,0,0,0.5066009958897986,0.49339900411020143
87874,0.5614035087719298,0.47846889952153115,-128,109,0.5390189988527938,0.4609810011472062,home,NYM,under,8.5,0.5145631067961165,-106,0.49339900411020143,NYM,PHI,2022 REG,10,8,7,2,10,17,1,0,6,-6,1,1,0,0,0,0,0,0,0,0.5066009958897986,0.49339900411020143
87875,0.45454545454545453,0.5833333333333333,120,-140,0.43732782369146006,0.5626721763085399,away,TOR,over,6.5,0.5238095238095238,-110,0.4988662131519274,CLE,TOR,2022 REG,6,3,10,8,11,16,0,1,-5,5,1,1,1,0,0,0,0,0,0,0.4988662131519274,0.5011337868480725
87875,0.45454545454545453,0.5833333333333333,120,-140,0.43732782369146006,0.5626721763085399,home,CLE,under,6.5,0.5238095238095238,-110,0.5011337868480725,CLE,TOR,2022 REG,6,3,10,8,11,16,0,1,-5,5,1,1,1,0,0,0,0,0,0,0.4988662131519274,0.5011337868480725
87876,0.5305164319248826,0.5145631067961165,-113,-106,0.5066009958897986,0.49339900411020143,away,ATL,over,7,0.5454545454545454,-120,0.5206611570247933,MIA,ATL,2022 REG,8,4,6,3,7,14,1,0,1,-1,1,1,1,0,0,0,0,0,0,0.5206611570247933,0.4793388429752067
87876,0.5305164319248826,0.5145631067961165,-113,-106,0.5066009958897986,0.49339900411020143,home,MIA,under,7,0.5,100,0.4793388429752067,MIA,ATL,2022 REG,8,4,6,3,7,14,1,0,1,-1,1,1,1,0,0,0,0,0,0,0.5206611570247933,0.4793388429752067
87877,0.425531914893617,0.6124031007751938,135,-158,0.4093893550345486,0.5906106449654513,away,CLE,over,9,0.5348837209302326,-115,0.5097020142727117,DET,CLE,2022 REG,13,11,11,4,15,24,1,0,7,-7,1,1,1,1,0,0,0,0,0,0.5097020142727117,0.49029798572728833
87877,0.425531914893617,0.6124031007751938,135,-158,0.4093893550345486,0.5906106449654513,home,DET,under,9,0.5121951219512195,-105,0.49029798572728833,DET,CLE,2022 REG,13,11,11,4,15,24,1,0,7,-7,1,1,1,1,0,0,0,0,0,0.5097020142727117,0.49029798572728833
87878,0.35714285714285715,0.6845425867507886,180,-217,0.3422551986094122,0.6577448013905878,away,ATL,over,8.5,0.5454545454545454,-120,0.5206611570247933,WSH,ATL,2022 REG,6,2,10,8,10,16,0,1,-6,6,1,1,0,0,0,0,0,0,0,0.5206611570247933,0.4793388429752067
87878,0.35714285714285715,0.6845425867507886,180,-217,0.3422551986094122,0.6577448013905878,home,WSH,under,8.5,0.5,100,0.4793388429752067,WSH,ATL,2022 REG,6,2,10,8,10,16,0,1,-6,6,1,1,0,0,0,0,0,0,0,0.5206611570247933,0.4793388429752067
87879,0.6774193548387096,0.36363636363636365,-210,175,0.6496074165168858,0.3503925834831142,away,WSH,over,8,0.5121951219512195,-105,0.48919479393107135,PHI,WSH,2022 REG,4,2,8,3,5,12,0,1,-1,1,1,1,0,0,0,0,0,0,0,0.48919479393107135,0.5108052060689287
87879,0.6774193548387096,0.36363636363636365,-210,175,0.6496074165168858,0.3503925834831142,home,PHI,under,8,0.5327102803738317,-114,0.5108052060689287,PHI,WSH,2022 REG,4,2,8,3,5,12,0,1,-1,1,1,1,0,0,0,0,0,0,0,0.48919479393107135,0.5108052060689287
87880,0.6309963099630996,0.4081632653061224,-171,145,0.6062867624684983,0.39371323753150167,away,TEX,over,8,0.5169082125603864,-107,0.49353874091423283,LAA,TEX,2022 REG,12,5,6,3,8,18,1,0,2,-2,1,1,1,0,0,0,0,0,0,0.49353874091423283,0.5064612590857671
87880,0.6309963099630996,0.4081632653061224,-171,145,0.6062867624684983,0.39371323753150167,home,LAA,under,8,0.5283018867924528,-112,0.5064612590857671,LAA,TEX,2022 REG,12,5,6,3,8,18,1,0,2,-2,1,1,1,0,0,0,0,0,0,0.49353874091423283,0.5064612590857671
87881,0.5815899581589958,0.4566210045662101,-139,119,0.5593668459464284,0.4406331540535716,away,PHI,over,7.5,0.5348837209302326,-115,0.5097020142727117,ATL,PHI,2022 REG,6,1,5,3,4,11,0,1,-2,2,1,0,0,0,0,0,0,0,0,0.5097020142727117,0.49029798572728833
87881,0.5815899581589958,0.4566210045662101,-139,119,0.5593668459464284,0.4406331540535716,home,ATL,under,7.5,0.5121951219512195,-105,0.49029798572728833,ATL,PHI,2022 REG,6,1,5,3,4,11,0,1,-2,2,1,0,0,0,0,0,0,0,0,0.5097020142727117,0.49029798572728833
87882,0.7395833333333334,0.3058103975535168,-284,227,0.7060108865316004,0.2939891134683996,away,ARI,over,8,0.5238095238095238,-110,0.5012646084074657,LAD,ARI,2022 REG,9,5,9,3,8,18,1,0,2,-2,1,1,1,0,0,0,0,0,0,0.5012646084074657,0.4987353915925343
87882,0.7395833333333334,0.3058103975535168,-284,227,0.7060108865316004,0.2939891134683996,home,LAD,under,8,0.5192307692307692,-108,0.4987353915925343,LAD,ARI,2022 REG,9,5,9,3,8,18,1,0,2,-2,1,1,1,0,0,0,0,0,0,0.5012646084074657,0.4987353915925343
87883,0.5145631067961165,0.5260663507109005,-106,-111,0.49365668691386505,0.506343313086135,away,PHI,over,7.5,0.5348837209302326,-115,0.5109810284308424,MIA,PHI,2022 REG,8,3,11,10,13,19,0,1,-7,7,1,1,1,0,0,0,0,0,0,0.5109810284308424,0.48901897156915763
87883,0.5145631067961165,0.5260663507109005,-106,-111,0.49365668691386505,0.506343313086135,home,MIA,under,7.5,0.5098039215686274,-104,0.48901897156915763,MIA,PHI,2022 REG,8,3,11,10,13,19,0,1,-7,7,1,1,1,0,0,0,0,0,0,0.5109810284308424,0.48901897156915763
87884,0.4504504504504505,0.5918367346938775,122,-145,0.43140216885390636,0.5685978311460936,away,MIL,over,9,0.5260663507109005,-111,0.5022370601254724,CHC,MIL,2022 REG,12,8,7,7,15,19,1,0,1,-1,1,1,1,1,1,1,1,0,0,0.5022370601254724,0.4977629398745276
87884,0.4504504504504505,0.5918367346938775,122,-145,0.43140216885390636,0.5685978311460936,home,CHC,under,9,0.5192307692307692,-108,0.4977629398745276,CHC,MIL,2022 REG,12,8,7,7,15,19,1,0,1,-1,1,1,1,1,1,1,1,0,0,0.5022370601254724,0.4977629398745276
87885,0.4065040650406504,0.626865671641791,146,-168,0.39293913142990194,0.607060868570098,away,SD,over,7.5,0.48780487804878053,105,0.4676213138438005,PIT,SD,2022 REG,10,3,7,7,10,17,0,1,-4,4,1,1,1,0,0,0,0,0,0,0.4676213138438005,0.5323786861561994
87885,0.4065040650406504,0.626865671641791,146,-168,0.39293913142990194,0.607060868570098,home,PIT,under,7.5,0.5535714285714286,-124,0.5323786861561994,PIT,SD,2022 REG,10,3,7,7,10,17,0,1,-4,4,1,1,1,0,0,0,0,0,0,0.4676213138438005,0.5323786861561994
87886,0.6183206106870228,0.42194092827004215,-162,137,0.5934260713318911,0.40657392866810893,away,HOU,over,8.5,0.5121951219512195,-105,0.48808156828023186,ATL,HOU,2022 REG,7,4,10,5,9,17,0,1,-1,1,1,1,1,1,0,0,0,0,0,0.48808156828023186,0.5119184317197681
87886,0.6183206106870228,0.42194092827004215,-162,137,0.5934260713318911,0.40657392866810893,home,ATL,under,8.5,0.5348837209302326,-115,0.5119184317197681,ATL,HOU,2022 REG,7,4,10,5,9,17,0,1,-1,1,1,1,1,1,0,0,0,0,0,0.48808156828023186,0.5119184317197681
87887,0.5495495495495495,0.49504950495049505,-122,102,0.5250401592387142,0.47495984076128583,away,BOS,over,8.5,0.5121951219512195,-105,0.48919479393107135,TEX,BOS,2022 REG,4,1,10,7,8,14,0,1,-6,6,1,0,0,0,0,0,0,0,0,0.48919479393107135,0.5108052060689287
87887,0.5495495495495495,0.49504950495049505,-122,102,0.5250401592387142,0.47495984076128583,home,TEX,under,8.5,0.5327102803738317,-114,0.5108052060689287,TEX,BOS,2022 REG,4,1,10,7,8,14,0,1,-6,6,1,0,0,0,0,0,0,0,0,0.48919479393107135,0.5108052060689287
87888,0.5884773662551441,0.45248868778280543,-143,121,0.5643697706690257,0.4356302293309743,away,PHI,over,8.5,0.5121951219512195,-105,0.48919479393107135,ATL,PHI,2022 REG,13,8,11,4,12,24,1,0,4,-4,1,1,1,1,0,0,0,0,0,0.48919479393107135,0.5108052060689287
87888,0.5884773662551441,0.45248868778280543,-143,121,0.5643697706690257,0.4356302293309743,home,ATL,under,8.5,0.5327102803738317,-114,0.5108052060689287,ATL,PHI,2022 REG,13,8,11,4,12,24,1,0,4,-4,1,1,1,1,0,0,0,0,0,0.48919479393107135,0.5108052060689287
87889,0.37735849056603776,0.6610169491525424,165,-195,0.36287719255902645,0.6371228074409736,away,CWS,over,7.5,0.5192307692307692,-108,0.49571111079951763,OAK,CWS,2022 REG,3,2,20,10,12,23,0,1,-8,8,1,1,0,0,0,0,0,0,0,0.49571111079951763,0.5042888892004824
87889,0.37735849056603776,0.6610169491525424,165,-195,0.36287719255902645,0.6371228074409736,home,OAK,under,7.5,0.5260663507109005,-111,0.5042888892004824,OAK,CWS,2022 REG,3,2,20,10,12,23,0,1,-8,8,1,1,0,0,0,0,0,0,0,0.49571111079951763,0.5042888892004824
87890,0.4098360655737705,0.6226415094339623,144,-165,0.39652558401322424,0.6034744159867758,away,MIL,over,7.5,0.5327102803738317,-114,0.508788710910954,CIN,MIL,2022 REG,4,1,4,5,6,8,0,1,-4,4,1,0,0,0,0,0,0,0,0,0.508788710910954,0.491211289089046
87890,0.4098360655737705,0.6226415094339623,144,-165,0.39652558401322424,0.6034744159867758,home,CIN,under,7.5,0.5121951219512195,-105,0.491211289089046,CIN,MIL,2022 REG,4,1,4,5,6,8,0,1,-4,4,1,0,0,0,0,0,0,0,0,0.508788710910954,0.491211289089046
87891,0.6632996632996633,0.37735849056603776,-197,165,0.6363311235301577,0.36366887646984225,away,MIN,over,8,0.5412844036697247,-118,0.5136310900085983,TOR,MIN,2022 REG,10,6,16,8,14,26,0,1,-2,2,1,1,1,1,1,1,0,0,0,0.5136310900085983,0.4863689099914017
87891,0.6632996632996633,0.37735849056603776,-197,165,0.6363311235301577,0.36366887646984225,home,TOR,under,8,0.5098039215686274,-104,0.4863689099914017,TOR,MIN,2022 REG,10,6,16,8,14,26,0,1,-2,2,1,1,1,1,1,1,0,0,0,0.5136310900085983,0.4863689099914017
87892,0.44052863436123346,0.6031746031746031,127,-152,0.4212761068124068,0.5787238931875932,away,NYM,over,8,0.5073891625615764,-103,0.4837652908580103,PHI,NYM,2022 REG,11,3,6,2,5,17,1,0,1,-1,1,1,0,0,0,0,0,0,0,0.4837652908580103,0.5162347091419897
87892,0.44052863436123346,0.6031746031746031,127,-152,0.4212761068124068,0.5787238931875932,home,PHI,under,8,0.5391705069124424,-117,0.5162347091419897,PHI,NYM,2022 REG,11,3,6,2,5,17,1,0,1,-1,1,1,0,0,0,0,0,0,0,0.4837652908580103,0.5162347091419897
87893,0.6389891696750902,0.4,-177,150,0.614075512518083,0.385924487481917,away,TB,over,8.5,0.5327102803738317,-114,0.508788710910954,NYY,TB,2022 REG,4,2,3,1,3,7,1,0,1,-1,1,0,0,0,0,0,0,0,0,0.508788710910954,0.491211289089046
87893,0.6389891696750902,0.4,-177,150,0.614075512518083,0.385924487481917,home,NYY,under,8.5,0.5121951219512195,-105,0.491211289089046,NYY,TB,2022 REG,4,2,3,1,3,7,1,0,1,-1,1,0,0,0,0,0,0,0,0,0.508788710910954,0.491211289089046
87894,0.5815899581589958,0.4608294930875576,-139,117,0.5569192312833853,0.4430807687166147,away,MIA,over,7,0.5370370370370371,-116,0.5118817074154765,PHI,MIA,2022 REG,9,5,12,6,11,21,0,1,-1,1,1,1,1,1,1,0,0,0,0,0.5118817074154765,0.48811829258452355
87894,0.5815899581589958,0.4608294930875576,-139,117,0.5569192312833853,0.4430807687166147,home,PHI,under,7,0.5098039215686274,-104,0.48811829258452355,PHI,MIA,2022 REG,9,5,12,6,11,21,0,1,-1,1,1,1,1,1,1,0,0,0,0,0.5118817074154765,0.48811829258452355
87895,0.3076923076923077,0.7333333333333333,225,-275,0.29506903353057207,0.7049309664694279,away,MIL,over,8,0.5121951219512195,-105,0.48808156828023186,PIT,MIL,2022 REG,12,5,7,4,9,19,1,0,1,-1,1,1,1,1,0,0,0,0,0,0.48808156828023186,0.5119184317197681
87895,0.3076923076923077,0.7333333333333333,225,-275,0.29506903353057207,0.7049309664694279,home,PIT,under,8,0.5348837209302326,-115,0.5119184317197681,PIT,MIL,2022 REG,12,5,7,4,9,19,1,0,1,-1,1,1,1,1,0,0,0,0,0,0.48808156828023186,0.5119184317197681
87896,0.5708154506437768,0.4739336492890995,-133,111,0.5452719729996885,0.45472802700031145,away,BAL,over,7.5,0.5,100,0.4772727272727273,NYY,BAL,2022 REG,4,1,7,3,4,11,0,1,-2,2,1,0,0,0,0,0,0,0,0,0.4772727272727273,0.5227272727272727
87896,0.5708154506437768,0.4739336492890995,-133,111,0.5452719729996885,0.45472802700031145,home,NYY,under,7.5,0.5454545454545454,-120,0.5227272727272727,NYY,BAL,2022 REG,4,1,7,3,4,11,0,1,-2,2,1,0,0,0,0,0,0,0,0,0.4772727272727273,0.5227272727272727
87897,0.6721311475409836,0.36363636363636365,-205,175,0.6480906892086682,0.3519093107913318,away,SD,over,8,0.5238095238095238,-110,0.4988662131519274,LAD,SD,2022 REG,8,2,8,4,6,16,0,1,-2,2,1,1,0,0,0,0,0,0,0,0.4988662131519274,0.5011337868480725
87897,0.6721311475409836,0.36363636363636365,-205,175,0.6480906892086682,0.3519093107913318,home,LAD,under,8,0.5238095238095238,-110,0.5011337868480725,LAD,SD,2022 REG,8,2,8,4,6,16,0,1,-2,2,1,1,0,0,0,0,0,0,0,0.4988662131519274,0.5011337868480725
87898,0.42016806722689076,0.6183206106870228,138,-162,0.4039963538176834,0.5960036461823166,away,NYY,over,9,0.5121951219512195,-105,0.48808156828023186,TOR,NYY,2022 REG,7,10,11,9,19,18,1,0,1,-1,1,1,1,1,1,1,1,1,1,0.48808156828023186,0.5119184317197681
87898,0.42016806722689076,0.6183206106870228,138,-162,0.4039963538176834,0.5960036461823166,home,TOR,under,9,0.5348837209302326,-115,0.5119184317197681,TOR,NYY,2022 REG,7,10,11,9,19,18,1,0,1,-1,1,1,1,1,1,1,1,1,1,0.48808156828023186,0.5119184317197681
87899,0.35714285714285715,0.6774193548387096,180,-210,0.3447992100065833,0.6552007899934167,away,LAD,over,9,0.5145631067961165,-106,0.49023796582517226,CIN,LAD,2022 REG,13,5,16,10,15,29,0,1,-5,5,1,1,1,1,1,0,0,0,0,0.49023796582517226,0.5097620341748277
87899,0.35714285714285715,0.6774193548387096,180,-210,0.3447992100065833,0.6552007899934167,home,CIN,under,9,0.5327102803738317,-114,0.5097620341748277,CIN,LAD,2022 REG,13,5,16,10,15,29,0,1,-5,5,1,1,1,1,1,0,0,0,0,0.49023796582517226,0.5097620341748277
87900,0.601593625498008,0.4347826086956522,-151,130,0.5797099148874794,0.42029008511252064,away,CIN,over,11,0.5238095238095238,-110,0.4988662131519274,COL,CIN,2022 REG,5,4,5,3,7,10,1,0,1,-1,1,1,1,0,0,0,0,0,0,0.4988662131519274,0.5011337868480725
87900,0.601593625498008,0.4347826086956522,-151,130,0.5797099148874794,0.42029008511252064,home,COL,under,11,0.5238095238095238,-110,0.5011337868480725,COL,CIN,2022 REG,5,4,5,3,7,10,1,0,1,-1,1,1,1,0,0,0,0,0,0,0.4988662131519274,0.5011337868480725
87901,0.47619047619047616,0.5633187772925764,110,-129,0.45737654596045113,0.5426234540395489,away,MIA,over,8.5,0.5145631067961165,-106,0.4913668392989033,WSH,MIA,2022 REG,5,4,8,7,11,13,0,1,-3,3,1,1,1,1,0,0,0,0,0,0.4913668392989033,0.5086331607010968
87901,0.47619047619047616,0.5633187772925764,110,-129,0.45737654596045113,0.5426234540395489,home,WSH,under,8.5,0.5305164319248826,-113,0.5086331607010968,WSH,MIA,2022 REG,5,4,8,7,11,13,0,1,-3,3,1,1,1,1,0,0,0,0,0,0.4913668392989033,0.5086331607010968
87902,0.6389891696750902,0.4,-177,150,0.614075512518083,0.385924487481917,away,CLE,over,7,0.5412844036697247,-118,0.5189377998484975,CWS,CLE,2022 REG,10,7,11,10,17,21,0,1,-3,3,1,1,1,1,1,1,1,0,0,0.5189377998484975,0.4810622001515025
87902,0.6389891696750902,0.4,-177,150,0.614075512518083,0.385924487481917,home,CWS,under,7,0.5,100,0.4810622001515025,CWS,CLE,2022 REG,10,7,11,10,17,21,0,1,-3,3,1,1,1,1,1,1,1,0,0,0.5189377998484975,0.4810622001515025
87903,0.626865671641791,0.4098360655737705,-168,144,0.6038586124917376,0.39614138750826244,away,PIT,over,7.5,0.5283018867924528,-112,0.5056562298022652,CHC,PIT,2022 REG,7,2,8,4,6,15,0,1,-2,2,1,1,0,0,0,0,0,0,0,0.5056562298022652,0.4943437701977348
87903,0.626865671641791,0.4098360655737705,-168,144,0.6038586124917376,0.39614138750826244,home,CHC,under,7.5,0.5145631067961165,-106,0.4943437701977348,CHC,PIT,2022 REG,7,2,8,4,6,15,0,1,-2,2,1,1,0,0,0,0,0,0,0,0.5056562298022652,0.4943437701977348
87904,0.801980198019802,0.24096385542168672,-405,315,0.767539917537024,0.232460082462976,away,WSH,over,7.5,0.5,100,0.4772727272727273,NYM,WSH,2022 REG,4,1,14,7,8,18,0,1,-6,6,1,0,0,0,0,0,0,0,0,0.4772727272727273,0.5227272727272727
87904,0.801980198019802,0.24096385542168672,-405,315,0.767539917537024,0.232460082462976,home,NYM,under,7.5,0.5454545454545454,-120,0.5227272727272727,NYM,WSH,2022 REG,4,1,14,7,8,18,0,1,-6,6,1,0,0,0,0,0,0,0,0,0.4772727272727273,0.5227272727272727
87905,0.48780487804878053,0.5535714285714286,105,-124,0.4676213138438005,0.5323786861561994,away,TB,over,8.5,0.5169082125603864,-107,0.49353874091423283,TEX,TB,2022 REG,6,1,9,3,4,15,0,1,-2,2,1,0,0,0,0,0,0,0,0,0.49353874091423283,0.5064612590857671
87905,0.48780487804878053,0.5535714285714286,105,-124,0.4676213138438005,0.5323786861561994,home,TEX,under,8.5,0.5283018867924528,-112,0.5064612590857671,TEX,TB,2022 REG,6,1,9,3,4,15,0,1,-2,2,1,0,0,0,0,0,0,0,0,0.49353874091423283,0.5064612590857671
87906,0.6240601503759399,0.41152263374485604,-166,143,0.6018543527667214,0.3981456472332786,away,CHC,over,8.5,0.5412844036697247,-118,0.5149381613977361,MIL,CHC,2022 REG,16,9,11,7,16,27,1,0,2,-2,1,1,1,1,1,1,1,0,0,0.5149381613977361,0.48506183860226393
87906,0.6240601503759399,0.41152263374485604,-166,143,0.6018543527667214,0.3981456472332786,home,MIL,under,8.5,0.5073891625615764,-103,0.48506183860226393,MIL,CHC,2022 REG,16,9,11,7,16,27,1,0,2,-2,1,1,1,1,1,1,1,0,0,0.5149381613977361,0.48506183860226393
87907,0.4807692307692307,0.5555555555555556,108,-125,0.4633053911900066,0.5366946088099934,away,BOS,over,8.5,0.5238095238095238,-110,0.4988662131519274,CIN,BOS,2022 REG,9,3,7,5,8,16,0,1,-2,2,1,1,1,0,0,0,0,0,0,0.4988662131519274,0.5011337868480725
87907,0.4807692307692307,0.5555555555555556,108,-125,0.4633053911900066,0.5366946088099934,home,CIN,under,8.5,0.5238095238095238,-110,0.5011337868480725,CIN,BOS,2022 REG,9,3,7,5,8,16,0,1,-2,2,1,1,1,0,0,0,0,0,0,0.4988662131519274,0.5011337868480725
87908,0.574468085106383,0.46511627906976744,-135,115,0.5517281312179562,0.44827186878204384,away,ATL,over,7,0.5260663507109005,-111,0.5022370601254724,NYM,ATL,2022 REG,8,2,9,9,11,17,0,1,-7,7,1,1,0,0,0,0,0,0,0,0.5022370601254724,0.4977629398745276
87908,0.574468085106383,0.46511627906976744,-135,115,0.5517281312179562,0.44827186878204384,home,NYM,under,7,0.5192307692307692,-108,0.4977629398745276,NYM,ATL,2022 REG,8,2,9,9,11,17,0,1,-7,7,1,1,0,0,0,0,0,0,0,0.5022370601254724,0.4977629398745276
87909,0.6742671009771988,0.36363636363636365,-207,175,0.6487100417752203,0.3512899582247797,away,BAL,over,8.5,0.5433789954337899,-119,0.5184560714286826,CWS,BAL,2022 REG,8,4,7,3,7,15,1,0,1,-1,1,1,1,0,0,0,0,0,0,0.5184560714286826,0.48154392857131745
87909,0.6742671009771988,0.36363636363636365,-207,175,0.6487100417752203,0.3512899582247797,home,CWS,under,8.5,0.5024875621890548,-101,0.48154392857131745,CWS,BAL,2022 REG,8,4,7,3,7,15,1,0,1,-1,1,1,1,0,0,0,0,0,0,0.5184560714286826,0.48154392857131745
87910,0.373134328358209,0.6688741721854304,168,-202,0.35745951472252263,0.6425404852774774,away,HOU,over,6.5,0.5454545454545454,-120,0.5206611570247933,BAL,HOU,2022 REG,7,2,2,0,2,9,1,0,2,-2,0,0,0,0,0,0,0,0,0,0.5206611570247933,0.4793388429752067
87910,0.373134328358209,0.6688741721854304,168,-202,0.35745951472252263,0.6425404852774774,home,BAL,under,6.5,0.5,100,0.4793388429752067,BAL,HOU,2022 REG,7,2,2,0,2,9,1,0,2,-2,0,0,0,0,0,0,0,0,0,0.5206611570247933,0.4793388429752067
87911,0.5192307692307692,0.5238095238095238,-108,-110,0.49688292476754015,0.5031170752324599,away,STL,over,8,0.5098039215686274,-104,0.48592421718142587,CHC,STL,2022 REG,11,5,15,14,19,26,0,1,-9,9,1,1,1,1,1,0,0,0,0,0.48592421718142587,0.5140757828185741
87911,0.5192307692307692,0.5238095238095238,-108,-110,0.49688292476754015,0.5031170752324599,home,CHC,under,8,0.5370370370370371,-116,0.5140757828185741,CHC,STL,2022 REG,11,5,15,14,19,26,0,1,-9,9,1,1,1,1,1,0,0,0,0,0.48592421718142587,0.5140757828185741
87912,0.5169082125603864,0.5238095238095238,-107,-110,0.49586088023391106,0.5041391197660889,away,TEX,over,9.5,0.5,100,0.4772727272727273,BAL,TEX,2022 REG,14,10,12,9,19,26,1,0,1,-1,1,1,1,1,1,1,1,1,1,0.4772727272727273,0.5227272727272727
87912,0.5169082125603864,0.5238095238095238,-107,-110,0.49586088023391106,0.5041391197660889,home,BAL,under,9.5,0.5454545454545454,-120,0.5227272727272727,BAL,TEX,2022 REG,14,10,12,9,19,26,1,0,1,-1,1,1,1,1,1,1,1,1,1,0.4772727272727273,0.5227272727272727
87913,0.45454545454545453,0.5833333333333333,120,-140,0.43732782369146006,0.5626721763085399,away,STL,over,8.5,0.5412844036697247,-118,0.5189377998484975,PIT,STL,2022 REG,7,4,10,5,9,17,0,1,-1,1,1,1,1,1,0,0,0,0,0,0.5189377998484975,0.4810622001515025
87913,0.45454545454545453,0.5833333333333333,120,-140,0.43732782369146006,0.5626721763085399,home,PIT,under,8.5,0.5,100,0.4810622001515025,PIT,STL,2022 REG,7,4,10,5,9,17,0,1,-1,1,1,1,1,1,0,0,0,0,0,0.5189377998484975,0.4810622001515025
87914,0.5412844036697247,0.5,-118,100,0.5189377998484975,0.4810622001515025,away,KC,over,8.5,0.5327102803738317,-114,0.508788710910954,ARI,KC,2022 REG,10,9,12,5,14,22,1,0,4,-4,1,1,1,1,1,0,0,0,0,0.508788710910954,0.491211289089046
87914,0.5412844036697247,0.5,-118,100,0.5189377998484975,0.4810622001515025,home,ARI,under,8.5,0.5121951219512195,-105,0.491211289089046,ARI,KC,2022 REG,10,9,12,5,14,22,1,0,4,-4,1,1,1,1,1,0,0,0,0,0.508788710910954,0.491211289089046
87915,0.4629629629629629,0.5815899581589958,116,-139,0.4423366105916858,0.5576633894083143,away,CLE,over,11.5,0.5238095238095238,-110,0.49651307063705985,COL,CLE,2022 REG,11,2,8,4,6,19,0,1,-2,2,1,1,0,0,0,0,0,0,0,0.49651307063705985,0.5034869293629401
87915,0.4629629629629629,0.5815899581589958,116,-139,0.4423366105916858,0.5576633894083143,home,COL,under,11.5,0.5283018867924528,-112,0.5034869293629401,COL,CLE,2022 REG,11,2,8,4,6,19,0,1,-2,2,1,1,0,0,0,0,0,0,0,0.49651307063705985,0.5034869293629401
87916,0.3968253968253968,0.6376811594202898,152,-176,0.38313231895012434,0.6168676810498757,away,MIL,over,7.5,0.5192307692307692,-108,0.49688292476754015,CIN,MIL,2022 REG,14,10,7,5,15,21,1,0,5,-5,1,1,1,1,1,0,0,0,0,0.49688292476754015,0.5031170752324599
87916,0.3968253968253968,0.6376811594202898,152,-176,0.38313231895012434,0.6168676810498757,home,CIN,under,7.5,0.5238095238095238,-110,0.5031170752324599,CIN,MIL,2022 REG,14,10,7,5,15,21,1,0,5,-5,1,1,1,1,1,0,0,0,0,0.49688292476754015,0.5031170752324599
87917,0.726027397260274,0.31545741324921134,-265,217,0.6959082882602367,0.30409171173976335,away,KC,over,8,0.5454545454545454,-120,0.5206611570247933,HOU,KC,2022 REG,13,9,9,7,16,22,1,0,2,-2,1,1,1,1,1,1,1,0,0,0.5206611570247933,0.4793388429752067
87917,0.726027397260274,0.31545741324921134,-265,217,0.6959082882602367,0.30409171173976335,home,HOU,under,8,0.5,100,0.4793388429752067,HOU,KC,2022 REG,13,9,9,7,16,22,1,0,2,-2,1,1,1,1,1,1,1,0,0,0.5206611570247933,0.4793388429752067
87918,0.48780487804878053,0.5535714285714286,105,-124,0.4676213138438005,0.5323786861561994,away,TEX,over,8.5,0.5454545454545454,-120,0.5206611570247933,DET,TEX,2022 REG,19,14,10,7,21,29,1,0,7,-7,1,1,1,1,1,1,1,0,0,0.5206611570247933,0.4793388429752067
87918,0.48780487804878053,0.5535714285714286,105,-124,0.4676213138438005,0.5323786861561994,home,DET,under,8.5,0.5,100,0.4793388429752067,DET,TEX,2022 REG,19,14,10,7,21,29,1,0,7,-7,1,1,1,1,1,1,1,0,0,0.5206611570247933,0.4793388429752067
87919,0.6688741721854304,0.36900369003690037,-202,171,0.6435386484473151,0.3564613515526849,away,DET,over,8,0.5348837209302326,-115,0.5097020142727117,HOU,DET,2022 REG,7,3,2,2,5,9,1,0,1,-1,1,1,0,0,0,0,0,0,0,0.5097020142727117,0.49029798572728833
87919,0.6688741721854304,0.36900369003690037,-202,171,0.6435386484473151,0.3564613515526849,home,HOU,under,8,0.5121951219512195,-105,0.49029798572728833,HOU,DET,2022 REG,7,3,2,2,5,9,1,0,1,-1,1,1,0,0,0,0,0,0,0,0.5097020142727117,0.49029798572728833
87920,0.2857142857142857,0.7560975609756098,250,-310,0.27376804380288694,0.7262319561971131,away,ATL,over,7.5,0.5,100,0.47935779816513757,OAK,ATL,2022 REG,3,3,10,7,10,13,0,1,-4,4,1,1,1,0,0,0,0,0,0,0.47935779816513757,0.5206422018348624
87920,0.2857142857142857,0.7560975609756098,250,-310,0.27376804380288694,0.7262319561971131,home,OAK,under,7.5,0.5412844036697247,-118,0.5206422018348624,OAK,ATL,2022 REG,3,3,10,7,10,13,0,1,-4,4,1,1,1,0,0,0,0,0,0,0.47935779816513757,0.5206422018348624
87921,0.4081632653061224,0.626865671641791,145,-168,0.39386574002125985,0.6061342599787402,away,NYM,over,9.5,0.5370370370370371,-116,0.514488177212783,CIN,NYM,2022 REG,5,3,16,8,11,21,0,1,-5,5,1,1,1,0,0,0,0,0,0,0.514488177212783,0.48551182278721705
87921,0.4081632653061224,0.626865671641791,145,-168,0.39386574002125985,0.6061342599787402,home,CIN,under,9.5,0.504950495049505,-102,0.48551182278721705,CIN,NYM,2022 REG,5,3,16,8,11,21,0,1,-5,5,1,1,1,0,0,0,0,0,0,0.514488177212783,0.48551182278721705
87922,0.42372881355932196,0.6183206106870228,136,-162,0.40591126091256574,0.5940887390874343,away,BOS,over,8.5,0.5121951219512195,-105,0.48808156828023186,PIT,BOS,2022 REG,6,3,12,8,11,18,0,1,-5,5,1,1,1,0,0,0,0,0,0,0.48808156828023186,0.5119184317197681
87922,0.42372881355932196,0.6183206106870228,136,-162,0.40591126091256574,0.5940887390874343,home,PIT,under,8.5,0.5348837209302326,-115,0.5119184317197681,PIT,BOS,2022 REG,6,3,12,8,11,18,0,1,-5,5,1,1,1,0,0,0,0,0,0,0.48808156828023186,0.5119184317197681
87923,0.6415770609318996,0.39840637450199207,-179,151,0.615924605940263,0.384075394059737,away,BOS,over,7.5,0.5348837209302326,-115,0.5097020142727117,HOU,BOS,2022 REG,6,2,6,3,5,12,0,1,-1,1,1,1,0,0,0,0,0,0,0,0.5097020142727117,0.49029798572728833
87923,0.6415770609318996,0.39840637450199207,-179,151,0.615924605940263,0.384075394059737,home,HOU,under,7.5,0.5121951219512195,-105,0.49029798572728833,HOU,BOS,2022 REG,6,2,6,3,5,12,0,1,-1,1,1,1,0,0,0,0,0,0,0,0.5097020142727117,0.49029798572728833
87924,0.43103448275862066,0.6000000000000001,132,-150,0.4176575505350773,0.5823424494649228,away,STL,over,9,0.5454545454545454,-120,0.5206611570247933,ARI,STL,2022 REG,8,7,18,16,23,26,0,1,-9,9,1,1,1,1,1,1,1,0,0,0.5206611570247933,0.4793388429752067
87924,0.43103448275862066,0.6000000000000001,132,-150,0.4176575505350773,0.5823424494649228,home,ARI,under,9,0.5,100,0.4793388429752067,ARI,STL,2022 REG,8,7,18,16,23,26,0,1,-9,9,1,1,1,1,1,1,1,0,0,0.5206611570247933,0.4793388429752067
87925,0.390625,0.6515679442508712,156,-187,0.3741433811520034,0.6258566188479966,away,ATL,over,9,0.5283018867924528,-112,0.5044173060022736,CIN,ATL,2022 REG,1,1,7,4,5,8,0,1,-3,3,1,0,0,0,0,0,0,0,0,0.5044173060022736,0.49558269399772636
87925,0.390625,0.6515679442508712,156,-187,0.3741433811520034,0.6258566188479966,home,CIN,under,9,0.5169082125603864,-107,0.49558269399772636,CIN,ATL,2022 REG,1,1,7,4,5,8,0,1,-3,3,1,0,0,0,0,0,0,0,0,0.5044173060022736,0.49558269399772636
87926,0.613899613899614,0.425531914893617,-159,135,0.589692613597978,0.410307386402022,away,MIN,over,9,0.5260663507109005,-111,0.5022370601254724,TOR,MIN,2022 REG,16,12,6,3,15,22,1,0,9,-9,1,1,1,0,0,0,0,0,0,0.5022370601254724,0.4977629398745276
87926,0.613899613899614,0.425531914893617,-159,135,0.589692613597978,0.410307386402022,home,TOR,under,9,0.5192307692307692,-108,0.4977629398745276,TOR,MIN,2022 REG,16,12,6,3,15,22,1,0,9,-9,1,1,1,0,0,0,0,0,0,0.5022370601254724,0.4977629398745276
87927,0.4065040650406504,0.6363636363636364,146,-175,0.389078170160859,0.610921829839141,away,SF,over,11,0.5121951219512195,-105,0.48919479393107135,COL,SF,2022 REG,12,4,5,3,7,17,1,0,1,-1,1,1,1,0,0,0,0,0,0,0.48919479393107135,0.5108052060689287
87927,0.4065040650406504,0.6363636363636364,146,-175,0.389078170160859,0.610921829839141,home,COL,under,11,0.5327102803738317,-114,0.5108052060689287,COL,SF,2022 REG,12,4,5,3,7,17,1,0,1,-1,1,1,1,0,0,0,0,0,0,0.48919479393107135,0.5108052060689287
87928,0.4132231404958678,0.6226415094339623,142,-165,0.3984030372190785,0.6015969627809215,away,HOU,over,9,0.49751243781094534,101,0.476135829221149,WSH,HOU,2022 REG,14,13,12,6,19,26,1,0,7,-7,1,1,1,1,1,1,0,0,0,0.476135829221149,0.523864170778851
87928,0.4132231404958678,0.6226415094339623,142,-165,0.3984030372190785,0.6015969627809215,home,WSH,under,9,0.5454545454545454,-120,0.523864170778851,WSH,HOU,2022 REG,14,13,12,6,19,26,1,0,7,-7,1,1,1,1,1,1,0,0,0,0.476135829221149,0.523864170778851
87929,0.5867768595041323,0.45248868778280543,-142,121,0.563736744980392,0.43626325501960805,away,PIT,over,7,0.5454545454545454,-120,0.5206611570247933,CHC,PIT,2022 REG,7,7,5,0,7,12,1,0,7,-7,0,0,0,0,0,0,0,0,0,0.5206611570247933,0.4793388429752067
87929,0.5867768595041323,0.45248868778280543,-142,121,0.563736744980392,0.43626325501960805,home,CHC,under,7,0.5,100,0.4793388429752067,CHC,PIT,2022 REG,7,7,5,0,7,12,1,0,7,-7,0,0,0,0,0,0,0,0,0,0.5206611570247933,0.4793388429752067
87930,0.6031746031746031,0.4347826086956522,-152,130,0.5802797769671475,0.4197202230328525,away,ATL,over,8.5,0.5121951219512195,-105,0.48808156828023186,PHI,ATL,2022 REG,13,14,9,4,18,22,1,0,10,-10,1,1,1,1,0,0,0,0,0,0.48808156828023186,0.5119184317197681
87930,0.6031746031746031,0.4347826086956522,-152,130,0.5802797769671475,0.4197202230328525,home,PHI,under,8.5,0.5348837209302326,-115,0.5119184317197681,PHI,ATL,2022 REG,13,14,9,4,18,22,1,0,10,-10,1,1,1,1,0,0,0,0,0,0.48808156828023186,0.5119184317197681
87931,0.6666666666666666,0.37037037037037035,-200,170,0.6419753086419753,0.3580246913580247,away,KC,over,9,0.5238095238095238,-110,0.4988662131519274,SF,KC,2022 REG,7,2,4,3,5,11,0,1,-1,1,1,1,0,0,0,0,0,0,0,0.4988662131519274,0.5011337868480725
87931,0.6666666666666666,0.37037037037037035,-200,170,0.6419753086419753,0.3580246913580247,home,SF,under,9,0.5238095238095238,-110,0.5011337868480725,SF,KC,2022 REG,7,2,4,3,5,11,0,1,-1,1,1,1,0,0,0,0,0,0,0,0.4988662131519274,0.5011337868480725
87932,0.7389033942558746,0.29850746268656714,-283,235,0.7112603850790834,0.2887396149209166,away,OAK,over,7.5,0.5305164319248826,-113,0.5066009958897986,HOU,OAK,2022 REG,10,6,7,3,9,17,1,0,3,-3,1,1,1,0,0,0,0,0,0,0.5066009958897986,0.49339900411020143
87932,0.7389033942558746,0.29850746268656714,-283,235,0.7112603850790834,0.2887396149209166,home,HOU,under,7.5,0.5145631067961165,-106,0.49339900411020143,HOU,OAK,2022 REG,10,6,7,3,9,17,1,0,3,-3,1,1,1,0,0,0,0,0,0,0.5066009958897986,0.49339900411020143
87933,0.6376811594202898,0.4065040650406504,-176,146,0.6095050742567917,0.3904949257432083,away,MIA,over,7.5,0.5145631067961165,-106,0.4913668392989033,TB,MIA,2022 REG,6,5,9,4,9,15,1,0,1,-1,1,1,1,1,0,0,0,0,0,0.4913668392989033,0.5086331607010968
87933,0.6376811594202898,0.4065040650406504,-176,146,0.6095050742567917,0.3904949257432083,home,TB,under,7.5,0.5305164319248826,-113,0.5086331607010968,TB,MIA,2022 REG,6,5,9,4,9,15,1,0,1,-1,1,1,1,1,0,0,0,0,0,0.4913668392989033,0.5086331607010968
87934,0.3508771929824561,0.6875,185,-220,0.3374115112342259,0.662588488765774,away,SD,over,8.5,0.5260663507109005,-111,0.5022370601254724,KC,SD,2022 REG,7,3,11,4,7,18,0,1,-1,1,1,1,1,0,0,0,0,0,0,0.5022370601254724,0.4977629398745276
87934,0.3508771929824561,0.6875,185,-220,0.3374115112342259,0.662588488765774,home,KC,under,8.5,0.5192307692307692,-108,0.4977629398745276,KC,SD,2022 REG,7,3,11,4,7,18,0,1,-1,1,1,1,1,0,0,0,0,0,0,0.5022370601254724,0.4977629398745276
87935,0.5934959349593496,0.4444444444444444,-146,125,0.5709784740123824,0.42902152598761756,away,ARI,over,7.5,0.504950495049505,-102,0.48054649490447493,MIA,ARI,2022 REG,10,7,9,8,15,19,0,1,-1,1,1,1,1,1,1,1,1,0,0,0.48054649490447493,0.5194535050955251
87935,0.5934959349593496,0.4444444444444444,-146,125,0.5709784740123824,0.42902152598761756,home,MIA,under,7.5,0.5433789954337899,-119,0.5194535050955251,MIA,ARI,2022 REG,10,7,9,8,15,19,0,1,-1,1,1,1,1,1,1,1,1,0,0,0.48054649490447493,0.5194535050955251
87936,0.6226415094339623,0.41493775933609955,-165,141,0.5992430968035465,0.4007569031964535,away,STL,over,8,0.5327102803738317,-114,0.508788710910954,LAD,STL,2022 REG,7,0,12,11,11,19,0,1,-11,11,0,0,0,0,0,0,0,0,0,0.508788710910954,0.491211289089046
87936,0.6226415094339623,0.41493775933609955,-165,141,0.5992430968035465,0.4007569031964535,home,LAD,under,8,0.5121951219512195,-105,0.491211289089046,LAD,STL,2022 REG,7,0,12,11,11,19,0,1,-11,11,0,0,0,0,0,0,0,0,0,0.508788710910954,0.491211289089046
87937,0.5555555555555556,0.48780487804878053,-125,105,0.5314664257753688,0.46853357422463116,away,CHC,over,9,0.5121951219512195,-105,0.48808156828023186,ARI,CHC,2022 REG,12,4,5,3,7,17,1,0,1,-1,1,1,1,0,0,0,0,0,0,0.48808156828023186,0.5119184317197681
87937,0.5555555555555556,0.48780487804878053,-125,105,0.5314664257753688,0.46853357422463116,home,ARI,under,9,0.5348837209302326,-115,0.5119184317197681,ARI,CHC,2022 REG,12,4,5,3,7,17,1,0,1,-1,1,1,1,0,0,0,0,0,0,0.48808156828023186,0.5119184317197681
87938,0.47619047619047616,0.5652173913043479,110,-130,0.4564724440500838,0.5435275559499162,away,PHI,over,8,0.5,100,0.47935779816513757,STL,PHI,2022 REG,6,0,5,2,2,11,0,1,-2,2,0,0,0,0,0,0,0,0,0,0.47935779816513757,0.5206422018348624
87938,0.47619047619047616,0.5652173913043479,110,-130,0.4564724440500838,0.5435275559499162,home,STL,under,8,0.5412844036697247,-118,0.5206422018348624,STL,PHI,2022 REG,6,0,5,2,2,11,0,1,-2,2,0,0,0,0,0,0,0,0,0,0.47935779816513757,0.5206422018348624
87939,0.4629629629629629,0.5798319327731092,116,-138,0.44315051123329985,0.5568494887667002,away,CLE,over,8,0.5098039215686274,-104,0.48592421718142587,KC,CLE,2022 REG,6,2,8,1,3,14,1,0,1,-1,1,0,0,0,0,0,0,0,0,0.48592421718142587,0.5140757828185741
87939,0.4629629629629629,0.5798319327731092,116,-138,0.44315051123329985,0.5568494887667002,home,KC,under,8,0.5370370370370371,-116,0.5140757828185741,KC,CLE,2022 REG,6,2,8,1,3,14,1,0,1,-1,1,0,0,0,0,0,0,0,0,0.48592421718142587,0.5140757828185741
87940,0.5555555555555556,0.48780487804878053,-125,105,0.5314664257753688,0.46853357422463116,away,NYM,over,8.5,0.5169082125603864,-107,0.4946943078742622,SF,NYM,2022 REG,8,9,5,3,12,13,1,0,6,-6,1,1,1,0,0,0,0,0,0,0.4946943078742622,0.5053056921257377
87940,0.5555555555555556,0.48780487804878053,-125,105,0.5314664257753688,0.46853357422463116,home,SF,under,8.5,0.5260663507109005,-111,0.5053056921257377,SF,NYM,2022 REG,8,9,5,3,12,13,1,0,6,-6,1,1,1,0,0,0,0,0,0,0.4946943078742622,0.5053056921257377
87941,0.6376811594202898,0.4,-176,150,0.6136525939928585,0.38634740600714146,away,CHC,over,8,0.5238095238095238,-110,0.4988662131519274,PHI,CHC,2022 REG,6,2,7,6,8,13,0,1,-4,4,1,1,0,0,0,0,0,0,0,0.4988662131519274,0.5011337868480725
87941,0.6376811594202898,0.4,-176,150,0.6136525939928585,0.38634740600714146,home,PHI,under,8,0.5238095238095238,-110,0.5011337868480725,PHI,CHC,2022 REG,6,2,7,6,8,13,0,1,-4,4,1,1,0,0,0,0,0,0,0,0.4988662131519274,0.5011337868480725
87942,0.4694835680751174,0.5708154506437768,113,-133,0.45056384097704505,0.549436159022955,away,SEA,over,7.5,0.5,100,0.4772727272727273,LAA,SEA,2022 REG,8,1,9,9,10,17,0,1,-8,8,1,0,0,0,0,0,0,0,0,0.4772727272727273,0.5227272727272727
87942,0.4694835680751174,0.5708154506437768,113,-133,0.45056384097704505,0.549436159022955,home,LAA,under,7.5,0.5454545454545454,-120,0.5227272727272727,LAA,SEA,2022 REG,8,1,9,9,10,17,0,1,-8,8,1,0,0,0,0,0,0,0,0,0.4772727272727273,0.5227272727272727
87943,0.646643109540636,0.3891050583657587,-183,157,0.6235268030852642,0.3764731969147358,away,LAA,over,7.5,0.5192307692307692,-108,0.49571111079951763,TEX,LAA,2022 REG,6,5,8,3,8,14,1,0,2,-2,1,1,1,0,0,0,0,0,0,0.49571111079951763,0.5042888892004824
87943,0.646643109540636,0.3891050583657587,-183,157,0.6235268030852642,0.3764731969147358,home,TEX,under,7.5,0.5260663507109005,-111,0.5042888892004824,TEX,LAA,2022 REG,6,5,8,3,8,14,1,0,2,-2,1,1,1,0,0,0,0,0,0,0.49571111079951763,0.5042888892004824
87944,0.5,0.5412844036697247,100,-118,0.47935779816513757,0.5206422018348624,away,SD,over,8,0.5412844036697247,-118,0.5149381613977361,STL,SD,2022 REG,8,5,6,2,7,14,1,0,3,-3,1,1,0,0,0,0,0,0,0,0.5149381613977361,0.48506183860226393
87944,0.5,0.5412844036697247,100,-118,0.47935779816513757,0.5206422018348624,home,STL,under,8,0.5073891625615764,-103,0.48506183860226393,STL,SD,2022 REG,8,5,6,2,7,14,1,0,3,-3,1,1,0,0,0,0,0,0,0,0.5149381613977361,0.48506183860226393
87945,0.5833333333333333,0.45454545454545453,-140,120,0.5612373737373737,0.4387626262626263,away,LAA,over,7.5,0.5,100,0.4772727272727273,SEA,LAA,2022 REG,7,1,8,7,8,15,0,1,-6,6,1,0,0,0,0,0,0,0,0,0.4772727272727273,0.5227272727272727
87945,0.5833333333333333,0.45454545454545453,-140,120,0.5612373737373737,0.4387626262626263,home,SEA,under,7.5,0.5454545454545454,-120,0.5227272727272727,SEA,LAA,2022 REG,7,1,8,7,8,15,0,1,-6,6,1,0,0,0,0,0,0,0,0,0.4772727272727273,0.5227272727272727
87946,0.7032640949554896,0.3389830508474576,-237,195,0.6735531941979274,0.32644680580207264,away,COL,over,8,0.5260663507109005,-111,0.5022370601254724,STL,COL,2022 REG,10,5,6,4,9,16,1,0,1,-1,1,1,1,1,0,0,0,0,0,0.5022370601254724,0.4977629398745276
87946,0.7032640949554896,0.3389830508474576,-237,195,0.6735531941979274,0.32644680580207264,home,STL,under,8,0.5192307692307692,-108,0.4977629398745276,STL,COL,2022 REG,10,5,6,4,9,16,1,0,1,-1,1,1,1,1,0,0,0,0,0,0.5022370601254724,0.4977629398745276
87947,0.42194092827004215,0.6226415094339623,137,-165,0.40312977312067316,0.5968702268793269,away,ATL,over,8,0.5098039215686274,-104,0.48592421718142587,SF,ATL,2022 REG,4,1,10,5,6,14,0,1,-4,4,1,0,0,0,0,0,0,0,0,0.48592421718142587,0.5140757828185741
87947,0.42194092827004215,0.6226415094339623,137,-165,0.40312977312067316,0.5968702268793269,home,SF,under,8,0.5370370370370371,-116,0.5140757828185741,SF,ATL,2022 REG,4,1,10,5,6,14,0,1,-4,4,1,0,0,0,0,0,0,0,0,0.48592421718142587,0.5140757828185741
87948,0.5850622406639003,0.4566210045662101,-141,119,0.5606749478114291,0.4393250521885709,away,PIT,over,9.5,0.5,100,0.4772727272727273,CIN,PIT,2022 REG,5,1,12,6,7,17,0,1,-5,5,1,0,0,0,0,0,0,0,0,0.4772727272727273,0.5227272727272727
87948,0.5850622406639003,0.4566210045662101,-141,119,0.5606749478114291,0.4393250521885709,home,CIN,under,9.5,0.5454545454545454,-120,0.5227272727272727,CIN,PIT,2022 REG,5,1,12,6,7,17,0,1,-5,5,1,0,0,0,0,0,0,0,0,0.4772727272727273,0.5227272727272727
87949,0.5780590717299579,0.4587155963302753,-137,118,0.5568011412478822,0.44319885875211784,away,MIN,over,7.5,0.5,100,0.4772727272727273,CWS,MIN,2022 REG,13,13,1,0,13,14,1,0,13,-13,0,0,0,0,0,0,0,0,0,0.4772727272727273,0.5227272727272727
87949,0.5780590717299579,0.4587155963302753,-137,118,0.5568011412478822,0.44319885875211784,home,CWS,under,7.5,0.5454545454545454,-120,0.5227272727272727,CWS,MIN,2022 REG,13,13,1,0,13,14,1,0,13,-13,0,0,0,0,0,0,0,0,0,0.4772727272727273,0.5227272727272727
87950,0.4464285714285714,0.5934959349593496,124,-146,0.42860513107682097,0.571394868923179,away,LAA,over,7.5,0.5121951219512195,-105,0.48808156828023186,OAK,LAA,2022 REG,6,2,7,1,3,13,1,0,1,-1,1,0,0,0,0,0,0,0,0,0.48808156828023186,0.5119184317197681
87950,0.4464285714285714,0.5934959349593496,124,-146,0.42860513107682097,0.571394868923179,home,OAK,under,7.5,0.5348837209302326,-115,0.5119184317197681,OAK,LAA,2022 REG,6,2,7,1,3,13,1,0,1,-1,1,0,0,0,0,0,0,0,0,0.48808156828023186,0.5119184317197681
87951,0.6000000000000001,0.43859649122807015,-150,128,0.5768421052631579,0.42315789473684207,away,COL,over,8,0.5098039215686274,-104,0.4870219861770517,ARI,COL,2022 REG,8,4,5,0,4,13,1,0,4,-4,0,0,0,0,0,0,0,0,0,0.4870219861770517,0.5129780138229483
87951,0.6000000000000001,0.43859649122807015,-150,128,0.5768421052631579,0.42315789473684207,home,ARI,under,8,0.5348837209302326,-115,0.5129780138229483,ARI,COL,2022 REG,8,4,5,0,4,13,1,0,4,-4,0,0,0,0,0,0,0,0,0,0.4870219861770517,0.5129780138229483
87952,0.35460992907801414,0.6875,182,-220,0.3396773301141794,0.6603226698858207,away,LAD,over,8,0.5192307692307692,-108,0.49688292476754015,SF,LAD,2022 REG,5,3,8,5,8,13,0,1,-2,2,1,1,1,0,0,0,0,0,0,0.49688292476754015,0.5031170752324599
87952,0.35460992907801414,0.6875,182,-220,0.3396773301141794,0.6603226698858207,home,SF,under,8,0.5238095238095238,-110,0.5031170752324599,SF,LAD,2022 REG,5,3,8,5,8,13,0,1,-2,2,1,1,1,0,0,0,0,0,0,0.49688292476754015,0.5031170752324599
87953,0.6296296296296295,0.4081632653061224,-170,145,0.6058341031886005,0.39416589681139946,away,ARI,over,6,0.5454545454545454,-120,0.5206611570247933,HOU,ARI,2022 REG,7,2,9,5,7,16,0,1,-3,3,1,1,0,0,0,0,0,0,0,0.5206611570247933,0.4793388429752067
87953,0.6296296296296295,0.4081632653061224,-170,145,0.6058341031886005,0.39416589681139946,home,HOU,under,6,0.5,100,0.4793388429752067,HOU,ARI,2022 REG,7,2,9,5,7,16,0,1,-3,3,1,1,0,0,0,0,0,0,0,0.5206611570247933,0.4793388429752067
87954,0.607843137254902,0.4291845493562232,-155,133,0.5853361120599043,0.4146638879400957,away,CIN,over,8,0.5169082125603864,-107,0.49353874091423283,SF,CIN,2022 REG,5,3,14,10,13,19,0,1,-7,7,1,1,1,0,0,0,0,0,0,0.49353874091423283,0.5064612590857671
87954,0.607843137254902,0.4291845493562232,-155,133,0.5853361120599043,0.4146638879400957,home,SF,under,8,0.5283018867924528,-112,0.5064612590857671,SF,CIN,2022 REG,5,3,14,10,13,19,0,1,-7,7,1,1,1,0,0,0,0,0,0,0.49353874091423283,0.5064612590857671
87955,0.4132231404958678,0.6240601503759399,142,-166,0.39781682195379847,0.6021831780462015,away,SD,over,7,0.5305164319248826,-113,0.5066009958897986,PIT,SD,2022 REG,8,7,7,6,13,15,1,0,1,-1,1,1,1,1,1,1,0,0,0,0.5066009958897986,0.49339900411020143
87955,0.4132231404958678,0.6240601503759399,142,-166,0.39781682195379847,0.6021831780462015,home,PIT,under,7,0.5145631067961165,-106,0.49339900411020143,PIT,SD,2022 REG,8,7,7,6,13,15,1,0,1,-1,1,1,1,1,1,1,0,0,0,0.5066009958897986,0.49339900411020143
87956,0.4694835680751174,0.574468085106383,113,-135,0.44884898911666654,0.5511510108833335,away,MIA,over,7.5,0.5215311004784688,-109,0.49907282342437215,STL,MIA,2022 REG,7,3,7,4,7,14,0,1,-1,1,1,1,1,0,0,0,0,0,0,0.49907282342437215,0.5009271765756278
87956,0.4694835680751174,0.574468085106383,113,-135,0.44884898911666654,0.5511510108833335,home,STL,under,7.5,0.5215311004784688,-109,0.5009271765756278,STL,MIA,2022 REG,7,3,7,4,7,14,0,1,-1,1,1,1,1,0,0,0,0,0,0,0.49907282342437215,0.5009271765756278
87957,0.6000000000000001,0.4366812227074236,-150,129,0.5779912663755458,0.42200873362445424,away,MIL,over,8,0.5238095238095238,-110,0.4988662131519274,STL,MIL,2022 REG,7,6,6,3,9,13,1,0,3,-3,1,1,1,0,0,0,0,0,0,0.4988662131519274,0.5011337868480725
87957,0.6000000000000001,0.4366812227074236,-150,129,0.5779912663755458,0.42200873362445424,home,STL,under,8,0.5238095238095238,-110,0.5011337868480725,STL,MIL,2022 REG,7,6,6,3,9,13,1,0,3,-3,1,1,1,0,0,0,0,0,0,0.4988662131519274,0.5011337868480725
87958,0.37037037037037035,0.6721311475409836,170,-205,0.35462906744023925,0.6453709325597607,away,LAD,over,8.5,0.5215311004784688,-109,0.49907282342437215,SF,LAD,2022 REG,5,3,13,2,5,18,1,0,1,-1,1,1,0,0,0,0,0,0,0,0.49907282342437215,0.5009271765756278
87958,0.37037037037037035,0.6721311475409836,170,-205,0.35462906744023925,0.6453709325597607,home,SF,under,8.5,0.5215311004784688,-109,0.5009271765756278,SF,LAD,2022 REG,5,3,13,2,5,18,1,0,1,-1,1,1,0,0,0,0,0,0,0,0.49907282342437215,0.5009271765756278
87959,0.7198879551820728,0.3205128205128205,-257,212,0.6908039233793066,0.30919607662069337,away,WSH,over,9,0.5121951219512195,-105,0.48808156828023186,LAD,WSH,2022 REG,6,3,14,8,11,20,0,1,-5,5,1,1,1,0,0,0,0,0,0,0.48808156828023186,0.5119184317197681
87959,0.7198879551820728,0.3205128205128205,-257,212,0.6908039233793066,0.30919607662069337,home,LAD,under,9,0.5348837209302326,-115,0.5119184317197681,LAD,WSH,2022 REG,6,3,14,8,11,20,0,1,-5,5,1,1,1,0,0,0,0,0,0,0.48808156828023186,0.5119184317197681
87960,0.4854368932038835,0.5555555555555556,106,-125,0.465537646233282,0.534462353766718,away,ARI,over,9,0.5169082125603864,-107,0.49353874091423283,KC,ARI,2022 REG,5,3,13,7,10,18,0,1,-4,4,1,1,1,0,0,0,0,0,0,0.49353874091423283,0.5064612590857671
87960,0.4854368932038835,0.5555555555555556,106,-125,0.465537646233282,0.534462353766718,home,KC,under,9,0.5283018867924528,-112,0.5064612590857671,KC,ARI,2022 REG,5,3,13,7,10,18,0,1,-4,4,1,1,1,0,0,0,0,0,0,0.49353874091423283,0.5064612590857671
87961,0.5555555555555556,0.4854368932038835,-125,106,0.5327819729114227,0.4672180270885773,away,STL,over,10,0.5283018867924528,-112,0.5056562298022652,PHI,STL,2022 REG,12,6,9,7,13,21,0,1,-1,1,1,1,1,1,1,1,0,0,0,0.5056562298022652,0.4943437701977348
87961,0.5555555555555556,0.4854368932038835,-125,106,0.5327819729114227,0.4672180270885773,home,PHI,under,10,0.5145631067961165,-106,0.4943437701977348,PHI,STL,2022 REG,12,6,9,7,13,21,0,1,-1,1,1,1,1,1,1,1,0,0,0,0.5056562298022652,0.4943437701977348
87962,0.3921568627450981,0.6453900709219857,155,-182,0.37743257503251615,0.6225674249674839,away,NYY,over,9,0.5348837209302326,-115,0.5097020142727117,MIN,NYY,2022 REG,11,8,5,1,9,16,1,0,7,-7,1,0,0,0,0,0,0,0,0,0.5097020142727117,0.49029798572728833
87962,0.3921568627450981,0.6453900709219857,155,-182,0.37743257503251615,0.6225674249674839,home,MIN,under,9,0.5121951219512195,-105,0.49029798572728833,MIN,NYY,2022 REG,11,8,5,1,9,16,1,0,7,-7,1,0,0,0,0,0,0,0,0,0.5097020142727117,0.49029798572728833
87963,0.5121951219512195,0.5305164319248826,-105,-113,0.4903184724049234,0.5096815275950766,away,TB,over,8,0.5121951219512195,-105,0.48919479393107135,NYY,TB,2022 REG,15,10,7,3,13,22,1,0,7,-7,1,1,1,0,0,0,0,0,0,0.48919479393107135,0.5108052060689287
87963,0.5121951219512195,0.5305164319248826,-105,-113,0.4903184724049234,0.5096815275950766,home,NYY,under,8,0.5327102803738317,-114,0.5108052060689287,NYY,TB,2022 REG,15,10,7,3,13,22,1,0,7,-7,1,1,1,0,0,0,0,0,0,0.48919479393107135,0.5108052060689287
87964,0.5815899581589958,0.4629629629629629,-139,116,0.5556784266278149,0.44432157337218514,away,ARI,over,10,0.5098039215686274,-104,0.4870219861770517,CIN,ARI,2022 REG,9,4,7,5,9,16,0,1,-1,1,1,1,1,1,0,0,0,0,0,0.4870219861770517,0.5129780138229483
87964,0.5815899581589958,0.4629629629629629,-139,116,0.5556784266278149,0.44432157337218514,home,CIN,under,10,0.5348837209302326,-115,0.5129780138229483,CIN,ARI,2022 REG,9,4,7,5,9,16,0,1,-1,1,1,1,1,1,0,0,0,0,0,0.4870219861770517,0.5129780138229483
87965,0.3921568627450981,0.6491228070175439,155,-185,0.37596875695582666,0.6240312430441733,away,PHI,over,7,0.5454545454545454,-120,0.5206611570247933,PIT,PHI,2022 REG,9,2,18,8,10,27,0,1,-6,6,1,1,0,0,0,0,0,0,0,0.5206611570247933,0.4793388429752067
87965,0.3921568627450981,0.6491228070175439,155,-185,0.37596875695582666,0.6240312430441733,home,PIT,under,7,0.5,100,0.4793388429752067,PIT,PHI,2022 REG,9,2,18,8,10,27,0,1,-6,6,1,1,0,0,0,0,0,0,0,0.5206611570247933,0.4793388429752067
87966,0.47619047619047616,0.5652173913043479,110,-130,0.4564724440500838,0.5435275559499162,away,PHI,over,7.5,0.5145631067961165,-106,0.4925063625223866,MIA,PHI,2022 REG,7,5,8,3,8,15,1,0,2,-2,1,1,1,0,0,0,0,0,0,0.4925063625223866,0.5074936374776133
87966,0.47619047619047616,0.5652173913043479,110,-130,0.4564724440500838,0.5435275559499162,home,MIA,under,7.5,0.5283018867924528,-112,0.5074936374776133,MIA,PHI,2022 REG,7,5,8,3,8,15,1,0,2,-2,1,1,1,0,0,0,0,0,0,0.4925063625223866,0.5074936374776133
87967,0.6254681647940076,0.41493775933609955,-167,141,0.6001955455815435,0.39980445441845647,away,DET,over,8.5,0.5121951219512195,-105,0.48808156828023186,CLE,DET,2022 REG,13,10,5,0,10,18,1,0,10,-10,0,0,0,0,0,0,0,0,0,0.48808156828023186,0.5119184317197681
87967,0.6254681647940076,0.41493775933609955,-167,141,0.6001955455815435,0.39980445441845647,home,CLE,under,8.5,0.5348837209302326,-115,0.5119184317197681,CLE,DET,2022 REG,13,10,5,0,10,18,1,0,10,-10,0,0,0,0,0,0,0,0,0,0.48808156828023186,0.5119184317197681
87968,0.3802281368821293,0.6575342465753424,163,-192,0.3658698161758662,0.6341301838241338,away,LAA,over,6.5,0.5348837209302326,-115,0.5097020142727117,DET,LAA,2022 REG,7,4,7,0,4,14,1,0,4,-4,0,0,0,0,0,0,0,0,0,0.5097020142727117,0.49029798572728833
87968,0.3802281368821293,0.6575342465753424,163,-192,0.3658698161758662,0.6341301838241338,home,DET,under,6.5,0.5121951219512195,-105,0.49029798572728833,DET,LAA,2022 REG,7,4,7,0,4,14,1,0,4,-4,0,0,0,0,0,0,0,0,0,0.5097020142727117,0.49029798572728833
87969,0.4854368932038835,0.5555555555555556,106,-125,0.465537646233282,0.534462353766718,away,NYY,over,7,0.5,100,0.4772727272727273,TB,NYY,2022 REG,6,1,6,2,3,12,0,1,-1,1,1,0,0,0,0,0,0,0,0,0.4772727272727273,0.5227272727272727
87969,0.4854368932038835,0.5555555555555556,106,-125,0.465537646233282,0.534462353766718,home,TB,under,7,0.5454545454545454,-120,0.5227272727272727,TB,NYY,2022 REG,6,1,6,2,3,12,0,1,-1,1,1,0,0,0,0,0,0,0,0,0.4772727272727273,0.5227272727272727
87970,0.5983935742971888,0.4347826086956522,-149,130,0.5785411595745651,0.4214588404254349,away,TEX,over,7.5,0.49504950495049505,102,0.4739797934813417,TB,TEX,2022 REG,10,3,9,4,7,19,0,1,-1,1,1,1,1,0,0,0,0,0,0,0.4739797934813417,0.5260202065186583
87970,0.5983935742971888,0.4347826086956522,-149,130,0.5785411595745651,0.4214588404254349,home,TB,under,7.5,0.5475113122171946,-121,0.5260202065186583,TB,TEX,2022 REG,10,3,9,4,7,19,0,1,-1,1,1,1,1,0,0,0,0,0,0,0.4739797934813417,0.5260202065186583
87971,0.45248868778280543,0.5967741935483871,121,-148,0.430197791252854,0.5698022087471459,away,NYM,over,7.5,0.49504950495049505,102,0.4739797934813417,MIA,NYM,2022 REG,7,3,14,9,12,21,0,1,-6,6,1,1,1,0,0,0,0,0,0,0.4739797934813417,0.5260202065186583
87971,0.45248868778280543,0.5967741935483871,121,-148,0.430197791252854,0.5698022087471459,home,MIA,under,7.5,0.5475113122171946,-121,0.5260202065186583,MIA,NYM,2022 REG,7,3,14,9,12,21,0,1,-6,6,1,1,1,0,0,0,0,0,0,0.4739797934813417,0.5260202065186583
87972,0.4672897196261683,0.5708154506437768,114,-133,0.44948356529441824,0.5505164347055818,away,MIN,over,8,0.5391705069124424,-117,0.5140669063204599,DET,MIN,2022 REG,5,3,5,2,5,10,1,0,1,-1,1,1,0,0,0,0,0,0,0,0.5140669063204599,0.4859330936795401
87972,0.4672897196261683,0.5708154506437768,114,-133,0.44948356529441824,0.5505164347055818,home,DET,under,8,0.5073891625615764,-103,0.4859330936795401,DET,MIN,2022 REG,5,3,5,2,5,10,1,0,1,-1,1,1,0,0,0,0,0,0,0,0.5140669063204599,0.4859330936795401
87973,0.6666666666666666,0.36363636363636365,-200,175,0.6464646464646464,0.3535353535353536,away,COL,over,8.5,0.5121951219512195,-105,0.48919479393107135,CWS,COL,2022 REG,7,4,5,2,6,12,1,0,2,-2,1,1,0,0,0,0,0,0,0,0.48919479393107135,0.5108052060689287
87973,0.6666666666666666,0.36363636363636365,-200,175,0.6464646464646464,0.3535353535353536,home,CWS,under,8.5,0.5327102803738317,-114,0.5108052060689287,CWS,COL,2022 REG,7,4,5,2,6,12,1,0,2,-2,1,1,0,0,0,0,0,0,0,0.48919479393107135,0.5108052060689287
87974,0.5850622406639003,0.45454545454545453,-141,120,0.5618892737571823,0.43811072624281766,away,CWS,over,8.5,0.5475113122171946,-121,0.5242087833606768,LAA,CWS,2022 REG,9,4,6,3,7,15,1,0,1,-1,1,1,1,0,0,0,0,0,0,0.5242087833606768,0.4757912166393232
87974,0.5850622406639003,0.45454545454545453,-141,120,0.5618892737571823,0.43811072624281766,home,LAA,under,8.5,0.49504950495049505,102,0.4757912166393232,LAA,CWS,2022 REG,9,4,6,3,7,15,1,0,1,-1,1,1,1,0,0,0,0,0,0,0.5242087833606768,0.4757912166393232
87975,0.6389891696750902,0.39525691699604737,-177,153,0.6171062911884788,0.3828937088115212,away,WSH,over,7.5,0.5412844036697247,-118,0.5162581740877563,SF,WSH,2022 REG,6,5,12,11,16,18,0,1,-6,6,1,1,1,1,1,0,0,0,0,0.5162581740877563,0.4837418259122437
87975,0.6389891696750902,0.39525691699604737,-177,153,0.6171062911884788,0.3828937088115212,home,SF,under,7.5,0.504950495049505,-102,0.4837418259122437,SF,WSH,2022 REG,6,5,12,11,16,18,0,1,-6,6,1,1,1,1,1,0,0,0,0,0.5162581740877563,0.4837418259122437
87976,0.4504504504504505,0.5918367346938775,122,-145,0.43140216885390636,0.5685978311460936,away,PHI,over,7.5,0.5121951219512195,-105,0.48919479393107135,TEX,PHI,2022 REG,7,4,5,2,6,12,1,0,2,-2,1,1,0,0,0,0,0,0,0,0.48919479393107135,0.5108052060689287
87976,0.4504504504504505,0.5918367346938775,122,-145,0.43140216885390636,0.5685978311460936,home,TEX,under,7.5,0.5327102803738317,-114,0.5108052060689287,TEX,PHI,2022 REG,7,4,5,2,6,12,1,0,2,-2,1,1,0,0,0,0,0,0,0,0.48919479393107135,0.5108052060689287
87977,0.7142857142857143,0.3278688524590164,-250,205,0.6841753094680495,0.3158246905319505,away,SF,over,8,0.5370370370370371,-116,0.5118817074154765,LAD,SF,2022 REG,11,7,8,3,10,19,1,0,4,-4,1,1,1,0,0,0,0,0,0,0.5118817074154765,0.48811829258452355
87977,0.7142857142857143,0.3278688524590164,-250,205,0.6841753094680495,0.3158246905319505,home,LAD,under,8,0.5098039215686274,-104,0.48811829258452355,LAD,SF,2022 REG,11,7,8,3,10,19,1,0,4,-4,1,1,1,0,0,0,0,0,0,0.5118817074154765,0.48811829258452355
89013,0.35714285714285715,0.6845425867507886,180,-217,0.3422551986094122,0.6577448013905878,away,PHI,over,8.5,0.504950495049505,-102,0.48160416005266615,WSH,PHI,2022 REG,7,1,11,5,6,18,0,1,-4,4,1,0,0,0,0,0,0,0,0,0.48160416005266615,0.5183958399473338
89013,0.35714285714285715,0.6845425867507886,180,-217,0.3422551986094122,0.6577448013905878,home,WSH,under,8.5,0.5412844036697247,-118,0.5183958399473338,WSH,PHI,2022 REG,7,1,11,5,6,18,0,1,-4,4,1,0,0,0,0,0,0,0,0,0.48160416005266615,0.5183958399473338
89014,0.37593984962406013,0.6666666666666666,166,-200,0.35992236229671926,0.6400776377032807,away,PHI,over,7.5,0.5348837209302326,-115,0.5097020142727117,WSH,PHI,2022 REG,14,13,7,4,17,21,1,0,9,-9,1,1,1,1,0,0,0,0,0,0.5097020142727117,0.49029798572728833
89014,0.37593984962406013,0.6666666666666666,166,-200,0.35992236229671926,0.6400776377032807,home,WSH,under,7.5,0.5121951219512195,-105,0.49029798572728833,WSH,PHI,2022 REG,14,13,7,4,17,21,1,0,9,-9,1,1,1,1,0,0,0,0,0,0.5097020142727117,0.49029798572728833
89083,0.5238095238095238,0.5238095238095238,-110,-110,0.4988662131519274,0.5011337868480725,away,CLE,over,9,0.5348837209302326,-115,0.5097020142727117,ARI,CLE,2023 REG,9,3,16,12,15,25,0,1,-9,9,1,1,1,0,0,0,0,0,0,0.5097020142727117,0.49029798572728833
89083,0.5238095238095238,0.5238095238095238,-110,-110,0.4988662131519274,0.5011337868480725,home,ARI,under,9,0.5121951219512195,-105,0.49029798572728833,ARI,CLE,2023 REG,9,3,16,12,15,25,0,1,-9,9,1,1,1,0,0,0,0,0,0,0.5097020142727117,0.49029798572728833
89095,0.6323529411764706,0.4,-172,150,0.6118944636678201,0.3881055363321799,away,CHC,over,8.5,0.5121951219512195,-105,0.48808156828023186,HOU,CHC,2023 REG,13,7,13,6,13,26,1,0,1,-1,1,1,1,1,1,1,0,0,0,0.48808156828023186,0.5119184317197681
89095,0.6323529411764706,0.4,-172,150,0.6118944636678201,0.3881055363321799,home,HOU,under,8.5,0.5348837209302326,-115,0.5119184317197681,HOU,CHC,2023 REG,13,7,13,6,13,26,1,0,1,-1,1,1,1,1,1,1,0,0,0,0.48808156828023186,0.5119184317197681
89100,0.4444444444444444,0.5967741935483871,125,-148,0.42612504978096366,0.5738749502190363,away,KC,over,8.5,0.5454545454545454,-120,0.5206611570247933,OAK,KC,2023 REG,2,0,5,4,4,7,0,1,-4,4,0,0,0,0,0,0,0,0,0,0.5206611570247933,0.4793388429752067
89100,0.4444444444444444,0.5967741935483871,125,-148,0.42612504978096366,0.5738749502190363,home,OAK,under,8.5,0.5,100,0.4793388429752067,OAK,KC,2023 REG,2,0,5,4,4,7,0,1,-4,4,0,0,0,0,0,0,0,0,0,0.5206611570247933,0.4793388429752067
89104,0.4081632653061224,0.6363636363636364,145,-175,0.3899890197266291,0.6100109802733709,away,ATL,over,9,0.5348837209302326,-115,0.5097020142727117,MIA,ATL,2023 REG,13,9,11,6,15,24,1,0,3,-3,1,1,1,1,1,1,0,0,0,0.5097020142727117,0.49029798572728833
89104,0.4081632653061224,0.6363636363636364,145,-175,0.3899890197266291,0.6100109802733709,home,MIA,under,9,0.5121951219512195,-105,0.49029798572728833,MIA,ATL,2023 REG,13,9,11,6,15,24,1,0,3,-3,1,1,1,1,1,1,0,0,0,0.5097020142727117,0.49029798572728833
89110,0.574468085106383,0.46511627906976744,-135,115,0.5517281312179562,0.44827186878204384,away,BOS,over,8,0.5145631067961165,-106,0.4913668392989033,CLE,BOS,2023 REG,11,5,5,2,7,16,1,0,3,-3,1,1,0,0,0,0,0,0,0,0.4913668392989033,0.5086331607010968
89110,0.574468085106383,0.46511627906976744,-135,115,0.5517281312179562,0.44827186878204384,home,CLE,under,8,0.5305164319248826,-113,0.5086331607010968,CLE,BOS,2023 REG,11,5,5,2,7,16,1,0,3,-3,1,1,0,0,0,0,0,0,0,0.4913668392989033,0.5086331607010968
89113,0.5283018867924528,0.5121951219512195,-112,-105,0.5069072406637203,0.4930927593362797,away,CLE,over,8.5,0.5348837209302326,-115,0.5097020142727117,PIT,CLE,2023 REG,5,1,13,10,11,18,0,1,-9,9,1,0,0,0,0,0,0,0,0,0.5097020142727117,0.49029798572728833
89113,0.5283018867924528,0.5121951219512195,-112,-105,0.5069072406637203,0.4930927593362797,home,PIT,under,8.5,0.5121951219512195,-105,0.49029798572728833,PIT,CLE,2023 REG,5,1,13,10,11,18,0,1,-9,9,1,0,0,0,0,0,0,0,0,0.5097020142727117,0.49029798572728833
89117,0.607843137254902,0.4291845493562232,-155,133,0.5853361120599043,0.4146638879400957,away,CWS,over,7.5,0.5348837209302326,-115,0.5109810284308424,SEA,CWS,2023 REG,5,5,6,1,6,11,1,0,4,-4,1,0,0,0,0,0,0,0,0,0.5109810284308424,0.48901897156915763
89117,0.607843137254902,0.4291845493562232,-155,133,0.5853361120599043,0.4146638879400957,home,SEA,under,7.5,0.5098039215686274,-104,0.48901897156915763,SEA,CWS,2023 REG,5,5,6,1,6,11,1,0,4,-4,1,0,0,0,0,0,0,0,0,0.5109810284308424,0.48901897156915763
89128,0.5652173913043479,0.4716981132075471,-130,112,0.5443521061454507,0.4556478938545493,away,TB,over,7.5,0.49504950495049505,102,0.4739797934813417,SEA,TB,2023 REG,10,7,7,6,13,17,1,0,1,-1,1,1,1,1,1,1,0,0,0,0.4739797934813417,0.5260202065186583
89128,0.5652173913043479,0.4716981132075471,-130,112,0.5443521061454507,0.4556478938545493,home,SEA,under,7.5,0.5475113122171946,-121,0.5260202065186583,SEA,TB,2023 REG,10,7,7,6,13,17,1,0,1,-1,1,1,1,1,1,1,0,0,0,0.4739797934813417,0.5260202065186583
89139,0.6875,0.35714285714285715,-220,180,0.6568080357142857,0.3431919642857143,away,WSH,over,8.5,0.5121951219512195,-105,0.48808156828023186,MIA,WSH,2023 REG,9,4,13,7,11,22,0,1,-3,3,1,1,1,1,0,0,0,0,0,0.48808156828023186,0.5119184317197681
89139,0.6875,0.35714285714285715,-220,180,0.6568080357142857,0.3431919642857143,home,MIA,under,8.5,0.5348837209302326,-115,0.5119184317197681,MIA,WSH,2023 REG,9,4,13,7,11,22,0,1,-3,3,1,1,1,1,0,0,0,0,0,0.48808156828023186,0.5119184317197681
89140,0.6491228070175439,0.3921568627450981,-185,155,0.6223272319084604,0.3776727680915396,away,SF,over,9,0.49751243781094534,101,0.47511256217505476,LAD,SF,2023 REG,9,7,3,2,9,12,1,0,5,-5,1,1,0,0,0,0,0,0,0,0.47511256217505476,0.5248874378249453
89140,0.6491228070175439,0.3921568627450981,-185,155,0.6223272319084604,0.3776727680915396,home,LAD,under,9,0.5475113122171946,-121,0.5248874378249453,LAD,SF,2023 REG,9,7,3,2,9,12,1,0,5,-5,1,1,0,0,0,0,0,0,0,0.47511256217505476,0.5248874378249453
89141,0.6610169491525424,0.37878787878787884,-195,164,0.6347052832258232,0.3652947167741768,away,KC,over,8,0.5327102803738317,-114,0.5075272610403079,SEA,KC,2023 REG,16,7,10,5,12,26,1,0,2,-2,1,1,1,1,1,0,0,0,0,0.5075272610403079,0.4924727389596921
89141,0.6610169491525424,0.37878787878787884,-195,164,0.6347052832258232,0.3652947167741768,home,SEA,under,8,0.5145631067961165,-106,0.4924727389596921,SEA,KC,2023 REG,16,7,10,5,12,26,1,0,2,-2,1,1,1,1,1,0,0,0,0,0.5075272610403079,0.4924727389596921
89149,0.6363636363636364,0.40322580645161293,-175,148,0.6111703545721141,0.3888296454278859,away,OAK,over,8,0.5121951219512195,-105,0.48808156828023186,DET,OAK,2023 REG,6,0,2,1,1,8,0,1,-1,1,0,0,0,0,0,0,0,0,0,0.48808156828023186,0.5119184317197681
89149,0.6363636363636364,0.40322580645161293,-175,148,0.6111703545721141,0.3888296454278859,home,DET,under,8,0.5348837209302326,-115,0.5119184317197681,DET,OAK,2023 REG,6,0,2,1,1,8,0,1,-1,1,0,0,0,0,0,0,0,0,0,0.48808156828023186,0.5119184317197681
89153,0.46511627906976744,0.5798319327731092,115,-138,0.44421013402656906,0.5557898659734309,away,NYM,over,13,0.5215311004784688,-109,0.49670754937970685,COL,NYM,2023 REG,15,11,14,10,21,29,1,0,1,-1,1,1,1,1,1,1,1,1,1,0.49670754937970685,0.5032924506202932
89153,0.46511627906976744,0.5798319327731092,115,-138,0.44421013402656906,0.5557898659734309,home,COL,under,13,0.5260663507109005,-111,0.5032924506202932,COL,NYM,2023 REG,15,11,14,10,21,29,1,0,1,-1,1,1,1,1,1,1,1,1,1,0.49670754937970685,0.5032924506202932
89156,0.5192307692307692,0.5238095238095238,-108,-110,0.49688292476754015,0.5031170752324599,away,MIA,over,8.5,0.5348837209302326,-115,0.5097020142727117,STL,MIA,2023 REG,11,6,12,4,10,23,1,0,2,-2,1,1,1,1,0,0,0,0,0,0.5097020142727117,0.49029798572728833
89156,0.5192307692307692,0.5238095238095238,-108,-110,0.49688292476754015,0.5031170752324599,home,STL,under,8.5,0.5121951219512195,-105,0.49029798572728833,STL,MIA,2023 REG,11,6,12,4,10,23,1,0,2,-2,1,1,1,1,0,0,0,0,0,0.5097020142727117,0.49029798572728833
89157,0.4854368932038835,0.5535714285714286,106,-124,0.4665008146721786,0.5334991853278215,away,TB,over,9,0.5238095238095238,-110,0.4988662131519274,TEX,TB,2023 REG,6,3,5,2,5,11,1,0,1,-1,1,1,0,0,0,0,0,0,0,0.4988662131519274,0.5011337868480725
89157,0.4854368932038835,0.5535714285714286,106,-124,0.4665008146721786,0.5334991853278215,home,TEX,under,9,0.5238095238095238,-110,0.5011337868480725,TEX,TB,2023 REG,6,3,5,2,5,11,1,0,1,-1,1,1,0,0,0,0,0,0,0,0.4988662131519274,0.5011337868480725
89158,0.6428571428571428,0.4,-180,150,0.6153061224489796,0.38469387755102036,away,SF,over,9,0.5348837209302326,-115,0.5097020142727117,LAD,SF,2023 REG,6,3,8,2,5,14,1,0,1,-1,1,1,0,0,0,0,0,0,0,0.5097020142727117,0.49029798572728833
89158,0.6428571428571428,0.4,-180,150,0.6153061224489796,0.38469387755102036,home,LAD,under,9,0.5121951219512195,-105,0.49029798572728833,LAD,SF,2023 REG,6,3,8,2,5,14,1,0,1,-1,1,1,0,0,0,0,0,0,0,0.5097020142727117,0.49029798572728833
89159,0.5370370370370371,0.5,-116,100,0.5171467764060357,0.4828532235939643,away,TOR,over,7.5,0.5454545454545454,-120,0.5206611570247933,MIA,TOR,2023 REG,6,0,7,2,2,13,0,1,-2,2,0,0,0,0,0,0,0,0,0,0.5206611570247933,0.4793388429752067
89159,0.5370370370370371,0.5,-116,100,0.5171467764060357,0.4828532235939643,home,MIA,under,7.5,0.5,100,0.4793388429752067,MIA,TOR,2023 REG,6,0,7,2,2,13,0,1,-2,2,0,0,0,0,0,0,0,0,0,0.5206611570247933,0.4793388429752067
89160,0.6226415094339623,0.4166666666666667,-165,140,0.5981666073335706,0.40183339266642937,away,TOR,over,10.5,0.5305164319248826,-113,0.5066009958897986,BOS,TOR,2023 REG,6,3,14,7,10,20,0,1,-4,4,1,1,1,0,0,0,0,0,0,0.5066009958897986,0.49339900411020143
89160,0.6226415094339623,0.4166666666666667,-165,140,0.5981666073335706,0.40183339266642937,home,BOS,under,10.5,0.5145631067961165,-106,0.49339900411020143,BOS,TOR,2023 REG,6,3,14,7,10,20,0,1,-4,4,1,1,1,0,0,0,0,0,0,0.5066009958897986,0.49339900411020143
89164,0.49504950495049505,0.5495495495495495,102,-122,0.47297076509898783,0.5270292349010122,away,MIN,over,9,0.5192307692307692,-108,0.49455035168025013,PHI,MIN,2023 REG,9,1,11,8,9,20,0,1,-7,7,1,0,0,0,0,0,0,0,0,0.49455035168025013,0.5054496483197499
89164,0.49504950495049505,0.5495495495495495,102,-122,0.47297076509898783,0.5270292349010122,home,PHI,under,9,0.5283018867924528,-112,0.5054496483197499,PHI,MIN,2023 REG,9,1,11,8,9,20,0,1,-7,7,1,0,0,0,0,0,0,0,0,0.49455035168025013,0.5054496483197499
89165,0.4347826086956522,0.607843137254902,130,-155,0.41624967567367205,0.583750324326328,away,SEA,over,9,0.504950495049505,-102,0.48160416005266615,NYM,SEA,2023 REG,10,6,6,3,9,16,1,0,3,-3,1,1,1,0,0,0,0,0,0,0.48160416005266615,0.5183958399473338
89165,0.4347826086956522,0.607843137254902,130,-155,0.41624967567367205,0.583750324326328,home,NYM,under,9,0.5412844036697247,-118,0.5183958399473338,NYM,SEA,2023 REG,10,6,6,3,9,16,1,0,3,-3,1,1,1,0,0,0,0,0,0,0.48160416005266615,0.5183958399473338
89166,0.5215311004784688,0.5238095238095238,-109,-110,0.4978845547971712,0.5021154452028288,away,CHC,over,9,0.5121951219512195,-105,0.48808156828023186,MIL,CHC,2023 REG,8,8,10,6,14,18,1,0,2,-2,1,1,1,1,1,1,0,0,0,0.48808156828023186,0.5119184317197681
89166,0.5215311004784688,0.5238095238095238,-109,-110,0.4978845547971712,0.5021154452028288,home,MIL,under,9,0.5348837209302326,-115,0.5119184317197681,MIL,CHC,2023 REG,8,8,10,6,14,18,1,0,2,-2,1,1,1,1,1,1,0,0,0,0.48808156828023186,0.5119184317197681
89169,0.6296296296296295,0.4065040650406504,-170,146,0.606878784837231,0.393121215162769,away,KC,over,9.5,0.5238095238095238,-110,0.4988662131519274,MIL,KC,2023 REG,6,9,8,6,15,14,1,0,3,-3,1,1,1,1,1,1,0,0,0,0.4988662131519274,0.5011337868480725
89169,0.6296296296296295,0.4065040650406504,-170,146,0.606878784837231,0.393121215162769,home,MIL,under,9.5,0.5238095238095238,-110,0.5011337868480725,MIL,KC,2023 REG,6,9,8,6,15,14,1,0,3,-3,1,1,1,1,1,1,0,0,0,0.4988662131519274,0.5011337868480725
89174,0.5454545454545454,0.5,-120,100,0.5206611570247933,0.4793388429752067,away,PIT,over,9.5,0.5,100,0.4772727272727273,LAA,PIT,2023 REG,10,7,10,5,12,20,1,0,2,-2,1,1,1,1,1,0,0,0,0,0.4772727272727273,0.5227272727272727
89174,0.5454545454545454,0.5,-120,100,0.5206611570247933,0.4793388429752067,home,LAA,under,9.5,0.5454545454545454,-120,0.5227272727272727,LAA,PIT,2023 REG,10,7,10,5,12,20,1,0,2,-2,1,1,1,1,1,0,0,0,0,0.4772727272727273,0.5227272727272727
89176,0.41152263374485604,0.6296296296296295,143,-170,0.39458754593642575,0.6054124540635742,away,TOR,over,7.5,0.5238095238095238,-110,0.4988662131519274,OAK,TOR,2023 REG,8,5,6,2,7,14,1,0,3,-3,1,1,0,0,0,0,0,0,0,0.4988662131519274,0.5011337868480725
89176,0.41152263374485604,0.6296296296296295,143,-170,0.39458754593642575,0.6054124540635742,home,OAK,under,7.5,0.5238095238095238,-110,0.5011337868480725,OAK,TOR,2023 REG,8,5,6,2,7,14,1,0,3,-3,1,1,0,0,0,0,0,0,0,0.4988662131519274,0.5011337868480725
89177,0.5850622406639003,0.45454545454545453,-141,120,0.5618892737571823,0.43811072624281766,away,ARI,over,7,0.5454545454545454,-120,0.5206611570247933,CHC,ARI,2023 REG,8,2,8,3,5,16,0,1,-1,1,1,1,0,0,0,0,0,0,0,0.5206611570247933,0.4793388429752067
89177,0.5850622406639003,0.45454545454545453,-141,120,0.5618892737571823,0.43811072624281766,home,CHC,under,7,0.5,100,0.4793388429752067,CHC,ARI,2023 REG,8,2,8,3,5,16,0,1,-1,1,1,1,0,0,0,0,0,0,0,0.5206611570247933,0.4793388429752067
89180,0.425531914893617,0.607843137254902,135,-155,0.4113297650431834,0.5886702349568166,away,LAD,over,7.5,0.5,100,0.4772727272727273,SF,LAD,2023 REG,7,1,9,9,10,16,0,1,-8,8,1,0,0,0,0,0,0,0,0,0.4772727272727273,0.5227272727272727
89180,0.425531914893617,0.607843137254902,135,-155,0.4113297650431834,0.5886702349568166,home,SF,under,7.5,0.5454545454545454,-120,0.5227272727272727,SF,LAD,2023 REG,7,1,9,9,10,16,0,1,-8,8,1,0,0,0,0,0,0,0,0,0.4772727272727273,0.5227272727272727
89182,0.5815899581589958,0.45454545454545453,-139,120,0.5605739649961564,0.4394260350038436,away,COL,over,8.5,0.5215311004784688,-109,0.4978845547971712,PIT,COL,2023 REG,6,3,8,4,7,14,0,1,-1,1,1,1,1,0,0,0,0,0,0,0.4978845547971712,0.5021154452028288
89182,0.5815899581589958,0.45454545454545453,-139,120,0.5605739649961564,0.4394260350038436,home,PIT,under,8.5,0.5238095238095238,-110,0.5021154452028288,PIT,COL,2023 REG,6,3,8,4,7,14,0,1,-1,1,1,1,1,0,0,0,0,0,0,0.4978845547971712,0.5021154452028288
89183,0.4347826086956522,0.6031746031746031,130,-152,0.418279473099889,0.581720526900111,away,CHC,over,10,0.5348837209302326,-115,0.5097020142727117,CIN,CHC,2023 REG,11,7,18,15,22,29,0,1,-8,8,1,1,1,1,1,1,1,0,0,0.5097020142727117,0.49029798572728833
89183,0.4347826086956522,0.6031746031746031,130,-152,0.418279473099889,0.581720526900111,home,CIN,under,10,0.5121951219512195,-105,0.49029798572728833,CIN,CHC,2023 REG,11,7,18,15,22,29,0,1,-8,8,1,1,1,1,1,1,1,0,0,0.5097020142727117,0.49029798572728833
89184,0.7206703910614525,0.3225806451612903,-258,210,0.6895006498729954,0.3104993501270046,away,WSH,over,9,0.5121951219512195,-105,0.48808156828023186,PHI,WSH,2023 REG,6,6,10,2,8,16,1,0,4,-4,1,1,0,0,0,0,0,0,0,0.48808156828023186,0.5119184317197681
89184,0.7206703910614525,0.3225806451612903,-258,210,0.6895006498729954,0.3104993501270046,home,PHI,under,9,0.5348837209302326,-115,0.5119184317197681,PHI,WSH,2023 REG,6,6,10,2,8,16,1,0,4,-4,1,1,0,0,0,0,0,0,0,0.48808156828023186,0.5119184317197681
89185,0.4608294930875576,0.5780590717299579,117,-137,0.44290849547579936,0.5570915045242006,away,LAD,over,9,0.5121951219512195,-105,0.48808156828023186,BAL,LAD,2023 REG,10,8,7,5,13,17,1,0,3,-3,1,1,1,1,1,0,0,0,0,0.48808156828023186,0.5119184317197681
89185,0.4608294930875576,0.5780590717299579,117,-137,0.44290849547579936,0.5570915045242006,home,BAL,under,9,0.5348837209302326,-115,0.5119184317197681,BAL,LAD,2023 REG,10,8,7,5,13,17,1,0,3,-3,1,1,1,1,1,0,0,0,0,0.48808156828023186,0.5119184317197681
89187,0.5238095238095238,0.5192307692307692,-110,-108,0.5012646084074657,0.4987353915925343,away,SD,over,7,0.5515695067264574,-123,0.5258558814517258,CHC,SD,2023 REG,7,6,5,0,6,12,1,0,6,-6,0,0,0,0,0,0,0,0,0,0.5258558814517258,0.4741441185482742
89187,0.5238095238095238,0.5192307692307692,-110,-108,0.5012646084074657,0.4987353915925343,home,CHC,under,7,0.49504950495049505,102,0.4741441185482742,CHC,SD,2023 REG,7,6,5,0,6,12,1,0,6,-6,0,0,0,0,0,0,0,0,0,0.5258558814517258,0.4741441185482742
89188,0.45454545454545453,0.5833333333333333,120,-140,0.43732782369146006,0.5626721763085399,away,SF,over,11,0.5121951219512195,-105,0.48808156828023186,CIN,SF,2023 REG,14,10,11,11,21,25,0,1,-1,1,1,1,1,1,1,1,1,1,1,0.48808156828023186,0.5119184317197681
89188,0.45454545454545453,0.5833333333333333,120,-140,0.43732782369146006,0.5626721763085399,home,CIN,under,11,0.5348837209302326,-115,0.5119184317197681,CIN,SF,2023 REG,14,10,11,11,21,25,0,1,-1,1,1,1,1,1,1,1,1,1,1,0.48808156828023186,0.5119184317197681
89190,0.5,0.5391705069124424,100,-117,0.4804147465437788,0.5195852534562212,away,CIN,over,10.5,0.5238095238095238,-110,0.4988662131519274,WSH,CIN,2023 REG,8,2,7,3,5,15,0,1,-1,1,1,1,0,0,0,0,0,0,0,0.4988662131519274,0.5011337868480725
89190,0.5,0.5391705069124424,100,-117,0.4804147465437788,0.5195852534562212,home,WSH,under,10.5,0.5238095238095238,-110,0.5011337868480725,WSH,CIN,2023 REG,8,2,7,3,5,15,0,1,-1,1,1,1,0,0,0,0,0,0,0,0.4988662131519274,0.5011337868480725
89192,0.75,0.29411764705882354,-300,240,0.7169117647058822,0.28308823529411775,away,DET,over,9,0.5121951219512195,-105,0.48919479393107135,TOR,DET,2023 REG,9,4,6,3,7,15,1,0,1,-1,1,1,1,0,0,0,0,0,0,0.48919479393107135,0.5108052060689287
89192,0.75,0.29411764705882354,-300,240,0.7169117647058822,0.28308823529411775,home,TOR,under,9,0.5327102803738317,-114,0.5108052060689287,TOR,DET,2023 REG,9,4,6,3,7,15,1,0,1,-1,1,1,1,0,0,0,0,0,0,0.48919479393107135,0.5108052060689287
89193,0.5555555555555556,0.48780487804878053,-125,105,0.5314664257753688,0.46853357422463116,away,SD,over,9,0.5,100,0.4772727272727273,TOR,SD,2023 REG,6,0,8,2,2,14,0,1,-2,2,0,0,0,0,0,0,0,0,0,0.4772727272727273,0.5227272727272727
89193,0.5555555555555556,0.48780487804878053,-125,105,0.5314664257753688,0.46853357422463116,home,TOR,under,9,0.5454545454545454,-120,0.5227272727272727,TOR,SD,2023 REG,6,0,8,2,2,14,0,1,-2,2,0,0,0,0,0,0,0,0,0,0.4772727272727273,0.5227272727272727
89194,0.5708154506437768,0.4694835680751174,-133,113,0.5478121481132493,0.4521878518867507,away,BAL,over,8.5,0.5238095238095238,-110,0.4988662131519274,TOR,BAL,2023 REG,3,4,7,1,5,10,1,0,3,-3,1,0,0,0,0,0,0,0,0,0.4988662131519274,0.5011337868480725
89194,0.5708154506437768,0.4694835680751174,-133,113,0.5478121481132493,0.4521878518867507,home,TOR,under,8.5,0.5238095238095238,-110,0.5011337868480725,TOR,BAL,2023 REG,3,4,7,1,5,10,1,0,3,-3,1,0,0,0,0,0,0,0,0,0.4988662131519274,0.5011337868480725
89195,0.5,0.5454545454545454,100,-120,0.4772727272727273,0.5227272727272727,away,ATL,over,9,0.5,100,0.4772727272727273,SD,ATL,2023 REG,6,1,4,0,1,10,1,0,1,-1,0,0,0,0,0,0,0,0,0,0.4772727272727273,0.5227272727272727
89195,0.5,0.5454545454545454,100,-120,0.4772727272727273,0.5227272727272727,home,SD,under,9,0.5454545454545454,-120,0.5227272727272727,SD,ATL,2023 REG,6,1,4,0,1,10,1,0,1,-1,0,0,0,0,0,0,0,0,0,0.4772727272727273,0.5227272727272727
89196,0.5594713656387665,0.47619047619047616,-127,110,0.5395195862893665,0.46048041371063353,away,CWS,over,12,0.5145631067961165,-106,0.49023796582517226,COL,CWS,2023 REG,13,14,4,1,15,17,1,0,13,-13,1,0,0,0,0,0,0,0,0,0.49023796582517226,0.5097620341748277
89196,0.5594713656387665,0.47619047619047616,-127,110,0.5395195862893665,0.46048041371063353,home,COL,under,12,0.5327102803738317,-114,0.5097620341748277,COL,CWS,2023 REG,13,14,4,1,15,17,1,0,13,-13,1,0,0,0,0,0,0,0,0,0.49023796582517226,0.5097620341748277
89198,0.3125,0.7275204359673024,220,-267,0.299993613760218,0.7000063862397821,away,ATL,over,9,0.5145631067961165,-106,0.4913668392989033,DET,ATL,2023 REG,15,6,8,5,11,23,1,0,1,-1,1,1,1,1,1,0,0,0,0,0.4913668392989033,0.5086331607010968
89198,0.3125,0.7275204359673024,220,-267,0.299993613760218,0.7000063862397821,home,DET,under,9,0.5305164319248826,-113,0.5086331607010968,DET,ATL,2023 REG,15,6,8,5,11,23,1,0,1,-1,1,1,1,1,1,0,0,0,0,0.4913668392989033,0.5086331607010968
89204,0.32573289902280134,0.7159090909090909,207,-252,0.3121687329212078,0.6878312670787923,away,LAD,over,9,0.5348837209302326,-115,0.5097020142727117,ARI,LAD,2023 REG,10,6,5,3,9,15,1,0,3,-3,1,1,1,0,0,0,0,0,0,0.5097020142727117,0.49029798572728833
89204,0.32573289902280134,0.7159090909090909,207,-252,0.3121687329212078,0.6878312670787923,home,ARI,under,9,0.5121951219512195,-105,0.49029798572728833,ARI,LAD,2023 REG,10,6,5,3,9,15,1,0,3,-3,1,1,1,0,0,0,0,0,0,0.5097020142727117,0.49029798572728833
89205,0.5238095238095238,0.5192307692307692,-110,-108,0.5012646084074657,0.4987353915925343,away,HOU,over,9,0.504950495049505,-102,0.4826715732667395,TEX,HOU,2023 REG,8,1,20,14,15,28,0,1,-13,13,1,0,0,0,0,0,0,0,0,0.4826715732667395,0.5173284267332605
89205,0.5238095238095238,0.5192307692307692,-110,-108,0.5012646084074657,0.4987353915925343,home,TEX,under,9,0.5391705069124424,-117,0.5173284267332605,TEX,HOU,2023 REG,8,1,20,14,15,28,0,1,-13,13,1,0,0,0,0,0,0,0,0,0.4826715732667395,0.5173284267332605
89207,0.7014925373134329,0.3401360544217687,-235,194,0.6722903908723213,0.32770960912767866,away,ARI,over,10,0.5169082125603864,-107,0.49239402434819424,ATL,ARI,2023 REG,4,3,9,5,8,13,0,1,-2,2,1,1,1,0,0,0,0,0,0,0.49239402434819424,0.5076059756518058
89207,0.7014925373134329,0.3401360544217687,-235,194,0.6722903908723213,0.32770960912767866,home,ATL,under,10,0.5305164319248826,-113,0.5076059756518058,ATL,ARI,2023 REG,4,3,9,5,8,13,0,1,-2,2,1,1,1,0,0,0,0,0,0,0.49239402434819424,0.5076059756518058
89210,0.6825396825396826,0.35714285714285715,-215,180,0.6554547745023935,0.34454522549760647,away,COL,over,8,0.5348837209302326,-115,0.5097020142727117,CLE,COL,2023 REG,6,1,8,5,6,14,0,1,-4,4,1,0,0,0,0,0,0,0,0,0.5097020142727117,0.49029798572728833
89210,0.6825396825396826,0.35714285714285715,-215,180,0.6554547745023935,0.34454522549760647,home,CLE,under,8,0.5121951219512195,-105,0.49029798572728833,CLE,COL,2023 REG,6,1,8,5,6,14,0,1,-4,4,1,0,0,0,0,0,0,0,0,0.5097020142727117,0.49029798572728833
89212,0.5798319327731092,0.4587155963302753,-138,118,0.557480844469466,0.442519155530534,away,NYM,over,10,0.5121951219512195,-105,0.48808156828023186,ARI,NYM,2023 REG,4,0,17,9,9,21,0,1,-9,9,0,0,0,0,0,0,0,0,0,0.48808156828023186,0.5119184317197681
89212,0.5798319327731092,0.4587155963302753,-138,118,0.557480844469466,0.442519155530534,home,ARI,under,10,0.5348837209302326,-115,0.5119184317197681,ARI,NYM,2023 REG,4,0,17,9,9,21,0,1,-9,9,0,0,0,0,0,0,0,0,0,0.48808156828023186,0.5119184317197681
89213,0.5867768595041323,0.45454545454545453,-142,120,0.5625298818386723,0.43747011816132775,away,STL,over,8,0.5454545454545454,-120,0.5206611570247933,MIL,STL,2023 REG,7,3,8,2,5,15,1,0,1,-1,1,1,0,0,0,0,0,0,0,0.5206611570247933,0.4793388429752067
89213,0.5867768595041323,0.45454545454545453,-142,120,0.5625298818386723,0.43747011816132775,home,MIL,under,8,0.5,100,0.4793388429752067,MIL,STL,2023 REG,7,3,8,2,5,15,1,0,1,-1,1,1,0,0,0,0,0,0,0,0.5206611570247933,0.4793388429752067
89216,0.39840637450199207,0.6453900709219857,151,-182,0.38095759146455066,0.6190424085354493,away,ATL,over,9,0.504950495049505,-102,0.47949844489399435,CHC,ATL,2023 REG,4,0,11,8,8,15,0,1,-8,8,0,0,0,0,0,0,0,0,0,0.47949844489399435,0.5205015551060057
89216,0.39840637450199207,0.6453900709219857,151,-182,0.38095759146455066,0.6190424085354493,home,CHC,under,9,0.5454545454545454,-120,0.5205015551060057,CHC,ATL,2023 REG,4,0,11,8,8,15,0,1,-8,8,0,0,0,0,0,0,0,0,0,0.47949844489399435,0.5205015551060057
89217,0.646643109540636,0.38759689922480617,-183,158,0.6245020438018518,0.3754979561981482,away,BOS,over,9.5,0.5348837209302326,-115,0.5109810284308424,ATL,BOS,2023 REG,12,9,8,3,12,20,1,0,6,-6,1,1,1,0,0,0,0,0,0,0.5109810284308424,0.48901897156915763
89217,0.646643109540636,0.38759689922480617,-183,158,0.6245020438018518,0.3754979561981482,home,ATL,under,9.5,0.5098039215686274,-104,0.48901897156915763,ATL,BOS,2023 REG,12,9,8,3,12,20,1,0,6,-6,1,1,1,0,0,0,0,0,0,0.5109810284308424,0.48901897156915763
89218,0.425531914893617,0.607843137254902,135,-155,0.4113297650431834,0.5886702349568166,away,ATL,over,8,0.5348837209302326,-115,0.5097020142727117,TB,ATL,2023 REG,4,1,7,6,7,11,0,1,-5,5,1,0,0,0,0,0,0,0,0,0.5097020142727117,0.49029798572728833
89218,0.425531914893617,0.607843137254902,135,-155,0.4113297650431834,0.5886702349568166,home,TB,under,8,0.5121951219512195,-105,0.49029798572728833,TB,ATL,2023 REG,4,1,7,6,7,11,0,1,-5,5,1,0,0,0,0,0,0,0,0,0.5097020142727117,0.49029798572728833
89220,0.6062992125984252,0.43103448275862066,-154,132,0.5836638225000588,0.41633617749994123,away,LAA,over,10,0.5348837209302326,-115,0.5097020142727117,TEX,LAA,2023 REG,12,6,10,9,15,22,0,1,-3,3,1,1,1,1,1,1,0,0,0,0.5097020142727117,0.49029798572728833
89220,0.6062992125984252,0.43103448275862066,-154,132,0.5836638225000588,0.41633617749994123,home,TEX,under,10,0.5121951219512195,-105,0.49029798572728833,TEX,LAA,2023 REG,12,6,10,9,15,22,0,1,-3,3,1,1,1,1,1,1,0,0,0,0.5097020142727117,0.49029798572728833
89221,0.46511627906976744,0.574468085106383,115,-135,0.44670494689481377,0.5532950531051862,away,TOR,over,8,0.5412844036697247,-118,0.5149381613977361,BAL,TOR,2023 REG,10,7,5,0,7,15,1,0,7,-7,0,0,0,0,0,0,0,0,0,0.5149381613977361,0.48506183860226393
89221,0.46511627906976744,0.574468085106383,115,-135,0.44670494689481377,0.5532950531051862,home,BAL,under,8,0.5073891625615764,-103,0.48506183860226393,BAL,TOR,2023 REG,10,7,5,0,7,15,1,0,7,-7,0,0,0,0,0,0,0,0,0,0.5149381613977361,0.48506183860226393
89223,0.5,0.5412844036697247,100,-118,0.47935779816513757,0.5206422018348624,away,ATL,over,8.5,0.5121951219512195,-105,0.48808156828023186,LAD,ATL,2023 REG,6,3,14,6,9,20,0,1,-3,3,1,1,1,0,0,0,0,0,0,0.48808156828023186,0.5119184317197681
89223,0.5,0.5412844036697247,100,-118,0.47935779816513757,0.5206422018348624,home,LAD,under,8.5,0.5348837209302326,-115,0.5119184317197681,LAD,ATL,2023 REG,6,3,14,6,9,20,0,1,-3,3,1,1,1,0,0,0,0,0,0,0.48808156828023186,0.5119184317197681
89226,0.5073891625615764,0.5348837209302326,-103,-115,0.4859403596076043,0.5140596403923957,away,MIL,over,12,0.5238095238095238,-110,0.5012646084074657,COL,MIL,2023 REG,10,7,5,1,8,15,1,0,6,-6,1,0,0,0,0,0,0,0,0,0.5012646084074657,0.4987353915925343
89226,0.5073891625615764,0.5348837209302326,-103,-115,0.4859403596076043,0.5140596403923957,home,COL,under,12,0.5192307692307692,-108,0.4987353915925343,COL,MIL,2023 REG,10,7,5,1,8,15,1,0,6,-6,1,0,0,0,0,0,0,0,0,0.5012646084074657,0.4987353915925343
89227,0.4629629629629629,0.5798319327731092,116,-138,0.44315051123329985,0.5568494887667002,away,CHC,over,9,0.5391705069124424,-117,0.5153817639191344,NYM,CHC,2023 REG,6,2,8,3,5,14,0,1,-1,1,1,1,0,0,0,0,0,0,0,0.5153817639191344,0.4846182360808656
89227,0.4629629629629629,0.5798319327731092,116,-138,0.44315051123329985,0.5568494887667002,home,NYM,under,9,0.504950495049505,-102,0.4846182360808656,NYM,CHC,2023 REG,6,2,8,3,5,14,0,1,-1,1,1,1,0,0,0,0,0,0,0,0.5153817639191344,0.4846182360808656
89228,0.6124031007751938,0.425531914893617,-158,135,0.5891715795516586,0.41082842044834145,away,DET,over,8.5,0.5454545454545454,-120,0.5206611570247933,MIA,DET,2023 REG,7,0,8,5,5,15,0,1,-5,5,0,0,0,0,0,0,0,0,0,0.5206611570247933,0.4793388429752067
89228,0.6124031007751938,0.425531914893617,-158,135,0.5891715795516586,0.41082842044834145,home,MIA,under,8.5,0.5,100,0.4793388429752067,MIA,DET,2023 REG,7,0,8,5,5,15,0,1,-5,5,0,0,0,0,0,0,0,0,0,0.5206611570247933,0.4793388429752067
89230,0.7340425531914894,0.3076923076923077,-276,225,0.7034073893512554,0.29659261064874465,away,OAK,over,7.5,0.5215311004784688,-109,0.4978845547971712,TB,OAK,2023 REG,10,9,12,5,14,22,1,0,4,-4,1,1,1,1,1,0,0,0,0,0.4978845547971712,0.5021154452028288
89230,0.7340425531914894,0.3076923076923077,-276,225,0.7034073893512554,0.29659261064874465,home,TB,under,7.5,0.5238095238095238,-110,0.5021154452028288,TB,OAK,2023 REG,10,9,12,5,14,22,1,0,4,-4,1,1,1,1,1,0,0,0,0,0.4978845547971712,0.5021154452028288
89231,0.4444444444444444,0.5918367346938775,125,-145,0.42831947593852354,0.5716805240614764,away,BAL,over,9,0.5,100,0.4772727272727273,WSH,BAL,2023 REG,5,0,5,1,1,10,0,1,-1,1,0,0,0,0,0,0,0,0,0,0.4772727272727273,0.5227272727272727
89231,0.4444444444444444,0.5918367346938775,125,-145,0.42831947593852354,0.5716805240614764,home,WSH,under,9,0.5454545454545454,-120,0.5227272727272727,WSH,BAL,2023 REG,5,0,5,1,1,10,0,1,-1,1,0,0,0,0,0,0,0,0,0,0.4772727272727273,0.5227272727272727
89232,0.6363636363636364,0.4081632653061224,-175,145,0.6080283353010626,0.3919716646989374,away,CIN,over,7.5,0.5,100,0.4772727272727273,SF,CIN,2023 REG,4,1,11,4,5,15,0,1,-3,3,1,0,0,0,0,0,0,0,0,0.4772727272727273,0.5227272727272727
89232,0.6363636363636364,0.4081632653061224,-175,145,0.6080283353010626,0.3919716646989374,home,SF,under,7.5,0.5454545454545454,-120,0.5227272727272727,SF,CIN,2023 REG,4,1,11,4,5,15,0,1,-3,3,1,0,0,0,0,0,0,0,0,0.4772727272727273,0.5227272727272727
89233,0.5495495495495495,0.49019607843137253,-122,104,0.5277073575960698,0.4722926424039302,away,STL,over,9,0.5238095238095238,-110,0.4988662131519274,CHC,STL,2023 REG,6,2,10,7,9,16,0,1,-5,5,1,1,0,0,0,0,0,0,0,0.4988662131519274,0.5011337868480725
89233,0.5495495495495495,0.49019607843137253,-122,104,0.5277073575960698,0.4722926424039302,home,CHC,under,9,0.5238095238095238,-110,0.5011337868480725,CHC,STL,2023 REG,6,2,10,7,9,16,0,1,-5,5,1,1,0,0,0,0,0,0,0,0.4988662131519274,0.5011337868480725
89234,0.4854368932038835,0.5555555555555556,106,-125,0.465537646233282,0.534462353766718,away,BOS,over,8.5,0.5121951219512195,-105,0.48808156828023186,DET,BOS,2023 REG,9,1,7,4,5,16,0,1,-3,3,1,0,0,0,0,0,0,0,0,0.48808156828023186,0.5119184317197681
89234,0.4854368932038835,0.5555555555555556,106,-125,0.465537646233282,0.534462353766718,home,DET,under,8.5,0.5348837209302326,-115,0.5119184317197681,DET,BOS,2023 REG,9,1,7,4,5,16,0,1,-3,3,1,0,0,0,0,0,0,0,0,0.48808156828023186,0.5119184317197681
89235,0.7041420118343195,0.3389830508474576,-238,195,0.6737758434370918,0.32622415656290815,away,MIL,over,8,0.5412844036697247,-118,0.5162581740877563,LAD,MIL,2023 REG,10,7,3,1,8,13,1,0,6,-6,1,0,0,0,0,0,0,0,0,0.5162581740877563,0.4837418259122437
89235,0.7041420118343195,0.3389830508474576,-238,195,0.6737758434370918,0.32622415656290815,home,LAD,under,8,0.504950495049505,-102,0.4837418259122437,LAD,MIL,2023 REG,10,7,3,1,8,13,1,0,6,-6,1,0,0,0,0,0,0,0,0,0.5162581740877563,0.4837418259122437
89236,0.4347826086956522,0.607843137254902,130,-155,0.41624967567367205,0.583750324326328,away,BAL,over,8.5,0.5348837209302326,-115,0.5097020142727117,LAA,BAL,2023 REG,7,3,12,10,13,19,0,1,-7,7,1,1,1,0,0,0,0,0,0,0.5097020142727117,0.49029798572728833
89236,0.4347826086956522,0.607843137254902,130,-155,0.41624967567367205,0.583750324326328,home,LAA,under,8.5,0.5121951219512195,-105,0.49029798572728833,LAA,BAL,2023 REG,7,3,12,10,13,19,0,1,-7,7,1,1,1,0,0,0,0,0,0,0.5097020142727117,0.49029798572728833
89238,0.7014925373134329,0.3424657534246575,-235,192,0.6706561244076082,0.32934387559239175,away,PIT,over,8.5,0.5121951219512195,-105,0.48808156828023186,MIN,PIT,2023 REG,10,5,9,1,6,19,1,0,4,-4,1,0,0,0,0,0,0,0,0,0.48808156828023186,0.5119184317197681
89238,0.7014925373134329,0.3424657534246575,-235,192,0.6706561244076082,0.32934387559239175,home,MIN,under,8.5,0.5348837209302326,-115,0.5119184317197681,MIN,PIT,2023 REG,10,5,9,1,6,19,1,0,4,-4,1,0,0,0,0,0,0,0,0,0.48808156828023186,0.5119184317197681
89239,0.7297297297297298,0.3125,-270,220,0.6989134404674946,0.3010865595325054,away,COL,over,7.5,0.5238095238095238,-110,0.4988662131519274,MIA,COL,2023 REG,7,3,7,2,5,14,1,0,1,-1,1,1,0,0,0,0,0,0,0,0.4988662131519274,0.5011337868480725
89239,0.7297297297297298,0.3125,-270,220,0.6989134404674946,0.3010865595325054,home,MIA,under,7.5,0.5238095238095238,-110,0.5011337868480725,MIA,COL,2023 REG,7,3,7,2,5,14,1,0,1,-1,1,1,0,0,0,0,0,0,0,0.4988662131519274,0.5011337868480725
89240,0.5652173913043479,0.47619047619047616,-130,110,0.5418129444594474,0.4581870555405526,away,BOS,over,8.5,0.5412844036697247,-118,0.5189377998484975,HOU,BOS,2023 REG,8,7,10,3,10,18,1,0,4,-4,1,1,1,0,0,0,0,0,0,0.5189377998484975,0.4810622001515025
89240,0.5652173913043479,0.47619047619047616,-130,110,0.5418129444594474,0.4581870555405526,home,HOU,under,8.5,0.5,100,0.4810622001515025,HOU,BOS,2023 REG,8,7,10,3,10,18,1,0,4,-4,1,1,1,0,0,0,0,0,0,0.5189377998484975,0.4810622001515025
89242,0.6774193548387096,0.36363636363636365,-210,175,0.6496074165168858,0.3503925834831142,away,COL,over,8.5,0.5121951219512195,-105,0.48808156828023186,MIL,COL,2023 REG,9,3,6,7,10,15,0,1,-4,4,1,1,1,0,0,0,0,0,0,0.48808156828023186,0.5119184317197681
89242,0.6774193548387096,0.36363636363636365,-210,175,0.6496074165168858,0.3503925834831142,home,MIL,under,8.5,0.5348837209302326,-115,0.5119184317197681,MIL,COL,2023 REG,9,3,6,7,10,15,0,1,-4,4,1,1,1,0,0,0,0,0,0,0.48808156828023186,0.5119184317197681
89243,0.574468085106383,0.46511627906976744,-135,115,0.5517281312179562,0.44827186878204384,away,KC,over,9,0.5238095238095238,-110,0.4988662131519274,CWS,KC,2023 REG,5,2,1,0,2,6,1,0,2,-2,0,0,0,0,0,0,0,0,0,0.4988662131519274,0.5011337868480725
89243,0.574468085106383,0.46511627906976744,-135,115,0.5517281312179562,0.44827186878204384,home,CWS,under,9,0.5238095238095238,-110,0.5011337868480725,CWS,KC,2023 REG,5,2,1,0,2,6,1,0,2,-2,0,0,0,0,0,0,0,0,0,0.4988662131519274,0.5011337868480725
89246,0.6855345911949686,0.35714285714285715,-218,180,0.6562777240954528,0.3437222759045472,away,CWS,over,9,0.5348837209302326,-115,0.5097020142727117,BOS,CWS,2023 REG,7,3,7,2,5,14,1,0,1,-1,1,1,0,0,0,0,0,0,0,0.5097020142727117,0.49029798572728833
89246,0.6855345911949686,0.35714285714285715,-218,180,0.6562777240954528,0.3437222759045472,home,BOS,under,9,0.5121951219512195,-105,0.49029798572728833,BOS,CWS,2023 REG,7,3,7,2,5,14,1,0,1,-1,1,1,0,0,0,0,0,0,0,0.5097020142727117,0.49029798572728833
89247,0.5652173913043479,0.47619047619047616,-130,110,0.5418129444594474,0.4581870555405526,away,CIN,over,9.5,0.5,100,0.4772727272727273,MIL,CIN,2023 REG,9,5,13,8,13,22,0,1,-3,3,1,1,1,1,1,0,0,0,0,0.4772727272727273,0.5227272727272727
89247,0.5652173913043479,0.47619047619047616,-130,110,0.5418129444594474,0.4581870555405526,home,MIL,under,9.5,0.5454545454545454,-120,0.5227272727272727,MIL,CIN,2023 REG,9,5,13,8,13,22,0,1,-3,3,1,1,1,1,1,0,0,0,0,0.4772727272727273,0.5227272727272727
89248,0.5024875621890548,0.5370370370370371,-101,-116,0.48262694267743644,0.5173730573225636,away,SEA,over,8.5,0.5238095238095238,-110,0.4988662131519274,LAA,SEA,2023 REG,11,7,14,9,16,25,0,1,-2,2,1,1,1,1,1,1,1,0,0,0.4988662131519274,0.5011337868480725
89248,0.5024875621890548,0.5370370370370371,-101,-116,0.48262694267743644,0.5173730573225636,home,LAA,under,8.5,0.5238095238095238,-110,0.5011337868480725,LAA,SEA,2023 REG,11,7,14,9,16,25,0,1,-2,2,1,1,1,1,1,1,1,0,0,0.4988662131519274,0.5011337868480725
89249,0.6062992125984252,0.4347826086956522,-154,130,0.581391336695717,0.41860866330428304,away,CLE,over,8,0.5121951219512195,-105,0.48808156828023186,MIN,CLE,2023 REG,4,2,7,5,7,11,0,1,-3,3,1,1,0,0,0,0,0,0,0,0.48808156828023186,0.5119184317197681
89249,0.6062992125984252,0.4347826086956522,-154,130,0.581391336695717,0.41860866330428304,home,MIN,under,8,0.5348837209302326,-115,0.5119184317197681,MIN,CLE,2023 REG,4,2,7,5,7,11,0,1,-3,3,1,1,0,0,0,0,0,0,0,0.48808156828023186,0.5119184317197681
89251,0.35714285714285715,0.6875,180,-220,0.3411989795918367,0.6588010204081634,away,BAL,over,8.5,0.5215311004784688,-109,0.4978845547971712,OAK,BAL,2023 REG,12,4,16,9,13,28,0,1,-5,5,1,1,1,1,0,0,0,0,0,0.4978845547971712,0.5021154452028288
89251,0.35714285714285715,0.6875,180,-220,0.3411989795918367,0.6588010204081634,home,OAK,under,8.5,0.5238095238095238,-110,0.5021154452028288,OAK,BAL,2023 REG,12,4,16,9,13,28,0,1,-5,5,1,1,1,1,0,0,0,0,0,0.4978845547971712,0.5021154452028288
89252,0.4329004329004329,0.6047430830039526,131,-153,0.41660453856953006,0.5833954614304699,away,ARI,over,8,0.5145631067961165,-106,0.4913668392989033,TEX,ARI,2023 REG,10,6,9,4,10,19,1,0,2,-2,1,1,1,1,0,0,0,0,0,0.4913668392989033,0.5086331607010968
89252,0.4329004329004329,0.6047430830039526,131,-153,0.41660453856953006,0.5833954614304699,home,TEX,under,8,0.5305164319248826,-113,0.5086331607010968,TEX,ARI,2023 REG,10,6,9,4,10,19,1,0,2,-2,1,1,1,1,0,0,0,0,0,0.4913668392989033,0.5086331607010968
89253,0.5555555555555556,0.48780487804878053,-125,105,0.5314664257753688,0.46853357422463116,away,MIA,over,8,0.5121951219512195,-105,0.48919479393107135,CWS,MIA,2023 REG,11,2,4,1,3,15,1,0,1,-1,1,0,0,0,0,0,0,0,0,0.48919479393107135,0.5108052060689287
89253,0.5555555555555556,0.48780487804878053,-125,105,0.5314664257753688,0.46853357422463116,home,CWS,under,8,0.5327102803738317,-114,0.5108052060689287,CWS,MIA,2023 REG,11,2,4,1,3,15,1,0,1,-1,1,0,0,0,0,0,0,0,0,0.48919479393107135,0.5108052060689287
89254,0.6254681647940076,0.41152263374485604,-167,143,0.6023315979176397,0.3976684020823603,away,BOS,over,8,0.504950495049505,-102,0.4826715732667395,TB,BOS,2023 REG,8,3,5,1,4,13,1,0,2,-2,1,0,0,0,0,0,0,0,0,0.4826715732667395,0.5173284267332605
89254,0.6254681647940076,0.41152263374485604,-167,143,0.6023315979176397,0.3976684020823603,home,TB,under,8,0.5391705069124424,-117,0.5173284267332605,TB,BOS,2023 REG,8,3,5,1,4,13,1,0,2,-2,1,0,0,0,0,0,0,0,0,0.4826715732667395,0.5173284267332605
89255,0.6721311475409836,0.3663003663003663,-205,173,0.6463001300410599,0.3536998699589401,away,MIA,over,8.5,0.5475113122171946,-121,0.5242087833606768,PHI,MIA,2023 REG,8,2,8,3,5,16,0,1,-1,1,1,1,0,0,0,0,0,0,0,0.5242087833606768,0.4757912166393232
89255,0.6721311475409836,0.3663003663003663,-205,173,0.6463001300410599,0.3536998699589401,home,PHI,under,8.5,0.49504950495049505,102,0.4757912166393232,PHI,MIA,2023 REG,8,2,8,3,5,16,0,1,-1,1,1,1,0,0,0,0,0,0,0,0.5242087833606768,0.4757912166393232
89256,0.6108949416342413,0.425531914893617,-157,135,0.5886419592417365,0.41135804075826354,away,STL,over,9,0.5283018867924528,-112,0.5056562298022652,MIL,STL,2023 REG,11,6,6,1,7,17,1,0,5,-5,1,0,0,0,0,0,0,0,0,0.5056562298022652,0.4943437701977348
89256,0.6108949416342413,0.425531914893617,-157,135,0.5886419592417365,0.41135804075826354,home,MIL,under,9,0.5145631067961165,-106,0.4943437701977348,MIL,STL,2023 REG,11,6,6,1,7,17,1,0,5,-5,1,0,0,0,0,0,0,0,0,0.5056562298022652,0.4943437701977348
89257,0.4444444444444444,0.5934959349593496,125,-146,0.42758205359831375,0.5724179464016863,away,PHI,over,9,0.5,100,0.47935779816513757,PIT,PHI,2023 REG,9,6,8,4,10,17,1,0,2,-2,1,1,1,1,0,0,0,0,0,0.47935779816513757,0.5206422018348624
89257,0.4444444444444444,0.5934959349593496,125,-146,0.42758205359831375,0.5724179464016863,home,PIT,under,9,0.5412844036697247,-118,0.5206422018348624,PIT,PHI,2023 REG,9,6,8,4,10,17,1,0,2,-2,1,1,1,1,0,0,0,0,0,0.47935779816513757,0.5206422018348624
89259,0.47619047619047616,0.5652173913043479,110,-130,0.4564724440500838,0.5435275559499162,away,MIN,over,8.5,0.5098039215686274,-104,0.4870219861770517,CLE,MIN,2023 REG,5,2,2,1,3,7,1,0,1,-1,1,0,0,0,0,0,0,0,0,0.4870219861770517,0.5129780138229483
89259,0.47619047619047616,0.5652173913043479,110,-130,0.4564724440500838,0.5435275559499162,home,CLE,under,8.5,0.5348837209302326,-115,0.5129780138229483,CLE,MIN,2023 REG,5,2,2,1,3,7,1,0,1,-1,1,0,0,0,0,0,0,0,0,0.4870219861770517,0.5129780138229483
89261,0.7590361445783133,0.2857142857142857,-315,250,0.7250689505007983,0.27493104949920166,away,KC,over,8,0.5348837209302326,-115,0.5097020142727117,TOR,KC,2023 REG,8,5,2,1,6,10,1,0,4,-4,1,0,0,0,0,0,0,0,0,0.5097020142727117,0.49029798572728833
89261,0.7590361445783133,0.2857142857142857,-315,250,0.7250689505007983,0.27493104949920166,home,TOR,under,8,0.5121951219512195,-105,0.49029798572728833,TOR,KC,2023 REG,8,5,2,1,6,10,1,0,4,-4,1,0,0,0,0,0,0,0,0,0.5097020142727117,0.49029798572728833
89263,0.5370370370370371,0.504950495049505,-116,-102,0.514488177212783,0.48551182278721705,away,ARI,over,8.5,0.5454545454545454,-120,0.5206611570247933,SD,ARI,2023 REG,7,4,9,6,10,16,0,1,-2,2,1,1,1,1,0,0,0,0,0,0.5206611570247933,0.4793388429752067
89263,0.5370370370370371,0.504950495049505,-116,-102,0.514488177212783,0.48551182278721705,home,SD,under,8.5,0.5,100,0.4793388429752067,SD,ARI,2023 REG,7,4,9,6,10,16,0,1,-2,2,1,1,1,1,0,0,0,0,0,0.5206611570247933,0.4793388429752067
89266,0.3333333333333333,0.7101449275362319,200,-245,0.3188405797101449,0.6811594202898551,away,ATL,over,12.5,0.5098039215686274,-104,0.4870219861770517,COL,ATL,2023 REG,9,4,18,14,18,27,0,1,-10,10,1,1,1,1,0,0,0,0,0,0.4870219861770517,0.5129780138229483
89266,0.3333333333333333,0.7101449275362319,200,-245,0.3188405797101449,0.6811594202898551,home,COL,under,12.5,0.5348837209302326,-115,0.5129780138229483,COL,ATL,2023 REG,9,4,18,14,18,27,0,1,-10,10,1,1,1,1,0,0,0,0,0,0.4870219861770517,0.5129780138229483
89267,0.5121951219512195,0.5283018867924528,-105,-112,0.49145275161909474,0.5085472483809053,away,LAD,over,8,0.5192307692307692,-108,0.49455035168025013,SD,LAD,2023 REG,9,2,6,5,7,15,0,1,-3,3,1,1,0,0,0,0,0,0,0,0.49455035168025013,0.5054496483197499
89267,0.5121951219512195,0.5283018867924528,-105,-112,0.49145275161909474,0.5085472483809053,home,SD,under,8,0.5283018867924528,-112,0.5054496483197499,SD,LAD,2023 REG,9,2,6,5,7,15,0,1,-3,3,1,1,0,0,0,0,0,0,0,0.49455035168025013,0.5054496483197499
89268,0.35714285714285715,0.6875,180,-220,0.3411989795918367,0.6588010204081634,away,SD,over,9,0.5,100,0.4772727272727273,DET,SD,2023 REG,8,3,3,1,4,11,1,0,2,-2,1,0,0,0,0,0,0,0,0,0.4772727272727273,0.5227272727272727
89268,0.35714285714285715,0.6875,180,-220,0.3411989795918367,0.6588010204081634,home,DET,under,9,0.5454545454545454,-120,0.5227272727272727,DET,SD,2023 REG,8,3,3,1,4,11,1,0,2,-2,1,0,0,0,0,0,0,0,0,0.4772727272727273,0.5227272727272727
89270,0.5652173913043479,0.47619047619047616,-130,110,0.5418129444594474,0.4581870555405526,away,BOS,over,8.5,0.5327102803738317,-114,0.508788710910954,MIL,BOS,2023 REG,9,5,8,4,9,17,1,0,1,-1,1,1,1,1,0,0,0,0,0,0.508788710910954,0.491211289089046
89270,0.5652173913043479,0.47619047619047616,-130,110,0.5418129444594474,0.4581870555405526,home,MIL,under,8.5,0.5121951219512195,-105,0.491211289089046,MIL,BOS,2023 REG,9,5,8,4,9,17,1,0,1,-1,1,1,1,1,0,0,0,0,0,0.508788710910954,0.491211289089046
89271,0.6666666666666666,0.3663003663003663,-200,173,0.6446886446886447,0.35531135531135527,away,COL,over,8.5,0.5348837209302326,-115,0.5097020142727117,NYM,COL,2023 REG,9,6,14,13,19,23,0,1,-7,7,1,1,1,1,1,1,0,0,0,0.5097020142727117,0.49029798572728833
89271,0.6666666666666666,0.3663003663003663,-200,173,0.6446886446886447,0.35531135531135527,home,NYM,under,8.5,0.5121951219512195,-105,0.49029798572728833,NYM,COL,2023 REG,9,6,14,13,19,23,0,1,-7,7,1,1,1,1,1,1,0,0,0,0.5097020142727117,0.49029798572728833
89272,0.607843137254902,0.4291845493562232,-155,133,0.5853361120599043,0.4146638879400957,away,BAL,over,9.5,0.5,100,0.47935779816513757,BOS,BAL,2023 REG,11,9,13,8,17,24,1,0,1,-1,1,1,1,1,1,1,1,1,0,0.47935779816513757,0.5206422018348624
89272,0.607843137254902,0.4291845493562232,-155,133,0.5853361120599043,0.4146638879400957,home,BOS,under,9.5,0.5412844036697247,-118,0.5206422018348624,BOS,BAL,2023 REG,11,9,13,8,17,24,1,0,1,-1,1,1,1,1,1,1,1,1,0,0.47935779816513757,0.5206422018348624
89273,0.5348837209302326,0.5098039215686274,-115,-104,0.5109810284308424,0.48901897156915763,away,BAL,over,7,0.5412844036697247,-118,0.5136310900085983,CLE,BAL,2023 REG,5,1,7,5,6,12,0,1,-4,4,1,0,0,0,0,0,0,0,0,0.5136310900085983,0.4863689099914017
89273,0.5348837209302326,0.5098039215686274,-115,-104,0.5109810284308424,0.48901897156915763,home,CLE,under,7,0.5098039215686274,-104,0.4863689099914017,CLE,BAL,2023 REG,5,1,7,5,6,12,0,1,-4,4,1,0,0,0,0,0,0,0,0,0.5136310900085983,0.4863689099914017
89275,0.6598639455782314,0.37878787878787884,-194,164,0.634359000248213,0.365640999751787,away,COL,over,9.5,0.5412844036697247,-118,0.5149381613977361,STL,COL,2023 REG,14,4,15,9,13,29,0,1,-5,5,1,1,1,1,0,0,0,0,0,0.5149381613977361,0.48506183860226393
89275,0.6598639455782314,0.37878787878787884,-194,164,0.634359000248213,0.365640999751787,home,STL,under,9.5,0.5073891625615764,-103,0.48506183860226393,STL,COL,2023 REG,14,4,15,9,13,29,0,1,-5,5,1,1,1,1,0,0,0,0,0,0.5149381613977361,0.48506183860226393
89276,0.4629629629629629,0.576271186440678,116,-136,0.4447990049057217,0.5552009950942782,away,SEA,over,8,0.5454545454545454,-120,0.5206611570247933,HOU,SEA,2023 REG,3,1,6,3,4,9,0,1,-2,2,1,0,0,0,0,0,0,0,0,0.5206611570247933,0.4793388429752067
89276,0.4629629629629629,0.576271186440678,116,-136,0.4447990049057217,0.5552009950942782,home,HOU,under,8,0.5,100,0.4793388429752067,HOU,SEA,2023 REG,3,1,6,3,4,9,0,1,-2,2,1,0,0,0,0,0,0,0,0,0.5206611570247933,0.4793388429752067
89277,0.4081632653061224,0.626865671641791,145,-168,0.39386574002125985,0.6061342599787402,away,SD,over,8.5,0.5283018867924528,-112,0.5044173060022736,CHC,SD,2023 REG,9,5,6,2,7,15,1,0,3,-3,1,1,0,0,0,0,0,0,0,0.5044173060022736,0.49558269399772636
89277,0.4081632653061224,0.626865671641791,145,-168,0.39386574002125985,0.6061342599787402,home,CHC,under,8.5,0.5169082125603864,-107,0.49558269399772636,CHC,SD,2023 REG,9,5,6,2,7,15,1,0,3,-3,1,1,0,0,0,0,0,0,0,0.5044173060022736,0.49558269399772636
89279,0.6875,0.35714285714285715,-220,180,0.6568080357142857,0.3431919642857143,away,WSH,over,8.5,0.5454545454545454,-120,0.5206611570247933,PHI,WSH,2023 REG,18,19,10,4,23,28,1,0,15,-15,1,1,1,1,0,0,0,0,0,0.5206611570247933,0.4793388429752067
89279,0.6875,0.35714285714285715,-220,180,0.6568080357142857,0.3431919642857143,home,PHI,under,8.5,0.5,100,0.4793388429752067,PHI,WSH,2023 REG,18,19,10,4,23,28,1,0,15,-15,1,1,1,1,0,0,0,0,0,0.5206611570247933,0.4793388429752067
89280,0.574468085106383,0.4672897196261683,-135,114,0.550479558983428,0.44952044101657196,away,MIA,over,7.5,0.5348837209302326,-115,0.5097020142727117,SF,MIA,2023 REG,9,7,13,5,12,22,1,0,2,-2,1,1,1,1,1,0,0,0,0,0.5097020142727117,0.49029798572728833
89280,0.574468085106383,0.4672897196261683,-135,114,0.550479558983428,0.44952044101657196,home,SF,under,7.5,0.5121951219512195,-105,0.49029798572728833,SF,MIA,2023 REG,9,7,13,5,12,22,1,0,2,-2,1,1,1,1,1,0,0,0,0,0.5097020142727117,0.49029798572728833
89282,0.6212121212121212,0.42016806722689076,-164,138,0.5955062465757653,0.40449375342423466,away,CWS,over,10,0.5348837209302326,-115,0.5097020142727117,KC,CWS,2023 REG,16,12,3,1,13,19,1,0,11,-11,1,0,0,0,0,0,0,0,0,0.5097020142727117,0.49029798572728833
89282,0.6212121212121212,0.42016806722689076,-164,138,0.5955062465757653,0.40449375342423466,home,KC,under,10,0.5121951219512195,-105,0.49029798572728833,KC,CWS,2023 REG,16,12,3,1,13,19,1,0,11,-11,1,0,0,0,0,0,0,0,0,0.5097020142727117,0.49029798572728833
89283,0.504950495049505,0.5412844036697247,-102,-118,0.48160416005266615,0.5183958399473338,away,ARI,over,8.5,0.5121951219512195,-105,0.48808156828023186,NYY,ARI,2023 REG,12,7,5,1,8,17,1,0,6,-6,1,0,0,0,0,0,0,0,0,0.48808156828023186,0.5119184317197681
89283,0.504950495049505,0.5412844036697247,-102,-118,0.48160416005266615,0.5183958399473338,home,NYY,under,8.5,0.5348837209302326,-115,0.5119184317197681,NYY,ARI,2023 REG,12,7,5,1,8,17,1,0,6,-6,1,0,0,0,0,0,0,0,0,0.48808156828023186,0.5119184317197681
89285,0.5867768595041323,0.45454545454545453,-142,120,0.5625298818386723,0.43747011816132775,away,PIT,over,8.5,0.5348837209302326,-115,0.5097020142727117,SEA,PIT,2023 REG,7,6,7,3,9,14,1,0,3,-3,1,1,1,0,0,0,0,0,0,0.5097020142727117,0.49029798572728833
89285,0.5867768595041323,0.45454545454545453,-142,120,0.5625298818386723,0.43747011816132775,home,SEA,under,8.5,0.5121951219512195,-105,0.49029798572728833,SEA,PIT,2023 REG,7,6,7,3,9,14,1,0,3,-3,1,1,1,0,0,0,0,0,0,0.5097020142727117,0.49029798572728833
89288,0.576271186440678,0.46511627906976744,-136,115,0.552420782587201,0.44757921741279905,away,CLE,over,7,0.5454545454545454,-120,0.5220180091279142,SEA,CLE,2023 REG,3,0,5,2,2,8,0,1,-2,2,0,0,0,0,0,0,0,0,0,0.5220180091279142,0.4779819908720858
89288,0.576271186440678,0.46511627906976744,-136,115,0.552420782587201,0.44757921741279905,home,SEA,under,7,0.49751243781094534,101,0.4779819908720858,SEA,CLE,2023 REG,3,0,5,2,2,8,0,1,-2,2,0,0,0,0,0,0,0,0,0,0.5220180091279142,0.4779819908720858
89291,0.5348837209302326,0.5121951219512195,-115,-105,0.5097020142727117,0.49029798572728833,away,DET,over,11.5,0.5327102803738317,-114,0.5075272610403079,COL,DET,2023 REG,6,2,9,4,6,15,0,1,-2,2,1,1,0,0,0,0,0,0,0,0.5075272610403079,0.4924727389596921
89291,0.5348837209302326,0.5121951219512195,-115,-105,0.5097020142727117,0.49029798572728833,home,COL,under,11.5,0.5145631067961165,-106,0.4924727389596921,COL,DET,2023 REG,6,2,9,4,6,15,0,1,-2,2,1,1,0,0,0,0,0,0,0,0.5075272610403079,0.4924727389596921
89292,0.30303030303030304,0.7368421052631579,230,-280,0.2909477550625876,0.7090522449374124,away,ATL,over,12,0.5348837209302326,-115,0.5097020142727117,COL,ATL,2023 REG,3,1,15,3,4,18,0,1,-2,2,1,0,0,0,0,0,0,0,0,0.5097020142727117,0.49029798572728833
89292,0.30303030303030304,0.7368421052631579,230,-280,0.2909477550625876,0.7090522449374124,home,COL,under,12,0.5121951219512195,-105,0.49029798572728833,COL,ATL,2023 REG,3,1,15,3,4,18,0,1,-2,2,1,0,0,0,0,0,0,0,0,0.5097020142727117,0.49029798572728833
89294,0.45454545454545453,0.5833333333333333,120,-140,0.43732782369146006,0.5626721763085399,away,PHI,over,7.5,0.49504950495049505,102,0.47297076509898783,MIA,PHI,2023 REG,9,3,11,4,7,20,0,1,-1,1,1,1,1,0,0,0,0,0,0,0.47297076509898783,0.5270292349010122
89294,0.45454545454545453,0.5833333333333333,120,-140,0.43732782369146006,0.5626721763085399,home,MIA,under,7.5,0.5495495495495495,-122,0.5270292349010122,MIA,PHI,2023 REG,9,3,11,4,7,20,0,1,-1,1,1,1,1,0,0,0,0,0,0,0.47297076509898783,0.5270292349010122
89295,0.4347826086956522,0.6000000000000001,130,-150,0.4196597353497164,0.5803402646502835,away,SD,over,9.5,0.5238095238095238,-110,0.4988662131519274,PIT,SD,2023 REG,16,9,11,4,13,27,1,0,5,-5,1,1,1,1,0,0,0,0,0,0.4988662131519274,0.5011337868480725
89295,0.4347826086956522,0.6000000000000001,130,-150,0.4196597353497164,0.5803402646502835,home,PIT,under,9.5,0.5238095238095238,-110,0.5011337868480725,PIT,SD,2023 REG,16,9,11,4,13,27,1,0,5,-5,1,1,1,1,0,0,0,0,0,0.4988662131519274,0.5011337868480725
89296,0.6721311475409836,0.37037037037037035,-205,170,0.6435645535349916,0.35643544646500835,away,BOS,over,8,0.5145631067961165,-106,0.49023796582517226,TOR,BOS,2023 REG,6,4,12,5,9,18,0,1,-1,1,1,1,1,1,0,0,0,0,0,0.49023796582517226,0.5097620341748277
89296,0.6721311475409836,0.37037037037037035,-205,170,0.6435645535349916,0.35643544646500835,home,TOR,under,8,0.5327102803738317,-114,0.5097620341748277,TOR,BOS,2023 REG,6,4,12,5,9,18,0,1,-1,1,1,1,1,1,0,0,0,0,0,0.49023796582517226,0.5097620341748277
89297,0.49504950495049505,0.5454545454545454,102,-120,0.47499799484898986,0.5250020051510101,away,NYM,over,8,0.5192307692307692,-108,0.49688292476754015,MIA,NYM,2023 REG,4,1,5,5,6,9,0,1,-4,4,1,0,0,0,0,0,0,0,0,0.49688292476754015,0.5031170752324599
89297,0.49504950495049505,0.5454545454545454,102,-120,0.47499799484898986,0.5250020051510101,home,MIA,under,8,0.5238095238095238,-110,0.5031170752324599,MIA,NYM,2023 REG,4,1,5,5,6,9,0,1,-4,4,1,0,0,0,0,0,0,0,0,0.49688292476754015,0.5031170752324599
89298,0.5594713656387665,0.48309178743961345,-127,107,0.5356585002601133,0.4643414997398867,away,STL,over,7,0.5535714285714286,-124,0.5293429871948779,CHC,STL,2023 REG,5,1,6,3,4,11,0,1,-2,2,1,0,0,0,0,0,0,0,0,0.5293429871948779,0.47065701280512207
89298,0.5594713656387665,0.48309178743961345,-127,107,0.5356585002601133,0.4643414997398867,home,CHC,under,7,0.49019607843137253,104,0.47065701280512207,CHC,STL,2023 REG,5,1,6,3,4,11,0,1,-2,2,1,0,0,0,0,0,0,0,0,0.5293429871948779,0.47065701280512207
89300,0.4694835680751174,0.574468085106383,113,-135,0.44884898911666654,0.5511510108833335,away,ATL,over,7.5,0.5348837209302326,-115,0.5097020142727117,NYM,ATL,2023 REG,3,0,5,4,4,8,0,1,-4,4,0,0,0,0,0,0,0,0,0,0.5097020142727117,0.49029798572728833
89300,0.4694835680751174,0.574468085106383,113,-135,0.44884898911666654,0.5511510108833335,home,NYM,under,7.5,0.5121951219512195,-105,0.49029798572728833,NYM,ATL,2023 REG,3,0,5,4,4,8,0,1,-4,4,0,0,0,0,0,0,0,0,0,0.5097020142727117,0.49029798572728833
89301,0.4347826086956522,0.607843137254902,130,-155,0.41624967567367205,0.583750324326328,away,ATL,over,8.5,0.5283018867924528,-112,0.5031902949311281,TOR,ATL,2023 REG,6,3,2,0,3,8,1,0,3,-3,0,0,0,0,0,0,0,0,0,0.5031902949311281,0.4968097050688719
89301,0.4347826086956522,0.607843137254902,130,-155,0.41624967567367205,0.583750324326328,home,TOR,under,8.5,0.5192307692307692,-108,0.4968097050688719,TOR,ATL,2023 REG,6,3,2,0,3,8,1,0,3,-3,0,0,0,0,0,0,0,0,0,0.5031902949311281,0.4968097050688719
89303,0.4347826086956522,0.6031746031746031,130,-152,0.418279473099889,0.581720526900111,away,ARI,over,9.5,0.5192307692307692,-108,0.49455035168025013,OAK,ARI,2023 REG,5,3,6,5,8,11,0,1,-2,2,1,1,1,0,0,0,0,0,0,0.49455035168025013,0.5054496483197499
89303,0.4347826086956522,0.6031746031746031,130,-152,0.418279473099889,0.581720526900111,home,OAK,under,9.5,0.5283018867924528,-112,0.5054496483197499,OAK,ARI,2023 REG,5,3,6,5,8,11,0,1,-2,2,1,1,1,0,0,0,0,0,0,0.49455035168025013,0.5054496483197499
89304,0.5833333333333333,0.4587155963302753,-140,118,0.5588047910295616,0.4411952089704384,away,LAA,over,9.5,0.49504950495049505,102,0.47297076509898783,PHI,LAA,2023 REG,7,6,11,4,10,18,1,0,2,-2,1,1,1,1,0,0,0,0,0,0.47297076509898783,0.5270292349010122
89304,0.5833333333333333,0.4587155963302753,-140,118,0.5588047910295616,0.4411952089704384,home,PHI,under,9.5,0.5495495495495495,-122,0.5270292349010122,PHI,LAA,2023 REG,7,6,11,4,10,18,1,0,2,-2,1,1,1,1,0,0,0,0,0,0.47297076509898783,0.5270292349010122
89305,0.48309178743961345,0.5555555555555556,107,-125,0.4644215734322854,0.5355784265677146,away,LAA,over,7.5,0.5238095238095238,-110,0.4988662131519274,STL,LAA,2023 REG,7,4,13,6,10,20,0,1,-2,2,1,1,1,1,0,0,0,0,0,0.4988662131519274,0.5011337868480725
89305,0.48309178743961345,0.5555555555555556,107,-125,0.4644215734322854,0.5355784265677146,home,STL,under,7.5,0.5238095238095238,-110,0.5011337868480725,STL,LAA,2023 REG,7,4,13,6,10,20,0,1,-2,2,1,1,1,1,0,0,0,0,0,0.4988662131519274,0.5011337868480725
89307,0.5283018867924528,0.5145631067961165,-112,-106,0.5056562298022652,0.4943437701977348,away,TB,over,9.5,0.5454545454545454,-120,0.5193043049216726,LAA,TB,2023 REG,9,6,15,9,15,24,0,1,-3,3,1,1,1,1,1,1,0,0,0,0.5193043049216726,0.48069569507832743
89307,0.5283018867924528,0.5145631067961165,-112,-106,0.5056562298022652,0.4943437701977348,home,LAA,under,9.5,0.5024875621890548,-101,0.48069569507832743,LAA,TB,2023 REG,9,6,15,9,15,24,0,1,-3,3,1,1,1,1,1,1,0,0,0,0.5193043049216726,0.48069569507832743
89308,0.6240601503759399,0.4166666666666667,-166,140,0.5986441668079975,0.4013558331920025,away,ARI,over,8.5,0.5495495495495495,-122,0.5223196169142115,SD,ARI,2023 REG,4,4,6,0,4,10,1,0,4,-4,0,0,0,0,0,0,0,0,0,0.5223196169142115,0.47768038308578853
89308,0.6240601503759399,0.4166666666666667,-166,140,0.5986441668079975,0.4013558331920025,home,SD,under,8.5,0.5,100,0.47768038308578853,SD,ARI,2023 REG,4,4,6,0,4,10,1,0,4,-4,0,0,0,0,0,0,0,0,0,0.5223196169142115,0.47768038308578853
89309,0.48780487804878053,0.5555555555555556,105,-125,0.4666534470222751,0.5333465529777248,away,LAA,over,8,0.5121951219512195,-105,0.48808156828023186,OAK,LAA,2023 REG,5,2,6,1,3,11,1,0,1,-1,1,0,0,0,0,0,0,0,0,0.48808156828023186,0.5119184317197681
89309,0.48780487804878053,0.5555555555555556,105,-125,0.4666534470222751,0.5333465529777248,home,OAK,under,8,0.5348837209302326,-115,0.5119184317197681,OAK,LAA,2023 REG,5,2,6,1,3,11,1,0,1,-1,1,0,0,0,0,0,0,0,0,0.48808156828023186,0.5119184317197681
89310,0.7416020671834626,0.30120481927710846,-287,232,0.7098563916946152,0.29014360830538477,away,CIN,over,8,0.5024875621890548,-101,0.48049269377245407,ATL,CIN,2023 REG,9,5,6,4,9,15,1,0,1,-1,1,1,1,1,0,0,0,0,0,0.48049269377245407,0.5195073062275459
89310,0.7416020671834626,0.30120481927710846,-287,232,0.7098563916946152,0.29014360830538477,home,ATL,under,8,0.5412844036697247,-118,0.5195073062275459,ATL,CIN,2023 REG,9,5,6,4,9,15,1,0,1,-1,1,1,1,1,0,0,0,0,0,0.48049269377245407,0.5195073062275459
89312,0.6363636363636364,0.40322580645161293,-175,148,0.6111703545721141,0.3888296454278859,away,MIA,over,8.5,0.5121951219512195,-105,0.48808156828023186,STL,MIA,2023 REG,6,5,11,2,7,17,1,0,3,-3,1,1,0,0,0,0,0,0,0,0.48808156828023186,0.5119184317197681
89312,0.6363636363636364,0.40322580645161293,-175,148,0.6111703545721141,0.3888296454278859,home,STL,under,8.5,0.5348837209302326,-115,0.5119184317197681,STL,MIA,2023 REG,6,5,11,2,7,17,1,0,3,-3,1,1,0,0,0,0,0,0,0,0.48808156828023186,0.5119184317197681
89313,0.4166666666666667,0.6226415094339623,140,-165,0.4002882599580712,0.5997117400419287,away,ATL,over,9,0.5121951219512195,-105,0.48808156828023186,PHI,ATL,2023 REG,4,1,10,4,5,14,0,1,-3,3,1,0,0,0,0,0,0,0,0,0.48808156828023186,0.5119184317197681
89313,0.4166666666666667,0.6226415094339623,140,-165,0.4002882599580712,0.5997117400419287,home,PHI,under,9,0.5348837209302326,-115,0.5119184317197681,PHI,ATL,2023 REG,4,1,10,4,5,14,0,1,-3,3,1,0,0,0,0,0,0,0,0,0.48808156828023186,0.5119184317197681
89314,0.6688741721854304,0.3663003663003663,-202,173,0.6453468318737386,0.35465316812626135,away,COL,over,8,0.5238095238095238,-110,0.4988662131519274,SD,COL,2023 REG,4,3,4,1,4,8,1,0,2,-2,1,0,0,0,0,0,0,0,0,0.4988662131519274,0.5011337868480725
89314,0.6688741721854304,0.3663003663003663,-202,173,0.6453468318737386,0.35465316812626135,home,SD,under,8,0.5238095238095238,-110,0.5011337868480725,SD,COL,2023 REG,4,3,4,1,4,8,1,0,2,-2,1,0,0,0,0,0,0,0,0,0.4988662131519274,0.5011337868480725
89315,0.6774193548387096,0.36363636363636365,-210,175,0.6496074165168858,0.3503925834831142,away,CHC,over,8.5,0.5238095238095238,-110,0.4988662131519274,NYY,CHC,2023 REG,8,6,5,3,9,13,1,0,3,-3,1,1,1,0,0,0,0,0,0,0.4988662131519274,0.5011337868480725
89315,0.6774193548387096,0.36363636363636365,-210,175,0.6496074165168858,0.3503925834831142,home,NYY,under,8.5,0.5238095238095238,-110,0.5011337868480725,NYY,CHC,2023 REG,8,6,5,3,9,13,1,0,3,-3,1,1,1,0,0,0,0,0,0,0.4988662131519274,0.5011337868480725
89316,0.6363636363636364,0.4,-175,150,0.6132231404958678,0.3867768595041322,away,MIA,over,7.5,0.504950495049505,-102,0.48160416005266615,SD,MIA,2023 REG,3,0,8,3,3,11,0,1,-3,3,0,0,0,0,0,0,0,0,0,0.48160416005266615,0.5183958399473338
89316,0.6363636363636364,0.4,-175,150,0.6132231404958678,0.3867768595041322,home,SD,under,7.5,0.5412844036697247,-118,0.5183958399473338,SD,MIA,2023 REG,3,0,8,3,3,11,0,1,-3,3,0,0,0,0,0,0,0,0,0,0.48160416005266615,0.5183958399473338
89317,0.4672897196261683,0.5652173913043479,114,-130,0.45209948087359064,0.5479005191264094,away,LAD,over,10.5,0.5348837209302326,-115,0.5097020142727117,PHI,LAD,2023 REG,13,7,5,3,10,18,1,0,4,-4,1,1,1,0,0,0,0,0,0,0.5097020142727117,0.49029798572728833
89317,0.4672897196261683,0.5652173913043479,114,-130,0.45209948087359064,0.5479005191264094,home,PHI,under,10.5,0.5121951219512195,-105,0.49029798572728833,PHI,LAD,2023 REG,13,7,5,3,10,18,1,0,4,-4,1,1,1,0,0,0,0,0,0,0.5097020142727117,0.49029798572728833
89318,0.5454545454545454,0.5,-120,100,0.5206611570247933,0.4793388429752067,away,CLE,over,6.5,0.5327102803738317,-114,0.508788710910954,SEA,CLE,2023 REG,7,3,4,0,3,11,1,0,3,-3,0,0,0,0,0,0,0,0,0,0.508788710910954,0.491211289089046
89318,0.5454545454545454,0.5,-120,100,0.5206611570247933,0.4793388429752067,home,SEA,under,6.5,0.5121951219512195,-105,0.491211289089046,SEA,CLE,2023 REG,7,3,4,0,3,11,1,0,3,-3,0,0,0,0,0,0,0,0,0,0.508788710910954,0.491211289089046
89321,0.3424657534246575,0.7058823529411764,192,-240,0.3259081827514267,0.6740918172485733,away,ATL,over,13,0.5327102803738317,-114,0.5075272610403079,COL,ATL,2023 REG,5,3,12,7,10,17,0,1,-4,4,1,1,1,0,0,0,0,0,0,0.5075272610403079,0.4924727389596921
89321,0.3424657534246575,0.7058823529411764,192,-240,0.3259081827514267,0.6740918172485733,home,COL,under,13,0.5145631067961165,-106,0.4924727389596921,COL,ATL,2023 REG,5,3,12,7,10,17,0,1,-4,4,1,1,1,0,0,0,0,0,0,0.5075272610403079,0.4924727389596921
89323,0.4807692307692307,0.5594713656387665,108,-127,0.46142279018846283,0.5385772098115371,away,LAD,over,8.5,0.5283018867924528,-112,0.5031902949311281,CHC,LAD,2023 REG,5,4,11,9,13,16,0,1,-5,5,1,1,1,1,0,0,0,0,0,0.5031902949311281,0.4968097050688719
89323,0.4807692307692307,0.5594713656387665,108,-127,0.46142279018846283,0.5385772098115371,home,CHC,under,8.5,0.5192307692307692,-108,0.4968097050688719,CHC,LAD,2023 REG,5,4,11,9,13,16,0,1,-5,5,1,1,1,1,0,0,0,0,0,0.5031902949311281,0.4968097050688719
89325,0.5633187772925764,0.47619047619047616,-129,110,0.5410624729287608,0.45893752707123925,away,CIN,over,8,0.5192307692307692,-108,0.49455035168025013,CLE,CIN,2023 REG,11,4,8,3,7,19,1,0,1,-1,1,1,1,0,0,0,0,0,0,0.49455035168025013,0.5054496483197499
89325,0.5633187772925764,0.47619047619047616,-129,110,0.5410624729287608,0.45893752707123925,home,CLE,under,8,0.5283018867924528,-112,0.5054496483197499,CLE,CIN,2023 REG,11,4,8,3,7,19,1,0,1,-1,1,1,1,0,0,0,0,0,0,0.49455035168025013,0.5054496483197499
89326,0.5,0.5454545454545454,100,-120,0.4772727272727273,0.5227272727272727,away,LAD,over,8.5,0.5,100,0.47935779816513757,NYM,LAD,2023 REG,1,0,7,6,6,8,0,1,-6,6,0,0,0,0,0,0,0,0,0,0.47935779816513757,0.5206422018348624
89326,0.5,0.5454545454545454,100,-120,0.4772727272727273,0.5227272727272727,home,NYM,under,8.5,0.5412844036697247,-118,0.5206422018348624,NYM,LAD,2023 REG,1,0,7,6,6,8,0,1,-6,6,0,0,0,0,0,0,0,0,0,0.47935779816513757,0.5206422018348624
89327,0.6363636363636364,0.4016064257028112,-175,149,0.6122008695940788,0.3877991304059212,away,TEX,over,7.5,0.5348837209302326,-115,0.5097020142727117,SEA,TEX,2023 REG,4,1,4,2,3,8,0,1,-1,1,1,0,0,0,0,0,0,0,0,0.5097020142727117,0.49029798572728833
89327,0.6363636363636364,0.4016064257028112,-175,149,0.6122008695940788,0.3877991304059212,home,SEA,under,7.5,0.5121951219512195,-105,0.49029798572728833,SEA,TEX,2023 REG,4,1,4,2,3,8,0,1,-1,1,1,0,0,0,0,0,0,0,0,0.5097020142727117,0.49029798572728833
89328,0.5121951219512195,0.5348837209302326,-105,-115,0.48808156828023186,0.5119184317197681,away,MIA,over,8.5,0.5,100,0.4772727272727273,STL,MIA,2023 REG,11,6,12,4,10,23,1,0,2,-2,1,1,1,1,0,0,0,0,0,0.4772727272727273,0.5227272727272727
89328,0.5121951219512195,0.5348837209302326,-105,-115,0.48808156828023186,0.5119184317197681,home,STL,under,8.5,0.5454545454545454,-120,0.5227272727272727,STL,MIA,2023 REG,11,6,12,4,10,23,1,0,2,-2,1,1,1,1,0,0,0,0,0,0.4772727272727273,0.5227272727272727
89330,0.6363636363636364,0.40322580645161293,-175,148,0.6111703545721141,0.3888296454278859,away,NYY,over,7,0.5121951219512195,-105,0.48808156828023186,TOR,NYY,2023 REG,3,0,5,2,2,8,0,1,-2,2,0,0,0,0,0,0,0,0,0,0.48808156828023186,0.5119184317197681
89330,0.6363636363636364,0.40322580645161293,-175,148,0.6111703545721141,0.3888296454278859,home,TOR,under,7,0.5348837209302326,-115,0.5119184317197681,TOR,NYY,2023 REG,3,0,5,2,2,8,0,1,-2,2,0,0,0,0,0,0,0,0,0,0.48808156828023186,0.5119184317197681
89331,0.574468085106383,0.4672897196261683,-135,114,0.550479558983428,0.44952044101657196,away,TEX,over,8,0.5391705069124424,-117,0.5127649394825569,TOR,TEX,2023 REG,5,0,12,10,10,17,0,1,-10,10,0,0,0,0,0,0,0,0,0,0.5127649394825569,0.48723506051744314
89331,0.574468085106383,0.4672897196261683,-135,114,0.550479558983428,0.44952044101657196,home,TOR,under,8,0.5098039215686274,-104,0.48723506051744314,TOR,TEX,2023 REG,5,0,12,10,10,17,0,1,-10,10,0,0,0,0,0,0,0,0,0,0.5127649394825569,0.48723506051744314
89332,0.5815899581589958,0.45454545454545453,-139,120,0.5605739649961564,0.4394260350038436,away,CLE,over,8.5,0.5454545454545454,-120,0.5206611570247933,TEX,CLE,2023 REG,17,12,8,4,16,25,1,0,8,-8,1,1,1,1,0,0,0,0,0,0.5206611570247933,0.4793388429752067
89332,0.5815899581589958,0.45454545454545453,-139,120,0.5605739649961564,0.4394260350038436,home,TEX,under,8.5,0.5,100,0.4793388429752067,TEX,CLE,2023 REG,17,12,8,4,16,25,1,0,8,-8,1,1,1,1,0,0,0,0,0,0.5206611570247933,0.4793388429752067
89333,0.5073891625615764,0.5348837209302326,-103,-115,0.4859403596076043,0.5140596403923957,away,SEA,over,11,0.5121951219512195,-105,0.48808156828023186,CHC,SEA,2023 REG,5,2,10,5,7,15,0,1,-3,3,1,1,0,0,0,0,0,0,0,0.48808156828023186,0.5119184317197681
89333,0.5073891625615764,0.5348837209302326,-103,-115,0.4859403596076043,0.5140596403923957,home,CHC,under,11,0.5348837209302326,-115,0.5119184317197681,CHC,SEA,2023 REG,5,2,10,5,7,15,0,1,-3,3,1,1,0,0,0,0,0,0,0,0.48808156828023186,0.5119184317197681
89334,0.7142857142857143,0.31746031746031744,-250,215,0.6916099773242631,0.3083900226757369,away,CWS,over,8,0.5305164319248826,-113,0.5066009958897986,LAD,CWS,2023 REG,7,4,13,8,12,20,0,1,-4,4,1,1,1,1,0,0,0,0,0,0.5066009958897986,0.49339900411020143
89334,0.7142857142857143,0.31746031746031744,-250,215,0.6916099773242631,0.3083900226757369,home,LAD,under,8,0.5145631067961165,-106,0.49339900411020143,LAD,CWS,2023 REG,7,4,13,8,12,20,0,1,-4,4,1,1,1,1,0,0,0,0,0,0.5066009958897986,0.49339900411020143
89335,0.3424657534246575,0.6923076923076923,192,-225,0.33055703913275686,0.6694429608672432,away,NYM,over,8,0.5348837209302326,-115,0.5097020142727117,OAK,NYM,2023 REG,13,6,11,17,23,24,0,1,-11,11,1,1,1,1,1,1,0,0,0,0.5097020142727117,0.49029798572728833
89335,0.3424657534246575,0.6923076923076923,192,-225,0.33055703913275686,0.6694429608672432,home,OAK,under,8,0.5121951219512195,-105,0.49029798572728833,OAK,NYM,2023 REG,13,6,11,17,23,24,0,1,-11,11,1,1,1,1,1,1,0,0,0,0.5097020142727117,0.49029798572728833
89336,0.7530864197530864,0.29411764705882354,-305,240,0.7175376780799196,0.28246232192008036,away,COL,over,7.5,0.5121951219512195,-105,0.48808156828023186,SD,COL,2023 REG,5,2,2,0,2,7,1,0,2,-2,0,0,0,0,0,0,0,0,0,0.48808156828023186,0.5119184317197681
89336,0.7530864197530864,0.29411764705882354,-305,240,0.7175376780799196,0.28246232192008036,home,SD,under,7.5,0.5348837209302326,-115,0.5119184317197681,SD,COL,2023 REG,5,2,2,0,2,7,1,0,2,-2,0,0,0,0,0,0,0,0,0,0.48808156828023186,0.5119184317197681
89337,0.5652173913043479,0.47619047619047616,-130,110,0.5418129444594474,0.4581870555405526,away,TOR,over,8.5,0.5145631067961165,-106,0.4913668392989033,NYM,TOR,2023 REG,5,0,8,3,3,13,0,1,-3,3,0,0,0,0,0,0,0,0,0,0.4913668392989033,0.5086331607010968
89337,0.5652173913043479,0.47619047619047616,-130,110,0.5418129444594474,0.4581870555405526,home,NYM,under,8.5,0.5305164319248826,-113,0.5086331607010968,NYM,TOR,2023 REG,5,0,8,3,3,13,0,1,-3,3,0,0,0,0,0,0,0,0,0,0.4913668392989033,0.5086331607010968
89339,0.6941896024464832,0.3436426116838488,-227,191,0.6679268727596778,0.33207312724032223,away,DET,over,8,0.5327102803738317,-114,0.508788710910954,STL,DET,2023 REG,12,4,9,5,9,21,0,1,-1,1,1,1,1,1,0,0,0,0,0,0.508788710910954,0.491211289089046
89339,0.6941896024464832,0.3436426116838488,-227,191,0.6679268727596778,0.33207312724032223,home,STL,under,8,0.5121951219512195,-105,0.491211289089046,STL,DET,2023 REG,12,4,9,5,9,21,0,1,-1,1,1,1,1,1,0,0,0,0,0,0.508788710910954,0.491211289089046
89340,0.6491228070175439,0.3921568627450981,-185,155,0.6223272319084604,0.3776727680915396,away,CWS,over,8.5,0.5192307692307692,-108,0.49455035168025013,BAL,CWS,2023 REG,9,5,15,10,15,24,0,1,-5,5,1,1,1,1,1,0,0,0,0,0.49455035168025013,0.5054496483197499
89340,0.6491228070175439,0.3921568627450981,-185,155,0.6223272319084604,0.3776727680915396,home,BAL,under,8.5,0.5283018867924528,-112,0.5054496483197499,BAL,CWS,2023 REG,9,5,15,10,15,24,0,1,-5,5,1,1,1,1,1,0,0,0,0,0.49455035168025013,0.5054496483197499
89342,0.5238095238095238,0.5121951219512195,-110,-105,0.5049499474586583,0.4950500525413417,away,WSH,over,9,0.5391705069124424,-117,0.5140669063204599,KC,WSH,2023 REG,6,3,8,2,5,14,1,0,1,-1,1,1,0,0,0,0,0,0,0,0.5140669063204599,0.4859330936795401
89342,0.5238095238095238,0.5121951219512195,-110,-105,0.5049499474586583,0.4950500525413417,home,KC,under,9,0.5073891625615764,-103,0.4859330936795401,KC,WSH,2023 REG,6,3,8,2,5,14,1,0,1,-1,1,1,0,0,0,0,0,0,0,0.5140669063204599,0.4859330936795401
89343,0.7058823529411764,0.3333333333333333,-240,200,0.6782006920415226,0.32179930795847744,away,DET,over,9,0.5169082125603864,-107,0.49353874091423283,TEX,DET,2023 REG,14,10,5,2,12,19,1,0,8,-8,1,1,0,0,0,0,0,0,0,0.49353874091423283,0.5064612590857671
89343,0.7058823529411764,0.3333333333333333,-240,200,0.6782006920415226,0.32179930795847744,home,TEX,under,9,0.5283018867924528,-112,0.5064612590857671,TEX,DET,2023 REG,14,10,5,2,12,19,1,0,8,-8,1,1,0,0,0,0,0,0,0,0.49353874091423283,0.5064612590857671
89344,0.5515695067264574,0.48780487804878053,-123,105,0.5298517967383217,0.4701482032616783,away,MIL,over,9,0.5121951219512195,-105,0.48808156828023186,CHC,MIL,2023 REG,9,5,13,9,14,22,0,1,-4,4,1,1,1,1,1,0,0,0,0,0.48808156828023186,0.5119184317197681
89344,0.5515695067264574,0.48780487804878053,-123,105,0.5298517967383217,0.4701482032616783,home,CHC,under,9,0.5348837209302326,-115,0.5119184317197681,CHC,MIL,2023 REG,9,5,13,9,14,22,0,1,-4,4,1,1,1,1,1,0,0,0,0,0.48808156828023186,0.5119184317197681
89345,0.6923076923076923,0.3508771929824561,-225,185,0.6624104640298972,0.33758953597010277,away,PIT,over,8.5,0.5238095238095238,-110,0.4988662131519274,ARI,PIT,2023 REG,12,7,6,3,10,18,1,0,4,-4,1,1,1,0,0,0,0,0,0,0.4988662131519274,0.5011337868480725
89345,0.6923076923076923,0.3508771929824561,-225,185,0.6624104640298972,0.33758953597010277,home,ARI,under,8.5,0.5238095238095238,-110,0.5011337868480725,ARI,PIT,2023 REG,12,7,6,3,10,18,1,0,4,-4,1,1,1,0,0,0,0,0,0,0.4988662131519274,0.5011337868480725
89346,0.4444444444444444,0.5918367346938775,125,-145,0.42831947593852354,0.5716805240614764,away,SD,over,9.5,0.5,100,0.4772727272727273,ARI,SD,2023 REG,9,3,6,5,8,15,0,1,-2,2,1,1,1,0,0,0,0,0,0,0.4772727272727273,0.5227272727272727
89346,0.4444444444444444,0.5918367346938775,125,-145,0.42831947593852354,0.5716805240614764,home,ARI,under,9.5,0.5454545454545454,-120,0.5227272727272727,ARI,SD,2023 REG,9,3,6,5,8,15,0,1,-2,2,1,1,1,0,0,0,0,0,0,0.4772727272727273,0.5227272727272727
89348,0.4444444444444444,0.5918367346938775,125,-145,0.42831947593852354,0.5716805240614764,away,TEX,over,9,0.5121951219512195,-105,0.48808156828023186,NYY,TEX,2023 REG,4,1,8,0,1,12,1,0,1,-1,0,0,0,0,0,0,0,0,0,0.48808156828023186,0.5119184317197681
89348,0.4444444444444444,0.5918367346938775,125,-145,0.42831947593852354,0.5716805240614764,home,NYY,under,9,0.5348837209302326,-115,0.5119184317197681,NYY,TEX,2023 REG,4,1,8,0,1,12,1,0,1,-1,0,0,0,0,0,0,0,0,0,0.48808156828023186,0.5119184317197681
89349,0.47619047619047616,0.5652173913043479,110,-130,0.4564724440500838,0.5435275559499162,away,TB,over,8.5,0.5145631067961165,-106,0.4913668392989033,BAL,TB,2023 REG,2,1,13,7,8,15,0,1,-6,6,1,0,0,0,0,0,0,0,0,0.4913668392989033,0.5086331607010968
89349,0.47619047619047616,0.5652173913043479,110,-130,0.4564724440500838,0.5435275559499162,home,BAL,under,8.5,0.5305164319248826,-113,0.5086331607010968,BAL,TB,2023 REG,2,1,13,7,8,15,0,1,-6,6,1,0,0,0,0,0,0,0,0,0.4913668392989033,0.5086331607010968
89350,0.5,0.5412844036697247,100,-118,0.47935779816513757,0.5206422018348624,away,LAD,over,9.5,0.5348837209302326,-115,0.5097020142727117,BOS,LAD,2023 REG,7,4,14,7,11,21,0,1,-3,3,1,1,1,1,0,0,0,0,0,0.5097020142727117,0.49029798572728833
89350,0.5,0.5412844036697247,100,-118,0.47935779816513757,0.5206422018348624,home,BOS,under,9.5,0.5121951219512195,-105,0.49029798572728833,BOS,LAD,2023 REG,7,4,14,7,11,21,0,1,-3,3,1,1,1,1,0,0,0,0,0,0.5097020142727117,0.49029798572728833
89353,0.4,0.6428571428571428,150,-180,0.38285714285714295,0.617142857142857,away,MIL,over,8.5,0.5121951219512195,-105,0.48808156828023186,PIT,MIL,2023 REG,8,3,7,7,10,15,0,1,-4,4,1,1,1,0,0,0,0,0,0,0.48808156828023186,0.5119184317197681
89353,0.4,0.6428571428571428,150,-180,0.38285714285714295,0.617142857142857,home,PIT,under,8.5,0.5348837209302326,-115,0.5119184317197681,PIT,MIL,2023 REG,8,3,7,7,10,15,0,1,-4,4,1,1,1,0,0,0,0,0,0,0.48808156828023186,0.5119184317197681
89355,0.37878787878787884,0.6575342465753424,164,-192,0.36502949796847683,0.6349705020315232,away,CHC,over,11.5,0.5348837209302326,-115,0.5097020142727117,COL,CHC,2023 REG,11,7,11,3,10,22,1,0,4,-4,1,1,1,0,0,0,0,0,0,0.5097020142727117,0.49029798572728833
89355,0.37878787878787884,0.6575342465753424,164,-192,0.36502949796847683,0.6349705020315232,home,COL,under,11.5,0.5121951219512195,-105,0.49029798572728833,COL,CHC,2023 REG,11,7,11,3,10,22,1,0,4,-4,1,1,1,0,0,0,0,0,0,0.5097020142727117,0.49029798572728833
89359,0.5555555555555556,0.4807692307692307,-125,108,0.5353751187084521,0.4646248812915479,away,LAD,over,8.5,0.5454545454545454,-120,0.5206611570247933,SD,LAD,2023 REG,5,1,3,2,3,8,0,1,-1,1,1,0,0,0,0,0,0,0,0,0.5206611570247933,0.4793388429752067
89359,0.5555555555555556,0.4807692307692307,-125,108,0.5353751187084521,0.4646248812915479,home,SD,under,8.5,0.5,100,0.4793388429752067,SD,LAD,2023 REG,5,1,3,2,3,8,0,1,-1,1,1,0,0,0,0,0,0,0,0,0.5206611570247933,0.4793388429752067
89361,0.6875,0.3508771929824561,-220,185,0.6611156798245614,0.33888432017543857,away,DET,over,8,0.5433789954337899,-119,0.5171177654451503,MIL,DET,2023 REG,8,6,7,2,8,15,1,0,4,-4,1,1,0,0,0,0,0,0,0,0.5171177654451503,0.4828822345548497
89361,0.6875,0.3508771929824561,-220,185,0.6611156798245614,0.33888432017543857,home,MIL,under,8,0.504950495049505,-102,0.4828822345548497,MIL,DET,2023 REG,8,6,7,2,8,15,1,0,4,-4,1,1,0,0,0,0,0,0,0,0.5171177654451503,0.4828822345548497
89362,0.6226415094339623,0.4166666666666667,-165,140,0.5981666073335706,0.40183339266642937,away,MIL,over,10,0.5192307692307692,-108,0.49455035168025013,TOR,MIL,2023 REG,7,2,7,4,6,14,0,1,-2,2,1,1,0,0,0,0,0,0,0,0.49455035168025013,0.5054496483197499
89362,0.6226415094339623,0.4166666666666667,-165,140,0.5981666073335706,0.40183339266642937,home,TOR,under,10,0.5283018867924528,-112,0.5054496483197499,TOR,MIL,2023 REG,7,2,7,4,6,14,0,1,-2,2,1,1,0,0,0,0,0,0,0,0.49455035168025013,0.5054496483197499
89363,0.4166666666666667,0.6212121212121212,140,-164,0.4008838383838384,0.5991161616161615,away,LAD,over,8,0.5238095238095238,-110,0.4988662131519274,SF,LAD,2023 REG,3,2,7,5,7,10,0,1,-3,3,1,1,0,0,0,0,0,0,0,0.4988662131519274,0.5011337868480725
89363,0.4166666666666667,0.6212121212121212,140,-164,0.4008838383838384,0.5991161616161615,home,SF,under,8,0.5238095238095238,-110,0.5011337868480725,SF,LAD,2023 REG,3,2,7,5,7,10,0,1,-3,3,1,1,0,0,0,0,0,0,0,0.4988662131519274,0.5011337868480725
89364,0.5,0.5348837209302326,100,-115,0.4825581395348837,0.5174418604651163,away,SEA,over,8.5,0.5169082125603864,-107,0.49353874091423283,PHI,SEA,2023 REG,12,6,8,5,11,20,1,0,1,-1,1,1,1,1,1,0,0,0,0,0.49353874091423283,0.5064612590857671
89364,0.5,0.5348837209302326,100,-115,0.4825581395348837,0.5174418604651163,home,PHI,under,8.5,0.5283018867924528,-112,0.5064612590857671,PHI,SEA,2023 REG,12,6,8,5,11,20,1,0,1,-1,1,1,1,1,1,0,0,0,0,0.49353874091423283,0.5064612590857671
89365,0.5433789954337899,0.5,-119,100,0.5198077604720502,0.48019223952794976,away,CLE,over,9,0.5283018867924528,-112,0.5044173060022736,BOS,CLE,2023 REG,16,8,14,7,15,30,1,0,1,-1,1,1,1,1,1,1,1,0,0,0.5044173060022736,0.49558269399772636
89365,0.5433789954337899,0.5,-119,100,0.5198077604720502,0.48019223952794976,home,BOS,under,9,0.5169082125603864,-107,0.49558269399772636,BOS,CLE,2023 REG,16,8,14,7,15,30,1,0,1,-1,1,1,1,1,1,1,1,0,0,0.5044173060022736,0.49558269399772636
89366,0.43103448275862066,0.6031746031746031,132,-152,0.4162891870977483,0.5837108129022517,away,LAD,over,7.5,0.5192307692307692,-108,0.49688292476754015,SF,LAD,2023 REG,10,5,13,10,15,23,0,1,-5,5,1,1,1,1,1,0,0,0,0,0.49688292476754015,0.5031170752324599
89366,0.43103448275862066,0.6031746031746031,132,-152,0.4162891870977483,0.5837108129022517,home,SF,under,7.5,0.5238095238095238,-110,0.5031170752324599,SF,LAD,2023 REG,10,5,13,10,15,23,0,1,-5,5,1,1,1,1,1,0,0,0,0,0.49688292476754015,0.5031170752324599
89368,0.6363636363636364,0.4081632653061224,-175,145,0.6080283353010626,0.3919716646989374,away,SF,over,9,0.5121951219512195,-105,0.48808156828023186,LAD,SF,2023 REG,5,1,8,5,6,13,0,1,-4,4,1,0,0,0,0,0,0,0,0,0.48808156828023186,0.5119184317197681
89368,0.6363636363636364,0.4081632653061224,-175,145,0.6080283353010626,0.3919716646989374,home,LAD,under,9,0.5348837209302326,-115,0.5119184317197681,LAD,SF,2023 REG,5,1,8,5,6,13,0,1,-4,4,1,0,0,0,0,0,0,0,0,0.48808156828023186,0.5119184317197681
89369,0.5,0.5412844036697247,100,-118,0.47935779816513757,0.5206422018348624,away,TEX,over,10.5,0.5169082125603864,-107,0.49353874091423283,BOS,TEX,2023 REG,10,2,10,6,8,20,0,1,-4,4,1,1,0,0,0,0,0,0,0,0.49353874091423283,0.5064612590857671
89369,0.5,0.5412844036697247,100,-118,0.47935779816513757,0.5206422018348624,home,BOS,under,10.5,0.5283018867924528,-112,0.5064612590857671,BOS,TEX,2023 REG,10,2,10,6,8,20,0,1,-4,4,1,1,0,0,0,0,0,0,0,0.49353874091423283,0.5064612590857671
89370,0.7222222222222222,0.3225806451612903,-260,210,0.6898645957785743,0.3101354042214257,away,KC,over,9,0.5121951219512195,-105,0.48808156828023186,TB,KC,2023 REG,8,4,11,9,13,19,0,1,-5,5,1,1,1,1,0,0,0,0,0,0.48808156828023186,0.5119184317197681
89370,0.7222222222222222,0.3225806451612903,-260,210,0.6898645957785743,0.3101354042214257,home,TB,under,9,0.5348837209302326,-115,0.5119184317197681,TB,KC,2023 REG,8,4,11,9,13,19,0,1,-5,5,1,1,1,1,0,0,0,0,0,0.48808156828023186,0.5119184317197681
89371,0.4444444444444444,0.5967741935483871,125,-148,0.42612504978096366,0.5738749502190363,away,TB,over,9.5,0.5121951219512195,-105,0.48808156828023186,CLE,TB,2023 REG,5,2,13,6,8,18,0,1,-4,4,1,1,0,0,0,0,0,0,0,0.48808156828023186,0.5119184317197681
89371,0.4444444444444444,0.5967741935483871,125,-148,0.42612504978096366,0.5738749502190363,home,CLE,under,9.5,0.5348837209302326,-115,0.5119184317197681,CLE,TB,2023 REG,5,2,13,6,8,18,0,1,-4,4,1,1,0,0,0,0,0,0,0,0.48808156828023186,0.5119184317197681
89372,0.46511627906976744,0.574468085106383,115,-135,0.44670494689481377,0.5532950531051862,away,HOU,over,8,0.5121951219512195,-105,0.48808156828023186,MIA,HOU,2023 REG,7,5,8,1,6,15,1,0,4,-4,1,0,0,0,0,0,0,0,0,0.48808156828023186,0.5119184317197681
89372,0.46511627906976744,0.574468085106383,115,-135,0.44670494689481377,0.5532950531051862,home,MIA,under,8,0.5348837209302326,-115,0.5119184317197681,MIA,HOU,2023 REG,7,5,8,1,6,15,1,0,4,-4,1,0,0,0,0,0,0,0,0,0.48808156828023186,0.5119184317197681
89373,0.4672897196261683,0.574468085106383,114,-135,0.4477767267604901,0.5522232732395099,away,NYY,over,9.5,0.5121951219512195,-105,0.48808156828023186,KC,NYY,2023 REG,12,2,12,5,7,24,0,1,-3,3,1,1,0,0,0,0,0,0,0,0.48808156828023186,0.5119184317197681
89373,0.4672897196261683,0.574468085106383,114,-135,0.4477767267604901,0.5522232732395099,home,KC,under,9.5,0.5348837209302326,-115,0.5119184317197681,KC,NYY,2023 REG,12,2,12,5,7,24,0,1,-3,3,1,1,0,0,0,0,0,0,0,0.48808156828023186,0.5119184317197681
89374,0.5348837209302326,0.5121951219512195,-115,-105,0.5097020142727117,0.49029798572728833,away,STL,over,11,0.5238095238095238,-110,0.4988662131519274,BOS,STL,2023 REG,9,6,14,8,14,23,0,1,-2,2,1,1,1,1,1,1,0,0,0,0.4988662131519274,0.5011337868480725
89374,0.5348837209302326,0.5121951219512195,-115,-105,0.5097020142727117,0.49029798572728833,home,BOS,under,11,0.5238095238095238,-110,0.5011337868480725,BOS,STL,2023 REG,9,6,14,8,14,23,0,1,-2,2,1,1,1,1,1,1,0,0,0,0.4988662131519274,0.5011337868480725
89376,0.6363636363636364,0.4,-175,150,0.6132231404958678,0.3867768595041322,away,MIL,over,8.5,0.5348837209302326,-115,0.5097020142727117,NYM,MIL,2023 REG,3,1,7,2,3,10,0,1,-1,1,1,0,0,0,0,0,0,0,0,0.5097020142727117,0.49029798572728833
89376,0.6363636363636364,0.4,-175,150,0.6132231404958678,0.3867768595041322,home,NYM,under,8.5,0.5121951219512195,-105,0.49029798572728833,NYM,MIL,2023 REG,3,1,7,2,3,10,0,1,-1,1,1,0,0,0,0,0,0,0,0,0.5097020142727117,0.49029798572728833
89378,0.4273504273504274,0.6124031007751938,134,-158,0.41036174011725596,0.5896382598827441,away,ARI,over,8,0.5121951219512195,-105,0.48808156828023186,NYM,ARI,2023 REG,11,7,6,1,8,17,1,0,6,-6,1,0,0,0,0,0,0,0,0,0.48808156828023186,0.5119184317197681
89378,0.4273504273504274,0.6124031007751938,134,-158,0.41036174011725596,0.5896382598827441,home,NYM,under,8,0.5348837209302326,-115,0.5119184317197681,NYM,ARI,2023 REG,11,7,6,1,8,17,1,0,6,-6,1,0,0,0,0,0,0,0,0,0.48808156828023186,0.5119184317197681
89379,0.4,0.6363636363636364,150,-175,0.3854545454545455,0.6145454545454545,away,TEX,over,9,0.5238095238095238,-110,0.4988662131519274,OAK,TEX,2023 REG,5,0,9,5,5,14,0,1,-5,5,0,0,0,0,0,0,0,0,0,0.4988662131519274,0.5011337868480725
89379,0.4,0.6363636363636364,150,-175,0.3854545454545455,0.6145454545454545,home,OAK,under,9,0.5238095238095238,-110,0.5011337868480725,OAK,TEX,2023 REG,5,0,9,5,5,14,0,1,-5,5,0,0,0,0,0,0,0,0,0,0.4988662131519274,0.5011337868480725
89380,0.4716981132075471,0.5689655172413793,112,-132,0.45251715544861953,0.5474828445513804,away,TOR,over,9,0.5454545454545454,-120,0.5206611570247933,DET,TOR,2023 REG,7,2,14,12,14,21,0,1,-10,10,1,1,0,0,0,0,0,0,0,0.5206611570247933,0.4793388429752067
89380,0.4716981132075471,0.5689655172413793,112,-132,0.45251715544861953,0.5474828445513804,home,DET,under,9,0.5,100,0.4793388429752067,DET,TOR,2023 REG,7,2,14,12,14,21,0,1,-10,10,1,1,0,0,0,0,0,0,0,0.5206611570247933,0.4793388429752067
89381,0.5555555555555556,0.48780487804878053,-125,105,0.5314664257753688,0.46853357422463116,away,HOU,over,7.5,0.5238095238095238,-110,0.4988662131519274,SEA,HOU,2023 REG,3,1,9,5,6,12,0,1,-4,4,1,0,0,0,0,0,0,0,0,0.4988662131519274,0.5011337868480725
89381,0.5555555555555556,0.48780487804878053,-125,105,0.5314664257753688,0.46853357422463116,home,SEA,under,7.5,0.5238095238095238,-110,0.5011337868480725,SEA,HOU,2023 REG,3,1,9,5,6,12,0,1,-4,4,1,0,0,0,0,0,0,0,0,0.4988662131519274,0.5011337868480725
89383,0.47619047619047616,0.5652173913043479,110,-130,0.4564724440500838,0.5435275559499162,away,MIN,over,8.5,0.504950495049505,-102,0.4826715732667395,STL,MIN,2023 REG,7,2,7,3,5,14,0,1,-1,1,1,1,0,0,0,0,0,0,0,0.4826715732667395,0.5173284267332605
89383,0.47619047619047616,0.5652173913043479,110,-130,0.4564724440500838,0.5435275559499162,home,STL,under,8.5,0.5391705069124424,-117,0.5173284267332605,STL,MIN,2023 REG,7,2,7,3,5,14,0,1,-1,1,1,1,0,0,0,0,0,0,0,0.4826715732667395,0.5173284267332605
89385,0.49019607843137253,0.5495495495495495,104,-122,0.4707129274603323,0.5292870725396677,away,TEX,over,8.5,0.5283018867924528,-112,0.5031902949311281,MIN,TEX,2023 REG,8,7,10,6,13,18,1,0,1,-1,1,1,1,1,1,1,0,0,0,0.5031902949311281,0.4968097050688719
89385,0.49019607843137253,0.5495495495495495,104,-122,0.4707129274603323,0.5292870725396677,home,MIN,under,8.5,0.5192307692307692,-108,0.4968097050688719,MIN,TEX,2023 REG,8,7,10,6,13,18,1,0,1,-1,1,1,1,1,1,1,0,0,0,0.5031902949311281,0.4968097050688719
89386,0.6875,0.35714285714285715,-220,180,0.6568080357142857,0.3431919642857143,away,MIA,over,8.5,0.5348837209302326,-115,0.5097020142727117,ATL,MIA,2023 REG,9,6,8,3,9,17,1,0,3,-3,1,1,1,0,0,0,0,0,0,0.5097020142727117,0.49029798572728833
89386,0.6875,0.35714285714285715,-220,180,0.6568080357142857,0.3431919642857143,home,ATL,under,8.5,0.5121951219512195,-105,0.49029798572728833,ATL,MIA,2023 REG,9,6,8,3,9,17,1,0,3,-3,1,1,1,0,0,0,0,0,0,0.5097020142727117,0.49029798572728833
89387,0.4672897196261683,0.5726495726495727,114,-134,0.44862649893656975,0.5513735010634302,away,SD,over,9,0.5454545454545454,-120,0.5206611570247933,TOR,SD,2023 REG,6,1,9,9,10,15,0,1,-8,8,1,0,0,0,0,0,0,0,0,0.5206611570247933,0.4793388429752067
89387,0.4672897196261683,0.5726495726495727,114,-134,0.44862649893656975,0.5513735010634302,home,TOR,under,9,0.5,100,0.4793388429752067,TOR,SD,2023 REG,6,1,9,9,10,15,0,1,-8,8,1,0,0,0,0,0,0,0,0,0.5206611570247933,0.4793388429752067
89390,0.5454545454545454,0.49019607843137253,-120,104,0.526008750607681,0.47399124939231896,away,TOR,over,9,0.5,100,0.47935779816513757,BAL,TOR,2023 REG,11,4,8,2,6,19,1,0,2,-2,1,1,0,0,0,0,0,0,0,0.47935779816513757,0.5206422018348624
89390,0.5454545454545454,0.49019607843137253,-120,104,0.526008750607681,0.47399124939231896,home,BAL,under,9,0.5412844036697247,-118,0.5206422018348624,BAL,TOR,2023 REG,11,4,8,2,6,19,1,0,2,-2,1,1,0,0,0,0,0,0,0,0.47935779816513757,0.5206422018348624
89391,0.4,0.6389891696750902,150,-177,0.3844043321299639,0.6155956678700361,away,TB,over,9,0.5433789954337899,-119,0.5198077604720502,WSH,TB,2023 REG,16,6,10,10,16,26,0,1,-4,4,1,1,1,1,1,1,0,0,0,0.5198077604720502,0.48019223952794976
89391,0.4,0.6389891696750902,150,-177,0.3844043321299639,0.6155956678700361,home,WSH,under,9,0.5,100,0.48019223952794976,WSH,TB,2023 REG,16,6,10,10,16,26,0,1,-4,4,1,1,1,1,1,1,0,0,0,0.5198077604720502,0.48019223952794976
89392,0.5433789954337899,0.5,-119,100,0.5198077604720502,0.48019223952794976,away,STL,over,8,0.5145631067961165,-106,0.4925063625223866,CHC,STL,2023 REG,9,4,9,6,10,18,0,1,-2,2,1,1,1,1,0,0,0,0,0,0.4925063625223866,0.5074936374776133
89392,0.5433789954337899,0.5,-119,100,0.5198077604720502,0.48019223952794976,home,CHC,under,8,0.5283018867924528,-112,0.5074936374776133,CHC,STL,2023 REG,9,4,9,6,10,18,0,1,-2,2,1,1,1,1,0,0,0,0,0,0.4925063625223866,0.5074936374776133
89393,0.4,0.6389891696750902,150,-177,0.3844043321299639,0.6155956678700361,away,HOU,over,9,0.5145631067961165,-106,0.49023796582517226,NYY,HOU,2023 REG,8,3,9,7,10,17,0,1,-4,4,1,1,1,0,0,0,0,0,0,0.49023796582517226,0.5097620341748277
89393,0.4,0.6389891696750902,150,-177,0.3844043321299639,0.6155956678700361,home,NYY,under,9,0.5327102803738317,-114,0.5097620341748277,NYY,HOU,2023 REG,8,3,9,7,10,17,0,1,-4,4,1,1,1,0,0,0,0,0,0,0.49023796582517226,0.5097620341748277
89396,0.4926108374384236,0.5454545454545454,103,-120,0.47385941729410397,0.526140582705896,away,MIA,over,7.5,0.5327102803738317,-114,0.508788710910954,NYM,MIA,2023 REG,12,11,9,2,13,21,1,0,9,-9,1,1,0,0,0,0,0,0,0,0.508788710910954,0.491211289089046
89396,0.4926108374384236,0.5454545454545454,103,-120,0.47385941729410397,0.526140582705896,home,NYM,under,7.5,0.5121951219512195,-105,0.491211289089046,NYM,MIA,2023 REG,12,11,9,2,13,21,1,0,9,-9,1,1,0,0,0,0,0,0,0,0.508788710910954,0.491211289089046
89397,0.48780487804878053,0.5535714285714286,105,-124,0.4676213138438005,0.5323786861561994,away,TB,over,9,0.5215311004784688,-109,0.49907282342437215,TOR,TB,2023 REG,10,6,8,3,9,18,1,0,3,-3,1,1,1,0,0,0,0,0,0,0.49907282342437215,0.5009271765756278
89397,0.48780487804878053,0.5535714285714286,105,-124,0.4676213138438005,0.5323786861561994,home,TOR,under,9,0.5215311004784688,-109,0.5009271765756278,TOR,TB,2023 REG,10,6,8,3,9,18,1,0,3,-3,1,1,1,0,0,0,0,0,0,0.49907282342437215,0.5009271765756278
89398,0.5918367346938775,0.4504504504504505,-145,122,0.566809625118663,0.43319037488133705,away,PHI,over,8,0.5238095238095238,-110,0.4988662131519274,TB,PHI,2023 REG,6,1,6,3,4,12,0,1,-2,2,1,0,0,0,0,0,0,0,0,0.4988662131519274,0.5011337868480725
89398,0.5918367346938775,0.4504504504504505,-145,122,0.566809625118663,0.43319037488133705,home,TB,under,8,0.5238095238095238,-110,0.5011337868480725,TB,PHI,2023 REG,6,1,6,3,4,12,0,1,-2,2,1,0,0,0,0,0,0,0,0,0.4988662131519274,0.5011337868480725
89399,0.7183098591549296,0.31746031746031744,-255,215,0.6926157886284845,0.3073842113715155,away,COL,over,8,0.5,100,0.4772727272727273,SF,COL,2023 REG,7,1,7,0,1,14,1,0,1,-1,0,0,0,0,0,0,0,0,0,0.4772727272727273,0.5227272727272727
89399,0.7183098591549296,0.31746031746031744,-255,215,0.6926157886284845,0.3073842113715155,home,SF,under,8,0.5454545454545454,-120,0.5227272727272727,SF,COL,2023 REG,7,1,7,0,1,14,1,0,1,-1,0,0,0,0,0,0,0,0,0,0.4772727272727273,0.5227272727272727
89400,0.7354497354497355,0.3021148036253776,-278,231,0.7078229051246523,0.2921770948753477,away,KC,over,8,0.5238095238095238,-110,0.4988662131519274,ARI,KC,2023 REG,6,2,5,0,2,11,1,0,2,-2,0,0,0,0,0,0,0,0,0,0.4988662131519274,0.5011337868480725
89400,0.7354497354497355,0.3021148036253776,-278,231,0.7078229051246523,0.2921770948753477,home,ARI,under,8,0.5238095238095238,-110,0.5011337868480725,ARI,KC,2023 REG,6,2,5,0,2,11,1,0,2,-2,0,0,0,0,0,0,0,0,0,0.4988662131519274,0.5011337868480725
89401,0.6666666666666666,0.373134328358209,-200,168,0.6401326699834162,0.3598673300165838,away,DET,over,9,0.5238095238095238,-110,0.4988662131519274,TEX,DET,2023 REG,8,2,10,7,9,18,0,1,-5,5,1,1,0,0,0,0,0,0,0,0.4988662131519274,0.5011337868480725
89401,0.6666666666666666,0.373134328358209,-200,168,0.6401326699834162,0.3598673300165838,home,TEX,under,9,0.5238095238095238,-110,0.5011337868480725,TEX,DET,2023 REG,8,2,10,7,9,18,0,1,-5,5,1,1,0,0,0,0,0,0,0,0.4988662131519274,0.5011337868480725
89402,0.5121951219512195,0.5348837209302326,-105,-115,0.48808156828023186,0.5119184317197681,away,OAK,over,10,0.5391705069124424,-117,0.5140669063204599,KC,OAK,2023 REG,9,5,4,1,6,13,1,0,4,-4,1,0,0,0,0,0,0,0,0,0.5140669063204599,0.4859330936795401
89402,0.5121951219512195,0.5348837209302326,-105,-115,0.48808156828023186,0.5119184317197681,home,KC,under,10,0.5073891625615764,-103,0.4859330936795401,KC,OAK,2023 REG,9,5,4,1,6,13,1,0,4,-4,1,0,0,0,0,0,0,0,0,0.5140669063204599,0.4859330936795401
89403,0.5238095238095238,0.5238095238095238,-110,-110,0.4988662131519274,0.5011337868480725,away,SD,over,9,0.5238095238095238,-110,0.4988662131519274,STL,SD,2023 REG,10,5,11,4,9,21,1,0,1,-1,1,1,1,1,0,0,0,0,0,0.4988662131519274,0.5011337868480725
89403,0.5238095238095238,0.5238095238095238,-110,-110,0.4988662131519274,0.5011337868480725,home,STL,under,9,0.5238095238095238,-110,0.5011337868480725,STL,SD,2023 REG,10,5,11,4,9,21,1,0,1,-1,1,1,1,1,0,0,0,0,0,0.4988662131519274,0.5011337868480725
89404,0.3508771929824561,0.6923076923076923,185,-225,0.3357246016525795,0.6642753983474206,away,TEX,over,10.5,0.5121951219512195,-105,0.48808156828023186,WSH,TEX,2023 REG,13,7,8,2,9,21,1,0,5,-5,1,1,0,0,0,0,0,0,0,0.48808156828023186,0.5119184317197681
89404,0.3508771929824561,0.6923076923076923,185,-225,0.3357246016525795,0.6642753983474206,home,WSH,under,10.5,0.5348837209302326,-115,0.5119184317197681,WSH,TEX,2023 REG,13,7,8,2,9,21,1,0,5,-5,1,1,0,0,0,0,0,0,0,0.48808156828023186,0.5119184317197681
89405,0.4098360655737705,0.6296296296296295,144,-170,0.3936616003264754,0.6063383996735245,away,TOR,over,8,0.5121951219512195,-105,0.48808156828023186,CLE,TOR,2023 REG,6,0,8,1,1,14,0,1,-1,1,0,0,0,0,0,0,0,0,0,0.48808156828023186,0.5119184317197681
89405,0.4098360655737705,0.6296296296296295,144,-170,0.3936616003264754,0.6063383996735245,home,CLE,under,8,0.5348837209302326,-115,0.5119184317197681,CLE,TOR,2023 REG,6,0,8,1,1,14,0,1,-1,1,0,0,0,0,0,0,0,0,0,0.48808156828023186,0.5119184317197681
89406,0.5918367346938775,0.4504504504504505,-145,122,0.566809625118663,0.43319037488133705,away,CWS,over,8.5,0.5412844036697247,-118,0.5162581740877563,CLE,CWS,2023 REG,7,3,10,5,8,17,0,1,-2,2,1,1,1,0,0,0,0,0,0,0.5162581740877563,0.4837418259122437
89406,0.5918367346938775,0.4504504504504505,-145,122,0.566809625118663,0.43319037488133705,home,CLE,under,8.5,0.504950495049505,-102,0.4837418259122437,CLE,CWS,2023 REG,7,3,10,5,8,17,0,1,-2,2,1,1,1,0,0,0,0,0,0,0.5162581740877563,0.4837418259122437
89407,0.6875,0.35211267605633806,-220,184,0.6602662852112676,0.3397337147887324,away,WSH,over,9,0.5348837209302326,-115,0.5097020142727117,NYM,WSH,2023 REG,6,2,5,1,3,11,1,0,1,-1,1,0,0,0,0,0,0,0,0,0.5097020142727117,0.49029798572728833
89407,0.6875,0.35211267605633806,-220,184,0.6602662852112676,0.3397337147887324,home,NYM,under,9,0.5121951219512195,-105,0.49029798572728833,NYM,WSH,2023 REG,6,2,5,1,3,11,1,0,1,-1,1,0,0,0,0,0,0,0,0,0.5097020142727117,0.49029798572728833
89408,0.6363636363636364,0.4081632653061224,-175,145,0.6080283353010626,0.3919716646989374,away,STL,over,9,0.5238095238095238,-110,0.4988662131519274,TB,STL,2023 REG,9,4,9,6,10,18,0,1,-2,2,1,1,1,1,0,0,0,0,0,0.4988662131519274,0.5011337868480725
89408,0.6363636363636364,0.4081632653061224,-175,145,0.6080283353010626,0.3919716646989374,home,TB,under,9,0.5238095238095238,-110,0.5011337868480725,TB,STL,2023 REG,9,4,9,6,10,18,0,1,-2,2,1,1,1,1,0,0,0,0,0,0.4988662131519274,0.5011337868480725
89409,0.5,0.5454545454545454,100,-120,0.4772727272727273,0.5227272727272727,away,LAA,over,9,0.5454545454545454,-120,0.5206611570247933,KC,LAA,2023 REG,8,2,9,5,7,17,0,1,-3,3,1,1,0,0,0,0,0,0,0,0.5206611570247933,0.4793388429752067
89409,0.5,0.5454545454545454,100,-120,0.4772727272727273,0.5227272727272727,home,KC,under,9,0.5,100,0.4793388429752067,KC,LAA,2023 REG,8,2,9,5,7,17,0,1,-3,3,1,1,0,0,0,0,0,0,0,0.5206611570247933,0.4793388429752067
89411,0.5555555555555556,0.4807692307692307,-125,108,0.5353751187084521,0.4646248812915479,away,PHI,over,8,0.5238095238095238,-110,0.4988662131519274,ARI,PHI,2023 REG,8,3,5,4,7,13,0,1,-1,1,1,1,1,0,0,0,0,0,0,0.4988662131519274,0.5011337868480725
89411,0.5555555555555556,0.4807692307692307,-125,108,0.5353751187084521,0.4646248812915479,home,ARI,under,8,0.5238095238095238,-110,0.5011337868480725,ARI,PHI,2023 REG,8,3,5,4,7,13,0,1,-1,1,1,1,1,0,0,0,0,0,0,0.4988662131519274,0.5011337868480725
89412,0.5121951219512195,0.5238095238095238,-105,-110,0.4937537180249852,0.5062462819750149,away,MIL,over,10,0.5348837209302326,-115,0.5097020142727117,CIN,MIL,2023 REG,11,8,11,10,18,22,0,1,-2,2,1,1,1,1,1,1,1,1,0,0.5097020142727117,0.49029798572728833
89412,0.5121951219512195,0.5238095238095238,-105,-110,0.4937537180249852,0.5062462819750149,home,CIN,under,10,0.5121951219512195,-105,0.49029798572728833,CIN,MIL,2023 REG,11,8,11,10,18,22,0,1,-2,2,1,1,1,1,1,1,1,1,0,0.5097020142727117,0.49029798572728833
89413,0.4347826086956522,0.6062992125984252,130,-154,0.4169209472634447,0.5830790527365552,away,ATL,over,8.5,0.5348837209302326,-115,0.5097020142727117,PHI,ATL,2023 REG,11,2,10,4,6,21,0,1,-2,2,1,1,0,0,0,0,0,0,0,0.5097020142727117,0.49029798572728833
89413,0.4347826086956522,0.6062992125984252,130,-154,0.4169209472634447,0.5830790527365552,home,PHI,under,8.5,0.5121951219512195,-105,0.49029798572728833,PHI,ATL,2023 REG,11,2,10,4,6,21,0,1,-2,2,1,1,0,0,0,0,0,0,0,0.5097020142727117,0.49029798572728833
89414,0.33557046979865773,0.7076023391812866,198,-242,0.3210829500067301,0.67891704999327,away,ATL,over,8.5,0.5121951219512195,-105,0.48808156828023186,NYM,ATL,2023 REG,5,0,7,6,6,12,0,1,-6,6,0,0,0,0,0,0,0,0,0,0.48808156828023186,0.5119184317197681
89414,0.33557046979865773,0.7076023391812866,198,-242,0.3210829500067301,0.67891704999327,home,NYM,under,8.5,0.5348837209302326,-115,0.5119184317197681,NYM,ATL,2023 REG,5,0,7,6,6,12,0,1,-6,6,0,0,0,0,0,0,0,0,0,0.48808156828023186,0.5119184317197681
89415,0.5726495726495727,0.4672897196261683,-134,114,0.5497783539959433,0.4502216460040567,away,CWS,over,9.5,0.5121951219512195,-105,0.48808156828023186,WSH,CWS,2023 REG,14,13,6,3,16,20,1,0,10,-10,1,1,1,0,0,0,0,0,0,0.48808156828023186,0.5119184317197681
89415,0.5726495726495727,0.4672897196261683,-134,114,0.5497783539959433,0.4502216460040567,home,WSH,under,9.5,0.5348837209302326,-115,0.5119184317197681,WSH,CWS,2023 REG,14,13,6,3,16,20,1,0,10,-10,1,1,1,0,0,0,0,0,0,0.48808156828023186,0.5119184317197681
89416,0.5454545454545454,0.5,-120,100,0.5206611570247933,0.4793388429752067,away,CWS,over,9.5,0.5327102803738317,-114,0.5075272610403079,WSH,CWS,2023 REG,7,4,8,3,7,15,1,0,1,-1,1,1,1,0,0,0,0,0,0,0.5075272610403079,0.4924727389596921
89416,0.5454545454545454,0.5,-120,100,0.5206611570247933,0.4793388429752067,home,WSH,under,9.5,0.5145631067961165,-106,0.4924727389596921,WSH,CWS,2023 REG,7,4,8,3,7,15,1,0,1,-1,1,1,1,0,0,0,0,0,0,0.5075272610403079,0.4924727389596921
89417,0.5833333333333333,0.45454545454545453,-140,120,0.5612373737373737,0.4387626262626263,away,KC,over,8.5,0.5238095238095238,-110,0.4988662131519274,DET,KC,2023 REG,11,9,11,4,13,22,1,0,5,-5,1,1,1,1,0,0,0,0,0,0.4988662131519274,0.5011337868480725
89417,0.5833333333333333,0.45454545454545453,-140,120,0.5612373737373737,0.4387626262626263,home,DET,under,8.5,0.5238095238095238,-110,0.5011337868480725,DET,KC,2023 REG,11,9,11,4,13,22,1,0,5,-5,1,1,1,1,0,0,0,0,0,0.4988662131519274,0.5011337868480725
89419,0.6491228070175439,0.38759689922480617,-185,158,0.6252872082286499,0.3747127917713501,away,WSH,over,9,0.5,100,0.4772727272727273,PHI,WSH,2023 REG,8,7,0,0,7,8,1,0,7,-7,0,0,0,0,0,0,0,0,0,0.4772727272727273,0.5227272727272727
89419,0.6491228070175439,0.38759689922480617,-185,158,0.6252872082286499,0.3747127917713501,home,PHI,under,9,0.5454545454545454,-120,0.5227272727272727,PHI,WSH,2023 REG,8,7,0,0,7,8,1,0,7,-7,0,0,0,0,0,0,0,0,0,0.4772727272727273,0.5227272727272727
89420,0.45248868778280543,0.5867768595041323,121,-142,0.4347214718158653,0.5652785281841347,away,LAD,over,7.5,0.5,100,0.4772727272727273,CHC,LAD,2023 REG,6,3,8,7,10,14,0,1,-4,4,1,1,1,0,0,0,0,0,0,0.4772727272727273,0.5227272727272727
89420,0.45248868778280543,0.5867768595041323,121,-142,0.4347214718158653,0.5652785281841347,home,CHC,under,7.5,0.5454545454545454,-120,0.5227272727272727,CHC,LAD,2023 REG,6,3,8,7,10,14,0,1,-4,4,1,1,1,0,0,0,0,0,0,0.4772727272727273,0.5227272727272727
89421,0.6183206106870228,0.4166666666666667,-162,140,0.5966872559874133,0.40331274401258665,away,MIN,over,10,0.5348837209302326,-115,0.5097020142727117,ATL,MIN,2023 REG,6,3,4,0,3,10,1,0,3,-3,0,0,0,0,0,0,0,0,0,0.5097020142727117,0.49029798572728833
89421,0.6183206106870228,0.4166666666666667,-162,140,0.5966872559874133,0.40331274401258665,home,ATL,under,10,0.5121951219512195,-105,0.49029798572728833,ATL,MIN,2023 REG,6,3,4,0,3,10,1,0,3,-3,0,0,0,0,0,0,0,0,0,0.5097020142727117,0.49029798572728833
89422,0.5215311004784688,0.5145631067961165,-109,-106,0.5027068488376564,0.4972931511623436,away,PIT,over,13,0.5305164319248826,-113,0.5066009958897986,COL,PIT,2023 REG,10,3,9,5,8,19,0,1,-2,2,1,1,1,0,0,0,0,0,0,0.5066009958897986,0.49339900411020143
89422,0.5215311004784688,0.5145631067961165,-109,-106,0.5027068488376564,0.4972931511623436,home,COL,under,13,0.5145631067961165,-106,0.49339900411020143,COL,PIT,2023 REG,10,3,9,5,8,19,0,1,-2,2,1,1,1,0,0,0,0,0,0,0.5066009958897986,0.49339900411020143
89423,0.6428571428571428,0.4,-180,150,0.6153061224489796,0.38469387755102036,away,NYY,over,8.5,0.5098039215686274,-104,0.48592421718142587,HOU,NYY,2023 REG,4,2,8,6,8,12,0,1,-4,4,1,1,0,0,0,0,0,0,0,0.48592421718142587,0.5140757828185741
89423,0.6428571428571428,0.4,-180,150,0.6153061224489796,0.38469387755102036,home,HOU,under,8.5,0.5370370370370371,-116,0.5140757828185741,HOU,NYY,2023 REG,4,2,8,6,8,12,0,1,-4,4,1,1,0,0,0,0,0,0,0,0.48592421718142587,0.5140757828185741
89424,0.574468085106383,0.4672897196261683,-135,114,0.550479558983428,0.44952044101657196,away,SD,over,8,0.5238095238095238,-110,0.5012646084074657,LAD,SD,2023 REG,3,1,8,6,7,11,0,1,-5,5,1,0,0,0,0,0,0,0,0,0.5012646084074657,0.4987353915925343
89424,0.574468085106383,0.4672897196261683,-135,114,0.550479558983428,0.44952044101657196,home,LAD,under,8,0.5192307692307692,-108,0.4987353915925343,LAD,SD,2023 REG,3,1,8,6,7,11,0,1,-5,5,1,0,0,0,0,0,0,0,0,0.5012646084074657,0.4987353915925343
89425,0.5121951219512195,0.5260663507109005,-105,-111,0.4925977822950117,0.5074022177049883,away,CIN,over,7.5,0.5327102803738317,-114,0.508788710910954,PIT,CIN,2023 REG,6,2,4,0,2,10,1,0,2,-2,0,0,0,0,0,0,0,0,0,0.508788710910954,0.491211289089046
89425,0.5121951219512195,0.5260663507109005,-105,-111,0.4925977822950117,0.5074022177049883,home,PIT,under,7.5,0.5121951219512195,-105,0.491211289089046,PIT,CIN,2023 REG,6,2,4,0,2,10,1,0,2,-2,0,0,0,0,0,0,0,0,0,0.508788710910954,0.491211289089046
89426,0.5833333333333333,0.4566210045662101,-140,119,0.5600266362252664,0.4399733637747336,away,BAL,over,9,0.5,100,0.4772727272727273,BOS,BAL,2023 REG,14,9,10,5,14,24,1,0,4,-4,1,1,1,1,1,0,0,0,0,0.4772727272727273,0.5227272727272727
89426,0.5833333333333333,0.4566210045662101,-140,119,0.5600266362252664,0.4399733637747336,home,BOS,under,9,0.5454545454545454,-120,0.5227272727272727,BOS,BAL,2023 REG,14,9,10,5,14,24,1,0,4,-4,1,1,1,1,1,0,0,0,0,0.4772727272727273,0.5227272727272727
89427,0.6254681647940076,0.41152263374485604,-167,143,0.6023315979176397,0.3976684020823603,away,CIN,over,9.5,0.5348837209302326,-115,0.5097020142727117,BAL,CIN,2023 REG,10,7,16,11,18,26,0,1,-4,4,1,1,1,1,1,1,1,0,0,0.5097020142727117,0.49029798572728833
89427,0.6254681647940076,0.41152263374485604,-167,143,0.6023315979176397,0.3976684020823603,home,BAL,under,9.5,0.5121951219512195,-105,0.49029798572728833,BAL,CIN,2023 REG,10,7,16,11,18,26,0,1,-4,4,1,1,1,1,1,1,1,0,0,0.5097020142727117,0.49029798572728833
89428,0.6610169491525424,0.37878787878787884,-195,164,0.6347052832258232,0.3652947167741768,away,KC,over,9,0.5,100,0.4772727272727273,CWS,KC,2023 REG,6,5,7,1,6,13,1,0,4,-4,1,0,0,0,0,0,0,0,0,0.4772727272727273,0.5227272727272727
89428,0.6610169491525424,0.37878787878787884,-195,164,0.6347052832258232,0.3652947167741768,home,CWS,under,9,0.5454545454545454,-120,0.5227272727272727,CWS,KC,2023 REG,6,5,7,1,6,13,1,0,4,-4,1,0,0,0,0,0,0,0,0,0.4772727272727273,0.5227272727272727
89429,0.6551724137931035,0.38759689922480617,-190,158,0.6271511397468869,0.37284886025311315,away,MIA,over,7,0.5,-100,0.4783105022831051,SEA,MIA,2023 REG,4,1,6,4,5,10,0,1,-3,3,1,0,0,0,0,0,0,0,0,0.4783105022831051,0.5216894977168949
89429,0.6551724137931035,0.38759689922480617,-190,158,0.6271511397468869,0.37284886025311315,home,SEA,under,7,0.5433789954337899,-119,0.5216894977168949,SEA,MIA,2023 REG,4,1,6,4,5,10,0,1,-3,3,1,0,0,0,0,0,0,0,0,0.4783105022831051,0.5216894977168949
89430,0.5121951219512195,0.5348837209302326,-105,-115,0.48808156828023186,0.5119184317197681,away,ARI,over,11.5,0.5024875621890548,-101,0.48049269377245407,CIN,ARI,2023 REG,13,7,10,3,10,23,1,0,4,-4,1,1,1,0,0,0,0,0,0,0.48049269377245407,0.5195073062275459
89430,0.5121951219512195,0.5348837209302326,-105,-115,0.48808156828023186,0.5119184317197681,home,CIN,under,11.5,0.5412844036697247,-118,0.5195073062275459,CIN,ARI,2023 REG,13,7,10,3,10,23,1,0,4,-4,1,1,1,0,0,0,0,0,0,0.48049269377245407,0.5195073062275459
89432,0.635036496350365,0.40485829959514175,-174,147,0.6097018449105176,0.3902981550894824,away,MIA,over,9,0.5433789954337899,-119,0.5198077604720502,CHC,MIA,2023 REG,8,4,8,1,5,16,1,0,3,-3,1,0,0,0,0,0,0,0,0,0.5198077604720502,0.48019223952794976
89432,0.635036496350365,0.40485829959514175,-174,147,0.6097018449105176,0.3902981550894824,home,CHC,under,9,0.5,100,0.48019223952794976,CHC,MIA,2023 REG,8,4,8,1,5,16,1,0,3,-3,1,0,0,0,0,0,0,0,0,0.5198077604720502,0.48019223952794976
89433,0.5652173913043479,0.47619047619047616,-130,110,0.5418129444594474,0.4581870555405526,away,CLE,over,8,0.5121951219512195,-105,0.48808156828023186,CHC,CLE,2023 REG,5,0,8,6,6,13,0,1,-6,6,0,0,0,0,0,0,0,0,0,0.48808156828023186,0.5119184317197681
89433,0.5652173913043479,0.47619047619047616,-130,110,0.5418129444594474,0.4581870555405526,home,CHC,under,8,0.5348837209302326,-115,0.5119184317197681,CHC,CLE,2023 REG,5,0,8,6,6,13,0,1,-6,6,0,0,0,0,0,0,0,0,0,0.48808156828023186,0.5119184317197681
89434,0.5867768595041323,0.45454545454545453,-142,120,0.5625298818386723,0.43747011816132775,away,SD,over,8.5,0.5192307692307692,-108,0.49455035168025013,MIL,SD,2023 REG,6,5,5,4,9,11,1,0,1,-1,1,1,1,1,0,0,0,0,0,0.49455035168025013,0.5054496483197499
89434,0.5867768595041323,0.45454545454545453,-142,120,0.5625298818386723,0.43747011816132775,home,MIL,under,8.5,0.5283018867924528,-112,0.5054496483197499,MIL,SD,2023 REG,6,5,5,4,9,11,1,0,1,-1,1,1,1,1,0,0,0,0,0,0.49455035168025013,0.5054496483197499
89435,0.607843137254902,0.4347826086956522,-155,130,0.5819333701084867,0.41806662989151333,away,STL,over,8.5,0.5238095238095238,-110,0.5000596729920038,MIL,STL,2023 REG,9,4,5,0,4,14,1,0,4,-4,0,0,0,0,0,0,0,0,0,0.5000596729920038,0.4999403270079962
89435,0.607843137254902,0.4347826086956522,-155,130,0.5819333701084867,0.41806662989151333,home,MIL,under,8.5,0.5215311004784688,-109,0.4999403270079962,MIL,STL,2023 REG,9,4,5,0,4,14,1,0,4,-4,0,0,0,0,0,0,0,0,0,0.5000596729920038,0.4999403270079962
89436,0.6491228070175439,0.38759689922480617,-185,158,0.6252872082286499,0.3747127917713501,away,HOU,over,8.5,0.5412844036697247,-118,0.5175913212324037,LAD,HOU,2023 REG,5,8,13,7,15,18,1,0,1,-1,1,1,1,1,1,1,1,0,0,0.5175913212324037,0.4824086787675963
89436,0.6491228070175439,0.38759689922480617,-185,158,0.6252872082286499,0.3747127917713501,home,LAD,under,8.5,0.5024875621890548,-101,0.4824086787675963,LAD,HOU,2023 REG,5,8,13,7,15,18,1,0,1,-1,1,1,1,1,1,1,1,0,0,0.5175913212324037,0.4824086787675963
89437,0.5192307692307692,0.5215311004784688,-108,-109,0.49806595226635714,0.5019340477336429,away,SEA,over,8.5,0.5121951219512195,-105,0.48808156828023186,BAL,SEA,2023 REG,3,1,17,13,14,20,0,1,-12,12,1,0,0,0,0,0,0,0,0,0.48808156828023186,0.5119184317197681
89437,0.5192307692307692,0.5215311004784688,-108,-109,0.49806595226635714,0.5019340477336429,home,BAL,under,8.5,0.5348837209302326,-115,0.5119184317197681,BAL,SEA,2023 REG,3,1,17,13,14,20,0,1,-12,12,1,0,0,0,0,0,0,0,0,0.48808156828023186,0.5119184317197681
89439,0.6363636363636364,0.4081632653061224,-175,145,0.6080283353010626,0.3919716646989374,away,DET,over,8,0.5,100,0.4772727272727273,CLE,DET,2023 REG,9,3,7,4,7,16,0,1,-1,1,1,1,1,0,0,0,0,0,0,0.4772727272727273,0.5227272727272727
89439,0.6363636363636364,0.4081632653061224,-175,145,0.6080283353010626,0.3919716646989374,home,CLE,under,8,0.5454545454545454,-120,0.5227272727272727,CLE,DET,2023 REG,9,3,7,4,7,16,0,1,-1,1,1,1,1,0,0,0,0,0,0,0.4772727272727273,0.5227272727272727
89440,0.5348837209302326,0.5121951219512195,-115,-105,0.5097020142727117,0.49029798572728833,away,LAA,over,9,0.5348837209302326,-115,0.5097020142727117,BOS,LAA,2023 REG,7,2,4,1,3,11,1,0,1,-1,1,0,0,0,0,0,0,0,0,0.5097020142727117,0.49029798572728833
89440,0.5348837209302326,0.5121951219512195,-115,-105,0.5097020142727117,0.49029798572728833,home,BOS,under,9,0.5121951219512195,-105,0.49029798572728833,BOS,LAA,2023 REG,7,2,4,1,3,11,1,0,1,-1,1,0,0,0,0,0,0,0,0,0.5097020142727117,0.49029798572728833
89441,0.5967741935483871,0.4444444444444444,-148,125,0.5721759741010521,0.42782402589894786,away,SF,over,8.5,0.5098039215686274,-104,0.48483656587239576,ARI,SF,2023 REG,13,8,6,4,12,19,1,0,4,-4,1,1,1,1,0,0,0,0,0,0.48483656587239576,0.5151634341276042
89441,0.5967741935483871,0.4444444444444444,-148,125,0.5721759741010521,0.42782402589894786,home,ARI,under,8.5,0.5391705069124424,-117,0.5151634341276042,ARI,SF,2023 REG,13,8,6,4,12,19,1,0,4,-4,1,1,1,1,0,0,0,0,0,0.48483656587239576,0.5151634341276042
89442,0.3846153846153846,0.6551724137931035,160,-190,0.3693123852275045,0.6306876147724956,away,MIN,over,11.5,0.5238095238095238,-110,0.4988662131519274,COL,MIN,2023 REG,13,6,14,7,13,27,0,1,-1,1,1,1,1,1,1,1,0,0,0,0.4988662131519274,0.5011337868480725
89442,0.3846153846153846,0.6551724137931035,160,-190,0.3693123852275045,0.6306876147724956,home,COL,under,11.5,0.5238095238095238,-110,0.5011337868480725,COL,MIN,2023 REG,13,6,14,7,13,27,0,1,-1,1,1,1,1,1,1,1,0,0,0,0.4988662131519274,0.5011337868480725
89445,0.42016806722689076,0.6153846153846154,138,-160,0.4052299652892831,0.5947700347107169,away,STL,over,11,0.5,100,0.4772727272727273,CIN,STL,2023 REG,18,10,8,3,13,26,1,0,7,-7,1,1,1,0,0,0,0,0,0,0.4772727272727273,0.5227272727272727
89445,0.42016806722689076,0.6153846153846154,138,-160,0.4052299652892831,0.5947700347107169,home,CIN,under,11,0.5454545454545454,-120,0.5227272727272727,CIN,STL,2023 REG,18,10,8,3,13,26,1,0,7,-7,1,1,1,0,0,0,0,0,0,0.4772727272727273,0.5227272727272727
89446,0.6875,0.35211267605633806,-220,184,0.6602662852112676,0.3397337147887324,away,PHI,over,8.5,0.5192307692307692,-108,0.49455035168025013,ATL,PHI,2023 REG,13,9,4,3,12,17,1,0,6,-6,1,1,1,0,0,0,0,0,0,0.49455035168025013,0.5054496483197499
89446,0.6875,0.35211267605633806,-220,184,0.6602662852112676,0.3397337147887324,home,ATL,under,8.5,0.5283018867924528,-112,0.5054496483197499,ATL,PHI,2023 REG,13,9,4,3,12,17,1,0,6,-6,1,1,1,0,0,0,0,0,0,0.49455035168025013,0.5054496483197499
89447,0.6000000000000001,0.43859649122807015,-150,128,0.5768421052631579,0.42315789473684207,away,SF,over,8.5,0.5454545454545454,-120,0.5206611570247933,NYM,SF,2023 REG,4,4,5,1,5,9,1,0,3,-3,1,0,0,0,0,0,0,0,0,0.5206611570247933,0.4793388429752067
89447,0.6000000000000001,0.43859649122807015,-150,128,0.5768421052631579,0.42315789473684207,home,NYM,under,8.5,0.5,100,0.4793388429752067,NYM,SF,2023 REG,4,4,5,1,5,9,1,0,3,-3,1,0,0,0,0,0,0,0,0,0.5206611570247933,0.4793388429752067
89448,0.5391705069124424,0.5,-117,100,0.5180509248444435,0.4819490751555565,away,MIA,over,8.5,0.5121951219512195,-105,0.48808156828023186,BOS,MIA,2023 REG,4,0,7,2,2,11,0,1,-2,2,0,0,0,0,0,0,0,0,0,0.48808156828023186,0.5119184317197681
89448,0.5391705069124424,0.5,-117,100,0.5180509248444435,0.4819490751555565,home,BOS,under,8.5,0.5348837209302326,-115,0.5119184317197681,BOS,MIA,2023 REG,4,0,7,2,2,11,0,1,-2,2,0,0,0,0,0,0,0,0,0,0.48808156828023186,0.5119184317197681
89449,0.6825396825396826,0.3508771929824561,-215,185,0.6597313389293339,0.3402686610706661,away,COL,over,9.5,0.5,100,0.4772727272727273,CIN,COL,2023 REG,9,5,6,3,8,15,1,0,2,-2,1,1,1,0,0,0,0,0,0,0.4772727272727273,0.5227272727272727
89449,0.6825396825396826,0.3508771929824561,-215,185,0.6597313389293339,0.3402686610706661,home,CIN,under,9.5,0.5454545454545454,-120,0.5227272727272727,CIN,COL,2023 REG,9,5,6,3,8,15,1,0,2,-2,1,1,1,0,0,0,0,0,0,0.4772727272727273,0.5227272727272727
89450,0.4716981132075471,0.5652173913043479,112,-130,0.4542851393811816,0.5457148606188185,away,TOR,over,7.5,0.5098039215686274,-104,0.48483656587239576,SEA,TOR,2023 REG,9,9,14,8,17,23,1,0,1,-1,1,1,1,1,1,1,1,1,0,0.48483656587239576,0.5151634341276042
89450,0.4716981132075471,0.5652173913043479,112,-130,0.4542851393811816,0.5457148606188185,home,SEA,under,7.5,0.5391705069124424,-117,0.5151634341276042,SEA,TOR,2023 REG,9,9,14,8,17,23,1,0,1,-1,1,1,1,1,1,1,1,1,0,0.48483656587239576,0.5151634341276042
89451,0.3225806451612903,0.7159090909090909,210,-252,0.3101646012676189,0.6898353987323811,away,ATL,over,9,0.5098039215686274,-104,0.4870219861770517,WSH,ATL,2023 REG,5,1,11,7,8,16,0,1,-6,6,1,0,0,0,0,0,0,0,0,0.4870219861770517,0.5129780138229483
89451,0.3225806451612903,0.7159090909090909,210,-252,0.3101646012676189,0.6898353987323811,home,WSH,under,9,0.5348837209302326,-115,0.5129780138229483,WSH,ATL,2023 REG,5,1,11,7,8,16,0,1,-6,6,1,0,0,0,0,0,0,0,0,0.4870219861770517,0.5129780138229483
89452,0.425531914893617,0.607843137254902,135,-155,0.4113297650431834,0.5886702349568166,away,NYY,over,7.5,0.504950495049505,-102,0.4826715732667395,OAK,NYY,2023 REG,0,0,11,11,11,11,0,1,-11,11,0,0,0,0,0,0,0,0,0,0.4826715732667395,0.5173284267332605
89452,0.425531914893617,0.607843137254902,135,-155,0.4113297650431834,0.5886702349568166,home,OAK,under,7.5,0.5391705069124424,-117,0.5173284267332605,OAK,NYY,2023 REG,0,0,11,11,11,11,0,1,-11,11,0,0,0,0,0,0,0,0,0,0.4826715732667395,0.5173284267332605
89453,0.4672897196261683,0.5726495726495727,114,-134,0.44862649893656975,0.5513735010634302,away,SEA,over,8,0.5238095238095238,-110,0.4988662131519274,OAK,SEA,2023 REG,3,1,3,2,3,6,0,1,-1,1,1,0,0,0,0,0,0,0,0,0.4988662131519274,0.5011337868480725
89453,0.4672897196261683,0.5726495726495727,114,-134,0.44862649893656975,0.5513735010634302,home,OAK,under,8,0.5238095238095238,-110,0.5011337868480725,OAK,SEA,2023 REG,3,1,3,2,3,6,0,1,-1,1,1,0,0,0,0,0,0,0,0,0.4988662131519274,0.5011337868480725
89454,0.6402877697841727,0.3921568627450981,-178,155,0.6195138683805389,0.3804861316194611,away,ARI,over,8,0.5348837209302326,-115,0.5109810284308424,SF,ARI,2023 REG,10,4,5,2,6,15,1,0,2,-2,1,1,0,0,0,0,0,0,0,0.5109810284308424,0.48901897156915763
89454,0.6402877697841727,0.3921568627450981,-178,155,0.6195138683805389,0.3804861316194611,home,SF,under,8,0.5098039215686274,-104,0.48901897156915763,SF,ARI,2023 REG,10,4,5,2,6,15,1,0,2,-2,1,1,0,0,0,0,0,0,0,0.5109810284308424,0.48901897156915763
89455,0.6153846153846154,0.42016806722689076,-160,138,0.5935060414698423,0.4064939585301577,away,NYY,over,8.5,0.5,100,0.4772727272727273,TEX,NYY,2023 REG,5,2,3,0,2,8,1,0,2,-2,0,0,0,0,0,0,0,0,0,0.4772727272727273,0.5227272727272727
89455,0.6153846153846154,0.42016806722689076,-160,138,0.5935060414698423,0.4064939585301577,home,TEX,under,8.5,0.5454545454545454,-120,0.5227272727272727,TEX,NYY,2023 REG,5,2,3,0,2,8,1,0,2,-2,0,0,0,0,0,0,0,0,0,0.4772727272727273,0.5227272727272727
89456,0.6875,0.35714285714285715,-220,180,0.6568080357142857,0.3431919642857143,away,COL,over,9,0.5098039215686274,-104,0.48592421718142587,BOS,COL,2023 REG,9,6,12,7,13,21,0,1,-1,1,1,1,1,1,1,1,0,0,0,0.48592421718142587,0.5140757828185741
89456,0.6875,0.35714285714285715,-220,180,0.6568080357142857,0.3431919642857143,home,BOS,under,9,0.5370370370370371,-116,0.5140757828185741,BOS,COL,2023 REG,9,6,12,7,13,21,0,1,-1,1,1,1,1,1,1,1,0,0,0,0.48592421718142587,0.5140757828185741
89458,0.696969696969697,0.35587188612099646,-230,181,0.6601407148155773,0.33985928518442265,away,ARI,over,10,0.5391705069124424,-117,0.5089345153072766,STL,ARI,2023 REG,13,14,11,5,19,24,1,0,9,-9,1,1,1,1,1,0,0,0,0,0.5089345153072766,0.4910654846927234
89458,0.696969696969697,0.35587188612099646,-230,181,0.6601407148155773,0.33985928518442265,home,STL,under,10,0.5169082125603864,-107,0.4910654846927234,STL,ARI,2023 REG,13,14,11,5,19,24,1,0,9,-9,1,1,1,1,1,0,0,0,0,0.5089345153072766,0.4910654846927234
89459,0.6389891696750902,0.4,-177,150,0.614075512518083,0.385924487481917,away,PIT,over,8.5,0.5121951219512195,-105,0.48808156828023186,BAL,PIT,2023 REG,5,2,3,0,2,8,1,0,2,-2,0,0,0,0,0,0,0,0,0,0.48808156828023186,0.5119184317197681
89459,0.6389891696750902,0.4,-177,150,0.614075512518083,0.385924487481917,home,BAL,under,8.5,0.5348837209302326,-115,0.5119184317197681,BAL,PIT,2023 REG,5,2,3,0,2,8,1,0,2,-2,0,0,0,0,0,0,0,0,0,0.48808156828023186,0.5119184317197681
89460,0.7222222222222222,0.31746031746031744,-260,215,0.693562610229277,0.306437389770723,away,WSH,over,8,0.504950495049505,-102,0.48054649490447493,SEA,WSH,2023 REG,12,8,10,4,12,22,1,0,4,-4,1,1,1,1,0,0,0,0,0,0.48054649490447493,0.5194535050955251
89460,0.7222222222222222,0.31746031746031744,-260,215,0.693562610229277,0.306437389770723,home,SEA,under,8,0.5433789954337899,-119,0.5194535050955251,SEA,WSH,2023 REG,12,8,10,4,12,22,1,0,4,-4,1,1,1,1,0,0,0,0,0,0.48054649490447493,0.5194535050955251
89461,0.45454545454545453,0.5833333333333333,120,-140,0.43732782369146006,0.5626721763085399,away,ATL,over,9,0.5348837209302326,-115,0.5097020142727117,CLE,ATL,2023 REG,11,6,10,5,11,21,1,0,1,-1,1,1,1,1,1,0,0,0,0,0.5097020142727117,0.49029798572728833
89461,0.45454545454545453,0.5833333333333333,120,-140,0.43732782369146006,0.5626721763085399,home,CLE,under,9,0.5121951219512195,-105,0.49029798572728833,CLE,ATL,2023 REG,11,6,10,5,11,21,1,0,1,-1,1,1,1,1,1,0,0,0,0,0.5097020142727117,0.49029798572728833
89462,0.4098360655737705,0.6336996336996338,144,-173,0.3919935658715556,0.6080064341284444,away,HOU,over,8,0.5412844036697247,-118,0.5189377998484975,PIT,HOU,2023 REG,10,7,9,4,11,19,1,0,3,-3,1,1,1,1,0,0,0,0,0,0.5189377998484975,0.4810622001515025
89462,0.4098360655737705,0.6336996336996338,144,-173,0.3919935658715556,0.6080064341284444,home,PIT,under,8,0.5,100,0.4810622001515025,PIT,HOU,2023 REG,10,7,9,4,11,19,1,0,3,-3,1,1,1,1,0,0,0,0,0,0.5189377998484975,0.4810622001515025
89463,0.31746031746031744,0.7275204359673024,215,-267,0.303180713197581,0.696819286802419,away,ATL,over,9,0.5238095238095238,-110,0.4988662131519274,WSH,ATL,2023 REG,10,6,10,9,15,20,0,1,-3,3,1,1,1,1,1,1,0,0,0,0.4988662131519274,0.5011337868480725
89463,0.31746031746031744,0.7275204359673024,215,-267,0.303180713197581,0.696819286802419,home,WSH,under,9,0.5238095238095238,-110,0.5011337868480725,WSH,ATL,2023 REG,10,6,10,9,15,20,0,1,-3,3,1,1,1,1,1,1,0,0,0,0.4988662131519274,0.5011337868480725
89464,0.43859649122807015,0.6000000000000001,128,-150,0.4216682056017235,0.5783317943982764,away,CHC,over,12,0.5283018867924528,-112,0.5044173060022736,STL,CHC,2023 REG,12,7,7,5,12,19,1,0,2,-2,1,1,1,1,1,0,0,0,0,0.5044173060022736,0.49558269399772636
89464,0.43859649122807015,0.6000000000000001,128,-150,0.4216682056017235,0.5783317943982764,home,STL,under,12,0.5169082125603864,-107,0.49558269399772636,STL,CHC,2023 REG,12,7,7,5,12,19,1,0,2,-2,1,1,1,1,1,0,0,0,0,0.5044173060022736,0.49558269399772636
89465,0.7101449275362319,0.3278688524590164,-245,205,0.6831496344961281,0.3168503655038719,away,COL,over,8.5,0.5121951219512195,-105,0.48808156828023186,MIL,COL,2023 REG,13,12,1,1,13,14,1,0,11,-11,1,0,0,0,0,0,0,0,0,0.48808156828023186,0.5119184317197681
89465,0.7101449275362319,0.3278688524590164,-245,205,0.6831496344961281,0.3168503655038719,home,MIL,under,8.5,0.5348837209302326,-115,0.5119184317197681,MIL,COL,2023 REG,13,12,1,1,13,14,1,0,11,-11,1,0,0,0,0,0,0,0,0,0.48808156828023186,0.5119184317197681
89466,0.5454545454545454,0.5,-120,100,0.5206611570247933,0.4793388429752067,away,PHI,over,7,0.5145631067961165,-106,0.4913668392989033,MIA,PHI,2023 REG,13,7,6,3,10,19,1,0,4,-4,1,1,1,0,0,0,0,0,0,0.4913668392989033,0.5086331607010968
89466,0.5454545454545454,0.5,-120,100,0.5206611570247933,0.4793388429752067,home,MIA,under,7,0.5305164319248826,-113,0.5086331607010968,MIA,PHI,2023 REG,13,7,6,3,10,19,1,0,4,-4,1,1,1,0,0,0,0,0,0,0.4913668392989033,0.5086331607010968
89467,0.5652173913043479,0.47619047619047616,-130,110,0.5418129444594474,0.4581870555405526,away,STL,over,9.5,0.5412844036697247,-118,0.5162581740877563,PIT,STL,2023 REG,8,6,9,3,9,17,1,0,3,-3,1,1,1,0,0,0,0,0,0,0.5162581740877563,0.4837418259122437
89467,0.5652173913043479,0.47619047619047616,-130,110,0.5418129444594474,0.4581870555405526,home,PIT,under,9.5,0.504950495049505,-102,0.4837418259122437,PIT,STL,2023 REG,8,6,9,3,9,17,1,0,3,-3,1,1,1,0,0,0,0,0,0,0.5162581740877563,0.4837418259122437
89468,0.6296296296296295,0.41152263374485604,-170,143,0.6037189452827312,0.3962810547172688,away,BOS,over,8.5,0.5121951219512195,-105,0.48919479393107135,BAL,BOS,2023 REG,2,1,5,6,7,7,0,1,-5,5,1,0,0,0,0,0,0,0,0,0.48919479393107135,0.5108052060689287
89468,0.6296296296296295,0.41152263374485604,-170,143,0.6037189452827312,0.3962810547172688,home,BAL,under,8.5,0.5327102803738317,-114,0.5108052060689287,BAL,BOS,2023 REG,2,1,5,6,7,7,0,1,-5,5,1,0,0,0,0,0,0,0,0,0.48919479393107135,0.5108052060689287
89470,0.3508771929824561,0.6923076923076923,185,-225,0.3357246016525795,0.6642753983474206,away,LAD,over,11.5,0.5348837209302326,-115,0.5097020142727117,COL,LAD,2023 REG,18,14,12,5,19,30,1,0,9,-9,1,1,1,1,1,0,0,0,0,0.5097020142727117,0.49029798572728833
89470,0.3508771929824561,0.6923076923076923,185,-225,0.3357246016525795,0.6642753983474206,home,COL,under,11.5,0.5121951219512195,-105,0.49029798572728833,COL,LAD,2023 REG,18,14,12,5,19,30,1,0,9,-9,1,1,1,1,1,0,0,0,0,0.5097020142727117,0.49029798572728833
89471,0.5,0.5454545454545454,100,-120,0.4772727272727273,0.5227272727272727,away,SF,over,9.5,0.5073891625615764,-103,0.4826927225525911,WSH,SF,2023 REG,11,6,6,1,7,17,1,0,5,-5,1,0,0,0,0,0,0,0,0,0.4826927225525911,0.5173072774474089
89471,0.5,0.5454545454545454,100,-120,0.4772727272727273,0.5227272727272727,home,WSH,under,9.5,0.5412844036697247,-118,0.5173072774474089,WSH,SF,2023 REG,11,6,6,1,7,17,1,0,5,-5,1,0,0,0,0,0,0,0,0,0.4826927225525911,0.5173072774474089
89472,0.5833333333333333,0.4629629629629629,-140,116,0.5563271604938271,0.44367283950617287,away,SEA,over,8,0.5348837209302326,-115,0.5097020142727117,TB,SEA,2023 REG,11,6,9,3,9,20,1,0,3,-3,1,1,1,0,0,0,0,0,0,0.5097020142727117,0.49029798572728833
89472,0.5833333333333333,0.4629629629629629,-140,116,0.5563271604938271,0.44367283950617287,home,TB,under,8,0.5121951219512195,-105,0.49029798572728833,TB,SEA,2023 REG,11,6,9,3,9,20,1,0,3,-3,1,1,1,0,0,0,0,0,0,0.5097020142727117,0.49029798572728833
89473,0.4291845493562232,0.607843137254902,133,-155,0.41329283836432396,0.586707161635676,away,SEA,over,7,0.5454545454545454,-120,0.5206611570247933,NYY,SEA,2023 REG,5,4,4,2,6,9,1,0,2,-2,1,1,0,0,0,0,0,0,0,0.5206611570247933,0.4793388429752067
89473,0.4291845493562232,0.607843137254902,133,-155,0.41329283836432396,0.586707161635676,home,NYY,under,7,0.5,100,0.4793388429752067,NYY,SEA,2023 REG,5,4,4,2,6,9,1,0,2,-2,1,1,0,0,0,0,0,0,0,0.5206611570247933,0.4793388429752067
89474,0.46511627906976744,0.574468085106383,115,-135,0.44670494689481377,0.5532950531051862,away,CHC,over,8.5,0.5145631067961165,-106,0.49023796582517226,ARI,CHC,2023 REG,8,6,7,4,10,15,1,0,2,-2,1,1,1,1,0,0,0,0,0,0.49023796582517226,0.5097620341748277
89474,0.46511627906976744,0.574468085106383,115,-135,0.44670494689481377,0.5532950531051862,home,ARI,under,8.5,0.5327102803738317,-114,0.5097620341748277,ARI,CHC,2023 REG,8,6,7,4,10,15,1,0,2,-2,1,1,1,1,0,0,0,0,0,0.49023796582517226,0.5097620341748277
89475,0.5833333333333333,0.45454545454545453,-140,120,0.5612373737373737,0.4387626262626263,away,CHC,over,7.5,0.5348837209302326,-115,0.5097020142727117,MIN,CHC,2023 REG,18,16,6,3,19,24,1,0,13,-13,1,1,1,0,0,0,0,0,0,0.5097020142727117,0.49029798572728833
89475,0.5833333333333333,0.45454545454545453,-140,120,0.5612373737373737,0.4387626262626263,home,MIN,under,7.5,0.5121951219512195,-105,0.49029798572728833,MIN,CHC,2023 REG,18,16,6,3,19,24,1,0,13,-13,1,1,1,0,0,0,0,0,0,0.5097020142727117,0.49029798572728833
89476,0.5348837209302326,0.5121951219512195,-115,-105,0.5097020142727117,0.49029798572728833,away,ATL,over,9.5,0.5073891625615764,-103,0.4837652908580103,TOR,ATL,2023 REG,13,6,10,5,11,23,1,0,1,-1,1,1,1,1,1,0,0,0,0,0.4837652908580103,0.5162347091419897
89476,0.5348837209302326,0.5121951219512195,-115,-105,0.5097020142727117,0.49029798572728833,home,TOR,under,9.5,0.5391705069124424,-117,0.5162347091419897,TOR,ATL,2023 REG,13,6,10,5,11,23,1,0,1,-1,1,1,1,1,1,0,0,0,0,0.4837652908580103,0.5162347091419897
89477,0.5833333333333333,0.45454545454545453,-140,120,0.5612373737373737,0.4387626262626263,away,TB,over,8.5,0.5348837209302326,-115,0.5097020142727117,TOR,TB,2023 REG,7,5,14,7,12,21,0,1,-2,2,1,1,1,1,1,0,0,0,0,0.5097020142727117,0.49029798572728833
89477,0.5833333333333333,0.45454545454545453,-140,120,0.5612373737373737,0.4387626262626263,home,TOR,under,8.5,0.5121951219512195,-105,0.49029798572728833,TOR,TB,2023 REG,7,5,14,7,12,21,0,1,-2,2,1,1,1,1,1,0,0,0,0,0.5097020142727117,0.49029798572728833
89478,0.4504504504504505,0.5918367346938775,122,-145,0.43140216885390636,0.5685978311460936,away,CLE,over,9,0.5391705069124424,-117,0.5153817639191344,CWS,CLE,2023 REG,4,0,7,5,5,11,0,1,-5,5,0,0,0,0,0,0,0,0,0,0.5153817639191344,0.4846182360808656
89478,0.4504504504504505,0.5918367346938775,122,-145,0.43140216885390636,0.5685978311460936,home,CWS,under,9,0.504950495049505,-102,0.4846182360808656,CWS,CLE,2023 REG,4,0,7,5,5,11,0,1,-5,5,0,0,0,0,0,0,0,0,0,0.5153817639191344,0.4846182360808656
89479,0.5689655172413793,0.47619047619047616,-132,110,0.5432733140818753,0.4567266859181247,away,CLE,over,8,0.5145631067961165,-106,0.4913668392989033,MIN,CLE,2023 REG,6,1,8,0,1,14,1,0,1,-1,0,0,0,0,0,0,0,0,0,0.4913668392989033,0.5086331607010968
89479,0.5689655172413793,0.47619047619047616,-132,110,0.5432733140818753,0.4567266859181247,home,MIN,under,8,0.5305164319248826,-113,0.5086331607010968,MIN,CLE,2023 REG,6,1,8,0,1,14,1,0,1,-1,0,0,0,0,0,0,0,0,0,0.4913668392989033,0.5086331607010968
89480,0.6153846153846154,0.425531914893617,-160,135,0.5902052121364724,0.40979478786352763,away,BOS,over,8,0.5238095238095238,-110,0.4988662131519274,PHI,BOS,2023 REG,8,3,8,5,8,16,0,1,-2,2,1,1,1,0,0,0,0,0,0,0.4988662131519274,0.5011337868480725
89480,0.6153846153846154,0.425531914893617,-160,135,0.5902052121364724,0.40979478786352763,home,PHI,under,8,0.5238095238095238,-110,0.5011337868480725,PHI,BOS,2023 REG,8,3,8,5,8,16,0,1,-2,2,1,1,1,0,0,0,0,0,0,0.4988662131519274,0.5011337868480725
89482,0.6688741721854304,0.37037037037037035,-202,170,0.6426245112706233,0.35737548872937674,away,KC,over,9.5,0.5238095238095238,-110,0.4988662131519274,BOS,KC,2023 REG,6,6,8,2,8,14,1,0,4,-4,1,1,0,0,0,0,0,0,0,0.4988662131519274,0.5011337868480725
89482,0.6688741721854304,0.37037037037037035,-202,170,0.6426245112706233,0.35737548872937674,home,BOS,under,9.5,0.5238095238095238,-110,0.5011337868480725,BOS,KC,2023 REG,6,6,8,2,8,14,1,0,4,-4,1,1,0,0,0,0,0,0,0,0.4988662131519274,0.5011337868480725
89485,0.37735849056603776,0.6610169491525424,165,-195,0.36287719255902645,0.6371228074409736,away,HOU,over,10.5,0.5327102803738317,-114,0.5075272610403079,KC,HOU,2023 REG,9,4,7,2,6,16,1,0,2,-2,1,1,0,0,0,0,0,0,0,0.5075272610403079,0.4924727389596921
89485,0.37735849056603776,0.6610169491525424,165,-195,0.36287719255902645,0.6371228074409736,home,KC,under,10.5,0.5145631067961165,-106,0.4924727389596921,KC,HOU,2023 REG,9,4,7,2,6,16,1,0,2,-2,1,1,0,0,0,0,0,0,0,0.5075272610403079,0.4924727389596921
89486,0.5238095238095238,0.5238095238095238,-110,-110,0.4988662131519274,0.5011337868480725,away,CHC,over,9,0.5192307692307692,-108,0.49688292476754015,SD,CHC,2023 REG,5,1,11,7,8,16,0,1,-6,6,1,0,0,0,0,0,0,0,0,0.49688292476754015,0.5031170752324599
89486,0.5238095238095238,0.5238095238095238,-110,-110,0.4988662131519274,0.5011337868480725,home,SD,under,9,0.5238095238095238,-110,0.5031170752324599,SD,CHC,2023 REG,5,1,11,7,8,16,0,1,-6,6,1,0,0,0,0,0,0,0,0,0.49688292476754015,0.5031170752324599
89488,0.48780487804878053,0.5535714285714286,105,-124,0.4676213138438005,0.5323786861561994,away,ATL,over,9.5,0.5121951219512195,-105,0.48919479393107135,MIL,ATL,2023 REG,6,4,6,6,10,12,0,1,-2,2,1,1,1,1,0,0,0,0,0,0.48919479393107135,0.5108052060689287
89488,0.48780487804878053,0.5535714285714286,105,-124,0.4676213138438005,0.5323786861561994,home,MIL,under,9.5,0.5327102803738317,-114,0.5108052060689287,MIL,ATL,2023 REG,6,4,6,6,10,12,0,1,-2,2,1,1,1,1,0,0,0,0,0,0.48919479393107135,0.5108052060689287
89489,0.7101449275362319,0.3333333333333333,-245,200,0.6792690611216132,0.3207309388783868,away,SF,over,9,0.5121951219512195,-105,0.48808156828023186,ATL,SF,2023 REG,10,4,2,0,4,12,1,0,4,-4,0,0,0,0,0,0,0,0,0,0.48808156828023186,0.5119184317197681
89489,0.7101449275362319,0.3333333333333333,-245,200,0.6792690611216132,0.3207309388783868,home,ATL,under,9,0.5348837209302326,-115,0.5119184317197681,ATL,SF,2023 REG,10,4,2,0,4,12,1,0,4,-4,0,0,0,0,0,0,0,0,0,0.48808156828023186,0.5119184317197681
89490,0.6389891696750902,0.3968253968253968,-177,152,0.6161040495646708,0.3838959504353292,away,SF,over,7.5,0.5454545454545454,-120,0.5206611570247933,ARI,SF,2023 REG,9,7,7,2,9,16,1,0,5,-5,1,1,0,0,0,0,0,0,0,0.5206611570247933,0.4793388429752067
89490,0.6389891696750902,0.3968253968253968,-177,152,0.6161040495646708,0.3838959504353292,home,ARI,under,7.5,0.5,100,0.4793388429752067,ARI,SF,2023 REG,9,7,7,2,9,16,1,0,5,-5,1,1,0,0,0,0,0,0,0,0.5206611570247933,0.4793388429752067
89491,0.4,0.6428571428571428,150,-180,0.38285714285714295,0.617142857142857,away,MIL,over,8.5,0.5260663507109005,-111,0.5022370601254724,STL,MIL,2023 REG,5,1,6,0,1,11,1,0,1,-1,0,0,0,0,0,0,0,0,0,0.5022370601254724,0.4977629398745276
89491,0.4,0.6428571428571428,150,-180,0.38285714285714295,0.617142857142857,home,STL,under,8.5,0.5192307692307692,-108,0.4977629398745276,STL,MIL,2023 REG,5,1,6,0,1,11,1,0,1,-1,0,0,0,0,0,0,0,0,0,0.5022370601254724,0.4977629398745276
89492,0.4081632653061224,0.6363636363636364,145,-175,0.3899890197266291,0.6100109802733709,away,HOU,over,8.5,0.5391705069124424,-117,0.5127649394825569,DET,HOU,2023 REG,5,4,25,17,21,30,0,1,-13,13,1,1,1,1,0,0,0,0,0,0.5127649394825569,0.48723506051744314
89492,0.4081632653061224,0.6363636363636364,145,-175,0.3899890197266291,0.6100109802733709,home,DET,under,8.5,0.5098039215686274,-104,0.48723506051744314,DET,HOU,2023 REG,5,4,25,17,21,30,0,1,-13,13,1,1,1,1,0,0,0,0,0,0.5127649394825569,0.48723506051744314
89493,0.5652173913043479,0.47619047619047616,-130,110,0.5418129444594474,0.4581870555405526,away,BOS,over,8.5,0.5475113122171946,-121,0.5214983313199976,ARI,BOS,2023 REG,9,4,8,2,6,17,1,0,2,-2,1,1,0,0,0,0,0,0,0,0.5214983313199976,0.47850166868000243
89493,0.5652173913043479,0.47619047619047616,-130,110,0.5418129444594474,0.4581870555405526,home,ARI,under,8.5,0.5,100,0.47850166868000243,ARI,BOS,2023 REG,9,4,8,2,6,17,1,0,2,-2,1,1,0,0,0,0,0,0,0,0.5214983313199976,0.47850166868000243
89495,0.37735849056603776,0.6666666666666666,165,-200,0.36074522368577194,0.639254776314228,away,ATL,over,10,0.5121951219512195,-105,0.48808156828023186,PIT,ATL,2023 REG,10,7,12,5,12,22,1,0,2,-2,1,1,1,1,1,0,0,0,0,0.48808156828023186,0.5119184317197681
89495,0.37735849056603776,0.6666666666666666,165,-200,0.36074522368577194,0.639254776314228,home,PIT,under,10,0.5348837209302326,-115,0.5119184317197681,PIT,ATL,2023 REG,10,7,12,5,12,22,1,0,2,-2,1,1,1,1,1,0,0,0,0,0.48808156828023186,0.5119184317197681
89496,0.6153846153846154,0.425531914893617,-160,135,0.5902052121364724,0.40979478786352763,away,MIL,over,8,0.5215311004784688,-109,0.49670754937970685,SEA,MIL,2023 REG,7,5,6,6,11,13,0,1,-1,1,1,1,1,1,1,0,0,0,0,0.49670754937970685,0.5032924506202932
89496,0.6153846153846154,0.425531914893617,-160,135,0.5902052121364724,0.40979478786352763,home,SEA,under,8,0.5260663507109005,-111,0.5032924506202932,SEA,MIL,2023 REG,7,5,6,6,11,13,0,1,-1,1,1,1,1,1,1,0,0,0,0,0.49670754937970685,0.5032924506202932
89497,0.6575342465753424,0.38167938931297707,-192,162,0.6317499380460364,0.3682500619539636,away,BAL,over,8.5,0.5454545454545454,-120,0.5206611570247933,HOU,BAL,2023 REG,10,7,16,8,15,26,0,1,-1,1,1,1,1,1,1,1,1,0,0,0.5206611570247933,0.4793388429752067
89497,0.6575342465753424,0.38167938931297707,-192,162,0.6317499380460364,0.3682500619539636,home,HOU,under,8.5,0.5,100,0.4793388429752067,HOU,BAL,2023 REG,10,7,16,8,15,26,0,1,-1,1,1,1,1,1,1,1,1,0,0,0.5206611570247933,0.4793388429752067
89498,0.425531914893617,0.607843137254902,135,-155,0.4113297650431834,0.5886702349568166,away,MIA,over,8,0.5391705069124424,-117,0.5153817639191344,WSH,MIA,2023 REG,12,5,11,6,11,23,0,1,-1,1,1,1,1,1,1,0,0,0,0,0.5153817639191344,0.4846182360808656
89498,0.425531914893617,0.607843137254902,135,-155,0.4113297650431834,0.5886702349568166,home,WSH,under,8,0.504950495049505,-102,0.4846182360808656,WSH,MIA,2023 REG,12,5,11,6,11,23,0,1,-1,1,1,1,1,1,1,0,0,0,0,0.5153817639191344,0.4846182360808656
89499,0.5348837209302326,0.5121951219512195,-115,-105,0.5097020142727117,0.49029798572728833,away,STL,over,9,0.5238095238095238,-110,0.4988662131519274,MIA,STL,2023 REG,12,10,12,9,19,24,1,0,1,-1,1,1,1,1,1,1,1,1,1,0.4988662131519274,0.5011337868480725
89499,0.5348837209302326,0.5121951219512195,-115,-105,0.5097020142727117,0.49029798572728833,home,MIA,under,9,0.5238095238095238,-110,0.5011337868480725,MIA,STL,2023 REG,12,10,12,9,19,24,1,0,1,-1,1,1,1,1,1,1,1,1,1,0.4988662131519274,0.5011337868480725
89500,0.5169082125603864,0.5238095238095238,-107,-110,0.49586088023391106,0.5041391197660889,away,HOU,over,7.5,0.5348837209302326,-115,0.5097020142727117,MIA,HOU,2023 REG,9,5,12,12,17,21,0,1,-7,7,1,1,1,1,1,0,0,0,0,0.5097020142727117,0.49029798572728833
89500,0.5169082125603864,0.5238095238095238,-107,-110,0.49586088023391106,0.5041391197660889,home,MIA,under,7.5,0.5121951219512195,-105,0.49029798572728833,MIA,HOU,2023 REG,9,5,12,12,17,21,0,1,-7,7,1,1,1,1,1,0,0,0,0,0.5097020142727117,0.49029798572728833
89501,0.6774193548387096,0.36363636363636365,-210,175,0.6496074165168858,0.3503925834831142,away,MIL,over,8.5,0.5121951219512195,-105,0.48808156828023186,TB,MIL,2023 REG,10,8,6,4,12,16,1,0,4,-4,1,1,1,1,0,0,0,0,0,0.48808156828023186,0.5119184317197681
89501,0.6774193548387096,0.36363636363636365,-210,175,0.6496074165168858,0.3503925834831142,home,TB,under,8.5,0.5348837209302326,-115,0.5119184317197681,TB,MIL,2023 REG,10,8,6,4,12,16,1,0,4,-4,1,1,1,1,0,0,0,0,0,0.48808156828023186,0.5119184317197681
89502,0.46511627906976744,0.574468085106383,115,-135,0.44670494689481377,0.5532950531051862,away,LAD,over,8,0.5169082125603864,-107,0.49353874091423283,STL,LAD,2023 REG,12,10,6,5,15,18,1,0,5,-5,1,1,1,1,1,0,0,0,0,0.49353874091423283,0.5064612590857671
89502,0.46511627906976744,0.574468085106383,115,-135,0.44670494689481377,0.5532950531051862,home,STL,under,8,0.5283018867924528,-112,0.5064612590857671,STL,LAD,2023 REG,12,10,6,5,15,18,1,0,5,-5,1,1,1,1,1,0,0,0,0,0.49353874091423283,0.5064612590857671
89503,0.5833333333333333,0.45454545454545453,-140,120,0.5612373737373737,0.4387626262626263,away,SD,over,9,0.5192307692307692,-108,0.49455035168025013,ARI,SD,2023 REG,10,3,5,0,3,15,1,0,3,-3,0,0,0,0,0,0,0,0,0,0.49455035168025013,0.5054496483197499
89503,0.5833333333333333,0.45454545454545453,-140,120,0.5612373737373737,0.4387626262626263,home,ARI,under,9,0.5283018867924528,-112,0.5054496483197499,ARI,SD,2023 REG,10,3,5,0,3,15,1,0,3,-3,0,0,0,0,0,0,0,0,0,0.49455035168025013,0.5054496483197499
89504,0.6226415094339623,0.4166666666666667,-165,140,0.5981666073335706,0.40183339266642937,away,ARI,over,9.5,0.5192307692307692,-108,0.49340049170764233,TOR,ARI,2023 REG,12,7,4,5,12,16,1,0,2,-2,1,1,1,1,1,0,0,0,0,0.49340049170764233,0.5065995082923577
89504,0.6226415094339623,0.4166666666666667,-165,140,0.5981666073335706,0.40183339266642937,home,TOR,under,9.5,0.5305164319248826,-113,0.5065995082923577,TOR,ARI,2023 REG,12,7,4,5,12,16,1,0,2,-2,1,1,1,1,1,0,0,0,0,0.49340049170764233,0.5065995082923577
89505,0.5555555555555556,0.48780487804878053,-125,105,0.5314664257753688,0.46853357422463116,away,MIN,over,8.5,0.5348837209302326,-115,0.5097020142727117,TOR,MIN,2023 REG,8,2,7,3,5,15,0,1,-1,1,1,1,0,0,0,0,0,0,0,0.5097020142727117,0.49029798572728833
89505,0.5555555555555556,0.48780487804878053,-125,105,0.5314664257753688,0.46853357422463116,home,TOR,under,8.5,0.5121951219512195,-105,0.49029798572728833,TOR,MIN,2023 REG,8,2,7,3,5,15,0,1,-1,1,1,1,0,0,0,0,0,0,0,0.5097020142727117,0.49029798572728833
89506,0.4739336492890995,0.5652173913043479,111,-130,0.4553786537471813,0.5446213462528187,away,MIA,over,8,0.5283018867924528,-112,0.5044173060022736,PHI,MIA,2023 REG,20,15,9,3,18,29,1,0,12,-12,1,1,1,0,0,0,0,0,0,0.5044173060022736,0.49558269399772636
89506,0.4739336492890995,0.5652173913043479,111,-130,0.4553786537471813,0.5446213462528187,home,PHI,under,8,0.5169082125603864,-107,0.49558269399772636,PHI,MIA,2023 REG,20,15,9,3,18,29,1,0,12,-12,1,1,1,0,0,0,0,0,0,0.5044173060022736,0.49558269399772636
89507,0.5833333333333333,0.45454545454545453,-140,120,0.5612373737373737,0.4387626262626263,away,NYM,over,8.5,0.5348837209302326,-115,0.5097020142727117,HOU,NYM,2023 REG,9,10,10,8,18,19,1,0,2,-2,1,1,1,1,1,1,1,1,0,0.5097020142727117,0.49029798572728833
89507,0.5833333333333333,0.45454545454545453,-140,120,0.5612373737373737,0.4387626262626263,home,HOU,under,8.5,0.5121951219512195,-105,0.49029798572728833,HOU,NYM,2023 REG,9,10,10,8,18,19,1,0,2,-2,1,1,1,1,1,1,1,1,0,0.5097020142727117,0.49029798572728833
89508,0.5454545454545454,0.5,-120,100,0.5206611570247933,0.4793388429752067,away,BOS,over,8.5,0.5192307692307692,-108,0.49688292476754015,MIN,BOS,2023 REG,9,5,10,4,9,19,1,0,1,-1,1,1,1,1,0,0,0,0,0,0.49688292476754015,0.5031170752324599
89508,0.5454545454545454,0.5,-120,100,0.5206611570247933,0.4793388429752067,home,MIN,under,8.5,0.5238095238095238,-110,0.5031170752324599,MIN,BOS,2023 REG,9,5,10,4,9,19,1,0,1,-1,1,1,1,1,0,0,0,0,0,0.49688292476754015,0.5031170752324599
89509,0.43859649122807015,0.5983935742971888,128,-149,0.4223727782783952,0.5776272217216047,away,PHI,over,10,0.5192307692307692,-108,0.49455035168025013,CIN,PHI,2023 REG,6,3,13,8,11,19,0,1,-5,5,1,1,1,0,0,0,0,0,0,0.49455035168025013,0.5054496483197499
89509,0.43859649122807015,0.5983935742971888,128,-149,0.4223727782783952,0.5776272217216047,home,CIN,under,10,0.5283018867924528,-112,0.5054496483197499,CIN,PHI,2023 REG,6,3,13,8,11,19,0,1,-5,5,1,1,1,0,0,0,0,0,0,0.49455035168025013,0.5054496483197499
89510,0.5918367346938775,0.45454545454545453,-145,120,0.5643860512665178,0.43561394873348225,away,MIN,over,9,0.5,100,0.4772727272727273,TEX,MIN,2023 REG,13,6,11,5,11,24,1,0,1,-1,1,1,1,1,1,0,0,0,0,0.4772727272727273,0.5227272727272727
89510,0.5918367346938775,0.45454545454545453,-145,120,0.5643860512665178,0.43561394873348225,home,TEX,under,9,0.5454545454545454,-120,0.5227272727272727,TEX,MIN,2023 REG,13,6,11,5,11,24,1,0,1,-1,1,1,1,1,1,0,0,0,0,0.4772727272727273,0.5227272727272727
89511,0.5348837209302326,0.5121951219512195,-115,-105,0.5097020142727117,0.49029798572728833,away,CWS,over,8.5,0.5348837209302326,-115,0.5097020142727117,DET,CWS,2023 REG,11,7,4,3,10,15,1,0,4,-4,1,1,1,0,0,0,0,0,0,0.5097020142727117,0.49029798572728833
89511,0.5348837209302326,0.5121951219512195,-115,-105,0.5097020142727117,0.49029798572728833,home,DET,under,8.5,0.5121951219512195,-105,0.49029798572728833,DET,CWS,2023 REG,11,7,4,3,10,15,1,0,4,-4,1,1,1,0,0,0,0,0,0,0.5097020142727117,0.49029798572728833
89512,0.5,0.5454545454545454,100,-120,0.4772727272727273,0.5227272727272727,away,CHC,over,8.5,0.5454545454545454,-120,0.5206611570247933,PIT,CHC,2023 REG,2,3,8,8,11,10,0,1,-5,5,1,1,1,0,0,0,0,0,0,0.5206611570247933,0.4793388429752067
89512,0.5,0.5454545454545454,100,-120,0.4772727272727273,0.5227272727272727,home,PIT,under,8.5,0.5,100,0.4793388429752067,PIT,CHC,2023 REG,2,3,8,8,11,10,0,1,-5,5,1,1,1,0,0,0,0,0,0,0.5206611570247933,0.4793388429752067
89513,0.41493775933609955,0.6240601503759399,141,-166,0.3987560540613944,0.6012439459386056,away,LAD,over,9.5,0.5192307692307692,-108,0.49688292476754015,CHC,LAD,2023 REG,17,13,1,0,13,18,1,0,13,-13,0,0,0,0,0,0,0,0,0,0.49688292476754015,0.5031170752324599
89513,0.41493775933609955,0.6240601503759399,141,-166,0.3987560540613944,0.6012439459386056,home,CHC,under,9.5,0.5238095238095238,-110,0.5031170752324599,CHC,LAD,2023 REG,17,13,1,0,13,18,1,0,13,-13,0,0,0,0,0,0,0,0,0,0.49688292476754015,0.5031170752324599
89514,0.3508771929824561,0.6923076923076923,185,-225,0.3357246016525795,0.6642753983474206,away,LAD,over,9.5,0.5121951219512195,-105,0.48808156828023186,WSH,LAD,2023 REG,8,7,9,6,13,17,1,0,1,-1,1,1,1,1,1,1,0,0,0,0.48808156828023186,0.5119184317197681
89514,0.3508771929824561,0.6923076923076923,185,-225,0.3357246016525795,0.6642753983474206,home,WSH,under,9.5,0.5348837209302326,-115,0.5119184317197681,WSH,LAD,2023 REG,8,7,9,6,13,17,1,0,1,-1,1,1,1,1,1,1,0,0,0,0.48808156828023186,0.5119184317197681
89516,0.4484304932735426,0.5901639344262295,123,-144,0.43112357502252374,0.5688764249774763,away,SF,over,9,0.5192307692307692,-108,0.49455035168025013,DET,SF,2023 REG,10,7,9,6,13,19,1,0,1,-1,1,1,1,1,1,1,0,0,0,0.49455035168025013,0.5054496483197499
89516,0.4484304932735426,0.5901639344262295,123,-144,0.43112357502252374,0.5688764249774763,home,DET,under,9,0.5283018867924528,-112,0.5054496483197499,DET,SF,2023 REG,10,7,9,6,13,19,1,0,1,-1,1,1,1,1,1,1,0,0,0,0.49455035168025013,0.5054496483197499
89517,0.5652173913043479,0.47619047619047616,-130,110,0.5418129444594474,0.4581870555405526,away,PIT,over,9,0.504950495049505,-102,0.4826715732667395,CHC,PIT,2023 REG,14,11,7,3,14,21,1,0,8,-8,1,1,1,0,0,0,0,0,0,0.4826715732667395,0.5173284267332605
89517,0.5652173913043479,0.47619047619047616,-130,110,0.5418129444594474,0.4581870555405526,home,CHC,under,9,0.5391705069124424,-117,0.5173284267332605,CHC,PIT,2023 REG,14,11,7,3,14,21,1,0,8,-8,1,1,1,0,0,0,0,0,0,0.4826715732667395,0.5173284267332605
89518,0.5475113122171946,0.49019607843137253,-121,104,0.5268660892829112,0.47313391071708877,away,BOS,over,7.5,0.5,100,0.4772727272727273,BAL,BOS,2023 REG,4,2,3,0,2,7,1,0,2,-2,0,0,0,0,0,0,0,0,0,0.4772727272727273,0.5227272727272727
89518,0.5475113122171946,0.49019607843137253,-121,104,0.5268660892829112,0.47313391071708877,home,BAL,under,7.5,0.5454545454545454,-120,0.5227272727272727,BAL,BOS,2023 REG,4,2,3,0,2,7,1,0,2,-2,0,0,0,0,0,0,0,0,0,0.4772727272727273,0.5227272727272727
89519,0.6402877697841727,0.3921568627450981,-178,155,0.6195138683805389,0.3804861316194611,away,LAA,over,8.5,0.5238095238095238,-110,0.4988662131519274,HOU,LAA,2023 REG,15,11,7,3,14,22,1,0,8,-8,1,1,1,0,0,0,0,0,0,0.4988662131519274,0.5011337868480725
89519,0.6402877697841727,0.3921568627450981,-178,155,0.6195138683805389,0.3804861316194611,home,HOU,under,8.5,0.5238095238095238,-110,0.5011337868480725,HOU,LAA,2023 REG,15,11,7,3,14,22,1,0,8,-8,1,1,1,0,0,0,0,0,0,0.4988662131519274,0.5011337868480725
89520,0.37735849056603776,0.6610169491525424,165,-195,0.36287719255902645,0.6371228074409736,away,CHC,over,7.5,0.5454545454545454,-120,0.5206611570247933,OAK,CHC,2023 REG,2,0,8,4,4,10,0,1,-4,4,0,0,0,0,0,0,0,0,0,0.5206611570247933,0.4793388429752067
89520,0.37735849056603776,0.6610169491525424,165,-195,0.36287719255902645,0.6371228074409736,home,OAK,under,7.5,0.5,100,0.4793388429752067,OAK,CHC,2023 REG,2,0,8,4,4,10,0,1,-4,4,0,0,0,0,0,0,0,0,0,0.5206611570247933,0.4793388429752067
89522,0.574468085106383,0.46511627906976744,-135,115,0.5517281312179562,0.44827186878204384,away,CIN,over,9,0.5,100,0.4772727272727273,MIL,CIN,2023 REG,9,3,6,0,3,15,1,0,3,-3,0,0,0,0,0,0,0,0,0,0.4772727272727273,0.5227272727272727
89522,0.574468085106383,0.46511627906976744,-135,115,0.5517281312179562,0.44827186878204384,home,MIL,under,9,0.5454545454545454,-120,0.5227272727272727,MIL,CIN,2023 REG,9,3,6,0,3,15,1,0,3,-3,0,0,0,0,0,0,0,0,0,0.4772727272727273,0.5227272727272727
89523,0.5614035087719298,0.47619047619047616,-128,110,0.5402981137053159,0.4597018862946841,away,BOS,over,8.5,0.5121951219512195,-105,0.48808156828023186,BAL,BOS,2023 REG,11,6,7,2,8,18,1,0,4,-4,1,1,0,0,0,0,0,0,0,0.48808156828023186,0.5119184317197681
89523,0.5614035087719298,0.47619047619047616,-128,110,0.5402981137053159,0.4597018862946841,home,BAL,under,8.5,0.5348837209302326,-115,0.5119184317197681,BAL,BOS,2023 REG,11,6,7,2,8,18,1,0,4,-4,1,1,0,0,0,0,0,0,0,0.48808156828023186,0.5119184317197681
89524,0.6153846153846154,0.4166666666666667,-160,140,0.5956607495069033,0.4043392504930967,away,SEA,over,8,0.5238095238095238,-110,0.4988662131519274,TEX,SEA,2023 REG,15,12,8,3,15,23,1,0,9,-9,1,1,1,0,0,0,0,0,0,0.4988662131519274,0.5011337868480725
89524,0.6153846153846154,0.4166666666666667,-160,140,0.5956607495069033,0.4043392504930967,home,TEX,under,8,0.5238095238095238,-110,0.5011337868480725,TEX,SEA,2023 REG,15,12,8,3,15,23,1,0,9,-9,1,1,1,0,0,0,0,0,0,0.4988662131519274,0.5011337868480725
89525,0.4347826086956522,0.601593625498008,130,-151,0.41896685469840866,0.5810331453015913,away,CIN,over,7.5,0.5283018867924528,-112,0.5044173060022736,OAK,CIN,2023 REG,7,2,9,3,5,16,0,1,-1,1,1,1,0,0,0,0,0,0,0,0.5044173060022736,0.49558269399772636
89525,0.4347826086956522,0.601593625498008,130,-151,0.41896685469840866,0.5810331453015913,home,OAK,under,7.5,0.5169082125603864,-107,0.49558269399772636,OAK,CIN,2023 REG,7,2,9,3,5,16,0,1,-1,1,1,1,0,0,0,0,0,0,0,0.5044173060022736,0.49558269399772636
89526,0.45454545454545453,0.5798319327731092,120,-138,0.4389193694006528,0.5610806305993472,away,ATL,over,7.5,0.5121951219512195,-105,0.48808156828023186,SD,ATL,2023 REG,4,1,8,8,9,12,0,1,-7,7,1,0,0,0,0,0,0,0,0,0.48808156828023186,0.5119184317197681
89526,0.45454545454545453,0.5798319327731092,120,-138,0.4389193694006528,0.5610806305993472,home,SD,under,7.5,0.5348837209302326,-115,0.5119184317197681,SD,ATL,2023 REG,4,1,8,8,9,12,0,1,-7,7,1,0,0,0,0,0,0,0,0,0.48808156828023186,0.5119184317197681
89527,0.4347826086956522,0.6062992125984252,130,-154,0.4169209472634447,0.5830790527365552,away,ARI,over,8.5,0.5098039215686274,-104,0.48483656587239576,MIN,ARI,2023 REG,6,5,11,3,8,17,1,0,2,-2,1,1,1,0,0,0,0,0,0,0.48483656587239576,0.5151634341276042
89527,0.4347826086956522,0.6062992125984252,130,-154,0.4169209472634447,0.5830790527365552,home,MIN,under,8.5,0.5391705069124424,-117,0.5151634341276042,MIN,ARI,2023 REG,6,5,11,3,8,17,1,0,2,-2,1,1,1,0,0,0,0,0,0,0.48483656587239576,0.5151634341276042
89528,0.5918367346938775,0.4464285714285714,-145,124,0.5691899208663057,0.4308100791336943,away,MIL,over,9,0.5348837209302326,-115,0.5097020142727117,PHI,MIL,2023 REG,7,3,10,5,8,17,0,1,-2,2,1,1,1,0,0,0,0,0,0,0.5097020142727117,0.49029798572728833
89528,0.5918367346938775,0.4464285714285714,-145,124,0.5691899208663057,0.4308100791336943,home,PHI,under,9,0.5121951219512195,-105,0.49029798572728833,PHI,MIL,2023 REG,7,3,10,5,8,17,0,1,-2,2,1,1,1,0,0,0,0,0,0,0.5097020142727117,0.49029798572728833
89529,0.6503496503496503,0.3921568627450981,-186,155,0.6227055544208978,0.3772944455791022,away,STL,over,11,0.5238095238095238,-110,0.4988662131519274,BAL,STL,2023 REG,9,2,9,5,7,18,0,1,-3,3,1,1,0,0,0,0,0,0,0,0.4988662131519274,0.5011337868480725
89529,0.6503496503496503,0.3921568627450981,-186,155,0.6227055544208978,0.3772944455791022,home,BAL,under,11,0.5238095238095238,-110,0.5011337868480725,BAL,STL,2023 REG,9,2,9,5,7,18,0,1,-3,3,1,1,0,0,0,0,0,0,0,0.4988662131519274,0.5011337868480725
89530,0.4347826086956522,0.6000000000000001,130,-150,0.4196597353497164,0.5803402646502835,away,ATL,over,7.5,0.5121951219512195,-105,0.48808156828023186,TEX,ATL,2023 REG,7,5,8,6,11,15,0,1,-1,1,1,1,1,1,1,0,0,0,0,0.48808156828023186,0.5119184317197681
89530,0.4347826086956522,0.6000000000000001,130,-150,0.4196597353497164,0.5803402646502835,home,TEX,under,7.5,0.5348837209302326,-115,0.5119184317197681,TEX,ATL,2023 REG,7,5,8,6,11,15,0,1,-1,1,1,1,1,1,1,0,0,0,0,0.48808156828023186,0.5119184317197681
89531,0.5454545454545454,0.5,-120,100,0.5206611570247933,0.4793388429752067,away,PHI,over,9,0.5454545454545454,-120,0.5206611570247933,SD,PHI,2023 REG,10,7,16,9,16,26,0,1,-2,2,1,1,1,1,1,1,1,0,0,0.5206611570247933,0.4793388429752067
89531,0.5454545454545454,0.5,-120,100,0.5206611570247933,0.4793388429752067,home,SD,under,9,0.5,100,0.4793388429752067,SD,PHI,2023 REG,10,7,16,9,16,26,0,1,-2,2,1,1,1,1,1,1,1,0,0,0.5206611570247933,0.4793388429752067
89532,0.5798319327731092,0.4587155963302753,-138,118,0.557480844469466,0.442519155530534,away,MIL,over,11,0.5238095238095238,-110,0.4988662131519274,CIN,MIL,2023 REG,7,3,9,4,7,16,0,1,-1,1,1,1,1,0,0,0,0,0,0,0.4988662131519274,0.5011337868480725
89532,0.5798319327731092,0.4587155963302753,-138,118,0.557480844469466,0.442519155530534,home,CIN,under,11,0.5238095238095238,-110,0.5011337868480725,CIN,MIL,2023 REG,7,3,9,4,7,16,0,1,-1,1,1,1,1,0,0,0,0,0,0,0.4988662131519274,0.5011337868480725
89533,0.576271186440678,0.4629629629629629,-136,116,0.553661676614851,0.446338323385149,away,CWS,over,8.5,0.5348837209302326,-115,0.5109810284308424,PIT,CWS,2023 REG,2,1,6,0,1,8,1,0,1,-1,0,0,0,0,0,0,0,0,0,0.5109810284308424,0.48901897156915763
89533,0.576271186440678,0.4629629629629629,-136,116,0.553661676614851,0.446338323385149,home,PIT,under,8.5,0.5098039215686274,-104,0.48901897156915763,PIT,CWS,2023 REG,2,1,6,0,1,8,1,0,1,-1,0,0,0,0,0,0,0,0,0,0.5109810284308424,0.48901897156915763
89534,0.6296296296296295,0.4065040650406504,-170,146,0.606878784837231,0.393121215162769,away,ARI,over,9,0.5412844036697247,-118,0.5162581740877563,LAD,ARI,2023 REG,11,7,6,0,7,17,1,0,7,-7,0,0,0,0,0,0,0,0,0,0.5162581740877563,0.4837418259122437
89534,0.6296296296296295,0.4065040650406504,-170,146,0.606878784837231,0.393121215162769,home,LAD,under,9,0.504950495049505,-102,0.4837418259122437,LAD,ARI,2023 REG,11,7,6,0,7,17,1,0,7,-7,0,0,0,0,0,0,0,0,0,0.5162581740877563,0.4837418259122437
89535,0.4854368932038835,0.5555555555555556,106,-125,0.465537646233282,0.534462353766718,away,TOR,over,8.5,0.5215311004784688,-109,0.4978845547971712,CLE,TOR,2023 REG,5,1,5,3,4,10,0,1,-2,2,1,0,0,0,0,0,0,0,0,0.4978845547971712,0.5021154452028288
89535,0.4854368932038835,0.5555555555555556,106,-125,0.465537646233282,0.534462353766718,home,CLE,under,8.5,0.5238095238095238,-110,0.5021154452028288,CLE,TOR,2023 REG,5,1,5,3,4,10,0,1,-2,2,1,0,0,0,0,0,0,0,0,0.4978845547971712,0.5021154452028288
89536,0.5652173913043479,0.47619047619047616,-130,110,0.5418129444594474,0.4581870555405526,away,SEA,over,9.5,0.5098039215686274,-104,0.4870219861770517,BOS,SEA,2023 REG,16,12,5,3,15,21,1,0,9,-9,1,1,1,0,0,0,0,0,0,0.4870219861770517,0.5129780138229483
89536,0.5652173913043479,0.47619047619047616,-130,110,0.5418129444594474,0.4581870555405526,home,BOS,under,9.5,0.5348837209302326,-115,0.5129780138229483,BOS,SEA,2023 REG,16,12,5,3,15,21,1,0,9,-9,1,1,1,0,0,0,0,0,0,0.4870219861770517,0.5129780138229483
89537,0.5967741935483871,0.4347826086956522,-148,130,0.5779419083382347,0.42205809166176533,away,COL,over,9,0.5215311004784688,-109,0.49670754937970685,KC,COL,2023 REG,4,2,8,0,2,12,1,0,2,-2,0,0,0,0,0,0,0,0,0,0.49670754937970685,0.5032924506202932
89537,0.5967741935483871,0.4347826086956522,-148,130,0.5779419083382347,0.42205809166176533,home,KC,under,9,0.5260663507109005,-111,0.5032924506202932,KC,COL,2023 REG,4,2,8,0,2,12,1,0,2,-2,0,0,0,0,0,0,0,0,0,0.49670754937970685,0.5032924506202932
89538,0.5901639344262295,0.4484304932735426,-144,123,0.5673868951280033,0.43261310487199667,away,BAL,over,8.5,0.5305164319248826,-113,0.5066009958897986,TEX,BAL,2023 REG,7,2,8,7,9,15,0,1,-5,5,1,1,0,0,0,0,0,0,0,0.5066009958897986,0.49339900411020143
89538,0.5901639344262295,0.4484304932735426,-144,123,0.5673868951280033,0.43261310487199667,home,TEX,under,8.5,0.5145631067961165,-106,0.49339900411020143,TEX,BAL,2023 REG,7,2,8,7,9,15,0,1,-5,5,1,1,0,0,0,0,0,0,0,0.5066009958897986,0.49339900411020143
89539,0.5238095238095238,0.5098039215686274,-110,-104,0.5062024809923971,0.49379751900760294,away,NYM,over,8.5,0.504950495049505,-102,0.4837488699364985,MIA,NYM,2023 REG,10,2,12,6,8,22,0,1,-4,4,1,1,0,0,0,0,0,0,0,0.4837488699364985,0.5162511300635015
89539,0.5238095238095238,0.5098039215686274,-110,-104,0.5062024809923971,0.49379751900760294,home,MIA,under,8.5,0.5370370370370371,-116,0.5162511300635015,MIA,NYM,2023 REG,10,2,12,6,8,22,0,1,-4,4,1,1,0,0,0,0,0,0,0,0.4837488699364985,0.5162511300635015
89540,0.607843137254902,0.4347826086956522,-155,130,0.5819333701084867,0.41806662989151333,away,ARI,over,8,0.5192307692307692,-108,0.49455035168025013,LAD,ARI,2023 REG,11,7,8,4,11,19,1,0,3,-3,1,1,1,1,0,0,0,0,0,0.49455035168025013,0.5054496483197499
89540,0.607843137254902,0.4347826086956522,-155,130,0.5819333701084867,0.41806662989151333,home,LAD,under,8,0.5283018867924528,-112,0.5054496483197499,LAD,ARI,2023 REG,11,7,8,4,11,19,1,0,3,-3,1,1,1,1,0,0,0,0,0,0.49455035168025013,0.5054496483197499
89541,0.4444444444444444,0.6031746031746031,125,-152,0.4232804232804233,0.5767195767195767,away,LAA,over,9,0.5370370370370371,-116,0.5118817074154765,KC,LAA,2023 REG,4,0,9,3,3,13,0,1,-3,3,0,0,0,0,0,0,0,0,0,0.5118817074154765,0.48811829258452355
89541,0.4444444444444444,0.6031746031746031,125,-152,0.4232804232804233,0.5767195767195767,home,KC,under,9,0.5098039215686274,-104,0.48811829258452355,KC,LAA,2023 REG,4,0,9,3,3,13,0,1,-3,3,0,0,0,0,0,0,0,0,0,0.5118817074154765,0.48811829258452355
89542,0.4,0.6363636363636364,150,-175,0.3854545454545455,0.6145454545454545,away,STL,over,13,0.5348837209302326,-115,0.5109810284308424,COL,STL,2023 REG,7,4,11,7,11,18,0,1,-3,3,1,1,1,1,0,0,0,0,0,0.5109810284308424,0.48901897156915763
89542,0.4,0.6363636363636364,150,-175,0.3854545454545455,0.6145454545454545,home,COL,under,13,0.5098039215686274,-104,0.48901897156915763,COL,STL,2023 REG,7,4,11,7,11,18,0,1,-3,3,1,1,1,1,0,0,0,0,0,0.5109810284308424,0.48901897156915763
89543,0.6763754045307443,0.36496350364963503,-209,174,0.6484147837873808,0.3515852162126192,away,WSH,over,9,0.5348837209302326,-115,0.5097020142727117,PHI,WSH,2023 REG,8,4,8,5,9,16,0,1,-1,1,1,1,1,1,0,0,0,0,0,0.5097020142727117,0.49029798572728833
89543,0.6763754045307443,0.36496350364963503,-209,174,0.6484147837873808,0.3515852162126192,home,PHI,under,9,0.5121951219512195,-105,0.49029798572728833,PHI,WSH,2023 REG,8,4,8,5,9,16,0,1,-1,1,1,1,1,1,0,0,0,0,0,0.5097020142727117,0.49029798572728833
89544,0.574468085106383,0.46511627906976744,-135,115,0.5517281312179562,0.44827186878204384,away,LAA,over,9.5,0.5327102803738317,-114,0.508788710910954,TEX,LAA,2023 REG,9,3,8,7,10,17,0,1,-4,4,1,1,1,0,0,0,0,0,0,0.508788710910954,0.491211289089046
89544,0.574468085106383,0.46511627906976744,-135,115,0.5517281312179562,0.44827186878204384,home,TEX,under,9.5,0.5121951219512195,-105,0.491211289089046,TEX,LAA,2023 REG,9,3,8,7,10,17,0,1,-4,4,1,1,1,0,0,0,0,0,0,0.508788710910954,0.491211289089046
89545,0.45454545454545453,0.5867768595041323,120,-142,0.43576258452291505,0.564237415477085,away,CLE,over,9,0.5238095238095238,-110,0.5000596729920038,KC,CLE,2023 REG,2,1,7,2,3,9,0,1,-1,1,1,0,0,0,0,0,0,0,0,0.5000596729920038,0.4999403270079962
89545,0.45454545454545453,0.5867768595041323,120,-142,0.43576258452291505,0.564237415477085,home,KC,under,9,0.5215311004784688,-109,0.4999403270079962,KC,CLE,2023 REG,2,1,7,2,3,9,0,1,-1,1,1,0,0,0,0,0,0,0,0,0.5000596729920038,0.4999403270079962
89546,0.43859649122807015,0.5967741935483871,128,-148,0.4230830329927819,0.5769169670072181,away,CIN,over,8,0.5348837209302326,-115,0.5097020142727117,OAK,CIN,2023 REG,9,5,12,4,9,21,1,0,1,-1,1,1,1,1,0,0,0,0,0,0.5097020142727117,0.49029798572728833
89546,0.43859649122807015,0.5967741935483871,128,-148,0.4230830329927819,0.5769169670072181,home,OAK,under,8,0.5121951219512195,-105,0.49029798572728833,OAK,CIN,2023 REG,9,5,12,4,9,21,1,0,1,-1,1,1,1,1,0,0,0,0,0,0.5097020142727117,0.49029798572728833
89547,0.4716981132075471,0.5652173913043479,112,-130,0.4542851393811816,0.5457148606188185,away,ARI,over,12,0.5121951219512195,-105,0.48808156828023186,COL,ARI,2023 REG,16,12,7,4,16,23,1,0,8,-8,1,1,1,1,0,0,0,0,0,0.48808156828023186,0.5119184317197681
89547,0.4716981132075471,0.5652173913043479,112,-130,0.4542851393811816,0.5457148606188185,home,COL,under,12,0.5348837209302326,-115,0.5119184317197681,COL,ARI,2023 REG,16,12,7,4,16,23,1,0,8,-8,1,1,1,1,0,0,0,0,0,0.48808156828023186,0.5119184317197681
89548,0.425531914893617,0.6168582375478928,135,-161,0.407493552152549,0.592506447847451,away,NYM,over,9,0.5348837209302326,-115,0.5097020142727117,CIN,NYM,2023 REG,2,1,10,2,3,12,0,1,-1,1,1,0,0,0,0,0,0,0,0,0.5097020142727117,0.49029798572728833
89548,0.425531914893617,0.6168582375478928,135,-161,0.407493552152549,0.592506447847451,home,CIN,under,9,0.5121951219512195,-105,0.49029798572728833,CIN,NYM,2023 REG,2,1,10,2,3,12,0,1,-1,1,1,0,0,0,0,0,0,0,0,0.5097020142727117,0.49029798572728833
89549,0.4504504504504505,0.5850622406639003,122,-141,0.43445374274128346,0.5655462572587165,away,ATL,over,8.5,0.5238095238095238,-110,0.4988662131519274,MIA,ATL,2023 REG,12,6,18,14,20,30,0,1,-8,8,1,1,1,1,1,1,0,0,0,0.4988662131519274,0.5011337868480725
89549,0.4504504504504505,0.5850622406639003,122,-141,0.43445374274128346,0.5655462572587165,home,MIA,under,8.5,0.5238095238095238,-110,0.5011337868480725,MIA,ATL,2023 REG,12,6,18,14,20,30,0,1,-8,8,1,1,1,1,1,1,0,0,0,0.4988662131519274,0.5011337868480725
89550,0.5918367346938775,0.4464285714285714,-145,124,0.5691899208663057,0.4308100791336943,away,WSH,over,9.5,0.5121951219512195,-105,0.48808156828023186,PIT,WSH,2023 REG,11,7,8,6,13,19,1,0,1,-1,1,1,1,1,1,1,0,0,0,0.48808156828023186,0.5119184317197681
89550,0.5918367346938775,0.4464285714285714,-145,124,0.5691899208663057,0.4308100791336943,home,PIT,under,9.5,0.5348837209302326,-115,0.5119184317197681,PIT,WSH,2023 REG,11,7,8,6,13,19,1,0,1,-1,1,1,1,1,1,1,0,0,0,0.48808156828023186,0.5119184317197681
89551,0.5454545454545454,0.5,-120,100,0.5206611570247933,0.4793388429752067,away,PHI,over,8.5,0.5305164319248826,-113,0.5053568787472517,NYM,PHI,2023 REG,2,1,12,9,10,14,0,1,-8,8,1,0,0,0,0,0,0,0,0,0.5053568787472517,0.49464312125274834
89551,0.5454545454545454,0.5,-120,100,0.5206611570247933,0.4793388429752067,home,NYM,under,8.5,0.5169082125603864,-107,0.49464312125274834,NYM,PHI,2023 REG,2,1,12,9,10,14,0,1,-8,8,1,0,0,0,0,0,0,0,0,0.5053568787472517,0.49464312125274834
89552,0.574468085106383,0.46511627906976744,-135,115,0.5517281312179562,0.44827186878204384,away,STL,over,9,0.5238095238095238,-110,0.4988662131519274,TEX,STL,2023 REG,4,0,4,1,1,8,0,1,-1,1,0,0,0,0,0,0,0,0,0,0.4988662131519274,0.5011337868480725
89552,0.574468085106383,0.46511627906976744,-135,115,0.5517281312179562,0.44827186878204384,home,TEX,under,9,0.5238095238095238,-110,0.5011337868480725,TEX,STL,2023 REG,4,0,4,1,1,8,0,1,-1,1,0,0,0,0,0,0,0,0,0,0.4988662131519274,0.5011337868480725
89554,0.5305164319248826,0.5121951219512195,-113,-105,0.5078572507605655,0.49214274923943446,away,SF,over,9,0.5,100,0.47935779816513757,STL,SF,2023 REG,7,3,17,11,14,24,0,1,-8,8,1,1,1,0,0,0,0,0,0,0.47935779816513757,0.5206422018348624
89554,0.5305164319248826,0.5121951219512195,-113,-105,0.5078572507605655,0.49214274923943446,home,STL,under,9,0.5412844036697247,-118,0.5206422018348624,STL,SF,2023 REG,7,3,17,11,14,24,0,1,-8,8,1,1,1,0,0,0,0,0,0,0.47935779816513757,0.5206422018348624
89555,0.4464285714285714,0.5884773662551441,124,-143,0.43084556353405556,0.5691544364659444,away,NYY,over,7.5,0.5238095238095238,-110,0.5024811857109994,BAL,NYY,2023 REG,6,3,9,5,8,15,0,1,-2,2,1,1,1,0,0,0,0,0,0,0.5024811857109994,0.4975188142890006
89555,0.4464285714285714,0.5884773662551441,124,-143,0.43084556353405556,0.5691544364659444,home,BAL,under,7.5,0.5169082125603864,-107,0.4975188142890006,BAL,NYY,2023 REG,6,3,9,5,8,15,0,1,-2,2,1,1,1,0,0,0,0,0,0,0.5024811857109994,0.4975188142890006
89556,0.601593625498008,0.4347826086956522,-151,130,0.5797099148874794,0.42029008511252064,away,PIT,over,8.5,0.5412844036697247,-118,0.5189377998484975,BOS,PIT,2023 REG,5,1,9,4,5,14,0,1,-3,3,1,0,0,0,0,0,0,0,0,0.5189377998484975,0.4810622001515025
89556,0.601593625498008,0.4347826086956522,-151,130,0.5797099148874794,0.42029008511252064,home,BOS,under,8.5,0.5,100,0.4810622001515025,BOS,PIT,2023 REG,5,1,9,4,5,14,0,1,-3,3,1,0,0,0,0,0,0,0,0,0.5189377998484975,0.4810622001515025
89557,0.5098039215686274,0.5238095238095238,-104,-110,0.49266765529741313,0.5073323447025868,away,DET,over,8.5,0.5391705069124424,-117,0.5140669063204599,WSH,DET,2023 REG,7,6,9,8,14,16,0,1,-2,2,1,1,1,1,1,1,0,0,0,0.5140669063204599,0.4859330936795401
89557,0.5098039215686274,0.5238095238095238,-104,-110,0.49266765529741313,0.5073323447025868,home,WSH,under,8.5,0.5073891625615764,-103,0.4859330936795401,WSH,DET,2023 REG,7,6,9,8,14,16,0,1,-2,2,1,1,1,1,1,1,0,0,0,0.5140669063204599,0.4859330936795401
89558,0.5454545454545454,0.5,-120,100,0.5206611570247933,0.4793388429752067,away,SF,over,8.5,0.5073891625615764,-103,0.48484779035144243,LAD,SF,2023 REG,9,3,8,7,10,17,0,1,-4,4,1,1,1,0,0,0,0,0,0,0.48484779035144243,0.5151522096485576
89558,0.5454545454545454,0.5,-120,100,0.5206611570247933,0.4793388429752067,home,LAD,under,8.5,0.5370370370370371,-116,0.5151522096485576,LAD,SF,2023 REG,9,3,8,7,10,17,0,1,-4,4,1,1,1,0,0,0,0,0,0,0.48484779035144243,0.5151522096485576
89559,0.5121951219512195,0.5348837209302326,-105,-115,0.48808156828023186,0.5119184317197681,away,PIT,over,8.5,0.5121951219512195,-105,0.48808156828023186,MIL,PIT,2023 REG,6,5,6,0,5,12,1,0,5,-5,0,0,0,0,0,0,0,0,0,0.48808156828023186,0.5119184317197681
89559,0.5121951219512195,0.5348837209302326,-105,-115,0.48808156828023186,0.5119184317197681,home,MIL,under,8.5,0.5348837209302326,-115,0.5119184317197681,MIL,PIT,2023 REG,6,5,6,0,5,12,1,0,5,-5,0,0,0,0,0,0,0,0,0,0.48808156828023186,0.5119184317197681
89560,0.5305164319248826,0.5098039215686274,-113,-104,0.5091258218555558,0.49087417814444423,away,CHC,over,9,0.5238095238095238,-110,0.4988662131519274,NYM,CHC,2023 REG,12,11,9,2,13,21,1,0,9,-9,1,1,0,0,0,0,0,0,0,0.4988662131519274,0.5011337868480725
89560,0.5305164319248826,0.5098039215686274,-113,-104,0.5091258218555558,0.49087417814444423,home,NYM,under,9,0.5238095238095238,-110,0.5011337868480725,NYM,CHC,2023 REG,12,11,9,2,13,21,1,0,9,-9,1,1,0,0,0,0,0,0,0,0.4988662131519274,0.5011337868480725
89561,0.6031746031746031,0.4347826086956522,-152,130,0.5802797769671475,0.4197202230328525,away,PIT,over,9.5,0.5121951219512195,-105,0.48808156828023186,BOS,PIT,2023 REG,10,6,9,7,13,19,0,1,-1,1,1,1,1,1,1,1,0,0,0,0.48808156828023186,0.5119184317197681
89561,0.6031746031746031,0.4347826086956522,-152,130,0.5802797769671475,0.4197202230328525,home,BOS,under,9.5,0.5348837209302326,-115,0.5119184317197681,BOS,PIT,2023 REG,10,6,9,7,13,19,0,1,-1,1,1,1,1,1,1,1,0,0,0,0.48808156828023186,0.5119184317197681
89562,0.4132231404958678,0.6254681647940076,142,-167,0.3972349978141011,0.6027650021858989,away,ATL,over,10,0.5121951219512195,-105,0.48808156828023186,PIT,ATL,2023 REG,9,6,14,8,14,23,0,1,-2,2,1,1,1,1,1,1,0,0,0,0.48808156828023186,0.5119184317197681
89562,0.4132231404958678,0.6254681647940076,142,-167,0.3972349978141011,0.6027650021858989,home,PIT,under,10,0.5348837209302326,-115,0.5119184317197681,PIT,ATL,2023 REG,9,6,14,8,14,23,0,1,-2,2,1,1,1,1,1,1,0,0,0,0.48808156828023186,0.5119184317197681
89563,0.7058823529411764,0.33112582781456956,-240,202,0.679758931231238,0.320241068768762,away,COL,over,8.5,0.5073891625615764,-103,0.4837652908580103,SD,COL,2023 REG,10,8,6,4,12,16,1,0,4,-4,1,1,1,1,0,0,0,0,0,0.4837652908580103,0.5162347091419897
89563,0.7058823529411764,0.33112582781456956,-240,202,0.679758931231238,0.320241068768762,home,SD,under,8.5,0.5391705069124424,-117,0.5162347091419897,SD,COL,2023 REG,10,8,6,4,12,16,1,0,4,-4,1,1,1,1,0,0,0,0,0,0.4837652908580103,0.5162347091419897
89565,0.6721311475409836,0.37037037037037035,-205,170,0.6435645535349916,0.35643544646500835,away,STL,over,9.5,0.5098039215686274,-104,0.48375889301574193,TB,STL,2023 REG,4,2,11,5,7,15,0,1,-3,3,1,1,0,0,0,0,0,0,0,0.48375889301574193,0.5162411069842581
89565,0.6721311475409836,0.37037037037037035,-205,170,0.6435645535349916,0.35643544646500835,home,TB,under,9.5,0.5412844036697247,-118,0.5162411069842581,TB,STL,2023 REG,4,2,11,5,7,15,0,1,-3,3,1,1,0,0,0,0,0,0,0,0.48375889301574193,0.5162411069842581
89566,0.635036496350365,0.4081632653061224,-174,145,0.6076030710648583,0.39239692893514166,away,ARI,over,7.5,0.49019607843137253,104,0.4707129274603323,LAD,ARI,2023 REG,12,8,4,2,10,16,1,0,6,-6,1,1,0,0,0,0,0,0,0,0.4707129274603323,0.5292870725396677
89566,0.635036496350365,0.4081632653061224,-174,145,0.6076030710648583,0.39239692893514166,home,LAD,under,7.5,0.5495495495495495,-122,0.5292870725396677,LAD,ARI,2023 REG,12,8,4,2,10,16,1,0,6,-6,1,1,0,0,0,0,0,0,0,0.4707129274603323,0.5292870725396677
89567,0.5652173913043479,0.47619047619047616,-130,110,0.5418129444594474,0.4581870555405526,away,MIN,over,8.5,0.5412844036697247,-118,0.5189377998484975,TOR,MIN,2023 REG,9,4,12,9,13,21,0,1,-5,5,1,1,1,1,0,0,0,0,0,0.5189377998484975,0.4810622001515025
89567,0.5652173913043479,0.47619047619047616,-130,110,0.5418129444594474,0.4581870555405526,home,TOR,under,8.5,0.5,100,0.4810622001515025,TOR,MIN,2023 REG,9,4,12,9,13,21,0,1,-5,5,1,1,1,1,0,0,0,0,0,0.5189377998484975,0.4810622001515025
89568,0.5918367346938775,0.4444444444444444,-145,125,0.5703642001018094,0.42963579989819056,away,LAA,over,9.5,0.5391705069124424,-117,0.5140669063204599,BAL,LAA,2023 REG,9,7,8,3,10,17,1,0,4,-4,1,1,1,0,0,0,0,0,0,0.5140669063204599,0.4859330936795401
89568,0.5918367346938775,0.4444444444444444,-145,125,0.5703642001018094,0.42963579989819056,home,BAL,under,9.5,0.5073891625615764,-103,0.4859330936795401,BAL,LAA,2023 REG,9,7,8,3,10,17,1,0,4,-4,1,1,1,0,0,0,0,0,0,0.5140669063204599,0.4859330936795401
89569,0.5555555555555556,0.48780487804878053,-125,105,0.5314664257753688,0.46853357422463116,away,CIN,over,9,0.5454545454545454,-120,0.5179608869977906,ARI,CIN,2023 REG,8,5,4,2,7,12,1,0,3,-3,1,1,0,0,0,0,0,0,0,0.5179608869977906,0.48203911300220936
89569,0.5555555555555556,0.48780487804878053,-125,105,0.5314664257753688,0.46853357422463116,home,ARI,under,9,0.504950495049505,-102,0.48203911300220936,ARI,CIN,2023 REG,8,5,4,2,7,12,1,0,3,-3,1,1,0,0,0,0,0,0,0,0.5179608869977906,0.48203911300220936
89570,0.6774193548387096,0.36363636363636365,-210,175,0.6496074165168858,0.3503925834831142,away,WSH,over,8.5,0.5169082125603864,-107,0.49586088023391106,NYM,WSH,2023 REG,5,0,11,5,5,16,0,1,-5,5,0,0,0,0,0,0,0,0,0,0.49586088023391106,0.5041391197660889
89570,0.6774193548387096,0.36363636363636365,-210,175,0.6496074165168858,0.3503925834831142,home,NYM,under,8.5,0.5238095238095238,-110,0.5041391197660889,NYM,WSH,2023 REG,5,0,11,5,5,16,0,1,-5,5,0,0,0,0,0,0,0,0,0,0.49586088023391106,0.5041391197660889
89571,0.5121951219512195,0.5283018867924528,-105,-112,0.49145275161909474,0.5085472483809053,away,NYM,over,8,0.5454545454545454,-120,0.5206611570247933,CHC,NYM,2023 REG,6,1,15,10,11,21,0,1,-9,9,1,0,0,0,0,0,0,0,0,0.5206611570247933,0.4793388429752067
89571,0.5121951219512195,0.5283018867924528,-105,-112,0.49145275161909474,0.5085472483809053,home,CHC,under,8,0.5,100,0.4793388429752067,CHC,NYM,2023 REG,6,1,15,10,11,21,0,1,-9,9,1,0,0,0,0,0,0,0,0,0.5206611570247933,0.4793388429752067
89572,0.48780487804878053,0.5555555555555556,105,-125,0.4666534470222751,0.5333465529777248,away,DET,over,8.5,0.5454545454545454,-120,0.5206611570247933,LAA,DET,2023 REG,6,4,6,5,9,12,0,1,-1,1,1,1,1,1,0,0,0,0,0,0.5206611570247933,0.4793388429752067
89572,0.48780487804878053,0.5555555555555556,105,-125,0.4666534470222751,0.5333465529777248,home,LAA,under,8.5,0.5,100,0.4793388429752067,LAA,DET,2023 REG,6,4,6,5,9,12,0,1,-1,1,1,1,1,1,0,0,0,0,0,0.5206611570247933,0.4793388429752067
89573,0.4081632653061224,0.6296296296296295,145,-170,0.39273759390377466,0.6072624060962253,away,LAA,over,7.5,0.5073891625615764,-103,0.4837652908580103,SEA,LAA,2023 REG,8,3,5,4,7,13,0,1,-1,1,1,1,1,0,0,0,0,0,0,0.4837652908580103,0.5162347091419897
89573,0.4081632653061224,0.6296296296296295,145,-170,0.39273759390377466,0.6072624060962253,home,SEA,under,7.5,0.5391705069124424,-117,0.5162347091419897,SEA,LAA,2023 REG,8,3,5,4,7,13,0,1,-1,1,1,1,1,0,0,0,0,0,0,0.4837652908580103,0.5162347091419897
89574,0.5454545454545454,0.4926108374384236,-120,103,0.5246916093311078,0.4753083906688922,away,ATL,over,8,0.5121951219512195,-105,0.48808156828023186,MIA,ATL,2023 REG,4,0,9,6,6,13,0,1,-6,6,0,0,0,0,0,0,0,0,0,0.48808156828023186,0.5119184317197681
89574,0.5454545454545454,0.4926108374384236,-120,103,0.5246916093311078,0.4753083906688922,home,MIA,under,8,0.5348837209302326,-115,0.5119184317197681,MIA,ATL,2023 REG,4,0,9,6,6,13,0,1,-6,6,0,0,0,0,0,0,0,0,0,0.48808156828023186,0.5119184317197681
89575,0.4166666666666667,0.6226415094339623,140,-165,0.4002882599580712,0.5997117400419287,away,TEX,over,8.5,0.5454545454545454,-120,0.5206611570247933,LAA,TEX,2023 REG,3,0,10,5,5,13,0,1,-5,5,0,0,0,0,0,0,0,0,0,0.5206611570247933,0.4793388429752067
89575,0.4166666666666667,0.6226415094339623,140,-165,0.4002882599580712,0.5997117400419287,home,LAA,under,8.5,0.5,100,0.4793388429752067,LAA,TEX,2023 REG,3,0,10,5,5,13,0,1,-5,5,0,0,0,0,0,0,0,0,0,0.5206611570247933,0.4793388429752067
89576,0.4484304932735426,0.5951417004048584,123,-147,0.4288913929693269,0.5711086070306731,away,CWS,over,7,0.5391705069124424,-117,0.5140669063204599,MIN,CWS,2023 REG,4,3,8,4,7,12,0,1,-1,1,1,1,1,0,0,0,0,0,0,0.5140669063204599,0.4859330936795401
89576,0.4484304932735426,0.5951417004048584,123,-147,0.4288913929693269,0.5711086070306731,home,MIN,under,7,0.5073891625615764,-103,0.4859330936795401,MIN,CWS,2023 REG,4,3,8,4,7,12,0,1,-1,1,1,1,1,0,0,0,0,0,0,0.5140669063204599,0.4859330936795401
89577,0.3921568627450981,0.6389891696750902,155,-177,0.37994273238423987,0.6200572676157601,away,ARI,over,7.5,0.5433789954337899,-119,0.5198077604720502,PIT,ARI,2023 REG,17,13,4,3,16,21,1,0,10,-10,1,1,1,0,0,0,0,0,0,0.5198077604720502,0.48019223952794976
89577,0.3921568627450981,0.6389891696750902,155,-177,0.37994273238423987,0.6200572676157601,home,PIT,under,7.5,0.5,100,0.48019223952794976,PIT,ARI,2023 REG,17,13,4,3,16,21,1,0,10,-10,1,1,1,0,0,0,0,0,0,0.5198077604720502,0.48019223952794976
89578,0.5918367346938775,0.45454545454545453,-145,120,0.5643860512665178,0.43561394873348225,away,MIA,over,8.5,0.5348837209302326,-115,0.5097020142727117,LAD,MIA,2023 REG,10,3,9,11,14,19,0,1,-8,8,1,1,1,0,0,0,0,0,0,0.5097020142727117,0.49029798572728833
89578,0.5918367346938775,0.45454545454545453,-145,120,0.5643860512665178,0.43561394873348225,home,LAD,under,8.5,0.5121951219512195,-105,0.49029798572728833,LAD,MIA,2023 REG,10,3,9,11,14,19,0,1,-8,8,1,1,1,0,0,0,0,0,0,0.5097020142727117,0.49029798572728833
89579,0.6168582375478928,0.4166666666666667,-161,140,0.5961781242201377,0.4038218757798623,away,CHC,over,8.5,0.5121951219512195,-105,0.48808156828023186,LAD,CHC,2023 REG,3,2,12,8,10,15,0,1,-6,6,1,1,0,0,0,0,0,0,0,0.48808156828023186,0.5119184317197681
89579,0.6168582375478928,0.4166666666666667,-161,140,0.5961781242201377,0.4038218757798623,home,LAD,under,8.5,0.5348837209302326,-115,0.5119184317197681,LAD,CHC,2023 REG,3,2,12,8,10,15,0,1,-6,6,1,1,0,0,0,0,0,0,0,0.48808156828023186,0.5119184317197681
89581,0.4291845493562232,0.607843137254902,133,-155,0.41329283836432396,0.586707161635676,away,TB,over,9.5,0.5121951219512195,-105,0.48808156828023186,ARI,TB,2023 REG,8,2,6,3,5,14,0,1,-1,1,1,1,0,0,0,0,0,0,0,0.48808156828023186,0.5119184317197681
89581,0.4291845493562232,0.607843137254902,133,-155,0.41329283836432396,0.586707161635676,home,ARI,under,9.5,0.5348837209302326,-115,0.5119184317197681,ARI,TB,2023 REG,8,2,6,3,5,14,0,1,-1,1,1,1,0,0,0,0,0,0,0,0.48808156828023186,0.5119184317197681
89582,0.5,0.5412844036697247,100,-118,0.47935779816513757,0.5206422018348624,away,LAD,over,9,0.5,100,0.4772727272727273,PHI,LAD,2023 REG,6,0,9,9,9,15,0,1,-9,9,0,0,0,0,0,0,0,0,0,0.4772727272727273,0.5227272727272727
89582,0.5,0.5412844036697247,100,-118,0.47935779816513757,0.5206422018348624,home,PHI,under,9,0.5454545454545454,-120,0.5227272727272727,PHI,LAD,2023 REG,6,0,9,9,9,15,0,1,-9,9,0,0,0,0,0,0,0,0,0,0.4772727272727273,0.5227272727272727
89583,0.6875,0.35714285714285715,-220,180,0.6568080357142857,0.3431919642857143,away,NYM,over,11,0.5305164319248826,-113,0.5066009958897986,ATL,NYM,2023 REG,9,3,5,2,5,14,1,0,1,-1,1,1,0,0,0,0,0,0,0,0.5066009958897986,0.49339900411020143
89583,0.6875,0.35714285714285715,-220,180,0.6568080357142857,0.3431919642857143,home,ATL,under,11,0.5145631067961165,-106,0.49339900411020143,ATL,NYM,2023 REG,9,3,5,2,5,14,1,0,1,-1,1,1,0,0,0,0,0,0,0,0.5066009958897986,0.49339900411020143
89584,0.7142857142857143,0.3278688524590164,-250,205,0.6841753094680495,0.3158246905319505,away,WSH,over,8,0.5,100,0.4772727272727273,BAL,WSH,2023 REG,9,5,6,1,6,15,1,0,4,-4,1,0,0,0,0,0,0,0,0,0.4772727272727273,0.5227272727272727
89584,0.7142857142857143,0.3278688524590164,-250,205,0.6841753094680495,0.3158246905319505,home,BAL,under,8,0.5454545454545454,-120,0.5227272727272727,BAL,WSH,2023 REG,9,5,6,1,6,15,1,0,4,-4,1,0,0,0,0,0,0,0,0,0.4772727272727273,0.5227272727272727
89585,0.6527777777777778,0.3921568627450981,-188,155,0.6234454429920115,0.37655455700798846,away,MIN,over,9,0.5412844036697247,-118,0.5136310900085983,TEX,MIN,2023 REG,9,7,13,9,16,22,0,1,-2,2,1,1,1,1,1,1,1,0,0,0.5136310900085983,0.4863689099914017
89585,0.6527777777777778,0.3921568627450981,-188,155,0.6234454429920115,0.37655455700798846,home,TEX,under,9,0.5098039215686274,-104,0.4863689099914017,TEX,MIN,2023 REG,9,7,13,9,16,22,0,1,-2,2,1,1,1,1,1,1,1,0,0,0.5136310900085983,0.4863689099914017
89586,0.29850746268656714,0.7368421052631579,235,-280,0.2879553528508283,0.7120446471491717,away,TB,over,8,0.5348837209302326,-115,0.5097020142727117,OAK,TB,2023 REG,7,3,13,6,9,20,0,1,-3,3,1,1,1,0,0,0,0,0,0,0.5097020142727117,0.49029798572728833
89586,0.29850746268656714,0.7368421052631579,235,-280,0.2879553528508283,0.7120446471491717,home,OAK,under,8,0.5121951219512195,-105,0.49029798572728833,OAK,TB,2023 REG,7,3,13,6,9,20,0,1,-3,3,1,1,1,0,0,0,0,0,0,0.5097020142727117,0.49029798572728833
89587,0.47619047619047616,0.5652173913043479,110,-130,0.4564724440500838,0.5435275559499162,away,CLE,over,9.5,0.5370370370370371,-116,0.5118817074154765,KC,CLE,2023 REG,6,6,9,4,10,15,1,0,2,-2,1,1,1,1,0,0,0,0,0,0.5118817074154765,0.48811829258452355
89587,0.47619047619047616,0.5652173913043479,110,-130,0.4564724440500838,0.5435275559499162,home,KC,under,9.5,0.5098039215686274,-104,0.48811829258452355,KC,CLE,2023 REG,6,6,9,4,10,15,1,0,2,-2,1,1,1,1,0,0,0,0,0,0.5118817074154765,0.48811829258452355
89588,0.4504504504504505,0.5918367346938775,122,-145,0.43140216885390636,0.5685978311460936,away,NYY,over,9,0.5073891625615764,-103,0.4837652908580103,LAA,NYY,2023 REG,6,7,8,3,10,14,1,0,4,-4,1,1,1,0,0,0,0,0,0,0.4837652908580103,0.5162347091419897
89588,0.4504504504504505,0.5918367346938775,122,-145,0.43140216885390636,0.5685978311460936,home,LAA,under,9,0.5391705069124424,-117,0.5162347091419897,LAA,NYY,2023 REG,6,7,8,3,10,14,1,0,4,-4,1,1,1,0,0,0,0,0,0,0.4837652908580103,0.5162347091419897
89589,0.425531914893617,0.6153846153846154,135,-160,0.4081206254135181,0.5918793745864819,away,CLE,over,9,0.5475113122171946,-121,0.5214983313199976,KC,CLE,2023 REG,13,7,10,6,13,23,1,0,1,-1,1,1,1,1,1,1,0,0,0,0.5214983313199976,0.47850166868000243
89589,0.425531914893617,0.6153846153846154,135,-160,0.4081206254135181,0.5918793745864819,home,KC,under,9,0.5,100,0.47850166868000243,KC,CLE,2023 REG,13,7,10,6,13,23,1,0,1,-1,1,1,1,1,1,1,0,0,0,0.5214983313199976,0.47850166868000243
89590,0.5535714285714286,0.48780487804878053,-124,105,0.53066668740667,0.46933331259333,away,MIN,over,7,0.5238095238095238,-110,0.4988662131519274,SEA,MIN,2023 REG,9,3,14,10,13,23,0,1,-7,7,1,1,1,0,0,0,0,0,0,0.4988662131519274,0.5011337868480725
89590,0.5535714285714286,0.48780487804878053,-124,105,0.53066668740667,0.46933331259333,home,SEA,under,7,0.5238095238095238,-110,0.5011337868480725,SEA,MIN,2023 REG,9,3,14,10,13,23,0,1,-7,7,1,1,1,0,0,0,0,0,0,0.4988662131519274,0.5011337868480725
89591,0.4608294930875576,0.5780590717299579,117,-137,0.44290849547579936,0.5570915045242006,away,TEX,over,9,0.5,100,0.4772727272727273,NYM,TEX,2023 REG,4,3,10,4,7,14,0,1,-1,1,1,1,1,0,0,0,0,0,0,0.4772727272727273,0.5227272727272727
89591,0.4608294930875576,0.5780590717299579,117,-137,0.44290849547579936,0.5570915045242006,home,NYM,under,9,0.5454545454545454,-120,0.5227272727272727,NYM,TEX,2023 REG,4,3,10,4,7,14,0,1,-1,1,1,1,1,0,0,0,0,0,0,0.4772727272727273,0.5227272727272727
89592,0.5726495726495727,0.4629629629629629,-134,116,0.5522560693500865,0.44774393064991347,away,NYY,over,9,0.5,100,0.47935779816513757,TOR,NYY,2023 REG,6,2,9,4,6,15,0,1,-2,2,1,1,0,0,0,0,0,0,0,0.47935779816513757,0.5206422018348624
89592,0.5726495726495727,0.4629629629629629,-134,116,0.5522560693500865,0.44774393064991347,home,TOR,under,9,0.5412844036697247,-118,0.5206422018348624,TOR,NYY,2023 REG,6,2,9,4,6,15,0,1,-2,2,1,1,0,0,0,0,0,0,0,0.47935779816513757,0.5206422018348624
89593,0.4854368932038835,0.5555555555555556,106,-125,0.465537646233282,0.534462353766718,away,LAA,over,8,0.5283018867924528,-112,0.5044173060022736,OAK,LAA,2023 REG,14,9,7,2,11,21,1,0,7,-7,1,1,0,0,0,0,0,0,0,0.5044173060022736,0.49558269399772636
89593,0.4854368932038835,0.5555555555555556,106,-125,0.465537646233282,0.534462353766718,home,OAK,under,8,0.5169082125603864,-107,0.49558269399772636,OAK,LAA,2023 REG,14,9,7,2,11,21,1,0,7,-7,1,1,0,0,0,0,0,0,0,0.5044173060022736,0.49558269399772636
89594,0.6363636363636364,0.4,-175,150,0.6132231404958678,0.3867768595041322,away,PIT,over,7.5,0.5348837209302326,-115,0.5097020142727117,PHI,PIT,2023 REG,5,3,5,2,5,10,1,0,1,-1,1,1,0,0,0,0,0,0,0,0.5097020142727117,0.49029798572728833
89594,0.6363636363636364,0.4,-175,150,0.6132231404958678,0.3867768595041322,home,PHI,under,7.5,0.5121951219512195,-105,0.49029798572728833,PHI,PIT,2023 REG,5,3,5,2,5,10,1,0,1,-1,1,1,0,0,0,0,0,0,0,0.5097020142727117,0.49029798572728833
89595,0.3333333333333333,0.7101449275362319,200,-245,0.3188405797101449,0.6811594202898551,away,SEA,over,9.5,0.5215311004784688,-109,0.4978845547971712,CWS,SEA,2023 REG,10,5,8,4,9,18,1,0,1,-1,1,1,1,1,0,0,0,0,0,0.4978845547971712,0.5021154452028288
89595,0.3333333333333333,0.7101449275362319,200,-245,0.3188405797101449,0.6811594202898551,home,CWS,under,9.5,0.5238095238095238,-110,0.5021154452028288,CWS,SEA,2023 REG,10,5,8,4,9,18,1,0,1,-1,1,1,1,1,0,0,0,0,0,0.4978845547971712,0.5021154452028288
89596,0.7590361445783133,0.2857142857142857,-315,250,0.7250689505007983,0.27493104949920166,away,OAK,over,9,0.5454545454545454,-120,0.5206611570247933,TOR,OAK,2023 REG,7,4,7,5,9,14,0,1,-1,1,1,1,1,1,0,0,0,0,0,0.5206611570247933,0.4793388429752067
89596,0.7590361445783133,0.2857142857142857,-315,250,0.7250689505007983,0.27493104949920166,home,TOR,under,9,0.5,100,0.4793388429752067,TOR,OAK,2023 REG,7,4,7,5,9,14,0,1,-1,1,1,1,1,1,0,0,0,0,0,0.5206611570247933,0.4793388429752067
89597,0.4716981132075471,0.5689655172413793,112,-132,0.45251715544861953,0.5474828445513804,away,PHI,over,8.5,0.5,100,0.4772727272727273,CHC,PHI,2023 REG,6,1,9,5,6,15,0,1,-4,4,1,0,0,0,0,0,0,0,0,0.4772727272727273,0.5227272727272727
89597,0.4716981132075471,0.5689655172413793,112,-132,0.45251715544861953,0.5474828445513804,home,CHC,under,8.5,0.5454545454545454,-120,0.5227272727272727,CHC,PHI,2023 REG,6,1,9,5,6,15,0,1,-4,4,1,0,0,0,0,0,0,0,0,0.4772727272727273,0.5227272727272727
89598,0.7354497354497355,0.30303030303030304,-278,230,0.7071496013294954,0.29285039867050455,away,KC,over,8.5,0.5348837209302326,-115,0.5097020142727117,TB,KC,2023 REG,7,3,4,1,4,11,1,0,2,-2,1,0,0,0,0,0,0,0,0,0.5097020142727117,0.49029798572728833
89598,0.7354497354497355,0.30303030303030304,-278,230,0.7071496013294954,0.29285039867050455,home,TB,under,8.5,0.5121951219512195,-105,0.49029798572728833,TB,KC,2023 REG,7,3,4,1,4,11,1,0,2,-2,1,0,0,0,0,0,0,0,0,0.5097020142727117,0.49029798572728833
89599,0.4854368932038835,0.5535714285714286,106,-124,0.4665008146721786,0.5334991853278215,away,LAD,over,9.5,0.5145631067961165,-106,0.4925063625223866,MIL,LAD,2023 REG,5,2,8,6,8,13,0,1,-4,4,1,1,0,0,0,0,0,0,0,0.4925063625223866,0.5074936374776133
89599,0.4854368932038835,0.5535714285714286,106,-124,0.4665008146721786,0.5334991853278215,home,MIL,under,9.5,0.5283018867924528,-112,0.5074936374776133,MIL,LAD,2023 REG,5,2,8,6,8,13,0,1,-4,4,1,1,0,0,0,0,0,0,0,0.4925063625223866,0.5074936374776133
89600,0.5348837209302326,0.5121951219512195,-115,-105,0.5097020142727117,0.49029798572728833,away,TEX,over,8,0.5454545454545454,-120,0.5206611570247933,SF,TEX,2023 REG,9,3,16,9,12,25,0,1,-6,6,1,1,1,0,0,0,0,0,0,0.5206611570247933,0.4793388429752067
89600,0.5348837209302326,0.5121951219512195,-115,-105,0.5097020142727117,0.49029798572728833,home,SF,under,8,0.5,100,0.4793388429752067,SF,TEX,2023 REG,9,3,16,9,12,25,0,1,-6,6,1,1,1,0,0,0,0,0,0,0.5206611570247933,0.4793388429752067
89601,0.5555555555555556,0.4854368932038835,-125,106,0.5327819729114227,0.4672180270885773,away,PHI,over,9,0.5391705069124424,-117,0.5140669063204599,TB,PHI,2023 REG,7,4,17,8,12,24,0,1,-4,4,1,1,1,1,0,0,0,0,0,0.5140669063204599,0.4859330936795401
89601,0.5555555555555556,0.4854368932038835,-125,106,0.5327819729114227,0.4672180270885773,home,TB,under,9,0.5073891625615764,-103,0.4859330936795401,TB,PHI,2023 REG,7,4,17,8,12,24,0,1,-4,4,1,1,1,1,0,0,0,0,0,0.5140669063204599,0.4859330936795401
89603,0.726027397260274,0.3125,-265,220,0.6980554513041847,0.30194454869581533,away,CIN,over,8.5,0.5454545454545454,-120,0.5206611570247933,SD,CIN,2023 REG,10,7,8,1,8,18,1,0,6,-6,1,0,0,0,0,0,0,0,0,0.5206611570247933,0.4793388429752067
89603,0.726027397260274,0.3125,-265,220,0.6980554513041847,0.30194454869581533,home,SD,under,8.5,0.5,100,0.4793388429752067,SD,CIN,2023 REG,10,7,8,1,8,18,1,0,6,-6,1,0,0,0,0,0,0,0,0,0.5206611570247933,0.4793388429752067
89604,0.574468085106383,0.4608294930875576,-135,117,0.5541907529524172,0.44580924704758285,away,NYM,over,8,0.5283018867924528,-112,0.5044173060022736,MIL,NYM,2023 REG,10,7,7,6,13,17,1,0,1,-1,1,1,1,1,1,1,0,0,0,0.5044173060022736,0.49558269399772636
89604,0.574468085106383,0.4608294930875576,-135,117,0.5541907529524172,0.44580924704758285,home,MIL,under,8,0.5169082125603864,-107,0.49558269399772636,MIL,NYM,2023 REG,10,7,7,6,13,17,1,0,1,-1,1,1,1,1,1,1,0,0,0,0.5044173060022736,0.49558269399772636
89605,0.7014925373134329,0.3389830508474576,-235,195,0.6730992142751963,0.32690078572480374,away,OAK,over,9,0.5098039215686274,-104,0.4870219861770517,SF,OAK,2023 REG,9,8,8,3,11,17,1,0,5,-5,1,1,1,0,0,0,0,0,0,0.4870219861770517,0.5129780138229483
89605,0.7014925373134329,0.3389830508474576,-235,195,0.6730992142751963,0.32690078572480374,home,SF,under,9,0.5348837209302326,-115,0.5129780138229483,SF,OAK,2023 REG,9,8,8,3,11,17,1,0,5,-5,1,1,1,0,0,0,0,0,0,0.4870219861770517,0.5129780138229483
89606,0.5454545454545454,0.5,-120,100,0.5206611570247933,0.4793388429752067,away,TB,over,7.5,0.5454545454545454,-120,0.5206611570247933,MIA,TB,2023 REG,10,2,15,11,13,25,0,1,-9,9,1,1,0,0,0,0,0,0,0,0.5206611570247933,0.4793388429752067
89606,0.5454545454545454,0.5,-120,100,0.5206611570247933,0.4793388429752067,home,MIA,under,7.5,0.5,100,0.4793388429752067,MIA,TB,2023 REG,10,2,15,11,13,25,0,1,-9,9,1,1,0,0,0,0,0,0,0,0.5206611570247933,0.4793388429752067
89607,0.5535714285714286,0.48780487804878053,-124,105,0.53066668740667,0.46933331259333,away,LAA,over,9.5,0.5391705069124424,-117,0.5127649394825569,TOR,LAA,2023 REG,10,6,6,1,7,16,1,0,5,-5,1,0,0,0,0,0,0,0,0,0.5127649394825569,0.48723506051744314
89607,0.5535714285714286,0.48780487804878053,-124,105,0.53066668740667,0.46933331259333,home,TOR,under,9.5,0.5098039215686274,-104,0.48723506051744314,TOR,LAA,2023 REG,10,6,6,1,7,16,1,0,5,-5,1,0,0,0,0,0,0,0,0,0.5127649394825569,0.48723506051744314
89608,0.5073891625615764,0.5348837209302326,-103,-115,0.4859403596076043,0.5140596403923957,away,BOS,over,9,0.5121951219512195,-105,0.48808156828023186,CHC,BOS,2023 REG,12,10,6,4,14,18,1,0,6,-6,1,1,1,1,0,0,0,0,0,0.48808156828023186,0.5119184317197681
89608,0.5073891625615764,0.5348837209302326,-103,-115,0.4859403596076043,0.5140596403923957,home,CHC,under,9,0.5348837209302326,-115,0.5119184317197681,CHC,BOS,2023 REG,12,10,6,4,14,18,1,0,6,-6,1,1,1,1,0,0,0,0,0,0.48808156828023186,0.5119184317197681
89609,0.4694835680751174,0.5708154506437768,113,-133,0.45056384097704505,0.549436159022955,away,SEA,over,8,0.5121951219512195,-105,0.48808156828023186,CLE,SEA,2023 REG,9,7,9,6,13,18,1,0,1,-1,1,1,1,1,1,1,0,0,0,0.48808156828023186,0.5119184317197681
89609,0.4694835680751174,0.5708154506437768,113,-133,0.45056384097704505,0.549436159022955,home,CLE,under,8,0.5348837209302326,-115,0.5119184317197681,CLE,SEA,2023 REG,9,7,9,6,13,18,1,0,1,-1,1,1,1,1,1,1,0,0,0,0.48808156828023186,0.5119184317197681
89610,0.46511627906976744,0.576271186440678,115,-136,0.44586629511142073,0.5541337048885793,away,PHI,over,8.5,0.5327102803738317,-114,0.508788710910954,CHC,PHI,2023 REG,10,5,11,8,13,21,0,1,-3,3,1,1,1,1,1,0,0,0,0,0.508788710910954,0.491211289089046
89610,0.46511627906976744,0.576271186440678,115,-136,0.44586629511142073,0.5541337048885793,home,CHC,under,8.5,0.5121951219512195,-105,0.491211289089046,CHC,PHI,2023 REG,10,5,11,8,13,21,0,1,-3,3,1,1,1,1,1,0,0,0,0,0.508788710910954,0.491211289089046
89611,0.6000000000000001,0.4347826086956522,-150,130,0.5791304347826086,0.4208695652173914,away,DET,over,8.5,0.5348837209302326,-115,0.5097020142727117,MIL,DET,2023 REG,5,2,8,4,6,13,0,1,-2,2,1,1,0,0,0,0,0,0,0,0.5097020142727117,0.49029798572728833
89611,0.6000000000000001,0.4347826086956522,-150,130,0.5791304347826086,0.4208695652173914,home,MIL,under,8.5,0.5121951219512195,-105,0.49029798572728833,MIL,DET,2023 REG,5,2,8,4,6,13,0,1,-2,2,1,1,0,0,0,0,0,0,0,0.5097020142727117,0.49029798572728833
89612,0.5867768595041323,0.45454545454545453,-142,120,0.5625298818386723,0.43747011816132775,away,PHI,over,9.5,0.5238095238095238,-110,0.4988662131519274,ATL,PHI,2023 REG,9,5,5,6,11,14,0,1,-1,1,1,1,1,1,1,0,0,0,0,0.4988662131519274,0.5011337868480725
89612,0.5867768595041323,0.45454545454545453,-142,120,0.5625298818386723,0.43747011816132775,home,ATL,under,9.5,0.5238095238095238,-110,0.5011337868480725,ATL,PHI,2023 REG,9,5,5,6,11,14,0,1,-1,1,1,1,1,1,1,0,0,0,0,0.4988662131519274,0.5011337868480725
89613,0.5652173913043479,0.47619047619047616,-130,110,0.5418129444594474,0.4581870555405526,away,CWS,over,8.5,0.5192307692307692,-108,0.49455035168025013,CLE,CWS,2023 REG,7,2,8,4,6,15,0,1,-2,2,1,1,0,0,0,0,0,0,0,0.49455035168025013,0.5054496483197499
89613,0.5652173913043479,0.47619047619047616,-130,110,0.5418129444594474,0.4581870555405526,home,CLE,under,8.5,0.5283018867924528,-112,0.5054496483197499,CLE,CWS,2023 REG,7,2,8,4,6,15,0,1,-2,2,1,1,0,0,0,0,0,0,0,0.49455035168025013,0.5054496483197499
89614,0.7014925373134329,0.3367003367003367,-235,197,0.6747005212142214,0.3252994787857786,away,CHC,over,8.5,0.5098039215686274,-104,0.4870219861770517,LAD,CHC,2023 REG,8,2,11,3,5,19,0,1,-1,1,1,1,0,0,0,0,0,0,0,0.4870219861770517,0.5129780138229483
89614,0.7014925373134329,0.3367003367003367,-235,197,0.6747005212142214,0.3252994787857786,home,LAD,under,8.5,0.5348837209302326,-115,0.5129780138229483,LAD,CHC,2023 REG,8,2,11,3,5,19,0,1,-1,1,1,1,0,0,0,0,0,0,0,0.4870219861770517,0.5129780138229483
89616,0.4166666666666667,0.6226415094339623,140,-165,0.4002882599580712,0.5997117400419287,away,MIL,over,11,0.5169082125603864,-107,0.49353874091423283,COL,MIL,2023 REG,9,3,8,2,5,17,1,0,1,-1,1,1,0,0,0,0,0,0,0,0.49353874091423283,0.5064612590857671
89616,0.4166666666666667,0.6226415094339623,140,-165,0.4002882599580712,0.5997117400419287,home,COL,under,11,0.5283018867924528,-112,0.5064612590857671,COL,MIL,2023 REG,9,3,8,2,5,17,1,0,1,-1,1,1,0,0,0,0,0,0,0,0.49353874091423283,0.5064612590857671
89617,0.5,0.5454545454545454,100,-120,0.4772727272727273,0.5227272727272727,away,NYY,over,9,0.5348837209302326,-115,0.5097020142727117,PIT,NYY,2023 REG,4,3,9,6,9,13,0,1,-3,3,1,1,1,0,0,0,0,0,0,0.5097020142727117,0.49029798572728833
89617,0.5,0.5454545454545454,100,-120,0.4772727272727273,0.5227272727272727,home,PIT,under,9,0.5121951219512195,-105,0.49029798572728833,PIT,NYY,2023 REG,4,3,9,6,9,13,0,1,-3,3,1,1,1,0,0,0,0,0,0,0.5097020142727117,0.49029798572728833
89618,0.7014925373134329,0.33557046979865773,-235,198,0.6754931144139067,0.3245068855860933,away,DET,over,6.5,0.5515695067264574,-123,0.5258558814517258,TB,DET,2023 REG,6,4,6,0,4,12,1,0,4,-4,0,0,0,0,0,0,0,0,0,0.5258558814517258,0.4741441185482742
89618,0.7014925373134329,0.33557046979865773,-235,198,0.6754931144139067,0.3245068855860933,home,TB,under,6.5,0.49504950495049505,102,0.4741441185482742,TB,DET,2023 REG,6,4,6,0,4,12,1,0,4,-4,0,0,0,0,0,0,0,0,0,0.5258558814517258,0.4741441185482742
89619,0.43859649122807015,0.6000000000000001,128,-150,0.4216682056017235,0.5783317943982764,away,SEA,over,8,0.5215311004784688,-109,0.4978845547971712,KC,SEA,2023 REG,14,7,7,6,13,21,1,0,1,-1,1,1,1,1,1,1,0,0,0,0.4978845547971712,0.5021154452028288
89619,0.43859649122807015,0.6000000000000001,128,-150,0.4216682056017235,0.5783317943982764,home,KC,under,8,0.5238095238095238,-110,0.5021154452028288,KC,SEA,2023 REG,14,7,7,6,13,21,1,0,1,-1,1,1,1,1,1,1,0,0,0,0.4978845547971712,0.5021154452028288
89620,0.5,0.5454545454545454,100,-120,0.4772727272727273,0.5227272727272727,away,MIN,over,8,0.5098039215686274,-104,0.48483656587239576,CLE,MIN,2023 REG,7,3,11,8,11,18,0,1,-5,5,1,1,1,0,0,0,0,0,0,0.48483656587239576,0.5151634341276042
89620,0.5,0.5454545454545454,100,-120,0.4772727272727273,0.5227272727272727,home,CLE,under,8,0.5391705069124424,-117,0.5151634341276042,CLE,MIN,2023 REG,7,3,11,8,11,18,0,1,-5,5,1,1,1,0,0,0,0,0,0,0.48483656587239576,0.5151634341276042
89621,0.5850622406639003,0.45454545454545453,-141,120,0.5618892737571823,0.43811072624281766,away,PHI,over,7.5,0.5238095238095238,-110,0.4988662131519274,TOR,PHI,2023 REG,5,4,11,9,13,16,0,1,-5,5,1,1,1,1,0,0,0,0,0,0.4988662131519274,0.5011337868480725
89621,0.5850622406639003,0.45454545454545453,-141,120,0.5618892737571823,0.43811072624281766,home,TOR,under,7.5,0.5238095238095238,-110,0.5011337868480725,TOR,PHI,2023 REG,5,4,11,9,13,16,0,1,-5,5,1,1,1,1,0,0,0,0,0,0.4988662131519274,0.5011337868480725
89622,0.6551724137931035,0.3846153846153846,-190,160,0.6291045458703008,0.37089545412969915,away,KC,over,8.5,0.5121951219512195,-105,0.48808156828023186,CLE,KC,2023 REG,6,3,2,0,3,8,1,0,3,-3,0,0,0,0,0,0,0,0,0,0.48808156828023186,0.5119184317197681
89622,0.6551724137931035,0.3846153846153846,-190,160,0.6291045458703008,0.37089545412969915,home,CLE,under,8.5,0.5348837209302326,-115,0.5119184317197681,CLE,KC,2023 REG,6,3,2,0,3,8,1,0,3,-3,0,0,0,0,0,0,0,0,0,0.48808156828023186,0.5119184317197681
89623,0.4444444444444444,0.5918367346938775,125,-145,0.42831947593852354,0.5716805240614764,away,SD,over,9,0.5121951219512195,-105,0.48808156828023186,STL,SD,2023 REG,9,6,12,5,11,21,1,0,1,-1,1,1,1,1,1,0,0,0,0,0.48808156828023186,0.5119184317197681
89623,0.4444444444444444,0.5918367346938775,125,-145,0.42831947593852354,0.5716805240614764,home,STL,under,9,0.5348837209302326,-115,0.5119184317197681,STL,SD,2023 REG,9,6,12,5,11,21,1,0,1,-1,1,1,1,1,1,0,0,0,0,0.48808156828023186,0.5119184317197681
89624,0.5535714285714286,0.48780487804878053,-124,105,0.53066668740667,0.46933331259333,away,MIN,over,7.5,0.5370370370370371,-116,0.5118817074154765,CWS,MIN,2023 REG,12,6,8,4,10,20,1,0,2,-2,1,1,1,1,0,0,0,0,0,0.5118817074154765,0.48811829258452355
89624,0.5535714285714286,0.48780487804878053,-124,105,0.53066668740667,0.46933331259333,home,CWS,under,7.5,0.5098039215686274,-104,0.48811829258452355,CWS,MIN,2023 REG,12,6,8,4,10,20,1,0,2,-2,1,1,1,1,0,0,0,0,0,0.5118817074154765,0.48811829258452355
89625,0.6153846153846154,0.4166666666666667,-160,140,0.5956607495069033,0.4043392504930967,away,PIT,over,8.5,0.504950495049505,-102,0.4837488699364985,SF,PIT,2023 REG,5,1,6,2,3,11,0,1,-1,1,1,0,0,0,0,0,0,0,0,0.4837488699364985,0.5162511300635015
89625,0.6153846153846154,0.4166666666666667,-160,140,0.5956607495069033,0.4043392504930967,home,SF,under,8.5,0.5370370370370371,-116,0.5162511300635015,SF,PIT,2023 REG,5,1,6,2,3,11,0,1,-1,1,1,0,0,0,0,0,0,0,0,0.4837488699364985,0.5162511300635015
89626,0.5454545454545454,0.5,-120,100,0.5206611570247933,0.4793388429752067,away,MIL,over,8,0.5121951219512195,-105,0.48808156828023186,STL,MIL,2023 REG,8,3,7,0,3,15,1,0,3,-3,0,0,0,0,0,0,0,0,0,0.48808156828023186,0.5119184317197681
89626,0.5454545454545454,0.5,-120,100,0.5206611570247933,0.4793388429752067,home,STL,under,8,0.5348837209302326,-115,0.5119184317197681,STL,MIL,2023 REG,8,3,7,0,3,15,1,0,3,-3,0,0,0,0,0,0,0,0,0,0.48808156828023186,0.5119184317197681
89627,0.5850622406639003,0.45454545454545453,-141,120,0.5618892737571823,0.43811072624281766,away,MIA,over,8,0.5348837209302326,-115,0.5097020142727117,NYM,MIA,2023 REG,9,2,11,7,9,20,0,1,-5,5,1,1,0,0,0,0,0,0,0,0.5097020142727117,0.49029798572728833
89627,0.5850622406639003,0.45454545454545453,-141,120,0.5618892737571823,0.43811072624281766,home,NYM,under,8,0.5121951219512195,-105,0.49029798572728833,NYM,MIA,2023 REG,9,2,11,7,9,20,0,1,-5,5,1,1,0,0,0,0,0,0,0,0.5097020142727117,0.49029798572728833
89628,0.4347826086956522,0.607843137254902,130,-155,0.41624967567367205,0.583750324326328,away,PHI,over,9.5,0.5098039215686274,-104,0.48483656587239576,WSH,PHI,2023 REG,9,3,16,12,15,25,0,1,-9,9,1,1,1,0,0,0,0,0,0,0.48483656587239576,0.5151634341276042
89628,0.4347826086956522,0.607843137254902,130,-155,0.41624967567367205,0.583750324326328,home,WSH,under,9.5,0.5391705069124424,-117,0.5151634341276042,WSH,PHI,2023 REG,9,3,16,12,15,25,0,1,-9,9,1,1,1,0,0,0,0,0,0,0.48483656587239576,0.5151634341276042
89629,0.4166666666666667,0.6153846153846154,140,-160,0.40331196581196577,0.5966880341880343,away,BOS,over,8.5,0.5454545454545454,-120,0.5206611570247933,OAK,BOS,2023 REG,1,0,10,7,7,11,0,1,-7,7,0,0,0,0,0,0,0,0,0,0.5206611570247933,0.4793388429752067
89629,0.4166666666666667,0.6153846153846154,140,-160,0.40331196581196577,0.5966880341880343,home,OAK,under,8.5,0.5,100,0.4793388429752067,OAK,BOS,2023 REG,1,0,10,7,7,11,0,1,-7,7,0,0,0,0,0,0,0,0,0,0.5206611570247933,0.4793388429752067
89630,0.5260663507109005,0.5145631067961165,-111,-106,0.5046925602688205,0.4953074397311795,away,BAL,over,7.5,0.5348837209302326,-115,0.5097020142727117,DET,BAL,2023 REG,16,7,9,4,11,25,1,0,3,-3,1,1,1,1,0,0,0,0,0,0.5097020142727117,0.49029798572728833
89630,0.5260663507109005,0.5145631067961165,-111,-106,0.5046925602688205,0.4953074397311795,home,DET,under,7.5,0.5121951219512195,-105,0.49029798572728833,DET,BAL,2023 REG,16,7,9,4,11,25,1,0,3,-3,1,1,1,1,0,0,0,0,0,0.5097020142727117,0.49029798572728833
89631,0.5121951219512195,0.5305164319248826,-105,-113,0.4903184724049234,0.5096815275950766,away,NYY,over,9.5,0.5121951219512195,-105,0.48808156828023186,STL,NYY,2023 REG,7,2,10,6,8,17,0,1,-4,4,1,1,0,0,0,0,0,0,0,0.48808156828023186,0.5119184317197681
89631,0.5121951219512195,0.5305164319248826,-105,-113,0.4903184724049234,0.5096815275950766,home,STL,under,9.5,0.5348837209302326,-115,0.5119184317197681,STL,NYY,2023 REG,7,2,10,6,8,17,0,1,-4,4,1,1,0,0,0,0,0,0,0,0.48808156828023186,0.5119184317197681
89632,0.5,0.5454545454545454,100,-120,0.4772727272727273,0.5227272727272727,away,ATL,over,10,0.5238095238095238,-110,0.4988662131519274,LAD,ATL,2023 REG,6,2,5,4,6,11,0,1,-2,2,1,1,0,0,0,0,0,0,0,0.4988662131519274,0.5011337868480725
89632,0.5,0.5454545454545454,100,-120,0.4772727272727273,0.5227272727272727,home,LAD,under,10,0.5238095238095238,-110,0.5011337868480725,LAD,ATL,2023 REG,6,2,5,4,6,11,0,1,-2,2,1,1,0,0,0,0,0,0,0,0.4988662131519274,0.5011337868480725
89633,0.6226415094339623,0.4166666666666667,-165,140,0.5981666073335706,0.40183339266642937,away,CWS,over,7.5,0.5260663507109005,-111,0.5010269332605688,MIN,CWS,2023 REG,9,4,4,3,7,13,1,0,1,-1,1,1,1,0,0,0,0,0,0,0.5010269332605688,0.4989730667394312
89633,0.6226415094339623,0.4166666666666667,-165,140,0.5981666073335706,0.40183339266642937,home,MIN,under,7.5,0.5215311004784688,-109,0.4989730667394312,MIN,CWS,2023 REG,9,4,4,3,7,13,1,0,1,-1,1,1,1,0,0,0,0,0,0,0.5010269332605688,0.4989730667394312
89634,0.5652173913043479,0.47619047619047616,-130,110,0.5418129444594474,0.4581870555405526,away,SF,over,9,0.5238095238095238,-110,0.4988662131519274,PHI,SF,2023 REG,9,4,8,3,7,17,1,0,1,-1,1,1,1,0,0,0,0,0,0,0.4988662131519274,0.5011337868480725
89634,0.5652173913043479,0.47619047619047616,-130,110,0.5418129444594474,0.4581870555405526,home,PHI,under,9,0.5238095238095238,-110,0.5011337868480725,PHI,SF,2023 REG,9,4,8,3,7,17,1,0,1,-1,1,1,1,0,0,0,0,0,0,0.4988662131519274,0.5011337868480725
89635,0.4484304932735426,0.5918367346938775,123,-145,0.43037344037335423,0.5696265596266458,away,SEA,over,8.5,0.5454545454545454,-120,0.5206611570247933,CWS,SEA,2023 REG,10,3,9,6,9,19,0,1,-3,3,1,1,1,0,0,0,0,0,0,0.5206611570247933,0.4793388429752067
89635,0.4484304932735426,0.5918367346938775,123,-145,0.43037344037335423,0.5696265596266458,home,CWS,under,8.5,0.5,100,0.4793388429752067,CWS,SEA,2023 REG,10,3,9,6,9,19,0,1,-3,3,1,1,1,0,0,0,0,0,0,0.5206611570247933,0.4793388429752067
89636,0.4347826086956522,0.6000000000000001,130,-150,0.4196597353497164,0.5803402646502835,away,SEA,over,8,0.5391705069124424,-117,0.5140669063204599,NYM,SEA,2023 REG,13,7,10,8,15,23,0,1,-1,1,1,1,1,1,1,1,1,0,0,0.5140669063204599,0.4859330936795401
89636,0.4347826086956522,0.6000000000000001,130,-150,0.4196597353497164,0.5803402646502835,home,NYM,under,8,0.5073891625615764,-103,0.4859330936795401,NYM,SEA,2023 REG,13,7,10,8,15,23,0,1,-1,1,1,1,1,1,1,1,1,0,0,0.5140669063204599,0.4859330936795401
89637,0.5454545454545454,0.5,-120,100,0.5206611570247933,0.4793388429752067,away,NYY,over,9.5,0.5121951219512195,-105,0.48808156828023186,BAL,NYY,2023 REG,5,3,12,8,11,17,0,1,-5,5,1,1,1,0,0,0,0,0,0,0.48808156828023186,0.5119184317197681
89637,0.5454545454545454,0.5,-120,100,0.5206611570247933,0.4793388429752067,home,BAL,under,9.5,0.5348837209302326,-115,0.5119184317197681,BAL,NYY,2023 REG,5,3,12,8,11,17,0,1,-5,5,1,1,1,0,0,0,0,0,0,0.48808156828023186,0.5119184317197681
89638,0.6794871794871794,0.36101083032490977,-212,177,0.6519693010251187,0.34803069897488126,away,KC,over,9.5,0.5327102803738317,-114,0.5075272610403079,PHI,KC,2023 REG,12,8,7,4,12,19,1,0,4,-4,1,1,1,1,0,0,0,0,0,0.5075272610403079,0.4924727389596921
89638,0.6794871794871794,0.36101083032490977,-212,177,0.6519693010251187,0.34803069897488126,home,PHI,under,9.5,0.5145631067961165,-106,0.4924727389596921,PHI,KC,2023 REG,12,8,7,4,12,19,1,0,4,-4,1,1,1,1,0,0,0,0,0,0.5075272610403079,0.4924727389596921
89639,0.5,0.5412844036697247,100,-118,0.47935779816513757,0.5206422018348624,away,NYY,over,8,0.5169082125603864,-107,0.49239402434819424,DET,NYY,2023 REG,8,4,5,3,7,13,1,0,1,-1,1,1,1,0,0,0,0,0,0,0.49239402434819424,0.5076059756518058
89639,0.5,0.5412844036697247,100,-118,0.47935779816513757,0.5206422018348624,home,DET,under,8,0.5305164319248826,-113,0.5076059756518058,DET,NYY,2023 REG,8,4,5,3,7,13,1,0,1,-1,1,1,1,0,0,0,0,0,0,0.49239402434819424,0.5076059756518058
89640,0.6153846153846154,0.425531914893617,-160,135,0.5902052121364724,0.40979478786352763,away,SEA,over,9,0.504950495049505,-102,0.48054649490447493,TB,SEA,2023 REG,7,7,6,5,12,13,1,0,2,-2,1,1,1,1,1,0,0,0,0,0.48054649490447493,0.5194535050955251
89640,0.6153846153846154,0.425531914893617,-160,135,0.5902052121364724,0.40979478786352763,home,TB,under,9,0.5433789954337899,-119,0.5194535050955251,TB,SEA,2023 REG,7,7,6,5,12,13,1,0,2,-2,1,1,1,1,1,0,0,0,0,0.48054649490447493,0.5194535050955251
89641,0.47619047619047616,0.5652173913043479,110,-130,0.4564724440500838,0.5435275559499162,away,MIN,over,9.5,0.5121951219512195,-105,0.48808156828023186,CIN,MIN,2023 REG,4,0,11,7,7,15,0,1,-7,7,0,0,0,0,0,0,0,0,0,0.48808156828023186,0.5119184317197681
89641,0.47619047619047616,0.5652173913043479,110,-130,0.4564724440500838,0.5435275559499162,home,CIN,under,9.5,0.5348837209302326,-115,0.5119184317197681,CIN,MIN,2023 REG,4,0,11,7,7,15,0,1,-7,7,0,0,0,0,0,0,0,0,0,0.48808156828023186,0.5119184317197681
89642,0.5454545454545454,0.5,-120,100,0.5206611570247933,0.4793388429752067,away,SEA,over,8,0.5283018867924528,-112,0.5044173060022736,SF,SEA,2023 REG,5,0,13,6,6,18,0,1,-6,6,0,0,0,0,0,0,0,0,0,0.5044173060022736,0.49558269399772636
89642,0.5454545454545454,0.5,-120,100,0.5206611570247933,0.4793388429752067,home,SF,under,8,0.5169082125603864,-107,0.49558269399772636,SF,SEA,2023 REG,5,0,13,6,6,18,0,1,-6,6,0,0,0,0,0,0,0,0,0,0.5044173060022736,0.49558269399772636
89643,0.46511627906976744,0.576271186440678,115,-136,0.44586629511142073,0.5541337048885793,away,NYM,over,8.5,0.5391705069124424,-117,0.5127649394825569,LAD,NYM,2023 REG,5,3,11,5,8,16,0,1,-2,2,1,1,1,0,0,0,0,0,0,0.5127649394825569,0.48723506051744314
89643,0.46511627906976744,0.576271186440678,115,-136,0.44586629511142073,0.5541337048885793,home,LAD,under,8.5,0.5098039215686274,-104,0.48723506051744314,LAD,NYM,2023 REG,5,3,11,5,8,16,0,1,-2,2,1,1,1,0,0,0,0,0,0,0.5127649394825569,0.48723506051744314
89644,0.35714285714285715,0.6875,180,-220,0.3411989795918367,0.6588010204081634,away,HOU,over,12,0.5238095238095238,-110,0.4988662131519274,COL,HOU,2023 REG,7,4,8,3,7,15,1,0,1,-1,1,1,1,0,0,0,0,0,0,0.4988662131519274,0.5011337868480725
89644,0.35714285714285715,0.6875,180,-220,0.3411989795918367,0.6588010204081634,home,COL,under,12,0.5238095238095238,-110,0.5011337868480725,COL,HOU,2023 REG,7,4,8,3,7,15,1,0,1,-1,1,1,1,0,0,0,0,0,0,0.4988662131519274,0.5011337868480725
89645,0.4,0.6389891696750902,150,-177,0.3844043321299639,0.6155956678700361,away,MIL,over,8.5,0.5145631067961165,-106,0.49023796582517226,CWS,MIL,2023 REG,5,2,7,3,5,12,0,1,-1,1,1,1,0,0,0,0,0,0,0,0.49023796582517226,0.5097620341748277
89645,0.4,0.6389891696750902,150,-177,0.3844043321299639,0.6155956678700361,home,CWS,under,8.5,0.5327102803738317,-114,0.5097620341748277,CWS,MIL,2023 REG,5,2,7,3,5,12,0,1,-1,1,1,1,0,0,0,0,0,0,0,0.49023796582517226,0.5097620341748277
89646,0.5348837209302326,0.5098039215686274,-115,-104,0.5109810284308424,0.48901897156915763,away,SEA,over,7.5,0.5,100,0.4772727272727273,LAA,SEA,2023 REG,6,5,4,4,9,10,1,0,1,-1,1,1,1,1,0,0,0,0,0,0.4772727272727273,0.5227272727272727
89646,0.5348837209302326,0.5098039215686274,-115,-104,0.5109810284308424,0.48901897156915763,home,LAA,under,7.5,0.5454545454545454,-120,0.5227272727272727,LAA,SEA,2023 REG,6,5,4,4,9,10,1,0,1,-1,1,1,1,1,0,0,0,0,0,0.4772727272727273,0.5227272727272727
89647,0.4065040650406504,0.635036496350365,146,-174,0.38961765797113196,0.6103823420288681,away,SEA,over,8,0.5169082125603864,-107,0.49353874091423283,OAK,SEA,2023 REG,5,0,9,5,5,14,0,1,-5,5,0,0,0,0,0,0,0,0,0,0.49353874091423283,0.5064612590857671
89647,0.4065040650406504,0.635036496350365,146,-174,0.38961765797113196,0.6103823420288681,home,OAK,under,8,0.5283018867924528,-112,0.5064612590857671,OAK,SEA,2023 REG,5,0,9,5,5,14,0,1,-5,5,0,0,0,0,0,0,0,0,0,0.49353874091423283,0.5064612590857671
89648,0.4347826086956522,0.6062992125984252,130,-154,0.4169209472634447,0.5830790527365552,away,TEX,over,9,0.5121951219512195,-105,0.48808156828023186,OAK,TEX,2023 REG,7,3,11,11,14,18,0,1,-8,8,1,1,1,0,0,0,0,0,0,0.48808156828023186,0.5119184317197681
89648,0.4347826086956522,0.6062992125984252,130,-154,0.4169209472634447,0.5830790527365552,home,OAK,under,9,0.5348837209302326,-115,0.5119184317197681,OAK,TEX,2023 REG,7,3,11,11,14,18,0,1,-8,8,1,1,1,0,0,0,0,0,0,0.48808156828023186,0.5119184317197681
89649,0.6923076923076923,0.3472222222222222,-225,188,0.6649408284023669,0.3350591715976331,away,KC,over,9,0.5454545454545454,-120,0.5206611570247933,CLE,KC,2023 REG,11,6,6,1,7,17,1,0,5,-5,1,0,0,0,0,0,0,0,0,0.5206611570247933,0.4793388429752067
89649,0.6923076923076923,0.3472222222222222,-225,188,0.6649408284023669,0.3350591715976331,home,CLE,under,9,0.5,100,0.4793388429752067,CLE,KC,2023 REG,11,6,6,1,7,17,1,0,5,-5,1,0,0,0,0,0,0,0,0,0.5206611570247933,0.4793388429752067
89650,0.6389891696750902,0.4,-177,150,0.614075512518083,0.385924487481917,away,COL,over,10.5,0.5121951219512195,-105,0.48808156828023186,PHI,COL,2023 REG,7,4,9,3,7,16,1,0,1,-1,1,1,1,0,0,0,0,0,0,0.48808156828023186,0.5119184317197681
89650,0.6389891696750902,0.4,-177,150,0.614075512518083,0.385924487481917,home,PHI,under,10.5,0.5348837209302326,-115,0.5119184317197681,PHI,COL,2023 REG,7,4,9,3,7,16,1,0,1,-1,1,1,1,0,0,0,0,0,0,0.48808156828023186,0.5119184317197681
89651,0.5850622406639003,0.45454545454545453,-141,120,0.5618892737571823,0.43811072624281766,away,NYM,over,8.5,0.5305164319248826,-113,0.5053568787472517,NYY,NYM,2023 REG,6,3,4,1,4,10,1,0,2,-2,1,0,0,0,0,0,0,0,0,0.5053568787472517,0.49464312125274834
89651,0.5850622406639003,0.45454545454545453,-141,120,0.5618892737571823,0.43811072624281766,home,NYY,under,8.5,0.5169082125603864,-107,0.49464312125274834,NYY,NYM,2023 REG,6,3,4,1,4,10,1,0,2,-2,1,0,0,0,0,0,0,0,0,0.5053568787472517,0.49464312125274834
89652,0.4166666666666667,0.6226415094339623,140,-165,0.4002882599580712,0.5997117400419287,away,PHI,over,10.5,0.5454545454545454,-120,0.5206611570247933,COL,PHI,2023 REG,6,4,7,0,4,13,1,0,4,-4,0,0,0,0,0,0,0,0,0,0.5206611570247933,0.4793388429752067
89652,0.4166666666666667,0.6226415094339623,140,-165,0.4002882599580712,0.5997117400419287,home,COL,under,10.5,0.5,100,0.4793388429752067,COL,PHI,2023 REG,6,4,7,0,4,13,1,0,4,-4,0,0,0,0,0,0,0,0,0,0.5206611570247933,0.4793388429752067
89653,0.49019607843137253,0.5454545454545454,104,-120,0.4727202824088637,0.5272797175911363,away,SD,over,8,0.5215311004784688,-109,0.4978845547971712,SF,SD,2023 REG,8,4,8,2,6,16,1,0,2,-2,1,1,0,0,0,0,0,0,0,0.4978845547971712,0.5021154452028288
89653,0.49019607843137253,0.5454545454545454,104,-120,0.4727202824088637,0.5272797175911363,home,SF,under,8,0.5238095238095238,-110,0.5021154452028288,SF,SD,2023 REG,8,4,8,2,6,16,1,0,2,-2,1,1,0,0,0,0,0,0,0,0.4978845547971712,0.5021154452028288
89654,0.5594713656387665,0.47619047619047616,-127,110,0.5395195862893665,0.46048041371063353,away,WSH,over,9.5,0.5121951219512195,-105,0.48808156828023186,ARI,WSH,2023 REG,16,8,11,7,15,27,1,0,1,-1,1,1,1,1,1,1,1,0,0,0.48808156828023186,0.5119184317197681
89654,0.5594713656387665,0.47619047619047616,-127,110,0.5395195862893665,0.46048041371063353,home,ARI,under,9.5,0.5348837209302326,-115,0.5119184317197681,ARI,WSH,2023 REG,16,8,11,7,15,27,1,0,1,-1,1,1,1,1,1,1,1,0,0,0.48808156828023186,0.5119184317197681
89655,0.6551724137931035,0.3846153846153846,-190,160,0.6291045458703008,0.37089545412969915,away,ARI,over,10.5,0.5238095238095238,-110,0.4988662131519274,ATL,ARI,2023 REG,11,13,16,16,29,27,0,1,-3,3,1,1,1,1,1,1,1,1,1,0.4988662131519274,0.5011337868480725
89655,0.6551724137931035,0.3846153846153846,-190,160,0.6291045458703008,0.37089545412969915,home,ATL,under,10.5,0.5238095238095238,-110,0.5011337868480725,ATL,ARI,2023 REG,11,13,16,16,29,27,0,1,-3,3,1,1,1,1,1,1,1,1,1,0.4988662131519274,0.5011337868480725
89656,0.5918367346938775,0.4444444444444444,-145,125,0.5703642001018094,0.42963579989819056,away,CLE,over,7.5,0.5348837209302326,-115,0.5097020142727117,NYM,CLE,2023 REG,11,5,8,4,9,19,1,0,1,-1,1,1,1,1,0,0,0,0,0,0.5097020142727117,0.49029798572728833
89656,0.5918367346938775,0.4444444444444444,-145,125,0.5703642001018094,0.42963579989819056,home,NYM,under,7.5,0.5121951219512195,-105,0.49029798572728833,NYM,CLE,2023 REG,11,5,8,4,9,19,1,0,1,-1,1,1,1,1,0,0,0,0,0,0.5097020142727117,0.49029798572728833
89657,0.576271186440678,0.4629629629629629,-136,116,0.553661676614851,0.446338323385149,away,STL,over,8,0.5348837209302326,-115,0.5097020142727117,CHC,STL,2023 REG,9,4,7,3,7,16,1,0,1,-1,1,1,1,0,0,0,0,0,0,0.5097020142727117,0.49029798572728833
89657,0.576271186440678,0.4629629629629629,-136,116,0.553661676614851,0.446338323385149,home,CHC,under,8,0.5121951219512195,-105,0.49029798572728833,CHC,STL,2023 REG,9,4,7,3,7,16,1,0,1,-1,1,1,1,0,0,0,0,0,0,0.5097020142727117,0.49029798572728833
89658,0.5,0.5454545454545454,100,-120,0.4772727272727273,0.5227272727272727,away,LAD,over,10,0.5098039215686274,-104,0.48592421718142587,TEX,LAD,2023 REG,9,8,8,4,12,17,1,0,4,-4,1,1,1,1,0,0,0,0,0,0.48592421718142587,0.5140757828185741
89658,0.5,0.5454545454545454,100,-120,0.4772727272727273,0.5227272727272727,home,TEX,under,10,0.5370370370370371,-116,0.5140757828185741,TEX,LAD,2023 REG,9,8,8,4,12,17,1,0,4,-4,1,1,1,1,0,0,0,0,0,0.48592421718142587,0.5140757828185741
89659,0.6491228070175439,0.38759689922480617,-185,158,0.6252872082286499,0.3747127917713501,away,STL,over,8.5,0.5215311004784688,-109,0.4978845547971712,MIA,STL,2023 REG,19,15,9,2,17,28,1,0,13,-13,1,1,0,0,0,0,0,0,0,0.4978845547971712,0.5021154452028288
89659,0.6491228070175439,0.38759689922480617,-185,158,0.6252872082286499,0.3747127917713501,home,MIA,under,8.5,0.5238095238095238,-110,0.5021154452028288,MIA,STL,2023 REG,19,15,9,2,17,28,1,0,13,-13,1,1,0,0,0,0,0,0,0,0.4978845547971712,0.5021154452028288
89660,0.6000000000000001,0.4347826086956522,-150,130,0.5791304347826086,0.4208695652173914,away,CHC,over,9.5,0.5,100,0.4772727272727273,ATL,CHC,2023 REG,9,6,7,5,11,16,1,0,1,-1,1,1,1,1,1,0,0,0,0,0.4772727272727273,0.5227272727272727
89660,0.6000000000000001,0.4347826086956522,-150,130,0.5791304347826086,0.4208695652173914,home,ATL,under,9.5,0.5454545454545454,-120,0.5227272727272727,ATL,CHC,2023 REG,9,6,7,5,11,16,1,0,1,-1,1,1,1,1,1,0,0,0,0,0.4772727272727273,0.5227272727272727
89661,0.5967741935483871,0.4464285714285714,-148,124,0.5709918983202021,0.42900810167979786,away,BOS,over,8.5,0.5238095238095238,-110,0.4988662131519274,TOR,BOS,2023 REG,8,4,5,3,7,13,1,0,1,-1,1,1,1,0,0,0,0,0,0,0.4988662131519274,0.5011337868480725
89661,0.5967741935483871,0.4464285714285714,-148,124,0.5709918983202021,0.42900810167979786,home,TOR,under,8.5,0.5238095238095238,-110,0.5011337868480725,TOR,BOS,2023 REG,8,4,5,3,7,13,1,0,1,-1,1,1,1,0,0,0,0,0,0,0.4988662131519274,0.5011337868480725
89663,0.6402877697841727,0.4,-178,150,0.6144920035194866,0.38550799648051337,away,LAA,over,9,0.5,100,0.4772727272727273,LAD,LAA,2023 REG,11,11,8,4,15,19,1,0,7,-7,1,1,1,1,0,0,0,0,0,0.4772727272727273,0.5227272727272727
89663,0.6402877697841727,0.4,-178,150,0.6144920035194866,0.38550799648051337,home,LAD,under,9,0.5454545454545454,-120,0.5227272727272727,LAD,LAA,2023 REG,11,11,8,4,15,19,1,0,7,-7,1,1,1,1,0,0,0,0,0,0.4772727272727273,0.5227272727272727
89664,0.4132231404958678,0.6254681647940076,142,-167,0.3972349978141011,0.6027650021858989,away,TEX,over,9,0.5,100,0.4772727272727273,LAA,TEX,2023 REG,12,9,6,3,12,18,1,0,6,-6,1,1,1,0,0,0,0,0,0,0.4772727272727273,0.5227272727272727
89664,0.4132231404958678,0.6254681647940076,142,-167,0.3972349978141011,0.6027650021858989,home,LAA,under,9,0.5454545454545454,-120,0.5227272727272727,LAA,TEX,2023 REG,12,9,6,3,12,18,1,0,6,-6,1,1,1,0,0,0,0,0,0,0.4772727272727273,0.5227272727272727
89665,0.48780487804878053,0.5535714285714286,105,-124,0.4676213138438005,0.5323786861561994,away,HOU,over,10,0.5348837209302326,-115,0.5097020142727117,STL,HOU,2023 REG,4,0,18,14,14,22,0,1,-14,14,0,0,0,0,0,0,0,0,0,0.5097020142727117,0.49029798572728833
89665,0.48780487804878053,0.5535714285714286,105,-124,0.4676213138438005,0.5323786861561994,home,STL,under,10,0.5121951219512195,-105,0.49029798572728833,STL,HOU,2023 REG,4,0,18,14,14,22,0,1,-14,14,0,0,0,0,0,0,0,0,0,0.5097020142727117,0.49029798572728833
89666,0.5555555555555556,0.48780487804878053,-125,105,0.5314664257753688,0.46853357422463116,away,CLE,over,7.5,0.5348837209302326,-115,0.5097020142727117,DET,CLE,2023 REG,9,5,5,2,7,14,1,0,3,-3,1,1,0,0,0,0,0,0,0,0.5097020142727117,0.49029798572728833
89666,0.5555555555555556,0.48780487804878053,-125,105,0.5314664257753688,0.46853357422463116,home,DET,under,7.5,0.5121951219512195,-105,0.49029798572728833,DET,CLE,2023 REG,9,5,5,2,7,14,1,0,3,-3,1,1,0,0,0,0,0,0,0,0.5097020142727117,0.49029798572728833
89667,0.45454545454545453,0.5867768595041323,120,-142,0.43576258452291505,0.564237415477085,away,LAD,over,7.5,0.5238095238095238,-110,0.4988662131519274,MIA,LAD,2023 REG,8,6,7,3,9,15,1,0,3,-3,1,1,1,0,0,0,0,0,0,0.4988662131519274,0.5011337868480725
89667,0.45454545454545453,0.5867768595041323,120,-142,0.43576258452291505,0.564237415477085,home,MIA,under,7.5,0.5238095238095238,-110,0.5011337868480725,MIA,LAD,2023 REG,8,6,7,3,9,15,1,0,3,-3,1,1,1,0,0,0,0,0,0,0.4988662131519274,0.5011337868480725
89668,0.6226415094339623,0.4166666666666667,-165,140,0.5981666073335706,0.40183339266642937,away,CIN,over,7.5,0.5348837209302326,-115,0.5097020142727117,SF,CIN,2023 REG,7,6,1,1,7,8,1,0,5,-5,1,0,0,0,0,0,0,0,0,0.5097020142727117,0.49029798572728833
89668,0.6226415094339623,0.4166666666666667,-165,140,0.5981666073335706,0.40183339266642937,home,SF,under,7.5,0.5121951219512195,-105,0.49029798572728833,SF,CIN,2023 REG,7,6,1,1,7,8,1,0,5,-5,1,0,0,0,0,0,0,0,0,0.5097020142727117,0.49029798572728833
89669,0.5121951219512195,0.5348837209302326,-105,-115,0.48808156828023186,0.5119184317197681,away,CLE,over,8,0.5192307692307692,-108,0.49455035168025013,DET,CLE,2023 REG,8,8,8,0,8,16,1,0,8,-8,0,0,0,0,0,0,0,0,0,0.49455035168025013,0.5054496483197499
89669,0.5121951219512195,0.5348837209302326,-105,-115,0.48808156828023186,0.5119184317197681,home,DET,under,8,0.5283018867924528,-112,0.5054496483197499,DET,CLE,2023 REG,8,8,8,0,8,16,1,0,8,-8,0,0,0,0,0,0,0,0,0,0.49455035168025013,0.5054496483197499
89670,0.5967741935483871,0.4444444444444444,-148,125,0.5721759741010521,0.42782402589894786,away,SF,over,7.5,0.5,100,0.4772727272727273,HOU,SF,2023 REG,5,2,7,4,6,12,0,1,-2,2,1,1,0,0,0,0,0,0,0,0.4772727272727273,0.5227272727272727
89670,0.5967741935483871,0.4444444444444444,-148,125,0.5721759741010521,0.42782402589894786,home,HOU,under,7.5,0.5454545454545454,-120,0.5227272727272727,HOU,SF,2023 REG,5,2,7,4,6,12,0,1,-2,2,1,1,0,0,0,0,0,0,0,0.4772727272727273,0.5227272727272727
89671,0.765807962529274,0.2777777777777778,-327,260,0.7324296555494005,0.26757034445059946,away,WSH,over,8.5,0.5121951219512195,-105,0.48919479393107135,LAA,WSH,2023 REG,5,2,1,0,2,6,1,0,2,-2,0,0,0,0,0,0,0,0,0,0.48919479393107135,0.5108052060689287
89671,0.765807962529274,0.2777777777777778,-327,260,0.7324296555494005,0.26757034445059946,home,LAA,under,8.5,0.5327102803738317,-114,0.5108052060689287,LAA,WSH,2023 REG,5,2,1,0,2,6,1,0,2,-2,0,0,0,0,0,0,0,0,0,0.48919479393107135,0.5108052060689287
89672,0.5391705069124424,0.5,-117,100,0.5180509248444435,0.4819490751555565,away,MIA,over,8,0.5348837209302326,-115,0.5109810284308424,CWS,MIA,2023 REG,7,5,10,6,11,17,0,1,-1,1,1,1,1,1,1,0,0,0,0,0.5109810284308424,0.48901897156915763
89672,0.5391705069124424,0.5,-117,100,0.5180509248444435,0.4819490751555565,home,CWS,under,8,0.5098039215686274,-104,0.48901897156915763,CWS,MIA,2023 REG,7,5,10,6,11,17,0,1,-1,1,1,1,1,1,1,0,0,0,0,0.5109810284308424,0.48901897156915763
89673,0.4081632653061224,0.6363636363636364,145,-175,0.3899890197266291,0.6100109802733709,away,SD,over,12.5,0.5169082125603864,-107,0.49239402434819424,COL,SD,2023 REG,12,5,9,8,13,21,0,1,-3,3,1,1,1,1,1,0,0,0,0,0.49239402434819424,0.5076059756518058
89673,0.4081632653061224,0.6363636363636364,145,-175,0.3899890197266291,0.6100109802733709,home,COL,under,12.5,0.5305164319248826,-113,0.5076059756518058,COL,SD,2023 REG,12,5,9,8,13,21,0,1,-3,3,1,1,1,1,1,0,0,0,0,0.49239402434819424,0.5076059756518058
89674,0.4444444444444444,0.5918367346938775,125,-145,0.42831947593852354,0.5716805240614764,away,STL,over,8.5,0.5121951219512195,-105,0.48808156828023186,WSH,STL,2023 REG,8,3,14,9,12,22,0,1,-6,6,1,1,1,0,0,0,0,0,0,0.48808156828023186,0.5119184317197681
89674,0.4444444444444444,0.5918367346938775,125,-145,0.42831947593852354,0.5716805240614764,home,WSH,under,8.5,0.5348837209302326,-115,0.5119184317197681,WSH,STL,2023 REG,8,3,14,9,12,22,0,1,-6,6,1,1,1,0,0,0,0,0,0,0.48808156828023186,0.5119184317197681
89675,0.6183206106870228,0.42372881355932196,-162,136,0.5923205850079852,0.40767941499201477,away,DET,over,8.5,0.5215311004784688,-109,0.49670754937970685,NYY,DET,2023 REG,6,3,14,10,13,20,0,1,-7,7,1,1,1,0,0,0,0,0,0,0.49670754937970685,0.5032924506202932
89675,0.6183206106870228,0.42372881355932196,-162,136,0.5923205850079852,0.40767941499201477,home,NYY,under,8.5,0.5260663507109005,-111,0.5032924506202932,NYY,DET,2023 REG,6,3,14,10,13,20,0,1,-7,7,1,1,1,0,0,0,0,0,0,0.49670754937970685,0.5032924506202932
89676,0.6226415094339623,0.4166666666666667,-165,140,0.5981666073335706,0.40183339266642937,away,CIN,over,10.5,0.5348837209302326,-115,0.5097020142727117,BOS,CIN,2023 REG,10,4,8,5,9,18,0,1,-1,1,1,1,1,1,0,0,0,0,0,0.5097020142727117,0.49029798572728833
89676,0.6226415094339623,0.4166666666666667,-165,140,0.5981666073335706,0.40183339266642937,home,BOS,under,10.5,0.5121951219512195,-105,0.49029798572728833,BOS,CIN,2023 REG,10,4,8,5,9,18,0,1,-1,1,1,1,1,1,0,0,0,0,0,0.5097020142727117,0.49029798572728833
89677,0.5780590717299579,0.4629629629629629,-137,116,0.5543459124348938,0.44565408756510616,away,CLE,over,7.5,0.5391705069124424,-117,0.5140669063204599,SF,CLE,2023 REG,12,5,9,4,9,21,1,0,1,-1,1,1,1,1,0,0,0,0,0,0.5140669063204599,0.4859330936795401
89677,0.5780590717299579,0.4629629629629629,-137,116,0.5543459124348938,0.44565408756510616,home,SF,under,7.5,0.5073891625615764,-103,0.4859330936795401,SF,CLE,2023 REG,12,5,9,4,9,21,1,0,1,-1,1,1,1,1,0,0,0,0,0,0.5140669063204599,0.4859330936795401
89678,0.5,0.5454545454545454,100,-120,0.4772727272727273,0.5227272727272727,away,TB,over,7,0.5238095238095238,-110,0.4988662131519274,MIN,TB,2023 REG,6,4,13,7,11,19,0,1,-3,3,1,1,1,1,0,0,0,0,0,0.4988662131519274,0.5011337868480725
89678,0.5,0.5454545454545454,100,-120,0.4772727272727273,0.5227272727272727,home,MIN,under,7,0.5238095238095238,-110,0.5011337868480725,MIN,TB,2023 REG,6,4,13,7,11,19,0,1,-3,3,1,1,1,1,0,0,0,0,0,0.4988662131519274,0.5011337868480725
89679,0.6875,0.35714285714285715,-220,180,0.6568080357142857,0.3431919642857143,away,WSH,over,8.5,0.5348837209302326,-115,0.5097020142727117,NYY,WSH,2023 REG,12,5,9,6,11,21,0,1,-1,1,1,1,1,1,1,0,0,0,0,0.5097020142727117,0.49029798572728833
89679,0.6875,0.35714285714285715,-220,180,0.6568080357142857,0.3431919642857143,home,NYY,under,8.5,0.5121951219512195,-105,0.49029798572728833,NYY,WSH,2023 REG,12,5,9,6,11,21,0,1,-1,1,1,1,1,1,1,0,0,0,0,0.5097020142727117,0.49029798572728833
89680,0.5454545454545454,0.49504950495049505,-120,102,0.5233614270517961,0.4766385729482039,away,SEA,over,8.5,0.5283018867924528,-112,0.5031902949311281,TEX,SEA,2023 REG,7,2,6,0,2,13,1,0,2,-2,0,0,0,0,0,0,0,0,0,0.5031902949311281,0.4968097050688719
89680,0.5454545454545454,0.49504950495049505,-120,102,0.5233614270517961,0.4766385729482039,home,TEX,under,8.5,0.5192307692307692,-108,0.4968097050688719,TEX,SEA,2023 REG,7,2,6,0,2,13,1,0,2,-2,0,0,0,0,0,0,0,0,0,0.5031902949311281,0.4968097050688719
89681,0.4166666666666667,0.6226415094339623,140,-165,0.4002882599580712,0.5997117400419287,away,MIN,over,7.5,0.5348837209302326,-115,0.5097020142727117,DET,MIN,2023 REG,8,3,8,2,5,16,1,0,1,-1,1,1,0,0,0,0,0,0,0,0.5097020142727117,0.49029798572728833
89681,0.4166666666666667,0.6226415094339623,140,-165,0.4002882599580712,0.5997117400419287,home,DET,under,7.5,0.5121951219512195,-105,0.49029798572728833,DET,MIN,2023 REG,8,3,8,2,5,16,1,0,1,-1,1,1,0,0,0,0,0,0,0,0.5097020142727117,0.49029798572728833
89682,0.5098039215686274,0.5348837209302326,-104,-115,0.4870219861770517,0.5129780138229483,away,BAL,over,10.5,0.5283018867924528,-112,0.5031902949311281,BOS,BAL,2023 REG,4,2,14,11,13,18,0,1,-9,9,1,1,0,0,0,0,0,0,0,0.5031902949311281,0.4968097050688719
89682,0.5098039215686274,0.5348837209302326,-104,-115,0.4870219861770517,0.5129780138229483,home,BOS,under,10.5,0.5192307692307692,-108,0.4968097050688719,BOS,BAL,2023 REG,4,2,14,11,13,18,0,1,-9,9,1,1,0,0,0,0,0,0,0,0.5031902949311281,0.4968097050688719
89683,0.5121951219512195,0.5348837209302326,-105,-115,0.48808156828023186,0.5119184317197681,away,NYM,over,9,0.5412844036697247,-118,0.5162581740877563,ARI,NYM,2023 REG,4,1,6,2,3,10,0,1,-1,1,1,0,0,0,0,0,0,0,0,0.5162581740877563,0.4837418259122437
89683,0.5121951219512195,0.5348837209302326,-105,-115,0.48808156828023186,0.5119184317197681,home,ARI,under,9,0.504950495049505,-102,0.4837418259122437,ARI,NYM,2023 REG,4,1,6,2,3,10,0,1,-1,1,1,0,0,0,0,0,0,0,0,0.5162581740877563,0.4837418259122437
89685,0.5833333333333333,0.4587155963302753,-140,118,0.5588047910295616,0.4411952089704384,away,MIL,over,8,0.5327102803738317,-114,0.508788710910954,TB,MIL,2023 REG,7,4,10,6,10,17,0,1,-2,2,1,1,1,1,0,0,0,0,0,0.508788710910954,0.491211289089046
89685,0.5833333333333333,0.4587155963302753,-140,118,0.5588047910295616,0.4411952089704384,home,TB,under,8,0.5121951219512195,-105,0.491211289089046,TB,MIL,2023 REG,7,4,10,6,10,17,0,1,-2,2,1,1,1,1,0,0,0,0,0,0.508788710910954,0.491211289089046
89686,0.5495495495495495,0.48780487804878053,-122,105,0.529021440689206,0.470978559310794,away,TEX,over,6.5,0.5348837209302326,-115,0.5097020142727117,CHC,TEX,2023 REG,6,2,3,0,2,9,1,0,2,-2,0,0,0,0,0,0,0,0,0,0.5097020142727117,0.49029798572728833
89686,0.5495495495495495,0.48780487804878053,-122,105,0.529021440689206,0.470978559310794,home,CHC,under,6.5,0.5121951219512195,-105,0.49029798572728833,CHC,TEX,2023 REG,6,2,3,0,2,9,1,0,2,-2,0,0,0,0,0,0,0,0,0,0.5097020142727117,0.49029798572728833
89687,0.6551724137931035,0.3846153846153846,-190,160,0.6291045458703008,0.37089545412969915,away,NYY,over,8.5,0.5238095238095238,-110,0.4988662131519274,HOU,NYY,2023 REG,9,4,8,5,9,17,0,1,-1,1,1,1,1,1,0,0,0,0,0,0.4988662131519274,0.5011337868480725
89687,0.6551724137931035,0.3846153846153846,-190,160,0.6291045458703008,0.37089545412969915,home,HOU,under,8.5,0.5238095238095238,-110,0.5011337868480725,HOU,NYY,2023 REG,9,4,8,5,9,17,0,1,-1,1,1,1,1,1,0,0,0,0,0,0.4988662131519274,0.5011337868480725
89688,0.7333333333333333,0.30864197530864196,-275,224,0.7025514403292181,0.2974485596707819,away,OAK,over,8.5,0.5348837209302326,-115,0.5122726437136835,NYY,OAK,2023 REG,10,10,10,5,15,20,1,0,5,-5,1,1,1,1,1,0,0,0,0,0.5122726437136835,0.48772735628631647
89688,0.7333333333333333,0.30864197530864196,-275,224,0.7025514403292181,0.2974485596707819,home,NYY,under,8.5,0.5073891625615764,-103,0.48772735628631647,NYY,OAK,2023 REG,10,10,10,5,15,20,1,0,5,-5,1,1,1,1,1,0,0,0,0,0.5122726437136835,0.48772735628631647
89689,0.7101449275362319,0.3278688524590164,-245,205,0.6831496344961281,0.3168503655038719,away,WSH,over,7.5,0.5283018867924528,-112,0.5056562298022652,MIN,WSH,2023 REG,6,2,6,3,5,12,0,1,-1,1,1,1,0,0,0,0,0,0,0,0.5056562298022652,0.4943437701977348
89689,0.7101449275362319,0.3278688524590164,-245,205,0.6831496344961281,0.3168503655038719,home,MIN,under,7.5,0.5145631067961165,-106,0.4943437701977348,MIN,WSH,2023 REG,6,2,6,3,5,12,0,1,-1,1,1,1,0,0,0,0,0,0,0,0.5056562298022652,0.4943437701977348
89690,0.7297297297297298,0.3115264797507788,-270,221,0.6996238471358451,0.30037615286415487,away,DET,over,7.5,0.5,100,0.4772727272727273,TB,DET,2023 REG,8,5,2,1,6,10,1,0,4,-4,1,0,0,0,0,0,0,0,0,0.4772727272727273,0.5227272727272727
89690,0.7297297297297298,0.3115264797507788,-270,221,0.6996238471358451,0.30037615286415487,home,TB,under,7.5,0.5454545454545454,-120,0.5227272727272727,TB,DET,2023 REG,8,5,2,1,6,10,1,0,4,-4,1,0,0,0,0,0,0,0,0,0.4772727272727273,0.5227272727272727
89692,0.425531914893617,0.613899613899614,135,-159,0.40875254093905067,0.5912474590609493,away,TEX,over,9,0.5,100,0.47935779816513757,DET,TEX,2023 REG,11,3,11,2,5,22,1,0,1,-1,1,1,0,0,0,0,0,0,0,0.47935779816513757,0.5206422018348624
89692,0.425531914893617,0.613899613899614,135,-159,0.40875254093905067,0.5912474590609493,home,DET,under,9,0.5412844036697247,-118,0.5206422018348624,DET,TEX,2023 REG,11,3,11,2,5,22,1,0,1,-1,1,1,0,0,0,0,0,0,0,0.47935779816513757,0.5206422018348624
89693,0.5305164319248826,0.5121951219512195,-113,-105,0.5078572507605655,0.49214274923943446,away,SF,over,9,0.5348837209302326,-115,0.5097020142727117,LAA,SF,2023 REG,12,7,5,5,12,17,1,0,2,-2,1,1,1,1,1,0,0,0,0,0.5097020142727117,0.49029798572728833
89693,0.5305164319248826,0.5121951219512195,-113,-105,0.5078572507605655,0.49214274923943446,home,LAA,under,9,0.5121951219512195,-105,0.49029798572728833,LAA,SF,2023 REG,12,7,5,5,12,17,1,0,2,-2,1,1,1,1,1,0,0,0,0,0.5097020142727117,0.49029798572728833
89694,0.6254681647940076,0.41152263374485604,-167,143,0.6023315979176397,0.3976684020823603,away,COL,over,9.5,0.5,100,0.4772727272727273,WSH,COL,2023 REG,7,6,16,10,16,23,0,1,-4,4,1,1,1,1,1,1,0,0,0,0.4772727272727273,0.5227272727272727
89694,0.6254681647940076,0.41152263374485604,-167,143,0.6023315979176397,0.3976684020823603,home,WSH,under,9.5,0.5454545454545454,-120,0.5227272727272727,WSH,COL,2023 REG,7,6,16,10,16,23,0,1,-4,4,1,1,1,1,1,1,0,0,0,0.4772727272727273,0.5227272727272727
89695,0.49019607843137253,0.5454545454545454,104,-120,0.4727202824088637,0.5272797175911363,away,MIA,over,11,0.5121951219512195,-105,0.48808156828023186,COL,MIA,2023 REG,13,7,12,6,13,25,1,0,1,-1,1,1,1,1,1,1,0,0,0,0.48808156828023186,0.5119184317197681
89695,0.49019607843137253,0.5454545454545454,104,-120,0.4727202824088637,0.5272797175911363,home,COL,under,11,0.5348837209302326,-115,0.5119184317197681,COL,MIA,2023 REG,13,7,12,6,13,25,1,0,1,-1,1,1,1,1,1,1,0,0,0,0.48808156828023186,0.5119184317197681
89696,0.4854368932038835,0.5555555555555556,106,-125,0.465537646233282,0.534462353766718,away,MIL,over,8.5,0.5348837209302326,-115,0.5097020142727117,ARI,MIL,2023 REG,4,1,8,7,8,12,0,1,-6,6,1,0,0,0,0,0,0,0,0,0.5097020142727117,0.49029798572728833
89696,0.4854368932038835,0.5555555555555556,106,-125,0.465537646233282,0.534462353766718,home,ARI,under,8.5,0.5121951219512195,-105,0.49029798572728833,ARI,MIL,2023 REG,4,1,8,7,8,12,0,1,-6,6,1,0,0,0,0,0,0,0,0,0.5097020142727117,0.49029798572728833
89697,0.5121951219512195,0.5348837209302326,-105,-115,0.48808156828023186,0.5119184317197681,away,SF,over,7.5,0.5454545454545454,-120,0.5206611570247933,ARI,SF,2023 REG,14,7,3,1,8,17,1,0,6,-6,1,0,0,0,0,0,0,0,0,0.5206611570247933,0.4793388429752067
89697,0.5121951219512195,0.5348837209302326,-105,-115,0.48808156828023186,0.5119184317197681,home,ARI,under,7.5,0.5,100,0.4793388429752067,ARI,SF,2023 REG,14,7,3,1,8,17,1,0,6,-6,1,0,0,0,0,0,0,0,0,0.5206611570247933,0.4793388429752067
89698,0.5850622406639003,0.45454545454545453,-141,120,0.5618892737571823,0.43811072624281766,away,CLE,over,8.5,0.5391705069124424,-117,0.5167097046779946,NYM,CLE,2023 REG,12,10,11,9,19,23,1,0,1,-1,1,1,1,1,1,1,1,1,1,0.5167097046779946,0.4832902953220054
89698,0.5850622406639003,0.45454545454545453,-141,120,0.5618892737571823,0.43811072624281766,home,NYM,under,8.5,0.5024875621890548,-101,0.4832902953220054,NYM,CLE,2023 REG,12,10,11,9,19,23,1,0,1,-1,1,1,1,1,1,1,1,1,1,0.5167097046779946,0.4832902953220054
89699,0.45454545454545453,0.5850622406639003,120,-141,0.4365419567230205,0.5634580432769796,away,PHI,over,11.5,0.5145631067961165,-106,0.49023796582517226,COL,PHI,2023 REG,8,4,11,7,11,19,0,1,-3,3,1,1,1,1,0,0,0,0,0,0.49023796582517226,0.5097620341748277
89699,0.45454545454545453,0.5850622406639003,120,-141,0.4365419567230205,0.5634580432769796,home,COL,under,11.5,0.5327102803738317,-114,0.5097620341748277,COL,PHI,2023 REG,8,4,11,7,11,19,0,1,-3,3,1,1,1,1,0,0,0,0,0,0.49023796582517226,0.5097620341748277
89700,0.39370078740157477,0.6491228070175439,154,-185,0.37684110455940206,0.623158895440598,away,MIN,over,8.5,0.5238095238095238,-110,0.4988662131519274,CWS,MIN,2023 REG,6,0,7,4,4,13,0,1,-4,4,0,0,0,0,0,0,0,0,0,0.4988662131519274,0.5011337868480725
89700,0.39370078740157477,0.6491228070175439,154,-185,0.37684110455940206,0.623158895440598,home,CWS,under,8.5,0.5238095238095238,-110,0.5011337868480725,CWS,MIN,2023 REG,6,0,7,4,4,13,0,1,-4,4,0,0,0,0,0,0,0,0,0,0.4988662131519274,0.5011337868480725
89701,0.5348837209302326,0.49504950495049505,-115,102,0.5188729256917038,0.48112707430829615,away,MIN,over,8,0.5121951219512195,-105,0.48808156828023186,TB,MIN,2023 REG,6,2,3,1,3,9,1,0,1,-1,1,0,0,0,0,0,0,0,0,0.48808156828023186,0.5119184317197681
89701,0.5348837209302326,0.49504950495049505,-115,102,0.5188729256917038,0.48112707430829615,home,TB,under,8,0.5348837209302326,-115,0.5119184317197681,TB,MIN,2023 REG,6,2,3,1,3,9,1,0,1,-1,1,0,0,0,0,0,0,0,0,0.48808156828023186,0.5119184317197681
89702,0.5238095238095238,0.5238095238095238,-110,-110,0.4988662131519274,0.5011337868480725,away,HOU,over,9,0.5238095238095238,-110,0.4988662131519274,MIL,HOU,2023 REG,5,4,4,0,4,9,1,0,4,-4,0,0,0,0,0,0,0,0,0,0.4988662131519274,0.5011337868480725
89702,0.5238095238095238,0.5238095238095238,-110,-110,0.4988662131519274,0.5011337868480725,home,MIL,under,9,0.5238095238095238,-110,0.5011337868480725,MIL,HOU,2023 REG,5,4,4,0,4,9,1,0,4,-4,0,0,0,0,0,0,0,0,0,0.4988662131519274,0.5011337868480725
89703,0.4629629629629629,0.5867768595041323,116,-142,0.4399352673763448,0.5600647326236552,away,SD,over,8.5,0.5238095238095238,-110,0.4988662131519274,OAK,SD,2023 REG,9,2,6,5,7,15,0,1,-3,3,1,1,0,0,0,0,0,0,0,0.4988662131519274,0.5011337868480725
89703,0.4629629629629629,0.5867768595041323,116,-142,0.4399352673763448,0.5600647326236552,home,OAK,under,8.5,0.5238095238095238,-110,0.5011337868480725,OAK,SD,2023 REG,9,2,6,5,7,15,0,1,-3,3,1,1,0,0,0,0,0,0,0,0.4988662131519274,0.5011337868480725
89704,0.42372881355932196,0.6183206106870228,136,-162,0.40591126091256574,0.5940887390874343,away,DET,over,8,0.5121951219512195,-105,0.48919479393107135,OAK,DET,2023 REG,9,8,5,2,10,14,1,0,6,-6,1,1,0,0,0,0,0,0,0,0.48919479393107135,0.5108052060689287
89704,0.42372881355932196,0.6183206106870228,136,-162,0.40591126091256574,0.5940887390874343,home,OAK,under,8,0.5327102803738317,-114,0.5108052060689287,OAK,DET,2023 REG,9,8,5,2,10,14,1,0,6,-6,1,1,0,0,0,0,0,0,0,0.48919479393107135,0.5108052060689287
89705,0.5884773662551441,0.45248868778280543,-143,121,0.5643697706690257,0.4356302293309743,away,MIA,over,8,0.5121951219512195,-105,0.48808156828023186,PHI,MIA,2023 REG,11,4,14,8,12,25,0,1,-4,4,1,1,1,1,0,0,0,0,0,0.48808156828023186,0.5119184317197681
89705,0.5884773662551441,0.45248868778280543,-143,121,0.5643697706690257,0.4356302293309743,home,PHI,under,8,0.5348837209302326,-115,0.5119184317197681,PHI,MIA,2023 REG,11,4,14,8,12,25,0,1,-4,4,1,1,1,1,0,0,0,0,0,0.48808156828023186,0.5119184317197681
89706,0.5555555555555556,0.48780487804878053,-125,105,0.5314664257753688,0.46853357422463116,away,LAD,over,9.5,0.5238095238095238,-110,0.4988662131519274,BAL,LAD,2023 REG,9,3,13,10,13,22,0,1,-7,7,1,1,1,0,0,0,0,0,0,0.4988662131519274,0.5011337868480725
89706,0.5555555555555556,0.48780487804878053,-125,105,0.5314664257753688,0.46853357422463116,home,BAL,under,9.5,0.5238095238095238,-110,0.5011337868480725,BAL,LAD,2023 REG,9,3,13,10,13,22,0,1,-7,7,1,1,1,0,0,0,0,0,0,0.4988662131519274,0.5011337868480725
89707,0.47619047619047616,0.5652173913043479,110,-130,0.4564724440500838,0.5435275559499162,away,CHC,over,9.5,0.5121951219512195,-105,0.48808156828023186,PIT,CHC,2023 REG,7,6,10,10,16,17,0,1,-4,4,1,1,1,1,1,1,0,0,0,0.48808156828023186,0.5119184317197681
89707,0.47619047619047616,0.5652173913043479,110,-130,0.4564724440500838,0.5435275559499162,home,PIT,under,9.5,0.5348837209302326,-115,0.5119184317197681,PIT,CHC,2023 REG,7,6,10,10,16,17,0,1,-4,4,1,1,1,1,1,1,0,0,0,0.48808156828023186,0.5119184317197681
89708,0.4098360655737705,0.6254681647940076,144,-167,0.39536711870173025,0.6046328812982698,away,LAD,over,8,0.5215311004784688,-109,0.49670754937970685,MIL,LAD,2023 REG,5,1,9,8,9,14,0,1,-7,7,1,0,0,0,0,0,0,0,0,0.49670754937970685,0.5032924506202932
89708,0.4098360655737705,0.6254681647940076,144,-167,0.39536711870173025,0.6046328812982698,home,MIL,under,8,0.5260663507109005,-111,0.5032924506202932,MIL,LAD,2023 REG,5,1,9,8,9,14,0,1,-7,7,1,0,0,0,0,0,0,0,0,0.49670754937970685,0.5032924506202932
89709,0.6389891696750902,0.4,-177,150,0.614075512518083,0.385924487481917,away,BOS,over,7.5,0.5,100,0.4772727272727273,TB,BOS,2023 REG,11,7,6,2,9,17,1,0,5,-5,1,1,0,0,0,0,0,0,0,0.4772727272727273,0.5227272727272727
89709,0.6389891696750902,0.4,-177,150,0.614075512518083,0.385924487481917,home,TB,under,7.5,0.5454545454545454,-120,0.5227272727272727,TB,BOS,2023 REG,11,7,6,2,9,17,1,0,5,-5,1,1,0,0,0,0,0,0,0,0.4772727272727273,0.5227272727272727
89710,0.4807692307692307,0.5575221238938054,108,-126,0.46235992564277106,0.5376400743572289,away,LAD,over,10,0.5348837209302326,-115,0.5097020142727117,BOS,LAD,2023 REG,14,4,10,7,11,24,0,1,-3,3,1,1,1,1,0,0,0,0,0,0.5097020142727117,0.49029798572728833
89710,0.4807692307692307,0.5575221238938054,108,-126,0.46235992564277106,0.5376400743572289,home,BOS,under,10,0.5121951219512195,-105,0.49029798572728833,BOS,LAD,2023 REG,14,4,10,7,11,24,0,1,-3,3,1,1,1,1,0,0,0,0,0,0.5097020142727117,0.49029798572728833
89711,0.635036496350365,0.4065040650406504,-174,146,0.6086567237881874,0.39134327621181264,away,TEX,over,8.5,0.5121951219512195,-105,0.48808156828023186,TB,TEX,2023 REG,8,8,3,3,11,11,1,0,5,-5,1,1,1,0,0,0,0,0,0,0.48808156828023186,0.5119184317197681
89711,0.635036496350365,0.4065040650406504,-174,146,0.6086567237881874,0.39134327621181264,home,TB,under,8.5,0.5348837209302326,-115,0.5119184317197681,TB,TEX,2023 REG,8,8,3,3,11,11,1,0,5,-5,1,1,1,0,0,0,0,0,0,0.48808156828023186,0.5119184317197681
89712,0.5454545454545454,0.5,-120,100,0.5206611570247933,0.4793388429752067,away,HOU,over,10.5,0.5238095238095238,-110,0.4988662131519274,BOS,HOU,2023 REG,6,2,9,6,8,15,0,1,-4,4,1,1,0,0,0,0,0,0,0,0.4988662131519274,0.5011337868480725
89712,0.5454545454545454,0.5,-120,100,0.5206611570247933,0.4793388429752067,home,BOS,under,10.5,0.5238095238095238,-110,0.5011337868480725,BOS,HOU,2023 REG,6,2,9,6,8,15,0,1,-4,4,1,1,0,0,0,0,0,0,0,0.4988662131519274,0.5011337868480725
89713,0.48780487804878053,0.5555555555555556,105,-125,0.4666534470222751,0.5333465529777248,away,PHI,over,9,0.5348837209302326,-115,0.5097020142727117,STL,PHI,2023 REG,6,1,11,6,7,17,0,1,-5,5,1,0,0,0,0,0,0,0,0,0.5097020142727117,0.49029798572728833
89713,0.48780487804878053,0.5555555555555556,105,-125,0.4666534470222751,0.5333465529777248,home,STL,under,9,0.5121951219512195,-105,0.49029798572728833,STL,PHI,2023 REG,6,1,11,6,7,17,0,1,-5,5,1,0,0,0,0,0,0,0,0,0.5097020142727117,0.49029798572728833
89714,0.45454545454545453,0.5867768595041323,120,-142,0.43576258452291505,0.564237415477085,away,TOR,over,9.5,0.5370370370370371,-116,0.5118817074154765,CIN,TOR,2023 REG,6,3,9,4,7,15,0,1,-1,1,1,1,1,0,0,0,0,0,0,0.5118817074154765,0.48811829258452355
89714,0.45454545454545453,0.5867768595041323,120,-142,0.43576258452291505,0.564237415477085,home,CIN,under,9.5,0.5098039215686274,-104,0.48811829258452355,CIN,TOR,2023 REG,6,3,9,4,7,15,0,1,-1,1,1,1,1,0,0,0,0,0,0,0.5118817074154765,0.48811829258452355
89715,0.37878787878787884,0.6610169491525424,164,-195,0.3637102924468102,0.6362897075531898,away,LAD,over,12,0.5348837209302326,-115,0.5097020142727117,COL,LAD,2023 REG,12,9,9,8,17,21,1,0,1,-1,1,1,1,1,1,1,1,1,0,0.5097020142727117,0.49029798572728833
89715,0.37878787878787884,0.6610169491525424,164,-195,0.3637102924468102,0.6362897075531898,home,COL,under,12,0.5121951219512195,-105,0.49029798572728833,COL,LAD,2023 REG,12,9,9,8,17,21,1,0,1,-1,1,1,1,1,1,1,1,1,0,0.5097020142727117,0.49029798572728833
89716,0.782608695652174,0.25641025641025644,-360,290,0.7520721244728805,0.24792787552711948,away,OAK,over,8.5,0.5348837209302326,-115,0.5097020142727117,HOU,OAK,2023 REG,5,2,4,0,2,9,1,0,2,-2,0,0,0,0,0,0,0,0,0,0.5097020142727117,0.49029798572728833
89716,0.782608695652174,0.25641025641025644,-360,290,0.7520721244728805,0.24792787552711948,home,HOU,under,8.5,0.5121951219512195,-105,0.49029798572728833,HOU,OAK,2023 REG,5,2,4,0,2,9,1,0,2,-2,0,0,0,0,0,0,0,0,0,0.5097020142727117,0.49029798572728833
89717,0.5098039215686274,0.5327102803738317,-104,-114,0.4881300146960012,0.5118699853039987,away,TB,over,8.5,0.5121951219512195,-105,0.48808156828023186,NYY,TB,2023 REG,7,2,6,5,7,13,0,1,-3,3,1,1,0,0,0,0,0,0,0,0.48808156828023186,0.5119184317197681
89717,0.5098039215686274,0.5327102803738317,-104,-114,0.4881300146960012,0.5118699853039987,home,NYY,under,8.5,0.5348837209302326,-115,0.5119184317197681,NYY,TB,2023 REG,7,2,6,5,7,13,0,1,-3,3,1,1,0,0,0,0,0,0,0,0.48808156828023186,0.5119184317197681
89718,0.5726495726495727,0.46511627906976744,-134,115,0.5510229738017454,0.44897702619825464,away,SF,over,7.5,0.5238095238095238,-110,0.4988662131519274,CWS,SF,2023 REG,13,7,4,3,10,17,1,0,4,-4,1,1,1,0,0,0,0,0,0,0.4988662131519274,0.5011337868480725
89718,0.5726495726495727,0.46511627906976744,-134,115,0.5510229738017454,0.44897702619825464,home,CWS,under,7.5,0.5238095238095238,-110,0.5011337868480725,CWS,SF,2023 REG,13,7,4,3,10,17,1,0,4,-4,1,1,1,0,0,0,0,0,0,0.4988662131519274,0.5011337868480725
89719,0.696969696969697,0.3389830508474576,-230,195,0.6719117212183469,0.32808827878165314,away,KC,over,9,0.5348837209302326,-115,0.5097020142727117,SD,KC,2023 REG,5,4,2,0,4,7,1,0,4,-4,0,0,0,0,0,0,0,0,0,0.5097020142727117,0.49029798572728833
89719,0.696969696969697,0.3389830508474576,-230,195,0.6719117212183469,0.32808827878165314,home,SD,under,9,0.5121951219512195,-105,0.49029798572728833,SD,KC,2023 REG,5,4,2,0,4,7,1,0,4,-4,0,0,0,0,0,0,0,0,0,0.5097020142727117,0.49029798572728833
89720,0.5283018867924528,0.5192307692307692,-112,-108,0.5031902949311281,0.4968097050688719,away,MIL,over,9,0.5121951219512195,-105,0.48808156828023186,NYY,MIL,2023 REG,3,2,16,8,10,19,0,1,-6,6,1,1,0,0,0,0,0,0,0,0.48808156828023186,0.5119184317197681
89720,0.5283018867924528,0.5192307692307692,-112,-108,0.5031902949311281,0.4968097050688719,home,NYY,under,9,0.5348837209302326,-115,0.5119184317197681,NYY,MIL,2023 REG,3,2,16,8,10,19,0,1,-6,6,1,1,0,0,0,0,0,0,0,0.48808156828023186,0.5119184317197681
89721,0.4504504504504505,0.5918367346938775,122,-145,0.43140216885390636,0.5685978311460936,away,STL,over,10.5,0.5348837209302326,-115,0.5097020142727117,CIN,STL,2023 REG,9,5,12,8,13,21,0,1,-3,3,1,1,1,1,1,0,0,0,0,0.5097020142727117,0.49029798572728833
89721,0.4504504504504505,0.5918367346938775,122,-145,0.43140216885390636,0.5685978311460936,home,CIN,under,10.5,0.5121951219512195,-105,0.49029798572728833,CIN,STL,2023 REG,9,5,12,8,13,21,0,1,-3,3,1,1,1,1,1,0,0,0,0,0.5097020142727117,0.49029798572728833
89722,0.5652173913043479,0.47619047619047616,-130,110,0.5418129444594474,0.4581870555405526,away,NYM,over,9.5,0.5121951219512195,-105,0.48919479393107135,ATL,NYM,2023 REG,14,7,6,5,12,20,1,0,2,-2,1,1,1,1,1,0,0,0,0,0.48919479393107135,0.5108052060689287
89722,0.5652173913043479,0.47619047619047616,-130,110,0.5418129444594474,0.4581870555405526,home,ATL,under,9.5,0.5327102803738317,-114,0.5108052060689287,ATL,NYM,2023 REG,14,7,6,5,12,20,1,0,2,-2,1,1,1,1,1,0,0,0,0,0.48919479393107135,0.5108052060689287
89723,0.6644295302013422,0.37735849056603776,-198,165,0.636664335194828,0.363335664805172,away,STL,over,9,0.5495495495495495,-122,0.5250401592387142,BAL,STL,2023 REG,3,0,4,1,1,7,0,1,-1,1,0,0,0,0,0,0,0,0,0,0.5250401592387142,0.47495984076128583
89723,0.6644295302013422,0.37735849056603776,-198,165,0.636664335194828,0.363335664805172,home,BAL,under,9,0.49504950495049505,102,0.47495984076128583,BAL,STL,2023 REG,3,0,4,1,1,7,0,1,-1,1,0,0,0,0,0,0,0,0,0,0.5250401592387142,0.47495984076128583
89724,0.574468085106383,0.46511627906976744,-135,115,0.5517281312179562,0.44827186878204384,away,NYY,over,7.5,0.5121951219512195,-105,0.48808156828023186,SEA,NYY,2023 REG,7,4,18,10,14,25,0,1,-6,6,1,1,1,1,0,0,0,0,0,0.48808156828023186,0.5119184317197681
89724,0.574468085106383,0.46511627906976744,-135,115,0.5517281312179562,0.44827186878204384,home,SEA,under,7.5,0.5348837209302326,-115,0.5119184317197681,SEA,NYY,2023 REG,7,4,18,10,14,25,0,1,-6,6,1,1,1,1,0,0,0,0,0,0.48808156828023186,0.5119184317197681
89725,0.390625,0.6503496503496503,156,-186,0.3746192772071678,0.6253807227928322,away,CHC,over,12,0.5238095238095238,-110,0.4988662131519274,COL,CHC,2023 REG,9,6,10,4,10,19,1,0,2,-2,1,1,1,1,0,0,0,0,0,0.4988662131519274,0.5011337868480725
89725,0.390625,0.6503496503496503,156,-186,0.3746192772071678,0.6253807227928322,home,COL,under,12,0.5238095238095238,-110,0.5011337868480725,COL,CHC,2023 REG,9,6,10,4,10,19,1,0,2,-2,1,1,1,1,0,0,0,0,0,0.4988662131519274,0.5011337868480725
89726,0.6153846153846154,0.42016806722689076,-160,138,0.5935060414698423,0.4064939585301577,away,MIL,over,9,0.5391705069124424,-117,0.5153817639191344,TOR,MIL,2023 REG,14,7,4,2,9,18,1,0,5,-5,1,1,0,0,0,0,0,0,0,0.5153817639191344,0.4846182360808656
89726,0.6153846153846154,0.42016806722689076,-160,138,0.5935060414698423,0.4064939585301577,home,TOR,under,9,0.504950495049505,-102,0.4846182360808656,TOR,MIL,2023 REG,14,7,4,2,9,18,1,0,5,-5,1,1,0,0,0,0,0,0,0,0.5153817639191344,0.4846182360808656
89727,0.5454545454545454,0.49751243781094534,-120,101,0.5220180091279142,0.4779819908720858,away,SF,over,7,0.5495495495495495,-122,0.5250401592387142,MIA,SF,2023 REG,9,4,7,3,7,16,1,0,1,-1,1,1,1,0,0,0,0,0,0,0.5250401592387142,0.47495984076128583
89727,0.5454545454545454,0.49751243781094534,-120,101,0.5220180091279142,0.4779819908720858,home,MIA,under,7,0.49504950495049505,102,0.47495984076128583,MIA,SF,2023 REG,9,4,7,3,7,16,1,0,1,-1,1,1,1,0,0,0,0,0,0,0.5250401592387142,0.47495984076128583
89728,0.574468085106383,0.4672897196261683,-135,114,0.550479558983428,0.44952044101657196,away,CIN,over,9,0.5238095238095238,-110,0.4988662131519274,NYM,CIN,2023 REG,13,8,9,4,12,22,1,0,4,-4,1,1,1,1,0,0,0,0,0,0.4988662131519274,0.5011337868480725
89728,0.574468085106383,0.4672897196261683,-135,114,0.550479558983428,0.44952044101657196,home,NYM,under,9,0.5238095238095238,-110,0.5011337868480725,NYM,CIN,2023 REG,13,8,9,4,12,22,1,0,4,-4,1,1,1,1,0,0,0,0,0,0.4988662131519274,0.5011337868480725
89729,0.31746031746031744,0.7142857142857143,215,-250,0.30738221214411693,0.692617787855883,away,ATL,over,8,0.5391705069124424,-117,0.5153817639191344,DET,ATL,2023 REG,15,7,11,10,17,26,0,1,-3,3,1,1,1,1,1,1,1,0,0,0.5153817639191344,0.4846182360808656
89729,0.31746031746031744,0.7142857142857143,215,-250,0.30738221214411693,0.692617787855883,home,DET,under,8,0.504950495049505,-102,0.4846182360808656,DET,ATL,2023 REG,15,7,11,10,17,26,0,1,-3,3,1,1,1,1,1,1,1,0,0,0.5153817639191344,0.4846182360808656
89730,0.3921568627450981,0.6453900709219857,155,-182,0.37743257503251615,0.6225674249674839,away,ATL,over,8,0.5454545454545454,-120,0.5206611570247933,SF,ATL,2023 REG,8,3,9,7,10,17,0,1,-4,4,1,1,1,0,0,0,0,0,0,0.5206611570247933,0.4793388429752067
89730,0.3921568627450981,0.6453900709219857,155,-182,0.37743257503251615,0.6225674249674839,home,SF,under,8,0.5,100,0.4793388429752067,SF,ATL,2023 REG,8,3,9,7,10,17,0,1,-4,4,1,1,1,0,0,0,0,0,0,0.5206611570247933,0.4793388429752067
89731,0.45454545454545453,0.5833333333333333,120,-140,0.43732782369146006,0.5626721763085399,away,MIN,over,8.5,0.5454545454545454,-120,0.5206611570247933,STL,MIN,2023 REG,8,3,7,5,8,15,0,1,-2,2,1,1,1,0,0,0,0,0,0,0.5206611570247933,0.4793388429752067
89731,0.45454545454545453,0.5833333333333333,120,-140,0.43732782369146006,0.5626721763085399,home,STL,under,8.5,0.5,100,0.4793388429752067,STL,MIN,2023 REG,8,3,7,5,8,15,0,1,-2,2,1,1,1,0,0,0,0,0,0,0.5206611570247933,0.4793388429752067
89732,0.6415770609318996,0.39840637450199207,-179,151,0.615924605940263,0.384075394059737,away,OAK,over,9,0.5454545454545454,-120,0.5193043049216726,LAA,OAK,2023 REG,10,5,6,3,8,16,1,0,2,-2,1,1,1,0,0,0,0,0,0,0.5193043049216726,0.48069569507832743
89732,0.6415770609318996,0.39840637450199207,-179,151,0.615924605940263,0.384075394059737,home,LAA,under,9,0.5024875621890548,-101,0.48069569507832743,LAA,OAK,2023 REG,10,5,6,3,8,16,1,0,2,-2,1,1,1,0,0,0,0,0,0,0.5193043049216726,0.48069569507832743
89733,0.607843137254902,0.4347826086956522,-155,130,0.5819333701084867,0.41806662989151333,away,MIL,over,8.5,0.5348837209302326,-115,0.5097020142727117,NYM,MIL,2023 REG,7,2,9,5,7,16,0,1,-3,3,1,1,0,0,0,0,0,0,0,0.5097020142727117,0.49029798572728833
89733,0.607843137254902,0.4347826086956522,-155,130,0.5819333701084867,0.41806662989151333,home,NYM,under,8.5,0.5121951219512195,-105,0.49029798572728833,NYM,MIL,2023 REG,7,2,9,5,7,16,0,1,-3,3,1,1,0,0,0,0,0,0,0,0.5097020142727117,0.49029798572728833
89734,0.5652173913043479,0.47619047619047616,-130,110,0.5418129444594474,0.4581870555405526,away,CIN,over,10,0.5121951219512195,-105,0.48919479393107135,WSH,CIN,2023 REG,8,4,6,5,9,14,0,1,-1,1,1,1,1,1,0,0,0,0,0,0.48919479393107135,0.5108052060689287
89734,0.5652173913043479,0.47619047619047616,-130,110,0.5418129444594474,0.4581870555405526,home,WSH,under,10,0.5327102803738317,-114,0.5108052060689287,WSH,CIN,2023 REG,8,4,6,5,9,14,0,1,-1,1,1,1,1,1,0,0,0,0,0,0.48919479393107135,0.5108052060689287
89735,0.5121951219512195,0.5348837209302326,-105,-115,0.48808156828023186,0.5119184317197681,away,STL,over,10,0.5121951219512195,-105,0.48808156828023186,BOS,STL,2023 REG,5,1,14,9,10,19,0,1,-8,8,1,0,0,0,0,0,0,0,0,0.48808156828023186,0.5119184317197681
89735,0.5121951219512195,0.5348837209302326,-105,-115,0.48808156828023186,0.5119184317197681,home,BOS,under,10,0.5348837209302326,-115,0.5119184317197681,BOS,STL,2023 REG,5,1,14,9,10,19,0,1,-8,8,1,0,0,0,0,0,0,0,0,0.48808156828023186,0.5119184317197681
89737,0.45454545454545453,0.5798319327731092,120,-138,0.4389193694006528,0.5610806305993472,away,MIN,over,9,0.5,100,0.4772727272727273,BOS,MIN,2023 REG,7,4,9,10,14,16,0,1,-6,6,1,1,1,1,0,0,0,0,0,0.4772727272727273,0.5227272727272727
89737,0.45454545454545453,0.5798319327731092,120,-138,0.4389193694006528,0.5610806305993472,home,BOS,under,9,0.5454545454545454,-120,0.5227272727272727,BOS,MIN,2023 REG,7,4,9,10,14,16,0,1,-6,6,1,1,1,1,0,0,0,0,0,0.4772727272727273,0.5227272727272727
89738,0.4464285714285714,0.5967741935483871,124,-148,0.42714162277814344,0.5728583772218565,away,SD,over,9,0.5121951219512195,-105,0.48808156828023186,ARI,SD,2023 REG,10,5,11,4,9,21,1,0,1,-1,1,1,1,1,0,0,0,0,0,0.48808156828023186,0.5119184317197681
89738,0.4464285714285714,0.5967741935483871,124,-148,0.42714162277814344,0.5728583772218565,home,ARI,under,9,0.5348837209302326,-115,0.5119184317197681,ARI,SD,2023 REG,10,5,11,4,9,21,1,0,1,-1,1,1,1,1,0,0,0,0,0,0.48808156828023186,0.5119184317197681
89739,0.6363636363636364,0.4081632653061224,-175,145,0.6080283353010626,0.3919716646989374,away,LAA,over,9.5,0.5145631067961165,-106,0.49023796582517226,HOU,LAA,2023 REG,13,11,5,3,14,18,1,0,8,-8,1,1,1,0,0,0,0,0,0,0.49023796582517226,0.5097620341748277
89739,0.6363636363636364,0.4081632653061224,-175,145,0.6080283353010626,0.3919716646989374,home,HOU,under,9.5,0.5327102803738317,-114,0.5097620341748277,HOU,LAA,2023 REG,13,11,5,3,14,18,1,0,8,-8,1,1,1,0,0,0,0,0,0,0.49023796582517226,0.5097620341748277
89740,0.607843137254902,0.4347826086956522,-155,130,0.5819333701084867,0.41806662989151333,away,SD,over,8.5,0.5238095238095238,-110,0.4988662131519274,LAD,SD,2023 REG,8,4,5,2,6,13,1,0,2,-2,1,1,0,0,0,0,0,0,0,0.4988662131519274,0.5011337868480725
89740,0.607843137254902,0.4347826086956522,-155,130,0.5819333701084867,0.41806662989151333,home,LAD,under,8.5,0.5238095238095238,-110,0.5011337868480725,LAD,SD,2023 REG,8,4,5,2,6,13,1,0,2,-2,1,1,0,0,0,0,0,0,0,0.4988662131519274,0.5011337868480725
89741,0.5689655172413793,0.4716981132075471,-132,112,0.5458293137100936,0.4541706862899064,away,BAL,over,7.5,0.5238095238095238,-110,0.4988662131519274,CWS,BAL,2023 REG,7,4,12,8,12,19,0,1,-4,4,1,1,1,1,0,0,0,0,0,0.4988662131519274,0.5011337868480725
89741,0.5689655172413793,0.4716981132075471,-132,112,0.5458293137100936,0.4541706862899064,home,CWS,under,7.5,0.5238095238095238,-110,0.5011337868480725,CWS,BAL,2023 REG,7,4,12,8,12,19,0,1,-4,4,1,1,1,1,0,0,0,0,0,0.4988662131519274,0.5011337868480725
89742,0.647887323943662,0.3921568627450981,-184,155,0.6219432029903809,0.37805679700961914,away,MIL,over,8,0.5121951219512195,-105,0.48808156828023186,TOR,MIL,2023 REG,9,3,6,1,4,15,1,0,2,-2,1,0,0,0,0,0,0,0,0,0.48808156828023186,0.5119184317197681
89742,0.647887323943662,0.3921568627450981,-184,155,0.6219432029903809,0.37805679700961914,home,TOR,under,8,0.5348837209302326,-115,0.5119184317197681,TOR,MIL,2023 REG,9,3,6,1,4,15,1,0,2,-2,1,0,0,0,0,0,0,0,0,0.48808156828023186,0.5119184317197681
89743,0.6363636363636364,0.39370078740157477,-175,154,0.6172317303312292,0.38276826966877076,away,BAL,over,8,0.5121951219512195,-105,0.48808156828023186,TB,BAL,2023 REG,9,3,6,4,7,15,0,1,-1,1,1,1,1,0,0,0,0,0,0,0.48808156828023186,0.5119184317197681
89743,0.6363636363636364,0.39370078740157477,-175,154,0.6172317303312292,0.38276826966877076,home,TB,under,8,0.5348837209302326,-115,0.5119184317197681,TB,BAL,2023 REG,9,3,6,4,7,15,0,1,-1,1,1,1,1,0,0,0,0,0,0,0.48808156828023186,0.5119184317197681
89744,0.5535714285714286,0.4854368932038835,-124,106,0.5319775361600951,0.46802246383990487,away,ARI,over,8.5,0.5238095238095238,-110,0.5000596729920038,MIA,ARI,2023 REG,9,3,6,2,5,15,1,0,1,-1,1,1,0,0,0,0,0,0,0,0.5000596729920038,0.4999403270079962
89744,0.5535714285714286,0.4854368932038835,-124,106,0.5319775361600951,0.46802246383990487,home,MIA,under,8.5,0.5215311004784688,-109,0.4999403270079962,MIA,ARI,2023 REG,9,3,6,2,5,15,1,0,1,-1,1,1,0,0,0,0,0,0,0,0.5000596729920038,0.4999403270079962
89745,0.7142857142857143,0.3278688524590164,-250,205,0.6841753094680495,0.3158246905319505,away,COL,over,8.5,0.5327102803738317,-114,0.5075272610403079,ARI,COL,2023 REG,6,4,5,2,6,11,1,0,2,-2,1,1,0,0,0,0,0,0,0,0.5075272610403079,0.4924727389596921
89745,0.7142857142857143,0.3278688524590164,-250,205,0.6841753094680495,0.3158246905319505,home,ARI,under,8.5,0.5145631067961165,-106,0.4924727389596921,ARI,COL,2023 REG,6,4,5,2,6,11,1,0,2,-2,1,1,0,0,0,0,0,0,0,0.5075272610403079,0.4924727389596921
89746,0.5652173913043479,0.47619047619047616,-130,110,0.5418129444594474,0.4581870555405526,away,TEX,over,8,0.5348837209302326,-115,0.5097020142727117,SF,TEX,2023 REG,10,3,8,2,5,18,1,0,1,-1,1,1,0,0,0,0,0,0,0,0.5097020142727117,0.49029798572728833
89746,0.5652173913043479,0.47619047619047616,-130,110,0.5418129444594474,0.4581870555405526,home,SF,under,8,0.5121951219512195,-105,0.49029798572728833,SF,TEX,2023 REG,10,3,8,2,5,18,1,0,1,-1,1,1,0,0,0,0,0,0,0,0.5097020142727117,0.49029798572728833
89747,0.635036496350365,0.4,-174,150,0.6127870424636368,0.3872129575363632,away,BOS,over,9,0.5348837209302326,-115,0.5097020142727117,SD,BOS,2023 REG,6,7,7,0,7,13,1,0,7,-7,0,0,0,0,0,0,0,0,0,0.5097020142727117,0.49029798572728833
89747,0.635036496350365,0.4,-174,150,0.6127870424636368,0.3872129575363632,home,SD,under,9,0.5121951219512195,-105,0.49029798572728833,SD,BOS,2023 REG,6,7,7,0,7,13,1,0,7,-7,0,0,0,0,0,0,0,0,0,0.5097020142727117,0.49029798572728833
89748,0.6031746031746031,0.4329004329004329,-152,131,0.5814150576055337,0.4185849423944663,away,STL,over,8,0.5348837209302326,-115,0.5109810284308424,LAD,STL,2023 REG,5,1,3,0,1,8,1,0,1,-1,0,0,0,0,0,0,0,0,0,0.5109810284308424,0.48901897156915763
89748,0.6031746031746031,0.4329004329004329,-152,131,0.5814150576055337,0.4185849423944663,home,LAD,under,8,0.5098039215686274,-104,0.48901897156915763,LAD,STL,2023 REG,5,1,3,0,1,8,1,0,1,-1,0,0,0,0,0,0,0,0,0,0.5109810284308424,0.48901897156915763
89749,0.36363636363636365,0.6774193548387096,175,-210,0.3487070114636097,0.6512929885363903,away,LAD,over,12.5,0.5283018867924528,-112,0.5044173060022736,COL,LAD,2023 REG,7,2,12,8,10,19,0,1,-6,6,1,1,0,0,0,0,0,0,0,0.5044173060022736,0.49558269399772636
89749,0.36363636363636365,0.6774193548387096,175,-210,0.3487070114636097,0.6512929885363903,home,COL,under,12.5,0.5169082125603864,-107,0.49558269399772636,COL,LAD,2023 REG,7,2,12,8,10,19,0,1,-6,6,1,1,0,0,0,0,0,0,0,0.5044173060022736,0.49558269399772636
89750,0.607843137254902,0.43103448275862066,-155,132,0.5842116427368785,0.41578835726312147,away,CHC,over,9.5,0.504950495049505,-102,0.47949844489399435,STL,CHC,2023 REG,7,2,8,3,5,15,0,1,-1,1,1,1,0,0,0,0,0,0,0,0.47949844489399435,0.5205015551060057
89750,0.607843137254902,0.43103448275862066,-155,132,0.5842116427368785,0.41578835726312147,home,STL,under,9.5,0.5454545454545454,-120,0.5205015551060057,STL,CHC,2023 REG,7,2,8,3,5,15,0,1,-1,1,1,1,0,0,0,0,0,0,0,0.47949844489399435,0.5205015551060057
89751,0.5833333333333333,0.45454545454545453,-140,120,0.5612373737373737,0.4387626262626263,away,BOS,over,8,0.5215311004784688,-109,0.4978845547971712,SF,BOS,2023 REG,6,2,8,3,5,14,0,1,-1,1,1,1,0,0,0,0,0,0,0,0.4978845547971712,0.5021154452028288
89751,0.5833333333333333,0.45454545454545453,-140,120,0.5612373737373737,0.4387626262626263,home,SF,under,8,0.5238095238095238,-110,0.5021154452028288,SF,BOS,2023 REG,6,2,8,3,5,14,0,1,-1,1,1,1,0,0,0,0,0,0,0,0.4978845547971712,0.5021154452028288
89752,0.7481108312342569,0.29239766081871343,-297,242,0.717805989572463,0.282194010427537,away,KC,over,8,0.5121951219512195,-105,0.48919479393107135,TEX,KC,2023 REG,10,8,11,5,13,21,1,0,3,-3,1,1,1,1,1,0,0,0,0,0.48919479393107135,0.5108052060689287
89752,0.7481108312342569,0.29239766081871343,-297,242,0.717805989572463,0.282194010427537,home,TEX,under,8,0.5327102803738317,-114,0.5108052060689287,TEX,KC,2023 REG,10,8,11,5,13,21,1,0,3,-3,1,1,1,1,1,0,0,0,0,0.48919479393107135,0.5108052060689287
89753,0.37037037037037035,0.6721311475409836,170,-205,0.35462906744023925,0.6453709325597607,away,SEA,over,9,0.5454545454545454,-120,0.5206611570247933,KC,SEA,2023 REG,10,5,12,6,11,22,0,1,-1,1,1,1,1,1,1,0,0,0,0,0.5206611570247933,0.4793388429752067
89753,0.37037037037037035,0.6721311475409836,170,-205,0.35462906744023925,0.6453709325597607,home,KC,under,9,0.5,100,0.4793388429752067,KC,SEA,2023 REG,10,5,12,6,11,22,0,1,-1,1,1,1,1,1,1,0,0,0,0,0.5206611570247933,0.4793388429752067
89754,0.6047430830039526,0.4347826086956522,-153,130,0.5808401943476698,0.41915980565233024,away,PIT,over,9,0.5,100,0.4772727272727273,BOS,PIT,2023 REG,4,1,5,4,5,9,0,1,-3,3,1,0,0,0,0,0,0,0,0,0.4772727272727273,0.5227272727272727
89754,0.6047430830039526,0.4347826086956522,-153,130,0.5808401943476698,0.41915980565233024,home,BOS,under,9,0.5454545454545454,-120,0.5227272727272727,BOS,PIT,2023 REG,4,1,5,4,5,9,0,1,-3,3,1,0,0,0,0,0,0,0,0,0.4772727272727273,0.5227272727272727
89755,0.6226415094339623,0.4166666666666667,-165,140,0.5981666073335706,0.40183339266642937,away,WSH,over,10.5,0.5348837209302326,-115,0.5097020142727117,CIN,WSH,2023 REG,7,3,10,6,9,17,0,1,-3,3,1,1,1,0,0,0,0,0,0,0.5097020142727117,0.49029798572728833
89755,0.6226415094339623,0.4166666666666667,-165,140,0.5981666073335706,0.40183339266642937,home,CIN,under,10.5,0.5121951219512195,-105,0.49029798572728833,CIN,WSH,2023 REG,7,3,10,6,9,17,0,1,-3,3,1,1,1,0,0,0,0,0,0,0.5097020142727117,0.49029798572728833
89756,0.6402877697841727,0.4,-178,150,0.6144920035194866,0.38550799648051337,away,CIN,over,8.5,0.5412844036697247,-118,0.5175913212324037,ARI,CIN,2023 REG,10,3,3,2,5,13,1,0,1,-1,1,1,0,0,0,0,0,0,0,0.5175913212324037,0.4824086787675963
89756,0.6402877697841727,0.4,-178,150,0.6144920035194866,0.38550799648051337,home,ARI,under,8.5,0.5024875621890548,-101,0.4824086787675963,ARI,CIN,2023 REG,10,3,3,2,5,13,1,0,1,-1,1,1,0,0,0,0,0,0,0,0.5175913212324037,0.4824086787675963
89757,0.4672897196261683,0.5652173913043479,114,-130,0.45209948087359064,0.5479005191264094,away,ATL,over,9,0.5348837209302326,-115,0.5097020142727117,KC,ATL,2023 REG,7,3,11,10,13,18,0,1,-7,7,1,1,1,0,0,0,0,0,0,0.5097020142727117,0.49029798572728833
89757,0.4672897196261683,0.5652173913043479,114,-130,0.45209948087359064,0.5479005191264094,home,KC,under,9,0.5121951219512195,-105,0.49029798572728833,KC,ATL,2023 REG,7,3,11,10,13,18,0,1,-7,7,1,1,1,0,0,0,0,0,0,0.5097020142727117,0.49029798572728833
89758,0.4629629629629629,0.5833333333333333,116,-140,0.44152949245541834,0.5584705075445817,away,DET,over,7.5,0.5433789954337899,-119,0.5171177654451503,OAK,DET,2023 REG,7,0,11,2,2,18,0,1,-2,2,0,0,0,0,0,0,0,0,0,0.5171177654451503,0.4828822345548497
89758,0.4629629629629629,0.5833333333333333,116,-140,0.44152949245541834,0.5584705075445817,home,OAK,under,7.5,0.504950495049505,-102,0.4828822345548497,OAK,DET,2023 REG,7,0,11,2,2,18,0,1,-2,2,0,0,0,0,0,0,0,0,0,0.5171177654451503,0.4828822345548497
89759,0.4,0.6376811594202898,150,-176,0.384927536231884,0.615072463768116,away,MIN,over,9,0.5,100,0.4772727272727273,CWS,MIN,2023 REG,7,2,14,10,12,21,0,1,-8,8,1,1,0,0,0,0,0,0,0,0.4772727272727273,0.5227272727272727
89759,0.4,0.6376811594202898,150,-176,0.384927536231884,0.615072463768116,home,CWS,under,9,0.5454545454545454,-120,0.5227272727272727,CWS,MIN,2023 REG,7,2,14,10,12,21,0,1,-8,8,1,1,0,0,0,0,0,0,0,0.4772727272727273,0.5227272727272727
89760,0.6254681647940076,0.4098360655737705,-167,144,0.6033864926164085,0.39661350738359147,away,NYM,over,10.5,0.5238095238095238,-110,0.4988662131519274,ATL,NYM,2023 REG,10,6,4,4,10,14,1,0,2,-2,1,1,1,1,0,0,0,0,0,0.4988662131519274,0.5011337868480725
89760,0.6254681647940076,0.4098360655737705,-167,144,0.6033864926164085,0.39661350738359147,home,ATL,under,10.5,0.5238095238095238,-110,0.5011337868480725,ATL,NYM,2023 REG,10,6,4,4,10,14,1,0,2,-2,1,1,1,1,0,0,0,0,0,0.4988662131519274,0.5011337868480725
89761,0.5391705069124424,0.5,-117,100,0.5180509248444435,0.4819490751555565,away,TB,over,8.5,0.5238095238095238,-110,0.4988662131519274,NYY,TB,2023 REG,4,2,11,8,10,15,0,1,-6,6,1,1,0,0,0,0,0,0,0,0.4988662131519274,0.5011337868480725
89761,0.5391705069124424,0.5,-117,100,0.5180509248444435,0.4819490751555565,home,NYY,under,8.5,0.5238095238095238,-110,0.5011337868480725,NYY,TB,2023 REG,4,2,11,8,10,15,0,1,-6,6,1,1,0,0,0,0,0,0,0,0.4988662131519274,0.5011337868480725
89762,0.6254681647940076,0.41152263374485604,-167,143,0.6023315979176397,0.3976684020823603,away,CIN,over,8.5,0.5238095238095238,-110,0.5000596729920038,HOU,CIN,2023 REG,6,1,5,2,3,11,0,1,-1,1,1,0,0,0,0,0,0,0,0,0.5000596729920038,0.4999403270079962
89762,0.6254681647940076,0.41152263374485604,-167,143,0.6023315979176397,0.3976684020823603,home,HOU,under,8.5,0.5215311004784688,-109,0.4999403270079962,HOU,CIN,2023 REG,6,1,5,2,3,11,0,1,-1,1,1,0,0,0,0,0,0,0,0,0.5000596729920038,0.4999403270079962
89763,0.6031746031746031,0.4347826086956522,-152,130,0.5802797769671475,0.4197202230328525,away,TEX,over,9,0.5348837209302326,-115,0.5097020142727117,BAL,TEX,2023 REG,7,3,7,2,5,14,1,0,1,-1,1,1,0,0,0,0,0,0,0,0.5097020142727117,0.49029798572728833
89763,0.6031746031746031,0.4347826086956522,-152,130,0.5802797769671475,0.4197202230328525,home,BAL,under,9,0.5121951219512195,-105,0.49029798572728833,BAL,TEX,2023 REG,7,3,7,2,5,14,1,0,1,-1,1,1,0,0,0,0,0,0,0,0.5097020142727117,0.49029798572728833
89764,0.37037037037037035,0.6721311475409836,170,-205,0.35462906744023925,0.6453709325597607,away,NYM,over,11.5,0.5121951219512195,-105,0.48919479393107135,COL,NYM,2023 REG,14,10,12,7,17,26,1,0,3,-3,1,1,1,1,1,1,1,0,0,0.48919479393107135,0.5108052060689287
89764,0.37037037037037035,0.6721311475409836,170,-205,0.35462906744023925,0.6453709325597607,home,COL,under,11.5,0.5327102803738317,-114,0.5108052060689287,COL,NYM,2023 REG,14,10,12,7,17,26,1,0,3,-3,1,1,1,1,1,1,1,0,0,0.48919479393107135,0.5108052060689287
89765,0.6296296296296295,0.4081632653061224,-170,145,0.6058341031886005,0.39416589681139946,away,BAL,over,8,0.5238095238095238,-110,0.4988662131519274,NYY,BAL,2023 REG,11,6,7,5,11,18,1,0,1,-1,1,1,1,1,1,0,0,0,0,0.4988662131519274,0.5011337868480725
89765,0.6296296296296295,0.4081632653061224,-170,145,0.6058341031886005,0.39416589681139946,home,NYY,under,8,0.5238095238095238,-110,0.5011337868480725,NYY,BAL,2023 REG,11,6,7,5,11,18,1,0,1,-1,1,1,1,1,1,0,0,0,0,0.4988662131519274,0.5011337868480725
89766,0.75,0.2898550724637681,-300,245,0.720108695652174,0.27989130434782605,away,OAK,over,9,0.5121951219512195,-105,0.48919479393107135,HOU,OAK,2023 REG,7,3,7,2,5,14,1,0,1,-1,1,1,0,0,0,0,0,0,0,0.48919479393107135,0.5108052060689287
89766,0.75,0.2898550724637681,-300,245,0.720108695652174,0.27989130434782605,home,HOU,under,9,0.5327102803738317,-114,0.5108052060689287,HOU,OAK,2023 REG,7,3,7,2,5,14,1,0,1,-1,1,1,0,0,0,0,0,0,0,0.48919479393107135,0.5108052060689287
89767,0.6923076923076923,0.34602076124567477,-225,189,0.6657726090784382,0.33422739092156184,away,COL,over,9,0.5454545454545454,-120,0.5206611570247933,PHI,COL,2023 REG,6,0,7,5,5,13,0,1,-5,5,0,0,0,0,0,0,0,0,0,0.5206611570247933,0.4793388429752067
89767,0.6923076923076923,0.34602076124567477,-225,189,0.6657726090784382,0.33422739092156184,home,PHI,under,9,0.5,100,0.4793388429752067,PHI,COL,2023 REG,6,0,7,5,5,13,0,1,-5,5,0,0,0,0,0,0,0,0,0,0.5206611570247933,0.4793388429752067
89768,0.6031746031746031,0.4347826086956522,-152,130,0.5802797769671475,0.4197202230328525,away,CIN,over,8,0.5145631067961165,-106,0.49023796582517226,MIL,CIN,2023 REG,10,3,6,4,7,16,0,1,-1,1,1,1,1,0,0,0,0,0,0,0.49023796582517226,0.5097620341748277
89768,0.6031746031746031,0.4347826086956522,-152,130,0.5802797769671475,0.4197202230328525,home,MIL,under,8,0.5327102803738317,-114,0.5097620341748277,MIL,CIN,2023 REG,10,3,6,4,7,16,0,1,-1,1,1,1,1,0,0,0,0,0,0,0.49023796582517226,0.5097620341748277
89769,0.6453900709219857,0.39370078740157477,-182,154,0.6201612190961417,0.37983878090385825,away,NYM,over,9,0.5,100,0.4772727272727273,PHI,NYM,2023 REG,6,5,3,2,7,9,1,0,3,-3,1,1,0,0,0,0,0,0,0,0.4772727272727273,0.5227272727272727
89769,0.6453900709219857,0.39370078740157477,-182,154,0.6201612190961417,0.37983878090385825,home,PHI,under,9,0.5454545454545454,-120,0.5227272727272727,PHI,NYM,2023 REG,6,5,3,2,7,9,1,0,3,-3,1,1,0,0,0,0,0,0,0,0.4772727272727273,0.5227272727272727
89770,0.6428571428571428,0.4,-180,150,0.6153061224489796,0.38469387755102036,away,NYM,over,9,0.5,100,0.4772727272727273,MIN,NYM,2023 REG,4,0,4,2,2,8,0,1,-2,2,0,0,0,0,0,0,0,0,0,0.4772727272727273,0.5227272727272727
89770,0.6428571428571428,0.4,-180,150,0.6153061224489796,0.38469387755102036,home,MIN,under,9,0.5454545454545454,-120,0.5227272727272727,MIN,NYM,2023 REG,4,0,4,2,2,8,0,1,-2,2,0,0,0,0,0,0,0,0,0,0.4772727272727273,0.5227272727272727
89771,0.5798319327731092,0.45454545454545453,-138,120,0.5598988258404966,0.44010117415950345,away,ATL,over,9.5,0.5283018867924528,-112,0.5044173060022736,STL,ATL,2023 REG,10,1,12,4,5,22,0,1,-3,3,1,0,0,0,0,0,0,0,0,0.5044173060022736,0.49558269399772636
89771,0.5798319327731092,0.45454545454545453,-138,120,0.5598988258404966,0.44010117415950345,home,STL,under,9.5,0.5169082125603864,-107,0.49558269399772636,STL,ATL,2023 REG,10,1,12,4,5,22,0,1,-3,3,1,0,0,0,0,0,0,0,0,0.5044173060022736,0.49558269399772636
89772,0.5652173913043479,0.4672897196261683,-130,114,0.5468438068653605,0.4531561931346395,away,BAL,over,8.5,0.5145631067961165,-106,0.4925063625223866,CHC,BAL,2023 REG,12,10,9,3,13,21,1,0,7,-7,1,1,1,0,0,0,0,0,0,0.4925063625223866,0.5074936374776133
89772,0.5652173913043479,0.4672897196261683,-130,114,0.5468438068653605,0.4531561931346395,home,CHC,under,8.5,0.5283018867924528,-112,0.5074936374776133,CHC,BAL,2023 REG,12,10,9,3,13,21,1,0,7,-7,1,1,1,0,0,0,0,0,0,0.4925063625223866,0.5074936374776133
89773,0.5652173913043479,0.47619047619047616,-130,110,0.5418129444594474,0.4581870555405526,away,CWS,over,9,0.5305164319248826,-113,0.5066009958897986,LAA,CWS,2023 REG,11,5,17,11,16,28,0,1,-6,6,1,1,1,1,1,0,0,0,0,0.5066009958897986,0.49339900411020143
89773,0.5652173913043479,0.47619047619047616,-130,110,0.5418129444594474,0.4581870555405526,home,LAA,under,9,0.5145631067961165,-106,0.49339900411020143,LAA,CWS,2023 REG,11,5,17,11,16,28,0,1,-6,6,1,1,1,1,1,0,0,0,0,0.5066009958897986,0.49339900411020143
89774,0.5652173913043479,0.47619047619047616,-130,110,0.5418129444594474,0.4581870555405526,away,SF,over,8.5,0.5370370370370371,-116,0.5118817074154765,CHC,SF,2023 REG,6,5,2,0,5,8,1,0,5,-5,0,0,0,0,0,0,0,0,0,0.5118817074154765,0.48811829258452355
89774,0.5652173913043479,0.47619047619047616,-130,110,0.5418129444594474,0.4581870555405526,home,CHC,under,8.5,0.5098039215686274,-104,0.48811829258452355,CHC,SF,2023 REG,6,5,2,0,5,8,1,0,5,-5,0,0,0,0,0,0,0,0,0,0.5118817074154765,0.48811829258452355
89775,0.37735849056603776,0.6551724137931035,165,-190,0.3650826776003241,0.6349173223996759,away,BAL,over,9.5,0.5121951219512195,-105,0.48808156828023186,KC,BAL,2023 REG,16,10,10,13,23,26,0,1,-3,3,1,1,1,1,1,1,1,1,1,0.48808156828023186,0.5119184317197681
89775,0.37735849056603776,0.6551724137931035,165,-190,0.3650826776003241,0.6349173223996759,home,KC,under,9.5,0.5348837209302326,-115,0.5119184317197681,KC,BAL,2023 REG,16,10,10,13,23,26,0,1,-3,3,1,1,1,1,1,1,1,1,1,0.48808156828023186,0.5119184317197681
89776,0.5327102803738317,0.5098039215686274,-114,-104,0.5100625279371946,0.48993747206280536,away,TOR,over,10,0.5192307692307692,-108,0.49455035168025013,BOS,TOR,2023 REG,8,1,16,13,14,24,0,1,-12,12,1,0,0,0,0,0,0,0,0,0.49455035168025013,0.5054496483197499
89776,0.5327102803738317,0.5098039215686274,-114,-104,0.5100625279371946,0.48993747206280536,home,BOS,under,10,0.5283018867924528,-112,0.5054496483197499,BOS,TOR,2023 REG,8,1,16,13,14,24,0,1,-12,12,1,0,0,0,0,0,0,0,0,0.49455035168025013,0.5054496483197499
89777,0.5967741935483871,0.4444444444444444,-148,125,0.5721759741010521,0.42782402589894786,away,SEA,over,7.5,0.5327102803738317,-114,0.508788710910954,HOU,SEA,2023 REG,11,3,17,10,13,28,0,1,-7,7,1,1,1,0,0,0,0,0,0,0.508788710910954,0.491211289089046
89777,0.5967741935483871,0.4444444444444444,-148,125,0.5721759741010521,0.42782402589894786,home,HOU,under,7.5,0.5121951219512195,-105,0.491211289089046,HOU,SEA,2023 REG,11,3,17,10,13,28,0,1,-7,7,1,1,1,0,0,0,0,0,0,0.508788710910954,0.491211289089046
89778,0.6031746031746031,0.4347826086956522,-152,130,0.5802797769671475,0.4197202230328525,away,WSH,over,11,0.5260663507109005,-111,0.5022370601254724,COL,WSH,2023 REG,11,6,11,7,13,22,0,1,-1,1,1,1,1,1,1,1,0,0,0,0.5022370601254724,0.4977629398745276
89778,0.6031746031746031,0.4347826086956522,-152,130,0.5802797769671475,0.4197202230328525,home,COL,under,11,0.5192307692307692,-108,0.4977629398745276,COL,WSH,2023 REG,11,6,11,7,13,22,0,1,-1,1,1,1,1,1,1,1,0,0,0,0.5022370601254724,0.4977629398745276
89779,0.6254681647940076,0.4098360655737705,-167,144,0.6033864926164085,0.39661350738359147,away,OAK,over,9.5,0.5238095238095238,-110,0.5012646084074657,MIL,OAK,2023 REG,6,1,7,2,3,13,0,1,-1,1,1,0,0,0,0,0,0,0,0,0.5012646084074657,0.4987353915925343
89779,0.6254681647940076,0.4098360655737705,-167,144,0.6033864926164085,0.39661350738359147,home,MIL,under,9.5,0.5192307692307692,-108,0.4987353915925343,MIL,OAK,2023 REG,6,1,7,2,3,13,0,1,-1,1,1,0,0,0,0,0,0,0,0,0.5012646084074657,0.4987353915925343
89781,0.4484304932735426,0.5884773662551441,123,-143,0.43187988361942303,0.5681201163805769,away,MIA,over,8.5,0.5412844036697247,-118,0.5162581740877563,PIT,MIA,2023 REG,9,3,10,4,7,19,0,1,-1,1,1,1,1,0,0,0,0,0,0,0.5162581740877563,0.4837418259122437
89781,0.4484304932735426,0.5884773662551441,123,-143,0.43187988361942303,0.5681201163805769,home,PIT,under,8.5,0.504950495049505,-102,0.4837418259122437,PIT,MIA,2023 REG,9,3,10,4,7,19,0,1,-1,1,1,1,1,0,0,0,0,0,0,0.5162581740877563,0.4837418259122437
89782,0.5884773662551441,0.45248868778280543,-143,121,0.5643697706690257,0.4356302293309743,away,LAA,over,8.5,0.5,100,0.4772727272727273,MIL,LAA,2023 REG,5,7,11,5,12,16,1,0,2,-2,1,1,1,1,1,0,0,0,0,0.4772727272727273,0.5227272727272727
89782,0.5884773662551441,0.45248868778280543,-143,121,0.5643697706690257,0.4356302293309743,home,MIL,under,8.5,0.5454545454545454,-120,0.5227272727272727,MIL,LAA,2023 REG,5,7,11,5,12,16,1,0,2,-2,1,1,1,1,1,0,0,0,0,0.4772727272727273,0.5227272727272727
89783,0.5121951219512195,0.5327102803738317,-105,-114,0.48919479393107135,0.5108052060689287,away,HOU,over,7,0.5238095238095238,-110,0.4988662131519274,STL,HOU,2023 REG,8,4,7,2,6,15,1,0,2,-2,1,1,0,0,0,0,0,0,0,0.4988662131519274,0.5011337868480725
89783,0.5121951219512195,0.5327102803738317,-105,-114,0.48919479393107135,0.5108052060689287,home,STL,under,7,0.5238095238095238,-110,0.5011337868480725,STL,HOU,2023 REG,8,4,7,2,6,15,1,0,2,-2,1,1,0,0,0,0,0,0,0,0.4988662131519274,0.5011337868480725
89784,0.5412844036697247,0.5,-118,100,0.5189377998484975,0.4810622001515025,away,CHC,over,9,0.5348837209302326,-115,0.5097020142727117,TOR,CHC,2023 REG,14,11,5,4,15,19,1,0,7,-7,1,1,1,1,0,0,0,0,0,0.5097020142727117,0.49029798572728833
89784,0.5412844036697247,0.5,-118,100,0.5189377998484975,0.4810622001515025,home,TOR,under,9,0.5121951219512195,-105,0.49029798572728833,TOR,CHC,2023 REG,14,11,5,4,15,19,1,0,7,-7,1,1,1,1,0,0,0,0,0,0.5097020142727117,0.49029798572728833
89786,0.6428571428571428,0.39370078740157477,-180,154,0.6193556162622529,0.3806443837377471,away,KC,over,9,0.5121951219512195,-105,0.48808156828023186,CWS,KC,2023 REG,9,5,4,2,7,13,1,0,3,-3,1,1,0,0,0,0,0,0,0,0.48808156828023186,0.5119184317197681
89786,0.6428571428571428,0.39370078740157477,-180,154,0.6193556162622529,0.3806443837377471,home,CWS,under,9,0.5348837209302326,-115,0.5119184317197681,CWS,KC,2023 REG,9,5,4,2,7,13,1,0,3,-3,1,1,0,0,0,0,0,0,0,0.48808156828023186,0.5119184317197681
89787,0.5348837209302326,0.5121951219512195,-115,-105,0.5097020142727117,0.49029798572728833,away,TEX,over,8,0.5348837209302326,-115,0.5097020142727117,TB,TEX,2023 REG,7,4,12,8,12,19,0,1,-4,4,1,1,1,1,0,0,0,0,0,0.5097020142727117,0.49029798572728833
89787,0.5348837209302326,0.5121951219512195,-115,-105,0.5097020142727117,0.49029798572728833,home,TB,under,8,0.5121951219512195,-105,0.49029798572728833,TB,TEX,2023 REG,7,4,12,8,12,19,0,1,-4,4,1,1,1,1,0,0,0,0,0,0.5097020142727117,0.49029798572728833
89788,0.6551724137931035,0.3846153846153846,-190,160,0.6291045458703008,0.37089545412969915,away,ARI,over,8.5,0.5145631067961165,-106,0.49023796582517226,SD,ARI,2023 REG,5,1,13,8,9,18,0,1,-7,7,1,0,0,0,0,0,0,0,0,0.49023796582517226,0.5097620341748277
89788,0.6551724137931035,0.3846153846153846,-190,160,0.6291045458703008,0.37089545412969915,home,SD,under,8.5,0.5327102803738317,-114,0.5097620341748277,SD,ARI,2023 REG,5,1,13,8,9,18,0,1,-7,7,1,0,0,0,0,0,0,0,0,0.49023796582517226,0.5097620341748277
89789,0.5,0.5454545454545454,100,-120,0.4772727272727273,0.5227272727272727,away,TB,over,7.5,0.5348837209302326,-115,0.5097020142727117,BAL,TB,2023 REG,12,8,5,0,8,17,1,0,8,-8,0,0,0,0,0,0,0,0,0,0.5097020142727117,0.49029798572728833
89789,0.5,0.5454545454545454,100,-120,0.4772727272727273,0.5227272727272727,home,BAL,under,7.5,0.5121951219512195,-105,0.49029798572728833,BAL,TB,2023 REG,12,8,5,0,8,17,1,0,8,-8,0,0,0,0,0,0,0,0,0,0.5097020142727117,0.49029798572728833
89790,0.5327102803738317,0.5098039215686274,-114,-104,0.5100625279371946,0.48993747206280536,away,SD,over,9.5,0.5073891625615764,-103,0.4837652908580103,MIN,SD,2023 REG,6,1,10,6,7,16,0,1,-5,5,1,0,0,0,0,0,0,0,0,0.4837652908580103,0.5162347091419897
89790,0.5327102803738317,0.5098039215686274,-114,-104,0.5100625279371946,0.48993747206280536,home,MIN,under,9.5,0.5391705069124424,-117,0.5162347091419897,MIN,SD,2023 REG,6,1,10,6,7,16,0,1,-5,5,1,0,0,0,0,0,0,0,0,0.4837652908580103,0.5162347091419897
89791,0.4504504504504505,0.5918367346938775,122,-145,0.43140216885390636,0.5685978311460936,away,SD,over,8.5,0.5348837209302326,-115,0.5097020142727117,CWS,SD,2023 REG,8,2,6,3,5,14,0,1,-1,1,1,1,0,0,0,0,0,0,0,0.5097020142727117,0.49029798572728833
89791,0.4504504504504505,0.5918367346938775,122,-145,0.43140216885390636,0.5685978311460936,home,CWS,under,8.5,0.5121951219512195,-105,0.49029798572728833,CWS,SD,2023 REG,8,2,6,3,5,14,0,1,-1,1,1,1,0,0,0,0,0,0,0,0.5097020142727117,0.49029798572728833
89792,0.5348837209302326,0.5121951219512195,-115,-105,0.5097020142727117,0.49029798572728833,away,TEX,over,8,0.5192307692307692,-108,0.49455035168025013,SEA,TEX,2023 REG,6,8,3,0,8,9,1,0,8,-8,0,0,0,0,0,0,0,0,0,0.49455035168025013,0.5054496483197499
89792,0.5348837209302326,0.5121951219512195,-115,-105,0.5097020142727117,0.49029798572728833,home,SEA,under,8,0.5283018867924528,-112,0.5054496483197499,SEA,TEX,2023 REG,6,8,3,0,8,9,1,0,8,-8,0,0,0,0,0,0,0,0,0,0.49455035168025013,0.5054496483197499
89793,0.5652173913043479,0.47619047619047616,-130,110,0.5418129444594474,0.4581870555405526,away,TB,over,8,0.5238095238095238,-110,0.4988662131519274,TOR,TB,2023 REG,16,11,7,4,15,23,1,0,7,-7,1,1,1,1,0,0,0,0,0,0.4988662131519274,0.5011337868480725
89793,0.5652173913043479,0.47619047619047616,-130,110,0.5418129444594474,0.4581870555405526,home,TOR,under,8,0.5238095238095238,-110,0.5011337868480725,TOR,TB,2023 REG,16,11,7,4,15,23,1,0,7,-7,1,1,1,1,0,0,0,0,0,0.4988662131519274,0.5011337868480725
89794,0.7142857142857143,0.3225806451612903,-250,210,0.6879526003949967,0.3120473996050033,away,OAK,over,7.5,0.5121951219512195,-105,0.48808156828023186,SEA,OAK,2023 REG,5,3,3,2,5,8,1,0,1,-1,1,1,0,0,0,0,0,0,0,0.48808156828023186,0.5119184317197681
89794,0.7142857142857143,0.3225806451612903,-250,210,0.6879526003949967,0.3120473996050033,home,SEA,under,7.5,0.5348837209302326,-115,0.5119184317197681,SEA,OAK,2023 REG,5,3,3,2,5,8,1,0,1,-1,1,1,0,0,0,0,0,0,0,0.48808156828023186,0.5119184317197681
89795,0.4166666666666667,0.6226415094339623,140,-165,0.4002882599580712,0.5997117400419287,away,NYY,over,11.5,0.5348837209302326,-115,0.5097020142727117,COL,NYY,2023 REG,6,3,8,6,9,14,0,1,-3,3,1,1,1,0,0,0,0,0,0,0.5097020142727117,0.49029798572728833
89795,0.4166666666666667,0.6226415094339623,140,-165,0.4002882599580712,0.5997117400419287,home,COL,under,11.5,0.5121951219512195,-105,0.49029798572728833,COL,NYY,2023 REG,6,3,8,6,9,14,0,1,-3,3,1,1,1,0,0,0,0,0,0,0.5097020142727117,0.49029798572728833
89796,0.46511627906976744,0.574468085106383,115,-135,0.44670494689481377,0.5532950531051862,away,CHC,over,8.5,0.5121951219512195,-105,0.48808156828023186,WSH,CHC,2023 REG,6,1,10,5,6,16,0,1,-4,4,1,0,0,0,0,0,0,0,0,0.48808156828023186,0.5119184317197681
89796,0.46511627906976744,0.574468085106383,115,-135,0.44670494689481377,0.5532950531051862,home,WSH,under,8.5,0.5348837209302326,-115,0.5119184317197681,WSH,CHC,2023 REG,6,1,10,5,6,16,0,1,-4,4,1,0,0,0,0,0,0,0,0,0.48808156828023186,0.5119184317197681
89797,0.40322580645161293,0.6296296296296295,148,-170,0.3899776467414345,0.6100223532585656,away,MIA,over,9,0.5283018867924528,-112,0.5044173060022736,WSH,MIA,2023 REG,8,2,7,5,7,15,0,1,-3,3,1,1,0,0,0,0,0,0,0,0.5044173060022736,0.49558269399772636
89797,0.40322580645161293,0.6296296296296295,148,-170,0.3899776467414345,0.6100223532585656,home,WSH,under,9,0.5169082125603864,-107,0.49558269399772636,WSH,MIA,2023 REG,8,2,7,5,7,15,0,1,-3,3,1,1,0,0,0,0,0,0,0,0.5044173060022736,0.49558269399772636
89798,0.5,0.5454545454545454,100,-120,0.4772727272727273,0.5227272727272727,away,ATL,over,9,0.5454545454545454,-120,0.5206611570247933,MIA,ATL,2023 REG,14,11,9,5,16,23,1,0,6,-6,1,1,1,1,1,0,0,0,0,0.5206611570247933,0.4793388429752067
89798,0.5,0.5454545454545454,100,-120,0.4772727272727273,0.5227272727272727,home,MIA,under,9,0.5,100,0.4793388429752067,MIA,ATL,2023 REG,14,11,9,5,16,23,1,0,6,-6,1,1,1,1,1,0,0,0,0,0.5206611570247933,0.4793388429752067
89799,0.5918367346938775,0.4444444444444444,-145,125,0.5703642001018094,0.42963579989819056,away,BAL,over,8,0.5348837209302326,-115,0.5097020142727117,NYY,BAL,2023 REG,6,6,10,9,15,16,0,1,-3,3,1,1,1,1,1,1,0,0,0,0.5097020142727117,0.49029798572728833
89799,0.5918367346938775,0.4444444444444444,-145,125,0.5703642001018094,0.42963579989819056,home,NYY,under,8,0.5121951219512195,-105,0.49029798572728833,NYY,BAL,2023 REG,6,6,10,9,15,16,0,1,-3,3,1,1,1,1,1,1,0,0,0,0.5097020142727117,0.49029798572728833
89800,0.576271186440678,0.4629629629629629,-136,116,0.553661676614851,0.446338323385149,away,ARI,over,9,0.5348837209302326,-115,0.5097020142727117,CHC,ARI,2023 REG,9,5,9,2,7,18,1,0,3,-3,1,1,0,0,0,0,0,0,0,0.5097020142727117,0.49029798572728833
89800,0.576271186440678,0.4629629629629629,-136,116,0.553661676614851,0.446338323385149,home,CHC,under,9,0.5121951219512195,-105,0.49029798572728833,CHC,ARI,2023 REG,9,5,9,2,7,18,1,0,3,-3,1,1,0,0,0,0,0,0,0,0.5097020142727117,0.49029798572728833
89801,0.5901639344262295,0.4504504504504505,-144,122,0.5661947892531068,0.43380521074689316,away,LAA,over,9,0.5,100,0.4772727272727273,CWS,LAA,2023 REG,8,4,8,6,10,16,0,1,-2,2,1,1,1,1,0,0,0,0,0,0.4772727272727273,0.5227272727272727
89801,0.5901639344262295,0.4504504504504505,-144,122,0.5661947892531068,0.43380521074689316,home,CWS,under,9,0.5454545454545454,-120,0.5227272727272727,CWS,LAA,2023 REG,8,4,8,6,10,16,0,1,-2,2,1,1,1,1,0,0,0,0,0,0.4772727272727273,0.5227272727272727
89802,0.40322580645161293,0.635036496350365,148,-174,0.38779745854758957,0.6122025414524104,away,MIN,over,9,0.5454545454545454,-120,0.5206611570247933,KC,MIN,2023 REG,6,2,7,1,3,13,1,0,1,-1,1,0,0,0,0,0,0,0,0,0.5206611570247933,0.4793388429752067
89802,0.40322580645161293,0.635036496350365,148,-174,0.38779745854758957,0.6122025414524104,home,KC,under,9,0.5,100,0.4793388429752067,KC,MIN,2023 REG,6,2,7,1,3,13,1,0,1,-1,1,0,0,0,0,0,0,0,0,0.5206611570247933,0.4793388429752067
89803,0.4672897196261683,0.574468085106383,114,-135,0.4477767267604901,0.5522232732395099,away,LAD,over,8.5,0.5283018867924528,-112,0.5031902949311281,SF,LAD,2023 REG,2,2,6,6,8,8,0,1,-4,4,1,1,0,0,0,0,0,0,0,0.5031902949311281,0.4968097050688719
89803,0.4672897196261683,0.574468085106383,114,-135,0.4477767267604901,0.5522232732395099,home,SF,under,8.5,0.5192307692307692,-108,0.4968097050688719,SF,LAD,2023 REG,2,2,6,6,8,8,0,1,-4,4,1,1,0,0,0,0,0,0,0,0.5031902949311281,0.4968097050688719
89804,0.5454545454545454,0.5,-120,100,0.5206611570247933,0.4793388429752067,away,TOR,over,9.5,0.5,100,0.4762443438914027,LAD,TOR,2023 REG,7,3,13,6,9,20,0,1,-3,3,1,1,1,0,0,0,0,0,0,0.4762443438914027,0.5237556561085973
89804,0.5454545454545454,0.5,-120,100,0.5206611570247933,0.4793388429752067,home,LAD,under,9.5,0.5475113122171946,-121,0.5237556561085973,LAD,TOR,2023 REG,7,3,13,6,9,20,0,1,-3,3,1,1,1,0,0,0,0,0,0,0.4762443438914027,0.5237556561085973
89805,0.5238095238095238,0.5238095238095238,-110,-110,0.4988662131519274,0.5011337868480725,away,BAL,over,8,0.5433789954337899,-119,0.5171177654451503,SF,BAL,2023 REG,5,3,11,8,11,16,0,1,-5,5,1,1,1,0,0,0,0,0,0,0.5171177654451503,0.4828822345548497
89805,0.5238095238095238,0.5238095238095238,-110,-110,0.4988662131519274,0.5011337868480725,home,SF,under,8,0.504950495049505,-102,0.4828822345548497,SF,BAL,2023 REG,5,3,11,8,11,16,0,1,-5,5,1,1,1,0,0,0,0,0,0,0.5171177654451503,0.4828822345548497
89806,0.48780487804878053,0.5515695067264574,105,-123,0.4685978610852498,0.5314021389147502,away,CWS,over,8.5,0.5327102803738317,-114,0.508788710910954,PIT,CWS,2023 REG,10,5,14,11,16,24,0,1,-6,6,1,1,1,1,1,0,0,0,0,0.508788710910954,0.491211289089046
89806,0.48780487804878053,0.5515695067264574,105,-123,0.4685978610852498,0.5314021389147502,home,PIT,under,8.5,0.5121951219512195,-105,0.491211289089046,PIT,CWS,2023 REG,10,5,14,11,16,24,0,1,-6,6,1,1,1,1,1,0,0,0,0,0.508788710910954,0.491211289089046
89807,0.5305164319248826,0.5098039215686274,-113,-104,0.5091258218555558,0.49087417814444423,away,MIA,over,9,0.5348837209302326,-115,0.5097020142727117,ARI,MIA,2023 REG,11,2,9,6,8,20,0,1,-4,4,1,1,0,0,0,0,0,0,0,0.5097020142727117,0.49029798572728833
89807,0.5305164319248826,0.5098039215686274,-113,-104,0.5091258218555558,0.49087417814444423,home,ARI,under,9,0.5121951219512195,-105,0.49029798572728833,ARI,MIA,2023 REG,11,2,9,6,8,20,0,1,-4,4,1,1,0,0,0,0,0,0,0,0.5097020142727117,0.49029798572728833
89808,0.6363636363636364,0.3968253968253968,-175,152,0.6152433425160697,0.3847566574839303,away,BAL,over,9,0.504950495049505,-102,0.48160416005266615,HOU,BAL,2023 REG,10,5,10,9,14,20,0,1,-4,4,1,1,1,1,1,0,0,0,0,0.48160416005266615,0.5183958399473338
89808,0.6363636363636364,0.3968253968253968,-175,152,0.6152433425160697,0.3847566574839303,home,HOU,under,9,0.5412844036697247,-118,0.5183958399473338,HOU,BAL,2023 REG,10,5,10,9,14,20,0,1,-4,4,1,1,1,1,1,0,0,0,0,0.48160416005266615,0.5183958399473338
89809,0.42194092827004215,0.6168582375478928,137,-161,0.4055699722287194,0.5944300277712806,away,MIL,over,8.5,0.5454545454545454,-120,0.5206611570247933,WSH,MIL,2023 REG,7,4,6,6,10,13,0,1,-2,2,1,1,1,1,0,0,0,0,0,0.5206611570247933,0.4793388429752067
89809,0.42194092827004215,0.6168582375478928,137,-161,0.4055699722287194,0.5944300277712806,home,WSH,under,8.5,0.5,100,0.4793388429752067,WSH,MIL,2023 REG,7,4,6,6,10,13,0,1,-2,2,1,1,1,1,0,0,0,0,0,0.5206611570247933,0.4793388429752067
89810,0.6296296296296295,0.4081632653061224,-170,145,0.6058341031886005,0.39416589681139946,away,LAA,over,8.5,0.5348837209302326,-115,0.5097020142727117,HOU,LAA,2023 REG,11,9,12,6,15,23,1,0,3,-3,1,1,1,1,1,1,0,0,0,0.5097020142727117,0.49029798572728833
89810,0.6296296296296295,0.4081632653061224,-170,145,0.6058341031886005,0.39416589681139946,home,HOU,under,8.5,0.5121951219512195,-105,0.49029798572728833,HOU,LAA,2023 REG,11,9,12,6,15,23,1,0,3,-3,1,1,1,1,1,1,0,0,0,0.5097020142727117,0.49029798572728833
89811,0.42372881355932196,0.6183206106870228,136,-162,0.40591126091256574,0.5940887390874343,away,BAL,over,8,0.5348837209302326,-115,0.5097020142727117,CLE,BAL,2023 REG,8,5,7,2,7,15,1,0,3,-3,1,1,0,0,0,0,0,0,0,0.5097020142727117,0.49029798572728833
89811,0.42372881355932196,0.6183206106870228,136,-162,0.40591126091256574,0.5940887390874343,home,CLE,under,8,0.5121951219512195,-105,0.49029798572728833,CLE,BAL,2023 REG,8,5,7,2,7,15,1,0,3,-3,1,1,0,0,0,0,0,0,0,0.5097020142727117,0.49029798572728833
89812,0.425531914893617,0.613899613899614,135,-159,0.40875254093905067,0.5912474590609493,away,SD,over,9,0.5121951219512195,-105,0.48808156828023186,DET,SD,2023 REG,8,4,9,5,9,17,0,1,-1,1,1,1,1,1,0,0,0,0,0,0.48808156828023186,0.5119184317197681
89812,0.425531914893617,0.613899613899614,135,-159,0.40875254093905067,0.5912474590609493,home,DET,under,9,0.5348837209302326,-115,0.5119184317197681,DET,SD,2023 REG,8,4,9,5,9,17,0,1,-1,1,1,1,1,1,0,0,0,0,0,0.48808156828023186,0.5119184317197681
89813,0.6108949416342413,0.4273504273504274,-157,134,0.5875310391805721,0.41246896081942785,away,TOR,over,7.5,0.5238095238095238,-110,0.4988662131519274,TB,TOR,2023 REG,8,2,8,6,8,16,0,1,-4,4,1,1,0,0,0,0,0,0,0,0.4988662131519274,0.5011337868480725
89813,0.6108949416342413,0.4273504273504274,-157,134,0.5875310391805721,0.41246896081942785,home,TB,under,7.5,0.5238095238095238,-110,0.5011337868480725,TB,TOR,2023 REG,8,2,8,6,8,16,0,1,-4,4,1,1,0,0,0,0,0,0,0,0.4988662131519274,0.5011337868480725
89814,0.7014925373134329,0.3389830508474576,-235,195,0.6730992142751963,0.32690078572480374,away,OAK,over,10.5,0.5238095238095238,-110,0.4988662131519274,BOS,OAK,2023 REG,10,7,7,3,10,17,1,0,4,-4,1,1,1,0,0,0,0,0,0,0.4988662131519274,0.5011337868480725
89814,0.7014925373134329,0.3389830508474576,-235,195,0.6730992142751963,0.32690078572480374,home,BOS,under,10.5,0.5238095238095238,-110,0.5011337868480725,BOS,OAK,2023 REG,10,7,7,3,10,17,1,0,4,-4,1,1,1,0,0,0,0,0,0,0.4988662131519274,0.5011337868480725
89815,0.7222222222222222,0.3225806451612903,-260,210,0.6898645957785743,0.3101354042214257,away,PHI,over,9,0.504950495049505,-102,0.47949844489399435,ATL,PHI,2023 REG,20,11,6,4,15,26,1,0,7,-7,1,1,1,1,0,0,0,0,0,0.47949844489399435,0.5205015551060057
89815,0.7222222222222222,0.3225806451612903,-260,210,0.6898645957785743,0.3101354042214257,home,ATL,under,9,0.5454545454545454,-120,0.5205015551060057,ATL,PHI,2023 REG,20,11,6,4,15,26,1,0,7,-7,1,1,1,1,0,0,0,0,0,0.47949844489399435,0.5205015551060057
89816,0.5238095238095238,0.5215311004784688,-110,-109,0.5000596729920038,0.4999403270079962,away,CHC,over,8.5,0.5327102803738317,-114,0.5075272610403079,MIL,CHC,2023 REG,8,4,6,3,7,14,1,0,1,-1,1,1,1,0,0,0,0,0,0,0.5075272610403079,0.4924727389596921
89816,0.5238095238095238,0.5215311004784688,-110,-109,0.5000596729920038,0.4999403270079962,home,MIL,under,8.5,0.5145631067961165,-106,0.4924727389596921,MIL,CHC,2023 REG,8,4,6,3,7,14,1,0,1,-1,1,1,1,0,0,0,0,0,0,0.5075272610403079,0.4924727389596921
89817,0.5238095238095238,0.5238095238095238,-110,-110,0.4988662131519274,0.5011337868480725,away,SEA,over,8,0.5454545454545454,-120,0.5193043049216726,ARI,SEA,2023 REG,3,0,10,4,4,13,0,1,-4,4,0,0,0,0,0,0,0,0,0,0.5193043049216726,0.48069569507832743
89817,0.5238095238095238,0.5238095238095238,-110,-110,0.4988662131519274,0.5011337868480725,home,ARI,under,8,0.5024875621890548,-101,0.48069569507832743,ARI,SEA,2023 REG,3,0,10,4,4,13,0,1,-4,4,0,0,0,0,0,0,0,0,0,0.5193043049216726,0.48069569507832743
89818,0.5283018867924528,0.5121951219512195,-112,-105,0.5069072406637203,0.4930927593362797,away,SD,over,9.5,0.5145631067961165,-106,0.4913668392989033,ATL,SD,2023 REG,6,4,7,5,9,13,0,1,-1,1,1,1,1,1,0,0,0,0,0,0.4913668392989033,0.5086331607010968
89818,0.5283018867924528,0.5121951219512195,-112,-105,0.5069072406637203,0.4930927593362797,home,ATL,under,9.5,0.5305164319248826,-113,0.5086331607010968,ATL,SD,2023 REG,6,4,7,5,9,13,0,1,-1,1,1,1,1,1,0,0,0,0,0,0.4913668392989033,0.5086331607010968
89819,0.5145631067961165,0.5283018867924528,-106,-112,0.4925063625223866,0.5074936374776133,away,CIN,over,9.5,0.5412844036697247,-118,0.5136310900085983,WSH,CIN,2023 REG,10,2,16,9,11,26,0,1,-7,7,1,1,0,0,0,0,0,0,0,0.5136310900085983,0.4863689099914017
89819,0.5145631067961165,0.5283018867924528,-106,-112,0.4925063625223866,0.5074936374776133,home,WSH,under,9.5,0.5098039215686274,-104,0.4863689099914017,WSH,CIN,2023 REG,10,2,16,9,11,26,0,1,-7,7,1,1,0,0,0,0,0,0,0,0.5136310900085983,0.4863689099914017
89820,0.5833333333333333,0.4587155963302753,-140,118,0.5588047910295616,0.4411952089704384,away,CLE,over,8,0.5098039215686274,-104,0.4870219861770517,BAL,CLE,2023 REG,5,0,9,5,5,14,0,1,-5,5,0,0,0,0,0,0,0,0,0,0.4870219861770517,0.5129780138229483
89820,0.5833333333333333,0.4587155963302753,-140,118,0.5588047910295616,0.4411952089704384,home,BAL,under,8,0.5348837209302326,-115,0.5129780138229483,BAL,CLE,2023 REG,5,0,9,5,5,14,0,1,-5,5,0,0,0,0,0,0,0,0,0,0.4870219861770517,0.5129780138229483
89821,0.5391705069124424,0.5,-117,100,0.5180509248444435,0.4819490751555565,away,PIT,over,9,0.5454545454545454,-120,0.5206611570247933,KC,PIT,2023 REG,2,0,12,5,5,14,0,1,-5,5,0,0,0,0,0,0,0,0,0,0.5206611570247933,0.4793388429752067
89821,0.5391705069124424,0.5,-117,100,0.5180509248444435,0.4819490751555565,home,KC,under,9,0.5,100,0.4793388429752067,KC,PIT,2023 REG,2,0,12,5,5,14,0,1,-5,5,0,0,0,0,0,0,0,0,0,0.5206611570247933,0.4793388429752067
89822,0.6621621621621622,0.37735849056603776,-196,165,0.6359930813015974,0.3640069186984026,away,SF,over,15.5,0.5169082125603864,-107,0.49353874091423283,SD,SF,2023 REG,17,16,13,11,27,30,1,0,5,-5,1,1,1,1,1,1,1,1,1,0.49353874091423283,0.5064612590857671
89822,0.6621621621621622,0.37735849056603776,-196,165,0.6359930813015974,0.3640069186984026,home,SD,under,15.5,0.5283018867924528,-112,0.5064612590857671,SD,SF,2023 REG,17,16,13,11,27,30,1,0,5,-5,1,1,1,1,1,1,1,1,1,0.49353874091423283,0.5064612590857671
89823,0.4854368932038835,0.5535714285714286,106,-124,0.4665008146721786,0.5334991853278215,away,NYM,over,8.5,0.5073891625615764,-103,0.4837652908580103,SF,NYM,2023 REG,7,4,13,9,13,20,0,1,-5,5,1,1,1,1,0,0,0,0,0,0.4837652908580103,0.5162347091419897
89823,0.4854368932038835,0.5535714285714286,106,-124,0.4665008146721786,0.5334991853278215,home,SF,under,8.5,0.5391705069124424,-117,0.5162347091419897,SF,NYM,2023 REG,7,4,13,9,13,20,0,1,-5,5,1,1,1,1,0,0,0,0,0,0.4837652908580103,0.5162347091419897
89824,0.4672897196261683,0.5726495726495727,114,-134,0.44862649893656975,0.5513735010634302,away,DET,over,8.5,0.5121951219512195,-105,0.48808156828023186,CWS,DET,2023 REG,9,2,11,4,6,20,0,1,-2,2,1,1,0,0,0,0,0,0,0,0.48808156828023186,0.5119184317197681
89824,0.4672897196261683,0.5726495726495727,114,-134,0.44862649893656975,0.5513735010634302,home,CWS,under,8.5,0.5348837209302326,-115,0.5119184317197681,CWS,DET,2023 REG,9,2,11,4,6,20,0,1,-2,2,1,1,0,0,0,0,0,0,0,0.48808156828023186,0.5119184317197681
89825,0.48780487804878053,0.5475113122171946,105,-121,0.470577468162939,0.529422531837061,away,CLE,over,8.5,0.5238095238095238,-110,0.4988662131519274,CWS,CLE,2023 REG,16,8,9,3,11,25,1,0,5,-5,1,1,1,0,0,0,0,0,0,0.4988662131519274,0.5011337868480725
89825,0.48780487804878053,0.5475113122171946,105,-121,0.470577468162939,0.529422531837061,home,CWS,under,8.5,0.5238095238095238,-110,0.5011337868480725,CWS,CLE,2023 REG,16,8,9,3,11,25,1,0,5,-5,1,1,1,0,0,0,0,0,0,0.4988662131519274,0.5011337868480725
89826,0.7101449275362319,0.3278688524590164,-245,205,0.6831496344961281,0.3168503655038719,away,WSH,over,8,0.5454545454545454,-120,0.5206611570247933,SEA,WSH,2023 REG,7,4,9,7,11,16,0,1,-3,3,1,1,1,1,0,0,0,0,0,0.5206611570247933,0.4793388429752067
89826,0.7101449275362319,0.3278688524590164,-245,205,0.6831496344961281,0.3168503655038719,home,SEA,under,8,0.5,100,0.4793388429752067,SEA,WSH,2023 REG,7,4,9,7,11,16,0,1,-3,3,1,1,1,1,0,0,0,0,0,0.5206611570247933,0.4793388429752067
89827,0.5535714285714286,0.48780487804878053,-124,105,0.53066668740667,0.46933331259333,away,MIA,over,9.5,0.5238095238095238,-110,0.4988662131519274,CIN,MIA,2023 REG,10,4,8,5,9,18,0,1,-1,1,1,1,1,1,0,0,0,0,0,0.4988662131519274,0.5011337868480725
89827,0.5535714285714286,0.48780487804878053,-124,105,0.53066668740667,0.46933331259333,home,CIN,under,9.5,0.5238095238095238,-110,0.5011337868480725,CIN,MIA,2023 REG,10,4,8,5,9,18,0,1,-1,1,1,1,1,1,0,0,0,0,0,0.4988662131519274,0.5011337868480725
89828,0.6503496503496503,0.3921568627450981,-186,155,0.6227055544208978,0.3772944455791022,away,KC,over,8.5,0.5238095238095238,-110,0.4988662131519274,CLE,KC,2023 REG,18,10,12,6,16,30,1,0,4,-4,1,1,1,1,1,1,0,0,0,0.4988662131519274,0.5011337868480725
89828,0.6503496503496503,0.3921568627450981,-186,155,0.6227055544208978,0.3772944455791022,home,CLE,under,8.5,0.5238095238095238,-110,0.5011337868480725,CLE,KC,2023 REG,18,10,12,6,16,30,1,0,4,-4,1,1,1,1,1,1,0,0,0,0.4988662131519274,0.5011337868480725
89829,0.4672897196261683,0.5652173913043479,114,-130,0.45209948087359064,0.5479005191264094,away,TEX,over,9.5,0.5,100,0.4772727272727273,CIN,TEX,2023 REG,11,7,10,6,13,21,1,0,1,-1,1,1,1,1,1,1,0,0,0,0.4772727272727273,0.5227272727272727
89829,0.4672897196261683,0.5652173913043479,114,-130,0.45209948087359064,0.5479005191264094,home,CIN,under,9.5,0.5454545454545454,-120,0.5227272727272727,CIN,TEX,2023 REG,11,7,10,6,13,21,1,0,1,-1,1,1,1,1,1,1,0,0,0,0.4772727272727273,0.5227272727272727
89830,0.4347826086956522,0.6000000000000001,130,-150,0.4196597353497164,0.5803402646502835,away,TB,over,8.5,0.5145631067961165,-106,0.4913668392989033,NYY,TB,2023 REG,10,9,12,8,17,22,1,0,1,-1,1,1,1,1,1,1,1,1,0,0.4913668392989033,0.5086331607010968
89830,0.4347826086956522,0.6000000000000001,130,-150,0.4196597353497164,0.5803402646502835,home,NYY,under,8.5,0.5305164319248826,-113,0.5086331607010968,NYY,TB,2023 REG,10,9,12,8,17,22,1,0,1,-1,1,1,1,1,1,1,1,1,0,0.4913668392989033,0.5086331607010968
89831,0.7032640949554896,0.3389830508474576,-237,195,0.6735531941979274,0.32644680580207264,away,CIN,over,9,0.5098039215686274,-104,0.48592421718142587,ATL,CIN,2023 REG,11,7,8,6,13,19,1,0,1,-1,1,1,1,1,1,1,0,0,0,0.48592421718142587,0.5140757828185741
89831,0.7032640949554896,0.3389830508474576,-237,195,0.6735531941979274,0.32644680580207264,home,ATL,under,9,0.5370370370370371,-116,0.5140757828185741,ATL,CIN,2023 REG,11,7,8,6,13,19,1,0,1,-1,1,1,1,1,1,1,0,0,0,0.48592421718142587,0.5140757828185741
89832,0.4,0.6428571428571428,150,-180,0.38285714285714295,0.617142857142857,away,BAL,over,8.5,0.5454545454545454,-120,0.5206611570247933,LAA,BAL,2023 REG,8,3,10,6,9,18,0,1,-3,3,1,1,1,0,0,0,0,0,0,0.5206611570247933,0.4793388429752067
89832,0.4,0.6428571428571428,150,-180,0.38285714285714295,0.617142857142857,home,LAA,under,8.5,0.5,100,0.4793388429752067,LAA,BAL,2023 REG,8,3,10,6,9,18,0,1,-3,3,1,1,1,0,0,0,0,0,0,0.5206611570247933,0.4793388429752067
89833,0.607843137254902,0.425531914893617,-155,135,0.5875563408509002,0.41244365914909975,away,BAL,over,9.5,0.5,100,0.4772727272727273,TOR,BAL,2023 REG,8,2,7,6,8,15,0,1,-4,4,1,1,0,0,0,0,0,0,0,0.4772727272727273,0.5227272727272727
89833,0.607843137254902,0.425531914893617,-155,135,0.5875563408509002,0.41244365914909975,home,TOR,under,9.5,0.5454545454545454,-120,0.5227272727272727,TOR,BAL,2023 REG,8,2,7,6,8,15,0,1,-4,4,1,1,0,0,0,0,0,0,0,0.4772727272727273,0.5227272727272727
89834,0.6363636363636364,0.40322580645161293,-175,148,0.6111703545721141,0.3888296454278859,away,DET,over,8,0.5370370370370371,-116,0.5131785224377817,MIN,DET,2023 REG,13,7,12,8,15,25,0,1,-1,1,1,1,1,1,1,1,1,0,0,0.5131785224377817,0.4868214775622183
89834,0.6363636363636364,0.40322580645161293,-175,148,0.6111703545721141,0.3888296454278859,home,MIN,under,8,0.5073891625615764,-103,0.4868214775622183,MIN,DET,2023 REG,13,7,12,8,15,25,0,1,-1,1,1,1,1,1,1,1,1,0,0,0.5131785224377817,0.4868214775622183
89835,0.6503496503496503,0.38759689922480617,-186,158,0.6256711251019269,0.3743288748980731,away,OAK,over,9,0.5098039215686274,-104,0.4870219861770517,PIT,OAK,2023 REG,6,5,8,4,9,14,1,0,1,-1,1,1,1,1,0,0,0,0,0,0.4870219861770517,0.5129780138229483
89835,0.6503496503496503,0.38759689922480617,-186,158,0.6256711251019269,0.3743288748980731,home,PIT,under,9,0.5348837209302326,-115,0.5129780138229483,PIT,OAK,2023 REG,6,5,8,4,9,14,1,0,1,-1,1,1,1,1,0,0,0,0,0,0.4870219861770517,0.5129780138229483
89836,0.7340425531914894,0.3058103975535168,-276,227,0.7047887914744104,0.2952112085255896,away,WSH,over,9.5,0.5391705069124424,-117,0.5140669063204599,LAA,WSH,2023 REG,7,4,14,6,10,21,0,1,-2,2,1,1,1,1,0,0,0,0,0,0.5140669063204599,0.4859330936795401
89836,0.7340425531914894,0.3058103975535168,-276,227,0.7047887914744104,0.2952112085255896,home,LAA,under,9.5,0.5073891625615764,-103,0.4859330936795401,LAA,WSH,2023 REG,7,4,14,6,10,21,0,1,-2,2,1,1,1,1,0,0,0,0,0,0.5140669063204599,0.4859330936795401
89837,0.4587155963302753,0.5815899581589958,118,-139,0.4402268098673069,0.5597731901326931,away,TB,over,8.5,0.5283018867924528,-112,0.5019750255927206,CHC,TB,2023 REG,6,3,5,4,7,11,0,1,-1,1,1,1,1,0,0,0,0,0,0,0.5019750255927206,0.49802497440727944
89837,0.4587155963302753,0.5815899581589958,118,-139,0.4402268098673069,0.5597731901326931,home,CHC,under,8.5,0.5215311004784688,-109,0.49802497440727944,CHC,TB,2023 REG,6,3,5,4,7,11,0,1,-1,1,1,1,1,0,0,0,0,0,0,0.5019750255927206,0.49802497440727944
89838,0.5798319327731092,0.4587155963302753,-138,118,0.557480844469466,0.442519155530534,away,MIL,over,7.5,0.5,100,0.4772727272727273,NYY,MIL,2023 REG,3,4,6,3,7,9,1,0,1,-1,1,1,1,0,0,0,0,0,0,0.4772727272727273,0.5227272727272727
89838,0.5798319327731092,0.4587155963302753,-138,118,0.557480844469466,0.442519155530534,home,NYY,under,7.5,0.5454545454545454,-120,0.5227272727272727,NYY,MIL,2023 REG,3,4,6,3,7,9,1,0,1,-1,1,1,1,0,0,0,0,0,0,0.4772727272727273,0.5227272727272727
89839,0.7311827956989247,0.3125,-272,220,0.69924268701584,0.30075731298416,away,WSH,over,8.5,0.5121951219512195,-105,0.48808156828023186,MIN,WSH,2023 REG,9,3,3,1,4,12,1,0,2,-2,1,0,0,0,0,0,0,0,0,0.48808156828023186,0.5119184317197681
89839,0.7311827956989247,0.3125,-272,220,0.69924268701584,0.30075731298416,home,MIN,under,8.5,0.5348837209302326,-115,0.5119184317197681,MIN,WSH,2023 REG,9,3,3,1,4,12,1,0,2,-2,1,0,0,0,0,0,0,0,0,0.48808156828023186,0.5119184317197681
89840,0.48780487804878053,0.5555555555555556,105,-125,0.4666534470222751,0.5333465529777248,away,HOU,over,10.5,0.5454545454545454,-120,0.5206611570247933,LAA,HOU,2023 REG,9,8,16,9,17,25,0,1,-1,1,1,1,1,1,1,1,1,1,0,0.5206611570247933,0.4793388429752067
89840,0.48780487804878053,0.5555555555555556,105,-125,0.4666534470222751,0.5333465529777248,home,LAA,under,10.5,0.5,100,0.4793388429752067,LAA,HOU,2023 REG,9,8,16,9,17,25,0,1,-1,1,1,1,1,1,1,1,1,1,0,0.5206611570247933,0.4793388429752067
89841,0.425531914893617,0.613899613899614,135,-159,0.40875254093905067,0.5912474590609493,away,ATL,over,9,0.5454545454545454,-120,0.5206611570247933,KC,ATL,2023 REG,7,4,7,5,9,14,0,1,-1,1,1,1,1,1,0,0,0,0,0,0.5206611570247933,0.4793388429752067
89841,0.425531914893617,0.613899613899614,135,-159,0.40875254093905067,0.5912474590609493,home,KC,under,9,0.5,100,0.4793388429752067,KC,ATL,2023 REG,7,4,7,5,9,14,0,1,-1,1,1,1,1,1,0,0,0,0,0,0.5206611570247933,0.4793388429752067
89842,0.7354497354497355,0.3076923076923077,-278,225,0.7037209312341587,0.2962790687658413,away,COL,over,8,0.5348837209302326,-115,0.5109810284308424,TB,COL,2023 REG,11,6,8,5,11,19,1,0,1,-1,1,1,1,1,1,0,0,0,0,0.5109810284308424,0.48901897156915763
89842,0.7354497354497355,0.3076923076923077,-278,225,0.7037209312341587,0.2962790687658413,home,TB,under,8,0.5098039215686274,-104,0.48901897156915763,TB,COL,2023 REG,11,6,8,5,11,19,1,0,1,-1,1,1,1,1,1,0,0,0,0,0.5109810284308424,0.48901897156915763
89843,0.5614035087719298,0.47619047619047616,-128,110,0.5402981137053159,0.4597018862946841,away,WSH,over,9.5,0.5121951219512195,-105,0.48808156828023186,KC,WSH,2023 REG,7,2,8,4,6,15,0,1,-2,2,1,1,0,0,0,0,0,0,0,0.48808156828023186,0.5119184317197681
89843,0.5614035087719298,0.47619047619047616,-128,110,0.5402981137053159,0.4597018862946841,home,KC,under,9.5,0.5348837209302326,-115,0.5119184317197681,KC,WSH,2023 REG,7,2,8,4,6,15,0,1,-2,2,1,1,0,0,0,0,0,0,0,0.48808156828023186,0.5119184317197681
89844,0.3802281368821293,0.6551724137931035,163,-190,0.36676785145428414,0.6332321485457159,away,SEA,over,8.5,0.5454545454545454,-120,0.5206611570247933,DET,SEA,2023 REG,3,0,6,5,5,9,0,1,-5,5,0,0,0,0,0,0,0,0,0,0.5206611570247933,0.4793388429752067
89844,0.3802281368821293,0.6551724137931035,163,-190,0.36676785145428414,0.6332321485457159,home,DET,under,8.5,0.5,100,0.4793388429752067,DET,SEA,2023 REG,3,0,6,5,5,9,0,1,-5,5,0,0,0,0,0,0,0,0,0,0.5206611570247933,0.4793388429752067
89845,0.5833333333333333,0.45248868778280543,-140,121,0.562437154348919,0.43756284565108094,away,ARI,over,8,0.5370370370370371,-116,0.5118817074154765,SD,ARI,2023 REG,8,5,9,4,9,17,1,0,1,-1,1,1,1,1,0,0,0,0,0,0.5118817074154765,0.48811829258452355
89845,0.5833333333333333,0.45248868778280543,-140,121,0.562437154348919,0.43756284565108094,home,SD,under,8,0.5098039215686274,-104,0.48811829258452355,SD,ARI,2023 REG,8,5,9,4,9,17,1,0,1,-1,1,1,1,1,0,0,0,0,0,0.5118817074154765,0.48811829258452355
89846,0.5901639344262295,0.4504504504504505,-144,122,0.5661947892531068,0.43380521074689316,away,KC,over,9.5,0.5,100,0.4772727272727273,BAL,KC,2023 REG,10,6,8,1,7,18,1,0,5,-5,1,0,0,0,0,0,0,0,0,0.4772727272727273,0.5227272727272727
89846,0.5901639344262295,0.4504504504504505,-144,122,0.5661947892531068,0.43380521074689316,home,BAL,under,9.5,0.5454545454545454,-120,0.5227272727272727,BAL,KC,2023 REG,10,6,8,1,7,18,1,0,5,-5,1,0,0,0,0,0,0,0,0,0.4772727272727273,0.5227272727272727
89847,0.6825396825396826,0.35714285714285715,-215,180,0.6554547745023935,0.34454522549760647,away,COL,over,8.5,0.5238095238095238,-110,0.4988662131519274,SF,COL,2023 REG,11,6,6,3,9,17,1,0,3,-3,1,1,1,0,0,0,0,0,0,0.4988662131519274,0.5011337868480725
89847,0.6825396825396826,0.35714285714285715,-215,180,0.6554547745023935,0.34454522549760647,home,SF,under,8.5,0.5238095238095238,-110,0.5011337868480725,SF,COL,2023 REG,11,6,6,3,9,17,1,0,3,-3,1,1,1,0,0,0,0,0,0,0.4988662131519274,0.5011337868480725
89848,0.36363636363636365,0.6721311475409836,175,-205,0.3506299959355101,0.6493700040644899,away,TOR,over,8.5,0.5327102803738317,-114,0.508788710910954,BOS,TOR,2023 REG,16,11,9,5,16,25,1,0,6,-6,1,1,1,1,1,0,0,0,0,0.508788710910954,0.491211289089046
89848,0.36363636363636365,0.6721311475409836,175,-205,0.3506299959355101,0.6493700040644899,home,BOS,under,8.5,0.5121951219512195,-105,0.491211289089046,BOS,TOR,2023 REG,16,11,9,5,16,25,1,0,6,-6,1,1,1,1,1,0,0,0,0,0.508788710910954,0.491211289089046
89849,0.574468085106383,0.46511627906976744,-135,115,0.5517281312179562,0.44827186878204384,away,ARI,over,7,0.5121951219512195,-105,0.48808156828023186,MIA,ARI,2023 REG,4,0,7,5,5,11,0,1,-5,5,0,0,0,0,0,0,0,0,0,0.48808156828023186,0.5119184317197681
89849,0.574468085106383,0.46511627906976744,-135,115,0.5517281312179562,0.44827186878204384,home,MIA,under,7,0.5348837209302326,-115,0.5119184317197681,MIA,ARI,2023 REG,4,0,7,5,5,11,0,1,-5,5,0,0,0,0,0,0,0,0,0,0.48808156828023186,0.5119184317197681
89850,0.576271186440678,0.46511627906976744,-136,115,0.552420782587201,0.44757921741279905,away,NYY,over,9,0.5121951219512195,-105,0.48808156828023186,STL,NYY,2023 REG,12,11,10,4,15,22,1,0,7,-7,1,1,1,1,0,0,0,0,0,0.48808156828023186,0.5119184317197681
89850,0.576271186440678,0.46511627906976744,-136,115,0.552420782587201,0.44757921741279905,home,STL,under,9,0.5348837209302326,-115,0.5119184317197681,STL,NYY,2023 REG,12,11,10,4,15,22,1,0,7,-7,1,1,1,1,0,0,0,0,0,0.48808156828023186,0.5119184317197681
89851,0.36764705882352944,0.6666666666666666,172,-200,0.35503171856978094,0.6449682814302191,away,SD,over,9.5,0.5121951219512195,-105,0.48808156828023186,WSH,SD,2023 REG,12,6,9,8,14,21,0,1,-2,2,1,1,1,1,1,1,0,0,0,0.48808156828023186,0.5119184317197681
89851,0.36764705882352944,0.6666666666666666,172,-200,0.35503171856978094,0.6449682814302191,home,WSH,under,9.5,0.5348837209302326,-115,0.5119184317197681,WSH,SD,2023 REG,12,6,9,8,14,21,0,1,-2,2,1,1,1,1,1,1,0,0,0,0.48808156828023186,0.5119184317197681
89852,0.3125,0.7333333333333333,220,-275,0.2981770833333333,0.7018229166666667,away,ATL,over,9,0.504950495049505,-102,0.47949844489399435,WSH,ATL,2023 REG,8,3,18,10,13,26,0,1,-7,7,1,1,1,0,0,0,0,0,0,0.47949844489399435,0.5205015551060057
89852,0.3125,0.7333333333333333,220,-275,0.2981770833333333,0.7018229166666667,home,WSH,under,9,0.5454545454545454,-120,0.5205015551060057,WSH,ATL,2023 REG,8,3,18,10,13,26,0,1,-7,7,1,1,1,0,0,0,0,0,0,0.47949844489399435,0.5205015551060057
89853,0.5475113122171946,0.49019607843137253,-121,104,0.5268660892829112,0.47313391071708877,away,SD,over,9,0.5121951219512195,-105,0.48808156828023186,ATL,SD,2023 REG,8,2,13,10,12,21,0,1,-8,8,1,1,0,0,0,0,0,0,0,0.48808156828023186,0.5119184317197681
89853,0.5475113122171946,0.49019607843137253,-121,104,0.5268660892829112,0.47313391071708877,home,ATL,under,9,0.5348837209302326,-115,0.5119184317197681,ATL,SD,2023 REG,8,2,13,10,12,21,0,1,-8,8,1,1,0,0,0,0,0,0,0,0.48808156828023186,0.5119184317197681
89854,0.607843137254902,0.4273504273504274,-155,134,0.5864509705340155,0.4135490294659845,away,ARI,over,9.5,0.5121951219512195,-105,0.48808156828023186,PHI,ARI,2023 REG,6,3,10,4,7,16,0,1,-1,1,1,1,1,0,0,0,0,0,0,0.48808156828023186,0.5119184317197681
89854,0.607843137254902,0.4273504273504274,-155,134,0.5864509705340155,0.4135490294659845,home,PHI,under,9.5,0.5348837209302326,-115,0.5119184317197681,PHI,ARI,2023 REG,6,3,10,4,7,16,0,1,-1,1,1,1,1,0,0,0,0,0,0,0.48808156828023186,0.5119184317197681
89855,0.4716981132075471,0.5652173913043479,112,-130,0.4542851393811816,0.5457148606188185,away,BAL,over,9,0.5238095238095238,-110,0.4988662131519274,ARI,BAL,2023 REG,5,3,11,7,10,16,0,1,-4,4,1,1,1,0,0,0,0,0,0,0.4988662131519274,0.5011337868480725
89855,0.4716981132075471,0.5652173913043479,112,-130,0.4542851393811816,0.5457148606188185,home,ARI,under,9,0.5238095238095238,-110,0.5011337868480725,ARI,BAL,2023 REG,5,3,11,7,10,16,0,1,-4,4,1,1,1,0,0,0,0,0,0,0.4988662131519274,0.5011337868480725
89856,0.6551724137931035,0.38167938931297707,-190,162,0.6310281289994645,0.3689718710005355,away,BAL,over,7.5,0.5283018867924528,-112,0.5044173060022736,TEX,BAL,2023 REG,9,5,2,2,7,11,1,0,3,-3,1,1,0,0,0,0,0,0,0,0.5044173060022736,0.49558269399772636
89856,0.6551724137931035,0.38167938931297707,-190,162,0.6310281289994645,0.3689718710005355,home,TEX,under,7.5,0.5169082125603864,-107,0.49558269399772636,TEX,BAL,2023 REG,9,5,2,2,7,11,1,0,3,-3,1,1,0,0,0,0,0,0,0,0.5044173060022736,0.49558269399772636
89857,0.7222222222222222,0.31746031746031744,-260,215,0.693562610229277,0.306437389770723,away,COL,over,8.5,0.5238095238095238,-110,0.4988662131519274,SD,COL,2023 REG,8,3,9,2,5,17,1,0,1,-1,1,1,0,0,0,0,0,0,0,0.4988662131519274,0.5011337868480725
89857,0.7222222222222222,0.31746031746031744,-260,215,0.693562610229277,0.306437389770723,home,SD,under,8.5,0.5238095238095238,-110,0.5011337868480725,SD,COL,2023 REG,8,3,9,2,5,17,1,0,1,-1,1,1,0,0,0,0,0,0,0,0.4988662131519274,0.5011337868480725
89858,0.6363636363636364,0.4081632653061224,-175,145,0.6080283353010626,0.3919716646989374,away,PIT,over,8,0.5145631067961165,-106,0.4913668392989033,MIA,PIT,2023 REG,12,4,6,3,7,18,1,0,1,-1,1,1,1,0,0,0,0,0,0,0.4913668392989033,0.5086331607010968
89858,0.6363636363636364,0.4081632653061224,-175,145,0.6080283353010626,0.3919716646989374,home,MIA,under,8,0.5305164319248826,-113,0.5086331607010968,MIA,PIT,2023 REG,12,4,6,3,7,18,1,0,1,-1,1,1,1,0,0,0,0,0,0,0.4913668392989033,0.5086331607010968
89859,0.5535714285714286,0.48780487804878053,-124,105,0.53066668740667,0.46933331259333,away,TB,over,9,0.5433789954337899,-119,0.5184560714286826,TEX,TB,2023 REG,9,5,10,1,6,19,1,0,4,-4,1,0,0,0,0,0,0,0,0,0.5184560714286826,0.48154392857131745
89859,0.5535714285714286,0.48780487804878053,-124,105,0.53066668740667,0.46933331259333,home,TEX,under,9,0.5024875621890548,-101,0.48154392857131745,TEX,TB,2023 REG,9,5,10,1,6,19,1,0,4,-4,1,0,0,0,0,0,0,0,0,0.5184560714286826,0.48154392857131745
89860,0.6363636363636364,0.4,-175,150,0.6132231404958678,0.3867768595041322,away,CLE,over,9.5,0.5,100,0.4772727272727273,HOU,CLE,2023 REG,7,7,9,3,10,16,1,0,4,-4,1,1,1,0,0,0,0,0,0,0.4772727272727273,0.5227272727272727
89860,0.6363636363636364,0.4,-175,150,0.6132231404958678,0.3867768595041322,home,HOU,under,9.5,0.5454545454545454,-120,0.5227272727272727,HOU,CLE,2023 REG,7,7,9,3,10,16,1,0,4,-4,1,1,1,0,0,0,0,0,0,0.4772727272727273,0.5227272727272727
89861,0.5454545454545454,0.5,-120,100,0.5206611570247933,0.4793388429752067,away,SF,over,9.5,0.5073891625615764,-103,0.4826927225525911,ATL,SF,2023 REG,11,6,11,5,11,22,1,0,1,-1,1,1,1,1,1,0,0,0,0,0.4826927225525911,0.5173072774474089
89861,0.5454545454545454,0.5,-120,100,0.5206611570247933,0.4793388429752067,home,ATL,under,9.5,0.5412844036697247,-118,0.5173072774474089,ATL,SF,2023 REG,11,6,11,5,11,22,1,0,1,-1,1,1,1,1,1,0,0,0,0,0.4826927225525911,0.5173072774474089
89862,0.4184100418410042,0.6183206106870228,139,-162,0.40304156797990504,0.5969584320200949,away,MIN,over,9,0.5238095238095238,-110,0.5000596729920038,KC,MIN,2023 REG,2,0,11,2,2,13,0,1,-2,2,0,0,0,0,0,0,0,0,0,0.5000596729920038,0.4999403270079962
89862,0.4184100418410042,0.6183206106870228,139,-162,0.40304156797990504,0.5969584320200949,home,KC,under,9,0.5215311004784688,-109,0.4999403270079962,KC,MIN,2023 REG,2,0,11,2,2,13,0,1,-2,2,0,0,0,0,0,0,0,0,0,0.5000596729920038,0.4999403270079962
89863,0.6923076923076923,0.35714285714285715,-225,180,0.658072696534235,0.34192730346576505,away,COL,over,8,0.5348837209302326,-115,0.5097020142727117,SF,COL,2023 REG,13,9,11,8,17,24,1,0,1,-1,1,1,1,1,1,1,1,1,0,0.5097020142727117,0.49029798572728833
89863,0.6923076923076923,0.35714285714285715,-225,180,0.658072696534235,0.34192730346576505,home,SF,under,8,0.5121951219512195,-105,0.49029798572728833,SF,COL,2023 REG,13,9,11,8,17,24,1,0,1,-1,1,1,1,1,1,1,1,1,0,0.5097020142727117,0.49029798572728833
89864,0.6825396825396826,0.35714285714285715,-215,180,0.6554547745023935,0.34454522549760647,away,KC,over,9,0.49504950495049505,102,0.4719707862985384,CLE,KC,2023 REG,10,3,7,5,8,17,0,1,-2,2,1,1,1,0,0,0,0,0,0,0.4719707862985384,0.5280292137014616
89864,0.6825396825396826,0.35714285714285715,-215,180,0.6554547745023935,0.34454522549760647,home,CLE,under,9,0.5515695067264574,-123,0.5280292137014616,CLE,KC,2023 REG,10,3,7,5,8,17,0,1,-2,2,1,1,1,0,0,0,0,0,0,0.4719707862985384,0.5280292137014616
89865,0.5454545454545454,0.49504950495049505,-120,102,0.5233614270517961,0.4766385729482039,away,MIN,over,8.5,0.5348837209302326,-115,0.5097020142727117,LAD,MIN,2023 REG,11,9,13,8,17,24,1,0,1,-1,1,1,1,1,1,1,1,1,0,0.5097020142727117,0.49029798572728833
89865,0.5454545454545454,0.49504950495049505,-120,102,0.5233614270517961,0.4766385729482039,home,LAD,under,8.5,0.5121951219512195,-105,0.49029798572728833,LAD,MIN,2023 REG,11,9,13,8,17,24,1,0,1,-1,1,1,1,1,1,1,1,1,0,0.5097020142727117,0.49029798572728833
89866,0.6000000000000001,0.4347826086956522,-150,130,0.5791304347826086,0.4208695652173914,away,CWS,over,7,0.5238095238095238,-110,0.4988662131519274,SEA,CWS,2023 REG,8,3,12,4,7,20,0,1,-1,1,1,1,1,0,0,0,0,0,0,0.4988662131519274,0.5011337868480725
89866,0.6000000000000001,0.4347826086956522,-150,130,0.5791304347826086,0.4208695652173914,home,SEA,under,7,0.5238095238095238,-110,0.5011337868480725,SEA,CWS,2023 REG,8,3,12,4,7,20,0,1,-1,1,1,1,1,0,0,0,0,0,0,0.4988662131519274,0.5011337868480725
89867,0.6875,0.35460992907801414,-220,182,0.6585494237588654,0.3414505762411346,away,KC,over,8,0.5121951219512195,-105,0.48808156828023186,MIN,KC,2023 REG,10,7,3,1,8,13,1,0,6,-6,1,0,0,0,0,0,0,0,0,0.48808156828023186,0.5119184317197681
89867,0.6875,0.35460992907801414,-220,182,0.6585494237588654,0.3414505762411346,home,MIN,under,8,0.5348837209302326,-115,0.5119184317197681,MIN,KC,2023 REG,10,7,3,1,8,13,1,0,6,-6,1,0,0,0,0,0,0,0,0,0.48808156828023186,0.5119184317197681
89868,0.5121951219512195,0.5348837209302326,-105,-115,0.48808156828023186,0.5119184317197681,away,NYM,over,10,0.5073891625615764,-103,0.4837652908580103,BOS,NYM,2023 REG,8,4,13,5,9,21,0,1,-1,1,1,1,1,1,0,0,0,0,0,0.4837652908580103,0.5162347091419897
89868,0.5121951219512195,0.5348837209302326,-105,-115,0.48808156828023186,0.5119184317197681,home,BOS,under,10,0.5391705069124424,-117,0.5162347091419897,BOS,NYM,2023 REG,8,4,13,5,9,21,0,1,-1,1,1,1,1,1,0,0,0,0,0,0.4837652908580103,0.5162347091419897
89869,0.6428571428571428,0.4,-180,150,0.6153061224489796,0.38469387755102036,away,BOS,over,8.5,0.5305164319248826,-113,0.5066009958897986,TEX,BOS,2023 REG,5,2,8,4,6,13,0,1,-2,2,1,1,0,0,0,0,0,0,0,0.5066009958897986,0.49339900411020143
89869,0.6428571428571428,0.4,-180,150,0.6153061224489796,0.38469387755102036,home,TEX,under,8.5,0.5145631067961165,-106,0.49339900411020143,TEX,BOS,2023 REG,5,2,8,4,6,13,0,1,-2,2,1,1,0,0,0,0,0,0,0,0.5066009958897986,0.49339900411020143
89870,0.5348837209302326,0.5073891625615764,-115,-103,0.5122726437136835,0.48772735628631647,away,BOS,over,8.5,0.5,100,0.4772727272727273,NYY,BOS,2023 REG,3,2,7,3,5,10,0,1,-1,1,1,1,0,0,0,0,0,0,0,0.4772727272727273,0.5227272727272727
89870,0.5348837209302326,0.5073891625615764,-115,-103,0.5122726437136835,0.48772735628631647,home,NYY,under,8.5,0.5454545454545454,-120,0.5227272727272727,NYY,BOS,2023 REG,3,2,7,3,5,10,0,1,-1,1,1,1,0,0,0,0,0,0,0,0.4772727272727273,0.5227272727272727
89871,0.4672897196261683,0.574468085106383,114,-135,0.4477767267604901,0.5522232732395099,away,STL,over,9,0.5,100,0.4772727272727273,PIT,STL,2023 REG,10,4,10,6,10,20,0,1,-2,2,1,1,1,1,0,0,0,0,0,0.4772727272727273,0.5227272727272727
89871,0.4672897196261683,0.574468085106383,114,-135,0.4477767267604901,0.5522232732395099,home,PIT,under,9,0.5454545454545454,-120,0.5227272727272727,PIT,STL,2023 REG,10,4,10,6,10,20,0,1,-2,2,1,1,1,1,0,0,0,0,0,0.4772727272727273,0.5227272727272727
89872,0.46511627906976744,0.574468085106383,115,-135,0.44670494689481377,0.5532950531051862,away,DET,over,9.5,0.5,100,0.4772727272727273,KC,DET,2023 REG,6,2,5,3,5,11,0,1,-1,1,1,1,0,0,0,0,0,0,0,0.4772727272727273,0.5227272727272727
89872,0.46511627906976744,0.574468085106383,115,-135,0.44670494689481377,0.5532950531051862,home,KC,under,9.5,0.5454545454545454,-120,0.5227272727272727,KC,DET,2023 REG,6,2,5,3,5,11,0,1,-1,1,1,1,0,0,0,0,0,0,0,0.4772727272727273,0.5227272727272727
89873,0.5098039215686274,0.5305164319248826,-104,-113,0.4892484472386027,0.5107515527613973,away,NYY,over,7.5,0.5098039215686274,-104,0.4870219861770517,MIN,NYY,2023 REG,5,6,14,12,18,19,0,1,-6,6,1,1,1,1,1,1,0,0,0,0.4870219861770517,0.5129780138229483
89873,0.5098039215686274,0.5305164319248826,-104,-113,0.4892484472386027,0.5107515527613973,home,MIN,under,7.5,0.5348837209302326,-115,0.5129780138229483,MIN,NYY,2023 REG,5,6,14,12,18,19,0,1,-6,6,1,1,1,1,1,1,0,0,0,0.4870219861770517,0.5129780138229483
89874,0.7142857142857143,0.3278688524590164,-250,205,0.6841753094680495,0.3158246905319505,away,OAK,over,9,0.5192307692307692,-108,0.49688292476754015,CLE,OAK,2023 REG,10,3,6,2,5,16,1,0,1,-1,1,1,0,0,0,0,0,0,0,0.49688292476754015,0.5031170752324599
89874,0.7142857142857143,0.3278688524590164,-250,205,0.6841753094680495,0.3158246905319505,home,CLE,under,9,0.5238095238095238,-110,0.5031170752324599,CLE,OAK,2023 REG,10,3,6,2,5,16,1,0,1,-1,1,1,0,0,0,0,0,0,0,0.49688292476754015,0.5031170752324599
89875,0.47619047619047616,0.5652173913043479,110,-130,0.4564724440500838,0.5435275559499162,away,CHC,over,13.5,0.5121951219512195,-105,0.48808156828023186,STL,CHC,2023 REG,6,1,14,9,10,20,0,1,-8,8,1,0,0,0,0,0,0,0,0,0.48808156828023186,0.5119184317197681
89875,0.47619047619047616,0.5652173913043479,110,-130,0.4564724440500838,0.5435275559499162,home,STL,under,13.5,0.5348837209302326,-115,0.5119184317197681,STL,CHC,2023 REG,6,1,14,9,10,20,0,1,-8,8,1,0,0,0,0,0,0,0,0,0.48808156828023186,0.5119184317197681
89876,0.6551724137931035,0.3861003861003861,-190,159,0.6281316138628862,0.3718683861371138,away,OAK,over,8,0.5238095238095238,-110,0.5000596729920038,BAL,OAK,2023 REG,6,5,8,1,6,14,1,0,4,-4,1,0,0,0,0,0,0,0,0,0.5000596729920038,0.4999403270079962
89876,0.6551724137931035,0.3861003861003861,-190,159,0.6281316138628862,0.3718683861371138,home,BAL,under,8,0.5215311004784688,-109,0.4999403270079962,BAL,OAK,2023 REG,6,5,8,1,6,14,1,0,4,-4,1,0,0,0,0,0,0,0,0,0.5000596729920038,0.4999403270079962
89877,0.5934959349593496,0.4444444444444444,-146,125,0.5709784740123824,0.42902152598761756,away,KC,over,9,0.5238095238095238,-110,0.5012646084074657,DET,KC,2023 REG,8,6,7,4,10,15,1,0,2,-2,1,1,1,1,0,0,0,0,0,0.5012646084074657,0.4987353915925343
89877,0.5934959349593496,0.4444444444444444,-146,125,0.5709784740123824,0.42902152598761756,home,DET,under,9,0.5192307692307692,-108,0.4987353915925343,DET,KC,2023 REG,8,6,7,4,10,15,1,0,2,-2,1,1,1,1,0,0,0,0,0,0.5012646084074657,0.4987353915925343
89878,0.390625,0.6453900709219857,156,-182,0.3765566129210993,0.6234433870789007,away,CHC,over,8.5,0.504950495049505,-102,0.4837488699364985,MIA,CHC,2023 REG,8,4,9,3,7,17,1,0,1,-1,1,1,1,0,0,0,0,0,0,0.4837488699364985,0.5162511300635015
89878,0.390625,0.6453900709219857,156,-182,0.3765566129210993,0.6234433870789007,home,MIA,under,8.5,0.5370370370370371,-116,0.5162511300635015,MIA,CHC,2023 REG,8,4,9,3,7,17,1,0,1,-1,1,1,1,0,0,0,0,0,0,0.4837488699364985,0.5162511300635015
89879,0.5652173913043479,0.47619047619047616,-130,110,0.5418129444594474,0.4581870555405526,away,MIA,over,7.5,0.5454545454545454,-120,0.5206611570247933,SD,MIA,2023 REG,7,4,4,0,4,11,1,0,4,-4,0,0,0,0,0,0,0,0,0,0.5206611570247933,0.4793388429752067
89879,0.5652173913043479,0.47619047619047616,-130,110,0.5418129444594474,0.4581870555405526,home,SD,under,7.5,0.5,100,0.4793388429752067,SD,MIA,2023 REG,7,4,4,0,4,11,1,0,4,-4,0,0,0,0,0,0,0,0,0,0.5206611570247933,0.4793388429752067
89880,0.45454545454545453,0.5918367346938775,120,-145,0.433462641254849,0.566537358745151,away,SEA,over,9.5,0.5,100,0.4772727272727273,KC,SEA,2023 REG,15,8,14,10,18,29,0,1,-2,2,1,1,1,1,1,1,1,1,0,0.4772727272727273,0.5227272727272727
89880,0.45454545454545453,0.5918367346938775,120,-145,0.433462641254849,0.566537358745151,home,KC,under,9.5,0.5454545454545454,-120,0.5227272727272727,KC,SEA,2023 REG,15,8,14,10,18,29,0,1,-2,2,1,1,1,1,1,1,1,1,0,0.4772727272727273,0.5227272727272727
89881,0.6527777777777778,0.3846153846153846,-188,160,0.6283683523266858,0.37163164767331425,away,DET,over,9.5,0.5192307692307692,-108,0.49455035168025013,TEX,DET,2023 REG,12,8,5,3,11,17,1,0,5,-5,1,1,1,0,0,0,0,0,0,0.49455035168025013,0.5054496483197499
89881,0.6527777777777778,0.3846153846153846,-188,160,0.6283683523266858,0.37163164767331425,home,TEX,under,9.5,0.5283018867924528,-112,0.5054496483197499,TEX,DET,2023 REG,12,8,5,3,11,17,1,0,5,-5,1,1,1,0,0,0,0,0,0,0.49455035168025013,0.5054496483197499
89882,0.6000000000000001,0.4347826086956522,-150,130,0.5791304347826086,0.4208695652173914,away,SF,over,8.5,0.5348837209302326,-115,0.5097020142727117,STL,SF,2023 REG,9,5,11,8,13,20,0,1,-3,3,1,1,1,1,1,0,0,0,0,0.5097020142727117,0.49029798572728833
89882,0.6000000000000001,0.4347826086956522,-150,130,0.5791304347826086,0.4208695652173914,home,STL,under,8.5,0.5121951219512195,-105,0.49029798572728833,STL,SF,2023 REG,9,5,11,8,13,20,0,1,-3,3,1,1,1,1,1,0,0,0,0,0.5097020142727117,0.49029798572728833
89883,0.6503496503496503,0.3921568627450981,-186,155,0.6227055544208978,0.3772944455791022,away,NYM,over,9.5,0.5121951219512195,-105,0.48808156828023186,PHI,NYM,2023 REG,7,7,11,6,13,18,1,0,1,-1,1,1,1,1,1,1,0,0,0,0.48808156828023186,0.5119184317197681
89883,0.6503496503496503,0.3921568627450981,-186,155,0.6227055544208978,0.3772944455791022,home,PHI,under,9.5,0.5348837209302326,-115,0.5119184317197681,PHI,NYM,2023 REG,7,7,11,6,13,18,1,0,1,-1,1,1,1,1,1,1,0,0,0,0.48808156828023186,0.5119184317197681
89884,0.5121951219512195,0.5348837209302326,-105,-115,0.48808156828023186,0.5119184317197681,away,SD,over,9.5,0.5,100,0.4772727272727273,NYY,SD,2023 REG,7,1,9,5,6,16,0,1,-4,4,1,0,0,0,0,0,0,0,0,0.4772727272727273,0.5227272727272727
89884,0.5121951219512195,0.5348837209302326,-105,-115,0.48808156828023186,0.5119184317197681,home,NYY,under,9.5,0.5454545454545454,-120,0.5227272727272727,NYY,SD,2023 REG,7,1,9,5,6,16,0,1,-4,4,1,0,0,0,0,0,0,0,0,0.4772727272727273,0.5227272727272727
89885,0.574468085106383,0.4716981132075471,-135,112,0.547947077564338,0.452052922435662,away,SEA,over,7,0.5238095238095238,-110,0.4988662131519274,HOU,SEA,2023 REG,4,3,5,2,5,9,1,0,1,-1,1,1,0,0,0,0,0,0,0,0.4988662131519274,0.5011337868480725
89885,0.574468085106383,0.4716981132075471,-135,112,0.547947077564338,0.452052922435662,home,HOU,under,7,0.5238095238095238,-110,0.5011337868480725,HOU,SEA,2023 REG,4,3,5,2,5,9,1,0,1,-1,1,1,0,0,0,0,0,0,0,0.4988662131519274,0.5011337868480725
89886,0.4347826086956522,0.607843137254902,130,-155,0.41624967567367205,0.583750324326328,away,MIN,over,9.5,0.5121951219512195,-105,0.48808156828023186,CIN,MIN,2023 REG,9,7,5,3,10,14,1,0,4,-4,1,1,1,0,0,0,0,0,0,0.48808156828023186,0.5119184317197681
89886,0.4347826086956522,0.607843137254902,130,-155,0.41624967567367205,0.583750324326328,home,CIN,under,9.5,0.5348837209302326,-115,0.5119184317197681,CIN,MIN,2023 REG,9,7,5,3,10,14,1,0,4,-4,1,1,1,0,0,0,0,0,0,0.48808156828023186,0.5119184317197681
89887,0.7402597402597403,0.30303030303030304,-285,230,0.7082138640580199,0.2917861359419801,away,KC,over,10,0.5454545454545454,-120,0.5179608869977906,HOU,KC,2023 REG,6,2,7,3,5,13,0,1,-1,1,1,1,0,0,0,0,0,0,0,0.5179608869977906,0.48203911300220936
89887,0.7402597402597403,0.30303030303030304,-285,230,0.7082138640580199,0.2917861359419801,home,HOU,under,10,0.504950495049505,-102,0.48203911300220936,HOU,KC,2023 REG,6,2,7,3,5,13,0,1,-1,1,1,1,0,0,0,0,0,0,0,0.5179608869977906,0.48203911300220936
89888,0.574468085106383,0.46511627906976744,-135,115,0.5517281312179562,0.44827186878204384,away,MIA,over,8.5,0.5192307692307692,-108,0.49688292476754015,TEX,MIA,2023 REG,10,6,7,2,8,17,1,0,4,-4,1,1,0,0,0,0,0,0,0,0.49688292476754015,0.5031170752324599
89888,0.574468085106383,0.46511627906976744,-135,115,0.5517281312179562,0.44827186878204384,home,TEX,under,8.5,0.5238095238095238,-110,0.5031170752324599,TEX,MIA,2023 REG,10,6,7,2,8,17,1,0,4,-4,1,1,0,0,0,0,0,0,0,0.49688292476754015,0.5031170752324599
89889,0.36764705882352944,0.6774193548387096,172,-210,0.35107852438888276,0.6489214756111172,away,ATL,over,8,0.5238095238095238,-110,0.4988662131519274,NYM,ATL,2023 REG,9,8,9,9,17,18,0,1,-1,1,1,1,1,1,1,1,1,1,0,0.4988662131519274,0.5011337868480725
89889,0.36764705882352944,0.6774193548387096,172,-210,0.35107852438888276,0.6489214756111172,home,NYM,under,8,0.5238095238095238,-110,0.5011337868480725,NYM,ATL,2023 REG,9,8,9,9,17,18,0,1,-1,1,1,1,1,1,1,1,1,1,0,0.4988662131519274,0.5011337868480725
89890,0.4444444444444444,0.5918367346938775,125,-145,0.42831947593852354,0.5716805240614764,away,SEA,over,8,0.5348837209302326,-115,0.5109810284308424,HOU,SEA,2023 REG,7,1,6,5,6,13,0,1,-4,4,1,0,0,0,0,0,0,0,0,0.5109810284308424,0.48901897156915763
89890,0.4444444444444444,0.5918367346938775,125,-145,0.42831947593852354,0.5716805240614764,home,HOU,under,8,0.5098039215686274,-104,0.48901897156915763,HOU,SEA,2023 REG,7,1,6,5,6,13,0,1,-4,4,1,0,0,0,0,0,0,0,0,0.5109810284308424,0.48901897156915763
89891,0.5024875621890548,0.5391705069124424,-101,-117,0.4815549006007403,0.5184450993992598,away,PHI,over,7.5,0.49504950495049505,102,0.47297076509898783,MIA,PHI,2023 REG,13,9,12,8,17,25,1,0,1,-1,1,1,1,1,1,1,1,1,0,0.47297076509898783,0.5270292349010122
89891,0.5024875621890548,0.5391705069124424,-101,-117,0.4815549006007403,0.5184450993992598,home,MIA,under,7.5,0.5495495495495495,-122,0.5270292349010122,MIA,PHI,2023 REG,13,9,12,8,17,25,1,0,1,-1,1,1,1,1,1,1,1,1,0,0.47297076509898783,0.5270292349010122
89892,0.5833333333333333,0.45454545454545453,-140,120,0.5612373737373737,0.4387626262626263,away,CIN,over,7.5,0.5121951219512195,-105,0.48808156828023186,MIA,CIN,2023 REG,7,4,11,7,11,18,0,1,-3,3,1,1,1,1,0,0,0,0,0,0.48808156828023186,0.5119184317197681
89892,0.5833333333333333,0.45454545454545453,-140,120,0.5612373737373737,0.4387626262626263,home,MIA,under,7.5,0.5348837209302326,-115,0.5119184317197681,MIA,CIN,2023 REG,7,4,11,7,11,18,0,1,-3,3,1,1,1,1,0,0,0,0,0,0.48808156828023186,0.5119184317197681
89893,0.7590361445783133,0.2777777777777778,-315,260,0.7310930468863406,0.2689069531136594,away,OAK,over,9,0.5348837209302326,-115,0.5097020142727117,LAD,OAK,2023 REG,7,7,6,3,10,13,1,0,4,-4,1,1,1,0,0,0,0,0,0,0.5097020142727117,0.49029798572728833
89893,0.7590361445783133,0.2777777777777778,-315,260,0.7310930468863406,0.2689069531136594,home,LAD,under,9,0.5121951219512195,-105,0.49029798572728833,LAD,OAK,2023 REG,7,7,6,3,10,13,1,0,4,-4,1,1,1,0,0,0,0,0,0,0.5097020142727117,0.49029798572728833
89894,0.48780487804878053,0.5555555555555556,105,-125,0.4666534470222751,0.5333465529777248,away,STL,over,10.5,0.5238095238095238,-110,0.4988662131519274,CIN,STL,2023 REG,6,3,8,4,7,14,0,1,-1,1,1,1,1,0,0,0,0,0,0,0.4988662131519274,0.5011337868480725
89894,0.48780487804878053,0.5555555555555556,105,-125,0.4666534470222751,0.5333465529777248,home,CIN,under,10.5,0.5238095238095238,-110,0.5011337868480725,CIN,STL,2023 REG,6,3,8,4,7,14,0,1,-1,1,1,1,1,0,0,0,0,0,0,0.4988662131519274,0.5011337868480725
89895,0.6226415094339623,0.4166666666666667,-165,140,0.5981666073335706,0.40183339266642937,away,PIT,over,7.5,0.5169082125603864,-107,0.49353874091423283,DET,PIT,2023 REG,1,0,14,8,8,15,0,1,-8,8,0,0,0,0,0,0,0,0,0,0.49353874091423283,0.5064612590857671
89895,0.6226415094339623,0.4166666666666667,-165,140,0.5981666073335706,0.40183339266642937,home,DET,under,7.5,0.5283018867924528,-112,0.5064612590857671,DET,PIT,2023 REG,1,0,14,8,8,15,0,1,-8,8,0,0,0,0,0,0,0,0,0,0.49353874091423283,0.5064612590857671
89896,0.607843137254902,0.4347826086956522,-155,130,0.5819333701084867,0.41806662989151333,away,NYY,over,7.5,0.504950495049505,-102,0.47949844489399435,MIA,NYY,2023 REG,8,3,5,1,4,13,1,0,2,-2,1,0,0,0,0,0,0,0,0,0.47949844489399435,0.5205015551060057
89896,0.607843137254902,0.4347826086956522,-155,130,0.5819333701084867,0.41806662989151333,home,MIA,under,7.5,0.5454545454545454,-120,0.5205015551060057,MIA,NYY,2023 REG,8,3,5,1,4,13,1,0,2,-2,1,0,0,0,0,0,0,0,0,0.47949844489399435,0.5205015551060057
89897,0.626865671641791,0.4132231404958678,-168,142,0.6017353714957959,0.3982646285042041,away,WSH,over,11,0.5192307692307692,-108,0.49455035168025013,COL,WSH,2023 REG,9,1,6,0,1,15,1,0,1,-1,0,0,0,0,0,0,0,0,0,0.49455035168025013,0.5054496483197499
89897,0.626865671641791,0.4132231404958678,-168,142,0.6017353714957959,0.3982646285042041,home,COL,under,11,0.5283018867924528,-112,0.5054496483197499,COL,WSH,2023 REG,9,1,6,0,1,15,1,0,1,-1,0,0,0,0,0,0,0,0,0,0.49455035168025013,0.5054496483197499
89898,0.35460992907801414,0.6875,182,-220,0.3396773301141794,0.6603226698858207,away,LAA,over,7,0.5391705069124424,-117,0.5140669063204599,OAK,LAA,2023 REG,6,2,5,1,3,11,1,0,1,-1,1,0,0,0,0,0,0,0,0,0.5140669063204599,0.4859330936795401
89898,0.35460992907801414,0.6875,182,-220,0.3396773301141794,0.6603226698858207,home,OAK,under,7,0.5073891625615764,-103,0.4859330936795401,OAK,LAA,2023 REG,6,2,5,1,3,11,1,0,1,-1,1,0,0,0,0,0,0,0,0,0.5140669063204599,0.4859330936795401
89899,0.5098039215686274,0.5348837209302326,-104,-115,0.4870219861770517,0.5129780138229483,away,PHI,over,8.5,0.5305164319248826,-113,0.5066009958897986,CWS,PHI,2023 REG,6,2,9,5,7,15,0,1,-3,3,1,1,0,0,0,0,0,0,0,0.5066009958897986,0.49339900411020143
89899,0.5098039215686274,0.5348837209302326,-104,-115,0.4870219861770517,0.5129780138229483,home,CWS,under,8.5,0.5145631067961165,-106,0.49339900411020143,CWS,PHI,2023 REG,6,2,9,5,7,15,0,1,-3,3,1,1,0,0,0,0,0,0,0,0.5066009958897986,0.49339900411020143
89900,0.36363636363636365,0.6774193548387096,175,-210,0.3487070114636097,0.6512929885363903,away,SD,over,12,0.5215311004784688,-109,0.4978845547971712,COL,SD,2023 REG,5,4,12,3,7,17,1,0,1,-1,1,1,1,0,0,0,0,0,0,0.4978845547971712,0.5021154452028288
89900,0.36363636363636365,0.6774193548387096,175,-210,0.3487070114636097,0.6512929885363903,home,COL,under,12,0.5238095238095238,-110,0.5021154452028288,COL,SD,2023 REG,5,4,12,3,7,17,1,0,1,-1,1,1,1,0,0,0,0,0,0,0.4978845547971712,0.5021154452028288
89901,0.5867768595041323,0.45454545454545453,-142,120,0.5625298818386723,0.43747011816132775,away,SF,over,9,0.5121951219512195,-105,0.48808156828023186,NYM,SF,2023 REG,11,8,8,4,12,19,1,0,4,-4,1,1,1,1,0,0,0,0,0,0.48808156828023186,0.5119184317197681
89901,0.5867768595041323,0.45454545454545453,-142,120,0.5625298818386723,0.43747011816132775,home,NYM,under,9,0.5348837209302326,-115,0.5119184317197681,NYM,SF,2023 REG,11,8,8,4,12,19,1,0,4,-4,1,1,1,1,0,0,0,0,0,0.48808156828023186,0.5119184317197681
89902,0.5283018867924528,0.5145631067961165,-112,-106,0.5056562298022652,0.4943437701977348,away,TOR,over,8.5,0.504950495049505,-102,0.4837488699364985,SEA,TOR,2023 REG,10,3,6,2,5,16,1,0,1,-1,1,1,0,0,0,0,0,0,0,0.4837488699364985,0.5162511300635015
89902,0.5283018867924528,0.5145631067961165,-112,-106,0.5056562298022652,0.4943437701977348,home,SEA,under,8.5,0.5370370370370371,-116,0.5162511300635015,SEA,TOR,2023 REG,10,3,6,2,5,16,1,0,1,-1,1,1,0,0,0,0,0,0,0,0.4837488699364985,0.5162511300635015
89903,0.5555555555555556,0.48780487804878053,-125,105,0.5314664257753688,0.46853357422463116,away,OAK,over,11,0.5238095238095238,-110,0.4988662131519274,COL,OAK,2023 REG,11,5,14,8,13,25,0,1,-3,3,1,1,1,1,1,0,0,0,0,0.4988662131519274,0.5011337868480725
89903,0.5555555555555556,0.48780487804878053,-125,105,0.5314664257753688,0.46853357422463116,home,COL,under,11,0.5238095238095238,-110,0.5011337868480725,COL,OAK,2023 REG,11,5,14,8,13,25,0,1,-3,3,1,1,1,1,1,0,0,0,0,0.4988662131519274,0.5011337868480725
89904,0.6923076923076923,0.3508771929824561,-225,185,0.6624104640298972,0.33758953597010277,away,KC,over,11,0.504950495049505,-102,0.48160416005266615,BOS,KC,2023 REG,7,4,7,3,7,14,1,0,1,-1,1,1,1,0,0,0,0,0,0,0.48160416005266615,0.5183958399473338
89904,0.6923076923076923,0.3508771929824561,-225,185,0.6624104640298972,0.33758953597010277,home,BOS,under,11,0.5412844036697247,-118,0.5183958399473338,BOS,KC,2023 REG,7,4,7,3,7,14,1,0,1,-1,1,1,1,0,0,0,0,0,0,0.48160416005266615,0.5183958399473338
89905,0.6226415094339623,0.4166666666666667,-165,140,0.5981666073335706,0.40183339266642937,away,CIN,over,9.5,0.5238095238095238,-110,0.4988662131519274,LAD,CIN,2023 REG,6,0,14,9,9,20,0,1,-9,9,0,0,0,0,0,0,0,0,0,0.4988662131519274,0.5011337868480725
89905,0.6226415094339623,0.4166666666666667,-165,140,0.5981666073335706,0.40183339266642937,home,LAD,under,9.5,0.5238095238095238,-110,0.5011337868480725,LAD,CIN,2023 REG,6,0,14,9,9,20,0,1,-9,9,0,0,0,0,0,0,0,0,0,0.4988662131519274,0.5011337868480725
89906,0.7101449275362319,0.3278688524590164,-245,205,0.6831496344961281,0.3168503655038719,away,WSH,over,7.5,0.5348837209302326,-115,0.5097020142727117,BAL,WSH,2023 REG,6,1,3,0,1,9,1,0,1,-1,0,0,0,0,0,0,0,0,0,0.5097020142727117,0.49029798572728833
89906,0.7101449275362319,0.3278688524590164,-245,205,0.6831496344961281,0.3168503655038719,home,BAL,under,7.5,0.5121951219512195,-105,0.49029798572728833,BAL,WSH,2023 REG,6,1,3,0,1,9,1,0,1,-1,0,0,0,0,0,0,0,0,0,0.5097020142727117,0.49029798572728833
89907,0.6610169491525424,0.37735849056603776,-195,165,0.6356501330673793,0.3643498669326207,away,OAK,over,8.5,0.5121951219512195,-105,0.48808156828023186,NYY,OAK,2023 REG,9,7,10,2,9,19,1,0,5,-5,1,1,0,0,0,0,0,0,0,0.48808156828023186,0.5119184317197681
89907,0.6610169491525424,0.37735849056603776,-195,165,0.6356501330673793,0.3643498669326207,home,NYY,under,8.5,0.5348837209302326,-115,0.5119184317197681,NYY,OAK,2023 REG,9,7,10,2,9,19,1,0,5,-5,1,1,0,0,0,0,0,0,0,0.48808156828023186,0.5119184317197681
89908,0.6551724137931035,0.3846153846153846,-190,160,0.6291045458703008,0.37089545412969915,away,WSH,over,9,0.5348837209302326,-115,0.5097020142727117,SD,WSH,2023 REG,4,0,6,2,2,10,0,1,-2,2,0,0,0,0,0,0,0,0,0,0.5097020142727117,0.49029798572728833
89908,0.6551724137931035,0.3846153846153846,-190,160,0.6291045458703008,0.37089545412969915,home,SD,under,9,0.5121951219512195,-105,0.49029798572728833,SD,WSH,2023 REG,4,0,6,2,2,10,0,1,-2,2,0,0,0,0,0,0,0,0,0,0.5097020142727117,0.49029798572728833
89909,0.6254681647940076,0.40322580645161293,-167,148,0.6075209992583573,0.39247900074164266,away,MIL,over,8.5,0.5475113122171946,-121,0.5242087833606768,SD,MIL,2023 REG,9,2,15,11,13,24,0,1,-9,9,1,1,0,0,0,0,0,0,0,0.5242087833606768,0.4757912166393232
89909,0.6254681647940076,0.40322580645161293,-167,148,0.6075209992583573,0.39247900074164266,home,SD,under,8.5,0.49504950495049505,102,0.4757912166393232,SD,MIL,2023 REG,9,2,15,11,13,24,0,1,-9,9,1,1,0,0,0,0,0,0,0,0.5242087833606768,0.4757912166393232
89910,0.5121951219512195,0.5348837209302326,-105,-115,0.48808156828023186,0.5119184317197681,away,SD,over,8.5,0.5348837209302326,-115,0.5097020142727117,MIA,SD,2023 REG,6,2,2,1,3,8,1,0,1,-1,1,0,0,0,0,0,0,0,0,0.5097020142727117,0.49029798572728833
89910,0.5121951219512195,0.5348837209302326,-105,-115,0.48808156828023186,0.5119184317197681,home,MIA,under,8.5,0.5121951219512195,-105,0.49029798572728833,MIA,SD,2023 REG,6,2,2,1,3,8,1,0,1,-1,1,0,0,0,0,0,0,0,0,0.5097020142727117,0.49029798572728833
89911,0.7142857142857143,0.3225806451612903,-250,210,0.6879526003949967,0.3120473996050033,away,COL,over,9,0.5412844036697247,-118,0.5149381613977361,BAL,COL,2023 REG,5,3,9,4,7,14,0,1,-1,1,1,1,1,0,0,0,0,0,0,0.5149381613977361,0.48506183860226393
89911,0.7142857142857143,0.3225806451612903,-250,210,0.6879526003949967,0.3120473996050033,home,BAL,under,9,0.5073891625615764,-103,0.48506183860226393,BAL,COL,2023 REG,5,3,9,4,7,14,0,1,-1,1,1,1,1,0,0,0,0,0,0,0.5149381613977361,0.48506183860226393
89912,0.6254681647940076,0.4081632653061224,-167,145,0.6044327759298813,0.3955672240701187,away,CIN,over,9.5,0.5121951219512195,-105,0.48808156828023186,BOS,CIN,2023 REG,8,8,7,2,10,15,1,0,6,-6,1,1,0,0,0,0,0,0,0,0.48808156828023186,0.5119184317197681
89912,0.6254681647940076,0.4081632653061224,-167,145,0.6044327759298813,0.3955672240701187,home,BOS,under,9.5,0.5348837209302326,-115,0.5119184317197681,BOS,CIN,2023 REG,8,8,7,2,10,15,1,0,6,-6,1,1,0,0,0,0,0,0,0,0.48808156828023186,0.5119184317197681
89913,0.38167938931297707,0.6575342465753424,162,-192,0.36671235271438185,0.6332876472856181,away,MIA,over,9,0.5238095238095238,-110,0.4988662131519274,WSH,MIA,2023 REG,10,4,10,6,10,20,0,1,-2,2,1,1,1,1,0,0,0,0,0,0.4988662131519274,0.5011337868480725
89913,0.38167938931297707,0.6575342465753424,162,-192,0.36671235271438185,0.6332876472856181,home,WSH,under,9,0.5238095238095238,-110,0.5011337868480725,WSH,MIA,2023 REG,10,4,10,6,10,20,0,1,-2,2,1,1,1,1,0,0,0,0,0,0.4988662131519274,0.5011337868480725
89914,0.6825396825396826,0.35714285714285715,-215,180,0.6554547745023935,0.34454522549760647,away,TEX,over,8,0.5098039215686274,-104,0.4870219861770517,HOU,TEX,2023 REG,4,1,8,9,10,12,0,1,-8,8,1,0,0,0,0,0,0,0,0,0.4870219861770517,0.5129780138229483
89914,0.6825396825396826,0.35714285714285715,-215,180,0.6554547745023935,0.34454522549760647,home,HOU,under,8,0.5348837209302326,-115,0.5129780138229483,HOU,TEX,2023 REG,4,1,8,9,10,12,0,1,-8,8,1,0,0,0,0,0,0,0,0,0.4870219861770517,0.5129780138229483
89915,0.4739336492890995,0.5633187772925764,111,-129,0.4562784708143716,0.5437215291856283,away,NYM,over,7,0.5215311004784688,-109,0.4978845547971712,MIA,NYM,2023 REG,5,3,8,5,8,13,0,1,-2,2,1,1,1,0,0,0,0,0,0,0.4978845547971712,0.5021154452028288
89915,0.4739336492890995,0.5633187772925764,111,-129,0.4562784708143716,0.5437215291856283,home,MIA,under,7,0.5238095238095238,-110,0.5021154452028288,MIA,NYM,2023 REG,5,3,8,5,8,13,0,1,-2,2,1,1,1,0,0,0,0,0,0,0.4978845547971712,0.5021154452028288
89916,0.47619047619047616,0.5652173913043479,110,-130,0.4564724440500838,0.5435275559499162,away,MIL,over,7,0.5,100,0.4772727272727273,MIA,MIL,2023 REG,17,6,8,1,7,25,1,0,5,-5,1,0,0,0,0,0,0,0,0,0.4772727272727273,0.5227272727272727
89916,0.47619047619047616,0.5652173913043479,110,-130,0.4564724440500838,0.5435275559499162,home,MIA,under,7,0.5454545454545454,-120,0.5227272727272727,MIA,MIL,2023 REG,17,6,8,1,7,25,1,0,5,-5,1,0,0,0,0,0,0,0,0,0.4772727272727273,0.5227272727272727
89917,0.45454545454545453,0.5833333333333333,120,-140,0.43732782369146006,0.5626721763085399,away,SD,over,12.5,0.5121951219512195,-105,0.48808156828023186,COL,SD,2023 REG,5,2,9,3,5,14,0,1,-1,1,1,1,0,0,0,0,0,0,0,0.48808156828023186,0.5119184317197681
89917,0.45454545454545453,0.5833333333333333,120,-140,0.43732782369146006,0.5626721763085399,home,COL,under,12.5,0.5348837209302326,-115,0.5119184317197681,COL,SD,2023 REG,5,2,9,3,5,14,0,1,-1,1,1,1,0,0,0,0,0,0,0,0.48808156828023186,0.5119184317197681
89918,0.4098360655737705,0.6309963099630996,144,-171,0.393101485435709,0.606898514564291,away,MIN,over,8.5,0.5098039215686274,-104,0.48375889301574193,DET,MIN,2023 REG,8,3,12,9,12,20,0,1,-6,6,1,1,1,0,0,0,0,0,0,0.48375889301574193,0.5162411069842581
89918,0.4098360655737705,0.6309963099630996,144,-171,0.393101485435709,0.606898514564291,home,DET,under,8.5,0.5412844036697247,-118,0.5162411069842581,DET,MIN,2023 REG,8,3,12,9,12,20,0,1,-6,6,1,1,1,0,0,0,0,0,0,0.48375889301574193,0.5162411069842581
89919,0.5238095238095238,0.5192307692307692,-110,-108,0.5012646084074657,0.4987353915925343,away,STL,over,9,0.5145631067961165,-106,0.49023796582517226,ARI,STL,2023 REG,8,3,5,1,4,13,1,0,2,-2,1,0,0,0,0,0,0,0,0,0.49023796582517226,0.5097620341748277
89919,0.5238095238095238,0.5192307692307692,-110,-108,0.5012646084074657,0.4987353915925343,home,ARI,under,9,0.5327102803738317,-114,0.5097620341748277,ARI,STL,2023 REG,8,3,5,1,4,13,1,0,2,-2,1,0,0,0,0,0,0,0,0,0.49023796582517226,0.5097620341748277
89920,0.5348837209302326,0.5121951219512195,-115,-105,0.5097020142727117,0.49029798572728833,away,NYM,over,6.5,0.5412844036697247,-118,0.5189377998484975,CHC,NYM,2023 REG,8,4,4,2,6,12,1,0,2,-2,1,1,0,0,0,0,0,0,0,0.5189377998484975,0.4810622001515025
89920,0.5348837209302326,0.5121951219512195,-115,-105,0.5097020142727117,0.49029798572728833,home,CHC,under,6.5,0.5,100,0.4810622001515025,CHC,NYM,2023 REG,8,4,4,2,6,12,1,0,2,-2,1,1,0,0,0,0,0,0,0,0.5189377998484975,0.4810622001515025
89922,0.4672897196261683,0.574468085106383,114,-135,0.4477767267604901,0.5522232732395099,away,ATL,over,10,0.5121951219512195,-105,0.48808156828023186,SF,ATL,2023 REG,8,8,6,5,13,14,1,0,3,-3,1,1,1,1,1,0,0,0,0,0.48808156828023186,0.5119184317197681
89922,0.4672897196261683,0.574468085106383,114,-135,0.4477767267604901,0.5522232732395099,home,SF,under,10,0.5348837209302326,-115,0.5119184317197681,SF,ATL,2023 REG,8,8,6,5,13,14,1,0,3,-3,1,1,1,1,1,0,0,0,0,0.48808156828023186,0.5119184317197681
89923,0.6226415094339623,0.4166666666666667,-165,140,0.5981666073335706,0.40183339266642937,away,SF,over,8.5,0.5238095238095238,-110,0.4988662131519274,MIN,SF,2023 REG,4,1,5,4,5,9,0,1,-3,3,1,0,0,0,0,0,0,0,0,0.4988662131519274,0.5011337868480725
89923,0.6226415094339623,0.4166666666666667,-165,140,0.5981666073335706,0.40183339266642937,home,MIN,under,8.5,0.5238095238095238,-110,0.5011337868480725,MIN,SF,2023 REG,4,1,5,4,5,9,0,1,-3,3,1,0,0,0,0,0,0,0,0,0.4988662131519274,0.5011337868480725
89924,0.7142857142857143,0.3278688524590164,-250,205,0.6841753094680495,0.3158246905319505,away,CIN,over,7.5,0.5,100,0.47935779816513757,MIA,CIN,2023 REG,9,5,8,6,11,17,0,1,-1,1,1,1,1,1,1,0,0,0,0,0.47935779816513757,0.5206422018348624
89924,0.7142857142857143,0.3278688524590164,-250,205,0.6841753094680495,0.3158246905319505,home,MIA,under,7.5,0.5412844036697247,-118,0.5206422018348624,MIA,CIN,2023 REG,9,5,8,6,11,17,0,1,-1,1,1,1,1,1,1,0,0,0,0,0.47935779816513757,0.5206422018348624
89925,0.5121951219512195,0.5260663507109005,-105,-111,0.4925977822950117,0.5074022177049883,away,NYM,over,8,0.504950495049505,-102,0.4826715732667395,MIA,NYM,2023 REG,10,2,4,1,3,14,1,0,1,-1,1,0,0,0,0,0,0,0,0,0.4826715732667395,0.5173284267332605
89925,0.5121951219512195,0.5260663507109005,-105,-111,0.4925977822950117,0.5074022177049883,home,MIA,under,8,0.5391705069124424,-117,0.5173284267332605,MIA,NYM,2023 REG,10,2,4,1,3,14,1,0,1,-1,1,0,0,0,0,0,0,0,0,0.4826715732667395,0.5173284267332605
89926,0.5454545454545454,0.5,-120,100,0.5206611570247933,0.4793388429752067,away,MIL,over,8,0.5391705069124424,-117,0.5153817639191344,CLE,MIL,2023 REG,9,4,4,2,6,13,1,0,2,-2,1,1,0,0,0,0,0,0,0,0.5153817639191344,0.4846182360808656
89926,0.5454545454545454,0.5,-120,100,0.5206611570247933,0.4793388429752067,home,CLE,under,8,0.504950495049505,-102,0.4846182360808656,CLE,MIL,2023 REG,9,4,4,2,6,13,1,0,2,-2,1,1,0,0,0,0,0,0,0,0.5153817639191344,0.4846182360808656
89927,0.5121951219512195,0.5327102803738317,-105,-114,0.48919479393107135,0.5108052060689287,away,ARI,over,7.5,0.5348837209302326,-115,0.5097020142727117,SF,ARI,2023 REG,9,4,6,3,7,15,1,0,1,-1,1,1,1,0,0,0,0,0,0,0.5097020142727117,0.49029798572728833
89927,0.5121951219512195,0.5327102803738317,-105,-114,0.48919479393107135,0.5108052060689287,home,SF,under,7.5,0.5121951219512195,-105,0.49029798572728833,SF,ARI,2023 REG,9,4,6,3,7,15,1,0,1,-1,1,1,1,0,0,0,0,0,0,0.5097020142727117,0.49029798572728833
89928,0.5348837209302326,0.5121951219512195,-115,-105,0.5097020142727117,0.49029798572728833,away,TOR,over,8.5,0.5348837209302326,-115,0.5097020142727117,TB,TOR,2023 REG,6,1,27,20,21,33,0,1,-19,19,1,0,0,0,0,0,0,0,0,0.5097020142727117,0.49029798572728833
89928,0.5348837209302326,0.5121951219512195,-115,-105,0.5097020142727117,0.49029798572728833,home,TB,under,8.5,0.5121951219512195,-105,0.49029798572728833,TB,TOR,2023 REG,6,1,27,20,21,33,0,1,-19,19,1,0,0,0,0,0,0,0,0,0.5097020142727117,0.49029798572728833
89929,0.3921568627450981,0.6503496503496503,155,-186,0.3754876419236281,0.6245123580763718,away,NYY,over,8,0.5454545454545454,-120,0.5206611570247933,OAK,NYY,2023 REG,8,4,13,10,14,21,0,1,-6,6,1,1,1,1,0,0,0,0,0,0.5206611570247933,0.4793388429752067
89929,0.3921568627450981,0.6503496503496503,155,-186,0.3754876419236281,0.6245123580763718,home,OAK,under,8,0.5,100,0.4793388429752067,OAK,NYY,2023 REG,8,4,13,10,14,21,0,1,-6,6,1,1,1,1,0,0,0,0,0,0.5206611570247933,0.4793388429752067
89930,0.42016806722689076,0.6183206106870228,138,-162,0.4039963538176834,0.5960036461823166,away,CHC,over,7.5,0.49751243781094534,101,0.47511256217505476,OAK,CHC,2023 REG,5,2,11,12,14,16,0,1,-10,10,1,1,0,0,0,0,0,0,0,0.47511256217505476,0.5248874378249453
89930,0.42016806722689076,0.6183206106870228,138,-162,0.4039963538176834,0.5960036461823166,home,OAK,under,7.5,0.5475113122171946,-121,0.5248874378249453,OAK,CHC,2023 REG,5,2,11,12,14,16,0,1,-10,10,1,1,0,0,0,0,0,0,0,0.47511256217505476,0.5248874378249453
89931,0.37735849056603776,0.6610169491525424,165,-195,0.36287719255902645,0.6371228074409736,away,SD,over,11.5,0.5238095238095238,-110,0.4988662131519274,COL,SD,2023 REG,10,6,15,9,15,25,0,1,-3,3,1,1,1,1,1,1,0,0,0,0.4988662131519274,0.5011337868480725
89931,0.37735849056603776,0.6610169491525424,165,-195,0.36287719255902645,0.6371228074409736,home,COL,under,11.5,0.5238095238095238,-110,0.5011337868480725,COL,SD,2023 REG,10,6,15,9,15,25,0,1,-3,3,1,1,1,1,1,1,0,0,0,0.4988662131519274,0.5011337868480725
89932,0.31545741324921134,0.7237569060773481,217,-262,0.3030869655121263,0.6969130344878737,away,ATL,over,7.5,0.5145631067961165,-106,0.4913668392989033,WSH,ATL,2023 REG,8,2,12,7,9,20,0,1,-5,5,1,1,0,0,0,0,0,0,0,0.4913668392989033,0.5086331607010968
89932,0.31545741324921134,0.7237569060773481,217,-262,0.3030869655121263,0.6969130344878737,home,WSH,under,7.5,0.5305164319248826,-113,0.5086331607010968,WSH,ATL,2023 REG,8,2,12,7,9,20,0,1,-5,5,1,1,0,0,0,0,0,0,0,0.4913668392989033,0.5086331607010968
89933,0.47619047619047616,0.5652173913043479,110,-130,0.4564724440500838,0.5435275559499162,away,SF,over,9,0.5238095238095238,-110,0.4988662131519274,PIT,SF,2023 REG,8,4,10,6,10,18,0,1,-2,2,1,1,1,1,0,0,0,0,0,0.4988662131519274,0.5011337868480725
89933,0.47619047619047616,0.5652173913043479,110,-130,0.4564724440500838,0.5435275559499162,home,PIT,under,9,0.5238095238095238,-110,0.5011337868480725,PIT,SF,2023 REG,8,4,10,6,10,18,0,1,-2,2,1,1,1,1,0,0,0,0,0,0.4988662131519274,0.5011337868480725
89934,0.5726495726495727,0.4672897196261683,-134,114,0.5497783539959433,0.4502216460040567,away,CWS,over,8,0.5348837209302326,-115,0.5097020142727117,MIN,CWS,2023 REG,6,3,10,2,5,16,1,0,1,-1,1,1,0,0,0,0,0,0,0,0.5097020142727117,0.49029798572728833
89934,0.5726495726495727,0.4672897196261683,-134,114,0.5497783539959433,0.4502216460040567,home,MIN,under,8,0.5121951219512195,-105,0.49029798572728833,MIN,CWS,2023 REG,6,3,10,2,5,16,1,0,1,-1,1,1,0,0,0,0,0,0,0,0.5097020142727117,0.49029798572728833
89935,0.6226415094339623,0.41493775933609955,-165,141,0.5992430968035465,0.4007569031964535,away,KC,over,9,0.5,100,0.4772727272727273,TEX,KC,2023 REG,4,1,14,10,11,18,0,1,-9,9,1,0,0,0,0,0,0,0,0,0.4772727272727273,0.5227272727272727
89935,0.6226415094339623,0.41493775933609955,-165,141,0.5992430968035465,0.4007569031964535,home,TEX,under,9,0.5454545454545454,-120,0.5227272727272727,TEX,KC,2023 REG,4,1,14,10,11,18,0,1,-9,9,1,0,0,0,0,0,0,0,0,0.4772727272727273,0.5227272727272727
89936,0.6000000000000001,0.4347826086956522,-150,130,0.5791304347826086,0.4208695652173914,away,PIT,over,7,0.504950495049505,-102,0.48054649490447493,CHC,PIT,2023 REG,12,7,6,2,9,18,1,0,5,-5,1,1,0,0,0,0,0,0,0,0.48054649490447493,0.5194535050955251
89936,0.6000000000000001,0.4347826086956522,-150,130,0.5791304347826086,0.4208695652173914,home,CHC,under,7,0.5433789954337899,-119,0.5194535050955251,CHC,PIT,2023 REG,12,7,6,2,9,18,1,0,5,-5,1,1,0,0,0,0,0,0,0,0.48054649490447493,0.5194535050955251
89937,0.4081632653061224,0.6296296296296295,145,-170,0.39273759390377466,0.6072624060962253,away,MIN,over,10,0.5121951219512195,-105,0.48808156828023186,KC,MIN,2023 REG,9,8,8,5,13,17,1,0,3,-3,1,1,1,1,1,0,0,0,0,0.48808156828023186,0.5119184317197681
89937,0.4081632653061224,0.6296296296296295,145,-170,0.39273759390377466,0.6072624060962253,home,KC,under,10,0.5348837209302326,-115,0.5119184317197681,KC,MIN,2023 REG,9,8,8,5,13,17,1,0,3,-3,1,1,1,1,1,0,0,0,0,0.48808156828023186,0.5119184317197681
89938,0.5238095238095238,0.5192307692307692,-110,-108,0.5012646084074657,0.4987353915925343,away,MIL,over,8.5,0.5370370370370371,-116,0.5118817074154765,PHI,MIL,2023 REG,2,0,8,4,4,10,0,1,-4,4,0,0,0,0,0,0,0,0,0,0.5118817074154765,0.48811829258452355
89938,0.5238095238095238,0.5192307692307692,-110,-108,0.5012646084074657,0.4987353915925343,home,PHI,under,8.5,0.5098039215686274,-104,0.48811829258452355,PHI,MIL,2023 REG,2,0,8,4,4,10,0,1,-4,4,0,0,0,0,0,0,0,0,0,0.5118817074154765,0.48811829258452355
89939,0.5967741935483871,0.4464285714285714,-148,124,0.5709918983202021,0.42900810167979786,away,BOS,over,8.5,0.5073891625615764,-103,0.4837652908580103,TOR,BOS,2023 REG,7,3,9,2,5,16,1,0,1,-1,1,1,0,0,0,0,0,0,0,0.4837652908580103,0.5162347091419897
89939,0.5967741935483871,0.4464285714285714,-148,124,0.5709918983202021,0.42900810167979786,home,TOR,under,8.5,0.5391705069124424,-117,0.5162347091419897,TOR,BOS,2023 REG,7,3,9,2,5,16,1,0,1,-1,1,1,0,0,0,0,0,0,0,0.4837652908580103,0.5162347091419897
89940,0.6666666666666666,0.37037037037037035,-200,170,0.6419753086419753,0.3580246913580247,away,CHC,over,7.5,0.5412844036697247,-118,0.5136310900085983,HOU,CHC,2023 REG,11,6,8,4,10,19,1,0,2,-2,1,1,1,1,0,0,0,0,0,0.5136310900085983,0.4863689099914017
89940,0.6666666666666666,0.37037037037037035,-200,170,0.6419753086419753,0.3580246913580247,home,HOU,under,7.5,0.5098039215686274,-104,0.4863689099914017,HOU,CHC,2023 REG,11,6,8,4,10,19,1,0,2,-2,1,1,1,1,0,0,0,0,0,0.5136310900085983,0.4863689099914017
89941,0.425531914893617,0.607843137254902,135,-155,0.4113297650431834,0.5886702349568166,away,BOS,over,9,0.5,100,0.4772727272727273,WSH,BOS,2023 REG,9,6,4,2,8,13,1,0,4,-4,1,1,0,0,0,0,0,0,0,0.4772727272727273,0.5227272727272727
89941,0.425531914893617,0.607843137254902,135,-155,0.4113297650431834,0.5886702349568166,home,WSH,under,9,0.5454545454545454,-120,0.5227272727272727,WSH,BOS,2023 REG,9,6,4,2,8,13,1,0,4,-4,1,1,0,0,0,0,0,0,0,0.4772727272727273,0.5227272727272727
89942,0.4273504273504274,0.6124031007751938,134,-158,0.41036174011725596,0.5896382598827441,away,TB,over,9,0.504950495049505,-102,0.47949844489399435,NYY,TB,2023 REG,3,1,8,5,6,11,0,1,-4,4,1,0,0,0,0,0,0,0,0,0.47949844489399435,0.5205015551060057
89942,0.4273504273504274,0.6124031007751938,134,-158,0.41036174011725596,0.5896382598827441,home,NYY,under,9,0.5454545454545454,-120,0.5205015551060057,NYY,TB,2023 REG,3,1,8,5,6,11,0,1,-4,4,1,0,0,0,0,0,0,0,0,0.47949844489399435,0.5205015551060057
89943,0.5348837209302326,0.5121951219512195,-115,-105,0.5097020142727117,0.49029798572728833,away,TEX,over,8.5,0.5433789954337899,-119,0.5171177654451503,BAL,TEX,2023 REG,6,3,10,5,8,16,0,1,-2,2,1,1,1,0,0,0,0,0,0,0.5171177654451503,0.4828822345548497
89943,0.5348837209302326,0.5121951219512195,-115,-105,0.5097020142727117,0.49029798572728833,home,BAL,under,8.5,0.504950495049505,-102,0.4828822345548497,BAL,TEX,2023 REG,6,3,10,5,8,16,0,1,-2,2,1,1,1,0,0,0,0,0,0,0.5171177654451503,0.4828822345548497
89944,0.5169082125603864,0.5238095238095238,-107,-110,0.49586088023391106,0.5041391197660889,away,STL,over,8.5,0.5,100,0.4772727272727273,CLE,STL,2023 REG,8,1,2,2,3,10,0,1,-1,1,1,0,0,0,0,0,0,0,0,0.4772727272727273,0.5227272727272727
89944,0.5169082125603864,0.5238095238095238,-107,-110,0.49586088023391106,0.5041391197660889,home,CLE,under,8.5,0.5454545454545454,-120,0.5227272727272727,CLE,STL,2023 REG,8,1,2,2,3,10,0,1,-1,1,1,0,0,0,0,0,0,0,0,0.4772727272727273,0.5227272727272727
89945,0.48780487804878053,0.5555555555555556,105,-125,0.4666534470222751,0.5333465529777248,away,CHC,over,8.5,0.5454545454545454,-120,0.5206611570247933,MIL,CHC,2023 REG,12,6,13,10,16,25,0,1,-4,4,1,1,1,1,1,1,0,0,0,0.5206611570247933,0.4793388429752067
89945,0.48780487804878053,0.5555555555555556,105,-125,0.4666534470222751,0.5333465529777248,home,MIL,under,8.5,0.5,100,0.4793388429752067,MIL,CHC,2023 REG,12,6,13,10,16,25,0,1,-4,4,1,1,1,1,1,1,0,0,0,0.5206611570247933,0.4793388429752067
89946,0.6000000000000001,0.4424778761061947,-150,126,0.5745132743362832,0.4254867256637168,away,MIN,over,9,0.5145631067961165,-106,0.49023796582517226,ATL,MIN,2023 REG,10,6,7,2,8,17,1,0,4,-4,1,1,0,0,0,0,0,0,0,0.49023796582517226,0.5097620341748277
89946,0.6000000000000001,0.4424778761061947,-150,126,0.5745132743362832,0.4254867256637168,home,ATL,under,9,0.5327102803738317,-114,0.5097620341748277,ATL,MIN,2023 REG,10,6,7,2,8,17,1,0,4,-4,1,1,0,0,0,0,0,0,0,0.49023796582517226,0.5097620341748277
89947,0.29411764705882354,0.7468354430379747,240,-295,0.28207262055976523,0.7179273794402348,away,ATL,over,9.5,0.5121951219512195,-105,0.48808156828023186,PIT,ATL,2023 REG,10,5,15,6,11,25,0,1,-1,1,1,1,1,1,1,0,0,0,0,0.48808156828023186,0.5119184317197681
89947,0.29411764705882354,0.7468354430379747,240,-295,0.28207262055976523,0.7179273794402348,home,PIT,under,9.5,0.5348837209302326,-115,0.5119184317197681,PIT,ATL,2023 REG,10,5,15,6,11,25,0,1,-1,1,1,1,1,1,1,0,0,0,0,0.48808156828023186,0.5119184317197681
89948,0.5121951219512195,0.5348837209302326,-105,-115,0.48808156828023186,0.5119184317197681,away,CLE,over,7.5,0.5238095238095238,-110,0.4988662131519274,CWS,CLE,2023 REG,8,3,13,6,9,21,0,1,-3,3,1,1,1,0,0,0,0,0,0,0.4988662131519274,0.5011337868480725
89948,0.5121951219512195,0.5348837209302326,-105,-115,0.48808156828023186,0.5119184317197681,home,CWS,under,7.5,0.5238095238095238,-110,0.5011337868480725,CWS,CLE,2023 REG,8,3,13,6,9,21,0,1,-3,3,1,1,1,0,0,0,0,0,0,0.4988662131519274,0.5011337868480725
89949,0.6428571428571428,0.3921568627450981,-180,155,0.6203481392557023,0.3796518607442977,away,TB,over,8.5,0.5495495495495495,-122,0.5250401592387142,NYY,TB,2023 REG,9,6,13,5,11,22,1,0,1,-1,1,1,1,1,1,0,0,0,0,0.5250401592387142,0.47495984076128583
89949,0.6428571428571428,0.3921568627450981,-180,155,0.6203481392557023,0.3796518607442977,home,NYY,under,8.5,0.49504950495049505,102,0.47495984076128583,NYY,TB,2023 REG,9,6,13,5,11,22,1,0,1,-1,1,1,1,1,1,0,0,0,0,0.5250401592387142,0.47495984076128583
89950,0.6363636363636364,0.4081632653061224,-175,145,0.6080283353010626,0.3919716646989374,away,BAL,over,7.5,0.5238095238095238,-110,0.4988662131519274,TB,BAL,2023 REG,9,6,10,8,14,19,0,1,-2,2,1,1,1,1,1,1,0,0,0,0.4988662131519274,0.5011337868480725
89950,0.6363636363636364,0.4081632653061224,-175,145,0.6080283353010626,0.3919716646989374,home,TB,under,7.5,0.5238095238095238,-110,0.5011337868480725,TB,BAL,2023 REG,9,6,10,8,14,19,0,1,-2,2,1,1,1,1,1,1,0,0,0,0.4988662131519274,0.5011337868480725
89951,0.47846889952153115,0.5555555555555556,109,-125,0.4621892559439777,0.5378107440560222,away,MIN,over,8,0.5283018867924528,-112,0.5056562298022652,MIA,MIN,2023 REG,12,1,10,11,12,22,0,1,-10,10,1,0,0,0,0,0,0,0,0,0.5056562298022652,0.4943437701977348
89951,0.47846889952153115,0.5555555555555556,109,-125,0.4621892559439777,0.5378107440560222,home,MIA,under,8,0.5145631067961165,-106,0.4943437701977348,MIA,MIN,2023 REG,12,1,10,11,12,22,0,1,-10,10,1,0,0,0,0,0,0,0,0,0.5056562298022652,0.4943437701977348
89952,0.6875,0.35714285714285715,-220,180,0.6568080357142857,0.3431919642857143,away,OAK,over,9.5,0.5121951219512195,-105,0.48808156828023186,STL,OAK,2023 REG,14,6,6,2,8,20,1,0,4,-4,1,1,0,0,0,0,0,0,0,0.48808156828023186,0.5119184317197681
89952,0.6875,0.35714285714285715,-220,180,0.6568080357142857,0.3431919642857143,home,STL,under,9.5,0.5348837209302326,-115,0.5119184317197681,STL,OAK,2023 REG,14,6,6,2,8,20,1,0,4,-4,1,1,0,0,0,0,0,0,0,0.48808156828023186,0.5119184317197681
89953,0.425531914893617,0.6153846153846154,135,-160,0.4081206254135181,0.5918793745864819,away,SEA,over,10.5,0.5121951219512195,-105,0.48808156828023186,BOS,SEA,2023 REG,11,9,8,4,13,19,1,0,5,-5,1,1,1,1,0,0,0,0,0,0.48808156828023186,0.5119184317197681
89953,0.425531914893617,0.6153846153846154,135,-160,0.4081206254135181,0.5918793745864819,home,BOS,under,10.5,0.5348837209302326,-115,0.5119184317197681,BOS,SEA,2023 REG,11,9,8,4,13,19,1,0,5,-5,1,1,1,1,0,0,0,0,0,0.48808156828023186,0.5119184317197681
89954,0.4166666666666667,0.6226415094339623,140,-165,0.4002882599580712,0.5997117400419287,away,TEX,over,8,0.5238095238095238,-110,0.4988662131519274,PIT,TEX,2023 REG,6,1,9,6,7,15,0,1,-5,5,1,0,0,0,0,0,0,0,0,0.4988662131519274,0.5011337868480725
89954,0.4166666666666667,0.6226415094339623,140,-165,0.4002882599580712,0.5997117400419287,home,PIT,under,8,0.5238095238095238,-110,0.5011337868480725,PIT,TEX,2023 REG,6,1,9,6,7,15,0,1,-5,5,1,0,0,0,0,0,0,0,0,0.4988662131519274,0.5011337868480725
89955,0.6000000000000001,0.4347826086956522,-150,130,0.5791304347826086,0.4208695652173914,away,NYY,over,8.5,0.5073891625615764,-103,0.48484779035144243,BAL,NYY,2023 REG,12,9,9,3,12,21,1,0,6,-6,1,1,1,0,0,0,0,0,0,0.48484779035144243,0.5151522096485576
89955,0.6000000000000001,0.4347826086956522,-150,130,0.5791304347826086,0.4208695652173914,home,BAL,under,8.5,0.5370370370370371,-116,0.5151522096485576,BAL,NYY,2023 REG,12,9,9,3,12,21,1,0,6,-6,1,1,1,0,0,0,0,0,0,0.48484779035144243,0.5151522096485576
89956,0.6721311475409836,0.36363636363636365,-205,175,0.6480906892086682,0.3519093107913318,away,MIA,over,7.5,0.5,100,0.4772727272727273,TB,MIA,2023 REG,9,4,2,1,5,11,1,0,3,-3,1,0,0,0,0,0,0,0,0,0.4772727272727273,0.5227272727272727
89956,0.6721311475409836,0.36363636363636365,-205,175,0.6480906892086682,0.3519093107913318,home,TB,under,7.5,0.5454545454545454,-120,0.5227272727272727,TB,MIA,2023 REG,9,4,2,1,5,11,1,0,3,-3,1,0,0,0,0,0,0,0,0,0.4772727272727273,0.5227272727272727
89957,0.6402877697841727,0.4,-178,150,0.6144920035194866,0.38550799648051337,away,WSH,over,8.5,0.5121951219512195,-105,0.48808156828023186,NYY,WSH,2023 REG,2,1,7,2,3,9,0,1,-1,1,1,0,0,0,0,0,0,0,0,0.48808156828023186,0.5119184317197681
89957,0.6402877697841727,0.4,-178,150,0.6144920035194866,0.38550799648051337,home,NYY,under,8.5,0.5348837209302326,-115,0.5119184317197681,NYY,WSH,2023 REG,2,1,7,2,3,9,0,1,-1,1,1,0,0,0,0,0,0,0,0,0.48808156828023186,0.5119184317197681
89958,0.5,0.5412844036697247,100,-118,0.47935779816513757,0.5206422018348624,away,TEX,over,9,0.5238095238095238,-110,0.4988662131519274,PIT,TEX,2023 REG,8,2,8,3,5,16,0,1,-1,1,1,1,0,0,0,0,0,0,0,0.4988662131519274,0.5011337868480725
89958,0.5,0.5412844036697247,100,-118,0.47935779816513757,0.5206422018348624,home,PIT,under,9,0.5238095238095238,-110,0.5011337868480725,PIT,TEX,2023 REG,8,2,8,3,5,16,0,1,-1,1,1,1,0,0,0,0,0,0,0,0.4988662131519274,0.5011337868480725
89959,0.35714285714285715,0.6875,180,-220,0.3411989795918367,0.6588010204081634,away,NYM,over,11.5,0.5121951219512195,-105,0.48919479393107135,COL,NYM,2023 REG,8,2,7,5,7,15,0,1,-3,3,1,1,0,0,0,0,0,0,0,0.48919479393107135,0.5108052060689287
89959,0.35714285714285715,0.6875,180,-220,0.3411989795918367,0.6588010204081634,home,COL,under,11.5,0.5327102803738317,-114,0.5108052060689287,COL,NYM,2023 REG,8,2,7,5,7,15,0,1,-3,3,1,1,0,0,0,0,0,0,0,0.48919479393107135,0.5108052060689287
89960,0.5412844036697247,0.5,-118,100,0.5189377998484975,0.4810622001515025,away,TB,over,8.5,0.49504950495049505,102,0.4719707862985384,SF,TB,2023 REG,8,1,14,6,7,22,0,1,-5,5,1,0,0,0,0,0,0,0,0,0.4719707862985384,0.5280292137014616
89960,0.5412844036697247,0.5,-118,100,0.5189377998484975,0.4810622001515025,home,SF,under,8.5,0.5515695067264574,-123,0.5280292137014616,SF,TB,2023 REG,8,1,14,6,7,22,0,1,-5,5,1,0,0,0,0,0,0,0,0,0.4719707862985384,0.5280292137014616
89961,0.5652173913043479,0.47619047619047616,-130,110,0.5418129444594474,0.4581870555405526,away,SD,over,11,0.5,100,0.4772727272727273,CIN,SD,2023 REG,5,4,7,3,7,12,1,0,1,-1,1,1,1,0,0,0,0,0,0,0.4772727272727273,0.5227272727272727
89961,0.5652173913043479,0.47619047619047616,-130,110,0.5418129444594474,0.4581870555405526,home,CIN,under,11,0.5454545454545454,-120,0.5227272727272727,CIN,SD,2023 REG,5,4,7,3,7,12,1,0,1,-1,1,1,1,0,0,0,0,0,0,0.4772727272727273,0.5227272727272727
89962,0.5535714285714286,0.48780487804878053,-124,105,0.53066668740667,0.46933331259333,away,TB,over,9.5,0.5391705069124424,-117,0.5140669063204599,TOR,TB,2023 REG,7,5,8,2,7,15,1,0,3,-3,1,1,0,0,0,0,0,0,0,0.5140669063204599,0.4859330936795401
89962,0.5535714285714286,0.48780487804878053,-124,105,0.53066668740667,0.46933331259333,home,TOR,under,9.5,0.5073891625615764,-103,0.4859330936795401,TOR,TB,2023 REG,7,5,8,2,7,15,1,0,3,-3,1,1,0,0,0,0,0,0,0,0.5140669063204599,0.4859330936795401
89963,0.5073891625615764,0.5327102803738317,-103,-114,0.487043139791394,0.512956860208606,away,CIN,over,9,0.5192307692307692,-108,0.49688292476754015,OAK,CIN,2023 REG,11,7,16,11,18,27,0,1,-4,4,1,1,1,1,1,1,1,0,0,0.49688292476754015,0.5031170752324599
89963,0.5073891625615764,0.5327102803738317,-103,-114,0.487043139791394,0.512956860208606,home,OAK,under,9,0.5238095238095238,-110,0.5031170752324599,OAK,CIN,2023 REG,11,7,16,11,18,27,0,1,-4,4,1,1,1,1,1,1,1,0,0,0.49688292476754015,0.5031170752324599
89964,0.5652173913043479,0.47619047619047616,-130,110,0.5418129444594474,0.4581870555405526,away,STL,over,8,0.5121951219512195,-105,0.48808156828023186,MIA,STL,2023 REG,9,0,7,3,3,16,0,1,-3,3,0,0,0,0,0,0,0,0,0,0.48808156828023186,0.5119184317197681
89964,0.5652173913043479,0.47619047619047616,-130,110,0.5418129444594474,0.4581870555405526,home,MIA,under,8,0.5348837209302326,-115,0.5119184317197681,MIA,STL,2023 REG,9,0,7,3,3,16,0,1,-3,3,0,0,0,0,0,0,0,0,0,0.48808156828023186,0.5119184317197681
89965,0.5475113122171946,0.4926108374384236,-121,103,0.5255439814102724,0.47445601858972763,away,DET,over,9,0.5121951219512195,-105,0.48808156828023186,PIT,DET,2023 REG,8,4,6,1,5,14,1,0,3,-3,1,0,0,0,0,0,0,0,0,0.48808156828023186,0.5119184317197681
89965,0.5475113122171946,0.4926108374384236,-121,103,0.5255439814102724,0.47445601858972763,home,PIT,under,9,0.5348837209302326,-115,0.5119184317197681,PIT,DET,2023 REG,8,4,6,1,5,14,1,0,3,-3,1,0,0,0,0,0,0,0,0,0.48808156828023186,0.5119184317197681
89966,0.5884773662551441,0.45454545454545453,-143,120,0.5631594099815408,0.4368405900184592,away,BAL,over,8,0.5121951219512195,-105,0.48808156828023186,TB,BAL,2023 REG,10,7,4,2,9,14,1,0,5,-5,1,1,0,0,0,0,0,0,0,0.48808156828023186,0.5119184317197681
89966,0.5884773662551441,0.45454545454545453,-143,120,0.5631594099815408,0.4368405900184592,home,TB,under,8,0.5348837209302326,-115,0.5119184317197681,TB,BAL,2023 REG,10,7,4,2,9,14,1,0,5,-5,1,1,0,0,0,0,0,0,0,0.48808156828023186,0.5119184317197681
89967,0.4,0.6428571428571428,150,-180,0.38285714285714295,0.617142857142857,away,CHC,over,11.5,0.5,100,0.4772727272727273,COL,CHC,2023 REG,7,4,12,5,9,19,0,1,-1,1,1,1,1,1,0,0,0,0,0,0.4772727272727273,0.5227272727272727
89967,0.4,0.6428571428571428,150,-180,0.38285714285714295,0.617142857142857,home,COL,under,11.5,0.5454545454545454,-120,0.5227272727272727,COL,CHC,2023 REG,7,4,12,5,9,19,0,1,-1,1,1,1,1,1,0,0,0,0,0,0.4772727272727273,0.5227272727272727
89968,0.6389891696750902,0.4,-177,150,0.614075512518083,0.385924487481917,away,OAK,over,9,0.5,100,0.4772727272727273,DET,OAK,2023 REG,13,9,4,0,9,17,1,0,9,-9,0,0,0,0,0,0,0,0,0,0.4772727272727273,0.5227272727272727
89968,0.6389891696750902,0.4,-177,150,0.614075512518083,0.385924487481917,home,DET,under,9,0.5454545454545454,-120,0.5227272727272727,DET,OAK,2023 REG,13,9,4,0,9,17,1,0,9,-9,0,0,0,0,0,0,0,0,0,0.4772727272727273,0.5227272727272727
89969,0.46511627906976744,0.576271186440678,115,-136,0.44586629511142073,0.5541337048885793,away,SF,over,9,0.5412844036697247,-118,0.5136310900085983,MIL,SF,2023 REG,4,0,11,5,5,15,0,1,-5,5,0,0,0,0,0,0,0,0,0,0.5136310900085983,0.4863689099914017
89969,0.46511627906976744,0.576271186440678,115,-136,0.44586629511142073,0.5541337048885793,home,MIL,under,9,0.5098039215686274,-104,0.4863689099914017,MIL,SF,2023 REG,4,0,11,5,5,15,0,1,-5,5,0,0,0,0,0,0,0,0,0,0.5136310900085983,0.4863689099914017
89970,0.5283018867924528,0.5121951219512195,-112,-105,0.5069072406637203,0.4930927593362797,away,NYY,over,7,0.5535714285714286,-124,0.53066668740667,NYM,NYY,2023 REG,8,4,6,3,7,14,1,0,1,-1,1,1,1,0,0,0,0,0,0,0.53066668740667,0.46933331259333
89970,0.5283018867924528,0.5121951219512195,-112,-105,0.5069072406637203,0.4930927593362797,home,NYM,under,7,0.48780487804878053,105,0.46933331259333,NYM,NYY,2023 REG,8,4,6,3,7,14,1,0,1,-1,1,1,1,0,0,0,0,0,0,0.53066668740667,0.46933331259333
89971,0.7402597402597403,0.3048780487804878,-285,228,0.7068460522689222,0.29315394773107784,away,OAK,over,7.5,0.5121951219512195,-105,0.48808156828023186,MIN,OAK,2023 REG,13,6,9,4,10,22,1,0,2,-2,1,1,1,1,0,0,0,0,0,0.48808156828023186,0.5119184317197681
89971,0.7402597402597403,0.3048780487804878,-285,228,0.7068460522689222,0.29315394773107784,home,MIN,under,7.5,0.5348837209302326,-115,0.5119184317197681,MIN,OAK,2023 REG,13,6,9,4,10,22,1,0,2,-2,1,1,1,1,0,0,0,0,0,0.48808156828023186,0.5119184317197681
89972,0.607843137254902,0.4347826086956522,-155,130,0.5819333701084867,0.41806662989151333,away,PIT,over,9.5,0.5238095238095238,-110,0.4988662131519274,CIN,PIT,2023 REG,7,5,8,7,12,15,0,1,-2,2,1,1,1,1,1,0,0,0,0,0.4988662131519274,0.5011337868480725
89972,0.607843137254902,0.4347826086956522,-155,130,0.5819333701084867,0.41806662989151333,home,CIN,under,9.5,0.5238095238095238,-110,0.5011337868480725,CIN,PIT,2023 REG,7,5,8,7,12,15,0,1,-2,2,1,1,1,1,1,0,0,0,0,0.4988662131519274,0.5011337868480725
89973,0.4098360655737705,0.6296296296296295,144,-170,0.3936616003264754,0.6063383996735245,away,BOS,over,9.5,0.5073891625615764,-103,0.4826927225525911,WSH,BOS,2023 REG,6,4,7,5,9,13,0,1,-1,1,1,1,1,1,0,0,0,0,0,0.4826927225525911,0.5173072774474089
89973,0.4098360655737705,0.6296296296296295,144,-170,0.3936616003264754,0.6063383996735245,home,WSH,under,9.5,0.5412844036697247,-118,0.5173072774474089,WSH,BOS,2023 REG,6,4,7,5,9,13,0,1,-1,1,1,1,1,1,0,0,0,0,0,0.4826927225525911,0.5173072774474089
89974,0.7142857142857143,0.3278688524590164,-250,205,0.6841753094680495,0.3158246905319505,away,DET,over,8,0.5283018867924528,-112,0.5044173060022736,HOU,DET,2023 REG,9,6,9,7,13,18,0,1,-1,1,1,1,1,1,1,1,0,0,0,0.5044173060022736,0.49558269399772636
89974,0.7142857142857143,0.3278688524590164,-250,205,0.6841753094680495,0.3158246905319505,home,HOU,under,8,0.5169082125603864,-107,0.49558269399772636,HOU,DET,2023 REG,9,6,9,7,13,18,0,1,-1,1,1,1,1,1,1,1,0,0,0,0.5044173060022736,0.49558269399772636
89975,0.5689655172413793,0.4716981132075471,-132,112,0.5458293137100936,0.4541706862899064,away,CIN,over,9,0.5098039215686274,-104,0.48483656587239576,ARI,CIN,2023 REG,10,10,8,8,18,18,1,0,2,-2,1,1,1,1,1,1,1,1,0,0.48483656587239576,0.5151634341276042
89975,0.5689655172413793,0.4716981132075471,-132,112,0.5458293137100936,0.4541706862899064,home,ARI,under,9,0.5391705069124424,-117,0.5151634341276042,ARI,CIN,2023 REG,10,10,8,8,18,18,1,0,2,-2,1,1,1,1,1,1,1,1,0,0.48483656587239576,0.5151634341276042
89976,0.48780487804878053,0.5555555555555556,105,-125,0.4666534470222751,0.5333465529777248,away,NYM,over,9.5,0.5024875621890548,-101,0.4794401874631478,PHI,NYM,2023 REG,9,2,9,4,6,18,0,1,-2,2,1,1,0,0,0,0,0,0,0,0.4794401874631478,0.5205598125368522
89976,0.48780487804878053,0.5555555555555556,105,-125,0.4666534470222751,0.5333465529777248,home,PHI,under,9.5,0.5433789954337899,-119,0.5205598125368522,PHI,NYM,2023 REG,9,2,9,4,6,18,0,1,-2,2,1,1,0,0,0,0,0,0,0,0.4794401874631478,0.5205598125368522
89977,0.4608294930875576,0.5833333333333333,117,-140,0.4404779601747047,0.5595220398252954,away,LAD,over,9,0.5238095238095238,-110,0.4988662131519274,CLE,LAD,2023 REG,10,3,15,9,12,25,0,1,-6,6,1,1,1,0,0,0,0,0,0,0.4988662131519274,0.5011337868480725
89977,0.4608294930875576,0.5833333333333333,117,-140,0.4404779601747047,0.5595220398252954,home,CLE,under,9,0.5238095238095238,-110,0.5011337868480725,CLE,LAD,2023 REG,10,3,15,9,12,25,0,1,-6,6,1,1,1,0,0,0,0,0,0,0.4988662131519274,0.5011337868480725
89978,0.49019607843137253,0.5515695067264574,104,-123,0.4697227523736127,0.5302772476263873,away,PHI,over,7.5,0.5391705069124424,-117,0.5140669063204599,TEX,PHI,2023 REG,17,16,9,3,19,26,1,0,13,-13,1,1,1,0,0,0,0,0,0,0.5140669063204599,0.4859330936795401
89978,0.49019607843137253,0.5515695067264574,104,-123,0.4697227523736127,0.5302772476263873,home,TEX,under,7.5,0.5073891625615764,-103,0.4859330936795401,TEX,PHI,2023 REG,17,16,9,3,19,26,1,0,13,-13,1,1,1,0,0,0,0,0,0,0.5140669063204599,0.4859330936795401
89979,0.6363636363636364,0.4,-175,150,0.6132231404958678,0.3867768595041322,away,PHI,over,7.5,0.5348837209302326,-115,0.5097020142727117,NYY,PHI,2023 REG,9,8,11,1,9,20,1,0,7,-7,1,0,0,0,0,0,0,0,0,0.5097020142727117,0.49029798572728833
89979,0.6363636363636364,0.4,-175,150,0.6132231404958678,0.3867768595041322,home,NYY,under,7.5,0.5121951219512195,-105,0.49029798572728833,NYY,PHI,2023 REG,9,8,11,1,9,20,1,0,7,-7,1,0,0,0,0,0,0,0,0,0.5097020142727117,0.49029798572728833
89980,0.47619047619047616,0.5652173913043479,110,-130,0.4564724440500838,0.5435275559499162,away,DET,over,8.5,0.5348837209302326,-115,0.5097020142727117,OAK,DET,2023 REG,6,4,6,1,5,12,1,0,3,-3,1,0,0,0,0,0,0,0,0,0.5097020142727117,0.49029798572728833
89980,0.47619047619047616,0.5652173913043479,110,-130,0.4564724440500838,0.5435275559499162,home,OAK,under,8.5,0.5121951219512195,-105,0.49029798572728833,OAK,DET,2023 REG,6,4,6,1,5,12,1,0,3,-3,1,0,0,0,0,0,0,0,0,0.5097020142727117,0.49029798572728833
89981,0.5555555555555556,0.48780487804878053,-125,105,0.5314664257753688,0.46853357422463116,away,CWS,over,8.5,0.5,100,0.4772727272727273,LAA,CWS,2023 REG,5,2,3,1,3,8,1,0,1,-1,1,0,0,0,0,0,0,0,0,0.4772727272727273,0.5227272727272727
89981,0.5555555555555556,0.48780487804878053,-125,105,0.5314664257753688,0.46853357422463116,home,LAA,under,8.5,0.5454545454545454,-120,0.5227272727272727,LAA,CWS,2023 REG,5,2,3,1,3,8,1,0,1,-1,1,0,0,0,0,0,0,0,0,0.4772727272727273,0.5227272727272727
89982,0.5348837209302326,0.5121951219512195,-115,-105,0.5097020142727117,0.49029798572728833,away,TOR,over,8,0.5121951219512195,-105,0.48919479393107135,BAL,TOR,2023 REG,9,3,12,6,9,21,0,1,-3,3,1,1,1,0,0,0,0,0,0,0.48919479393107135,0.5108052060689287
89982,0.5348837209302326,0.5121951219512195,-115,-105,0.5097020142727117,0.49029798572728833,home,BAL,under,8,0.5327102803738317,-114,0.5108052060689287,BAL,TOR,2023 REG,9,3,12,6,9,21,0,1,-3,3,1,1,1,0,0,0,0,0,0,0.48919479393107135,0.5108052060689287
89983,0.6923076923076923,0.3448275862068966,-225,190,0.6665986533360538,0.33340134666394616,away,WSH,over,8.5,0.5348837209302326,-115,0.5109810284308424,SF,WSH,2023 REG,6,1,11,5,6,17,0,1,-4,4,1,0,0,0,0,0,0,0,0,0.5109810284308424,0.48901897156915763
89983,0.6923076923076923,0.3448275862068966,-225,190,0.6665986533360538,0.33340134666394616,home,SF,under,8.5,0.5098039215686274,-104,0.48901897156915763,SF,WSH,2023 REG,6,1,11,5,6,17,0,1,-4,4,1,0,0,0,0,0,0,0,0,0.5109810284308424,0.48901897156915763
89984,0.4347826086956522,0.6062992125984252,130,-154,0.4169209472634447,0.5830790527365552,away,CLE,over,7.5,0.5348837209302326,-115,0.5109810284308424,OAK,CLE,2023 REG,14,11,16,12,23,30,0,1,-1,1,1,1,1,1,1,1,1,1,1,0.5109810284308424,0.48901897156915763
89984,0.4347826086956522,0.6062992125984252,130,-154,0.4169209472634447,0.5830790527365552,home,OAK,under,7.5,0.5098039215686274,-104,0.48901897156915763,OAK,CLE,2023 REG,14,11,16,12,23,30,0,1,-1,1,1,1,1,1,1,1,1,1,1,0.5109810284308424,0.48901897156915763
89985,0.5327102803738317,0.5024875621890548,-114,-101,0.5139600277936025,0.4860399722063975,away,CLE,over,8,0.5283018867924528,-112,0.5044173060022736,SEA,CLE,2023 REG,9,5,9,6,11,18,0,1,-1,1,1,1,1,1,1,0,0,0,0,0.5044173060022736,0.49558269399772636
89985,0.5327102803738317,0.5024875621890548,-114,-101,0.5139600277936025,0.4860399722063975,home,SEA,under,8,0.5169082125603864,-107,0.49558269399772636,SEA,CLE,2023 REG,9,5,9,6,11,18,0,1,-1,1,1,1,1,1,1,0,0,0,0,0.5044173060022736,0.49558269399772636
89986,0.6875,0.35460992907801414,-220,182,0.6585494237588654,0.3414505762411346,away,COL,over,8.5,0.5327102803738317,-114,0.508788710910954,LAD,COL,2023 REG,13,13,6,4,17,19,1,0,9,-9,1,1,1,1,0,0,0,0,0,0.508788710910954,0.491211289089046
89986,0.6875,0.35460992907801414,-220,182,0.6585494237588654,0.3414505762411346,home,LAD,under,8.5,0.5121951219512195,-105,0.491211289089046,LAD,COL,2023 REG,13,13,6,4,17,19,1,0,9,-9,1,1,1,1,0,0,0,0,0,0.508788710910954,0.491211289089046
89987,0.7183098591549296,0.3225806451612903,-255,210,0.6889378067587716,0.3110621932412284,away,COL,over,9,0.5391705069124424,-117,0.5153817639191344,ATL,COL,2023 REG,11,8,7,3,11,18,1,0,5,-5,1,1,1,0,0,0,0,0,0,0.5153817639191344,0.4846182360808656
89987,0.7183098591549296,0.3225806451612903,-255,210,0.6889378067587716,0.3110621932412284,home,ATL,under,9,0.504950495049505,-102,0.4846182360808656,ATL,COL,2023 REG,11,8,7,3,11,18,1,0,5,-5,1,1,1,0,0,0,0,0,0,0.5153817639191344,0.4846182360808656
89988,0.5652173913043479,0.4716981132075471,-130,112,0.5443521061454507,0.4556478938545493,away,TB,over,8,0.5192307692307692,-108,0.49455035168025013,ARI,TB,2023 REG,10,8,6,4,12,16,1,0,4,-4,1,1,1,1,0,0,0,0,0,0.49455035168025013,0.5054496483197499
89988,0.5652173913043479,0.4716981132075471,-130,112,0.5443521061454507,0.4556478938545493,home,ARI,under,8,0.5283018867924528,-112,0.5054496483197499,ARI,TB,2023 REG,10,8,6,4,12,16,1,0,4,-4,1,1,1,1,0,0,0,0,0,0.49455035168025013,0.5054496483197499
89989,0.42016806722689076,0.6226415094339623,138,-165,0.40218085014249866,0.5978191498575014,away,NYY,over,7.5,0.5348837209302326,-115,0.5109810284308424,PIT,NYY,2023 REG,9,5,11,7,12,20,0,1,-2,2,1,1,1,1,1,0,0,0,0,0.5109810284308424,0.48901897156915763
89989,0.42016806722689076,0.6226415094339623,138,-165,0.40218085014249866,0.5978191498575014,home,PIT,under,7.5,0.5098039215686274,-104,0.48901897156915763,PIT,NYY,2023 REG,9,5,11,7,12,20,0,1,-2,2,1,1,1,1,1,0,0,0,0,0.5109810284308424,0.48901897156915763
89990,0.6000000000000001,0.4444444444444444,-150,125,0.5733333333333334,0.42666666666666664,away,HOU,over,8,0.5348837209302326,-115,0.5071810588305992,LAA,HOU,2023 REG,12,5,10,7,12,22,0,1,-2,2,1,1,1,1,1,0,0,0,0,0.5071810588305992,0.49281894116940084
89990,0.6000000000000001,0.4444444444444444,-150,125,0.5733333333333334,0.42666666666666664,home,LAA,under,8,0.5169082125603864,-107,0.49281894116940084,LAA,HOU,2023 REG,12,5,10,7,12,22,0,1,-2,2,1,1,1,1,1,0,0,0,0,0.5071810588305992,0.49281894116940084
89991,0.5238095238095238,0.5169082125603864,-110,-107,0.5024811857109994,0.4975188142890006,away,DET,over,8.5,0.5348837209302326,-115,0.5097020142727117,CWS,DET,2023 REG,4,0,18,10,10,22,0,1,-10,10,0,0,0,0,0,0,0,0,0,0.5097020142727117,0.49029798572728833
89991,0.5238095238095238,0.5169082125603864,-110,-107,0.5024811857109994,0.4975188142890006,home,CWS,under,8.5,0.5121951219512195,-105,0.49029798572728833,CWS,DET,2023 REG,4,0,18,10,10,22,0,1,-10,10,0,0,0,0,0,0,0,0,0,0.5097020142727117,0.49029798572728833
89992,0.5370370370370371,0.504950495049505,-116,-102,0.514488177212783,0.48551182278721705,away,CIN,over,9,0.5121951219512195,-105,0.48808156828023186,PIT,CIN,2023 REG,6,2,11,9,11,17,0,1,-7,7,1,1,0,0,0,0,0,0,0,0.48808156828023186,0.5119184317197681
89992,0.5370370370370371,0.504950495049505,-116,-102,0.514488177212783,0.48551182278721705,home,PIT,under,9,0.5348837209302326,-115,0.5119184317197681,PIT,CIN,2023 REG,6,2,11,9,11,17,0,1,-7,7,1,1,0,0,0,0,0,0,0,0.48808156828023186,0.5119184317197681
89993,0.46511627906976744,0.574468085106383,115,-135,0.44670494689481377,0.5532950531051862,away,ATL,over,12.5,0.5121951219512195,-105,0.48808156828023186,CIN,ATL,2023 REG,10,6,14,7,13,24,0,1,-1,1,1,1,1,1,1,1,0,0,0,0.48808156828023186,0.5119184317197681
89993,0.46511627906976744,0.574468085106383,115,-135,0.44670494689481377,0.5532950531051862,home,CIN,under,12.5,0.5348837209302326,-115,0.5119184317197681,CIN,ATL,2023 REG,10,6,14,7,13,24,0,1,-1,1,1,1,1,1,1,1,0,0,0,0.48808156828023186,0.5119184317197681
89994,0.5348837209302326,0.5098039215686274,-115,-104,0.5109810284308424,0.48901897156915763,away,STL,over,9.5,0.5121951219512195,-105,0.48919479393107135,SF,STL,2023 REG,9,5,9,4,9,18,1,0,1,-1,1,1,1,1,0,0,0,0,0,0.48919479393107135,0.5108052060689287
89994,0.5348837209302326,0.5098039215686274,-115,-104,0.5109810284308424,0.48901897156915763,home,SF,under,9.5,0.5327102803738317,-114,0.5108052060689287,SF,STL,2023 REG,9,5,9,4,9,18,1,0,1,-1,1,1,1,1,0,0,0,0,0,0.48919479393107135,0.5108052060689287
89995,0.6875,0.35211267605633806,-220,184,0.6602662852112676,0.3397337147887324,away,COL,over,9,0.5454545454545454,-120,0.5193043049216726,HOU,COL,2023 REG,10,6,8,4,10,18,1,0,2,-2,1,1,1,1,0,0,0,0,0,0.5193043049216726,0.48069569507832743
89995,0.6875,0.35211267605633806,-220,184,0.6602662852112676,0.3397337147887324,home,HOU,under,9,0.5024875621890548,-101,0.48069569507832743,HOU,COL,2023 REG,10,6,8,4,10,18,1,0,2,-2,1,1,1,1,0,0,0,0,0,0.5193043049216726,0.48069569507832743
89996,0.6428571428571428,0.4,-180,150,0.6153061224489796,0.38469387755102036,away,TEX,over,8.5,0.5412844036697247,-118,0.5149381613977361,HOU,TEX,2023 REG,6,5,17,13,18,23,0,1,-8,8,1,1,1,1,1,0,0,0,0,0.5149381613977361,0.48506183860226393
89996,0.6428571428571428,0.4,-180,150,0.6153061224489796,0.38469387755102036,home,HOU,under,8.5,0.5073891625615764,-103,0.48506183860226393,HOU,TEX,2023 REG,6,5,17,13,18,23,0,1,-8,8,1,1,1,1,1,0,0,0,0,0.5149381613977361,0.48506183860226393
89997,0.5934959349593496,0.4444444444444444,-146,125,0.5709784740123824,0.42902152598761756,away,MIA,over,8.5,0.5327102803738317,-114,0.508788710910954,ARI,MIA,2023 REG,5,4,7,5,9,12,0,1,-1,1,1,1,1,1,0,0,0,0,0,0.508788710910954,0.491211289089046
89997,0.5934959349593496,0.4444444444444444,-146,125,0.5709784740123824,0.42902152598761756,home,ARI,under,8.5,0.5121951219512195,-105,0.491211289089046,ARI,MIA,2023 REG,5,4,7,5,9,12,0,1,-1,1,1,1,1,1,0,0,0,0,0,0.508788710910954,0.491211289089046
89998,0.6031746031746031,0.4347826086956522,-152,130,0.5802797769671475,0.4197202230328525,away,COL,over,9.5,0.5073891625615764,-103,0.4837652908580103,KC,COL,2023 REG,11,4,8,6,10,19,0,1,-2,2,1,1,1,1,0,0,0,0,0,0.4837652908580103,0.5162347091419897
89998,0.6031746031746031,0.4347826086956522,-152,130,0.5802797769671475,0.4197202230328525,home,KC,under,9.5,0.5391705069124424,-117,0.5162347091419897,KC,COL,2023 REG,11,4,8,6,10,19,0,1,-2,2,1,1,1,1,0,0,0,0,0,0.4837652908580103,0.5162347091419897
89999,0.7727272727272727,0.27027027027027023,-340,270,0.7395018985928078,0.2604981014071922,away,STL,over,10.5,0.5098039215686274,-104,0.4870219861770517,ATL,STL,2023 REG,10,8,8,5,13,18,1,0,3,-3,1,1,1,1,1,0,0,0,0,0.4870219861770517,0.5129780138229483
89999,0.7727272727272727,0.27027027027027023,-340,270,0.7395018985928078,0.2604981014071922,home,ATL,under,10.5,0.5348837209302326,-115,0.5129780138229483,ATL,STL,2023 REG,10,8,8,5,13,18,1,0,3,-3,1,1,1,1,1,0,0,0,0,0.4870219861770517,0.5129780138229483
90000,0.5,0.5454545454545454,100,-120,0.4772727272727273,0.5227272727272727,away,MIL,over,7,0.5098039215686274,-104,0.4870219861770517,CHC,MIL,2023 REG,3,3,5,2,5,8,1,0,1,-1,1,1,0,0,0,0,0,0,0,0.4870219861770517,0.5129780138229483
90000,0.5,0.5454545454545454,100,-120,0.4772727272727273,0.5227272727272727,home,CHC,under,7,0.5348837209302326,-115,0.5129780138229483,CHC,MIL,2023 REG,3,3,5,2,5,8,1,0,1,-1,1,1,0,0,0,0,0,0,0,0.4870219861770517,0.5129780138229483
90001,0.3389830508474576,0.7014925373134329,195,-235,0.3252625124878337,0.6747374875121663,away,SEA,over,9,0.5,100,0.4772727272727273,KC,SEA,2023 REG,9,4,11,6,10,20,0,1,-2,2,1,1,1,1,0,0,0,0,0,0.4772727272727273,0.5227272727272727
90001,0.3389830508474576,0.7014925373134329,195,-235,0.3252625124878337,0.6747374875121663,home,KC,under,9,0.5454545454545454,-120,0.5227272727272727,KC,SEA,2023 REG,9,4,11,6,10,20,0,1,-2,2,1,1,1,1,0,0,0,0,0,0.4772727272727273,0.5227272727272727
90002,0.6363636363636364,0.4,-175,150,0.6132231404958678,0.3867768595041322,away,PIT,over,8.5,0.5121951219512195,-105,0.48808156828023186,LAD,PIT,2023 REG,9,5,7,2,7,16,1,0,3,-3,1,1,0,0,0,0,0,0,0,0.48808156828023186,0.5119184317197681
90002,0.6363636363636364,0.4,-175,150,0.6132231404958678,0.3867768595041322,home,LAD,under,8.5,0.5348837209302326,-115,0.5119184317197681,LAD,PIT,2023 REG,9,5,7,2,7,16,1,0,3,-3,1,1,0,0,0,0,0,0,0,0.48808156828023186,0.5119184317197681
90003,0.7409326424870467,0.29850746268656714,-286,235,0.7117101811407941,0.2882898188592059,away,OAK,over,9,0.5283018867924528,-112,0.5044173060022736,TOR,OAK,2023 REG,11,12,3,1,13,14,1,0,11,-11,1,0,0,0,0,0,0,0,0,0.5044173060022736,0.49558269399772636
90003,0.7409326424870467,0.29850746268656714,-286,235,0.7117101811407941,0.2882898188592059,home,TOR,under,9,0.5169082125603864,-107,0.49558269399772636,TOR,OAK,2023 REG,11,12,3,1,13,14,1,0,11,-11,1,0,0,0,0,0,0,0,0,0.5044173060022736,0.49558269399772636
90004,0.6363636363636364,0.4081632653061224,-175,145,0.6080283353010626,0.3919716646989374,away,WSH,over,9.5,0.5348837209302326,-115,0.5097020142727117,NYM,WSH,2023 REG,10,6,12,11,17,22,0,1,-5,5,1,1,1,1,1,1,0,0,0,0.5097020142727117,0.49029798572728833
90004,0.6363636363636364,0.4081632653061224,-175,145,0.6080283353010626,0.3919716646989374,home,NYM,under,9.5,0.5121951219512195,-105,0.49029798572728833,NYM,WSH,2023 REG,10,6,12,11,17,22,0,1,-5,5,1,1,1,1,1,1,0,0,0,0.5097020142727117,0.49029798572728833
90005,0.5024875621890548,0.5348837209302326,-101,-115,0.48370895723856705,0.5162910427614329,away,TB,over,9.5,0.5121951219512195,-105,0.48808156828023186,BAL,TB,2023 REG,6,2,6,1,3,12,1,0,1,-1,1,0,0,0,0,0,0,0,0,0.48808156828023186,0.5119184317197681
90005,0.5024875621890548,0.5348837209302326,-101,-115,0.48370895723856705,0.5162910427614329,home,BAL,under,9.5,0.5348837209302326,-115,0.5119184317197681,BAL,TB,2023 REG,6,2,6,1,3,12,1,0,1,-1,1,0,0,0,0,0,0,0,0,0.48808156828023186,0.5119184317197681
90006,0.574468085106383,0.4629629629629629,-135,116,0.5529651425984609,0.44703485740153914,away,CLE,over,7.5,0.5121951219512195,-105,0.48919479393107135,MIN,CLE,2023 REG,8,2,12,4,6,20,0,1,-2,2,1,1,0,0,0,0,0,0,0,0.48919479393107135,0.5108052060689287
90006,0.574468085106383,0.4629629629629629,-135,116,0.5529651425984609,0.44703485740153914,home,MIN,under,7.5,0.5327102803738317,-114,0.5108052060689287,MIN,CLE,2023 REG,8,2,12,4,6,20,0,1,-2,2,1,1,0,0,0,0,0,0,0,0.48919479393107135,0.5108052060689287
90007,0.5633187772925764,0.47619047619047616,-129,110,0.5410624729287608,0.45893752707123925,away,ARI,over,8.5,0.5454545454545454,-120,0.5206611570247933,SF,ARI,2023 REG,2,1,6,0,1,8,1,0,1,-1,0,0,0,0,0,0,0,0,0,0.5206611570247933,0.4793388429752067
90007,0.5633187772925764,0.47619047619047616,-129,110,0.5410624729287608,0.45893752707123925,home,SF,under,8.5,0.5,100,0.4793388429752067,SF,ARI,2023 REG,2,1,6,0,1,8,1,0,1,-1,0,0,0,0,0,0,0,0,0,0.5206611570247933,0.4793388429752067
90008,0.607843137254902,0.425531914893617,-155,135,0.5875563408509002,0.41244365914909975,away,STL,over,9,0.5024875621890548,-101,0.4815549006007403,NYM,STL,2023 REG,9,3,8,5,8,17,0,1,-2,2,1,1,1,0,0,0,0,0,0,0.4815549006007403,0.5184450993992598
90008,0.607843137254902,0.425531914893617,-155,135,0.5875563408509002,0.41244365914909975,home,NYM,under,9,0.5391705069124424,-117,0.5184450993992598,NYM,STL,2023 REG,9,3,8,5,8,17,0,1,-2,2,1,1,1,0,0,0,0,0,0,0.4815549006007403,0.5184450993992598
90009,0.5918367346938775,0.45454545454545453,-145,120,0.5643860512665178,0.43561394873348225,away,CLE,over,7.5,0.5348837209302326,-115,0.5097020142727117,SF,CLE,2023 REG,12,6,12,5,11,24,1,0,1,-1,1,1,1,1,1,0,0,0,0,0.5097020142727117,0.49029798572728833
90009,0.5918367346938775,0.45454545454545453,-145,120,0.5643860512665178,0.43561394873348225,home,SF,under,7.5,0.5121951219512195,-105,0.49029798572728833,SF,CLE,2023 REG,12,6,12,5,11,24,1,0,1,-1,1,1,1,1,1,0,0,0,0,0.5097020142727117,0.49029798572728833
90010,0.5238095238095238,0.5215311004784688,-110,-109,0.5000596729920038,0.4999403270079962,away,MIL,over,8,0.5348837209302326,-115,0.5097020142727117,CLE,MIL,2023 REG,10,4,8,5,9,18,0,1,-1,1,1,1,1,1,0,0,0,0,0,0.5097020142727117,0.49029798572728833
90010,0.5238095238095238,0.5215311004784688,-110,-109,0.5000596729920038,0.4999403270079962,home,CLE,under,8,0.5121951219512195,-105,0.49029798572728833,CLE,MIL,2023 REG,10,4,8,5,9,18,0,1,-1,1,1,1,1,1,0,0,0,0,0,0.5097020142727117,0.49029798572728833
90011,0.5121951219512195,0.5348837209302326,-105,-115,0.48808156828023186,0.5119184317197681,away,SD,over,9,0.5433789954337899,-119,0.5198077604720502,ARI,SD,2023 REG,12,9,2,0,9,14,1,0,9,-9,0,0,0,0,0,0,0,0,0,0.5198077604720502,0.48019223952794976
90011,0.5121951219512195,0.5348837209302326,-105,-115,0.48808156828023186,0.5119184317197681,home,ARI,under,9,0.5,100,0.48019223952794976,ARI,SD,2023 REG,12,9,2,0,9,14,1,0,9,-9,0,0,0,0,0,0,0,0,0,0.5198077604720502,0.48019223952794976
90012,0.4347826086956522,0.6000000000000001,130,-150,0.4196597353497164,0.5803402646502835,away,STL,over,9.5,0.5454545454545454,-120,0.5206611570247933,WSH,STL,2023 REG,11,6,11,8,14,22,0,1,-2,2,1,1,1,1,1,1,0,0,0,0.5206611570247933,0.4793388429752067
90012,0.4347826086956522,0.6000000000000001,130,-150,0.4196597353497164,0.5803402646502835,home,WSH,under,9.5,0.5,100,0.4793388429752067,WSH,STL,2023 REG,11,6,11,8,14,22,0,1,-2,2,1,1,1,1,1,1,0,0,0,0.5206611570247933,0.4793388429752067
90013,0.613899613899614,0.425531914893617,-159,135,0.589692613597978,0.410307386402022,away,CIN,over,8.5,0.504950495049505,-102,0.48160416005266615,LAA,CIN,2023 REG,10,4,9,9,13,19,0,1,-5,5,1,1,1,1,0,0,0,0,0,0.48160416005266615,0.5183958399473338
90013,0.613899613899614,0.425531914893617,-159,135,0.589692613597978,0.410307386402022,home,LAA,under,8.5,0.5412844036697247,-118,0.5183958399473338,LAA,CIN,2023 REG,10,4,9,9,13,19,0,1,-5,5,1,1,1,1,0,0,0,0,0,0.48160416005266615,0.5183958399473338
90014,0.7118155619596541,0.3367003367003367,-247,197,0.6772811902910151,0.3227188097089849,away,COL,over,9,0.5145631067961165,-106,0.49023796582517226,STL,COL,2023 REG,11,6,7,2,8,18,1,0,4,-4,1,1,0,0,0,0,0,0,0,0.49023796582517226,0.5097620341748277
90014,0.7118155619596541,0.3367003367003367,-247,197,0.6772811902910151,0.3227188097089849,home,STL,under,9,0.5327102803738317,-114,0.5097620341748277,STL,COL,2023 REG,11,6,7,2,8,18,1,0,4,-4,1,1,0,0,0,0,0,0,0,0.49023796582517226,0.5097620341748277
90015,0.48780487804878053,0.5495495495495495,105,-122,0.4695832060495952,0.5304167939504048,away,CHC,over,9,0.5121951219512195,-105,0.48808156828023186,DET,CHC,2023 REG,11,6,9,7,13,20,0,1,-1,1,1,1,1,1,1,1,0,0,0,0.48808156828023186,0.5119184317197681
90015,0.48780487804878053,0.5495495495495495,105,-122,0.4695832060495952,0.5304167939504048,home,DET,under,9,0.5348837209302326,-115,0.5119184317197681,DET,CHC,2023 REG,11,6,9,7,13,20,0,1,-1,1,1,1,1,1,1,1,0,0,0,0.48808156828023186,0.5119184317197681
90016,0.6453900709219857,0.3921568627450981,-182,155,0.6211576527396834,0.3788423472603166,away,DET,over,7,0.5348837209302326,-115,0.5097020142727117,SEA,DET,2023 REG,6,4,6,5,9,12,0,1,-1,1,1,1,1,1,0,0,0,0,0,0.5097020142727117,0.49029798572728833
90016,0.6453900709219857,0.3921568627450981,-182,155,0.6211576527396834,0.3788423472603166,home,SEA,under,7,0.5121951219512195,-105,0.49029798572728833,SEA,DET,2023 REG,6,4,6,5,9,12,0,1,-1,1,1,1,1,1,0,0,0,0,0,0.5097020142727117,0.49029798572728833
90017,0.5884773662551441,0.4484304932735426,-143,123,0.5667579262855877,0.43324207371441226,away,STL,over,10.5,0.5192307692307692,-108,0.49455035168025013,LAD,STL,2023 REG,7,6,10,3,9,17,1,0,3,-3,1,1,1,0,0,0,0,0,0,0.49455035168025013,0.5054496483197499
90017,0.5884773662551441,0.4484304932735426,-143,123,0.5667579262855877,0.43324207371441226,home,LAD,under,10.5,0.5283018867924528,-112,0.5054496483197499,LAD,STL,2023 REG,7,6,10,3,9,17,1,0,3,-3,1,1,1,0,0,0,0,0,0,0.49455035168025013,0.5054496483197499
90018,0.5967741935483871,0.4444444444444444,-148,125,0.5721759741010521,0.42782402589894786,away,CIN,over,9,0.5,100,0.47935779816513757,LAA,CIN,2023 REG,6,3,12,7,10,18,0,1,-4,4,1,1,1,0,0,0,0,0,0,0.47935779816513757,0.5206422018348624
90018,0.5967741935483871,0.4444444444444444,-148,125,0.5721759741010521,0.42782402589894786,home,LAA,under,9,0.5412844036697247,-118,0.5206422018348624,LAA,CIN,2023 REG,6,3,12,7,10,18,0,1,-4,4,1,1,1,0,0,0,0,0,0,0.47935779816513757,0.5206422018348624
90019,0.41152263374485604,0.6226415094339623,143,-165,0.39746331556427233,0.6025366844357276,away,PHI,over,8.5,0.5238095238095238,-110,0.4988662131519274,PIT,PHI,2023 REG,5,1,7,2,3,12,0,1,-1,1,1,0,0,0,0,0,0,0,0,0.4988662131519274,0.5011337868480725
90019,0.41152263374485604,0.6226415094339623,143,-165,0.39746331556427233,0.6025366844357276,home,PIT,under,8.5,0.5238095238095238,-110,0.5011337868480725,PIT,PHI,2023 REG,5,1,7,2,3,12,0,1,-1,1,1,0,0,0,0,0,0,0,0,0.4988662131519274,0.5011337868480725
90020,0.5238095238095238,0.5238095238095238,-110,-110,0.4988662131519274,0.5011337868480725,away,NYY,over,8,0.5348837209302326,-115,0.5097020142727117,DET,NYY,2023 REG,7,2,6,4,6,13,0,1,-2,2,1,1,0,0,0,0,0,0,0,0.5097020142727117,0.49029798572728833
90020,0.5238095238095238,0.5238095238095238,-110,-110,0.4988662131519274,0.5011337868480725,home,DET,under,8,0.5121951219512195,-105,0.49029798572728833,DET,NYY,2023 REG,7,2,6,4,6,13,0,1,-2,2,1,1,0,0,0,0,0,0,0,0.5097020142727117,0.49029798572728833
90021,0.4347826086956522,0.6031746031746031,130,-152,0.418279473099889,0.581720526900111,away,DET,over,8.5,0.5327102803738317,-114,0.508788710910954,KC,DET,2023 REG,11,4,8,1,5,19,1,0,3,-3,1,0,0,0,0,0,0,0,0,0.508788710910954,0.491211289089046
90021,0.4347826086956522,0.6031746031746031,130,-152,0.418279473099889,0.581720526900111,home,KC,under,8.5,0.5121951219512195,-105,0.491211289089046,KC,DET,2023 REG,11,4,8,1,5,19,1,0,3,-3,1,0,0,0,0,0,0,0,0,0.508788710910954,0.491211289089046
90022,0.36363636363636365,0.6774193548387096,175,-210,0.3487070114636097,0.6512929885363903,away,PHI,over,9.5,0.5192307692307692,-108,0.49455035168025013,CIN,PHI,2023 REG,8,3,23,14,17,31,0,1,-11,11,1,1,1,0,0,0,0,0,0,0.49455035168025013,0.5054496483197499
90022,0.36363636363636365,0.6774193548387096,175,-210,0.3487070114636097,0.6512929885363903,home,CIN,under,9.5,0.5283018867924528,-112,0.5054496483197499,CIN,PHI,2023 REG,8,3,23,14,17,31,0,1,-11,11,1,1,1,0,0,0,0,0,0,0.49455035168025013,0.5054496483197499
90023,0.47619047619047616,0.5594713656387665,110,-127,0.4592086467479796,0.5407913532520203,away,CWS,over,8.5,0.5327102803738317,-114,0.508788710910954,KC,CWS,2023 REG,14,12,8,5,17,22,1,0,7,-7,1,1,1,1,1,0,0,0,0,0.508788710910954,0.491211289089046
90023,0.47619047619047616,0.5594713656387665,110,-127,0.4592086467479796,0.5407913532520203,home,KC,under,8.5,0.5121951219512195,-105,0.491211289089046,KC,CWS,2023 REG,14,12,8,5,17,22,1,0,7,-7,1,1,1,1,1,0,0,0,0,0.508788710910954,0.491211289089046
90024,0.5391705069124424,0.49504950495049505,-117,102,0.5207200857697526,0.4792799142302474,away,TB,over,8.5,0.5121951219512195,-105,0.48919479393107135,SD,TB,2023 REG,4,2,3,0,2,7,1,0,2,-2,0,0,0,0,0,0,0,0,0,0.48919479393107135,0.5108052060689287
90024,0.5391705069124424,0.49504950495049505,-117,102,0.5207200857697526,0.4792799142302474,home,SD,under,8.5,0.5327102803738317,-114,0.5108052060689287,SD,TB,2023 REG,4,2,3,0,2,7,1,0,2,-2,0,0,0,0,0,0,0,0,0,0.48919479393107135,0.5108052060689287
90025,0.5454545454545454,0.4926108374384236,-120,103,0.5246916093311078,0.4753083906688922,away,TB,over,9,0.5169082125603864,-107,0.49353874091423283,BOS,TB,2023 REG,12,8,10,5,13,22,1,0,3,-3,1,1,1,1,1,0,0,0,0,0.49353874091423283,0.5064612590857671
90025,0.5454545454545454,0.4926108374384236,-120,103,0.5246916093311078,0.4753083906688922,home,BOS,under,9,0.5283018867924528,-112,0.5064612590857671,BOS,TB,2023 REG,12,8,10,5,13,22,1,0,3,-3,1,1,1,1,1,0,0,0,0,0.49353874091423283,0.5064612590857671
90026,0.3921568627450981,0.6551724137931035,155,-190,0.37359636214188174,0.6264036378581183,away,MIL,over,8.5,0.5348837209302326,-115,0.5097020142727117,PIT,MIL,2023 REG,9,4,6,2,6,15,1,0,2,-2,1,1,0,0,0,0,0,0,0,0.5097020142727117,0.49029798572728833
90026,0.3921568627450981,0.6551724137931035,155,-190,0.37359636214188174,0.6264036378581183,home,PIT,under,8.5,0.5121951219512195,-105,0.49029798572728833,PIT,MIL,2023 REG,9,4,6,2,6,15,1,0,2,-2,1,1,0,0,0,0,0,0,0,0.5097020142727117,0.49029798572728833
90027,0.36363636363636365,0.6721311475409836,175,-205,0.3506299959355101,0.6493700040644899,away,TB,over,8.5,0.5327102803738317,-114,0.508788710910954,OAK,TB,2023 REG,5,3,10,4,7,15,0,1,-1,1,1,1,1,0,0,0,0,0,0,0.508788710910954,0.491211289089046
90027,0.36363636363636365,0.6721311475409836,175,-205,0.3506299959355101,0.6493700040644899,home,OAK,under,8.5,0.5121951219512195,-105,0.491211289089046,OAK,TB,2023 REG,5,3,10,4,7,15,0,1,-1,1,1,1,1,0,0,0,0,0,0,0.508788710910954,0.491211289089046
90028,0.5555555555555556,0.48780487804878053,-125,105,0.5314664257753688,0.46853357422463116,away,CIN,over,7.5,0.5024875621890548,-101,0.48049269377245407,MIL,CIN,2023 REG,14,7,4,3,10,18,1,0,4,-4,1,1,1,0,0,0,0,0,0,0.48049269377245407,0.5195073062275459
90028,0.5555555555555556,0.48780487804878053,-125,105,0.5314664257753688,0.46853357422463116,home,MIL,under,7.5,0.5412844036697247,-118,0.5195073062275459,MIL,CIN,2023 REG,14,7,4,3,10,18,1,0,4,-4,1,1,1,0,0,0,0,0,0,0.48049269377245407,0.5195073062275459
90029,0.4807692307692307,0.5594713656387665,108,-127,0.46142279018846283,0.5385772098115371,away,STL,over,9.5,0.5454545454545454,-120,0.5193043049216726,CHC,STL,2023 REG,15,8,10,6,14,25,1,0,2,-2,1,1,1,1,1,1,0,0,0,0.5193043049216726,0.48069569507832743
90029,0.4807692307692307,0.5594713656387665,108,-127,0.46142279018846283,0.5385772098115371,home,CHC,under,9.5,0.5024875621890548,-101,0.48069569507832743,CHC,STL,2023 REG,15,8,10,6,14,25,1,0,2,-2,1,1,1,1,1,1,0,0,0,0.5193043049216726,0.48069569507832743
90030,0.6551724137931035,0.37878787878787884,-190,164,0.6329225669297013,0.3670774330702987,away,LAD,over,8.5,0.5238095238095238,-110,0.4988662131519274,ATL,LAD,2023 REG,5,1,9,8,9,14,0,1,-7,7,1,0,0,0,0,0,0,0,0,0.4988662131519274,0.5011337868480725
90030,0.6551724137931035,0.37878787878787884,-190,164,0.6329225669297013,0.3670774330702987,home,ATL,under,8.5,0.5238095238095238,-110,0.5011337868480725,ATL,LAD,2023 REG,5,1,9,8,9,14,0,1,-7,7,1,0,0,0,0,0,0,0,0,0.4988662131519274,0.5011337868480725
90031,0.6610169491525424,0.373134328358209,-195,168,0.6384423758827237,0.3615576241172763,away,TEX,over,8.5,0.5169082125603864,-107,0.49353874091423283,TB,TEX,2023 REG,12,7,5,3,10,17,1,0,4,-4,1,1,1,0,0,0,0,0,0,0.49353874091423283,0.5064612590857671
90031,0.6610169491525424,0.373134328358209,-195,168,0.6384423758827237,0.3615576241172763,home,TB,under,8.5,0.5283018867924528,-112,0.5064612590857671,TB,TEX,2023 REG,12,7,5,3,10,17,1,0,4,-4,1,1,1,0,0,0,0,0,0,0.49353874091423283,0.5064612590857671
90032,0.6551724137931035,0.3846153846153846,-190,160,0.6291045458703008,0.37089545412969915,away,PIT,over,8.5,0.5121951219512195,-105,0.48808156828023186,SD,PIT,2023 REG,4,2,5,3,5,9,0,1,-1,1,1,1,0,0,0,0,0,0,0,0.48808156828023186,0.5119184317197681
90032,0.6551724137931035,0.3846153846153846,-190,160,0.6291045458703008,0.37089545412969915,home,SD,under,8.5,0.5348837209302326,-115,0.5119184317197681,SD,PIT,2023 REG,4,2,5,3,5,9,0,1,-1,1,1,1,0,0,0,0,0,0,0,0.48808156828023186,0.5119184317197681
90033,0.31746031746031744,0.7222222222222222,215,-260,0.3048626858150668,0.6951373141849332,away,ATL,over,8.5,0.5283018867924528,-112,0.5031902949311281,OAK,ATL,2023 REG,5,2,4,1,3,9,1,0,1,-1,1,0,0,0,0,0,0,0,0,0.5031902949311281,0.4968097050688719
90033,0.31746031746031744,0.7222222222222222,215,-260,0.3048626858150668,0.6951373141849332,home,OAK,under,8.5,0.5192307692307692,-108,0.4968097050688719,OAK,ATL,2023 REG,5,2,4,1,3,9,1,0,1,-1,1,0,0,0,0,0,0,0,0,0.5031902949311281,0.4968097050688719
90034,0.47619047619047616,0.5594713656387665,110,-127,0.4592086467479796,0.5407913532520203,away,TB,over,9.5,0.5,100,0.4772727272727273,CIN,TB,2023 REG,4,0,17,10,10,21,0,1,-10,10,0,0,0,0,0,0,0,0,0,0.4772727272727273,0.5227272727272727
90034,0.47619047619047616,0.5594713656387665,110,-127,0.4592086467479796,0.5407913532520203,home,CIN,under,9.5,0.5454545454545454,-120,0.5227272727272727,CIN,TB,2023 REG,4,0,17,10,10,21,0,1,-10,10,0,0,0,0,0,0,0,0,0,0.4772727272727273,0.5227272727272727
90035,0.607843137254902,0.4291845493562232,-155,133,0.5853361120599043,0.4146638879400957,away,CIN,over,8.5,0.5,100,0.4772727272727273,MIA,CIN,2023 REG,11,3,5,1,4,16,1,0,2,-2,1,0,0,0,0,0,0,0,0,0.4772727272727273,0.5227272727272727
90035,0.607843137254902,0.4291845493562232,-155,133,0.5853361120599043,0.4146638879400957,home,MIA,under,8.5,0.5454545454545454,-120,0.5227272727272727,MIA,CIN,2023 REG,11,3,5,1,4,16,1,0,2,-2,1,0,0,0,0,0,0,0,0,0.4772727272727273,0.5227272727272727
90036,0.6363636363636364,0.4,-175,150,0.6132231404958678,0.3867768595041322,away,LAA,over,9.5,0.5121951219512195,-105,0.48808156828023186,PHI,LAA,2023 REG,13,12,11,7,19,24,1,0,5,-5,1,1,1,1,1,1,1,0,0,0.48808156828023186,0.5119184317197681
90036,0.6363636363636364,0.4,-175,150,0.6132231404958678,0.3867768595041322,home,PHI,under,9.5,0.5348837209302326,-115,0.5119184317197681,PHI,LAA,2023 REG,13,12,11,7,19,24,1,0,5,-5,1,1,1,1,1,1,1,0,0,0.48808156828023186,0.5119184317197681
90037,0.5454545454545454,0.5,-120,100,0.5206611570247933,0.4793388429752067,away,CHC,over,8,0.5169082125603864,-107,0.49353874091423283,SF,CHC,2023 REG,7,2,7,3,5,14,0,1,-1,1,1,1,0,0,0,0,0,0,0,0.49353874091423283,0.5064612590857671
90037,0.5454545454545454,0.5,-120,100,0.5206611570247933,0.4793388429752067,home,SF,under,8,0.5283018867924528,-112,0.5064612590857671,SF,CHC,2023 REG,7,2,7,3,5,14,0,1,-1,1,1,1,0,0,0,0,0,0,0,0.49353874091423283,0.5064612590857671
90038,0.6226415094339623,0.4166666666666667,-165,140,0.5981666073335706,0.40183339266642937,away,BOS,over,8,0.5305164319248826,-113,0.5066009958897986,NYY,BOS,2023 REG,2,1,12,8,9,14,0,1,-7,7,1,0,0,0,0,0,0,0,0,0.5066009958897986,0.49339900411020143
90038,0.6226415094339623,0.4166666666666667,-165,140,0.5981666073335706,0.40183339266642937,home,NYY,under,8,0.5145631067961165,-106,0.49339900411020143,NYY,BOS,2023 REG,2,1,12,8,9,14,0,1,-7,7,1,0,0,0,0,0,0,0,0,0.5066009958897986,0.49339900411020143
90039,0.6875,0.35714285714285715,-220,180,0.6568080357142857,0.3431919642857143,away,NYY,over,10.5,0.5283018867924528,-112,0.5031902949311281,ATL,NYY,2023 REG,6,5,1,0,5,7,1,0,5,-5,0,0,0,0,0,0,0,0,0,0.5031902949311281,0.4968097050688719
90039,0.6875,0.35714285714285715,-220,180,0.6568080357142857,0.3431919642857143,home,ATL,under,10.5,0.5192307692307692,-108,0.4968097050688719,ATL,NYY,2023 REG,6,5,1,0,5,7,1,0,5,-5,0,0,0,0,0,0,0,0,0,0.5031902949311281,0.4968097050688719
90040,0.4098360655737705,0.6309963099630996,144,-171,0.393101485435709,0.606898514564291,away,LAA,over,7.5,0.5283018867924528,-112,0.5056562298022652,OAK,LAA,2023 REG,5,1,11,13,14,16,0,1,-12,12,1,0,0,0,0,0,0,0,0,0.5056562298022652,0.4943437701977348
90040,0.4098360655737705,0.6309963099630996,144,-171,0.393101485435709,0.606898514564291,home,OAK,under,7.5,0.5145631067961165,-106,0.4943437701977348,OAK,LAA,2023 REG,5,1,11,13,14,16,0,1,-12,12,1,0,0,0,0,0,0,0,0,0.5056562298022652,0.4943437701977348
90041,0.5833333333333333,0.45248868778280543,-140,121,0.562437154348919,0.43756284565108094,away,MIN,over,8.5,0.5121951219512195,-105,0.48808156828023186,NYY,MIN,2023 REG,6,6,5,1,7,11,1,0,5,-5,1,0,0,0,0,0,0,0,0,0.48808156828023186,0.5119184317197681
90041,0.5833333333333333,0.45248868778280543,-140,121,0.562437154348919,0.43756284565108094,home,NYY,under,8.5,0.5348837209302326,-115,0.5119184317197681,NYY,MIN,2023 REG,6,6,5,1,7,11,1,0,5,-5,1,0,0,0,0,0,0,0,0,0.48808156828023186,0.5119184317197681
90042,0.607843137254902,0.425531914893617,-155,135,0.5875563408509002,0.41244365914909975,away,KC,over,9,0.5238095238095238,-110,0.4988662131519274,BAL,KC,2023 REG,14,11,8,3,14,22,1,0,8,-8,1,1,1,0,0,0,0,0,0,0.4988662131519274,0.5011337868480725
90042,0.607843137254902,0.425531914893617,-155,135,0.5875563408509002,0.41244365914909975,home,BAL,under,9,0.5238095238095238,-110,0.5011337868480725,BAL,KC,2023 REG,14,11,8,3,14,22,1,0,8,-8,1,1,1,0,0,0,0,0,0,0.4988662131519274,0.5011337868480725
90043,0.7142857142857143,0.3278688524590164,-250,205,0.6841753094680495,0.3158246905319505,away,WSH,over,8,0.5121951219512195,-105,0.48808156828023186,TOR,WSH,2023 REG,9,6,7,3,9,16,1,0,3,-3,1,1,1,0,0,0,0,0,0,0.48808156828023186,0.5119184317197681
90043,0.7142857142857143,0.3278688524590164,-250,205,0.6841753094680495,0.3158246905319505,home,TOR,under,8,0.5348837209302326,-115,0.5119184317197681,TOR,WSH,2023 REG,9,6,7,3,9,16,1,0,3,-3,1,1,1,0,0,0,0,0,0,0.48808156828023186,0.5119184317197681
90044,0.6923076923076923,0.35460992907801414,-225,182,0.6598262621175878,0.34017373788241223,away,KC,over,7.5,0.5121951219512195,-105,0.48919479393107135,MIN,KC,2023 REG,7,8,10,4,12,17,1,0,4,-4,1,1,1,1,0,0,0,0,0,0.48919479393107135,0.5108052060689287
90044,0.6923076923076923,0.35460992907801414,-225,182,0.6598262621175878,0.34017373788241223,home,MIN,under,7.5,0.5327102803738317,-114,0.5108052060689287,MIN,KC,2023 REG,7,8,10,4,12,17,1,0,4,-4,1,1,1,1,0,0,0,0,0,0.48919479393107135,0.5108052060689287
90045,0.5454545454545454,0.5,-120,100,0.5206611570247933,0.4793388429752067,away,BAL,over,9,0.5121951219512195,-105,0.48808156828023186,NYY,BAL,2023 REG,7,8,7,4,12,14,1,0,4,-4,1,1,1,1,0,0,0,0,0,0.48808156828023186,0.5119184317197681
90045,0.5454545454545454,0.5,-120,100,0.5206611570247933,0.4793388429752067,home,NYY,under,9,0.5348837209302326,-115,0.5119184317197681,NYY,BAL,2023 REG,7,8,7,4,12,14,1,0,4,-4,1,1,1,1,0,0,0,0,0,0.48808156828023186,0.5119184317197681
90046,0.45454545454545453,0.5833333333333333,120,-140,0.43732782369146006,0.5626721763085399,away,SD,over,10,0.5121951219512195,-105,0.48808156828023186,DET,SD,2023 REG,8,3,18,14,17,26,0,1,-11,11,1,1,1,0,0,0,0,0,0,0.48808156828023186,0.5119184317197681
90046,0.45454545454545453,0.5833333333333333,120,-140,0.43732782369146006,0.5626721763085399,home,DET,under,10,0.5348837209302326,-115,0.5119184317197681,DET,SD,2023 REG,8,3,18,14,17,26,0,1,-11,11,1,1,1,0,0,0,0,0,0,0.48808156828023186,0.5119184317197681
90047,0.36363636363636365,0.6774193548387096,175,-210,0.3487070114636097,0.6512929885363903,away,MIL,over,8.5,0.5305164319248826,-113,0.5053568787472517,WSH,MIL,2023 REG,7,5,10,3,8,17,1,0,2,-2,1,1,1,0,0,0,0,0,0,0.5053568787472517,0.49464312125274834
90047,0.36363636363636365,0.6774193548387096,175,-210,0.3487070114636097,0.6512929885363903,home,WSH,under,8.5,0.5169082125603864,-107,0.49464312125274834,WSH,MIL,2023 REG,7,5,10,3,8,17,1,0,2,-2,1,1,1,0,0,0,0,0,0,0.5053568787472517,0.49464312125274834
90048,0.5555555555555556,0.47846889952153115,-125,109,0.5366530805127296,0.46334691948727036,away,NYM,over,8.5,0.5454545454545454,-120,0.5193043049216726,SF,NYM,2023 REG,7,7,10,4,11,17,1,0,3,-3,1,1,1,1,0,0,0,0,0,0.5193043049216726,0.48069569507832743
90048,0.5555555555555556,0.47846889952153115,-125,109,0.5366530805127296,0.46334691948727036,home,SF,under,8.5,0.5024875621890548,-101,0.48069569507832743,SF,NYM,2023 REG,7,7,10,4,11,17,1,0,3,-3,1,1,1,1,0,0,0,0,0,0.5193043049216726,0.48069569507832743
90049,0.6108949416342413,0.425531914893617,-157,135,0.5886419592417365,0.41135804075826354,away,DET,over,7,0.5238095238095238,-110,0.4988662131519274,MIA,DET,2023 REG,13,8,10,6,14,23,1,0,2,-2,1,1,1,1,1,1,0,0,0,0.4988662131519274,0.5011337868480725
90049,0.6108949416342413,0.425531914893617,-157,135,0.5886419592417365,0.41135804075826354,home,MIA,under,7,0.5238095238095238,-110,0.5011337868480725,MIA,DET,2023 REG,13,8,10,6,14,23,1,0,2,-2,1,1,1,1,1,1,0,0,0,0.4988662131519274,0.5011337868480725
90050,0.5145631067961165,0.5238095238095238,-106,-110,0.4948179667757384,0.5051820332242616,away,TEX,over,8.5,0.5575221238938054,-126,0.5322513175010363,HOU,TEX,2023 REG,9,10,10,9,19,19,1,0,1,-1,1,1,1,1,1,1,1,1,1,0.5322513175010363,0.46774868249896373
90050,0.5145631067961165,0.5238095238095238,-106,-110,0.4948179667757384,0.5051820332242616,home,HOU,under,8.5,0.48780487804878053,105,0.46774868249896373,HOU,TEX,2023 REG,9,10,10,9,19,19,1,0,1,-1,1,1,1,1,1,1,1,1,1,0.5322513175010363,0.46774868249896373
90051,0.48780487804878053,0.5555555555555556,105,-125,0.4666534470222751,0.5333465529777248,away,ARI,over,9,0.5348837209302326,-115,0.5097020142727117,DET,ARI,2023 REG,6,0,7,5,5,13,0,1,-5,5,0,0,0,0,0,0,0,0,0,0.5097020142727117,0.49029798572728833
90051,0.48780487804878053,0.5555555555555556,105,-125,0.4666534470222751,0.5333465529777248,home,DET,under,9,0.5121951219512195,-105,0.49029798572728833,DET,ARI,2023 REG,6,0,7,5,5,13,0,1,-5,5,0,0,0,0,0,0,0,0,0,0.5097020142727117,0.49029798572728833
90052,0.7333333333333333,0.3076923076923077,-275,225,0.7032478632478633,0.29675213675213674,away,WSH,over,9.5,0.5169082125603864,-107,0.49353874091423283,ATL,WSH,2023 REG,9,2,9,6,8,18,0,1,-4,4,1,1,0,0,0,0,0,0,0,0.49353874091423283,0.5064612590857671
90052,0.7333333333333333,0.3076923076923077,-275,225,0.7032478632478633,0.29675213675213674,home,ATL,under,9.5,0.5283018867924528,-112,0.5064612590857671,ATL,WSH,2023 REG,9,2,9,6,8,18,0,1,-4,4,1,1,0,0,0,0,0,0,0,0.49353874091423283,0.5064612590857671
90053,0.6000000000000001,0.4347826086956522,-150,130,0.5791304347826086,0.4208695652173914,away,CIN,over,9,0.5412844036697247,-118,0.5189377998484975,HOU,CIN,2023 REG,13,7,10,9,16,23,0,1,-2,2,1,1,1,1,1,1,1,0,0,0.5189377998484975,0.4810622001515025
90053,0.6000000000000001,0.4347826086956522,-150,130,0.5791304347826086,0.4208695652173914,home,HOU,under,9,0.5,100,0.4810622001515025,HOU,CIN,2023 REG,13,7,10,9,16,23,0,1,-2,2,1,1,1,1,1,1,1,0,0,0.5189377998484975,0.4810622001515025
90054,0.7601918465227817,0.273972602739726,-317,265,0.7342203107524821,0.26577968924751794,away,CWS,over,8.5,0.5454545454545454,-120,0.5206611570247933,TEX,CWS,2023 REG,8,5,9,3,8,17,1,0,2,-2,1,1,1,0,0,0,0,0,0,0.5206611570247933,0.4793388429752067
90054,0.7601918465227817,0.273972602739726,-317,265,0.7342203107524821,0.26577968924751794,home,TEX,under,8.5,0.5,100,0.4793388429752067,TEX,CWS,2023 REG,8,5,9,3,8,17,1,0,2,-2,1,1,1,0,0,0,0,0,0,0.5206611570247933,0.4793388429752067
90055,0.37735849056603776,0.6610169491525424,165,-195,0.36287719255902645,0.6371228074409736,away,STL,over,10,0.5305164319248826,-113,0.5066009958897986,CIN,STL,2023 REG,8,6,7,5,11,15,1,0,1,-1,1,1,1,1,1,0,0,0,0,0.5066009958897986,0.49339900411020143
90055,0.37735849056603776,0.6610169491525424,165,-195,0.36287719255902645,0.6371228074409736,home,CIN,under,10,0.5145631067961165,-106,0.49339900411020143,CIN,STL,2023 REG,8,6,7,5,11,15,1,0,1,-1,1,1,1,1,1,0,0,0,0,0.5066009958897986,0.49339900411020143
90056,0.48780487804878053,0.5555555555555556,105,-125,0.4666534470222751,0.5333465529777248,away,MIN,over,7.5,0.5121951219512195,-105,0.48808156828023186,DET,MIN,2023 REG,6,3,12,6,9,18,0,1,-3,3,1,1,1,0,0,0,0,0,0,0.48808156828023186,0.5119184317197681
90056,0.48780487804878053,0.5555555555555556,105,-125,0.4666534470222751,0.5333465529777248,home,DET,under,7.5,0.5348837209302326,-115,0.5119184317197681,DET,MIN,2023 REG,6,3,12,6,9,18,0,1,-3,3,1,1,1,0,0,0,0,0,0,0.48808156828023186,0.5119184317197681
90057,0.6124031007751938,0.425531914893617,-158,135,0.5891715795516586,0.41082842044834145,away,SD,over,8.5,0.5215311004784688,-109,0.49670754937970685,ATL,SD,2023 REG,13,7,7,6,13,20,1,0,1,-1,1,1,1,1,1,1,0,0,0,0.49670754937970685,0.5032924506202932
90057,0.6124031007751938,0.425531914893617,-158,135,0.5891715795516586,0.41082842044834145,home,ATL,under,8.5,0.5260663507109005,-111,0.5032924506202932,ATL,SD,2023 REG,13,7,7,6,13,20,1,0,1,-1,1,1,1,1,1,1,0,0,0,0.49670754937970685,0.5032924506202932
90058,0.5098039215686274,0.5305164319248826,-104,-113,0.4892484472386027,0.5107515527613973,away,TEX,over,8,0.5391705069124424,-117,0.5140669063204599,CIN,TEX,2023 REG,8,7,10,6,13,18,1,0,1,-1,1,1,1,1,1,1,0,0,0,0.5140669063204599,0.4859330936795401
90058,0.5098039215686274,0.5305164319248826,-104,-113,0.4892484472386027,0.5107515527613973,home,CIN,under,8,0.5073891625615764,-103,0.4859330936795401,CIN,TEX,2023 REG,8,7,10,6,13,18,1,0,1,-1,1,1,1,1,1,1,0,0,0,0.5140669063204599,0.4859330936795401
90059,0.41152263374485604,0.6296296296296295,143,-170,0.39458754593642575,0.6054124540635742,away,NYY,over,10.5,0.5121951219512195,-105,0.48808156828023186,CIN,NYY,2023 REG,6,2,7,6,8,13,0,1,-4,4,1,1,0,0,0,0,0,0,0,0.48808156828023186,0.5119184317197681
90059,0.41152263374485604,0.6296296296296295,143,-170,0.39458754593642575,0.6054124540635742,home,CIN,under,10.5,0.5348837209302326,-115,0.5119184317197681,CIN,NYY,2023 REG,6,2,7,6,8,13,0,1,-4,4,1,1,0,0,0,0,0,0,0,0.48808156828023186,0.5119184317197681
90060,0.7142857142857143,0.3225806451612903,-250,210,0.6879526003949967,0.3120473996050033,away,COL,over,8.5,0.5454545454545454,-120,0.5206611570247933,ARI,COL,2023 REG,6,5,8,1,6,14,1,0,4,-4,1,0,0,0,0,0,0,0,0,0.5206611570247933,0.4793388429752067
90060,0.7142857142857143,0.3225806451612903,-250,210,0.6879526003949967,0.3120473996050033,home,ARI,under,8.5,0.5,100,0.4793388429752067,ARI,COL,2023 REG,6,5,8,1,6,14,1,0,4,-4,1,0,0,0,0,0,0,0,0,0.5206611570247933,0.4793388429752067
90061,0.5121951219512195,0.5348837209302326,-105,-115,0.48808156828023186,0.5119184317197681,away,SEA,over,9.5,0.49504950495049505,102,0.4719707862985384,ARI,SEA,2023 REG,9,4,10,3,7,19,1,0,1,-1,1,1,1,0,0,0,0,0,0,0.4719707862985384,0.5280292137014616
90061,0.5121951219512195,0.5348837209302326,-105,-115,0.48808156828023186,0.5119184317197681,home,ARI,under,9.5,0.5515695067264574,-123,0.5280292137014616,ARI,SEA,2023 REG,9,4,10,3,7,19,1,0,1,-1,1,1,1,0,0,0,0,0,0,0.4719707862985384,0.5280292137014616
90062,0.646643109540636,0.39370078740157477,-183,154,0.6205550065709379,0.3794449934290621,away,KC,over,10,0.5169082125603864,-107,0.49353874091423283,BOS,KC,2023 REG,6,3,15,9,12,21,0,1,-6,6,1,1,1,0,0,0,0,0,0,0.49353874091423283,0.5064612590857671
90062,0.646643109540636,0.39370078740157477,-183,154,0.6205550065709379,0.3794449934290621,home,BOS,under,10,0.5283018867924528,-112,0.5064612590857671,BOS,KC,2023 REG,6,3,15,9,12,21,0,1,-6,6,1,1,1,0,0,0,0,0,0,0.49353874091423283,0.5064612590857671
90063,0.6402877697841727,0.4,-178,150,0.6144920035194866,0.38550799648051337,away,CLE,over,8.5,0.5,100,0.4772727272727273,TOR,CLE,2023 REG,11,8,5,3,11,16,1,0,5,-5,1,1,1,0,0,0,0,0,0,0.4772727272727273,0.5227272727272727
90063,0.6402877697841727,0.4,-178,150,0.6144920035194866,0.38550799648051337,home,TOR,under,8.5,0.5454545454545454,-120,0.5227272727272727,TOR,CLE,2023 REG,11,8,5,3,11,16,1,0,5,-5,1,1,1,0,0,0,0,0,0,0.4772727272727273,0.5227272727272727
90064,0.3448275862068966,0.696969696969697,190,-230,0.3304147299391057,0.6695852700608943,away,BOS,over,8.5,0.5121951219512195,-105,0.48919479393107135,OAK,BOS,2023 REG,10,6,6,5,11,16,1,0,1,-1,1,1,1,1,1,0,0,0,0,0.48919479393107135,0.5108052060689287
90064,0.3448275862068966,0.696969696969697,190,-230,0.3304147299391057,0.6695852700608943,home,OAK,under,8.5,0.5327102803738317,-114,0.5108052060689287,OAK,BOS,2023 REG,10,6,6,5,11,16,1,0,1,-1,1,1,1,1,1,0,0,0,0,0.48919479393107135,0.5108052060689287
90065,0.5815899581589958,0.4629629629629629,-139,116,0.5556784266278149,0.44432157337218514,away,NYM,over,8.5,0.5238095238095238,-110,0.4988662131519274,LAD,NYM,2023 REG,9,6,14,8,14,23,0,1,-2,2,1,1,1,1,1,1,0,0,0,0.4988662131519274,0.5011337868480725
90065,0.5815899581589958,0.4629629629629629,-139,116,0.5556784266278149,0.44432157337218514,home,LAD,under,8.5,0.5238095238095238,-110,0.5011337868480725,LAD,NYM,2023 REG,9,6,14,8,14,23,0,1,-2,2,1,1,1,1,1,1,0,0,0,0.4988662131519274,0.5011337868480725
90066,0.5535714285714286,0.48780487804878053,-124,105,0.53066668740667,0.46933331259333,away,CHC,over,8,0.504950495049505,-102,0.47949844489399435,DET,CHC,2023 REG,5,4,9,6,10,14,0,1,-2,2,1,1,1,1,0,0,0,0,0,0.47949844489399435,0.5205015551060057
90066,0.5535714285714286,0.48780487804878053,-124,105,0.53066668740667,0.46933331259333,home,DET,under,8,0.5454545454545454,-120,0.5205015551060057,DET,CHC,2023 REG,5,4,9,6,10,14,0,1,-2,2,1,1,1,1,0,0,0,0,0,0.47949844489399435,0.5205015551060057
90067,0.6183206106870228,0.4166666666666667,-162,140,0.5966872559874133,0.40331274401258665,away,PIT,over,6.5,0.5495495495495495,-122,0.5250401592387142,SEA,PIT,2023 REG,7,6,15,11,17,22,0,1,-5,5,1,1,1,1,1,1,0,0,0,0.5250401592387142,0.47495984076128583
90067,0.6183206106870228,0.4166666666666667,-162,140,0.5966872559874133,0.40331274401258665,home,SEA,under,6.5,0.49504950495049505,102,0.47495984076128583,SEA,PIT,2023 REG,7,6,15,11,17,22,0,1,-5,5,1,1,1,1,1,1,0,0,0,0.5250401592387142,0.47495984076128583
90068,0.607843137254902,0.43103448275862066,-155,132,0.5842116427368785,0.41578835726312147,away,SF,over,9,0.5454545454545454,-120,0.5206611570247933,TOR,SF,2023 REG,3,2,5,1,3,8,1,0,1,-1,1,0,0,0,0,0,0,0,0,0.5206611570247933,0.4793388429752067
90068,0.607843137254902,0.43103448275862066,-155,132,0.5842116427368785,0.41578835726312147,home,TOR,under,9,0.5,100,0.4793388429752067,TOR,SF,2023 REG,3,2,5,1,3,8,1,0,1,-1,1,0,0,0,0,0,0,0,0,0.5206611570247933,0.4793388429752067
90069,0.5,0.5412844036697247,100,-118,0.47935779816513757,0.5206422018348624,away,CHC,over,9,0.5454545454545454,-120,0.5206611570247933,ARI,CHC,2023 REG,9,6,7,2,8,16,1,0,4,-4,1,1,0,0,0,0,0,0,0,0.5206611570247933,0.4793388429752067
90069,0.5,0.5412844036697247,100,-118,0.47935779816513757,0.5206422018348624,home,ARI,under,9,0.5,100,0.4793388429752067,ARI,CHC,2023 REG,9,6,7,2,8,16,1,0,4,-4,1,1,0,0,0,0,0,0,0,0.5206611570247933,0.4793388429752067
90070,0.4,0.6402877697841727,150,-178,0.383884892086331,0.6161151079136691,away,ATL,over,8.5,0.5145631067961165,-106,0.4925063625223866,WSH,ATL,2023 REG,6,4,4,1,5,10,1,0,3,-3,1,0,0,0,0,0,0,0,0,0.4925063625223866,0.5074936374776133
90070,0.4,0.6402877697841727,150,-178,0.383884892086331,0.6161151079136691,home,WSH,under,8.5,0.5283018867924528,-112,0.5074936374776133,WSH,ATL,2023 REG,6,4,4,1,5,10,1,0,3,-3,1,0,0,0,0,0,0,0,0,0.4925063625223866,0.5074936374776133
90071,0.607843137254902,0.4347826086956522,-155,130,0.5819333701084867,0.41806662989151333,away,PIT,over,9.5,0.5,100,0.4772727272727273,STL,PIT,2023 REG,8,6,11,7,13,19,0,1,-1,1,1,1,1,1,1,1,0,0,0,0.4772727272727273,0.5227272727272727
90071,0.607843137254902,0.4347826086956522,-155,130,0.5819333701084867,0.41806662989151333,home,STL,under,9.5,0.5454545454545454,-120,0.5227272727272727,STL,PIT,2023 REG,8,6,11,7,13,19,0,1,-1,1,1,1,1,1,1,1,0,0,0,0.4772727272727273,0.5227272727272727
90072,0.5,0.5348837209302326,100,-115,0.4825581395348837,0.5174418604651163,away,BOS,over,10,0.5370370370370371,-116,0.5118817074154765,CWS,BOS,2023 REG,7,4,5,1,5,12,1,0,3,-3,1,0,0,0,0,0,0,0,0,0.5118817074154765,0.48811829258452355
90072,0.5,0.5348837209302326,100,-115,0.4825581395348837,0.5174418604651163,home,CWS,under,10,0.5098039215686274,-104,0.48811829258452355,CWS,BOS,2023 REG,7,4,5,1,5,12,1,0,3,-3,1,0,0,0,0,0,0,0,0,0.5118817074154765,0.48811829258452355
90073,0.5238095238095238,0.5238095238095238,-110,-110,0.4988662131519274,0.5011337868480725,away,TB,over,9,0.5238095238095238,-110,0.4988662131519274,TOR,TB,2023 REG,12,8,16,12,20,28,0,1,-4,4,1,1,1,1,1,1,1,1,0,0.4988662131519274,0.5011337868480725
90073,0.5238095238095238,0.5238095238095238,-110,-110,0.4988662131519274,0.5011337868480725,home,TOR,under,9,0.5238095238095238,-110,0.5011337868480725,TOR,TB,2023 REG,12,8,16,12,20,28,0,1,-4,4,1,1,1,1,1,1,1,1,0,0.4988662131519274,0.5011337868480725
90074,0.6296296296296295,0.4081632653061224,-170,145,0.6058341031886005,0.39416589681139946,away,MIA,over,8.5,0.5215311004784688,-109,0.49907282342437215,ATL,MIA,2023 REG,5,4,11,5,9,16,0,1,-1,1,1,1,1,1,0,0,0,0,0,0.49907282342437215,0.5009271765756278
90074,0.6296296296296295,0.4081632653061224,-170,145,0.6058341031886005,0.39416589681139946,home,ATL,under,8.5,0.5215311004784688,-109,0.5009271765756278,ATL,MIA,2023 REG,5,4,11,5,9,16,0,1,-1,1,1,1,1,1,0,0,0,0,0,0.49907282342437215,0.5009271765756278
90075,0.5,0.5412844036697247,100,-118,0.47935779816513757,0.5206422018348624,away,KC,over,8.5,0.5412844036697247,-118,0.5136310900085983,OAK,KC,2023 REG,7,5,6,4,9,13,1,0,1,-1,1,1,1,1,0,0,0,0,0,0.5136310900085983,0.4863689099914017
90075,0.5,0.5412844036697247,100,-118,0.47935779816513757,0.5206422018348624,home,OAK,under,8.5,0.5098039215686274,-104,0.4863689099914017,OAK,KC,2023 REG,7,5,6,4,9,13,1,0,1,-1,1,1,1,1,0,0,0,0,0,0.5136310900085983,0.4863689099914017
90076,0.425531914893617,0.6124031007751938,135,-158,0.4093893550345486,0.5906106449654513,away,STL,over,9,0.5121951219512195,-105,0.48919479393107135,MIL,STL,2023 REG,5,0,12,6,6,17,0,1,-6,6,0,0,0,0,0,0,0,0,0,0.48919479393107135,0.5108052060689287
90076,0.425531914893617,0.6124031007751938,135,-158,0.4093893550345486,0.5906106449654513,home,MIL,under,9,0.5327102803738317,-114,0.5108052060689287,MIL,STL,2023 REG,5,0,12,6,6,17,0,1,-6,6,0,0,0,0,0,0,0,0,0,0.48919479393107135,0.5108052060689287
90077,0.3278688524590164,0.7142857142857143,205,-250,0.3140476830345145,0.6859523169654855,away,SEA,over,8.5,0.5238095238095238,-110,0.4988662131519274,OAK,SEA,2023 REG,8,3,7,5,8,15,0,1,-2,2,1,1,1,0,0,0,0,0,0,0.4988662131519274,0.5011337868480725
90077,0.3278688524590164,0.7142857142857143,205,-250,0.3140476830345145,0.6859523169654855,home,OAK,under,8.5,0.5238095238095238,-110,0.5011337868480725,OAK,SEA,2023 REG,8,3,7,5,8,15,0,1,-2,2,1,1,1,0,0,0,0,0,0,0.4988662131519274,0.5011337868480725
90078,0.4587155963302753,0.5833333333333333,118,-140,0.4394270964845833,0.5605729035154168,away,PHI,over,8.5,0.5238095238095238,-110,0.4988662131519274,OAK,PHI,2023 REG,7,1,7,6,7,14,0,1,-5,5,1,0,0,0,0,0,0,0,0,0.4988662131519274,0.5011337868480725
90078,0.4587155963302753,0.5833333333333333,118,-140,0.4394270964845833,0.5605729035154168,home,OAK,under,8.5,0.5238095238095238,-110,0.5011337868480725,OAK,PHI,2023 REG,7,1,7,6,7,14,0,1,-5,5,1,0,0,0,0,0,0,0,0,0.4988662131519274,0.5011337868480725
90079,0.626865671641791,0.41152263374485604,-168,143,0.6028013608024003,0.3971986391975997,away,CWS,over,8.5,0.5,100,0.4772727272727273,LAA,CWS,2023 REG,6,4,9,2,6,15,1,0,2,-2,1,1,0,0,0,0,0,0,0,0.4772727272727273,0.5227272727272727
90079,0.626865671641791,0.41152263374485604,-168,143,0.6028013608024003,0.3971986391975997,home,LAA,under,8.5,0.5454545454545454,-120,0.5227272727272727,LAA,CWS,2023 REG,6,4,9,2,6,15,1,0,2,-2,1,1,0,0,0,0,0,0,0,0.4772727272727273,0.5227272727272727
90080,0.4854368932038835,0.5555555555555556,106,-125,0.465537646233282,0.534462353766718,away,CWS,over,9,0.5348837209302326,-115,0.5097020142727117,WSH,CWS,2023 REG,6,1,15,6,7,21,0,1,-5,5,1,0,0,0,0,0,0,0,0,0.5097020142727117,0.49029798572728833
90080,0.4854368932038835,0.5555555555555556,106,-125,0.465537646233282,0.534462353766718,home,WSH,under,9,0.5121951219512195,-105,0.49029798572728833,WSH,CWS,2023 REG,6,1,15,6,7,21,0,1,-5,5,1,0,0,0,0,0,0,0,0,0.5097020142727117,0.49029798572728833
90081,0.49751243781094534,0.5454545454545454,101,-120,0.476135829221149,0.523864170778851,away,CHC,over,9,0.5192307692307692,-108,0.49571111079951763,CIN,CHC,2023 REG,10,7,12,6,13,22,1,0,1,-1,1,1,1,1,1,1,0,0,0,0.49571111079951763,0.5042888892004824
90081,0.49751243781094534,0.5454545454545454,101,-120,0.476135829221149,0.523864170778851,home,CIN,under,9,0.5260663507109005,-111,0.5042888892004824,CIN,CHC,2023 REG,10,7,12,6,13,22,1,0,1,-1,1,1,1,1,1,1,0,0,0,0.49571111079951763,0.5042888892004824
90082,0.5454545454545454,0.5,-120,100,0.5206611570247933,0.4793388429752067,away,CHC,over,9.5,0.5283018867924528,-112,0.5056562298022652,LAA,CHC,2023 REG,5,7,8,4,11,13,1,0,3,-3,1,1,1,1,0,0,0,0,0,0.5056562298022652,0.4943437701977348
90082,0.5454545454545454,0.5,-120,100,0.5206611570247933,0.4793388429752067,home,LAA,under,9.5,0.5145631067961165,-106,0.4943437701977348,LAA,CHC,2023 REG,5,7,8,4,11,13,1,0,3,-3,1,1,1,1,0,0,0,0,0,0.5056562298022652,0.4943437701977348
90083,0.7354497354497355,0.3125,-278,220,0.7001851151983428,0.2998148848016572,away,LAA,over,7.5,0.5238095238095238,-110,0.4988662131519274,TB,LAA,2023 REG,9,5,10,4,9,19,1,0,1,-1,1,1,1,1,0,0,0,0,0,0.4988662131519274,0.5011337868480725
90083,0.7354497354497355,0.3125,-278,220,0.7001851151983428,0.2998148848016572,home,TB,under,7.5,0.5238095238095238,-110,0.5011337868480725,TB,LAA,2023 REG,9,5,10,4,9,19,1,0,1,-1,1,1,1,1,0,0,0,0,0,0.4988662131519274,0.5011337868480725
90084,0.5515695067264574,0.49019607843137253,-123,104,0.5285328835228112,0.47146711647718875,away,CWS,over,9.5,0.5348837209302326,-115,0.5097020142727117,CIN,CWS,2023 REG,10,4,18,17,21,28,0,1,-13,13,1,1,1,1,0,0,0,0,0,0.5097020142727117,0.49029798572728833
90084,0.5515695067264574,0.49019607843137253,-123,104,0.5285328835228112,0.47146711647718875,home,CIN,under,9.5,0.5121951219512195,-105,0.49029798572728833,CIN,CWS,2023 REG,10,4,18,17,21,28,0,1,-13,13,1,1,1,1,0,0,0,0,0,0.5097020142727117,0.49029798572728833
90085,0.5391705069124424,0.5,-117,100,0.5180509248444435,0.4819490751555565,away,SD,over,8.5,0.5348837209302326,-115,0.5097020142727117,SF,SD,2023 REG,5,2,10,5,7,15,0,1,-3,3,1,1,0,0,0,0,0,0,0,0.5097020142727117,0.49029798572728833
90085,0.5391705069124424,0.5,-117,100,0.5180509248444435,0.4819490751555565,home,SF,under,8.5,0.5121951219512195,-105,0.49029798572728833,SF,SD,2023 REG,5,2,10,5,7,15,0,1,-3,3,1,1,0,0,0,0,0,0,0,0.5097020142727117,0.49029798572728833
90086,0.7435897435897436,0.29411764705882354,-290,240,0.7155509146459372,0.28444908535406277,away,COL,over,9.5,0.5098039215686274,-104,0.48483656587239576,LAD,COL,2023 REG,8,4,3,1,5,11,1,0,3,-3,1,0,0,0,0,0,0,0,0,0.48483656587239576,0.5151634341276042
90086,0.7435897435897436,0.29411764705882354,-290,240,0.7155509146459372,0.28444908535406277,home,LAD,under,9.5,0.5391705069124424,-117,0.5151634341276042,LAD,COL,2023 REG,8,4,3,1,5,11,1,0,3,-3,1,0,0,0,0,0,0,0,0,0.48483656587239576,0.5151634341276042
90087,0.5918367346938775,0.4444444444444444,-145,125,0.5703642001018094,0.42963579989819056,away,MIA,over,8,0.5169082125603864,-107,0.49353874091423283,ATL,MIA,2023 REG,9,6,5,4,10,14,1,0,2,-2,1,1,1,1,0,0,0,0,0,0.49353874091423283,0.5064612590857671
90087,0.5918367346938775,0.4444444444444444,-145,125,0.5703642001018094,0.42963579989819056,home,ATL,under,8,0.5283018867924528,-112,0.5064612590857671,ATL,MIA,2023 REG,9,6,5,4,10,14,1,0,2,-2,1,1,1,1,0,0,0,0,0,0.49353874091423283,0.5064612590857671
90088,0.5121951219512195,0.5348837209302326,-105,-115,0.48808156828023186,0.5119184317197681,away,PHI,over,10,0.5024875621890548,-101,0.4794401874631478,MIL,PHI,2023 REG,7,2,6,4,6,13,0,1,-2,2,1,1,0,0,0,0,0,0,0,0.4794401874631478,0.5205598125368522
90088,0.5121951219512195,0.5348837209302326,-105,-115,0.48808156828023186,0.5119184317197681,home,MIL,under,10,0.5433789954337899,-119,0.5205598125368522,MIL,PHI,2023 REG,7,2,6,4,6,13,0,1,-2,2,1,1,0,0,0,0,0,0,0,0.4794401874631478,0.5205598125368522
90089,0.6666666666666666,0.37735849056603776,-200,165,0.6373165618448637,0.36268343815513626,away,SF,over,8,0.5454545454545454,-120,0.5206611570247933,TOR,SF,2023 REG,8,0,6,3,3,14,0,1,-3,3,0,0,0,0,0,0,0,0,0,0.5206611570247933,0.4793388429752067
90089,0.6666666666666666,0.37735849056603776,-200,165,0.6373165618448637,0.36268343815513626,home,TOR,under,8,0.5,100,0.4793388429752067,TOR,SF,2023 REG,8,0,6,3,3,14,0,1,-3,3,0,0,0,0,0,0,0,0,0,0.5206611570247933,0.4793388429752067
90090,0.5884773662551441,0.4504504504504505,-143,122,0.5655692272061728,0.43443077279382725,away,STL,over,8,0.5121951219512195,-105,0.48808156828023186,MIA,STL,2023 REG,6,5,11,4,9,17,1,0,1,-1,1,1,1,1,0,0,0,0,0,0.48808156828023186,0.5119184317197681
90090,0.5884773662551441,0.4504504504504505,-143,122,0.5655692272061728,0.43443077279382725,home,MIA,under,8,0.5348837209302326,-115,0.5119184317197681,MIA,STL,2023 REG,6,5,11,4,9,17,1,0,1,-1,1,1,1,1,0,0,0,0,0,0.48808156828023186,0.5119184317197681
90091,0.5594713656387665,0.47619047619047616,-127,110,0.5395195862893665,0.46048041371063353,away,CIN,over,10,0.5370370370370371,-116,0.5118817074154765,BAL,CIN,2023 REG,12,10,7,3,13,19,1,0,7,-7,1,1,1,0,0,0,0,0,0,0.5118817074154765,0.48811829258452355
90091,0.5594713656387665,0.47619047619047616,-127,110,0.5395195862893665,0.46048041371063353,home,BAL,under,10,0.5098039215686274,-104,0.48811829258452355,BAL,CIN,2023 REG,12,10,7,3,13,19,1,0,7,-7,1,1,1,0,0,0,0,0,0,0.5118817074154765,0.48811829258452355
90092,0.5454545454545454,0.5,-120,100,0.5206611570247933,0.4793388429752067,away,OAK,over,9,0.5305164319248826,-113,0.5053568787472517,WSH,OAK,2023 REG,12,8,6,2,10,18,1,0,6,-6,1,1,0,0,0,0,0,0,0,0.5053568787472517,0.49464312125274834
90092,0.5454545454545454,0.5,-120,100,0.5206611570247933,0.4793388429752067,home,WSH,under,9,0.5169082125603864,-107,0.49464312125274834,WSH,OAK,2023 REG,12,8,6,2,10,18,1,0,6,-6,1,1,0,0,0,0,0,0,0,0.5053568787472517,0.49464312125274834
90093,0.726027397260274,0.31746031746031744,-265,215,0.6944541249288857,0.3055458750711143,away,KC,over,8.5,0.5348837209302326,-115,0.5097020142727117,SEA,KC,2023 REG,13,15,5,2,17,18,1,0,13,-13,1,1,0,0,0,0,0,0,0,0.5097020142727117,0.49029798572728833
90093,0.726027397260274,0.31746031746031744,-265,215,0.6944541249288857,0.3055458750711143,home,SEA,under,8.5,0.5121951219512195,-105,0.49029798572728833,SEA,KC,2023 REG,13,15,5,2,17,18,1,0,13,-13,1,1,0,0,0,0,0,0,0,0.5097020142727117,0.49029798572728833
90094,0.4347826086956522,0.6031746031746031,130,-152,0.418279473099889,0.581720526900111,away,NYM,over,9,0.5454545454545454,-120,0.5206611570247933,ARI,NYM,2023 REG,8,5,8,8,13,16,0,1,-3,3,1,1,1,1,1,0,0,0,0,0.5206611570247933,0.4793388429752067
90094,0.4347826086956522,0.6031746031746031,130,-152,0.418279473099889,0.581720526900111,home,ARI,under,9,0.5,100,0.4793388429752067,ARI,NYM,2023 REG,8,5,8,8,13,16,0,1,-3,3,1,1,1,1,1,0,0,0,0,0.5206611570247933,0.4793388429752067
90095,0.5918367346938775,0.4464285714285714,-145,124,0.5691899208663057,0.4308100791336943,away,BAL,over,8,0.5121951219512195,-105,0.48808156828023186,MIL,BAL,2023 REG,16,10,5,2,12,21,1,0,8,-8,1,1,0,0,0,0,0,0,0,0.48808156828023186,0.5119184317197681
90095,0.5918367346938775,0.4464285714285714,-145,124,0.5691899208663057,0.4308100791336943,home,MIL,under,8,0.5348837209302326,-115,0.5119184317197681,MIL,BAL,2023 REG,16,10,5,2,12,21,1,0,8,-8,1,1,0,0,0,0,0,0,0,0.48808156828023186,0.5119184317197681
90096,0.7142857142857143,0.3333333333333333,-250,200,0.6802721088435374,0.3197278911564626,away,OAK,over,8.5,0.5238095238095238,-110,0.4988662131519274,TEX,OAK,2023 REG,9,3,10,6,9,19,0,1,-3,3,1,1,1,0,0,0,0,0,0,0.4988662131519274,0.5011337868480725
90096,0.7142857142857143,0.3333333333333333,-250,200,0.6802721088435374,0.3197278911564626,home,TEX,under,8.5,0.5238095238095238,-110,0.5011337868480725,TEX,OAK,2023 REG,9,3,10,6,9,19,0,1,-3,3,1,1,1,0,0,0,0,0,0,0.4988662131519274,0.5011337868480725
90097,0.6183206106870228,0.4166666666666667,-162,140,0.5966872559874133,0.40331274401258665,away,CLE,over,8.5,0.5283018867924528,-112,0.5056562298022652,SD,CLE,2023 REG,9,5,5,0,5,14,1,0,5,-5,0,0,0,0,0,0,0,0,0,0.5056562298022652,0.4943437701977348
90097,0.6183206106870228,0.4166666666666667,-162,140,0.5966872559874133,0.40331274401258665,home,SD,under,8.5,0.5145631067961165,-106,0.4943437701977348,SD,CLE,2023 REG,9,5,5,0,5,14,1,0,5,-5,0,0,0,0,0,0,0,0,0,0.5056562298022652,0.4943437701977348
90098,0.7222222222222222,0.31746031746031744,-260,215,0.693562610229277,0.306437389770723,away,DET,over,8,0.5215311004784688,-109,0.4978845547971712,LAD,DET,2023 REG,3,2,7,4,6,10,0,1,-2,2,1,1,0,0,0,0,0,0,0,0.4978845547971712,0.5021154452028288
90098,0.7222222222222222,0.31746031746031744,-260,215,0.693562610229277,0.306437389770723,home,LAD,under,8,0.5238095238095238,-110,0.5021154452028288,LAD,DET,2023 REG,3,2,7,4,6,10,0,1,-2,2,1,1,0,0,0,0,0,0,0,0.4978845547971712,0.5021154452028288
90099,0.48780487804878053,0.5555555555555556,105,-125,0.4666534470222751,0.5333465529777248,away,STL,over,11,0.5348837209302326,-115,0.5097020142727117,KC,STL,2023 REG,16,12,11,8,20,27,1,0,4,-4,1,1,1,1,1,1,1,1,0,0.5097020142727117,0.49029798572728833
90099,0.48780487804878053,0.5555555555555556,105,-125,0.4666534470222751,0.5333465529777248,home,KC,under,11,0.5121951219512195,-105,0.49029798572728833,KC,STL,2023 REG,16,12,11,8,20,27,1,0,4,-4,1,1,1,1,1,1,1,1,0,0.5097020142727117,0.49029798572728833
90100,0.5121951219512195,0.5348837209302326,-105,-115,0.48808156828023186,0.5119184317197681,away,TB,over,7,0.5412844036697247,-118,0.5149381613977361,SEA,TB,2023 REG,13,8,5,3,11,18,1,0,5,-5,1,1,1,0,0,0,0,0,0,0.5149381613977361,0.48506183860226393
90100,0.5121951219512195,0.5348837209302326,-105,-115,0.48808156828023186,0.5119184317197681,home,SEA,under,7,0.5073891625615764,-103,0.48506183860226393,SEA,TB,2023 REG,13,8,5,3,11,18,1,0,5,-5,1,1,1,0,0,0,0,0,0,0.5149381613977361,0.48506183860226393
90101,0.48309178743961345,0.5594713656387665,107,-127,0.46252987773991294,0.5374701222600871,away,NYY,over,8.5,0.5327102803738317,-114,0.508788710910954,BAL,NYY,2023 REG,10,7,9,6,13,19,1,0,1,-1,1,1,1,1,1,1,0,0,0,0.508788710910954,0.491211289089046
90101,0.48309178743961345,0.5594713656387665,107,-127,0.46252987773991294,0.5374701222600871,home,BAL,under,8.5,0.5121951219512195,-105,0.491211289089046,BAL,NYY,2023 REG,10,7,9,6,13,19,1,0,1,-1,1,1,1,1,1,1,0,0,0,0.508788710910954,0.491211289089046
90102,0.6000000000000001,0.4347826086956522,-150,130,0.5791304347826086,0.4208695652173914,away,PIT,over,9,0.49504950495049505,102,0.47297076509898783,CHC,PIT,2023 REG,13,10,12,6,16,25,1,0,4,-4,1,1,1,1,1,1,0,0,0,0.47297076509898783,0.5270292349010122
90102,0.6000000000000001,0.4347826086956522,-150,130,0.5791304347826086,0.4208695652173914,home,CHC,under,9,0.5495495495495495,-122,0.5270292349010122,CHC,PIT,2023 REG,13,10,12,6,16,25,1,0,4,-4,1,1,1,1,1,1,0,0,0,0.47297076509898783,0.5270292349010122
90103,0.7402597402597403,0.30120481927710846,-285,232,0.7095651961870081,0.2904348038129919,away,OAK,over,9.5,0.5145631067961165,-106,0.49023796582517226,LAD,OAK,2023 REG,13,10,6,1,11,19,1,0,9,-9,1,0,0,0,0,0,0,0,0,0.49023796582517226,0.5097620341748277
90103,0.7402597402597403,0.30120481927710846,-285,232,0.7095651961870081,0.2904348038129919,home,LAD,under,9.5,0.5327102803738317,-114,0.5097620341748277,LAD,OAK,2023 REG,13,10,6,1,11,19,1,0,9,-9,1,0,0,0,0,0,0,0,0,0.49023796582517226,0.5097620341748277
90104,0.6875,0.35460992907801414,-220,182,0.6585494237588654,0.3414505762411346,away,KC,over,9.5,0.5348837209302326,-115,0.5109810284308424,LAA,KC,2023 REG,7,4,8,3,7,15,1,0,1,-1,1,1,1,0,0,0,0,0,0,0.5109810284308424,0.48901897156915763
90104,0.6875,0.35460992907801414,-220,182,0.6585494237588654,0.3414505762411346,home,LAA,under,9.5,0.5098039215686274,-104,0.48901897156915763,LAA,KC,2023 REG,7,4,8,3,7,15,1,0,1,-1,1,1,1,0,0,0,0,0,0,0.5109810284308424,0.48901897156915763
90105,0.37735849056603776,0.6610169491525424,165,-195,0.36287719255902645,0.6371228074409736,away,SF,over,8.5,0.5454545454545454,-120,0.5206611570247933,WSH,SF,2023 REG,14,10,5,1,11,19,1,0,9,-9,1,0,0,0,0,0,0,0,0,0.5206611570247933,0.4793388429752067
90105,0.37735849056603776,0.6610169491525424,165,-195,0.36287719255902645,0.6371228074409736,home,WSH,under,8.5,0.5,100,0.4793388429752067,WSH,SF,2023 REG,14,10,5,1,11,19,1,0,9,-9,1,0,0,0,0,0,0,0,0,0.5206611570247933,0.4793388429752067
90106,0.5098039215686274,0.5348837209302326,-104,-115,0.4870219861770517,0.5129780138229483,away,NYY,over,9.5,0.5305164319248826,-113,0.5066009958897986,CLE,NYY,2023 REG,6,3,7,4,7,13,0,1,-1,1,1,1,1,0,0,0,0,0,0,0.5066009958897986,0.49339900411020143
90106,0.5098039215686274,0.5348837209302326,-104,-115,0.4870219861770517,0.5129780138229483,home,CLE,under,9.5,0.5145631067961165,-106,0.49339900411020143,CLE,NYY,2023 REG,6,3,7,4,7,13,0,1,-1,1,1,1,1,0,0,0,0,0,0,0.5066009958897986,0.49339900411020143
90107,0.6363636363636364,0.40322580645161293,-175,148,0.6111703545721141,0.3888296454278859,away,HOU,over,8.5,0.5169082125603864,-107,0.49353874091423283,TEX,HOU,2023 REG,5,3,8,5,8,13,0,1,-2,2,1,1,1,0,0,0,0,0,0,0.49353874091423283,0.5064612590857671
90107,0.6363636363636364,0.40322580645161293,-175,148,0.6111703545721141,0.3888296454278859,home,TEX,under,8.5,0.5283018867924528,-112,0.5064612590857671,TEX,HOU,2023 REG,5,3,8,5,8,13,0,1,-2,2,1,1,1,0,0,0,0,0,0,0.49353874091423283,0.5064612590857671
90108,0.5121951219512195,0.5348837209302326,-105,-115,0.48808156828023186,0.5119184317197681,away,SEA,over,7.5,0.5121951219512195,-105,0.48808156828023186,NYM,SEA,2023 REG,9,2,7,1,3,16,1,0,1,-1,1,0,0,0,0,0,0,0,0,0.48808156828023186,0.5119184317197681
90108,0.5121951219512195,0.5348837209302326,-105,-115,0.48808156828023186,0.5119184317197681,home,NYM,under,7.5,0.5348837209302326,-115,0.5119184317197681,NYM,SEA,2023 REG,9,2,7,1,3,16,1,0,1,-1,1,0,0,0,0,0,0,0,0,0.48808156828023186,0.5119184317197681
90109,0.7076023391812866,0.3389830508474576,-242,195,0.6746384082252745,0.32536159177472546,away,WSH,over,8.5,0.5238095238095238,-110,0.4988662131519274,SF,WSH,2023 REG,10,4,10,1,5,20,1,0,3,-3,1,0,0,0,0,0,0,0,0,0.4988662131519274,0.5011337868480725
90109,0.7076023391812866,0.3389830508474576,-242,195,0.6746384082252745,0.32536159177472546,home,SF,under,8.5,0.5238095238095238,-110,0.5011337868480725,SF,WSH,2023 REG,10,4,10,1,5,20,1,0,3,-3,1,0,0,0,0,0,0,0,0,0.4988662131519274,0.5011337868480725
90110,0.5,0.5412844036697247,100,-118,0.47935779816513757,0.5206422018348624,away,BAL,over,9.5,0.5145631067961165,-106,0.49023796582517226,BOS,BAL,2023 REG,8,7,7,3,10,15,1,0,4,-4,1,1,1,0,0,0,0,0,0,0.49023796582517226,0.5097620341748277
90110,0.5,0.5412844036697247,100,-118,0.47935779816513757,0.5206422018348624,home,BOS,under,9.5,0.5327102803738317,-114,0.5097620341748277,BOS,BAL,2023 REG,8,7,7,3,10,15,1,0,4,-4,1,1,1,0,0,0,0,0,0,0.49023796582517226,0.5097620341748277
90111,0.6323529411764706,0.4081632653061224,-172,145,0.6067323988418897,0.3932676011581103,away,ARI,over,8,0.5238095238095238,-110,0.4988662131519274,STL,ARI,2023 REG,8,7,14,8,15,22,0,1,-1,1,1,1,1,1,1,1,1,0,0,0.4988662131519274,0.5011337868480725
90111,0.6323529411764706,0.4081632653061224,-172,145,0.6067323988418897,0.3932676011581103,home,STL,under,8,0.5238095238095238,-110,0.5011337868480725,STL,ARI,2023 REG,8,7,14,8,15,22,0,1,-1,1,1,1,1,1,1,1,1,0,0,0.4988662131519274,0.5011337868480725
90112,0.5283018867924528,0.5121951219512195,-112,-105,0.5069072406637203,0.4930927593362797,away,BAL,over,9,0.5145631067961165,-106,0.4913668392989033,NYY,BAL,2023 REG,6,3,10,6,9,16,0,1,-3,3,1,1,1,0,0,0,0,0,0,0.4913668392989033,0.5086331607010968
90112,0.5283018867924528,0.5121951219512195,-112,-105,0.5069072406637203,0.4930927593362797,home,NYY,under,9,0.5305164319248826,-113,0.5086331607010968,NYY,BAL,2023 REG,6,3,10,6,9,16,0,1,-3,3,1,1,1,0,0,0,0,0,0,0.4913668392989033,0.5086331607010968
90113,0.5238095238095238,0.5238095238095238,-110,-110,0.4988662131519274,0.5011337868480725,away,CLE,over,7.5,0.5283018867924528,-112,0.5031902949311281,CHC,CLE,2023 REG,8,6,10,8,14,18,0,1,-2,2,1,1,1,1,1,1,0,0,0,0.5031902949311281,0.4968097050688719
90113,0.5238095238095238,0.5238095238095238,-110,-110,0.4988662131519274,0.5011337868480725,home,CHC,under,7.5,0.5192307692307692,-108,0.4968097050688719,CHC,CLE,2023 REG,8,6,10,8,14,18,0,1,-2,2,1,1,1,1,1,1,0,0,0,0.5031902949311281,0.4968097050688719
90114,0.4291845493562232,0.607843137254902,133,-155,0.41329283836432396,0.586707161635676,away,LAD,over,8.5,0.5121951219512195,-105,0.48808156828023186,SF,LAD,2023 REG,7,5,3,0,5,10,1,0,5,-5,0,0,0,0,0,0,0,0,0,0.48808156828023186,0.5119184317197681
90114,0.4291845493562232,0.607843137254902,133,-155,0.41329283836432396,0.586707161635676,home,SF,under,8.5,0.5348837209302326,-115,0.5119184317197681,SF,LAD,2023 REG,7,5,3,0,5,10,1,0,5,-5,0,0,0,0,0,0,0,0,0,0.48808156828023186,0.5119184317197681
90115,0.5652173913043479,0.47619047619047616,-130,110,0.5418129444594474,0.4581870555405526,away,LAA,over,8,0.5348837209302326,-115,0.5097020142727117,DET,LAA,2023 REG,12,6,12,7,13,24,0,1,-1,1,1,1,1,1,1,1,0,0,0,0.5097020142727117,0.49029798572728833
90115,0.5652173913043479,0.47619047619047616,-130,110,0.5418129444594474,0.4581870555405526,home,DET,under,8,0.5121951219512195,-105,0.49029798572728833,DET,LAA,2023 REG,12,6,12,7,13,24,0,1,-1,1,1,1,1,1,1,1,0,0,0,0.5097020142727117,0.49029798572728833
90116,0.5121951219512195,0.5348837209302326,-105,-115,0.48808156828023186,0.5119184317197681,away,ARI,over,7,0.5238095238095238,-110,0.4988662131519274,NYY,ARI,2023 REG,6,1,8,7,8,14,0,1,-6,6,1,0,0,0,0,0,0,0,0,0.4988662131519274,0.5011337868480725
90116,0.5121951219512195,0.5348837209302326,-105,-115,0.48808156828023186,0.5119184317197681,home,NYY,under,7,0.5238095238095238,-110,0.5011337868480725,NYY,ARI,2023 REG,6,1,8,7,8,14,0,1,-6,6,1,0,0,0,0,0,0,0,0,0.4988662131519274,0.5011337868480725
90117,0.6363636363636364,0.4081632653061224,-175,145,0.6080283353010626,0.3919716646989374,away,DET,over,8,0.5121951219512195,-105,0.48808156828023186,SEA,DET,2023 REG,6,2,6,0,2,12,1,0,2,-2,0,0,0,0,0,0,0,0,0,0.48808156828023186,0.5119184317197681
90117,0.6363636363636364,0.4081632653061224,-175,145,0.6080283353010626,0.3919716646989374,home,SEA,under,8,0.5348837209302326,-115,0.5119184317197681,SEA,DET,2023 REG,6,2,6,0,2,12,1,0,2,-2,0,0,0,0,0,0,0,0,0,0.48808156828023186,0.5119184317197681
90118,0.4629629629629629,0.576271186440678,116,-136,0.4447990049057217,0.5552009950942782,away,TOR,over,9.5,0.5238095238095238,-110,0.4988662131519274,CWS,TOR,2023 REG,9,4,16,5,9,25,0,1,-1,1,1,1,1,1,0,0,0,0,0,0.4988662131519274,0.5011337868480725
90118,0.4629629629629629,0.576271186440678,116,-136,0.4447990049057217,0.5552009950942782,home,CWS,under,9.5,0.5238095238095238,-110,0.5011337868480725,CWS,TOR,2023 REG,9,4,16,5,9,25,0,1,-1,1,1,1,1,1,0,0,0,0,0,0.4988662131519274,0.5011337868480725
90119,0.6774193548387096,0.37037037037037035,-210,170,0.6450456700196554,0.3549543299803446,away,STL,over,9,0.5121951219512195,-105,0.48808156828023186,PHI,STL,2023 REG,11,3,2,0,3,13,1,0,3,-3,0,0,0,0,0,0,0,0,0,0.48808156828023186,0.5119184317197681
90119,0.6774193548387096,0.37037037037037035,-210,170,0.6450456700196554,0.3549543299803446,home,PHI,under,9,0.5348837209302326,-115,0.5119184317197681,PHI,STL,2023 REG,11,3,2,0,3,13,1,0,3,-3,0,0,0,0,0,0,0,0,0,0.48808156828023186,0.5119184317197681
90120,0.6226415094339623,0.4166666666666667,-165,140,0.5981666073335706,0.40183339266642937,away,COL,over,8.5,0.5348837209302326,-115,0.5097020142727117,MIA,COL,2023 REG,9,3,6,4,7,15,0,1,-1,1,1,1,1,0,0,0,0,0,0,0.5097020142727117,0.49029798572728833
90120,0.6226415094339623,0.4166666666666667,-165,140,0.5981666073335706,0.40183339266642937,home,MIA,under,8.5,0.5121951219512195,-105,0.49029798572728833,MIA,COL,2023 REG,9,3,6,4,7,15,0,1,-1,1,1,1,1,0,0,0,0,0,0,0.5097020142727117,0.49029798572728833
90121,0.3076923076923077,0.7333333333333333,225,-275,0.29506903353057207,0.7049309664694279,away,HOU,over,8.5,0.5169082125603864,-107,0.49353874091423283,OAK,HOU,2023 REG,5,2,9,5,7,14,0,1,-3,3,1,1,0,0,0,0,0,0,0,0.49353874091423283,0.5064612590857671
90121,0.3076923076923077,0.7333333333333333,225,-275,0.29506903353057207,0.7049309664694279,home,OAK,under,8.5,0.5283018867924528,-112,0.5064612590857671,OAK,HOU,2023 REG,5,2,9,5,7,14,0,1,-3,3,1,1,0,0,0,0,0,0,0,0.49353874091423283,0.5064612590857671
90122,0.5348837209302326,0.5098039215686274,-115,-104,0.5109810284308424,0.48901897156915763,away,ATL,over,8.5,0.5327102803738317,-114,0.508788710910954,MIA,ATL,2023 REG,10,3,12,6,9,22,0,1,-3,3,1,1,1,0,0,0,0,0,0,0.508788710910954,0.491211289089046
90122,0.5348837209302326,0.5098039215686274,-115,-104,0.5109810284308424,0.48901897156915763,home,MIA,under,8.5,0.5121951219512195,-105,0.491211289089046,MIA,ATL,2023 REG,10,3,12,6,9,22,0,1,-3,3,1,1,1,0,0,0,0,0,0,0.508788710910954,0.491211289089046
90123,0.7101449275362319,0.33444816053511706,-245,199,0.678477372239187,0.321522627760813,away,MIA,over,9,0.5238095238095238,-110,0.4988662131519274,ATL,MIA,2023 REG,10,7,10,4,11,20,1,0,3,-3,1,1,1,1,0,0,0,0,0,0.4988662131519274,0.5011337868480725
90123,0.7101449275362319,0.33444816053511706,-245,199,0.678477372239187,0.321522627760813,home,ATL,under,9,0.5238095238095238,-110,0.5011337868480725,ATL,MIA,2023 REG,10,7,10,4,11,20,1,0,3,-3,1,1,1,1,0,0,0,0,0,0.4988662131519274,0.5011337868480725
90124,0.4347826086956522,0.6000000000000001,130,-150,0.4196597353497164,0.5803402646502835,away,CWS,over,9,0.504950495049505,-102,0.4826715732667395,KC,CWS,2023 REG,5,2,6,4,6,11,0,1,-2,2,1,1,0,0,0,0,0,0,0,0.4826715732667395,0.5173284267332605
90124,0.4347826086956522,0.6000000000000001,130,-150,0.4196597353497164,0.5803402646502835,home,KC,under,9,0.5391705069124424,-117,0.5173284267332605,KC,CWS,2023 REG,5,2,6,4,6,11,0,1,-2,2,1,1,0,0,0,0,0,0,0,0.4826715732667395,0.5173284267332605
90125,0.6153846153846154,0.425531914893617,-160,135,0.5902052121364724,0.40979478786352763,away,CHC,over,7.5,0.5121951219512195,-105,0.48808156828023186,MIN,CHC,2023 REG,5,2,11,6,8,16,0,1,-4,4,1,1,0,0,0,0,0,0,0,0.48808156828023186,0.5119184317197681
90125,0.6153846153846154,0.425531914893617,-160,135,0.5902052121364724,0.40979478786352763,home,MIN,under,7.5,0.5348837209302326,-115,0.5119184317197681,MIN,CHC,2023 REG,5,2,11,6,8,16,0,1,-4,4,1,1,0,0,0,0,0,0,0,0.48808156828023186,0.5119184317197681
90126,0.7354497354497355,0.30303030303030304,-278,230,0.7071496013294954,0.29285039867050455,away,WSH,over,10,0.5238095238095238,-110,0.4988662131519274,ATL,WSH,2023 REG,17,6,10,10,16,27,0,1,-4,4,1,1,1,1,1,1,0,0,0,0.4988662131519274,0.5011337868480725
90126,0.7354497354497355,0.30303030303030304,-278,230,0.7071496013294954,0.29285039867050455,home,ATL,under,10,0.5238095238095238,-110,0.5011337868480725,ATL,WSH,2023 REG,17,6,10,10,16,27,0,1,-4,4,1,1,1,1,1,1,0,0,0,0.4988662131519274,0.5011337868480725
90127,0.6153846153846154,0.425531914893617,-160,135,0.5902052121364724,0.40979478786352763,away,KC,over,8,0.5121951219512195,-105,0.48808156828023186,DET,KC,2023 REG,7,6,8,3,9,15,1,0,3,-3,1,1,1,0,0,0,0,0,0,0.48808156828023186,0.5119184317197681
90127,0.6153846153846154,0.425531914893617,-160,135,0.5902052121364724,0.40979478786352763,home,DET,under,8,0.5348837209302326,-115,0.5119184317197681,DET,KC,2023 REG,7,6,8,3,9,15,1,0,3,-3,1,1,1,0,0,0,0,0,0,0.48808156828023186,0.5119184317197681
90128,0.6610169491525424,0.37735849056603776,-195,165,0.6356501330673793,0.3643498669326207,away,LAA,over,8.5,0.5283018867924528,-112,0.5031902949311281,TOR,LAA,2023 REG,8,4,9,1,5,17,1,0,3,-3,1,0,0,0,0,0,0,0,0,0.5031902949311281,0.4968097050688719
90128,0.6610169491525424,0.37735849056603776,-195,165,0.6356501330673793,0.3643498669326207,home,TOR,under,8.5,0.5192307692307692,-108,0.4968097050688719,TOR,LAA,2023 REG,8,4,9,1,5,17,1,0,3,-3,1,0,0,0,0,0,0,0,0,0.5031902949311281,0.4968097050688719
90129,0.3846153846153846,0.6551724137931035,160,-190,0.3693123852275045,0.6306876147724956,away,ARI,over,9,0.5370370370370371,-116,0.5118817074154765,CWS,ARI,2023 REG,8,0,4,3,3,12,0,1,-3,3,0,0,0,0,0,0,0,0,0,0.5118817074154765,0.48811829258452355
90129,0.3846153846153846,0.6551724137931035,160,-190,0.3693123852275045,0.6306876147724956,home,CWS,under,9,0.5098039215686274,-104,0.48811829258452355,CWS,ARI,2023 REG,8,0,4,3,3,12,0,1,-3,3,0,0,0,0,0,0,0,0,0,0.5118817074154765,0.48811829258452355
90130,0.6923076923076923,0.3472222222222222,-225,188,0.6649408284023669,0.3350591715976331,away,WSH,over,10.5,0.5454545454545454,-120,0.5206611570247933,ATL,WSH,2023 REG,11,9,15,10,19,26,0,1,-1,1,1,1,1,1,1,1,1,1,1,0.5206611570247933,0.4793388429752067
90130,0.6923076923076923,0.3472222222222222,-225,188,0.6649408284023669,0.3350591715976331,home,ATL,under,10.5,0.5,100,0.4793388429752067,ATL,WSH,2023 REG,11,9,15,10,19,26,0,1,-1,1,1,1,1,1,1,1,1,1,1,0.5206611570247933,0.4793388429752067
90131,0.47619047619047616,0.5652173913043479,110,-130,0.4564724440500838,0.5435275559499162,away,NYY,over,8.5,0.5305164319248826,-113,0.5066009958897986,BAL,NYY,2023 REG,4,1,4,0,1,8,1,0,1,-1,0,0,0,0,0,0,0,0,0,0.5066009958897986,0.49339900411020143
90131,0.47619047619047616,0.5652173913043479,110,-130,0.4564724440500838,0.5435275559499162,home,BAL,under,8.5,0.5145631067961165,-106,0.49339900411020143,BAL,NYY,2023 REG,4,1,4,0,1,8,1,0,1,-1,0,0,0,0,0,0,0,0,0,0.5066009958897986,0.49339900411020143
90132,0.5670995670995671,0.4739336492890995,-131,111,0.5438296478488513,0.45617035215114865,away,PIT,over,8.5,0.5145631067961165,-106,0.49023796582517226,MIL,PIT,2023 REG,16,14,6,1,15,22,1,0,13,-13,1,0,0,0,0,0,0,0,0,0.49023796582517226,0.5097620341748277
90132,0.5670995670995671,0.4739336492890995,-131,111,0.5438296478488513,0.45617035215114865,home,MIL,under,8.5,0.5327102803738317,-114,0.5097620341748277,MIL,PIT,2023 REG,16,14,6,1,15,22,1,0,13,-13,1,0,0,0,0,0,0,0,0,0.49023796582517226,0.5097620341748277
90133,0.574468085106383,0.46511627906976744,-135,115,0.5517281312179562,0.44827186878204384,away,CIN,over,8.5,0.5121951219512195,-105,0.48808156828023186,DET,CIN,2023 REG,7,3,5,4,7,12,0,1,-1,1,1,1,1,0,0,0,0,0,0,0.48808156828023186,0.5119184317197681
90133,0.574468085106383,0.46511627906976744,-135,115,0.5517281312179562,0.44827186878204384,home,DET,under,8.5,0.5348837209302326,-115,0.5119184317197681,DET,CIN,2023 REG,7,3,5,4,7,12,0,1,-1,1,1,1,1,0,0,0,0,0,0,0.48808156828023186,0.5119184317197681
90134,0.47619047619047616,0.5652173913043479,110,-130,0.4564724440500838,0.5435275559499162,away,MIN,over,8.5,0.5391705069124424,-117,0.5153817639191344,DET,MIN,2023 REG,7,1,6,4,5,13,0,1,-3,3,1,0,0,0,0,0,0,0,0,0.5153817639191344,0.4846182360808656
90134,0.47619047619047616,0.5652173913043479,110,-130,0.4564724440500838,0.5435275559499162,home,DET,under,8.5,0.504950495049505,-102,0.4846182360808656,DET,MIN,2023 REG,7,1,6,4,5,13,0,1,-3,3,1,0,0,0,0,0,0,0,0,0.5153817639191344,0.4846182360808656
90135,0.5555555555555556,0.48780487804878053,-125,105,0.5314664257753688,0.46853357422463116,away,NYY,over,10,0.5169082125603864,-107,0.49353874091423283,BOS,NYY,2023 REG,17,15,10,5,20,27,1,0,10,-10,1,1,1,1,1,0,0,0,0,0.49353874091423283,0.5064612590857671
90135,0.5555555555555556,0.48780487804878053,-125,105,0.5314664257753688,0.46853357422463116,home,BOS,under,10,0.5283018867924528,-112,0.5064612590857671,BOS,NYY,2023 REG,17,15,10,5,20,27,1,0,10,-10,1,1,1,1,1,0,0,0,0,0.49353874091423283,0.5064612590857671
90136,0.6721311475409836,0.36363636363636365,-205,175,0.6480906892086682,0.3519093107913318,away,WSH,over,10,0.5454545454545454,-120,0.5206611570247933,ATL,WSH,2023 REG,8,3,6,2,5,14,1,0,1,-1,1,1,0,0,0,0,0,0,0,0.5206611570247933,0.4793388429752067
90136,0.6721311475409836,0.36363636363636365,-205,175,0.6480906892086682,0.3519093107913318,home,ATL,under,10,0.5,100,0.4793388429752067,ATL,WSH,2023 REG,8,3,6,2,5,14,1,0,1,-1,1,1,0,0,0,0,0,0,0,0.5206611570247933,0.4793388429752067
90137,0.6108949416342413,0.425531914893617,-157,135,0.5886419592417365,0.41135804075826354,away,BOS,over,8.5,0.5433789954337899,-119,0.5198077604720502,TB,BOS,2023 REG,5,1,3,0,1,8,1,0,1,-1,0,0,0,0,0,0,0,0,0,0.5198077604720502,0.48019223952794976
90137,0.6108949416342413,0.425531914893617,-157,135,0.5886419592417365,0.41135804075826354,home,TB,under,8.5,0.5,100,0.48019223952794976,TB,BOS,2023 REG,5,1,3,0,1,8,1,0,1,-1,0,0,0,0,0,0,0,0,0,0.5198077604720502,0.48019223952794976
90138,0.44052863436123346,0.6000000000000001,127,-150,0.42267461041355353,0.5773253895864465,away,MIA,over,10,0.5238095238095238,-110,0.5000596729920038,CIN,MIA,2023 REG,6,2,7,3,5,13,0,1,-1,1,1,1,0,0,0,0,0,0,0,0.5000596729920038,0.4999403270079962
90138,0.44052863436123346,0.6000000000000001,127,-150,0.42267461041355353,0.5773253895864465,home,CIN,under,10,0.5215311004784688,-109,0.4999403270079962,CIN,MIA,2023 REG,6,2,7,3,5,13,0,1,-1,1,1,1,0,0,0,0,0,0,0,0.5000596729920038,0.4999403270079962
90139,0.5283018867924528,0.5121951219512195,-112,-105,0.5069072406637203,0.4930927593362797,away,STL,over,8,0.5348837209302326,-115,0.5097020142727117,CWS,STL,2023 REG,9,8,16,7,15,25,1,0,1,-1,1,1,1,1,1,1,1,0,0,0.5097020142727117,0.49029798572728833
90139,0.5283018867924528,0.5121951219512195,-112,-105,0.5069072406637203,0.4930927593362797,home,CWS,under,8,0.5121951219512195,-105,0.49029798572728833,CWS,STL,2023 REG,9,8,16,7,15,25,1,0,1,-1,1,1,1,1,1,1,1,0,0,0.5097020142727117,0.49029798572728833
90140,0.7560975609756098,0.2857142857142857,-310,250,0.7244837256734936,0.2755162743265064,away,LAA,over,7.5,0.5348837209302326,-115,0.5097020142727117,SEA,LAA,2023 REG,5,3,6,2,5,11,1,0,1,-1,1,1,0,0,0,0,0,0,0,0.5097020142727117,0.49029798572728833
90140,0.7560975609756098,0.2857142857142857,-310,250,0.7244837256734936,0.2755162743265064,home,SEA,under,7.5,0.5121951219512195,-105,0.49029798572728833,SEA,LAA,2023 REG,5,3,6,2,5,11,1,0,1,-1,1,1,0,0,0,0,0,0,0,0.5097020142727117,0.49029798572728833
90141,0.5689655172413793,0.4672897196261683,-132,114,0.5483375376443265,0.45166246235567353,away,PHI,over,9.5,0.5238095238095238,-110,0.4988662131519274,TB,PHI,2023 REG,4,1,6,3,4,10,0,1,-2,2,1,0,0,0,0,0,0,0,0,0.4988662131519274,0.5011337868480725
90141,0.5689655172413793,0.4672897196261683,-132,114,0.5483375376443265,0.45166246235567353,home,TB,under,9.5,0.5238095238095238,-110,0.5011337868480725,TB,PHI,2023 REG,4,1,6,3,4,10,0,1,-2,2,1,0,0,0,0,0,0,0,0,0.4988662131519274,0.5011337868480725
90142,0.607843137254902,0.425531914893617,-155,135,0.5875563408509002,0.41244365914909975,away,ARI,over,7,0.5475113122171946,-121,0.5214983313199976,SD,ARI,2023 REG,10,6,9,8,14,19,0,1,-2,2,1,1,1,1,1,1,0,0,0,0.5214983313199976,0.47850166868000243
90142,0.607843137254902,0.425531914893617,-155,135,0.5875563408509002,0.41244365914909975,home,SD,under,7,0.5,100,0.47850166868000243,SD,ARI,2023 REG,10,6,9,8,14,19,0,1,-2,2,1,1,1,1,1,1,0,0,0,0.5214983313199976,0.47850166868000243
90143,0.4587155963302753,0.5833333333333333,118,-140,0.4394270964845833,0.5605729035154168,away,TOR,over,8.5,0.5145631067961165,-106,0.4913668392989033,DET,TOR,2023 REG,11,3,5,4,7,16,0,1,-1,1,1,1,1,0,0,0,0,0,0,0.4913668392989033,0.5086331607010968
90143,0.4587155963302753,0.5833333333333333,118,-140,0.4394270964845833,0.5605729035154168,home,DET,under,8.5,0.5305164319248826,-113,0.5086331607010968,DET,TOR,2023 REG,11,3,5,4,7,16,0,1,-1,1,1,1,1,0,0,0,0,0,0,0.4913668392989033,0.5086331607010968
90144,0.574468085106383,0.46511627906976744,-135,115,0.5517281312179562,0.44827186878204384,away,TEX,over,8.5,0.5495495495495495,-122,0.5223196169142115,BAL,TEX,2023 REG,8,2,13,12,14,21,0,1,-10,10,1,1,0,0,0,0,0,0,0,0.5223196169142115,0.47768038308578853
90144,0.574468085106383,0.46511627906976744,-135,115,0.5517281312179562,0.44827186878204384,home,BAL,under,8.5,0.5,100,0.47768038308578853,BAL,TEX,2023 REG,8,2,13,12,14,21,0,1,-10,10,1,1,0,0,0,0,0,0,0,0.5223196169142115,0.47768038308578853
90145,0.4347826086956522,0.607843137254902,130,-155,0.41624967567367205,0.583750324326328,away,MIL,over,8,0.5121951219512195,-105,0.48808156828023186,CWS,MIL,2023 REG,9,3,7,7,10,16,0,1,-4,4,1,1,1,0,0,0,0,0,0,0.48808156828023186,0.5119184317197681
90145,0.4347826086956522,0.607843137254902,130,-155,0.41624967567367205,0.583750324326328,home,CWS,under,8,0.5348837209302326,-115,0.5119184317197681,CWS,MIL,2023 REG,9,3,7,7,10,16,0,1,-4,4,1,1,1,0,0,0,0,0,0,0.48808156828023186,0.5119184317197681
90146,0.5918367346938775,0.4444444444444444,-145,125,0.5703642001018094,0.42963579989819056,away,CWS,over,8,0.5238095238095238,-110,0.4988662131519274,NYY,CWS,2023 REG,3,2,7,3,5,10,0,1,-1,1,1,1,0,0,0,0,0,0,0,0.4988662131519274,0.5011337868480725
90146,0.5918367346938775,0.4444444444444444,-145,125,0.5703642001018094,0.42963579989819056,home,NYY,under,8,0.5238095238095238,-110,0.5011337868480725,NYY,CWS,2023 REG,3,2,7,3,5,10,0,1,-1,1,1,1,0,0,0,0,0,0,0,0.4988662131519274,0.5011337868480725
90147,0.6774193548387096,0.36363636363636365,-210,175,0.6496074165168858,0.3503925834831142,away,LAA,over,8.5,0.5238095238095238,-110,0.4988662131519274,TB,LAA,2023 REG,9,6,5,2,8,14,1,0,4,-4,1,1,0,0,0,0,0,0,0,0.4988662131519274,0.5011337868480725
90147,0.6774193548387096,0.36363636363636365,-210,175,0.6496074165168858,0.3503925834831142,home,TB,under,8.5,0.5238095238095238,-110,0.5011337868480725,TB,LAA,2023 REG,9,6,5,2,8,14,1,0,4,-4,1,1,0,0,0,0,0,0,0,0.4988662131519274,0.5011337868480725
90148,0.3846153846153846,0.6551724137931035,160,-190,0.3693123852275045,0.6306876147724956,away,PHI,over,9,0.5145631067961165,-106,0.4913668392989033,WSH,PHI,2023 REG,11,8,12,7,15,23,1,0,1,-1,1,1,1,1,1,1,1,0,0,0.4913668392989033,0.5086331607010968
90148,0.3846153846153846,0.6551724137931035,160,-190,0.3693123852275045,0.6306876147724956,home,WSH,under,9,0.5305164319248826,-113,0.5086331607010968,WSH,PHI,2023 REG,11,8,12,7,15,23,1,0,1,-1,1,1,1,1,1,1,1,0,0,0.4913668392989033,0.5086331607010968
90149,0.7058823529411764,0.33783783783783783,-240,196,0.6750210418030487,0.32497895819695133,away,OAK,over,9.5,0.5024875621890548,-101,0.47839724939301687,TEX,OAK,2023 REG,5,3,7,2,5,12,1,0,1,-1,1,1,0,0,0,0,0,0,0,0.47839724939301687,0.5216027506069831
90149,0.7058823529411764,0.33783783783783783,-240,196,0.6750210418030487,0.32497895819695133,home,TEX,under,9.5,0.5454545454545454,-120,0.5216027506069831,TEX,OAK,2023 REG,5,3,7,2,5,12,1,0,1,-1,1,1,0,0,0,0,0,0,0,0.47839724939301687,0.5216027506069831
90150,0.5024875621890548,0.5370370370370371,-101,-116,0.48262694267743644,0.5173730573225636,away,CHC,over,7.5,0.5169082125603864,-107,0.49353874091423283,MIA,CHC,2023 REG,8,3,10,2,5,18,1,0,1,-1,1,1,0,0,0,0,0,0,0,0.49353874091423283,0.5064612590857671
90150,0.5024875621890548,0.5370370370370371,-101,-116,0.48262694267743644,0.5173730573225636,home,MIA,under,7.5,0.5283018867924528,-112,0.5064612590857671,MIA,CHC,2023 REG,8,3,10,2,5,18,1,0,1,-1,1,1,0,0,0,0,0,0,0,0.49353874091423283,0.5064612590857671
90151,0.4444444444444444,0.5934959349593496,125,-146,0.42758205359831375,0.5724179464016863,away,SD,over,8.5,0.5348837209302326,-115,0.5097020142727117,CWS,SD,2023 REG,6,1,12,6,7,18,0,1,-5,5,1,0,0,0,0,0,0,0,0,0.5097020142727117,0.49029798572728833
90151,0.4444444444444444,0.5934959349593496,125,-146,0.42758205359831375,0.5724179464016863,home,CWS,under,8.5,0.5121951219512195,-105,0.49029798572728833,CWS,SD,2023 REG,6,1,12,6,7,18,0,1,-5,5,1,0,0,0,0,0,0,0,0,0.5097020142727117,0.49029798572728833
90152,0.3472222222222222,0.696969696969697,188,-230,0.3318778058361392,0.6681221941638609,away,NYY,over,11,0.5348837209302326,-115,0.5097020142727117,COL,NYY,2023 REG,8,8,9,7,15,17,1,0,1,-1,1,1,1,1,1,1,1,0,0,0.5097020142727117,0.49029798572728833
90152,0.3472222222222222,0.696969696969697,188,-230,0.3318778058361392,0.6681221941638609,home,COL,under,11,0.5121951219512195,-105,0.49029798572728833,COL,NYY,2023 REG,8,8,9,7,15,17,1,0,1,-1,1,1,1,1,1,1,1,0,0,0.5097020142727117,0.49029798572728833
90153,0.3968253968253968,0.6428571428571428,152,-180,0.3810783572688335,0.6189216427311666,away,MIL,over,8.5,0.5238095238095238,-110,0.4988662131519274,CWS,MIL,2023 REG,10,6,11,7,13,21,0,1,-1,1,1,1,1,1,1,1,0,0,0,0.4988662131519274,0.5011337868480725
90153,0.3968253968253968,0.6428571428571428,152,-180,0.3810783572688335,0.6189216427311666,home,CWS,under,8.5,0.5238095238095238,-110,0.5011337868480725,CWS,MIL,2023 REG,10,6,11,7,13,21,0,1,-1,1,1,1,1,1,1,1,0,0,0,0.4988662131519274,0.5011337868480725
90154,0.6226415094339623,0.4166666666666667,-165,140,0.5981666073335706,0.40183339266642937,away,WSH,over,7.5,0.5283018867924528,-112,0.5044173060022736,MIA,WSH,2023 REG,12,5,8,4,9,20,1,0,1,-1,1,1,1,1,0,0,0,0,0,0.5044173060022736,0.49558269399772636
90154,0.6226415094339623,0.4166666666666667,-165,140,0.5981666073335706,0.40183339266642937,home,MIA,under,7.5,0.5169082125603864,-107,0.49558269399772636,MIA,WSH,2023 REG,12,5,8,4,9,20,1,0,1,-1,1,1,1,1,0,0,0,0,0,0.5044173060022736,0.49558269399772636
90155,0.5192307692307692,0.5238095238095238,-108,-110,0.49688292476754015,0.5031170752324599,away,LAD,over,8,0.5121951219512195,-105,0.48808156828023186,SEA,LAD,2023 REG,11,3,8,6,9,19,0,1,-3,3,1,1,1,0,0,0,0,0,0,0.48808156828023186,0.5119184317197681
90155,0.5192307692307692,0.5238095238095238,-108,-110,0.49688292476754015,0.5031170752324599,home,SEA,under,8,0.5348837209302326,-115,0.5119184317197681,SEA,LAD,2023 REG,11,3,8,6,9,19,0,1,-3,3,1,1,1,0,0,0,0,0,0,0.48808156828023186,0.5119184317197681
90156,0.37735849056603776,0.6610169491525424,165,-195,0.36287719255902645,0.6371228074409736,away,TOR,over,8.5,0.5348837209302326,-115,0.5097020142727117,OAK,TOR,2023 REG,8,5,8,6,11,16,0,1,-1,1,1,1,1,1,1,0,0,0,0,0.5097020142727117,0.49029798572728833
90156,0.37735849056603776,0.6610169491525424,165,-195,0.36287719255902645,0.6371228074409736,home,OAK,under,8.5,0.5121951219512195,-105,0.49029798572728833,OAK,TOR,2023 REG,8,5,8,6,11,16,0,1,-1,1,1,1,1,1,1,0,0,0,0,0.5097020142727117,0.49029798572728833
90157,0.6527777777777778,0.3846153846153846,-188,160,0.6283683523266858,0.37163164767331425,away,DET,over,7.5,0.5305164319248826,-113,0.5066009958897986,MIN,DET,2023 REG,7,4,11,6,10,18,0,1,-2,2,1,1,1,1,0,0,0,0,0,0.5066009958897986,0.49339900411020143
90157,0.6527777777777778,0.3846153846153846,-188,160,0.6283683523266858,0.37163164767331425,home,MIN,under,7.5,0.5145631067961165,-106,0.49339900411020143,MIN,DET,2023 REG,7,4,11,6,10,18,0,1,-2,2,1,1,1,1,0,0,0,0,0,0.5066009958897986,0.49339900411020143
90158,0.626865671641791,0.41152263374485604,-168,143,0.6028013608024003,0.3971986391975997,away,MIA,over,9,0.5348837209302326,-115,0.5097020142727117,ATL,MIA,2023 REG,9,7,6,0,7,15,1,0,7,-7,0,0,0,0,0,0,0,0,0,0.5097020142727117,0.49029798572728833
90158,0.626865671641791,0.41152263374485604,-168,143,0.6028013608024003,0.3971986391975997,home,ATL,under,9,0.5121951219512195,-105,0.49029798572728833,ATL,MIA,2023 REG,9,7,6,0,7,15,1,0,7,-7,0,0,0,0,0,0,0,0,0,0.5097020142727117,0.49029798572728833
90159,0.6296296296296295,0.40322580645161293,-170,148,0.6089428735784769,0.3910571264215231,away,CIN,over,9.5,0.5238095238095238,-110,0.4988662131519274,BOS,CIN,2023 REG,14,8,12,9,17,26,0,1,-1,1,1,1,1,1,1,1,1,1,0,0.4988662131519274,0.5011337868480725
90159,0.6296296296296295,0.40322580645161293,-170,148,0.6089428735784769,0.3910571264215231,home,BOS,under,9.5,0.5238095238095238,-110,0.5011337868480725,BOS,CIN,2023 REG,14,8,12,9,17,26,0,1,-1,1,1,1,1,1,1,1,1,1,0,0.4988662131519274,0.5011337868480725
90160,0.6774193548387096,0.36363636363636365,-210,175,0.6496074165168858,0.3503925834831142,away,COL,over,9,0.5121951219512195,-105,0.48808156828023186,ARI,COL,2023 REG,13,12,6,5,17,19,1,0,7,-7,1,1,1,1,1,0,0,0,0,0.48808156828023186,0.5119184317197681
90160,0.6774193548387096,0.36363636363636365,-210,175,0.6496074165168858,0.3503925834831142,home,ARI,under,9,0.5348837209302326,-115,0.5119184317197681,ARI,COL,2023 REG,13,12,6,5,17,19,1,0,7,-7,1,1,1,1,1,0,0,0,0,0.48808156828023186,0.5119184317197681
90161,0.6363636363636364,0.4,-175,150,0.6132231404958678,0.3867768595041322,away,KC,over,8,0.5,100,0.4772727272727273,TOR,KC,2023 REG,6,5,8,2,7,14,1,0,3,-3,1,1,0,0,0,0,0,0,0,0.4772727272727273,0.5227272727272727
90161,0.6363636363636364,0.4,-175,150,0.6132231404958678,0.3867768595041322,home,TOR,under,8,0.5454545454545454,-120,0.5227272727272727,TOR,KC,2023 REG,6,5,8,2,7,14,1,0,3,-3,1,1,0,0,0,0,0,0,0,0.4772727272727273,0.5227272727272727
90162,0.5708154506437768,0.4694835680751174,-133,113,0.5478121481132493,0.4521878518867507,away,MIA,over,7.5,0.5348837209302326,-115,0.5097020142727117,CLE,MIA,2023 REG,7,2,11,3,5,18,0,1,-1,1,1,1,0,0,0,0,0,0,0,0.5097020142727117,0.49029798572728833
90162,0.5708154506437768,0.4694835680751174,-133,113,0.5478121481132493,0.4521878518867507,home,CLE,under,7.5,0.5121951219512195,-105,0.49029798572728833,CLE,MIA,2023 REG,7,2,11,3,5,18,0,1,-1,1,1,1,0,0,0,0,0,0,0,0.5097020142727117,0.49029798572728833
90163,0.6296296296296295,0.4081632653061224,-170,145,0.6058341031886005,0.39416589681139946,away,CIN,over,8.5,0.5454545454545454,-120,0.5206611570247933,CHC,CIN,2023 REG,8,5,12,8,13,20,0,1,-3,3,1,1,1,1,1,0,0,0,0,0.5206611570247933,0.4793388429752067
90163,0.6296296296296295,0.4081632653061224,-170,145,0.6058341031886005,0.39416589681139946,home,CHC,under,8.5,0.5,100,0.4793388429752067,CHC,CIN,2023 REG,8,5,12,8,13,20,0,1,-3,3,1,1,1,1,1,0,0,0,0,0.5206611570247933,0.4793388429752067
90164,0.6226415094339623,0.4166666666666667,-165,140,0.5981666073335706,0.40183339266642937,away,CHC,over,7.5,0.504950495049505,-102,0.47949844489399435,MIN,CHC,2023 REG,13,11,6,1,12,19,1,0,10,-10,1,0,0,0,0,0,0,0,0,0.47949844489399435,0.5205015551060057
90164,0.6226415094339623,0.4166666666666667,-165,140,0.5981666073335706,0.40183339266642937,home,MIN,under,7.5,0.5454545454545454,-120,0.5205015551060057,MIN,CHC,2023 REG,13,11,6,1,12,19,1,0,10,-10,1,0,0,0,0,0,0,0,0,0.47949844489399435,0.5205015551060057
90165,0.6825396825396826,0.35714285714285715,-215,180,0.6554547745023935,0.34454522549760647,away,WSH,over,9,0.5,100,0.4772727272727273,TOR,WSH,2023 REG,12,7,5,0,7,17,1,0,7,-7,0,0,0,0,0,0,0,0,0,0.4772727272727273,0.5227272727272727
90165,0.6825396825396826,0.35714285714285715,-215,180,0.6554547745023935,0.34454522549760647,home,TOR,under,9,0.5454545454545454,-120,0.5227272727272727,TOR,WSH,2023 REG,12,7,5,0,7,17,1,0,7,-7,0,0,0,0,0,0,0,0,0,0.4772727272727273,0.5227272727272727
90166,0.48780487804878053,0.5535714285714286,105,-124,0.4676213138438005,0.5323786861561994,away,TEX,over,7.5,0.5348837209302326,-115,0.5097020142727117,MIN,TEX,2023 REG,5,2,9,6,8,14,0,1,-4,4,1,1,0,0,0,0,0,0,0,0.5097020142727117,0.49029798572728833
90166,0.48780487804878053,0.5535714285714286,105,-124,0.4676213138438005,0.5323786861561994,home,MIN,under,7.5,0.5121951219512195,-105,0.49029798572728833,MIN,TEX,2023 REG,5,2,9,6,8,14,0,1,-4,4,1,1,0,0,0,0,0,0,0,0.5097020142727117,0.49029798572728833
90167,0.5098039215686274,0.5348837209302326,-104,-115,0.4870219861770517,0.5129780138229483,away,PHI,over,7.5,0.5283018867924528,-112,0.5031902949311281,TOR,PHI,2023 REG,4,2,4,1,3,8,1,0,1,-1,1,0,0,0,0,0,0,0,0,0.5031902949311281,0.4968097050688719
90167,0.5098039215686274,0.5348837209302326,-104,-115,0.4870219861770517,0.5129780138229483,home,TOR,under,7.5,0.5192307692307692,-108,0.4968097050688719,TOR,PHI,2023 REG,4,2,4,1,3,8,1,0,1,-1,1,0,0,0,0,0,0,0,0,0.5031902949311281,0.4968097050688719
90168,0.3278688524590164,0.7142857142857143,205,-250,0.3140476830345145,0.6859523169654855,away,LAD,over,9.5,0.48780487804878053,105,0.4666534470222751,CIN,LAD,2023 REG,6,0,12,6,6,18,0,1,-6,6,0,0,0,0,0,0,0,0,0,0.4666534470222751,0.5333465529777248
90168,0.3278688524590164,0.7142857142857143,205,-250,0.3140476830345145,0.6859523169654855,home,CIN,under,9.5,0.5555555555555556,-125,0.5333465529777248,CIN,LAD,2023 REG,6,0,12,6,6,18,0,1,-6,6,0,0,0,0,0,0,0,0,0,0.4666534470222751,0.5333465529777248
90169,0.7333333333333333,0.3076923076923077,-275,225,0.7032478632478633,0.29675213675213674,away,OAK,over,9,0.5192307692307692,-108,0.49455035168025013,HOU,OAK,2023 REG,9,6,2,2,8,11,1,0,4,-4,1,1,0,0,0,0,0,0,0,0.49455035168025013,0.5054496483197499
90169,0.7333333333333333,0.3076923076923077,-275,225,0.7032478632478633,0.29675213675213674,home,HOU,under,9,0.5283018867924528,-112,0.5054496483197499,HOU,OAK,2023 REG,9,6,2,2,8,11,1,0,4,-4,1,1,0,0,0,0,0,0,0,0.49455035168025013,0.5054496483197499
90170,0.6363636363636364,0.4,-175,150,0.6132231404958678,0.3867768595041322,away,NYY,over,8.5,0.5327102803738317,-114,0.508788710910954,LAD,NYY,2023 REG,4,1,5,4,5,9,0,1,-3,3,1,0,0,0,0,0,0,0,0,0.508788710910954,0.491211289089046
90170,0.6363636363636364,0.4,-175,150,0.6132231404958678,0.3867768595041322,home,LAD,under,8.5,0.5121951219512195,-105,0.491211289089046,LAD,NYY,2023 REG,4,1,5,4,5,9,0,1,-3,3,1,0,0,0,0,0,0,0,0,0.508788710910954,0.491211289089046
90171,0.5833333333333333,0.4587155963302753,-140,118,0.5588047910295616,0.4411952089704384,away,PHI,over,6.5,0.5454545454545454,-120,0.5206611570247933,TEX,PHI,2023 REG,10,11,12,7,18,22,1,0,4,-4,1,1,1,1,1,1,1,0,0,0.5206611570247933,0.4793388429752067
90171,0.5833333333333333,0.4587155963302753,-140,118,0.5588047910295616,0.4411952089704384,home,TEX,under,6.5,0.5,100,0.4793388429752067,TEX,PHI,2023 REG,10,11,12,7,18,22,1,0,4,-4,1,1,1,1,1,1,1,0,0,0.5206611570247933,0.4793388429752067
90172,0.6000000000000001,0.4347826086956522,-150,130,0.5791304347826086,0.4208695652173914,away,SEA,over,8.5,0.5495495495495495,-122,0.5223196169142115,ATL,SEA,2023 REG,11,6,8,2,8,19,1,0,4,-4,1,1,0,0,0,0,0,0,0,0.5223196169142115,0.47768038308578853
90172,0.6000000000000001,0.4347826086956522,-150,130,0.5791304347826086,0.4208695652173914,home,ATL,under,8.5,0.5,100,0.47768038308578853,ATL,SEA,2023 REG,11,6,8,2,8,19,1,0,4,-4,1,1,0,0,0,0,0,0,0,0.5223196169142115,0.47768038308578853
90173,0.47619047619047616,0.5652173913043479,110,-130,0.4564724440500838,0.5435275559499162,away,TB,over,8.5,0.5454545454545454,-120,0.5179608869977906,LAA,TB,2023 REG,8,4,19,18,22,27,0,1,-14,14,1,1,1,1,0,0,0,0,0,0.5179608869977906,0.48203911300220936
90173,0.47619047619047616,0.5652173913043479,110,-130,0.4564724440500838,0.5435275559499162,home,LAA,under,8.5,0.504950495049505,-102,0.48203911300220936,LAA,TB,2023 REG,8,4,19,18,22,27,0,1,-14,14,1,1,1,1,0,0,0,0,0,0.5179608869977906,0.48203911300220936
90174,0.5689655172413793,0.4716981132075471,-132,112,0.5458293137100936,0.4541706862899064,away,CIN,over,7.5,0.5327102803738317,-114,0.508788710910954,SF,CIN,2023 REG,8,4,6,1,5,14,1,0,3,-3,1,0,0,0,0,0,0,0,0,0.508788710910954,0.491211289089046
90174,0.5689655172413793,0.4716981132075471,-132,112,0.5458293137100936,0.4541706862899064,home,SF,under,7.5,0.5121951219512195,-105,0.491211289089046,SF,CIN,2023 REG,8,4,6,1,5,14,1,0,3,-3,1,0,0,0,0,0,0,0,0,0.508788710910954,0.491211289089046
90175,0.38759689922480617,0.6527777777777778,158,-188,0.37194779961140156,0.6280522003885984,away,MIL,over,8.5,0.5121951219512195,-105,0.48808156828023186,PIT,MIL,2023 REG,8,5,8,4,9,16,1,0,1,-1,1,1,1,1,0,0,0,0,0,0.48808156828023186,0.5119184317197681
90175,0.38759689922480617,0.6527777777777778,158,-188,0.37194779961140156,0.6280522003885984,home,PIT,under,8.5,0.5348837209302326,-115,0.5119184317197681,PIT,MIL,2023 REG,8,5,8,4,9,16,1,0,1,-1,1,1,1,1,0,0,0,0,0,0.48808156828023186,0.5119184317197681
90176,0.6226415094339623,0.4166666666666667,-165,140,0.5981666073335706,0.40183339266642937,away,SD,over,9.5,0.5283018867924528,-112,0.5031902949311281,LAD,SD,2023 REG,9,8,13,11,19,22,0,1,-3,3,1,1,1,1,1,1,1,1,0,0.5031902949311281,0.4968097050688719
90176,0.6226415094339623,0.4166666666666667,-165,140,0.5981666073335706,0.40183339266642937,home,LAD,under,9.5,0.5192307692307692,-108,0.4968097050688719,LAD,SD,2023 REG,9,8,13,11,19,22,0,1,-3,3,1,1,1,1,1,1,1,1,0,0.5031902949311281,0.4968097050688719
90177,0.6923076923076923,0.3508771929824561,-225,185,0.6624104640298972,0.33758953597010277,away,ARI,over,9,0.5121951219512195,-105,0.48808156828023186,PHI,ARI,2023 REG,6,3,10,6,9,16,0,1,-3,3,1,1,1,0,0,0,0,0,0,0.48808156828023186,0.5119184317197681
90177,0.6923076923076923,0.3508771929824561,-225,185,0.6624104640298972,0.33758953597010277,home,PHI,under,9,0.5348837209302326,-115,0.5119184317197681,PHI,ARI,2023 REG,6,3,10,6,9,16,0,1,-3,3,1,1,1,0,0,0,0,0,0,0.48808156828023186,0.5119184317197681
90178,0.5454545454545454,0.49504950495049505,-120,102,0.5233614270517961,0.4766385729482039,away,HOU,over,9.5,0.5238095238095238,-110,0.4988662131519274,ARI,HOU,2023 REG,4,1,8,2,3,12,0,1,-1,1,1,0,0,0,0,0,0,0,0,0.4988662131519274,0.5011337868480725
90178,0.5454545454545454,0.49504950495049505,-120,102,0.5233614270517961,0.4766385729482039,home,ARI,under,9.5,0.5238095238095238,-110,0.5011337868480725,ARI,HOU,2023 REG,4,1,8,2,3,12,0,1,-1,1,1,0,0,0,0,0,0,0,0,0.4988662131519274,0.5011337868480725
90179,0.7142857142857143,0.32573289902280134,-250,207,0.6857009904939174,0.3142990095060826,away,LAA,over,9,0.5454545454545454,-120,0.5179608869977906,ATL,LAA,2023 REG,7,5,6,1,6,13,1,0,4,-4,1,0,0,0,0,0,0,0,0,0.5179608869977906,0.48203911300220936
90179,0.7142857142857143,0.32573289902280134,-250,207,0.6857009904939174,0.3142990095060826,home,ATL,under,9,0.504950495049505,-102,0.48203911300220936,ATL,LAA,2023 REG,7,5,6,1,6,13,1,0,4,-4,1,0,0,0,0,0,0,0,0,0.5179608869977906,0.48203911300220936
90180,0.7701149425287357,0.2777777777777778,-335,260,0.7332320429823401,0.2667679570176599,away,CWS,over,8,0.5370370370370371,-116,0.5118817074154765,ATL,CWS,2023 REG,11,5,11,6,11,22,0,1,-1,1,1,1,1,1,1,0,0,0,0,0.5118817074154765,0.48811829258452355
90180,0.7701149425287357,0.2777777777777778,-335,260,0.7332320429823401,0.2667679570176599,home,ATL,under,8,0.5098039215686274,-104,0.48811829258452355,ATL,CWS,2023 REG,11,5,11,6,11,22,0,1,-1,1,1,1,1,1,1,0,0,0,0,0.5118817074154765,0.48811829258452355
90181,0.5238095238095238,0.5192307692307692,-110,-108,0.5012646084074657,0.4987353915925343,away,HOU,over,9.5,0.5348837209302326,-115,0.5097020142727117,TEX,HOU,2023 REG,9,6,16,13,19,25,0,1,-7,7,1,1,1,1,1,1,0,0,0,0.5097020142727117,0.49029798572728833
90181,0.5238095238095238,0.5192307692307692,-110,-108,0.5012646084074657,0.4987353915925343,home,TEX,under,9.5,0.5121951219512195,-105,0.49029798572728833,TEX,HOU,2023 REG,9,6,16,13,19,25,0,1,-7,7,1,1,1,1,1,1,0,0,0,0.5097020142727117,0.49029798572728833
90182,0.6240601503759399,0.41493775933609955,-166,141,0.5997231089766972,0.40027689102330277,away,CIN,over,8.5,0.5348837209302326,-115,0.5097020142727117,CHC,CIN,2023 REG,21,20,12,9,29,33,1,0,11,-11,1,1,1,1,1,1,1,1,1,0.5097020142727117,0.49029798572728833
90182,0.6240601503759399,0.41493775933609955,-166,141,0.5997231089766972,0.40027689102330277,home,CHC,under,8.5,0.5121951219512195,-105,0.49029798572728833,CHC,CIN,2023 REG,21,20,12,9,29,33,1,0,11,-11,1,1,1,1,1,1,1,1,1,0.5097020142727117,0.49029798572728833
90183,0.6254681647940076,0.41152263374485604,-167,143,0.6023315979176397,0.3976684020823603,away,CLE,over,7.5,0.5121951219512195,-105,0.48808156828023186,MIN,CLE,2023 REG,7,2,11,4,6,18,0,1,-2,2,1,1,0,0,0,0,0,0,0,0.48808156828023186,0.5119184317197681
90183,0.6254681647940076,0.41152263374485604,-167,143,0.6023315979176397,0.3976684020823603,home,MIN,under,7.5,0.5348837209302326,-115,0.5119184317197681,MIN,CLE,2023 REG,7,2,11,4,6,18,0,1,-2,2,1,1,0,0,0,0,0,0,0,0.48808156828023186,0.5119184317197681
90184,0.574468085106383,0.4672897196261683,-135,114,0.550479558983428,0.44952044101657196,away,DET,over,8.5,0.5348837209302326,-115,0.5097020142727117,WSH,DET,2023 REG,18,6,6,4,10,24,1,0,2,-2,1,1,1,1,0,0,0,0,0,0.5097020142727117,0.49029798572728833
90184,0.574468085106383,0.4672897196261683,-135,114,0.550479558983428,0.44952044101657196,home,WSH,under,8.5,0.5121951219512195,-105,0.49029798572728833,WSH,DET,2023 REG,18,6,6,4,10,24,1,0,2,-2,1,1,1,1,0,0,0,0,0,0.5097020142727117,0.49029798572728833
90185,0.5575221238938054,0.4807692307692307,-126,108,0.5361738465152985,0.46382615348470146,away,STL,over,9.5,0.5121951219512195,-105,0.48808156828023186,CWS,STL,2023 REG,5,3,5,4,7,10,0,1,-1,1,1,1,1,0,0,0,0,0,0,0.48808156828023186,0.5119184317197681
90185,0.5575221238938054,0.4807692307692307,-126,108,0.5361738465152985,0.46382615348470146,home,CWS,under,9.5,0.5348837209302326,-115,0.5119184317197681,CWS,STL,2023 REG,5,3,5,4,7,10,0,1,-1,1,1,1,1,0,0,0,0,0,0,0.48808156828023186,0.5119184317197681
90186,0.4716981132075471,0.5633187772925764,112,-129,0.45518071202824356,0.5448192879717564,away,TOR,over,9,0.5,100,0.4772727272727273,PIT,TOR,2023 REG,8,1,15,10,11,23,0,1,-9,9,1,0,0,0,0,0,0,0,0,0.4772727272727273,0.5227272727272727
90186,0.4716981132075471,0.5633187772925764,112,-129,0.45518071202824356,0.5448192879717564,home,PIT,under,9,0.5454545454545454,-120,0.5227272727272727,PIT,TOR,2023 REG,8,1,15,10,11,23,0,1,-9,9,1,0,0,0,0,0,0,0,0,0.4772727272727273,0.5227272727272727
90187,0.43859649122807015,0.6000000000000001,128,-150,0.4216682056017235,0.5783317943982764,away,LAD,over,17.5,0.49504950495049505,102,0.4615351100989763,STL,LAD,2023 REG,12,16,9,8,24,21,1,0,8,-8,1,1,1,1,1,1,1,1,0,0.4615351100989763,0.5384648899010237
90187,0.43859649122807015,0.6000000000000001,128,-150,0.4216682056017235,0.5783317943982764,home,STL,under,17.5,0.5726495726495727,-134,0.5384648899010237,STL,LAD,2023 REG,12,16,9,8,24,21,1,0,8,-8,1,1,1,1,1,1,1,1,0,0.4615351100989763,0.5384648899010237
90188,0.5495495495495495,0.49019607843137253,-122,104,0.5277073575960698,0.4722926424039302,away,SEA,over,9.5,0.5238095238095238,-110,0.4988662131519274,LAA,SEA,2023 REG,6,2,7,3,5,13,0,1,-1,1,1,1,0,0,0,0,0,0,0,0.4988662131519274,0.5011337868480725
90188,0.5495495495495495,0.49019607843137253,-122,104,0.5277073575960698,0.4722926424039302,home,LAA,under,9.5,0.5238095238095238,-110,0.5011337868480725,LAA,SEA,2023 REG,6,2,7,3,5,13,0,1,-1,1,1,1,0,0,0,0,0,0,0,0.4988662131519274,0.5011337868480725
90189,0.5454545454545454,0.5,-120,100,0.5206611570247933,0.4793388429752067,away,TEX,over,9,0.5,100,0.4772727272727273,MIN,TEX,2023 REG,11,7,10,5,12,21,1,0,2,-2,1,1,1,1,1,0,0,0,0,0.4772727272727273,0.5227272727272727
90189,0.5454545454545454,0.5,-120,100,0.5206611570247933,0.4793388429752067,home,MIN,under,9,0.5454545454545454,-120,0.5227272727272727,MIN,TEX,2023 REG,11,7,10,5,12,21,1,0,2,-2,1,1,1,1,1,0,0,0,0,0.4772727272727273,0.5227272727272727
90190,0.6923076923076923,0.3472222222222222,-225,188,0.6649408284023669,0.3350591715976331,away,COL,over,9.5,0.5073891625615764,-103,0.48484779035144243,MIL,COL,2023 REG,10,7,7,6,13,17,1,0,1,-1,1,1,1,1,1,1,0,0,0,0.48484779035144243,0.5151522096485576
90190,0.6923076923076923,0.3472222222222222,-225,188,0.6649408284023669,0.3350591715976331,home,MIL,under,9.5,0.5370370370370371,-116,0.5151522096485576,MIL,COL,2023 REG,10,7,7,6,13,17,1,0,1,-1,1,1,1,1,1,1,0,0,0,0.48484779035144243,0.5151522096485576
90191,0.5305164319248826,0.5121951219512195,-113,-105,0.5078572507605655,0.49214274923943446,away,CIN,over,9.5,0.5433789954337899,-119,0.5184560714286826,PIT,CIN,2023 REG,9,5,12,6,11,21,0,1,-1,1,1,1,1,1,1,0,0,0,0,0.5184560714286826,0.48154392857131745
90191,0.5305164319248826,0.5121951219512195,-113,-105,0.5078572507605655,0.49214274923943446,home,PIT,under,9.5,0.5024875621890548,-101,0.48154392857131745,PIT,CIN,2023 REG,9,5,12,6,11,21,0,1,-1,1,1,1,1,1,1,0,0,0,0,0.5184560714286826,0.48154392857131745
90192,0.5348837209302326,0.5,-115,100,0.5162249864791779,0.4837750135208221,away,DET,over,8.5,0.5348837209302326,-115,0.5097020142727117,KC,DET,2023 REG,5,5,11,8,13,16,0,1,-3,3,1,1,1,1,1,0,0,0,0,0.5097020142727117,0.49029798572728833
90192,0.5348837209302326,0.5,-115,100,0.5162249864791779,0.4837750135208221,home,KC,under,8.5,0.5121951219512195,-105,0.49029798572728833,KC,DET,2023 REG,5,5,11,8,13,16,0,1,-3,3,1,1,1,1,1,0,0,0,0,0.5097020142727117,0.49029798572728833
90193,0.49504950495049505,0.5454545454545454,102,-120,0.47499799484898986,0.5250020051510101,away,PHI,over,7.5,0.5348837209302326,-115,0.5097020142727117,SD,PHI,2023 REG,3,1,12,5,6,15,0,1,-4,4,1,0,0,0,0,0,0,0,0,0.5097020142727117,0.49029798572728833
90193,0.49504950495049505,0.5454545454545454,102,-120,0.47499799484898986,0.5250020051510101,home,SD,under,7.5,0.5121951219512195,-105,0.49029798572728833,SD,PHI,2023 REG,3,1,12,5,6,15,0,1,-4,4,1,0,0,0,0,0,0,0,0,0.5097020142727117,0.49029798572728833
90194,0.49019607843137253,0.5495495495495495,104,-122,0.4707129274603323,0.5292870725396677,away,STL,over,10,0.5121951219512195,-105,0.48808156828023186,PIT,STL,2023 REG,16,11,5,1,12,21,1,0,10,-10,1,0,0,0,0,0,0,0,0,0.48808156828023186,0.5119184317197681
90194,0.49019607843137253,0.5495495495495495,104,-122,0.4707129274603323,0.5292870725396677,home,PIT,under,10,0.5348837209302326,-115,0.5119184317197681,PIT,STL,2023 REG,16,11,5,1,12,21,1,0,10,-10,1,0,0,0,0,0,0,0,0,0.48808156828023186,0.5119184317197681
90195,0.38759689922480617,0.646643109540636,158,-183,0.37432557799789057,0.6256744220021094,away,BAL,over,8.5,0.5370370370370371,-116,0.5118817074154765,KC,BAL,2023 REG,7,7,15,11,18,22,0,1,-4,4,1,1,1,1,1,1,1,0,0,0.5118817074154765,0.48811829258452355
90195,0.38759689922480617,0.646643109540636,158,-183,0.37432557799789057,0.6256744220021094,home,KC,under,8.5,0.5098039215686274,-104,0.48811829258452355,KC,BAL,2023 REG,7,7,15,11,18,22,0,1,-4,4,1,1,1,1,1,1,1,0,0,0.5118817074154765,0.48811829258452355
90196,0.4854368932038835,0.5555555555555556,106,-125,0.465537646233282,0.534462353766718,away,DET,over,8.5,0.5238095238095238,-110,0.4988662131519274,PIT,DET,2023 REG,9,3,8,6,9,17,0,1,-3,3,1,1,1,0,0,0,0,0,0,0.4988662131519274,0.5011337868480725
90196,0.4854368932038835,0.5555555555555556,106,-125,0.465537646233282,0.534462353766718,home,PIT,under,8.5,0.5238095238095238,-110,0.5011337868480725,PIT,DET,2023 REG,9,3,8,6,9,17,0,1,-3,3,1,1,1,0,0,0,0,0,0,0.4988662131519274,0.5011337868480725
90197,0.43859649122807015,0.6031746031746031,128,-152,0.4202758357883012,0.5797241642116988,away,NYM,over,9.5,0.5283018867924528,-112,0.5044173060022736,KC,NYM,2023 REG,9,7,8,6,13,17,1,0,1,-1,1,1,1,1,1,1,0,0,0,0.5044173060022736,0.49558269399772636
90197,0.43859649122807015,0.6031746031746031,128,-152,0.4202758357883012,0.5797241642116988,home,KC,under,9.5,0.5169082125603864,-107,0.49558269399772636,KC,NYM,2023 REG,9,7,8,6,13,17,1,0,1,-1,1,1,1,1,1,1,0,0,0,0.5044173060022736,0.49558269399772636
90198,0.43103448275862066,0.6108949416342413,132,-157,0.41296145500307674,0.5870385449969233,away,NYM,over,9,0.5,100,0.4772727272727273,KC,NYM,2023 REG,12,4,9,0,4,21,1,0,4,-4,0,0,0,0,0,0,0,0,0,0.4772727272727273,0.5227272727272727
90198,0.43103448275862066,0.6108949416342413,132,-157,0.41296145500307674,0.5870385449969233,home,KC,under,9,0.5454545454545454,-120,0.5227272727272727,KC,NYM,2023 REG,12,4,9,0,4,21,1,0,4,-4,0,0,0,0,0,0,0,0,0,0.4772727272727273,0.5227272727272727
90199,0.5454545454545454,0.5,-120,100,0.5206611570247933,0.4793388429752067,away,MIL,over,9.5,0.5121951219512195,-105,0.48808156828023186,CIN,MIL,2023 REG,6,1,7,5,6,13,0,1,-4,4,1,0,0,0,0,0,0,0,0,0.48808156828023186,0.5119184317197681
90199,0.5454545454545454,0.5,-120,100,0.5206611570247933,0.4793388429752067,home,CIN,under,9.5,0.5348837209302326,-115,0.5119184317197681,CIN,MIL,2023 REG,6,1,7,5,6,13,0,1,-4,4,1,0,0,0,0,0,0,0,0,0.48808156828023186,0.5119184317197681
90200,0.5594713656387665,0.47846889952153115,-127,109,0.5382448736768379,0.46175512632316207,away,SEA,over,7.5,0.5283018867924528,-112,0.5044173060022736,CLE,SEA,2023 REG,7,3,10,5,8,17,0,1,-2,2,1,1,1,0,0,0,0,0,0,0.5044173060022736,0.49558269399772636
90200,0.5594713656387665,0.47846889952153115,-127,109,0.5382448736768379,0.46175512632316207,home,CLE,under,7.5,0.5169082125603864,-107,0.49558269399772636,CLE,SEA,2023 REG,7,3,10,5,8,17,0,1,-2,2,1,1,1,0,0,0,0,0,0,0.5044173060022736,0.49558269399772636
90201,0.6845425867507886,0.35714285714285715,-217,180,0.6560071251579774,0.34399287484202257,away,KC,over,8,0.5121951219512195,-105,0.48808156828023186,SF,KC,2023 REG,5,1,9,3,4,14,0,1,-2,2,1,0,0,0,0,0,0,0,0,0.48808156828023186,0.5119184317197681
90201,0.6845425867507886,0.35714285714285715,-217,180,0.6560071251579774,0.34399287484202257,home,SF,under,8,0.5348837209302326,-115,0.5119184317197681,SF,KC,2023 REG,5,1,9,3,4,14,0,1,-2,2,1,0,0,0,0,0,0,0,0,0.48808156828023186,0.5119184317197681
90202,0.5238095238095238,0.5238095238095238,-110,-110,0.4988662131519274,0.5011337868480725,away,PHI,over,9.5,0.504950495049505,-102,0.4826715732667395,ATL,PHI,2023 REG,12,8,11,5,13,23,1,0,3,-3,1,1,1,1,1,0,0,0,0,0.4826715732667395,0.5173284267332605
90202,0.5238095238095238,0.5238095238095238,-110,-110,0.4988662131519274,0.5011337868480725,home,ATL,under,9.5,0.5391705069124424,-117,0.5173284267332605,ATL,PHI,2023 REG,12,8,11,5,13,23,1,0,3,-3,1,1,1,1,1,0,0,0,0,0.4826715732667395,0.5173284267332605
90203,0.6610169491525424,0.38167938931297707,-195,162,0.6327939457600804,0.3672060542399196,away,COL,over,8.5,0.5098039215686274,-104,0.4870219861770517,SF,COL,2023 REG,5,2,9,5,7,14,0,1,-3,3,1,1,0,0,0,0,0,0,0,0.4870219861770517,0.5129780138229483
90203,0.6610169491525424,0.38167938931297707,-195,162,0.6327939457600804,0.3672060542399196,home,SF,under,8.5,0.5348837209302326,-115,0.5129780138229483,SF,COL,2023 REG,5,2,9,5,7,14,0,1,-3,3,1,1,0,0,0,0,0,0,0,0.4870219861770517,0.5129780138229483
90204,0.5867768595041323,0.45454545454545453,-142,120,0.5625298818386723,0.43747011816132775,away,BOS,over,7.5,0.5215311004784688,-109,0.4978845547971712,MIN,BOS,2023 REG,7,3,10,9,12,17,0,1,-6,6,1,1,1,0,0,0,0,0,0,0.4978845547971712,0.5021154452028288
90204,0.5867768595041323,0.45454545454545453,-142,120,0.5625298818386723,0.43747011816132775,home,MIN,under,7.5,0.5238095238095238,-110,0.5021154452028288,MIN,BOS,2023 REG,7,3,10,9,12,17,0,1,-6,6,1,1,1,0,0,0,0,0,0,0.4978845547971712,0.5021154452028288
90205,0.6666666666666666,0.37037037037037035,-200,170,0.6419753086419753,0.3580246913580247,away,WSH,over,8.5,0.5391705069124424,-117,0.5127649394825569,MIA,WSH,2023 REG,6,2,7,1,3,13,1,0,1,-1,1,0,0,0,0,0,0,0,0,0.5127649394825569,0.48723506051744314
90205,0.6666666666666666,0.37037037037037035,-200,170,0.6419753086419753,0.3580246913580247,home,MIA,under,8.5,0.5098039215686274,-104,0.48723506051744314,MIA,WSH,2023 REG,6,2,7,1,3,13,1,0,1,-1,1,0,0,0,0,0,0,0,0,0.5127649394825569,0.48723506051744314
90206,0.5833333333333333,0.4587155963302753,-140,118,0.5588047910295616,0.4411952089704384,away,BAL,over,8,0.5348837209302326,-115,0.5097020142727117,CHC,BAL,2023 REG,4,3,7,2,5,11,1,0,1,-1,1,1,0,0,0,0,0,0,0,0.5097020142727117,0.49029798572728833
90206,0.5833333333333333,0.4587155963302753,-140,118,0.5588047910295616,0.4411952089704384,home,CHC,under,8,0.5121951219512195,-105,0.49029798572728833,CHC,BAL,2023 REG,4,3,7,2,5,11,1,0,1,-1,1,1,0,0,0,0,0,0,0,0.5097020142727117,0.49029798572728833
90207,0.5983935742971888,0.4444444444444444,-149,125,0.5727595791465728,0.42724042085342717,away,MIA,over,9,0.5348837209302326,-115,0.5097020142727117,TEX,MIA,2023 REG,9,9,11,8,17,20,1,0,1,-1,1,1,1,1,1,1,1,1,0,0.5097020142727117,0.49029798572728833
90207,0.5983935742971888,0.4444444444444444,-149,125,0.5727595791465728,0.42724042085342717,home,TEX,under,9,0.5121951219512195,-105,0.49029798572728833,TEX,MIA,2023 REG,9,9,11,8,17,20,1,0,1,-1,1,1,1,1,1,1,1,1,0,0.5097020142727117,0.49029798572728833
90208,0.574468085106383,0.46511627906976744,-135,115,0.5517281312179562,0.44827186878204384,away,CIN,over,12.5,0.5238095238095238,-110,0.4988662131519274,COL,CIN,2023 REG,4,1,6,3,4,10,0,1,-2,2,1,0,0,0,0,0,0,0,0,0.4988662131519274,0.5011337868480725
90208,0.574468085106383,0.46511627906976744,-135,115,0.5517281312179562,0.44827186878204384,home,COL,under,12.5,0.5238095238095238,-110,0.5011337868480725,COL,CIN,2023 REG,4,1,6,3,4,10,0,1,-2,2,1,0,0,0,0,0,0,0,0,0.4988662131519274,0.5011337868480725
90209,0.4672897196261683,0.5726495726495727,114,-134,0.44862649893656975,0.5513735010634302,away,SEA,over,9,0.5327102803738317,-114,0.5075272610403079,LAA,SEA,2023 REG,6,2,7,3,5,13,0,1,-1,1,1,1,0,0,0,0,0,0,0,0.5075272610403079,0.4924727389596921
90209,0.4672897196261683,0.5726495726495727,114,-134,0.44862649893656975,0.5513735010634302,home,LAA,under,9,0.5145631067961165,-106,0.4924727389596921,LAA,SEA,2023 REG,6,2,7,3,5,13,0,1,-1,1,1,1,0,0,0,0,0,0,0,0.5075272610403079,0.4924727389596921
90210,0.6376811594202898,0.4,-176,150,0.6136525939928585,0.38634740600714146,away,DET,over,8.5,0.5348837209302326,-115,0.5097020142727117,MIL,DET,2023 REG,5,3,12,4,7,17,0,1,-1,1,1,1,1,0,0,0,0,0,0,0.5097020142727117,0.49029798572728833
90210,0.6376811594202898,0.4,-176,150,0.6136525939928585,0.38634740600714146,home,MIL,under,8.5,0.5121951219512195,-105,0.49029798572728833,MIL,DET,2023 REG,5,3,12,4,7,17,0,1,-1,1,1,1,1,0,0,0,0,0,0,0.5097020142727117,0.49029798572728833
90211,0.574468085106383,0.46511627906976744,-135,115,0.5517281312179562,0.44827186878204384,away,HOU,over,8.5,0.5,100,0.4772727272727273,LAD,HOU,2023 REG,6,5,10,6,11,16,0,1,-1,1,1,1,1,1,1,0,0,0,0,0.4772727272727273,0.5227272727272727
90211,0.574468085106383,0.46511627906976744,-135,115,0.5517281312179562,0.44827186878204384,home,LAD,under,8.5,0.5454545454545454,-120,0.5227272727272727,LAD,HOU,2023 REG,6,5,10,6,11,16,0,1,-1,1,1,1,1,1,1,0,0,0,0,0.4772727272727273,0.5227272727272727
90212,0.4444444444444444,0.5967741935483871,125,-148,0.42612504978096366,0.5738749502190363,away,HOU,over,9.5,0.504950495049505,-102,0.48160416005266615,KC,HOU,2023 REG,9,10,12,8,18,21,1,0,2,-2,1,1,1,1,1,1,1,1,0,0.48160416005266615,0.5183958399473338
90212,0.4444444444444444,0.5967741935483871,125,-148,0.42612504978096366,0.5738749502190363,home,KC,under,9.5,0.5412844036697247,-118,0.5183958399473338,KC,HOU,2023 REG,9,10,12,8,18,21,1,0,2,-2,1,1,1,1,1,1,1,1,0,0.48160416005266615,0.5183958399473338
90213,0.45454545454545453,0.5850622406639003,120,-141,0.4365419567230205,0.5634580432769796,away,BOS,over,8,0.5283018867924528,-112,0.5044173060022736,DET,BOS,2023 REG,6,3,7,6,9,13,0,1,-3,3,1,1,1,0,0,0,0,0,0,0.5044173060022736,0.49558269399772636
90213,0.45454545454545453,0.5850622406639003,120,-141,0.4365419567230205,0.5634580432769796,home,DET,under,8,0.5169082125603864,-107,0.49558269399772636,DET,BOS,2023 REG,6,3,7,6,9,13,0,1,-3,3,1,1,1,0,0,0,0,0,0,0.5044173060022736,0.49558269399772636
90214,0.47619047619047616,0.5652173913043479,110,-130,0.4564724440500838,0.5435275559499162,away,MIA,over,9.5,0.5238095238095238,-110,0.4988662131519274,WSH,MIA,2023 REG,10,5,18,11,16,28,0,1,-6,6,1,1,1,1,1,0,0,0,0,0.4988662131519274,0.5011337868480725
90214,0.47619047619047616,0.5652173913043479,110,-130,0.4564724440500838,0.5435275559499162,home,WSH,under,9.5,0.5238095238095238,-110,0.5011337868480725,WSH,MIA,2023 REG,10,5,18,11,16,28,0,1,-6,6,1,1,1,1,1,0,0,0,0,0.4988662131519274,0.5011337868480725
90215,0.6363636363636364,0.4,-175,150,0.6132231404958678,0.3867768595041322,away,OAK,over,9,0.5495495495495495,-122,0.5236866555946829,STL,OAK,2023 REG,9,0,14,8,8,23,0,1,-8,8,0,0,0,0,0,0,0,0,0,0.5236866555946829,0.47631334440531714
90215,0.6363636363636364,0.4,-175,150,0.6132231404958678,0.3867768595041322,home,STL,under,9,0.49751243781094534,101,0.47631334440531714,STL,OAK,2023 REG,9,0,14,8,8,23,0,1,-8,8,0,0,0,0,0,0,0,0,0,0.5236866555946829,0.47631334440531714
90216,0.574468085106383,0.4716981132075471,-135,112,0.547947077564338,0.452052922435662,away,NYY,over,7,0.5454545454545454,-120,0.5179608869977906,TB,NYY,2023 REG,4,2,11,6,8,15,0,1,-4,4,1,1,0,0,0,0,0,0,0,0.5179608869977906,0.48203911300220936
90216,0.574468085106383,0.4716981132075471,-135,112,0.547947077564338,0.452052922435662,home,TB,under,7,0.504950495049505,-102,0.48203911300220936,TB,NYY,2023 REG,4,2,11,6,8,15,0,1,-4,4,1,1,0,0,0,0,0,0,0,0.5179608869977906,0.48203911300220936
90217,0.49751243781094534,0.5433789954337899,101,-119,0.4771684411717736,0.5228315588282264,away,BOS,over,8.5,0.5145631067961165,-106,0.4913668392989033,BAL,BOS,2023 REG,13,5,7,4,9,20,1,0,1,-1,1,1,1,1,0,0,0,0,0,0.4913668392989033,0.5086331607010968
90217,0.49751243781094534,0.5433789954337899,101,-119,0.4771684411717736,0.5228315588282264,home,BAL,under,8.5,0.5305164319248826,-113,0.5086331607010968,BAL,BOS,2023 REG,13,5,7,4,9,20,1,0,1,-1,1,1,1,1,0,0,0,0,0,0.4913668392989033,0.5086331607010968
90218,0.48780487804878053,0.5555555555555556,105,-125,0.4666534470222751,0.5333465529777248,away,CHC,over,10,0.5327102803738317,-114,0.508788710910954,CIN,CHC,2023 REG,8,3,5,2,5,13,1,0,1,-1,1,1,0,0,0,0,0,0,0,0.508788710910954,0.491211289089046
90218,0.48780487804878053,0.5555555555555556,105,-125,0.4666534470222751,0.5333465529777248,home,CIN,under,10,0.5121951219512195,-105,0.491211289089046,CIN,CHC,2023 REG,8,3,5,2,5,13,1,0,1,-1,1,1,0,0,0,0,0,0,0,0.508788710910954,0.491211289089046
90219,0.5633187772925764,0.47619047619047616,-129,110,0.5410624729287608,0.45893752707123925,away,TB,over,8,0.5238095238095238,-110,0.4988662131519274,MIN,TB,2023 REG,6,3,6,2,5,12,1,0,1,-1,1,1,0,0,0,0,0,0,0,0.4988662131519274,0.5011337868480725
90219,0.5633187772925764,0.47619047619047616,-129,110,0.5410624729287608,0.45893752707123925,home,MIN,under,8,0.5238095238095238,-110,0.5011337868480725,MIN,TB,2023 REG,6,3,6,2,5,12,1,0,1,-1,1,1,0,0,0,0,0,0,0,0.4988662131519274,0.5011337868480725
90220,0.5918367346938775,0.4444444444444444,-145,125,0.5703642001018094,0.42963579989819056,away,TOR,over,9,0.5121951219512195,-105,0.48808156828023186,LAD,TOR,2023 REG,12,8,12,7,15,24,1,0,1,-1,1,1,1,1,1,1,1,0,0,0.48808156828023186,0.5119184317197681
90220,0.5918367346938775,0.4444444444444444,-145,125,0.5703642001018094,0.42963579989819056,home,LAD,under,9,0.5348837209302326,-115,0.5119184317197681,LAD,TOR,2023 REG,12,8,12,7,15,24,1,0,1,-1,1,1,1,1,1,1,1,0,0,0.48808156828023186,0.5119184317197681
90221,0.6108949416342413,0.4273504273504274,-157,134,0.5875310391805721,0.41246896081942785,away,SEA,over,8.5,0.5454545454545454,-120,0.5206611570247933,MIN,SEA,2023 REG,12,7,10,8,15,22,0,1,-1,1,1,1,1,1,1,1,1,0,0,0.5206611570247933,0.4793388429752067
90221,0.6108949416342413,0.4273504273504274,-157,134,0.5875310391805721,0.41246896081942785,home,MIN,under,8.5,0.5,100,0.4793388429752067,MIN,SEA,2023 REG,12,7,10,8,15,22,0,1,-1,1,1,1,1,1,1,1,1,0,0,0.5206611570247933,0.4793388429752067
90222,0.425531914893617,0.607843137254902,135,-155,0.4113297650431834,0.5886702349568166,away,TEX,over,8.5,0.5238095238095238,-110,0.4988662131519274,CWS,TEX,2023 REG,9,7,11,6,13,20,1,0,1,-1,1,1,1,1,1,1,0,0,0,0.4988662131519274,0.5011337868480725
90222,0.425531914893617,0.607843137254902,135,-155,0.4113297650431834,0.5886702349568166,home,CWS,under,8.5,0.5238095238095238,-110,0.5011337868480725,CWS,TEX,2023 REG,9,7,11,6,13,20,1,0,1,-1,1,1,1,1,1,1,0,0,0,0.4988662131519274,0.5011337868480725
90223,0.6363636363636364,0.40322580645161293,-175,148,0.6111703545721141,0.3888296454278859,away,CLE,over,8.5,0.5555555555555556,-125,0.5314664257753688,MIN,CLE,2023 REG,12,10,7,6,16,19,1,0,4,-4,1,1,1,1,1,1,0,0,0,0.5314664257753688,0.46853357422463116
90223,0.6363636363636364,0.40322580645161293,-175,148,0.6111703545721141,0.3888296454278859,home,MIN,under,8.5,0.48780487804878053,105,0.46853357422463116,MIN,CLE,2023 REG,12,10,7,6,16,19,1,0,4,-4,1,1,1,1,1,1,0,0,0,0.5314664257753688,0.46853357422463116
90224,0.5238095238095238,0.5238095238095238,-110,-110,0.4988662131519274,0.5011337868480725,away,BAL,over,9,0.5,100,0.4772727272727273,CHC,BAL,2023 REG,3,3,14,6,9,17,0,1,-3,3,1,1,1,0,0,0,0,0,0,0.4772727272727273,0.5227272727272727
90224,0.5238095238095238,0.5238095238095238,-110,-110,0.4988662131519274,0.5011337868480725,home,CHC,under,9,0.5454545454545454,-120,0.5227272727272727,CHC,BAL,2023 REG,3,3,14,6,9,17,0,1,-3,3,1,1,1,0,0,0,0,0,0,0.4772727272727273,0.5227272727272727
90225,0.46511627906976744,0.574468085106383,115,-135,0.44670494689481377,0.5532950531051862,away,CLE,over,10,0.5348837209302326,-115,0.5097020142727117,CWS,CLE,2023 REG,6,3,6,0,3,12,1,0,3,-3,0,0,0,0,0,0,0,0,0,0.5097020142727117,0.49029798572728833
90225,0.46511627906976744,0.574468085106383,115,-135,0.44670494689481377,0.5532950531051862,home,CWS,under,10,0.5121951219512195,-105,0.49029798572728833,CWS,CLE,2023 REG,6,3,6,0,3,12,1,0,3,-3,0,0,0,0,0,0,0,0,0,0.5097020142727117,0.49029798572728833
90226,0.4587155963302753,0.5780590717299579,118,-137,0.4418464825411775,0.5581535174588226,away,CHC,over,8,0.5169082125603864,-107,0.49353874091423283,PIT,CHC,2023 REG,5,0,7,4,4,12,0,1,-4,4,0,0,0,0,0,0,0,0,0,0.49353874091423283,0.5064612590857671
90226,0.4587155963302753,0.5780590717299579,118,-137,0.4418464825411775,0.5581535174588226,home,PIT,under,8,0.5283018867924528,-112,0.5064612590857671,PIT,CHC,2023 REG,5,0,7,4,4,12,0,1,-4,4,0,0,0,0,0,0,0,0,0,0.49353874091423283,0.5064612590857671
90227,0.6587030716723549,0.38167938931297707,-193,162,0.6321030205796278,0.36789697942037225,away,ARI,over,8.5,0.5475113122171946,-121,0.5214983313199976,LAD,ARI,2023 REG,4,1,9,2,3,13,0,1,-1,1,1,0,0,0,0,0,0,0,0,0.5214983313199976,0.47850166868000243
90227,0.6587030716723549,0.38167938931297707,-193,162,0.6321030205796278,0.36789697942037225,home,LAD,under,8.5,0.5,100,0.47850166868000243,LAD,ARI,2023 REG,4,1,9,2,3,13,0,1,-1,1,1,0,0,0,0,0,0,0,0,0.5214983313199976,0.47850166868000243
90228,0.6794871794871794,0.36101083032490977,-212,177,0.6519693010251187,0.34803069897488126,away,OAK,over,10,0.5260663507109005,-111,0.5022370601254724,LAA,OAK,2023 REG,13,10,14,11,21,27,0,1,-1,1,1,1,1,1,1,1,1,1,1,0.5022370601254724,0.4977629398745276
90228,0.6794871794871794,0.36101083032490977,-212,177,0.6519693010251187,0.34803069897488126,home,LAA,under,10,0.5192307692307692,-108,0.4977629398745276,LAA,OAK,2023 REG,13,10,14,11,21,27,0,1,-1,1,1,1,1,1,1,1,1,1,1,0.5022370601254724,0.4977629398745276
90229,0.3389830508474576,0.7058823529411764,195,-240,0.3237744393936834,0.6762255606063166,away,MIN,over,8,0.5238095238095238,-110,0.4988662131519274,OAK,MIN,2023 REG,10,7,11,10,17,21,0,1,-3,3,1,1,1,1,1,1,1,0,0,0.4988662131519274,0.5011337868480725
90229,0.3389830508474576,0.7058823529411764,195,-240,0.3237744393936834,0.6762255606063166,home,OAK,under,8,0.5238095238095238,-110,0.5011337868480725,OAK,MIN,2023 REG,10,7,11,10,17,21,0,1,-3,3,1,1,1,1,1,1,1,0,0,0.4988662131519274,0.5011337868480725
90230,0.6226415094339623,0.41493775933609955,-165,141,0.5992430968035465,0.4007569031964535,away,CLE,over,7.5,0.5454545454545454,-120,0.5206611570247933,SEA,CLE,2023 REG,7,4,13,9,13,20,0,1,-5,5,1,1,1,1,0,0,0,0,0,0.5206611570247933,0.4793388429752067
90230,0.6226415094339623,0.41493775933609955,-165,141,0.5992430968035465,0.4007569031964535,home,SEA,under,7.5,0.5,100,0.4793388429752067,SEA,CLE,2023 REG,7,4,13,9,13,20,0,1,-5,5,1,1,1,1,0,0,0,0,0,0.5206611570247933,0.4793388429752067
90231,0.5555555555555556,0.48780487804878053,-125,105,0.5314664257753688,0.46853357422463116,away,ARI,over,9,0.5495495495495495,-122,0.5250401592387142,MIL,ARI,2023 REG,10,7,10,5,12,20,1,0,2,-2,1,1,1,1,1,0,0,0,0,0.5250401592387142,0.47495984076128583
90231,0.5555555555555556,0.48780487804878053,-125,105,0.5314664257753688,0.46853357422463116,home,MIL,under,9,0.49504950495049505,102,0.47495984076128583,MIL,ARI,2023 REG,10,7,10,5,12,20,1,0,2,-2,1,1,1,1,1,0,0,0,0,0.5250401592387142,0.47495984076128583
90232,0.5833333333333333,0.4566210045662101,-140,119,0.5600266362252664,0.4399733637747336,away,PIT,over,8.5,0.5073891625615764,-103,0.4837652908580103,CIN,PIT,2023 REG,7,4,6,5,9,13,0,1,-1,1,1,1,1,1,0,0,0,0,0,0.4837652908580103,0.5162347091419897
90232,0.5833333333333333,0.4566210045662101,-140,119,0.5600266362252664,0.4399733637747336,home,CIN,under,8.5,0.5391705069124424,-117,0.5162347091419897,CIN,PIT,2023 REG,7,4,6,5,9,13,0,1,-1,1,1,1,1,1,0,0,0,0,0,0.4837652908580103,0.5162347091419897
90233,0.75,0.29411764705882354,-300,240,0.7169117647058822,0.28308823529411775,away,WSH,over,8,0.504950495049505,-102,0.47949844489399435,MIL,WSH,2023 REG,6,1,4,2,3,10,0,1,-1,1,1,0,0,0,0,0,0,0,0,0.47949844489399435,0.5205015551060057
90233,0.75,0.29411764705882354,-300,240,0.7169117647058822,0.28308823529411775,home,MIL,under,8,0.5454545454545454,-120,0.5205015551060057,MIL,WSH,2023 REG,6,1,4,2,3,10,0,1,-1,1,1,0,0,0,0,0,0,0,0,0.47949844489399435,0.5205015551060057
90234,0.5833333333333333,0.45454545454545453,-140,120,0.5612373737373737,0.4387626262626263,away,SD,over,8.5,0.5348837209302326,-115,0.5097020142727117,HOU,SD,2023 REG,6,2,10,11,13,16,0,1,-9,9,1,1,0,0,0,0,0,0,0,0.5097020142727117,0.49029798572728833
90234,0.5833333333333333,0.45454545454545453,-140,120,0.5612373737373737,0.4387626262626263,home,HOU,under,8.5,0.5121951219512195,-105,0.49029798572728833,HOU,SD,2023 REG,6,2,10,11,13,16,0,1,-9,9,1,1,0,0,0,0,0,0,0,0.5097020142727117,0.49029798572728833
90235,0.5535714285714286,0.48780487804878053,-124,105,0.53066668740667,0.46933331259333,away,CLE,over,8.5,0.5475113122171946,-121,0.5228602997583487,BOS,CLE,2023 REG,9,7,4,1,8,13,1,0,6,-6,1,0,0,0,0,0,0,0,0,0.5228602997583487,0.4771397002416513
90235,0.5535714285714286,0.48780487804878053,-124,105,0.53066668740667,0.46933331259333,home,BOS,under,8.5,0.49751243781094534,101,0.4771397002416513,BOS,CLE,2023 REG,9,7,4,1,8,13,1,0,6,-6,1,0,0,0,0,0,0,0,0,0.5228602997583487,0.4771397002416513
90236,0.5555555555555556,0.48780487804878053,-125,105,0.5314664257753688,0.46853357422463116,away,CIN,over,8.5,0.5238095238095238,-110,0.4988662131519274,DET,CIN,2023 REG,9,8,5,2,10,14,1,0,6,-6,1,1,0,0,0,0,0,0,0,0.4988662131519274,0.5011337868480725
90236,0.5555555555555556,0.48780487804878053,-125,105,0.5314664257753688,0.46853357422463116,home,DET,under,8.5,0.5238095238095238,-110,0.5011337868480725,DET,CIN,2023 REG,9,8,5,2,10,14,1,0,6,-6,1,1,0,0,0,0,0,0,0,0.4988662131519274,0.5011337868480725
90237,0.4166666666666667,0.6226415094339623,140,-165,0.4002882599580712,0.5997117400419287,away,SD,over,9,0.5121951219512195,-105,0.48808156828023186,PHI,SD,2023 REG,10,6,9,4,10,19,1,0,2,-2,1,1,1,1,0,0,0,0,0,0.48808156828023186,0.5119184317197681
90237,0.4166666666666667,0.6226415094339623,140,-165,0.4002882599580712,0.5997117400419287,home,PHI,under,9,0.5348837209302326,-115,0.5119184317197681,PHI,SD,2023 REG,10,6,9,4,10,19,1,0,2,-2,1,1,1,1,0,0,0,0,0,0.48808156828023186,0.5119184317197681
90238,0.5708154506437768,0.4739336492890995,-133,111,0.5452719729996885,0.45472802700031145,away,KC,over,9,0.504950495049505,-102,0.4826715732667395,CWS,KC,2023 REG,9,6,7,2,8,16,1,0,4,-4,1,1,0,0,0,0,0,0,0,0.4826715732667395,0.5173284267332605
90238,0.5708154506437768,0.4739336492890995,-133,111,0.5452719729996885,0.45472802700031145,home,CWS,under,9,0.5391705069124424,-117,0.5173284267332605,CWS,KC,2023 REG,9,6,7,2,8,16,1,0,4,-4,1,1,0,0,0,0,0,0,0,0.4826715732667395,0.5173284267332605
90239,0.3597122302158273,0.6774193548387096,178,-210,0.3463555449444112,0.6536444550555889,away,TEX,over,10,0.504950495049505,-102,0.4826715732667395,WSH,TEX,2023 REG,12,8,8,3,11,20,1,0,5,-5,1,1,1,0,0,0,0,0,0,0.4826715732667395,0.5173284267332605
90239,0.3597122302158273,0.6774193548387096,178,-210,0.3463555449444112,0.6536444550555889,home,WSH,under,10,0.5391705069124424,-117,0.5173284267332605,WSH,TEX,2023 REG,12,8,8,3,11,20,1,0,5,-5,1,1,1,0,0,0,0,0,0,0.4826715732667395,0.5173284267332605
90240,0.425531914893617,0.6108949416342413,135,-157,0.41003112488176247,0.5899688751182375,away,LAD,over,11,0.5348837209302326,-115,0.5097020142727117,CIN,LAD,2023 REG,13,8,8,6,14,21,1,0,2,-2,1,1,1,1,1,1,0,0,0,0.5097020142727117,0.49029798572728833
90240,0.425531914893617,0.6108949416342413,135,-157,0.41003112488176247,0.5899688751182375,home,CIN,under,11,0.5121951219512195,-105,0.49029798572728833,CIN,LAD,2023 REG,13,8,8,6,14,21,1,0,2,-2,1,1,1,1,1,1,0,0,0,0.5097020142727117,0.49029798572728833
90241,0.5238095238095238,0.5145631067961165,-110,-106,0.5037095744446646,0.4962904255553354,away,SEA,over,7,0.5121951219512195,-105,0.48808156828023186,NYY,SEA,2023 REG,8,3,4,1,4,12,1,0,2,-2,1,0,0,0,0,0,0,0,0,0.48808156828023186,0.5119184317197681
90241,0.5238095238095238,0.5145631067961165,-110,-106,0.5037095744446646,0.4962904255553354,home,NYY,under,7,0.5348837209302326,-115,0.5119184317197681,NYY,SEA,2023 REG,8,3,4,1,4,12,1,0,2,-2,1,0,0,0,0,0,0,0,0,0.48808156828023186,0.5119184317197681
90242,0.5652173913043479,0.47619047619047616,-130,110,0.5418129444594474,0.4581870555405526,away,ARI,over,8.5,0.5454545454545454,-120,0.5193043049216726,NYM,ARI,2023 REG,6,3,10,4,7,16,0,1,-1,1,1,1,1,0,0,0,0,0,0,0.5193043049216726,0.48069569507832743
90242,0.5652173913043479,0.47619047619047616,-130,110,0.5418129444594474,0.4581870555405526,home,NYM,under,8.5,0.5024875621890548,-101,0.48069569507832743,NYM,ARI,2023 REG,6,3,10,4,7,16,0,1,-1,1,1,1,1,0,0,0,0,0,0,0.5193043049216726,0.48069569507832743
90243,0.7142857142857143,0.3278688524590164,-250,205,0.6841753094680495,0.3158246905319505,away,OAK,over,9.5,0.5121951219512195,-105,0.48808156828023186,MIL,OAK,2023 REG,4,2,6,5,7,10,0,1,-3,3,1,1,0,0,0,0,0,0,0,0.48808156828023186,0.5119184317197681
90243,0.7142857142857143,0.3278688524590164,-250,205,0.6841753094680495,0.3158246905319505,home,MIL,under,9.5,0.5348837209302326,-115,0.5119184317197681,MIL,OAK,2023 REG,4,2,6,5,7,10,0,1,-3,3,1,1,0,0,0,0,0,0,0,0.48808156828023186,0.5119184317197681
90244,0.7142857142857143,0.3333333333333333,-250,200,0.6802721088435374,0.3197278911564626,away,LAA,over,8,0.5348837209302326,-115,0.5097020142727117,MIN,LAA,2023 REG,10,9,11,3,12,21,1,0,6,-6,1,1,1,0,0,0,0,0,0,0.5097020142727117,0.49029798572728833
90244,0.7142857142857143,0.3333333333333333,-250,200,0.6802721088435374,0.3197278911564626,home,MIN,under,8,0.5121951219512195,-105,0.49029798572728833,MIN,LAA,2023 REG,10,9,11,3,12,21,1,0,6,-6,1,1,1,0,0,0,0,0,0,0.5097020142727117,0.49029798572728833
90245,0.7142857142857143,0.3278688524590164,-250,205,0.6841753094680495,0.3158246905319505,away,WSH,over,7.5,0.5121951219512195,-105,0.48808156828023186,HOU,WSH,2023 REG,8,5,7,4,9,15,1,0,1,-1,1,1,1,1,0,0,0,0,0,0.48808156828023186,0.5119184317197681
90245,0.7142857142857143,0.3278688524590164,-250,205,0.6841753094680495,0.3158246905319505,home,HOU,under,7.5,0.5348837209302326,-115,0.5119184317197681,HOU,WSH,2023 REG,8,5,7,4,9,15,1,0,1,-1,1,1,1,1,0,0,0,0,0,0.48808156828023186,0.5119184317197681
90246,0.7101449275362319,0.3333333333333333,-245,200,0.6792690611216132,0.3207309388783868,away,OAK,over,9,0.504950495049505,-102,0.47949844489399435,TEX,OAK,2023 REG,12,9,9,4,13,21,1,0,5,-5,1,1,1,1,0,0,0,0,0,0.47949844489399435,0.5205015551060057
90246,0.7101449275362319,0.3333333333333333,-245,200,0.6792690611216132,0.3207309388783868,home,TEX,under,9,0.5454545454545454,-120,0.5205015551060057,TEX,OAK,2023 REG,12,9,9,4,13,21,1,0,5,-5,1,1,1,1,0,0,0,0,0,0.47949844489399435,0.5205015551060057
90247,0.574468085106383,0.46511627906976744,-135,115,0.5517281312179562,0.44827186878204384,away,KC,over,8.5,0.5433789954337899,-119,0.5171177654451503,CWS,KC,2023 REG,10,10,12,11,21,22,0,1,-1,1,1,1,1,1,1,1,1,1,1,0.5171177654451503,0.4828822345548497
90247,0.574468085106383,0.46511627906976744,-135,115,0.5517281312179562,0.44827186878204384,home,CWS,under,8.5,0.504950495049505,-102,0.4828822345548497,CWS,KC,2023 REG,10,10,12,11,21,22,0,1,-1,1,1,1,1,1,1,1,1,1,1,0.5171177654451503,0.4828822345548497
90248,0.48780487804878053,0.5555555555555556,105,-125,0.4666534470222751,0.5333465529777248,away,CHC,over,9.5,0.5348837209302326,-115,0.5097020142727117,CIN,CHC,2023 REG,9,2,5,1,3,14,1,0,1,-1,1,0,0,0,0,0,0,0,0,0.5097020142727117,0.49029798572728833
90248,0.48780487804878053,0.5555555555555556,105,-125,0.4666534470222751,0.5333465529777248,home,CIN,under,9.5,0.5121951219512195,-105,0.49029798572728833,CIN,CHC,2023 REG,9,2,5,1,3,14,1,0,1,-1,1,0,0,0,0,0,0,0,0,0.5097020142727117,0.49029798572728833
90249,0.5121951219512195,0.5348837209302326,-105,-115,0.48808156828023186,0.5119184317197681,away,PHI,over,9.5,0.5192307692307692,-108,0.49455035168025013,ATL,PHI,2023 REG,4,1,7,7,8,11,0,1,-6,6,1,0,0,0,0,0,0,0,0,0.49455035168025013,0.5054496483197499
90249,0.5121951219512195,0.5348837209302326,-105,-115,0.48808156828023186,0.5119184317197681,home,ATL,under,9.5,0.5283018867924528,-112,0.5054496483197499,ATL,PHI,2023 REG,4,1,7,7,8,11,0,1,-6,6,1,0,0,0,0,0,0,0,0,0.49455035168025013,0.5054496483197499
90250,0.7590361445783133,0.2857142857142857,-315,250,0.7250689505007983,0.27493104949920166,away,WSH,over,8.5,0.5454545454545454,-120,0.5206611570247933,LAD,WSH,2023 REG,14,9,6,3,12,20,1,0,6,-6,1,1,1,0,0,0,0,0,0,0.5206611570247933,0.4793388429752067
90250,0.7590361445783133,0.2857142857142857,-315,250,0.7250689505007983,0.27493104949920166,home,LAD,under,8.5,0.5,100,0.4793388429752067,LAD,WSH,2023 REG,14,9,6,3,12,20,1,0,6,-6,1,1,1,0,0,0,0,0,0,0.5206611570247933,0.4793388429752067
90251,0.6774193548387096,0.36363636363636365,-210,175,0.6496074165168858,0.3503925834831142,away,OAK,over,8.5,0.5433789954337899,-119,0.5171177654451503,MIA,OAK,2023 REG,9,4,5,0,4,14,1,0,4,-4,0,0,0,0,0,0,0,0,0,0.5171177654451503,0.4828822345548497
90251,0.6774193548387096,0.36363636363636365,-210,175,0.6496074165168858,0.3503925834831142,home,MIA,under,8.5,0.504950495049505,-102,0.4828822345548497,MIA,OAK,2023 REG,9,4,5,0,4,14,1,0,4,-4,0,0,0,0,0,0,0,0,0,0.5171177654451503,0.4828822345548497
90252,0.4504504504504505,0.5918367346938775,122,-145,0.43140216885390636,0.5685978311460936,away,BOS,over,8,0.5348837209302326,-115,0.5109810284308424,DET,BOS,2023 REG,6,5,12,14,19,18,0,1,-9,9,1,1,1,1,1,0,0,0,0,0.5109810284308424,0.48901897156915763
90252,0.4504504504504505,0.5918367346938775,122,-145,0.43140216885390636,0.5685978311460936,home,DET,under,8,0.5098039215686274,-104,0.48901897156915763,DET,BOS,2023 REG,6,5,12,14,19,18,0,1,-9,9,1,1,1,1,1,0,0,0,0,0.5109810284308424,0.48901897156915763
90253,0.40485829959514175,0.6376811594202898,147,-176,0.3876358465524569,0.612364153447543,away,STL,over,12,0.5391705069124424,-117,0.5140669063204599,COL,STL,2023 REG,12,6,11,9,15,23,0,1,-3,3,1,1,1,1,1,1,0,0,0,0.5140669063204599,0.4859330936795401
90253,0.40485829959514175,0.6376811594202898,147,-176,0.3876358465524569,0.612364153447543,home,COL,under,12,0.5073891625615764,-103,0.4859330936795401,COL,STL,2023 REG,12,6,11,9,15,23,0,1,-3,3,1,1,1,1,1,1,0,0,0,0.5140669063204599,0.4859330936795401
90254,0.5652173913043479,0.47619047619047616,-130,110,0.5418129444594474,0.4581870555405526,away,SF,over,10.5,0.5238095238095238,-110,0.4988662131519274,CHC,SF,2023 REG,15,11,12,8,19,27,1,0,3,-3,1,1,1,1,1,1,1,1,0,0.4988662131519274,0.5011337868480725
90254,0.5652173913043479,0.47619047619047616,-130,110,0.5418129444594474,0.4581870555405526,home,CHC,under,10.5,0.5238095238095238,-110,0.5011337868480725,CHC,SF,2023 REG,15,11,12,8,19,27,1,0,3,-3,1,1,1,1,1,1,1,1,0,0.4988662131519274,0.5011337868480725
90255,0.42372881355932196,0.6183206106870228,136,-162,0.40591126091256574,0.5940887390874343,away,TEX,over,9,0.5454545454545454,-120,0.5206611570247933,NYM,TEX,2023 REG,11,6,7,5,11,18,1,0,1,-1,1,1,1,1,1,0,0,0,0,0.5206611570247933,0.4793388429752067
90255,0.42372881355932196,0.6183206106870228,136,-162,0.40591126091256574,0.5940887390874343,home,NYM,under,9,0.5,100,0.4793388429752067,NYM,TEX,2023 REG,11,6,7,5,11,18,1,0,1,-1,1,1,1,1,1,0,0,0,0,0.5206611570247933,0.4793388429752067
90256,0.574468085106383,0.46511627906976744,-135,115,0.5517281312179562,0.44827186878204384,away,LAA,over,9,0.5454545454545454,-120,0.5193043049216726,NYY,LAA,2023 REG,6,3,7,2,5,13,1,0,1,-1,1,1,0,0,0,0,0,0,0,0.5193043049216726,0.48069569507832743
90256,0.574468085106383,0.46511627906976744,-135,115,0.5517281312179562,0.44827186878204384,home,NYY,under,9,0.5024875621890548,-101,0.48069569507832743,NYY,LAA,2023 REG,6,3,7,2,5,13,1,0,1,-1,1,1,0,0,0,0,0,0,0,0.5193043049216726,0.48069569507832743
90257,0.5918367346938775,0.4484304932735426,-145,123,0.5680051099784656,0.43199489002153435,away,SF,over,8.5,0.5121951219512195,-105,0.48808156828023186,PHI,SF,2023 REG,17,10,9,4,14,26,1,0,6,-6,1,1,1,1,0,0,0,0,0,0.48808156828023186,0.5119184317197681
90257,0.5918367346938775,0.4484304932735426,-145,123,0.5680051099784656,0.43199489002153435,home,PHI,under,8.5,0.5348837209302326,-115,0.5119184317197681,PHI,SF,2023 REG,17,10,9,4,14,26,1,0,6,-6,1,1,1,1,0,0,0,0,0,0.48808156828023186,0.5119184317197681
90258,0.5454545454545454,0.49751243781094534,-120,101,0.5220180091279142,0.4779819908720858,away,HOU,over,8.5,0.5,100,0.47935779816513757,TB,HOU,2023 REG,2,0,5,1,1,7,0,1,-1,1,0,0,0,0,0,0,0,0,0,0.47935779816513757,0.5206422018348624
90258,0.5454545454545454,0.49751243781094534,-120,101,0.5220180091279142,0.4779819908720858,home,TB,under,8.5,0.5412844036697247,-118,0.5206422018348624,TB,HOU,2023 REG,2,0,5,1,1,7,0,1,-1,1,0,0,0,0,0,0,0,0,0,0.47935779816513757,0.5206422018348624
90260,0.574468085106383,0.4629629629629629,-135,116,0.5529651425984609,0.44703485740153914,away,BOS,over,8.5,0.5073891625615764,-103,0.4837652908580103,TB,BOS,2023 REG,11,9,10,7,16,21,1,0,2,-2,1,1,1,1,1,1,1,0,0,0.4837652908580103,0.5162347091419897
90260,0.574468085106383,0.4629629629629629,-135,116,0.5529651425984609,0.44703485740153914,home,TB,under,8.5,0.5391705069124424,-117,0.5162347091419897,TB,BOS,2023 REG,11,9,10,7,16,21,1,0,2,-2,1,1,1,1,1,1,1,0,0,0.4837652908580103,0.5162347091419897
90261,0.42372881355932196,0.6183206106870228,136,-162,0.40591126091256574,0.5940887390874343,away,NYM,over,10.5,0.5327102803738317,-114,0.508788710910954,CIN,NYM,2023 REG,10,7,7,6,13,17,1,0,1,-1,1,1,1,1,1,1,0,0,0,0.508788710910954,0.491211289089046
90261,0.42372881355932196,0.6183206106870228,136,-162,0.40591126091256574,0.5940887390874343,home,CIN,under,10.5,0.5121951219512195,-105,0.491211289089046,CIN,NYM,2023 REG,10,7,7,6,13,17,1,0,1,-1,1,1,1,1,1,1,0,0,0,0.508788710910954,0.491211289089046
90262,0.5370370370370371,0.5024875621890548,-116,-101,0.5158108633785803,0.4841891366214197,away,MIA,over,8.5,0.5348837209302326,-115,0.5097020142727117,TEX,MIA,2023 REG,8,6,6,0,6,14,1,0,6,-6,0,0,0,0,0,0,0,0,0,0.5097020142727117,0.49029798572728833
90262,0.5370370370370371,0.5024875621890548,-116,-101,0.5158108633785803,0.4841891366214197,home,TEX,under,8.5,0.5121951219512195,-105,0.49029798572728833,TEX,MIA,2023 REG,8,6,6,0,6,14,1,0,6,-6,0,0,0,0,0,0,0,0,0,0.5097020142727117,0.49029798572728833
90263,0.5348837209302326,0.5121951219512195,-115,-105,0.5097020142727117,0.49029798572728833,away,SEA,over,9.5,0.5238095238095238,-110,0.4988662131519274,ATL,SEA,2023 REG,7,3,3,2,5,10,1,0,1,-1,1,1,0,0,0,0,0,0,0,0.4988662131519274,0.5011337868480725
90263,0.5348837209302326,0.5121951219512195,-115,-105,0.5097020142727117,0.49029798572728833,home,ATL,under,9.5,0.5238095238095238,-110,0.5011337868480725,ATL,SEA,2023 REG,7,3,3,2,5,10,1,0,1,-1,1,1,0,0,0,0,0,0,0,0.4988662131519274,0.5011337868480725
90264,0.7530864197530864,0.2898550724637681,-305,245,0.7207477651206404,0.2792522348793596,away,COL,over,9,0.5412844036697247,-118,0.5189377998484975,ATL,COL,2023 REG,18,14,11,6,20,29,1,0,8,-8,1,1,1,1,1,1,0,0,0,0.5189377998484975,0.4810622001515025
90264,0.7530864197530864,0.2898550724637681,-305,245,0.7207477651206404,0.2792522348793596,home,ATL,under,9,0.5,100,0.4810622001515025,ATL,COL,2023 REG,18,14,11,6,20,29,1,0,8,-8,1,1,1,1,1,1,0,0,0,0.5189377998484975,0.4810622001515025
90265,0.5348837209302326,0.5073891625615764,-115,-103,0.5122726437136835,0.48772735628631647,away,MIA,over,8.5,0.5121951219512195,-105,0.48808156828023186,CWS,MIA,2023 REG,5,1,10,5,6,15,0,1,-4,4,1,0,0,0,0,0,0,0,0,0.48808156828023186,0.5119184317197681
90265,0.5348837209302326,0.5073891625615764,-115,-103,0.5122726437136835,0.48772735628631647,home,CWS,under,8.5,0.5348837209302326,-115,0.5119184317197681,CWS,MIA,2023 REG,5,1,10,5,6,15,0,1,-4,4,1,0,0,0,0,0,0,0,0,0.48808156828023186,0.5119184317197681
90266,0.5652173913043479,0.47619047619047616,-130,110,0.5418129444594474,0.4581870555405526,away,SD,over,8.5,0.5391705069124424,-117,0.5153817639191344,MIN,SD,2023 REG,9,4,4,3,7,13,1,0,1,-1,1,1,1,0,0,0,0,0,0,0.5153817639191344,0.4846182360808656
90266,0.5652173913043479,0.47619047619047616,-130,110,0.5418129444594474,0.4581870555405526,home,MIN,under,8.5,0.504950495049505,-102,0.4846182360808656,MIN,SD,2023 REG,9,4,4,3,7,13,1,0,1,-1,1,1,1,0,0,0,0,0,0,0.5153817639191344,0.4846182360808656
90267,0.6825396825396826,0.35211267605633806,-215,184,0.6588880727043035,0.3411119272956965,away,PIT,over,7,0.5495495495495495,-122,0.5223196169142115,TB,PIT,2023 REG,10,8,7,1,9,17,1,0,7,-7,1,0,0,0,0,0,0,0,0,0.5223196169142115,0.47768038308578853
90267,0.6825396825396826,0.35211267605633806,-215,184,0.6588880727043035,0.3411119272956965,home,TB,under,7,0.5,100,0.47768038308578853,TB,PIT,2023 REG,10,8,7,1,9,17,1,0,7,-7,1,0,0,0,0,0,0,0,0,0.5223196169142115,0.47768038308578853
90268,0.4166666666666667,0.6153846153846154,140,-160,0.40331196581196577,0.5966880341880343,away,NYM,over,10,0.5327102803738317,-114,0.508788710910954,WSH,NYM,2023 REG,15,10,11,3,13,26,1,0,7,-7,1,1,1,0,0,0,0,0,0,0.508788710910954,0.491211289089046
90268,0.4166666666666667,0.6153846153846154,140,-160,0.40331196581196577,0.5966880341880343,home,WSH,under,10,0.5121951219512195,-105,0.491211289089046,WSH,NYM,2023 REG,15,10,11,3,13,26,1,0,7,-7,1,1,1,0,0,0,0,0,0,0.508788710910954,0.491211289089046
90269,0.5850622406639003,0.45454545454545453,-141,120,0.5618892737571823,0.43811072624281766,away,HOU,over,10,0.5121951219512195,-105,0.48808156828023186,BAL,HOU,2023 REG,7,2,11,8,10,18,0,1,-6,6,1,1,0,0,0,0,0,0,0,0.48808156828023186,0.5119184317197681
90269,0.5850622406639003,0.45454545454545453,-141,120,0.5618892737571823,0.43811072624281766,home,BAL,under,10,0.5348837209302326,-115,0.5119184317197681,BAL,HOU,2023 REG,7,2,11,8,10,18,0,1,-6,6,1,1,0,0,0,0,0,0,0,0.48808156828023186,0.5119184317197681
90270,0.7435897435897436,0.3125,-290,220,0.7018819855358317,0.2981180144641683,away,OAK,over,8.5,0.5283018867924528,-112,0.5031902949311281,SEA,OAK,2023 REG,14,7,4,0,7,18,1,0,7,-7,0,0,0,0,0,0,0,0,0,0.5031902949311281,0.4968097050688719
90270,0.7435897435897436,0.3125,-290,220,0.7018819855358317,0.2981180144641683,home,SEA,under,8.5,0.5192307692307692,-108,0.4968097050688719,SEA,OAK,2023 REG,14,7,4,0,7,18,1,0,7,-7,0,0,0,0,0,0,0,0,0,0.5031902949311281,0.4968097050688719
90271,0.4608294930875576,0.576271186440678,117,-136,0.4437324057473569,0.5562675942526432,away,LAD,over,9.5,0.5215311004784688,-109,0.49907282342437215,ARI,LAD,2023 REG,16,11,7,6,17,23,1,0,5,-5,1,1,1,1,1,1,0,0,0,0.49907282342437215,0.5009271765756278
90271,0.4608294930875576,0.576271186440678,117,-136,0.4437324057473569,0.5562675942526432,home,ARI,under,9.5,0.5215311004784688,-109,0.5009271765756278,ARI,LAD,2023 REG,16,11,7,6,17,23,1,0,5,-5,1,1,1,1,1,1,0,0,0,0.49907282342437215,0.5009271765756278
90272,0.5348837209302326,0.5121951219512195,-115,-105,0.5097020142727117,0.49029798572728833,away,LAD,over,8,0.5238095238095238,-110,0.4988662131519274,TB,LAD,2023 REG,9,5,9,6,11,18,0,1,-1,1,1,1,1,1,1,0,0,0,0,0.4988662131519274,0.5011337868480725
90272,0.5348837209302326,0.5121951219512195,-115,-105,0.5097020142727117,0.49029798572728833,home,TB,under,8,0.5238095238095238,-110,0.5011337868480725,TB,LAD,2023 REG,9,5,9,6,11,18,0,1,-1,1,1,1,1,1,1,0,0,0,0,0.4988662131519274,0.5011337868480725
90273,0.5,0.5454545454545454,100,-120,0.4772727272727273,0.5227272727272727,away,MIL,over,8.5,0.5121951219512195,-105,0.48808156828023186,STL,MIL,2023 REG,6,2,10,8,10,16,0,1,-6,6,1,1,0,0,0,0,0,0,0,0.48808156828023186,0.5119184317197681
90273,0.5,0.5454545454545454,100,-120,0.4772727272727273,0.5227272727272727,home,STL,under,8.5,0.5348837209302326,-115,0.5119184317197681,STL,MIL,2023 REG,6,2,10,8,10,16,0,1,-6,6,1,1,0,0,0,0,0,0,0,0.48808156828023186,0.5119184317197681
90274,0.5555555555555556,0.48780487804878053,-125,105,0.5314664257753688,0.46853357422463116,away,ATL,over,8,0.5238095238095238,-110,0.5000596729920038,TB,ATL,2023 REG,10,10,9,4,14,19,1,0,6,-6,1,1,1,1,0,0,0,0,0,0.5000596729920038,0.4999403270079962
90274,0.5555555555555556,0.48780487804878053,-125,105,0.5314664257753688,0.46853357422463116,home,TB,under,8,0.5215311004784688,-109,0.4999403270079962,TB,ATL,2023 REG,10,10,9,4,14,19,1,0,6,-6,1,1,1,1,0,0,0,0,0,0.5000596729920038,0.4999403270079962
90275,0.6721311475409836,0.36363636363636365,-205,175,0.6480906892086682,0.3519093107913318,away,MIA,over,7.5,0.5348837209302326,-115,0.5097020142727117,LAA,MIA,2023 REG,8,5,8,8,13,16,0,1,-3,3,1,1,1,1,1,0,0,0,0,0.5097020142727117,0.49029798572728833
90275,0.6721311475409836,0.36363636363636365,-205,175,0.6480906892086682,0.3519093107913318,home,LAA,under,7.5,0.5121951219512195,-105,0.49029798572728833,LAA,MIA,2023 REG,8,5,8,8,13,16,0,1,-3,3,1,1,1,1,1,0,0,0,0,0.5097020142727117,0.49029798572728833
90276,0.4504504504504505,0.5833333333333333,122,-140,0.43523252982712446,0.5647674701728755,away,STL,over,8.5,0.504950495049505,-102,0.4837488699364985,CLE,STL,2023 REG,11,4,8,3,7,19,1,0,1,-1,1,1,1,0,0,0,0,0,0,0.4837488699364985,0.5162511300635015
90276,0.4504504504504505,0.5833333333333333,122,-140,0.43523252982712446,0.5647674701728755,home,CLE,under,8.5,0.5370370370370371,-116,0.5162511300635015,CLE,STL,2023 REG,11,4,8,3,7,19,1,0,1,-1,1,1,1,0,0,0,0,0,0,0.4837488699364985,0.5162511300635015
90277,0.607843137254902,0.43859649122807015,-155,128,0.5796151277848601,0.42038487221513987,away,NYY,over,9.5,0.5121951219512195,-105,0.48808156828023186,BOS,NYY,2023 REG,7,2,5,3,5,12,0,1,-1,1,1,1,0,0,0,0,0,0,0,0.48808156828023186,0.5119184317197681
90277,0.607843137254902,0.43859649122807015,-155,128,0.5796151277848601,0.42038487221513987,home,BOS,under,9.5,0.5348837209302326,-115,0.5119184317197681,BOS,NYY,2023 REG,7,2,5,3,5,12,0,1,-1,1,1,1,0,0,0,0,0,0,0,0.48808156828023186,0.5119184317197681
90278,0.574468085106383,0.46511627906976744,-135,115,0.5517281312179562,0.44827186878204384,away,PIT,over,9.5,0.504950495049505,-102,0.47949844489399435,NYM,PIT,2023 REG,9,7,5,2,9,14,1,0,5,-5,1,1,0,0,0,0,0,0,0,0.47949844489399435,0.5205015551060057
90278,0.574468085106383,0.46511627906976744,-135,115,0.5517281312179562,0.44827186878204384,home,NYM,under,9.5,0.5454545454545454,-120,0.5205015551060057,NYM,PIT,2023 REG,9,7,5,2,9,14,1,0,5,-5,1,1,0,0,0,0,0,0,0,0.47949844489399435,0.5205015551060057
90279,0.5,0.5454545454545454,100,-120,0.4772727272727273,0.5227272727272727,away,TEX,over,8,0.5073891625615764,-103,0.4837652908580103,CLE,TEX,2023 REG,15,12,6,3,15,21,1,0,9,-9,1,1,1,0,0,0,0,0,0,0.4837652908580103,0.5162347091419897
90279,0.5,0.5454545454545454,100,-120,0.4772727272727273,0.5227272727272727,home,CLE,under,8,0.5391705069124424,-117,0.5162347091419897,CLE,TEX,2023 REG,15,12,6,3,15,21,1,0,9,-9,1,1,1,0,0,0,0,0,0,0.4837652908580103,0.5162347091419897
90280,0.6296296296296295,0.4081632653061224,-170,145,0.6058341031886005,0.39416589681139946,away,COL,over,10.5,0.5121951219512195,-105,0.48808156828023186,CIN,COL,2023 REG,8,5,10,4,9,18,1,0,1,-1,1,1,1,1,0,0,0,0,0,0.48808156828023186,0.5119184317197681
90280,0.6296296296296295,0.4081632653061224,-170,145,0.6058341031886005,0.39416589681139946,home,CIN,under,10.5,0.5348837209302326,-115,0.5119184317197681,CIN,COL,2023 REG,8,5,10,4,9,18,1,0,1,-1,1,1,1,1,0,0,0,0,0,0.48808156828023186,0.5119184317197681
90281,0.42194092827004215,0.6153846153846154,137,-160,0.40619175373221195,0.593808246267788,away,TB,over,9,0.5238095238095238,-110,0.4988662131519274,DET,TB,2023 REG,11,6,13,10,16,24,0,1,-4,4,1,1,1,1,1,1,0,0,0,0.4988662131519274,0.5011337868480725
90281,0.42194092827004215,0.6153846153846154,137,-160,0.40619175373221195,0.593808246267788,home,DET,under,9,0.5238095238095238,-110,0.5011337868480725,DET,TB,2023 REG,11,6,13,10,16,24,0,1,-4,4,1,1,1,1,1,1,0,0,0,0.4988662131519274,0.5011337868480725
90282,0.5238095238095238,0.5238095238095238,-110,-110,0.4988662131519274,0.5011337868480725,away,CLE,over,9,0.5073891625615764,-103,0.4837652908580103,ARI,CLE,2023 REG,8,6,10,3,9,18,1,0,3,-3,1,1,1,0,0,0,0,0,0,0.4837652908580103,0.5162347091419897
90282,0.5238095238095238,0.5238095238095238,-110,-110,0.4988662131519274,0.5011337868480725,home,ARI,under,9,0.5391705069124424,-117,0.5162347091419897,ARI,CLE,2023 REG,8,6,10,3,9,18,1,0,3,-3,1,1,1,0,0,0,0,0,0,0.4837652908580103,0.5162347091419897
90283,0.6226415094339623,0.4166666666666667,-165,140,0.5981666073335706,0.40183339266642937,away,WSH,over,8.5,0.5412844036697247,-118,0.5136310900085983,SF,WSH,2023 REG,8,6,12,11,17,20,0,1,-5,5,1,1,1,1,1,1,0,0,0,0.5136310900085983,0.4863689099914017
90283,0.6226415094339623,0.4166666666666667,-165,140,0.5981666073335706,0.40183339266642937,home,SF,under,8.5,0.5098039215686274,-104,0.4863689099914017,SF,WSH,2023 REG,8,6,12,11,17,20,0,1,-5,5,1,1,1,1,1,1,0,0,0,0.5136310900085983,0.4863689099914017
90284,0.5,0.5475113122171946,100,-121,0.4762443438914027,0.5237556561085973,away,CIN,over,8.5,0.5121951219512195,-105,0.48808156828023186,STL,CIN,2023 REG,9,4,9,3,7,18,1,0,1,-1,1,1,1,0,0,0,0,0,0,0.48808156828023186,0.5119184317197681
90284,0.5,0.5475113122171946,100,-121,0.4762443438914027,0.5237556561085973,home,STL,under,8.5,0.5348837209302326,-115,0.5119184317197681,STL,CIN,2023 REG,9,4,9,3,7,18,1,0,1,-1,1,1,1,0,0,0,0,0,0,0.48808156828023186,0.5119184317197681
90285,0.5238095238095238,0.5145631067961165,-110,-106,0.5037095744446646,0.4962904255553354,away,CWS,over,9,0.5145631067961165,-106,0.4913668392989033,KC,CWS,2023 REG,6,4,8,3,7,14,1,0,1,-1,1,1,1,0,0,0,0,0,0,0.4913668392989033,0.5086331607010968
90285,0.5238095238095238,0.5145631067961165,-110,-106,0.5037095744446646,0.4962904255553354,home,KC,under,9,0.5305164319248826,-113,0.5086331607010968,KC,CWS,2023 REG,6,4,8,3,7,14,1,0,1,-1,1,1,1,0,0,0,0,0,0,0.4913668392989033,0.5086331607010968
90286,0.6336996336996338,0.4081632653061224,-173,145,0.6071711299340814,0.3928288700659186,away,MIL,over,8.5,0.5192307692307692,-108,0.49688292476754015,SF,MIL,2023 REG,6,4,6,1,5,12,1,0,3,-3,1,0,0,0,0,0,0,0,0,0.49688292476754015,0.5031170752324599
90286,0.6336996336996338,0.4081632653061224,-173,145,0.6071711299340814,0.3928288700659186,home,SF,under,8.5,0.5238095238095238,-110,0.5031170752324599,SF,MIL,2023 REG,6,4,6,1,5,12,1,0,3,-3,1,0,0,0,0,0,0,0,0,0.49688292476754015,0.5031170752324599
90287,0.6428571428571428,0.39525691699604737,-180,153,0.6183552472372348,0.3816447527627652,away,PIT,over,9,0.5098039215686274,-104,0.4870219861770517,MIL,PIT,2023 REG,8,4,12,8,12,20,0,1,-4,4,1,1,1,1,0,0,0,0,0,0.4870219861770517,0.5129780138229483
90287,0.6428571428571428,0.39525691699604737,-180,153,0.6183552472372348,0.3816447527627652,home,MIL,under,9,0.5348837209302326,-115,0.5129780138229483,MIL,PIT,2023 REG,8,4,12,8,12,20,0,1,-4,4,1,1,1,1,0,0,0,0,0,0.4870219861770517,0.5129780138229483
90288,0.5652173913043479,0.47619047619047616,-130,110,0.5418129444594474,0.4581870555405526,away,NYY,over,9.5,0.5098039215686274,-104,0.48375889301574193,BOS,NYY,2023 REG,6,1,9,4,5,15,0,1,-3,3,1,0,0,0,0,0,0,0,0,0.48375889301574193,0.5162411069842581
90288,0.5652173913043479,0.47619047619047616,-130,110,0.5418129444594474,0.4581870555405526,home,BOS,under,9.5,0.5412844036697247,-118,0.5162411069842581,BOS,NYY,2023 REG,6,1,9,4,5,15,0,1,-3,3,1,0,0,0,0,0,0,0,0,0.48375889301574193,0.5162411069842581
90289,0.6108949416342413,0.425531914893617,-157,135,0.5886419592417365,0.41135804075826354,away,PHI,over,9,0.5098039215686274,-104,0.48592421718142587,HOU,PHI,2023 REG,9,4,5,3,7,14,1,0,1,-1,1,1,1,0,0,0,0,0,0,0.48592421718142587,0.5140757828185741
90289,0.6108949416342413,0.425531914893617,-157,135,0.5886419592417365,0.41135804075826354,home,HOU,under,9,0.5370370370370371,-116,0.5140757828185741,HOU,PHI,2023 REG,9,4,5,3,7,14,1,0,1,-1,1,1,1,0,0,0,0,0,0,0.48592421718142587,0.5140757828185741
90290,0.6183206106870228,0.42372881355932196,-162,136,0.5923205850079852,0.40767941499201477,away,DET,over,7.5,0.5,100,0.4762443438914027,MIA,DET,2023 REG,12,6,11,5,11,23,1,0,1,-1,1,1,1,1,1,0,0,0,0,0.4762443438914027,0.5237556561085973
90290,0.6183206106870228,0.42372881355932196,-162,136,0.5923205850079852,0.40767941499201477,home,MIA,under,7.5,0.5475113122171946,-121,0.5237556561085973,MIA,DET,2023 REG,12,6,11,5,11,23,1,0,1,-1,1,1,1,1,1,0,0,0,0,0.4762443438914027,0.5237556561085973
90291,0.5833333333333333,0.45454545454545453,-140,120,0.5612373737373737,0.4387626262626263,away,NYY,over,7.5,0.5169082125603864,-107,0.49353874091423283,SEA,NYY,2023 REG,5,1,3,0,1,8,1,0,1,-1,0,0,0,0,0,0,0,0,0,0.49353874091423283,0.5064612590857671
90291,0.5833333333333333,0.45454545454545453,-140,120,0.5612373737373737,0.4387626262626263,home,SEA,under,7.5,0.5283018867924528,-112,0.5064612590857671,SEA,NYY,2023 REG,5,1,3,0,1,8,1,0,1,-1,0,0,0,0,0,0,0,0,0,0.49353874091423283,0.5064612590857671
90292,0.5238095238095238,0.5238095238095238,-110,-110,0.4988662131519274,0.5011337868480725,away,CIN,over,8.5,0.5169082125603864,-107,0.49353874091423283,NYM,CIN,2023 REG,8,2,9,3,5,17,0,1,-1,1,1,1,0,0,0,0,0,0,0,0.49353874091423283,0.5064612590857671
90292,0.5238095238095238,0.5238095238095238,-110,-110,0.4988662131519274,0.5011337868480725,home,NYM,under,8.5,0.5283018867924528,-112,0.5064612590857671,NYM,CIN,2023 REG,8,2,9,3,5,17,0,1,-1,1,1,1,0,0,0,0,0,0,0,0.49353874091423283,0.5064612590857671
90293,0.5348837209302326,0.5121951219512195,-115,-105,0.5097020142727117,0.49029798572728833,away,MIL,over,9,0.49504950495049505,102,0.4719707862985384,PIT,MIL,2023 REG,7,3,8,6,9,15,0,1,-3,3,1,1,1,0,0,0,0,0,0,0.4719707862985384,0.5280292137014616
90293,0.5348837209302326,0.5121951219512195,-115,-105,0.5097020142727117,0.49029798572728833,home,PIT,under,9,0.5515695067264574,-123,0.5280292137014616,PIT,MIL,2023 REG,7,3,8,6,9,15,0,1,-3,3,1,1,1,0,0,0,0,0,0,0.4719707862985384,0.5280292137014616
90294,0.3921568627450981,0.6491228070175439,155,-185,0.37596875695582666,0.6240312430441733,away,BAL,over,8.5,0.5348837209302326,-115,0.5097020142727117,LAA,BAL,2023 REG,12,4,13,5,9,25,0,1,-1,1,1,1,1,1,0,0,0,0,0,0.5097020142727117,0.49029798572728833
90294,0.3921568627450981,0.6491228070175439,155,-185,0.37596875695582666,0.6240312430441733,home,LAA,under,8.5,0.5121951219512195,-105,0.49029798572728833,LAA,BAL,2023 REG,12,4,13,5,9,25,0,1,-1,1,1,1,1,1,0,0,0,0,0,0.5097020142727117,0.49029798572728833
90295,0.4,0.6428571428571428,150,-180,0.38285714285714295,0.617142857142857,away,BOS,over,10,0.5412844036697247,-118,0.5175913212324037,KC,BOS,2023 REG,11,5,13,9,14,24,0,1,-4,4,1,1,1,1,1,0,0,0,0,0.5175913212324037,0.4824086787675963
90295,0.4,0.6428571428571428,150,-180,0.38285714285714295,0.617142857142857,home,KC,under,10,0.5024875621890548,-101,0.4824086787675963,KC,BOS,2023 REG,11,5,13,9,14,24,0,1,-4,4,1,1,1,1,1,0,0,0,0,0.5175913212324037,0.4824086787675963
90296,0.425531914893617,0.6108949416342413,135,-157,0.41003112488176247,0.5899688751182375,away,SD,over,9,0.5348837209302326,-115,0.5097020142727117,ARI,SD,2023 REG,6,5,8,7,12,14,0,1,-2,2,1,1,1,1,1,0,0,0,0,0.5097020142727117,0.49029798572728833
90296,0.425531914893617,0.6108949416342413,135,-157,0.41003112488176247,0.5899688751182375,home,ARI,under,9,0.5121951219512195,-105,0.49029798572728833,ARI,SD,2023 REG,6,5,8,7,12,14,0,1,-2,2,1,1,1,1,1,0,0,0,0,0.5097020142727117,0.49029798572728833
90297,0.6875,0.35714285714285715,-220,180,0.6568080357142857,0.3431919642857143,away,PIT,over,7.5,0.5145631067961165,-106,0.4913668392989033,MIA,PIT,2023 REG,7,1,7,3,4,14,0,1,-2,2,1,0,0,0,0,0,0,0,0,0.4913668392989033,0.5086331607010968
90297,0.6875,0.35714285714285715,-220,180,0.6568080357142857,0.3431919642857143,home,MIA,under,7.5,0.5305164319248826,-113,0.5086331607010968,MIA,PIT,2023 REG,7,1,7,3,4,14,0,1,-2,2,1,0,0,0,0,0,0,0,0,0.4913668392989033,0.5086331607010968
90298,0.5555555555555556,0.47846889952153115,-125,109,0.5366530805127296,0.46334691948727036,away,SF,over,8.5,0.5121951219512195,-105,0.48808156828023186,CWS,SF,2023 REG,11,6,20,16,22,31,0,1,-10,10,1,1,1,1,1,1,0,0,0,0.48808156828023186,0.5119184317197681
90298,0.5555555555555556,0.47846889952153115,-125,109,0.5366530805127296,0.46334691948727036,home,CWS,under,8.5,0.5348837209302326,-115,0.5119184317197681,CWS,SF,2023 REG,11,6,20,16,22,31,0,1,-10,10,1,1,1,1,1,1,0,0,0,0.48808156828023186,0.5119184317197681
90299,0.6296296296296295,0.4081632653061224,-170,145,0.6058341031886005,0.39416589681139946,away,STL,over,10,0.5121951219512195,-105,0.48808156828023186,BAL,STL,2023 REG,13,11,12,5,16,25,1,0,6,-6,1,1,1,1,1,0,0,0,0,0.48808156828023186,0.5119184317197681
90299,0.6296296296296295,0.4081632653061224,-170,145,0.6058341031886005,0.39416589681139946,home,BAL,under,10,0.5348837209302326,-115,0.5119184317197681,BAL,STL,2023 REG,13,11,12,5,16,25,1,0,6,-6,1,1,1,1,1,0,0,0,0,0.48808156828023186,0.5119184317197681
90300,0.4347826086956522,0.607843137254902,130,-155,0.41624967567367205,0.583750324326328,away,DET,over,9.5,0.5238095238095238,-110,0.4988662131519274,CWS,DET,2023 REG,6,2,5,3,5,11,0,1,-1,1,1,1,0,0,0,0,0,0,0,0.4988662131519274,0.5011337868480725
90300,0.4347826086956522,0.607843137254902,130,-155,0.41624967567367205,0.583750324326328,home,CWS,under,9.5,0.5238095238095238,-110,0.5011337868480725,CWS,DET,2023 REG,6,2,5,3,5,11,0,1,-1,1,1,1,0,0,0,0,0,0,0,0.4988662131519274,0.5011337868480725
90301,0.45454545454545453,0.5798319327731092,120,-138,0.4389193694006528,0.5610806305993472,away,ATL,over,8.5,0.5121951219512195,-105,0.48919479393107135,KC,ATL,2023 REG,11,3,14,9,12,25,0,1,-6,6,1,1,1,0,0,0,0,0,0,0.48919479393107135,0.5108052060689287
90301,0.45454545454545453,0.5798319327731092,120,-138,0.4389193694006528,0.5610806305993472,home,KC,under,8.5,0.5327102803738317,-114,0.5108052060689287,KC,ATL,2023 REG,11,3,14,9,12,25,0,1,-6,6,1,1,1,0,0,0,0,0,0,0.48919479393107135,0.5108052060689287
90302,0.6453900709219857,0.3968253968253968,-182,152,0.6181446271984977,0.3818553728015023,away,WSH,over,10.5,0.5454545454545454,-120,0.5206611570247933,CIN,WSH,2023 REG,7,3,7,6,9,14,0,1,-3,3,1,1,1,0,0,0,0,0,0,0.5206611570247933,0.4793388429752067
90302,0.6453900709219857,0.3968253968253968,-182,152,0.6181446271984977,0.3818553728015023,home,CIN,under,10.5,0.5,100,0.4793388429752067,CIN,WSH,2023 REG,7,3,7,6,9,14,0,1,-3,3,1,1,1,0,0,0,0,0,0,0.5206611570247933,0.4793388429752067
90303,0.6240601503759399,0.4132231404958678,-166,142,0.6007931342679697,0.39920686573203035,away,MIN,over,7,0.49504950495049505,102,0.4739797934813417,NYY,MIN,2023 REG,7,2,2,0,2,9,1,0,2,-2,0,0,0,0,0,0,0,0,0,0.4739797934813417,0.5260202065186583
90303,0.6240601503759399,0.4132231404958678,-166,142,0.6007931342679697,0.39920686573203035,home,NYY,under,7,0.5475113122171946,-121,0.5260202065186583,NYY,MIN,2023 REG,7,2,2,0,2,9,1,0,2,-2,0,0,0,0,0,0,0,0,0,0.4739797934813417,0.5260202065186583
90304,0.5238095238095238,0.5238095238095238,-110,-110,0.4988662131519274,0.5011337868480725,away,TB,over,7.5,0.5433789954337899,-119,0.5198077604720502,SD,TB,2023 REG,7,2,9,6,8,16,0,1,-4,4,1,1,0,0,0,0,0,0,0,0.5198077604720502,0.48019223952794976
90304,0.5238095238095238,0.5238095238095238,-110,-110,0.4988662131519274,0.5011337868480725,home,SD,under,7.5,0.5,100,0.48019223952794976,SD,TB,2023 REG,7,2,9,6,8,16,0,1,-4,4,1,1,0,0,0,0,0,0,0,0.5198077604720502,0.48019223952794976
90305,0.6000000000000001,0.4347826086956522,-150,130,0.5791304347826086,0.4208695652173914,away,BOS,over,8.5,0.5121951219512195,-105,0.48808156828023186,CLE,BOS,2023 REG,15,10,8,3,13,23,1,0,7,-7,1,1,1,0,0,0,0,0,0,0.48808156828023186,0.5119184317197681
90305,0.6000000000000001,0.4347826086956522,-150,130,0.5791304347826086,0.4208695652173914,home,CLE,under,8.5,0.5348837209302326,-115,0.5119184317197681,CLE,BOS,2023 REG,15,10,8,3,13,23,1,0,7,-7,1,1,1,0,0,0,0,0,0,0.48808156828023186,0.5119184317197681
90306,0.574468085106383,0.46511627906976744,-135,115,0.5517281312179562,0.44827186878204384,away,PIT,over,9.5,0.5327102803738317,-114,0.5075272610403079,CIN,PIT,2023 REG,16,12,16,13,25,32,0,1,-1,1,1,1,1,1,1,1,1,1,1,0.5075272610403079,0.4924727389596921
90306,0.574468085106383,0.46511627906976744,-135,115,0.5517281312179562,0.44827186878204384,home,CIN,under,9.5,0.5145631067961165,-106,0.4924727389596921,CIN,PIT,2023 REG,16,12,16,13,25,32,0,1,-1,1,1,1,1,1,1,1,1,1,1,0.5075272610403079,0.4924727389596921
90307,0.48780487804878053,0.5475113122171946,105,-121,0.470577468162939,0.529422531837061,away,NYY,over,8.5,0.5098039215686274,-104,0.48375889301574193,TEX,NYY,2023 REG,11,15,8,2,17,19,1,0,13,-13,1,1,0,0,0,0,0,0,0,0.48375889301574193,0.5162411069842581
90307,0.48780487804878053,0.5475113122171946,105,-121,0.470577468162939,0.529422531837061,home,TEX,under,8.5,0.5412844036697247,-118,0.5162411069842581,TEX,NYY,2023 REG,11,15,8,2,17,19,1,0,13,-13,1,1,0,0,0,0,0,0,0,0.48375889301574193,0.5162411069842581
90308,0.5555555555555556,0.48780487804878053,-125,105,0.5314664257753688,0.46853357422463116,away,MIL,over,8,0.5283018867924528,-112,0.5031902949311281,TEX,MIL,2023 REG,8,8,14,9,17,22,0,1,-1,1,1,1,1,1,1,1,1,1,0,0.5031902949311281,0.4968097050688719
90308,0.5555555555555556,0.48780487804878053,-125,105,0.5314664257753688,0.46853357422463116,home,TEX,under,8,0.5192307692307692,-108,0.4968097050688719,TEX,MIL,2023 REG,8,8,14,9,17,22,0,1,-1,1,1,1,1,1,1,1,1,1,0,0.5031902949311281,0.4968097050688719
90309,0.5495495495495495,0.48780487804878053,-122,105,0.529021440689206,0.470978559310794,away,BOS,over,10,0.5145631067961165,-106,0.4913668392989033,PHI,BOS,2023 REG,9,6,5,1,7,14,1,0,5,-5,1,0,0,0,0,0,0,0,0,0.4913668392989033,0.5086331607010968
90309,0.5495495495495495,0.48780487804878053,-122,105,0.529021440689206,0.470978559310794,home,PHI,under,10,0.5305164319248826,-113,0.5086331607010968,PHI,BOS,2023 REG,9,6,5,1,7,14,1,0,5,-5,1,0,0,0,0,0,0,0,0,0.4913668392989033,0.5086331607010968
90310,0.6666666666666666,0.37037037037037035,-200,170,0.6419753086419753,0.3580246913580247,away,CWS,over,8.5,0.5433789954337899,-119,0.5198077604720502,LAD,CWS,2023 REG,8,5,3,1,6,11,1,0,4,-4,1,0,0,0,0,0,0,0,0,0.5198077604720502,0.48019223952794976
90310,0.6666666666666666,0.37037037037037035,-200,170,0.6419753086419753,0.3580246913580247,home,LAD,under,8.5,0.5,100,0.48019223952794976,LAD,CWS,2023 REG,8,5,3,1,6,11,1,0,4,-4,1,0,0,0,0,0,0,0,0,0.5198077604720502,0.48019223952794976
90311,0.5555555555555556,0.48780487804878053,-125,105,0.5314664257753688,0.46853357422463116,away,BAL,over,8,0.5169082125603864,-107,0.49239402434819424,MIN,BAL,2023 REG,9,2,6,6,8,15,0,1,-4,4,1,1,0,0,0,0,0,0,0,0.49239402434819424,0.5076059756518058
90311,0.5555555555555556,0.48780487804878053,-125,105,0.5314664257753688,0.46853357422463116,home,MIN,under,8,0.5305164319248826,-113,0.5076059756518058,MIN,BAL,2023 REG,9,2,6,6,8,15,0,1,-4,4,1,1,0,0,0,0,0,0,0,0.49239402434819424,0.5076059756518058
90312,0.4347826086956522,0.607843137254902,130,-155,0.41624967567367205,0.583750324326328,away,ARI,over,9,0.5238095238095238,-110,0.4988662131519274,CWS,ARI,2023 REG,9,4,12,15,19,21,0,1,-11,11,1,1,1,1,0,0,0,0,0,0.4988662131519274,0.5011337868480725
90312,0.4347826086956522,0.607843137254902,130,-155,0.41624967567367205,0.583750324326328,home,CWS,under,9,0.5238095238095238,-110,0.5011337868480725,CWS,ARI,2023 REG,9,4,12,15,19,21,0,1,-11,11,1,1,1,1,0,0,0,0,0,0.4988662131519274,0.5011337868480725
90313,0.613899613899614,0.42016806722689076,-159,138,0.5929854776095975,0.4070145223904025,away,SD,over,9.5,0.5169082125603864,-107,0.49353874091423283,LAD,SD,2023 REG,4,4,3,0,4,7,1,0,4,-4,0,0,0,0,0,0,0,0,0,0.49353874091423283,0.5064612590857671
90313,0.613899613899614,0.42016806722689076,-159,138,0.5929854776095975,0.4070145223904025,home,LAD,under,9.5,0.5283018867924528,-112,0.5064612590857671,LAD,SD,2023 REG,4,4,3,0,4,7,1,0,4,-4,0,0,0,0,0,0,0,0,0,0.49353874091423283,0.5064612590857671
90314,0.3921568627450981,0.6453900709219857,155,-182,0.37743257503251615,0.6225674249674839,away,NYY,over,8.5,0.5121951219512195,-105,0.48808156828023186,CLE,NYY,2023 REG,7,2,13,11,13,20,0,1,-9,9,1,1,0,0,0,0,0,0,0,0.48808156828023186,0.5119184317197681
90314,0.3921568627450981,0.6453900709219857,155,-182,0.37743257503251615,0.6225674249674839,home,CLE,under,8.5,0.5348837209302326,-115,0.5119184317197681,CLE,NYY,2023 REG,7,2,13,11,13,20,0,1,-9,9,1,1,0,0,0,0,0,0,0,0.48808156828023186,0.5119184317197681
90315,0.6226415094339623,0.4166666666666667,-165,140,0.5981666073335706,0.40183339266642937,away,TEX,over,8.5,0.5215311004784688,-109,0.4978845547971712,SD,TEX,2023 REG,9,7,6,1,8,15,1,0,6,-6,1,0,0,0,0,0,0,0,0,0.4978845547971712,0.5021154452028288
90315,0.6226415094339623,0.4166666666666667,-165,140,0.5981666073335706,0.40183339266642937,home,SD,under,8.5,0.5238095238095238,-110,0.5021154452028288,SD,TEX,2023 REG,9,7,6,1,8,15,1,0,6,-6,1,0,0,0,0,0,0,0,0,0.4978845547971712,0.5021154452028288
90316,0.5555555555555556,0.48309178743961345,-125,107,0.5340848094471283,0.46591519055287167,away,SEA,over,9,0.5,100,0.47935779816513757,PHI,SEA,2023 REG,10,3,8,5,8,18,0,1,-2,2,1,1,1,0,0,0,0,0,0,0.47935779816513757,0.5206422018348624
90316,0.5555555555555556,0.48309178743961345,-125,107,0.5340848094471283,0.46591519055287167,home,PHI,under,9,0.5412844036697247,-118,0.5206422018348624,PHI,SEA,2023 REG,10,3,8,5,8,18,0,1,-2,2,1,1,1,0,0,0,0,0,0,0.47935779816513757,0.5206422018348624
90317,0.5967741935483871,0.4444444444444444,-148,125,0.5721759741010521,0.42782402589894786,away,MIN,over,9,0.5391705069124424,-117,0.5127649394825569,PHI,MIN,2023 REG,15,13,7,2,15,22,1,0,11,-11,1,1,0,0,0,0,0,0,0,0.5127649394825569,0.48723506051744314
90317,0.5967741935483871,0.4444444444444444,-148,125,0.5721759741010521,0.42782402589894786,home,PHI,under,9,0.5098039215686274,-104,0.48723506051744314,PHI,MIN,2023 REG,15,13,7,2,15,22,1,0,11,-11,1,1,0,0,0,0,0,0,0,0.5127649394825569,0.48723506051744314
90318,0.7354497354497355,0.3076923076923077,-278,225,0.7037209312341587,0.2962790687658413,away,OAK,over,8.5,0.5348837209302326,-115,0.5097020142727117,SEA,OAK,2023 REG,6,5,9,4,9,15,1,0,1,-1,1,1,1,1,0,0,0,0,0,0.5097020142727117,0.49029798572728833
90318,0.7354497354497355,0.3076923076923077,-278,225,0.7037209312341587,0.2962790687658413,home,SEA,under,8.5,0.5121951219512195,-105,0.49029798572728833,SEA,OAK,2023 REG,6,5,9,4,9,15,1,0,1,-1,1,1,1,1,0,0,0,0,0,0.5097020142727117,0.49029798572728833
90319,0.6000000000000001,0.43859649122807015,-150,128,0.5768421052631579,0.42315789473684207,away,LAA,over,8.5,0.5454545454545454,-120,0.5206611570247933,LAD,LAA,2023 REG,10,10,9,5,15,19,1,0,5,-5,1,1,1,1,1,0,0,0,0,0.5206611570247933,0.4793388429752067
90319,0.6000000000000001,0.43859649122807015,-150,128,0.5768421052631579,0.42315789473684207,home,LAD,under,8.5,0.5,100,0.4793388429752067,LAD,LAA,2023 REG,10,10,9,5,15,19,1,0,5,-5,1,1,1,1,1,0,0,0,0,0.5206611570247933,0.4793388429752067
90320,0.3508771929824561,0.6923076923076923,185,-225,0.3357246016525795,0.6642753983474206,away,SF,over,11,0.5121951219512195,-105,0.48808156828023186,COL,SF,2023 REG,9,4,8,5,9,17,0,1,-1,1,1,1,1,1,0,0,0,0,0,0.48808156828023186,0.5119184317197681
90320,0.3508771929824561,0.6923076923076923,185,-225,0.3357246016525795,0.6642753983474206,home,COL,under,11,0.5348837209302326,-115,0.5119184317197681,COL,SF,2023 REG,9,4,8,5,9,17,0,1,-1,1,1,1,1,1,0,0,0,0,0,0.48808156828023186,0.5119184317197681
90321,0.6363636363636364,0.40322580645161293,-175,148,0.6111703545721141,0.3888296454278859,away,LAD,over,8,0.5121951219512195,-105,0.48808156828023186,SEA,LAD,2023 REG,7,1,10,6,7,17,0,1,-5,5,1,0,0,0,0,0,0,0,0,0.48808156828023186,0.5119184317197681
90321,0.6363636363636364,0.40322580645161293,-175,148,0.6111703545721141,0.3888296454278859,home,SEA,under,8,0.5348837209302326,-115,0.5119184317197681,SEA,LAD,2023 REG,7,1,10,6,7,17,0,1,-5,5,1,0,0,0,0,0,0,0,0,0.48808156828023186,0.5119184317197681
90322,0.5073891625615764,0.5348837209302326,-103,-115,0.4859403596076043,0.5140596403923957,away,LAD,over,8.5,0.5412844036697247,-118,0.5189377998484975,STL,LAD,2023 REG,2,0,10,5,5,12,0,1,-5,5,0,0,0,0,0,0,0,0,0,0.5189377998484975,0.4810622001515025
90322,0.5073891625615764,0.5348837209302326,-103,-115,0.4859403596076043,0.5140596403923957,home,STL,under,8.5,0.5,100,0.4810622001515025,STL,LAD,2023 REG,2,0,10,5,5,12,0,1,-5,5,0,0,0,0,0,0,0,0,0,0.5189377998484975,0.4810622001515025
90323,0.4347826086956522,0.6031746031746031,130,-152,0.418279473099889,0.581720526900111,away,BAL,over,8.5,0.5121951219512195,-105,0.48808156828023186,DET,BAL,2023 REG,7,3,9,5,8,16,0,1,-2,2,1,1,1,0,0,0,0,0,0,0.48808156828023186,0.5119184317197681
90323,0.4347826086956522,0.6031746031746031,130,-152,0.418279473099889,0.581720526900111,home,DET,under,8.5,0.5348837209302326,-115,0.5119184317197681,DET,BAL,2023 REG,7,3,9,5,8,16,0,1,-2,2,1,1,1,0,0,0,0,0,0,0.48808156828023186,0.5119184317197681
90324,0.6108949416342413,0.425531914893617,-157,135,0.5886419592417365,0.41135804075826354,away,PIT,over,8.5,0.5098039215686274,-104,0.4870219861770517,STL,PIT,2023 REG,12,5,8,4,9,20,1,0,1,-1,1,1,1,1,0,0,0,0,0,0.4870219861770517,0.5129780138229483
90324,0.6108949416342413,0.425531914893617,-157,135,0.5886419592417365,0.41135804075826354,home,STL,under,8.5,0.5348837209302326,-115,0.5129780138229483,STL,PIT,2023 REG,12,5,8,4,9,20,1,0,1,-1,1,1,1,1,0,0,0,0,0,0.4870219861770517,0.5129780138229483
90325,0.5348837209302326,0.5098039215686274,-115,-104,0.5109810284308424,0.48901897156915763,away,TOR,over,8.5,0.5,100,0.4783105022831051,PHI,TOR,2023 REG,7,2,4,1,3,11,1,0,1,-1,1,0,0,0,0,0,0,0,0,0.4783105022831051,0.5216894977168949
90325,0.5348837209302326,0.5098039215686274,-115,-104,0.5109810284308424,0.48901897156915763,home,PHI,under,8.5,0.5433789954337899,-119,0.5216894977168949,PHI,TOR,2023 REG,7,2,4,1,3,11,1,0,1,-1,1,0,0,0,0,0,0,0,0,0.4783105022831051,0.5216894977168949
90326,0.5884773662551441,0.45454545454545453,-143,120,0.5631594099815408,0.4368405900184592,away,TEX,over,7.5,0.5073891625615764,-103,0.4837652908580103,SEA,TEX,2023 REG,7,1,8,6,7,15,0,1,-5,5,1,0,0,0,0,0,0,0,0,0.4837652908580103,0.5162347091419897
90326,0.5884773662551441,0.45454545454545453,-143,120,0.5631594099815408,0.4368405900184592,home,SEA,under,7.5,0.5391705069124424,-117,0.5162347091419897,SEA,TEX,2023 REG,7,1,8,6,7,15,0,1,-5,5,1,0,0,0,0,0,0,0,0,0.4837652908580103,0.5162347091419897
90327,0.5238095238095238,0.5238095238095238,-110,-110,0.4988662131519274,0.5011337868480725,away,NYY,over,9,0.5121951219512195,-105,0.48808156828023186,LAA,NYY,2023 REG,5,5,2,1,6,7,1,0,4,-4,1,0,0,0,0,0,0,0,0,0.48808156828023186,0.5119184317197681
90327,0.5238095238095238,0.5238095238095238,-110,-110,0.4988662131519274,0.5011337868480725,home,LAA,under,9,0.5348837209302326,-115,0.5119184317197681,LAA,NYY,2023 REG,5,5,2,1,6,7,1,0,4,-4,1,0,0,0,0,0,0,0,0,0.48808156828023186,0.5119184317197681
90328,0.7014925373134329,0.3389830508474576,-235,195,0.6730992142751963,0.32690078572480374,away,COL,over,8.5,0.5,100,0.4772727272727273,MIA,COL,2023 REG,7,1,9,6,7,16,0,1,-5,5,1,0,0,0,0,0,0,0,0,0.4772727272727273,0.5227272727272727
90328,0.7014925373134329,0.3389830508474576,-235,195,0.6730992142751963,0.32690078572480374,home,MIA,under,8.5,0.5454545454545454,-120,0.5227272727272727,MIA,COL,2023 REG,7,1,9,6,7,16,0,1,-5,5,1,0,0,0,0,0,0,0,0,0.4772727272727273,0.5227272727272727
90329,0.6402877697841727,0.4,-178,150,0.6144920035194866,0.38550799648051337,away,SD,over,10,0.5145631067961165,-106,0.49023796582517226,HOU,SD,2023 REG,11,12,7,2,14,18,1,0,10,-10,1,1,0,0,0,0,0,0,0,0.49023796582517226,0.5097620341748277
90329,0.6402877697841727,0.4,-178,150,0.6144920035194866,0.38550799648051337,home,HOU,under,10,0.5327102803738317,-114,0.5097620341748277,HOU,SD,2023 REG,11,12,7,2,14,18,1,0,10,-10,1,1,0,0,0,0,0,0,0,0.49023796582517226,0.5097620341748277
90330,0.5867768595041323,0.4629629629629629,-142,116,0.5575906826845971,0.4424093173154029,away,LAA,over,8.5,0.5454545454545454,-120,0.5140092723241282,HOU,LAA,2023 REG,7,1,4,2,3,11,0,1,-1,1,1,0,0,0,0,0,0,0,0,0.5140092723241282,0.4859907276758718
90330,0.5867768595041323,0.4629629629629629,-142,116,0.5575906826845971,0.4424093173154029,home,HOU,under,8.5,0.5121951219512195,-105,0.4859907276758718,HOU,LAA,2023 REG,7,1,4,2,3,11,0,1,-1,1,1,0,0,0,0,0,0,0,0,0.5140092723241282,0.4859907276758718
90331,0.5238095238095238,0.5238095238095238,-110,-110,0.4988662131519274,0.5011337868480725,away,KC,over,7,0.5412844036697247,-118,0.5162581740877563,DET,KC,2023 REG,10,7,6,3,10,16,1,0,4,-4,1,1,1,0,0,0,0,0,0,0.5162581740877563,0.4837418259122437
90331,0.5238095238095238,0.5238095238095238,-110,-110,0.4988662131519274,0.5011337868480725,home,DET,under,7,0.504950495049505,-102,0.4837418259122437,DET,KC,2023 REG,10,7,6,3,10,16,1,0,4,-4,1,1,1,0,0,0,0,0,0,0.5162581740877563,0.4837418259122437
90332,0.5815899581589958,0.4587155963302753,-139,118,0.5581486524100054,0.44185134758999456,away,STL,over,9.5,0.5348837209302326,-115,0.5097020142727117,PHI,STL,2023 REG,11,7,5,2,9,16,1,0,5,-5,1,1,0,0,0,0,0,0,0,0.5097020142727117,0.49029798572728833
90332,0.5815899581589958,0.4587155963302753,-139,118,0.5581486524100054,0.44185134758999456,home,PHI,under,9.5,0.5121951219512195,-105,0.49029798572728833,PHI,STL,2023 REG,11,7,5,2,9,16,1,0,5,-5,1,1,0,0,0,0,0,0,0,0.5097020142727117,0.49029798572728833
90333,0.7590361445783133,0.28169014084507044,-315,255,0.7281234219075522,0.2718765780924478,away,OAK,over,7.5,0.5412844036697247,-118,0.5189377998484975,TB,OAK,2023 REG,12,11,1,0,11,13,1,0,11,-11,0,0,0,0,0,0,0,0,0,0.5189377998484975,0.4810622001515025
90333,0.7590361445783133,0.28169014084507044,-315,255,0.7281234219075522,0.2718765780924478,home,TB,under,7.5,0.5,100,0.4810622001515025,TB,OAK,2023 REG,12,11,1,0,11,13,1,0,11,-11,0,0,0,0,0,0,0,0,0,0.5189377998484975,0.4810622001515025
90334,0.7333333333333333,0.3076923076923077,-275,225,0.7032478632478633,0.29675213675213674,away,CWS,over,9.5,0.5,100,0.4772727272727273,ATL,CWS,2023 REG,8,9,5,0,9,13,1,0,9,-9,0,0,0,0,0,0,0,0,0,0.4772727272727273,0.5227272727272727
90334,0.7333333333333333,0.3076923076923077,-275,225,0.7032478632478633,0.29675213675213674,home,ATL,under,9.5,0.5454545454545454,-120,0.5227272727272727,ATL,CWS,2023 REG,8,9,5,0,9,13,1,0,9,-9,0,0,0,0,0,0,0,0,0,0.4772727272727273,0.5227272727272727
90335,0.4,0.6402877697841727,150,-178,0.383884892086331,0.6161151079136691,away,SF,over,12,0.5121951219512195,-105,0.48808156828023186,COL,SF,2023 REG,15,10,14,11,21,29,0,1,-1,1,1,1,1,1,1,1,1,1,1,0.48808156828023186,0.5119184317197681
90335,0.4,0.6402877697841727,150,-178,0.383884892086331,0.6161151079136691,home,COL,under,12,0.5348837209302326,-115,0.5119184317197681,COL,SF,2023 REG,15,10,14,11,21,29,0,1,-1,1,1,1,1,1,1,1,1,1,1,0.48808156828023186,0.5119184317197681
90336,0.6491228070175439,0.3921568627450981,-185,155,0.6223272319084604,0.3776727680915396,away,MIN,over,7.5,0.5348837209302326,-115,0.5097020142727117,HOU,MIN,2023 REG,6,2,11,8,10,17,0,1,-6,6,1,1,0,0,0,0,0,0,0,0.5097020142727117,0.49029798572728833
90336,0.6491228070175439,0.3921568627450981,-185,155,0.6223272319084604,0.3776727680915396,home,HOU,under,7.5,0.5121951219512195,-105,0.49029798572728833,HOU,MIN,2023 REG,6,2,11,8,10,17,0,1,-6,6,1,1,0,0,0,0,0,0,0,0.5097020142727117,0.49029798572728833
90337,0.5918367346938775,0.4484304932735426,-145,123,0.5680051099784656,0.43199489002153435,away,MIL,over,9,0.5305164319248826,-113,0.5078572507605655,ARI,MIL,2023 REG,8,3,3,0,3,11,1,0,3,-3,0,0,0,0,0,0,0,0,0,0.5078572507605655,0.49214274923943446
90337,0.5918367346938775,0.4484304932735426,-145,123,0.5680051099784656,0.43199489002153435,home,ARI,under,9,0.5121951219512195,-105,0.49214274923943446,ARI,MIL,2023 REG,8,3,3,0,3,11,1,0,3,-3,0,0,0,0,0,0,0,0,0,0.5078572507605655,0.49214274923943446
90338,0.7058823529411764,0.3333333333333333,-240,200,0.6782006920415226,0.32179930795847744,away,DET,over,9.5,0.5145631067961165,-106,0.4913668392989033,TOR,DET,2023 REG,8,1,7,3,4,15,0,1,-2,2,1,0,0,0,0,0,0,0,0,0.4913668392989033,0.5086331607010968
90338,0.7058823529411764,0.3333333333333333,-240,200,0.6782006920415226,0.32179930795847744,home,TOR,under,9.5,0.5305164319248826,-113,0.5086331607010968,TOR,DET,2023 REG,8,1,7,3,4,15,0,1,-2,2,1,0,0,0,0,0,0,0,0,0.4913668392989033,0.5086331607010968
90339,0.5833333333333333,0.45454545454545453,-140,120,0.5612373737373737,0.4387626262626263,away,CLE,over,7.5,0.49504950495049505,102,0.47297076509898783,NYM,CLE,2023 REG,7,2,3,1,3,10,1,0,1,-1,1,0,0,0,0,0,0,0,0,0.47297076509898783,0.5270292349010122
90339,0.5833333333333333,0.45454545454545453,-140,120,0.5612373737373737,0.4387626262626263,home,NYM,under,7.5,0.5495495495495495,-122,0.5270292349010122,NYM,CLE,2023 REG,7,2,3,1,3,10,1,0,1,-1,1,0,0,0,0,0,0,0,0,0.47297076509898783,0.5270292349010122
90340,0.7560975609756098,0.2801120448179272,-310,257,0.7287195663512281,0.27128043364877186,away,COL,over,8.5,0.5412844036697247,-118,0.5175913212324037,PHI,COL,2023 REG,9,4,4,3,7,13,1,0,1,-1,1,1,1,0,0,0,0,0,0,0.5175913212324037,0.4824086787675963
90340,0.7560975609756098,0.2801120448179272,-310,257,0.7287195663512281,0.27128043364877186,home,PHI,under,8.5,0.5024875621890548,-101,0.4824086787675963,PHI,COL,2023 REG,9,4,4,3,7,13,1,0,1,-1,1,1,1,0,0,0,0,0,0,0.5175913212324037,0.4824086787675963
90341,0.5098039215686274,0.5348837209302326,-104,-115,0.4870219861770517,0.5129780138229483,away,STL,over,7.5,0.5192307692307692,-108,0.49571111079951763,CHC,STL,2023 REG,14,10,10,4,14,24,1,0,6,-6,1,1,1,1,0,0,0,0,0,0.49571111079951763,0.5042888892004824
90341,0.5098039215686274,0.5348837209302326,-104,-115,0.4870219861770517,0.5129780138229483,home,CHC,under,7.5,0.5260663507109005,-111,0.5042888892004824,CHC,STL,2023 REG,14,10,10,4,14,24,1,0,6,-6,1,1,1,1,0,0,0,0,0,0.49571111079951763,0.5042888892004824
90342,0.7142857142857143,0.3333333333333333,-250,200,0.6802721088435374,0.3197278911564626,away,DET,over,8,0.5283018867924528,-112,0.5031902949311281,NYY,DET,2023 REG,6,5,9,1,6,15,1,0,4,-4,1,0,0,0,0,0,0,0,0,0.5031902949311281,0.4968097050688719
90342,0.7142857142857143,0.3333333333333333,-250,200,0.6802721088435374,0.3197278911564626,home,NYY,under,8,0.5192307692307692,-108,0.4968097050688719,NYY,DET,2023 REG,6,5,9,1,6,15,1,0,4,-4,1,0,0,0,0,0,0,0,0,0.5031902949311281,0.4968097050688719
90343,0.5967741935483871,0.4464285714285714,-148,124,0.5709918983202021,0.42900810167979786,away,WSH,over,8.5,0.5348837209302326,-115,0.5097020142727117,NYY,WSH,2023 REG,8,9,3,1,10,11,1,0,8,-8,1,0,0,0,0,0,0,0,0,0.5097020142727117,0.49029798572728833
90343,0.5967741935483871,0.4464285714285714,-148,124,0.5709918983202021,0.42900810167979786,home,NYY,under,8.5,0.5121951219512195,-105,0.49029798572728833,NYY,WSH,2023 REG,8,9,3,1,10,11,1,0,8,-8,1,0,0,0,0,0,0,0,0,0.5097020142727117,0.49029798572728833
90344,0.5918367346938775,0.4464285714285714,-145,124,0.5691899208663057,0.4308100791336943,away,HOU,over,9,0.5454545454545454,-120,0.5206611570247933,TEX,HOU,2023 REG,12,11,13,12,23,25,0,1,-1,1,1,1,1,1,1,1,1,1,1,0.5206611570247933,0.4793388429752067
90344,0.5918367346938775,0.4464285714285714,-145,124,0.5691899208663057,0.4308100791336943,home,TEX,under,9,0.5,100,0.4793388429752067,TEX,HOU,2023 REG,12,11,13,12,23,25,0,1,-1,1,1,1,1,1,1,1,1,1,1,0.5206611570247933,0.4793388429752067
90345,0.33783783783783783,0.7058823529411764,196,-240,0.32306750311519783,0.6769324968848022,away,HOU,over,8.5,0.5169082125603864,-107,0.49353874091423283,OAK,HOU,2023 REG,7,2,5,3,5,12,0,1,-1,1,1,1,0,0,0,0,0,0,0,0.49353874091423283,0.5064612590857671
90345,0.33783783783783783,0.7058823529411764,196,-240,0.32306750311519783,0.6769324968848022,home,OAK,under,8.5,0.5283018867924528,-112,0.5064612590857671,OAK,HOU,2023 REG,7,2,5,3,5,12,0,1,-1,1,1,1,0,0,0,0,0,0,0,0.49353874091423283,0.5064612590857671
90346,0.4694835680751174,0.5689655172413793,113,-132,0.4514323543115039,0.548567645688496,away,CLE,over,8.5,0.5238095238095238,-110,0.4988662131519274,DET,CLE,2023 REG,5,1,4,0,1,9,1,0,1,-1,0,0,0,0,0,0,0,0,0,0.4988662131519274,0.5011337868480725
90346,0.4694835680751174,0.5689655172413793,113,-132,0.4514323543115039,0.548567645688496,home,DET,under,8.5,0.5238095238095238,-110,0.5011337868480725,DET,CLE,2023 REG,5,1,4,0,1,9,1,0,1,-1,0,0,0,0,0,0,0,0,0,0.4988662131519274,0.5011337868480725
90347,0.6428571428571428,0.3921568627450981,-180,155,0.6203481392557023,0.3796518607442977,away,CHC,over,9,0.49751243781094534,101,0.476135829221149,SD,CHC,2023 REG,4,1,4,2,3,8,0,1,-1,1,1,0,0,0,0,0,0,0,0,0.476135829221149,0.523864170778851
90347,0.6428571428571428,0.3921568627450981,-180,155,0.6203481392557023,0.3796518607442977,home,SD,under,9,0.5454545454545454,-120,0.523864170778851,SD,CHC,2023 REG,4,1,4,2,3,8,0,1,-1,1,1,0,0,0,0,0,0,0,0,0.476135829221149,0.523864170778851
90348,0.5238095238095238,0.5238095238095238,-110,-110,0.4988662131519274,0.5011337868480725,away,SF,over,8.5,0.5215311004784688,-109,0.4978845547971712,TOR,SF,2023 REG,12,6,6,1,7,18,1,0,5,-5,1,0,0,0,0,0,0,0,0,0.4978845547971712,0.5021154452028288
90348,0.5238095238095238,0.5238095238095238,-110,-110,0.4988662131519274,0.5011337868480725,home,TOR,under,8.5,0.5238095238095238,-110,0.5021154452028288,TOR,SF,2023 REG,12,6,6,1,7,18,1,0,5,-5,1,0,0,0,0,0,0,0,0,0.4978845547971712,0.5021154452028288
90349,0.6688741721854304,0.37037037037037035,-202,170,0.6426245112706233,0.35737548872937674,away,SF,over,8.5,0.5348837209302326,-115,0.5109810284308424,HOU,SF,2023 REG,10,7,5,3,10,15,1,0,4,-4,1,1,1,0,0,0,0,0,0,0.5109810284308424,0.48901897156915763
90349,0.6688741721854304,0.37037037037037035,-202,170,0.6426245112706233,0.35737548872937674,home,HOU,under,8.5,0.5098039215686274,-104,0.48901897156915763,HOU,SF,2023 REG,10,7,5,3,10,15,1,0,4,-4,1,1,1,0,0,0,0,0,0,0.5109810284308424,0.48901897156915763
90350,0.45248868778280543,0.5918367346938775,121,-145,0.4324319355309127,0.5675680644690873,away,MIN,over,9,0.5215311004784688,-109,0.4978845547971712,KC,MIN,2023 REG,6,4,13,7,11,19,0,1,-3,3,1,1,1,1,0,0,0,0,0,0.4978845547971712,0.5021154452028288
90350,0.45248868778280543,0.5918367346938775,121,-145,0.4324319355309127,0.5675680644690873,home,KC,under,9,0.5238095238095238,-110,0.5021154452028288,KC,MIN,2023 REG,6,4,13,7,11,19,0,1,-3,3,1,1,1,1,0,0,0,0,0,0.4978845547971712,0.5021154452028288
90351,0.607843137254902,0.43103448275862066,-155,132,0.5842116427368785,0.41578835726312147,away,BOS,over,9,0.5454545454545454,-120,0.5206611570247933,TEX,BOS,2023 REG,7,6,5,4,10,12,1,0,2,-2,1,1,1,1,0,0,0,0,0,0.5206611570247933,0.4793388429752067
90351,0.607843137254902,0.43103448275862066,-155,132,0.5842116427368785,0.41578835726312147,home,TEX,under,9,0.5,100,0.4793388429752067,TEX,BOS,2023 REG,7,6,5,4,10,12,1,0,2,-2,1,1,1,1,0,0,0,0,0,0.5206611570247933,0.4793388429752067
90352,0.4807692307692307,0.5555555555555556,108,-125,0.4633053911900066,0.5366946088099934,away,LAA,over,8,0.5412844036697247,-118,0.5189377998484975,CLE,LAA,2023 REG,12,8,10,6,14,22,1,0,2,-2,1,1,1,1,1,1,0,0,0,0.5189377998484975,0.4810622001515025
90352,0.4807692307692307,0.5555555555555556,108,-125,0.4633053911900066,0.5366946088099934,home,CLE,under,8,0.5,100,0.4810622001515025,CLE,LAA,2023 REG,12,8,10,6,14,22,1,0,2,-2,1,1,1,1,1,1,0,0,0,0.5189377998484975,0.4810622001515025
90353,0.5934959349593496,0.4444444444444444,-146,125,0.5709784740123824,0.42902152598761756,away,MIL,over,9,0.5454545454545454,-120,0.5206611570247933,NYM,MIL,2023 REG,9,7,7,2,9,16,1,0,5,-5,1,1,0,0,0,0,0,0,0,0.5206611570247933,0.4793388429752067
90353,0.5934959349593496,0.4444444444444444,-146,125,0.5709784740123824,0.42902152598761756,home,NYM,under,9,0.5,100,0.4793388429752067,NYM,MIL,2023 REG,9,7,7,2,9,16,1,0,5,-5,1,1,0,0,0,0,0,0,0,0.5206611570247933,0.4793388429752067
90354,0.38167938931297707,0.6575342465753424,162,-192,0.36671235271438185,0.6332876472856181,away,BOS,over,10,0.5348837209302326,-115,0.5097020142727117,KC,BOS,2023 REG,8,3,8,7,10,16,0,1,-4,4,1,1,1,0,0,0,0,0,0,0.5097020142727117,0.49029798572728833
90354,0.38167938931297707,0.6575342465753424,162,-192,0.36671235271438185,0.6332876472856181,home,KC,under,10,0.5121951219512195,-105,0.49029798572728833,KC,BOS,2023 REG,8,3,8,7,10,16,0,1,-4,4,1,1,1,0,0,0,0,0,0,0.5097020142727117,0.49029798572728833
90355,0.4716981132075471,0.5689655172413793,112,-132,0.45251715544861953,0.5474828445513804,away,ARI,over,12,0.5238095238095238,-110,0.4988662131519274,COL,ARI,2023 REG,13,7,12,9,16,25,0,1,-2,2,1,1,1,1,1,1,1,0,0,0.4988662131519274,0.5011337868480725
90355,0.4716981132075471,0.5689655172413793,112,-132,0.45251715544861953,0.5474828445513804,home,COL,under,12,0.5238095238095238,-110,0.5011337868480725,COL,ARI,2023 REG,13,7,12,9,16,25,0,1,-2,2,1,1,1,1,1,1,1,0,0,0.4988662131519274,0.5011337868480725
90356,0.6226415094339623,0.4166666666666667,-165,140,0.5981666073335706,0.40183339266642937,away,CWS,over,9,0.5454545454545454,-120,0.5206611570247933,NYM,CWS,2023 REG,4,2,9,6,8,13,0,1,-4,4,1,1,0,0,0,0,0,0,0,0.5206611570247933,0.4793388429752067
90356,0.6226415094339623,0.4166666666666667,-165,140,0.5981666073335706,0.40183339266642937,home,NYM,under,9,0.5,100,0.4793388429752067,NYM,CWS,2023 REG,4,2,9,6,8,13,0,1,-4,4,1,1,0,0,0,0,0,0,0,0.5206611570247933,0.4793388429752067
90357,0.5454545454545454,0.49751243781094534,-120,101,0.5220180091279142,0.4779819908720858,away,WSH,over,11.5,0.5238095238095238,-110,0.4988662131519274,COL,WSH,2023 REG,10,5,18,10,15,28,0,1,-5,5,1,1,1,1,1,0,0,0,0,0.4988662131519274,0.5011337868480725
90357,0.5454545454545454,0.49751243781094534,-120,101,0.5220180091279142,0.4779819908720858,home,COL,under,11.5,0.5238095238095238,-110,0.5011337868480725,COL,WSH,2023 REG,10,5,18,10,15,28,0,1,-5,5,1,1,1,1,1,0,0,0,0,0.4988662131519274,0.5011337868480725
90358,0.5238095238095238,0.5121951219512195,-110,-105,0.5049499474586583,0.4950500525413417,away,TEX,over,9.5,0.5121951219512195,-105,0.48808156828023186,CWS,TEX,2023 REG,4,3,7,6,9,11,0,1,-3,3,1,1,1,0,0,0,0,0,0,0.48808156828023186,0.5119184317197681
90358,0.5238095238095238,0.5121951219512195,-110,-105,0.5049499474586583,0.4950500525413417,home,CWS,under,9.5,0.5348837209302326,-115,0.5119184317197681,CWS,TEX,2023 REG,4,3,7,6,9,11,0,1,-3,3,1,1,1,0,0,0,0,0,0,0.48808156828023186,0.5119184317197681
90359,0.4587155963302753,0.5833333333333333,118,-140,0.4394270964845833,0.5605729035154168,away,PHI,over,9.5,0.5121951219512195,-105,0.48808156828023186,STL,PHI,2023 REG,9,6,11,5,11,20,1,0,1,-1,1,1,1,1,1,0,0,0,0,0.48808156828023186,0.5119184317197681
90359,0.4587155963302753,0.5833333333333333,118,-140,0.4394270964845833,0.5605729035154168,home,STL,under,9.5,0.5348837209302326,-115,0.5119184317197681,STL,PHI,2023 REG,9,6,11,5,11,20,1,0,1,-1,1,1,1,1,1,0,0,0,0,0.48808156828023186,0.5119184317197681
90360,0.5918367346938775,0.4504504504504505,-145,122,0.566809625118663,0.43319037488133705,away,NYM,over,9,0.5433789954337899,-119,0.5184560714286826,MIN,NYM,2023 REG,13,8,7,4,12,20,1,0,4,-4,1,1,1,1,0,0,0,0,0,0.5184560714286826,0.48154392857131745
90360,0.5918367346938775,0.4504504504504505,-145,122,0.566809625118663,0.43319037488133705,home,MIN,under,9,0.5024875621890548,-101,0.48154392857131745,MIN,NYM,2023 REG,13,8,7,4,12,20,1,0,4,-4,1,1,1,1,0,0,0,0,0,0.5184560714286826,0.48154392857131745
90361,0.6240601503759399,0.4166666666666667,-166,140,0.5986441668079975,0.4013558331920025,away,MIA,over,7.5,0.5238095238095238,-110,0.4988662131519274,SF,MIA,2023 REG,3,0,5,1,1,8,0,1,-1,1,0,0,0,0,0,0,0,0,0,0.4988662131519274,0.5011337868480725
90361,0.6240601503759399,0.4166666666666667,-166,140,0.5986441668079975,0.4013558331920025,home,SF,under,7.5,0.5238095238095238,-110,0.5011337868480725,SF,MIA,2023 REG,3,0,5,1,1,8,0,1,-1,1,0,0,0,0,0,0,0,0,0,0.4988662131519274,0.5011337868480725
90362,0.5073891625615764,0.5348837209302326,-103,-115,0.4859403596076043,0.5140596403923957,away,NYM,over,8.5,0.5145631067961165,-106,0.49023796582517226,MIN,NYM,2023 REG,8,5,4,2,7,12,1,0,3,-3,1,1,0,0,0,0,0,0,0,0.49023796582517226,0.5097620341748277
90362,0.5073891625615764,0.5348837209302326,-103,-115,0.4859403596076043,0.5140596403923957,home,MIN,under,8.5,0.5327102803738317,-114,0.5097620341748277,MIN,NYM,2023 REG,8,5,4,2,7,12,1,0,3,-3,1,1,0,0,0,0,0,0,0,0.49023796582517226,0.5097620341748277
90363,0.3125,0.7297297297297298,220,-270,0.29930320945945943,0.7006967905405406,away,TEX,over,8.5,0.5454545454545454,-120,0.5206611570247933,OAK,TEX,2023 REG,3,0,7,4,4,10,0,1,-4,4,0,0,0,0,0,0,0,0,0,0.5206611570247933,0.4793388429752067
90363,0.3125,0.7297297297297298,220,-270,0.29930320945945943,0.7006967905405406,home,OAK,under,8.5,0.5,100,0.4793388429752067,OAK,TEX,2023 REG,3,0,7,4,4,10,0,1,-4,4,0,0,0,0,0,0,0,0,0,0.5206611570247933,0.4793388429752067
90364,0.5594713656387665,0.47619047619047616,-127,110,0.5395195862893665,0.46048041371063353,away,TB,over,8.5,0.5305164319248826,-113,0.5066009958897986,NYM,TB,2023 REG,8,8,10,7,15,18,1,0,1,-1,1,1,1,1,1,1,1,0,0,0.5066009958897986,0.49339900411020143
90364,0.5594713656387665,0.47619047619047616,-127,110,0.5395195862893665,0.46048041371063353,home,NYM,under,8.5,0.5145631067961165,-106,0.49339900411020143,NYM,TB,2023 REG,8,8,10,7,15,18,1,0,1,-1,1,1,1,1,1,1,1,0,0,0.5066009958897986,0.49339900411020143
90365,0.607843137254902,0.425531914893617,-155,135,0.5875563408509002,0.41244365914909975,away,WSH,over,8,0.5073891625615764,-103,0.4837652908580103,MIA,WSH,2023 REG,9,5,8,3,8,17,1,0,2,-2,1,1,1,0,0,0,0,0,0,0.4837652908580103,0.5162347091419897
90365,0.607843137254902,0.425531914893617,-155,135,0.5875563408509002,0.41244365914909975,home,MIA,under,8,0.5391705069124424,-117,0.5162347091419897,MIA,WSH,2023 REG,9,5,8,3,8,17,1,0,2,-2,1,1,1,0,0,0,0,0,0,0.4837652908580103,0.5162347091419897
90366,0.6610169491525424,0.37878787878787884,-195,164,0.6347052832258232,0.3652947167741768,away,WSH,over,9,0.5098039215686274,-104,0.48483656587239576,STL,WSH,2023 REG,17,9,11,6,15,28,1,0,3,-3,1,1,1,1,1,1,0,0,0,0.48483656587239576,0.5151634341276042
90366,0.6610169491525424,0.37878787878787884,-195,164,0.6347052832258232,0.3652947167741768,home,STL,under,9,0.5391705069124424,-117,0.5151634341276042,STL,WSH,2023 REG,17,9,11,6,15,28,1,0,3,-3,1,1,1,1,1,1,0,0,0,0.48483656587239576,0.5151634341276042
90367,0.3508771929824561,0.6923076923076923,185,-225,0.3357246016525795,0.6642753983474206,away,ARI,over,11.5,0.5121951219512195,-105,0.48919479393107135,COL,ARI,2023 REG,11,6,5,4,10,16,1,0,2,-2,1,1,1,1,0,0,0,0,0,0.48919479393107135,0.5108052060689287
90367,0.3508771929824561,0.6923076923076923,185,-225,0.3357246016525795,0.6642753983474206,home,COL,under,11.5,0.5327102803738317,-114,0.5108052060689287,COL,ARI,2023 REG,11,6,5,4,10,16,1,0,2,-2,1,1,1,1,0,0,0,0,0,0.48919479393107135,0.5108052060689287
90368,0.7222222222222222,0.31746031746031744,-260,215,0.693562610229277,0.306437389770723,away,CWS,over,9,0.5121951219512195,-105,0.48808156828023186,BAL,CWS,2023 REG,11,9,2,0,9,13,1,0,9,-9,0,0,0,0,0,0,0,0,0,0.48808156828023186,0.5119184317197681
90368,0.7222222222222222,0.31746031746031744,-260,215,0.693562610229277,0.306437389770723,home,BAL,under,9,0.5348837209302326,-115,0.5119184317197681,BAL,CWS,2023 REG,11,9,2,0,9,13,1,0,9,-9,0,0,0,0,0,0,0,0,0,0.48808156828023186,0.5119184317197681
90369,0.5815899581589958,0.45454545454545453,-139,120,0.5605739649961564,0.4394260350038436,away,NYM,over,7.5,0.5169082125603864,-107,0.49353874091423283,HOU,NYM,2023 REG,9,4,4,2,6,13,1,0,2,-2,1,1,0,0,0,0,0,0,0,0.49353874091423283,0.5064612590857671
90369,0.5815899581589958,0.45454545454545453,-139,120,0.5605739649961564,0.4394260350038436,home,HOU,under,7.5,0.5283018867924528,-112,0.5064612590857671,HOU,NYM,2023 REG,9,4,4,2,6,13,1,0,2,-2,1,1,0,0,0,0,0,0,0,0.49353874091423283,0.5064612590857671
90370,0.5,0.5454545454545454,100,-120,0.4772727272727273,0.5227272727272727,away,DET,over,11,0.5238095238095238,-110,0.4988662131519274,COL,DET,2023 REG,11,8,9,5,13,20,1,0,3,-3,1,1,1,1,1,0,0,0,0,0.4988662131519274,0.5011337868480725
90370,0.5,0.5454545454545454,100,-120,0.4772727272727273,0.5227272727272727,home,COL,under,11,0.5238095238095238,-110,0.5011337868480725,COL,DET,2023 REG,11,8,9,5,13,20,1,0,3,-3,1,1,1,1,1,0,0,0,0,0.4988662131519274,0.5011337868480725
90371,0.5238095238095238,0.5145631067961165,-110,-106,0.5037095744446646,0.4962904255553354,away,MIN,over,8.5,0.5121951219512195,-105,0.48808156828023186,HOU,MIN,2023 REG,5,5,7,1,6,12,1,0,4,-4,1,0,0,0,0,0,0,0,0,0.48808156828023186,0.5119184317197681
90371,0.5238095238095238,0.5145631067961165,-110,-106,0.5037095744446646,0.4962904255553354,home,HOU,under,8.5,0.5348837209302326,-115,0.5119184317197681,HOU,MIN,2023 REG,5,5,7,1,6,12,1,0,4,-4,1,0,0,0,0,0,0,0,0,0.48808156828023186,0.5119184317197681
90372,0.6000000000000001,0.4347826086956522,-150,130,0.5791304347826086,0.4208695652173914,away,BOS,over,8,0.5121951219512195,-105,0.48808156828023186,NYY,BOS,2023 REG,9,2,10,3,5,19,0,1,-1,1,1,1,0,0,0,0,0,0,0,0.48808156828023186,0.5119184317197681
90372,0.6000000000000001,0.4347826086956522,-150,130,0.5791304347826086,0.4208695652173914,home,NYY,under,8,0.5348837209302326,-115,0.5119184317197681,NYY,BOS,2023 REG,9,2,10,3,5,19,0,1,-1,1,1,1,0,0,0,0,0,0,0,0.48808156828023186,0.5119184317197681
90373,0.574468085106383,0.4629629629629629,-135,116,0.5529651425984609,0.44703485740153914,away,TEX,over,9.5,0.5073891625615764,-103,0.4837652908580103,LAA,TEX,2023 REG,9,5,8,4,9,17,1,0,1,-1,1,1,1,1,0,0,0,0,0,0.4837652908580103,0.5162347091419897
90373,0.574468085106383,0.4629629629629629,-135,116,0.5529651425984609,0.44703485740153914,home,LAA,under,9.5,0.5391705069124424,-117,0.5162347091419897,LAA,TEX,2023 REG,9,5,8,4,9,17,1,0,1,-1,1,1,1,1,0,0,0,0,0,0.4837652908580103,0.5162347091419897
90374,0.4672897196261683,0.5689655172413793,114,-132,0.4503480201553517,0.5496519798446483,away,LAA,over,9,0.5475113122171946,-121,0.5214983313199976,DET,LAA,2023 REG,7,4,13,11,15,20,0,1,-7,7,1,1,1,1,0,0,0,0,0,0.5214983313199976,0.47850166868000243
90374,0.4672897196261683,0.5689655172413793,114,-132,0.4503480201553517,0.5496519798446483,home,DET,under,9,0.5,100,0.47850166868000243,DET,LAA,2023 REG,7,4,13,11,15,20,0,1,-7,7,1,1,1,1,0,0,0,0,0,0.5214983313199976,0.47850166868000243
90375,0.5121951219512195,0.5283018867924528,-105,-112,0.49145275161909474,0.5085472483809053,away,MIA,over,8,0.5,100,0.47935779816513757,MIL,MIA,2023 REG,7,4,6,2,6,13,1,0,2,-2,1,1,0,0,0,0,0,0,0,0.47935779816513757,0.5206422018348624
90375,0.5121951219512195,0.5283018867924528,-105,-112,0.49145275161909474,0.5085472483809053,home,MIL,under,8,0.5412844036697247,-118,0.5206422018348624,MIL,MIA,2023 REG,7,4,6,2,6,13,1,0,2,-2,1,1,0,0,0,0,0,0,0,0.47935779816513757,0.5206422018348624
90376,0.47619047619047616,0.5633187772925764,110,-129,0.45737654596045113,0.5426234540395489,away,NYY,over,9,0.5454545454545454,-120,0.5206611570247933,CWS,NYY,2023 REG,11,9,6,2,11,17,1,0,7,-7,1,1,0,0,0,0,0,0,0,0.5206611570247933,0.4793388429752067
90376,0.47619047619047616,0.5633187772925764,110,-129,0.45737654596045113,0.5426234540395489,home,CWS,under,9,0.5,100,0.4793388429752067,CWS,NYY,2023 REG,11,9,6,2,11,17,1,0,7,-7,1,1,0,0,0,0,0,0,0,0.5206611570247933,0.4793388429752067
90377,0.6621621621621622,0.37878787878787884,-196,164,0.6350465945060539,0.36495340549394606,away,CWS,over,9.5,0.5215311004784688,-109,0.4978845547971712,TEX,CWS,2023 REG,4,2,3,0,2,7,1,0,2,-2,0,0,0,0,0,0,0,0,0,0.4978845547971712,0.5021154452028288
90377,0.6621621621621622,0.37878787878787884,-196,164,0.6350465945060539,0.36495340549394606,home,TEX,under,9.5,0.5238095238095238,-110,0.5021154452028288,TEX,CWS,2023 REG,4,2,3,0,2,7,1,0,2,-2,0,0,0,0,0,0,0,0,0,0.4978845547971712,0.5021154452028288
90378,0.5833333333333333,0.45454545454545453,-140,120,0.5612373737373737,0.4387626262626263,away,SD,over,8,0.5454545454545454,-120,0.5193043049216726,MIA,SD,2023 REG,10,4,11,9,13,21,0,1,-5,5,1,1,1,1,0,0,0,0,0,0.5193043049216726,0.48069569507832743
90378,0.5833333333333333,0.45454545454545453,-140,120,0.5612373737373737,0.4387626262626263,home,MIA,under,8,0.5024875621890548,-101,0.48069569507832743,MIA,SD,2023 REG,10,4,11,9,13,21,0,1,-5,5,1,1,1,1,0,0,0,0,0,0.5193043049216726,0.48069569507832743
90379,0.5215311004784688,0.5215311004784688,-109,-109,0.49907282342437215,0.5009271765756278,away,SEA,over,8.5,0.5098039215686274,-104,0.4881300146960012,PHI,SEA,2023 REG,4,1,3,0,1,7,1,0,1,-1,0,0,0,0,0,0,0,0,0,0.4881300146960012,0.5118699853039987
90379,0.5215311004784688,0.5215311004784688,-109,-109,0.49907282342437215,0.5009271765756278,home,PHI,under,8.5,0.5327102803738317,-114,0.5118699853039987,PHI,SEA,2023 REG,4,1,3,0,1,7,1,0,1,-1,0,0,0,0,0,0,0,0,0,0.4881300146960012,0.5118699853039987
90380,0.5391705069124424,0.5,-117,100,0.5180509248444435,0.4819490751555565,away,MIN,over,8,0.5238095238095238,-110,0.4988662131519274,TB,MIN,2023 REG,4,4,6,2,6,10,1,0,2,-2,1,1,0,0,0,0,0,0,0,0.4988662131519274,0.5011337868480725
90380,0.5391705069124424,0.5,-117,100,0.5180509248444435,0.4819490751555565,home,TB,under,8,0.5238095238095238,-110,0.5011337868480725,TB,MIN,2023 REG,4,4,6,2,6,10,1,0,2,-2,1,1,0,0,0,0,0,0,0,0.4988662131519274,0.5011337868480725
90381,0.7058823529411764,0.3333333333333333,-240,200,0.6782006920415226,0.32179930795847744,away,WSH,over,9.5,0.504950495049505,-102,0.47949844489399435,LAD,WSH,2023 REG,11,6,12,10,16,23,0,1,-4,4,1,1,1,1,1,1,0,0,0,0.47949844489399435,0.5205015551060057
90381,0.7058823529411764,0.3333333333333333,-240,200,0.6782006920415226,0.32179930795847744,home,LAD,under,9.5,0.5454545454545454,-120,0.5205015551060057,LAD,WSH,2023 REG,11,6,12,10,16,23,0,1,-4,4,1,1,1,1,1,1,0,0,0,0.47949844489399435,0.5205015551060057
90382,0.49019607843137253,0.5515695067264574,104,-123,0.4697227523736127,0.5302772476263873,away,PHI,over,8.5,0.5348837209302326,-115,0.5097020142727117,MIA,PHI,2023 REG,7,2,6,4,6,13,0,1,-2,2,1,1,0,0,0,0,0,0,0,0.5097020142727117,0.49029798572728833
90382,0.49019607843137253,0.5515695067264574,104,-123,0.4697227523736127,0.5302772476263873,home,MIA,under,8.5,0.5121951219512195,-105,0.49029798572728833,MIA,PHI,2023 REG,7,2,6,4,6,13,0,1,-2,2,1,1,0,0,0,0,0,0,0,0.5097020142727117,0.49029798572728833
90383,0.43103448275862066,0.607843137254902,132,-155,0.4142768879252058,0.5857231120747942,away,TB,over,9.5,0.5121951219512195,-105,0.48919479393107135,CIN,TB,2023 REG,7,8,8,1,9,15,1,0,7,-7,1,0,0,0,0,0,0,0,0,0.48919479393107135,0.5108052060689287
90383,0.43103448275862066,0.607843137254902,132,-155,0.4142768879252058,0.5857231120747942,home,CIN,under,9.5,0.5327102803738317,-114,0.5108052060689287,CIN,TB,2023 REG,7,8,8,1,9,15,1,0,7,-7,1,0,0,0,0,0,0,0,0,0.48919479393107135,0.5108052060689287
90384,0.6598639455782314,0.3846153846153846,-194,160,0.630513639259995,0.36948636074000496,away,COL,over,7.5,0.5412844036697247,-118,0.5189377998484975,SD,COL,2023 REG,5,1,9,4,5,14,0,1,-3,3,1,0,0,0,0,0,0,0,0,0.5189377998484975,0.4810622001515025
90384,0.6598639455782314,0.3846153846153846,-194,160,0.630513639259995,0.36948636074000496,home,SD,under,7.5,0.5,100,0.4810622001515025,SD,COL,2023 REG,5,1,9,4,5,14,0,1,-3,3,1,0,0,0,0,0,0,0,0,0.5189377998484975,0.4810622001515025
90385,0.5238095238095238,0.5192307692307692,-110,-108,0.5012646084074657,0.4987353915925343,away,NYY,over,7.5,0.5238095238095238,-110,0.4988662131519274,STL,NYY,2023 REG,11,5,3,1,6,14,1,0,4,-4,1,0,0,0,0,0,0,0,0,0.4988662131519274,0.5011337868480725
90385,0.5238095238095238,0.5192307692307692,-110,-108,0.5012646084074657,0.4987353915925343,home,STL,under,7.5,0.5238095238095238,-110,0.5011337868480725,STL,NYY,2023 REG,11,5,3,1,6,14,1,0,4,-4,1,0,0,0,0,0,0,0,0,0.4988662131519274,0.5011337868480725
90386,0.6296296296296295,0.4081632653061224,-170,145,0.6058341031886005,0.39416589681139946,away,CHC,over,9,0.5215311004784688,-109,0.4978845547971712,SD,CHC,2023 REG,8,5,4,0,5,12,1,0,5,-5,0,0,0,0,0,0,0,0,0,0.4978845547971712,0.5021154452028288
90386,0.6296296296296295,0.4081632653061224,-170,145,0.6058341031886005,0.39416589681139946,home,SD,under,9,0.5238095238095238,-110,0.5021154452028288,SD,CHC,2023 REG,8,5,4,0,5,12,1,0,5,-5,0,0,0,0,0,0,0,0,0,0.4978845547971712,0.5021154452028288
90387,0.42016806722689076,0.6183206106870228,138,-162,0.4039963538176834,0.5960036461823166,away,MIN,over,8,0.5283018867924528,-112,0.5044173060022736,KC,MIN,2023 REG,4,0,5,2,2,9,0,1,-2,2,0,0,0,0,0,0,0,0,0,0.5044173060022736,0.49558269399772636
90387,0.42016806722689076,0.6183206106870228,138,-162,0.4039963538176834,0.5960036461823166,home,KC,under,8,0.5169082125603864,-107,0.49558269399772636,KC,MIN,2023 REG,4,0,5,2,2,9,0,1,-2,2,0,0,0,0,0,0,0,0,0,0.5044173060022736,0.49558269399772636
90388,0.6825396825396826,0.35714285714285715,-215,180,0.6554547745023935,0.34454522549760647,away,KC,over,9,0.5454545454545454,-120,0.5206611570247933,CHC,KC,2023 REG,5,4,7,3,7,12,1,0,1,-1,1,1,1,0,0,0,0,0,0,0.5206611570247933,0.4793388429752067
90388,0.6825396825396826,0.35714285714285715,-215,180,0.6554547745023935,0.34454522549760647,home,CHC,under,9,0.5,100,0.4793388429752067,CHC,KC,2023 REG,5,4,7,3,7,12,1,0,1,-1,1,1,1,0,0,0,0,0,0,0.5206611570247933,0.4793388429752067
90389,0.7512437810945274,0.2881844380403458,-302,247,0.7216235766698217,0.2783764233301783,away,OAK,over,7.5,0.5348837209302326,-115,0.5109810284308424,TB,OAK,2023 REG,8,11,3,0,11,11,1,0,11,-11,0,0,0,0,0,0,0,0,0,0.5109810284308424,0.48901897156915763
90389,0.7512437810945274,0.2881844380403458,-302,247,0.7216235766698217,0.2783764233301783,home,TB,under,7.5,0.5098039215686274,-104,0.48901897156915763,TB,OAK,2023 REG,8,11,3,0,11,11,1,0,11,-11,0,0,0,0,0,0,0,0,0,0.5109810284308424,0.48901897156915763
90390,0.4566210045662101,0.5798319327731092,119,-138,0.43997582769894106,0.5600241723010589,away,CLE,over,8,0.5412844036697247,-118,0.5189377998484975,DET,CLE,2023 REG,8,2,5,3,5,13,0,1,-1,1,1,1,0,0,0,0,0,0,0,0.5189377998484975,0.4810622001515025
90390,0.4566210045662101,0.5798319327731092,119,-138,0.43997582769894106,0.5600241723010589,home,DET,under,8,0.5,100,0.4810622001515025,DET,CLE,2023 REG,8,2,5,3,5,13,0,1,-1,1,1,1,0,0,0,0,0,0,0,0.5189377998484975,0.4810622001515025
90391,0.5121951219512195,0.5348837209302326,-105,-115,0.48808156828023186,0.5119184317197681,away,SD,over,9,0.5121951219512195,-105,0.48808156828023186,MIL,SD,2023 REG,10,10,9,6,16,19,1,0,4,-4,1,1,1,1,1,1,0,0,0,0.48808156828023186,0.5119184317197681
90391,0.5121951219512195,0.5348837209302326,-105,-115,0.48808156828023186,0.5119184317197681,home,MIL,under,9,0.5348837209302326,-115,0.5119184317197681,MIL,SD,2023 REG,10,10,9,6,16,19,1,0,4,-4,1,1,1,1,1,1,0,0,0,0.48808156828023186,0.5119184317197681
90392,0.5454545454545454,0.49504950495049505,-120,102,0.5233614270517961,0.4766385729482039,away,CHC,over,8.5,0.5169082125603864,-107,0.49353874091423283,PHI,CHC,2023 REG,7,2,3,1,3,10,1,0,1,-1,1,0,0,0,0,0,0,0,0,0.49353874091423283,0.5064612590857671
90392,0.5454545454545454,0.49504950495049505,-120,102,0.5233614270517961,0.4766385729482039,home,PHI,under,8.5,0.5283018867924528,-112,0.5064612590857671,PHI,CHC,2023 REG,7,2,3,1,3,10,1,0,1,-1,1,0,0,0,0,0,0,0,0,0.49353874091423283,0.5064612590857671
90393,0.5652173913043479,0.47619047619047616,-130,110,0.5418129444594474,0.4581870555405526,away,ATL,over,8.5,0.5348837209302326,-115,0.5109810284308424,ARI,ATL,2023 REG,8,5,14,8,13,22,0,1,-3,3,1,1,1,1,1,0,0,0,0,0.5109810284308424,0.48901897156915763
90393,0.5652173913043479,0.47619047619047616,-130,110,0.5418129444594474,0.4581870555405526,home,ARI,under,8.5,0.5098039215686274,-104,0.48901897156915763,ARI,ATL,2023 REG,8,5,14,8,13,22,0,1,-3,3,1,1,1,1,1,0,0,0,0,0.5109810284308424,0.48901897156915763
90394,0.5689655172413793,0.4716981132075471,-132,112,0.5458293137100936,0.4541706862899064,away,SEA,over,9.5,0.49751243781094534,101,0.476135829221149,ATL,SEA,2023 REG,8,3,9,7,10,17,0,1,-4,4,1,1,1,0,0,0,0,0,0,0.476135829221149,0.523864170778851
90394,0.5689655172413793,0.4716981132075471,-132,112,0.5458293137100936,0.4541706862899064,home,ATL,under,9.5,0.5454545454545454,-120,0.523864170778851,ATL,SEA,2023 REG,8,3,9,7,10,17,0,1,-4,4,1,1,1,0,0,0,0,0,0,0.476135829221149,0.523864170778851
90395,0.726027397260274,0.31746031746031744,-265,215,0.6944541249288857,0.3055458750711143,away,KC,over,8,0.5348837209302326,-115,0.5097020142727117,NYY,KC,2023 REG,8,5,7,2,7,15,1,0,3,-3,1,1,0,0,0,0,0,0,0,0.5097020142727117,0.49029798572728833
90395,0.726027397260274,0.31746031746031744,-265,215,0.6944541249288857,0.3055458750711143,home,NYY,under,8,0.5121951219512195,-105,0.49029798572728833,NYY,KC,2023 REG,8,5,7,2,7,15,1,0,3,-3,1,1,0,0,0,0,0,0,0,0.5097020142727117,0.49029798572728833
90396,0.6402877697841727,0.4,-178,150,0.6144920035194866,0.38550799648051337,away,LAA,over,9,0.5121951219512195,-105,0.48808156828023186,PHI,LAA,2023 REG,11,8,12,10,18,23,0,1,-2,2,1,1,1,1,1,1,1,1,0,0.48808156828023186,0.5119184317197681
90396,0.6402877697841727,0.4,-178,150,0.6144920035194866,0.38550799648051337,home,PHI,under,9,0.5348837209302326,-115,0.5119184317197681,PHI,LAA,2023 REG,11,8,12,10,18,23,0,1,-2,2,1,1,1,1,1,1,1,1,0,0.48808156828023186,0.5119184317197681
90397,0.5555555555555556,0.4854368932038835,-125,106,0.5327819729114227,0.4672180270885773,away,HOU,over,9.5,0.5073891625615764,-103,0.4826927225525911,NYY,HOU,2023 REG,8,7,6,9,16,14,0,1,-2,2,1,1,1,1,1,1,1,0,0,0.4826927225525911,0.5173072774474089
90397,0.5555555555555556,0.4854368932038835,-125,106,0.5327819729114227,0.4672180270885773,home,NYY,under,9.5,0.5412844036697247,-118,0.5173072774474089,NYY,HOU,2023 REG,8,7,6,9,16,14,0,1,-2,2,1,1,1,1,1,1,1,0,0,0.4826927225525911,0.5173072774474089
90398,0.46511627906976744,0.574468085106383,115,-135,0.44670494689481377,0.5532950531051862,away,ARI,over,10,0.5348837209302326,-115,0.5097020142727117,WSH,ARI,2023 REG,7,5,12,10,15,19,0,1,-5,5,1,1,1,1,1,0,0,0,0,0.5097020142727117,0.49029798572728833
90398,0.46511627906976744,0.574468085106383,115,-135,0.44670494689481377,0.5532950531051862,home,WSH,under,10,0.5121951219512195,-105,0.49029798572728833,WSH,ARI,2023 REG,7,5,12,10,15,19,0,1,-5,5,1,1,1,1,1,0,0,0,0,0.5097020142727117,0.49029798572728833
90399,0.4464285714285714,0.5967741935483871,124,-148,0.42714162277814344,0.5728583772218565,away,PHI,over,8.5,0.5,100,0.47935779816513757,STL,PHI,2023 REG,9,4,8,5,9,17,0,1,-1,1,1,1,1,1,0,0,0,0,0,0.47935779816513757,0.5206422018348624
90399,0.4464285714285714,0.5967741935483871,124,-148,0.42714162277814344,0.5728583772218565,home,STL,under,8.5,0.5412844036697247,-118,0.5206422018348624,STL,PHI,2023 REG,9,4,8,5,9,17,0,1,-1,1,1,1,1,1,0,0,0,0,0,0.47935779816513757,0.5206422018348624
90400,0.6742671009771988,0.36900369003690037,-207,171,0.6450910301631319,0.35490896983686815,away,CWS,over,9,0.5348837209302326,-115,0.5109810284308424,TOR,CWS,2023 REG,10,7,4,0,7,14,1,0,7,-7,0,0,0,0,0,0,0,0,0,0.5109810284308424,0.48901897156915763
90400,0.6742671009771988,0.36900369003690037,-207,171,0.6450910301631319,0.35490896983686815,home,TOR,under,9,0.5098039215686274,-104,0.48901897156915763,TOR,CWS,2023 REG,10,7,4,0,7,14,1,0,7,-7,0,0,0,0,0,0,0,0,0,0.5109810284308424,0.48901897156915763
90401,0.5,0.5348837209302326,100,-115,0.4825581395348837,0.5174418604651163,away,SEA,over,8.5,0.5283018867924528,-112,0.5044173060022736,LAA,SEA,2023 REG,13,9,9,4,13,22,1,0,5,-5,1,1,1,1,0,0,0,0,0,0.5044173060022736,0.49558269399772636
90401,0.5,0.5348837209302326,100,-115,0.4825581395348837,0.5174418604651163,home,LAA,under,8.5,0.5169082125603864,-107,0.49558269399772636,LAA,SEA,2023 REG,13,9,9,4,13,22,1,0,5,-5,1,1,1,1,0,0,0,0,0,0.5044173060022736,0.49558269399772636
90402,0.6336996336996338,0.40485829959514175,-173,147,0.6092654854945195,0.39073451450548047,away,CIN,over,9.5,0.49751243781094534,101,0.47511256217505476,PIT,CIN,2023 REG,4,4,8,3,7,12,1,0,1,-1,1,1,1,0,0,0,0,0,0,0.47511256217505476,0.5248874378249453
90402,0.6336996336996338,0.40485829959514175,-173,147,0.6092654854945195,0.39073451450548047,home,PIT,under,9.5,0.5475113122171946,-121,0.5248874378249453,PIT,CIN,2023 REG,4,4,8,3,7,12,1,0,1,-1,1,1,1,0,0,0,0,0,0,0.47511256217505476,0.5248874378249453
90403,0.7916666666666667,0.25,-380,300,0.7586805555555556,0.24131944444444442,away,OAK,over,7,0.5555555555555556,-125,0.5314664257753688,TEX,OAK,2023 REG,9,5,5,2,7,14,1,0,3,-3,1,1,0,0,0,0,0,0,0,0.5314664257753688,0.46853357422463116
90403,0.7916666666666667,0.25,-380,300,0.7586805555555556,0.24131944444444442,home,TEX,under,7,0.48780487804878053,105,0.46853357422463116,TEX,OAK,2023 REG,9,5,5,2,7,14,1,0,3,-3,1,1,0,0,0,0,0,0,0,0.5314664257753688,0.46853357422463116
90404,0.5575221238938054,0.4807692307692307,-126,108,0.5361738465152985,0.46382615348470146,away,CWS,over,9.5,0.5098039215686274,-104,0.48483656587239576,KC,CWS,2023 REG,10,7,13,6,13,23,1,0,1,-1,1,1,1,1,1,1,0,0,0,0.48483656587239576,0.5151634341276042
90404,0.5575221238938054,0.4807692307692307,-126,108,0.5361738465152985,0.46382615348470146,home,KC,under,9.5,0.5391705069124424,-117,0.5151634341276042,KC,CWS,2023 REG,10,7,13,6,13,23,1,0,1,-1,1,1,1,1,1,1,0,0,0,0.48483656587239576,0.5151634341276042
90405,0.5073891625615764,0.5348837209302326,-103,-115,0.4859403596076043,0.5140596403923957,away,MIL,over,7,0.5,100,0.4772727272727273,MIA,MIL,2023 REG,8,5,6,4,9,14,1,0,1,-1,1,1,1,1,0,0,0,0,0,0.4772727272727273,0.5227272727272727
90405,0.5073891625615764,0.5348837209302326,-103,-115,0.4859403596076043,0.5140596403923957,home,MIA,under,7,0.5454545454545454,-120,0.5227272727272727,MIA,MIL,2023 REG,8,5,6,4,9,14,1,0,1,-1,1,1,1,1,0,0,0,0,0,0.4772727272727273,0.5227272727272727
90406,0.5238095238095238,0.5238095238095238,-110,-110,0.4988662131519274,0.5011337868480725,away,OAK,over,8.5,0.5454545454545454,-120,0.5206611570247933,CWS,OAK,2023 REG,13,6,2,1,7,15,1,0,5,-5,1,0,0,0,0,0,0,0,0,0.5206611570247933,0.4793388429752067
90406,0.5238095238095238,0.5238095238095238,-110,-110,0.4988662131519274,0.5011337868480725,home,CWS,under,8.5,0.5,100,0.4793388429752067,CWS,OAK,2023 REG,13,6,2,1,7,15,1,0,5,-5,1,0,0,0,0,0,0,0,0,0.5206611570247933,0.4793388429752067
90407,0.37037037037037035,0.6721311475409836,170,-205,0.35462906744023925,0.6453709325597607,away,SD,over,9.5,0.5073891625615764,-103,0.4826927225525911,STL,SD,2023 REG,4,1,12,4,5,16,0,1,-3,3,1,0,0,0,0,0,0,0,0,0.4826927225525911,0.5173072774474089
90407,0.37037037037037035,0.6721311475409836,170,-205,0.35462906744023925,0.6453709325597607,home,STL,under,9.5,0.5412844036697247,-118,0.5173072774474089,STL,SD,2023 REG,4,1,12,4,5,16,0,1,-3,3,1,0,0,0,0,0,0,0,0,0.4826927225525911,0.5173072774474089
90408,0.5555555555555556,0.48780487804878053,-125,105,0.5314664257753688,0.46853357422463116,away,MIL,over,8,0.5348837209302326,-115,0.5097020142727117,TEX,MIL,2023 REG,5,1,15,6,7,20,0,1,-5,5,1,0,0,0,0,0,0,0,0,0.5097020142727117,0.49029798572728833
90408,0.5555555555555556,0.48780487804878053,-125,105,0.5314664257753688,0.46853357422463116,home,TEX,under,8,0.5121951219512195,-105,0.49029798572728833,TEX,MIL,2023 REG,5,1,15,6,7,20,0,1,-5,5,1,0,0,0,0,0,0,0,0,0.5097020142727117,0.49029798572728833
90409,0.5918367346938775,0.4444444444444444,-145,125,0.5703642001018094,0.42963579989819056,away,PHI,over,7.5,0.49751243781094534,101,0.476135829221149,HOU,PHI,2023 REG,3,1,8,3,4,11,0,1,-2,2,1,0,0,0,0,0,0,0,0,0.476135829221149,0.523864170778851
90409,0.5918367346938775,0.4444444444444444,-145,125,0.5703642001018094,0.42963579989819056,home,HOU,under,7.5,0.5454545454545454,-120,0.523864170778851,HOU,PHI,2023 REG,3,1,8,3,4,11,0,1,-2,2,1,0,0,0,0,0,0,0,0,0.476135829221149,0.523864170778851
90410,0.6389891696750902,0.4,-177,150,0.614075512518083,0.385924487481917,away,CLE,over,8.5,0.5145631067961165,-106,0.49023796582517226,SF,CLE,2023 REG,6,1,4,3,4,10,0,1,-2,2,1,0,0,0,0,0,0,0,0,0.49023796582517226,0.5097620341748277
90410,0.6389891696750902,0.4,-177,150,0.614075512518083,0.385924487481917,home,SF,under,8.5,0.5327102803738317,-114,0.5097620341748277,SF,CLE,2023 REG,6,1,4,3,4,10,0,1,-2,2,1,0,0,0,0,0,0,0,0,0.49023796582517226,0.5097620341748277
90411,0.6610169491525424,0.3802281368821293,-195,163,0.6337532482143695,0.3662467517856305,away,WSH,over,10,0.5121951219512195,-105,0.48808156828023186,PHI,WSH,2023 REG,8,1,8,2,3,16,0,1,-1,1,1,0,0,0,0,0,0,0,0,0.48808156828023186,0.5119184317197681
90411,0.6610169491525424,0.3802281368821293,-195,163,0.6337532482143695,0.3662467517856305,home,PHI,under,10,0.5348837209302326,-115,0.5119184317197681,PHI,WSH,2023 REG,8,1,8,2,3,16,0,1,-1,1,1,0,0,0,0,0,0,0,0,0.48808156828023186,0.5119184317197681
90412,0.6226415094339623,0.4166666666666667,-165,140,0.5981666073335706,0.40183339266642937,away,STL,over,8.5,0.5348837209302326,-115,0.5097020142727117,MIL,STL,2023 REG,5,1,5,4,5,10,0,1,-3,3,1,0,0,0,0,0,0,0,0,0.5097020142727117,0.49029798572728833
90412,0.6226415094339623,0.4166666666666667,-165,140,0.5981666073335706,0.40183339266642937,home,MIL,under,8.5,0.5121951219512195,-105,0.49029798572728833,MIL,STL,2023 REG,5,1,5,4,5,10,0,1,-3,3,1,0,0,0,0,0,0,0,0,0.5097020142727117,0.49029798572728833
90413,0.2898550724637681,0.75,245,-300,0.2783028775467339,0.7216971224532661,away,ATL,over,9,0.5121951219512195,-105,0.48808156828023186,PIT,ATL,2023 REG,9,7,10,6,13,19,1,0,1,-1,1,1,1,1,1,1,0,0,0,0.48808156828023186,0.5119184317197681
90413,0.2898550724637681,0.75,245,-300,0.2783028775467339,0.7216971224532661,home,PIT,under,9,0.5348837209302326,-115,0.5119184317197681,PIT,ATL,2023 REG,9,7,10,6,13,19,1,0,1,-1,1,1,1,1,1,1,0,0,0,0.48808156828023186,0.5119184317197681
90414,0.75,0.2898550724637681,-300,245,0.720108695652174,0.27989130434782605,away,OAK,over,8.5,0.5121951219512195,-105,0.48808156828023186,SEA,OAK,2023 REG,11,6,7,1,7,18,1,0,5,-5,1,0,0,0,0,0,0,0,0,0.48808156828023186,0.5119184317197681
90414,0.75,0.2898550724637681,-300,245,0.720108695652174,0.27989130434782605,home,SEA,under,8.5,0.5348837209302326,-115,0.5119184317197681,SEA,OAK,2023 REG,11,6,7,1,7,18,1,0,5,-5,1,0,0,0,0,0,0,0,0,0.48808156828023186,0.5119184317197681
90415,0.6666666666666666,0.37037037037037035,-200,170,0.6419753086419753,0.3580246913580247,away,COL,over,8,0.5238095238095238,-110,0.4988662131519274,CLE,COL,2023 REG,4,0,10,6,6,14,0,1,-6,6,0,0,0,0,0,0,0,0,0,0.4988662131519274,0.5011337868480725
90415,0.6666666666666666,0.37037037037037035,-200,170,0.6419753086419753,0.3580246913580247,home,CLE,under,8,0.5238095238095238,-110,0.5011337868480725,CLE,COL,2023 REG,4,0,10,6,6,14,0,1,-6,6,0,0,0,0,0,0,0,0,0,0.4988662131519274,0.5011337868480725
90416,0.5,0.5454545454545454,100,-120,0.4772727272727273,0.5227272727272727,away,BAL,over,9.5,0.5348837209302326,-115,0.5109810284308424,ARI,BAL,2023 REG,10,4,8,2,6,18,1,0,2,-2,1,1,0,0,0,0,0,0,0,0.5109810284308424,0.48901897156915763
90416,0.5,0.5454545454545454,100,-120,0.4772727272727273,0.5227272727272727,home,ARI,under,9.5,0.5098039215686274,-104,0.48901897156915763,ARI,BAL,2023 REG,10,4,8,2,6,18,1,0,2,-2,1,1,0,0,0,0,0,0,0,0.5109810284308424,0.48901897156915763
90417,0.5555555555555556,0.48780487804878053,-125,105,0.5314664257753688,0.46853357422463116,away,ARI,over,8.5,0.5348837209302326,-115,0.5097020142727117,TEX,ARI,2023 REG,12,7,10,12,19,22,0,1,-5,5,1,1,1,1,1,1,1,0,0,0.5097020142727117,0.49029798572728833
90417,0.5555555555555556,0.48780487804878053,-125,105,0.5314664257753688,0.46853357422463116,home,TEX,under,8.5,0.5121951219512195,-105,0.49029798572728833,TEX,ARI,2023 REG,12,7,10,12,19,22,0,1,-5,5,1,1,1,1,1,1,1,0,0,0.5097020142727117,0.49029798572728833
90418,0.48780487804878053,0.5555555555555556,105,-125,0.4666534470222751,0.5333465529777248,away,CIN,over,9,0.5238095238095238,-110,0.4988662131519274,DET,CIN,2023 REG,9,5,9,6,11,18,0,1,-1,1,1,1,1,1,1,0,0,0,0,0.4988662131519274,0.5011337868480725
90418,0.48780487804878053,0.5555555555555556,105,-125,0.4666534470222751,0.5333465529777248,home,DET,under,9,0.5238095238095238,-110,0.5011337868480725,DET,CIN,2023 REG,9,5,9,6,11,18,0,1,-1,1,1,1,1,1,1,0,0,0,0,0.4988662131519274,0.5011337868480725
90419,0.5833333333333333,0.45454545454545453,-140,120,0.5612373737373737,0.4387626262626263,away,TOR,over,7,0.5,100,0.4772727272727273,NYY,TOR,2023 REG,10,5,4,3,8,14,1,0,2,-2,1,1,1,0,0,0,0,0,0,0.4772727272727273,0.5227272727272727
90419,0.5833333333333333,0.45454545454545453,-140,120,0.5612373737373737,0.4387626262626263,home,NYY,under,7,0.5454545454545454,-120,0.5227272727272727,NYY,TOR,2023 REG,10,5,4,3,8,14,1,0,2,-2,1,1,1,0,0,0,0,0,0,0.4772727272727273,0.5227272727272727
90420,0.6363636363636364,0.4,-175,150,0.6132231404958678,0.3867768595041322,away,ARI,over,9,0.5391705069124424,-117,0.5140669063204599,TOR,ARI,2023 REG,16,7,9,2,9,25,1,0,5,-5,1,1,0,0,0,0,0,0,0,0.5140669063204599,0.4859330936795401
90420,0.6363636363636364,0.4,-175,150,0.6132231404958678,0.3867768595041322,home,TOR,under,9,0.5073891625615764,-103,0.4859330936795401,TOR,ARI,2023 REG,16,7,9,2,9,25,1,0,5,-5,1,1,0,0,0,0,0,0,0,0.5140669063204599,0.4859330936795401
90421,0.726027397260274,0.31746031746031744,-265,215,0.6944541249288857,0.3055458750711143,away,OAK,over,9.5,0.5348837209302326,-115,0.5097020142727117,HOU,OAK,2023 REG,10,5,8,1,6,18,1,0,4,-4,1,0,0,0,0,0,0,0,0,0.5097020142727117,0.49029798572728833
90421,0.726027397260274,0.31746031746031744,-265,215,0.6944541249288857,0.3055458750711143,home,HOU,under,9.5,0.5121951219512195,-105,0.49029798572728833,HOU,OAK,2023 REG,10,5,8,1,6,18,1,0,4,-4,1,0,0,0,0,0,0,0,0,0.5097020142727117,0.49029798572728833
90422,0.7142857142857143,0.3278688524590164,-250,205,0.6841753094680495,0.3158246905319505,away,BOS,over,8,0.5305164319248826,-113,0.5078572507605655,TB,BOS,2023 REG,10,9,4,3,12,14,1,0,6,-6,1,1,1,0,0,0,0,0,0,0.5078572507605655,0.49214274923943446
90422,0.7142857142857143,0.3278688524590164,-250,205,0.6841753094680495,0.3158246905319505,home,TB,under,8,0.5121951219512195,-105,0.49214274923943446,TB,BOS,2023 REG,10,9,4,3,12,14,1,0,6,-6,1,1,1,0,0,0,0,0,0,0.5078572507605655,0.49214274923943446
90423,0.5967741935483871,0.4464285714285714,-148,124,0.5709918983202021,0.42900810167979786,away,BAL,over,10,0.5121951219512195,-105,0.48808156828023186,BOS,BAL,2023 REG,23,12,14,13,25,37,0,1,-1,1,1,1,1,1,1,1,1,1,1,0.48808156828023186,0.5119184317197681
90423,0.5967741935483871,0.4464285714285714,-148,124,0.5709918983202021,0.42900810167979786,home,BOS,under,10,0.5348837209302326,-115,0.5119184317197681,BOS,BAL,2023 REG,23,12,14,13,25,37,0,1,-1,1,1,1,1,1,1,1,1,1,1,0.48808156828023186,0.5119184317197681
90424,0.4629629629629629,0.576271186440678,116,-136,0.4447990049057217,0.5552009950942782,away,CHC,over,8,0.5192307692307692,-108,0.49455035168025013,OAK,CHC,2023 REG,8,1,20,10,11,28,0,1,-9,9,1,0,0,0,0,0,0,0,0,0.49455035168025013,0.5054496483197499
90424,0.4629629629629629,0.576271186440678,116,-136,0.4447990049057217,0.5552009950942782,home,OAK,under,8,0.5283018867924528,-112,0.5054496483197499,OAK,CHC,2023 REG,8,1,20,10,11,28,0,1,-9,9,1,0,0,0,0,0,0,0,0,0.49455035168025013,0.5054496483197499
90425,0.4081632653061224,0.6323529411764706,145,-172,0.39162603817037017,0.6083739618296298,away,PHI,over,9,0.5238095238095238,-110,0.4988662131519274,WSH,PHI,2023 REG,13,8,10,7,15,23,1,0,1,-1,1,1,1,1,1,1,1,0,0,0.4988662131519274,0.5011337868480725
90425,0.4081632653061224,0.6323529411764706,145,-172,0.39162603817037017,0.6083739618296298,home,WSH,under,9,0.5238095238095238,-110,0.5011337868480725,WSH,PHI,2023 REG,13,8,10,7,15,23,1,0,1,-1,1,1,1,1,1,1,1,0,0,0.4988662131519274,0.5011337868480725
90426,0.5918367346938775,0.4504504504504505,-145,122,0.566809625118663,0.43319037488133705,away,LAA,over,9.5,0.5,100,0.4772727272727273,CWS,LAA,2023 REG,11,7,5,3,10,16,1,0,4,-4,1,1,1,0,0,0,0,0,0,0.4772727272727273,0.5227272727272727
90426,0.5918367346938775,0.4504504504504505,-145,122,0.566809625118663,0.43319037488133705,home,CWS,under,9.5,0.5454545454545454,-120,0.5227272727272727,CWS,LAA,2023 REG,11,7,5,3,10,16,1,0,4,-4,1,1,1,0,0,0,0,0,0,0.4772727272727273,0.5227272727272727
90427,0.5,0.5454545454545454,100,-120,0.4772727272727273,0.5227272727272727,away,PHI,over,7.5,0.5348837209302326,-115,0.5097020142727117,MIL,PHI,2023 REG,7,7,5,5,12,12,1,0,2,-2,1,1,1,1,1,0,0,0,0,0.5097020142727117,0.49029798572728833
90427,0.5,0.5454545454545454,100,-120,0.4772727272727273,0.5227272727272727,home,MIL,under,7.5,0.5121951219512195,-105,0.49029798572728833,MIL,PHI,2023 REG,7,7,5,5,12,12,1,0,2,-2,1,1,1,1,1,0,0,0,0,0.5097020142727117,0.49029798572728833
90428,0.5726495726495727,0.4672897196261683,-134,114,0.5497783539959433,0.4502216460040567,away,HOU,over,8.5,0.5391705069124424,-117,0.5140669063204599,TEX,HOU,2023 REG,5,3,14,12,15,19,0,1,-9,9,1,1,1,0,0,0,0,0,0,0.5140669063204599,0.4859330936795401
90428,0.5726495726495727,0.4672897196261683,-134,114,0.5497783539959433,0.4502216460040567,home,TEX,under,8.5,0.5073891625615764,-103,0.4859330936795401,TEX,HOU,2023 REG,5,3,14,12,15,19,0,1,-9,9,1,1,1,0,0,0,0,0,0,0.5140669063204599,0.4859330936795401
90429,0.4672897196261683,0.574468085106383,114,-135,0.4477767267604901,0.5522232732395099,away,MIN,over,13,0.5327102803738317,-114,0.5075272610403079,COL,MIN,2023 REG,11,6,12,14,20,23,0,1,-8,8,1,1,1,1,1,1,0,0,0,0.5075272610403079,0.4924727389596921
90429,0.4672897196261683,0.574468085106383,114,-135,0.4477767267604901,0.5522232732395099,home,COL,under,13,0.5145631067961165,-106,0.4924727389596921,COL,MIN,2023 REG,11,6,12,14,20,23,0,1,-8,8,1,1,1,1,1,1,0,0,0,0.5075272610403079,0.4924727389596921
90430,0.6000000000000001,0.4444444444444444,-150,125,0.5733333333333334,0.42666666666666664,away,BOS,over,9,0.5169082125603864,-107,0.4912600060678196,TEX,BOS,2023 REG,16,15,11,5,20,27,1,0,10,-10,1,1,1,1,1,0,0,0,0,0.4912600060678196,0.5087399939321804
90430,0.6000000000000001,0.4444444444444444,-150,125,0.5733333333333334,0.42666666666666664,home,TEX,under,9,0.5327102803738317,-114,0.5087399939321804,TEX,BOS,2023 REG,16,15,11,5,20,27,1,0,10,-10,1,1,1,1,1,0,0,0,0,0.4912600060678196,0.5087399939321804
90431,0.574468085106383,0.46511627906976744,-135,115,0.5517281312179562,0.44827186878204384,away,PIT,over,8,0.5238095238095238,-110,0.4988662131519274,ARI,PIT,2023 REG,5,3,4,2,5,9,1,0,1,-1,1,1,0,0,0,0,0,0,0,0.4988662131519274,0.5011337868480725
90431,0.574468085106383,0.46511627906976744,-135,115,0.5517281312179562,0.44827186878204384,home,ARI,under,8,0.5238095238095238,-110,0.5011337868480725,ARI,PIT,2023 REG,5,3,4,2,5,9,1,0,1,-1,1,1,0,0,0,0,0,0,0,0.4988662131519274,0.5011337868480725
90432,0.6296296296296295,0.4098360655737705,-170,144,0.6047808585756369,0.3952191414243631,away,MIA,over,9.5,0.5,100,0.4772727272727273,PHI,MIA,2023 REG,8,4,5,5,9,13,0,1,-1,1,1,1,1,1,0,0,0,0,0,0.4772727272727273,0.5227272727272727
90432,0.6296296296296295,0.4098360655737705,-170,144,0.6047808585756369,0.3952191414243631,home,PHI,under,9.5,0.5454545454545454,-120,0.5227272727272727,PHI,MIA,2023 REG,8,4,5,5,9,13,0,1,-1,1,1,1,1,1,0,0,0,0,0,0.4772727272727273,0.5227272727272727
90433,0.48780487804878053,0.5555555555555556,105,-125,0.4666534470222751,0.5333465529777248,away,ARI,over,11,0.5121951219512195,-105,0.48808156828023186,COL,ARI,2023 REG,7,1,10,9,10,17,0,1,-8,8,1,0,0,0,0,0,0,0,0,0.48808156828023186,0.5119184317197681
90433,0.48780487804878053,0.5555555555555556,105,-125,0.4666534470222751,0.5333465529777248,home,COL,under,11,0.5348837209302326,-115,0.5119184317197681,COL,ARI,2023 REG,7,1,10,9,10,17,0,1,-8,8,1,0,0,0,0,0,0,0,0,0.48808156828023186,0.5119184317197681
90434,0.4504504504504505,0.5901639344262295,122,-144,0.43215568248798203,0.567844317512018,away,STL,over,9.5,0.5348837209302326,-115,0.5097020142727117,PIT,STL,2023 REG,11,7,13,5,12,24,1,0,2,-2,1,1,1,1,1,0,0,0,0,0.5097020142727117,0.49029798572728833
90434,0.4504504504504505,0.5901639344262295,122,-144,0.43215568248798203,0.567844317512018,home,PIT,under,9.5,0.5121951219512195,-105,0.49029798572728833,PIT,STL,2023 REG,11,7,13,5,12,24,1,0,2,-2,1,1,1,1,1,0,0,0,0,0.5097020142727117,0.49029798572728833
90435,0.6254681647940076,0.4132231404958678,-167,142,0.6012679850808645,0.39873201491913546,away,CWS,over,9,0.5121951219512195,-105,0.48808156828023186,TEX,CWS,2023 REG,15,11,4,1,12,19,1,0,10,-10,1,0,0,0,0,0,0,0,0,0.48808156828023186,0.5119184317197681
90435,0.6254681647940076,0.4132231404958678,-167,142,0.6012679850808645,0.39873201491913546,home,TEX,under,9,0.5348837209302326,-115,0.5119184317197681,TEX,CWS,2023 REG,15,11,4,1,12,19,1,0,10,-10,1,0,0,0,0,0,0,0,0,0.48808156828023186,0.5119184317197681
90436,0.6923076923076923,0.3448275862068966,-225,190,0.6665986533360538,0.33340134666394616,away,NYY,over,7,0.5145631067961165,-106,0.4913668392989033,TEX,NYY,2023 REG,10,5,5,2,7,15,1,0,3,-3,1,1,0,0,0,0,0,0,0,0.4913668392989033,0.5086331607010968
90436,0.6923076923076923,0.3448275862068966,-225,190,0.6665986533360538,0.33340134666394616,home,TEX,under,7,0.5305164319248826,-113,0.5086331607010968,TEX,NYY,2023 REG,10,5,5,2,7,15,1,0,3,-3,1,1,0,0,0,0,0,0,0,0.4913668392989033,0.5086331607010968
90437,0.5780590717299579,0.4629629629629629,-137,116,0.5543459124348938,0.44565408756510616,away,MIL,over,9.5,0.504950495049505,-102,0.48054649490447493,ARI,MIL,2023 REG,12,7,11,3,10,23,1,0,4,-4,1,1,1,0,0,0,0,0,0,0.48054649490447493,0.5194535050955251
90437,0.5780590717299579,0.4629629629629629,-137,116,0.5543459124348938,0.44565408756510616,home,ARI,under,9.5,0.5433789954337899,-119,0.5194535050955251,ARI,MIL,2023 REG,12,7,11,3,10,23,1,0,4,-4,1,1,1,0,0,0,0,0,0,0.48054649490447493,0.5194535050955251
90438,0.5780590717299579,0.4608294930875576,-137,117,0.5555791840506346,0.44442081594936544,away,TB,over,9,0.5,100,0.4772727272727273,TEX,TB,2023 REG,8,5,6,3,8,14,1,0,2,-2,1,1,1,0,0,0,0,0,0,0.4772727272727273,0.5227272727272727
90438,0.5780590717299579,0.4608294930875576,-137,117,0.5555791840506346,0.44442081594936544,home,TEX,under,9,0.5454545454545454,-120,0.5227272727272727,TEX,TB,2023 REG,8,5,6,3,8,14,1,0,2,-2,1,1,1,0,0,0,0,0,0,0.4772727272727273,0.5227272727272727
90439,0.47846889952153115,0.5594713656387665,109,-127,0.4603156626027285,0.5396843373972715,away,ATL,over,10,0.5412844036697247,-118,0.5175913212324037,PHI,ATL,2023 REG,8,7,7,5,12,15,1,0,2,-2,1,1,1,1,1,0,0,0,0,0.5175913212324037,0.4824086787675963
90439,0.47846889952153115,0.5594713656387665,109,-127,0.4603156626027285,0.5396843373972715,home,PHI,under,10,0.5024875621890548,-101,0.4824086787675963,PHI,ATL,2023 REG,8,7,7,5,12,15,1,0,2,-2,1,1,1,1,1,0,0,0,0,0.5175913212324037,0.4824086787675963
90440,0.7619047619047619,0.2777777777777778,-320,260,0.7316704459561603,0.26832955404383974,away,OAK,over,7.5,0.5433789954337899,-119,0.5198077604720502,SEA,OAK,2023 REG,13,11,5,2,13,18,1,0,9,-9,1,1,0,0,0,0,0,0,0,0.5198077604720502,0.48019223952794976
90440,0.7619047619047619,0.2777777777777778,-320,260,0.7316704459561603,0.26832955404383974,home,SEA,under,7.5,0.5,100,0.48019223952794976,SEA,OAK,2023 REG,13,11,5,2,13,18,1,0,9,-9,1,1,0,0,0,0,0,0,0,0.5198077604720502,0.48019223952794976
90441,0.3508771929824561,0.6875,185,-220,0.3374115112342259,0.662588488765774,away,PHI,over,7.5,0.5305164319248826,-113,0.5066009958897986,OAK,PHI,2023 REG,9,2,7,3,5,16,0,1,-1,1,1,1,0,0,0,0,0,0,0,0.5066009958897986,0.49339900411020143
90441,0.3508771929824561,0.6875,185,-220,0.3374115112342259,0.662588488765774,home,OAK,under,7.5,0.5145631067961165,-106,0.49339900411020143,OAK,PHI,2023 REG,9,2,7,3,5,16,0,1,-1,1,1,1,0,0,0,0,0,0,0,0.5066009958897986,0.49339900411020143
90442,0.6363636363636364,0.4081632653061224,-175,145,0.6080283353010626,0.3919716646989374,away,BAL,over,8,0.5327102803738317,-114,0.5100625279371946,TOR,BAL,2023 REG,5,1,15,6,7,20,0,1,-5,5,1,0,0,0,0,0,0,0,0,0.5100625279371946,0.48993747206280536
90442,0.6363636363636364,0.4081632653061224,-175,145,0.6080283353010626,0.3919716646989374,home,TOR,under,8,0.5098039215686274,-104,0.48993747206280536,TOR,BAL,2023 REG,5,1,15,6,7,20,0,1,-5,5,1,0,0,0,0,0,0,0,0,0.5100625279371946,0.48993747206280536
90443,0.574468085106383,0.46511627906976744,-135,115,0.5517281312179562,0.44827186878204384,away,HOU,over,8,0.5121951219512195,-105,0.48808156828023186,TEX,HOU,2023 REG,15,5,4,2,7,19,1,0,3,-3,1,1,0,0,0,0,0,0,0,0.48808156828023186,0.5119184317197681
90443,0.574468085106383,0.46511627906976744,-135,115,0.5517281312179562,0.44827186878204384,home,TEX,under,8,0.5348837209302326,-115,0.5119184317197681,TEX,HOU,2023 REG,15,5,4,2,7,19,1,0,3,-3,1,1,0,0,0,0,0,0,0,0.48808156828023186,0.5119184317197681
90444,0.5098039215686274,0.5348837209302326,-104,-115,0.4870219861770517,0.5129780138229483,away,PHI,over,10,0.5370370370370371,-116,0.5118817074154765,ARI,PHI,2023 REG,12,9,13,8,17,25,1,0,1,-1,1,1,1,1,1,1,1,1,0,0.5118817074154765,0.48811829258452355
90444,0.5098039215686274,0.5348837209302326,-104,-115,0.4870219861770517,0.5129780138229483,home,ARI,under,10,0.5098039215686274,-104,0.48811829258452355,ARI,PHI,2023 REG,12,9,13,8,17,25,1,0,1,-1,1,1,1,1,1,1,1,1,0,0.5118817074154765,0.48811829258452355
90445,0.5215311004784688,0.5215311004784688,-109,-109,0.49907282342437215,0.5009271765756278,away,MIN,over,8.5,0.5433789954337899,-119,0.5198077604720502,BOS,MIN,2023 REG,12,5,4,4,9,16,1,0,1,-1,1,1,1,1,0,0,0,0,0,0.5198077604720502,0.48019223952794976
90445,0.5215311004784688,0.5215311004784688,-109,-109,0.49907282342437215,0.5009271765756278,home,BOS,under,8.5,0.5,100,0.48019223952794976,BOS,MIN,2023 REG,12,5,4,4,9,16,1,0,1,-1,1,1,1,1,0,0,0,0,0,0.5198077604720502,0.48019223952794976
90446,0.6031746031746031,0.43859649122807015,-152,128,0.5779793398841018,0.4220206601158982,away,PIT,over,8.5,0.5348837209302326,-115,0.5097020142727117,KC,PIT,2023 REG,6,3,9,6,9,15,0,1,-3,3,1,1,1,0,0,0,0,0,0,0.5097020142727117,0.49029798572728833
90446,0.6031746031746031,0.43859649122807015,-152,128,0.5779793398841018,0.4220206601158982,home,KC,under,8.5,0.5121951219512195,-105,0.49029798572728833,KC,PIT,2023 REG,6,3,9,6,9,15,0,1,-3,3,1,1,1,0,0,0,0,0,0,0.5097020142727117,0.49029798572728833
90447,0.3846153846153846,0.6551724137931035,160,-190,0.3693123852275045,0.6306876147724956,away,DET,over,7.5,0.5238095238095238,-110,0.4988662131519274,OAK,DET,2023 REG,5,3,9,7,10,14,0,1,-4,4,1,1,1,0,0,0,0,0,0,0.4988662131519274,0.5011337868480725
90447,0.3846153846153846,0.6551724137931035,160,-190,0.3693123852275045,0.6306876147724956,home,OAK,under,7.5,0.5238095238095238,-110,0.5011337868480725,OAK,DET,2023 REG,5,3,9,7,10,14,0,1,-4,4,1,1,1,0,0,0,0,0,0,0.4988662131519274,0.5011337868480725
90448,0.5833333333333333,0.4566210045662101,-140,119,0.5600266362252664,0.4399733637747336,away,STL,over,8.5,0.5454545454545454,-120,0.5206611570247933,LAD,STL,2023 REG,9,7,6,3,10,15,1,0,4,-4,1,1,1,0,0,0,0,0,0,0.5206611570247933,0.4793388429752067
90448,0.5833333333333333,0.4566210045662101,-140,119,0.5600266362252664,0.4399733637747336,home,LAD,under,8.5,0.5,100,0.4793388429752067,LAD,STL,2023 REG,9,7,6,3,10,15,1,0,4,-4,1,1,1,0,0,0,0,0,0,0.5206611570247933,0.4793388429752067
90449,0.3921568627450981,0.6453900709219857,155,-182,0.37743257503251615,0.6225674249674839,away,TB,over,8,0.5260663507109005,-111,0.5022370601254724,WSH,TB,2023 REG,4,2,9,6,8,13,0,1,-4,4,1,1,0,0,0,0,0,0,0,0.5022370601254724,0.4977629398745276
90449,0.3921568627450981,0.6453900709219857,155,-182,0.37743257503251615,0.6225674249674839,home,WSH,under,8,0.5192307692307692,-108,0.4977629398745276,WSH,TB,2023 REG,4,2,9,6,8,13,0,1,-4,4,1,1,0,0,0,0,0,0,0,0.5022370601254724,0.4977629398745276
90450,0.6108949416342413,0.425531914893617,-157,135,0.5886419592417365,0.41135804075826354,away,LAA,over,8.5,0.5348837209302326,-115,0.5097020142727117,BAL,LAA,2023 REG,11,3,4,1,4,15,1,0,2,-2,1,0,0,0,0,0,0,0,0,0.5097020142727117,0.49029798572728833
90450,0.6108949416342413,0.425531914893617,-157,135,0.5886419592417365,0.41135804075826354,home,BAL,under,8.5,0.5121951219512195,-105,0.49029798572728833,BAL,LAA,2023 REG,11,3,4,1,4,15,1,0,2,-2,1,0,0,0,0,0,0,0,0,0.5097020142727117,0.49029798572728833
90451,0.7333333333333333,0.30303030303030304,-275,230,0.7066666666666666,0.29333333333333345,away,KC,over,8,0.5348837209302326,-115,0.5109810284308424,MIL,KC,2023 REG,11,5,3,1,6,14,1,0,4,-4,1,0,0,0,0,0,0,0,0,0.5109810284308424,0.48901897156915763
90451,0.7333333333333333,0.30303030303030304,-275,230,0.7066666666666666,0.29333333333333345,home,MIL,under,8,0.5098039215686274,-104,0.48901897156915763,MIL,KC,2023 REG,11,5,3,1,6,14,1,0,4,-4,1,0,0,0,0,0,0,0,0,0.5109810284308424,0.48901897156915763
90452,0.6551724137931035,0.3846153846153846,-190,160,0.6291045458703008,0.37089545412969915,away,KC,over,9,0.5121951219512195,-105,0.48808156828023186,STL,KC,2023 REG,5,2,5,1,3,10,1,0,1,-1,1,0,0,0,0,0,0,0,0,0.48808156828023186,0.5119184317197681
90452,0.6551724137931035,0.3846153846153846,-190,160,0.6291045458703008,0.37089545412969915,home,STL,under,9,0.5348837209302326,-115,0.5119184317197681,STL,KC,2023 REG,5,2,5,1,3,10,1,0,1,-1,1,0,0,0,0,0,0,0,0,0.48808156828023186,0.5119184317197681
90453,0.3968253968253968,0.6402877697841727,152,-178,0.38209794975810735,0.6179020502418926,away,TB,over,8.5,0.5348837209302326,-115,0.5097020142727117,CHC,TB,2023 REG,8,2,7,1,3,15,1,0,1,-1,1,0,0,0,0,0,0,0,0,0.5097020142727117,0.49029798572728833
90453,0.3968253968253968,0.6402877697841727,152,-178,0.38209794975810735,0.6179020502418926,home,CHC,under,8.5,0.5121951219512195,-105,0.49029798572728833,CHC,TB,2023 REG,8,2,7,1,3,15,1,0,1,-1,1,0,0,0,0,0,0,0,0,0.5097020142727117,0.49029798572728833
90454,0.607843137254902,0.4291845493562232,-155,133,0.5853361120599043,0.4146638879400957,away,STL,over,8.5,0.5327102803738317,-114,0.508788710910954,SF,STL,2023 REG,6,0,12,6,6,18,0,1,-6,6,0,0,0,0,0,0,0,0,0,0.508788710910954,0.491211289089046
90454,0.607843137254902,0.4291845493562232,-155,133,0.5853361120599043,0.4146638879400957,home,SF,under,8.5,0.5121951219512195,-105,0.491211289089046,SF,STL,2023 REG,6,0,12,6,6,18,0,1,-6,6,0,0,0,0,0,0,0,0,0,0.508788710910954,0.491211289089046
90455,0.6551724137931035,0.3846153846153846,-190,160,0.6291045458703008,0.37089545412969915,away,OAK,over,9.5,0.5454545454545454,-120,0.5206611570247933,BOS,OAK,2023 REG,7,4,11,3,7,18,1,0,1,-1,1,1,1,0,0,0,0,0,0,0.5206611570247933,0.4793388429752067
90455,0.6551724137931035,0.3846153846153846,-190,160,0.6291045458703008,0.37089545412969915,home,BOS,under,9.5,0.5,100,0.4793388429752067,BOS,OAK,2023 REG,7,4,11,3,7,18,1,0,1,-1,1,1,1,0,0,0,0,0,0,0.5206611570247933,0.4793388429752067
90456,0.45454545454545453,0.5833333333333333,120,-140,0.43732782369146006,0.5626721763085399,away,NYY,over,8.5,0.5348837209302326,-115,0.5097020142727117,KC,NYY,2023 REG,11,5,7,2,7,18,1,0,3,-3,1,1,0,0,0,0,0,0,0,0.5097020142727117,0.49029798572728833
90456,0.45454545454545453,0.5833333333333333,120,-140,0.43732782369146006,0.5626721763085399,home,KC,under,8.5,0.5121951219512195,-105,0.49029798572728833,KC,NYY,2023 REG,11,5,7,2,7,18,1,0,3,-3,1,1,0,0,0,0,0,0,0,0.5097020142727117,0.49029798572728833
90457,0.5652173913043479,0.47619047619047616,-130,110,0.5418129444594474,0.4581870555405526,away,SEA,over,7,0.5,100,0.4772727272727273,SF,SEA,2023 REG,7,5,10,6,11,17,0,1,-1,1,1,1,1,1,1,0,0,0,0,0.4772727272727273,0.5227272727272727
90457,0.5652173913043479,0.47619047619047616,-130,110,0.5418129444594474,0.4581870555405526,home,SF,under,7,0.5454545454545454,-120,0.5227272727272727,SF,SEA,2023 REG,7,5,10,6,11,17,0,1,-1,1,1,1,1,1,1,0,0,0,0,0.4772727272727273,0.5227272727272727
90458,0.5918367346938775,0.4504504504504505,-145,122,0.566809625118663,0.43319037488133705,away,OAK,over,8.5,0.5121951219512195,-105,0.48808156828023186,LAA,OAK,2023 REG,9,5,4,1,6,13,1,0,4,-4,1,0,0,0,0,0,0,0,0,0.48808156828023186,0.5119184317197681
90458,0.5918367346938775,0.4504504504504505,-145,122,0.566809625118663,0.43319037488133705,home,LAA,under,8.5,0.5348837209302326,-115,0.5119184317197681,LAA,OAK,2023 REG,9,5,4,1,6,13,1,0,4,-4,1,0,0,0,0,0,0,0,0,0.48808156828023186,0.5119184317197681
90459,0.6363636363636364,0.4,-175,150,0.6132231404958678,0.3867768595041322,away,CHC,over,7.5,0.5305164319248826,-113,0.5066009958897986,HOU,CHC,2023 REG,9,7,6,3,10,15,1,0,4,-4,1,1,1,0,0,0,0,0,0,0.5066009958897986,0.49339900411020143
90459,0.6363636363636364,0.4,-175,150,0.6132231404958678,0.3867768595041322,home,HOU,under,7.5,0.5145631067961165,-106,0.49339900411020143,HOU,CHC,2023 REG,9,7,6,3,10,15,1,0,4,-4,1,1,1,0,0,0,0,0,0,0.5066009958897986,0.49339900411020143
90460,0.5555555555555556,0.47619047619047616,-125,110,0.5379188712522047,0.4620811287477953,away,COL,over,9.5,0.5073891625615764,-103,0.4837652908580103,KC,COL,2023 REG,6,2,9,7,9,15,0,1,-5,5,1,1,0,0,0,0,0,0,0,0.4837652908580103,0.5162347091419897
90460,0.5555555555555556,0.47619047619047616,-125,110,0.5379188712522047,0.4620811287477953,home,KC,under,9.5,0.5391705069124424,-117,0.5162347091419897,KC,COL,2023 REG,6,2,9,7,9,15,0,1,-5,5,1,1,0,0,0,0,0,0,0,0.4837652908580103,0.5162347091419897
90461,0.3448275862068966,0.6923076923076923,190,-225,0.3320223177535901,0.6679776822464099,away,ARI,over,8.5,0.5073891625615764,-103,0.4837652908580103,DET,ARI,2023 REG,11,5,9,7,12,20,0,1,-2,2,1,1,1,1,1,0,0,0,0,0.4837652908580103,0.5162347091419897
90461,0.3448275862068966,0.6923076923076923,190,-225,0.3320223177535901,0.6679776822464099,home,DET,under,8.5,0.5391705069124424,-117,0.5162347091419897,DET,ARI,2023 REG,11,5,9,7,12,20,0,1,-2,2,1,1,1,1,1,0,0,0,0,0.4837652908580103,0.5162347091419897
90462,0.5798319327731092,0.4587155963302753,-138,118,0.557480844469466,0.442519155530534,away,SD,over,9,0.5454545454545454,-120,0.5206611570247933,LAD,SD,2023 REG,6,4,8,2,6,14,1,0,2,-2,1,1,0,0,0,0,0,0,0,0.5206611570247933,0.4793388429752067
90462,0.5798319327731092,0.4587155963302753,-138,118,0.557480844469466,0.442519155530534,home,LAD,under,9,0.5,100,0.4793388429752067,LAD,SD,2023 REG,6,4,8,2,6,14,1,0,2,-2,1,1,0,0,0,0,0,0,0,0.5206611570247933,0.4793388429752067
90463,0.5833333333333333,0.45454545454545453,-140,120,0.5612373737373737,0.4387626262626263,away,CWS,over,8.5,0.5370370370370371,-116,0.514488177212783,HOU,CWS,2023 REG,11,6,10,4,10,21,1,0,2,-2,1,1,1,1,0,0,0,0,0,0.514488177212783,0.48551182278721705
90463,0.5833333333333333,0.45454545454545453,-140,120,0.5612373737373737,0.4387626262626263,home,HOU,under,8.5,0.504950495049505,-102,0.48551182278721705,HOU,CWS,2023 REG,11,6,10,4,10,21,1,0,2,-2,1,1,1,1,0,0,0,0,0,0.514488177212783,0.48551182278721705
90464,0.5918367346938775,0.4464285714285714,-145,124,0.5691899208663057,0.4308100791336943,away,LAA,over,9,0.5412844036697247,-118,0.5136310900085983,CWS,LAA,2023 REG,12,5,13,12,17,25,0,1,-7,7,1,1,1,1,1,0,0,0,0,0.5136310900085983,0.4863689099914017
90464,0.5918367346938775,0.4464285714285714,-145,124,0.5691899208663057,0.4308100791336943,home,CWS,under,9,0.5098039215686274,-104,0.4863689099914017,CWS,LAA,2023 REG,12,5,13,12,17,25,0,1,-7,7,1,1,1,1,1,0,0,0,0,0.5136310900085983,0.4863689099914017
90465,0.38759689922480617,0.6551724137931035,158,-190,0.37101964611708926,0.6289803538829107,away,HOU,over,8,0.5145631067961165,-106,0.4913668392989033,PIT,HOU,2023 REG,3,2,13,8,10,16,0,1,-6,6,1,1,0,0,0,0,0,0,0,0.4913668392989033,0.5086331607010968
90465,0.38759689922480617,0.6551724137931035,158,-190,0.37101964611708926,0.6289803538829107,home,PIT,under,8,0.5305164319248826,-113,0.5086331607010968,PIT,HOU,2023 REG,3,2,13,8,10,16,0,1,-6,6,1,1,0,0,0,0,0,0,0,0.4913668392989033,0.5086331607010968
90466,0.7340425531914894,0.303951367781155,-276,229,0.7061533984349738,0.2938466015650262,away,PIT,over,8.5,0.5305164319248826,-113,0.5066009958897986,STL,PIT,2023 REG,6,0,9,5,5,15,0,1,-5,5,0,0,0,0,0,0,0,0,0,0.5066009958897986,0.49339900411020143
90466,0.7340425531914894,0.303951367781155,-276,229,0.7061533984349738,0.2938466015650262,home,STL,under,8.5,0.5145631067961165,-106,0.49339900411020143,STL,PIT,2023 REG,6,0,9,5,5,15,0,1,-5,5,0,0,0,0,0,0,0,0,0,0.5066009958897986,0.49339900411020143
90467,0.4347826086956522,0.607843137254902,130,-155,0.41624967567367205,0.583750324326328,away,SEA,over,10.5,0.504950495049505,-102,0.47949844489399435,CIN,SEA,2023 REG,8,6,9,3,9,17,1,0,3,-3,1,1,1,0,0,0,0,0,0,0.47949844489399435,0.5205015551060057
90467,0.4347826086956522,0.607843137254902,130,-155,0.41624967567367205,0.583750324326328,home,CIN,under,10.5,0.5454545454545454,-120,0.5205015551060057,CIN,SEA,2023 REG,8,6,9,3,9,17,1,0,3,-3,1,1,1,0,0,0,0,0,0,0.47949844489399435,0.5205015551060057
90468,0.626865671641791,0.41152263374485604,-168,143,0.6028013608024003,0.3971986391975997,away,KC,over,9,0.5412844036697247,-118,0.5189377998484975,MIL,KC,2023 REG,7,4,9,3,7,16,1,0,1,-1,1,1,1,0,0,0,0,0,0,0.5189377998484975,0.4810622001515025
90468,0.626865671641791,0.41152263374485604,-168,143,0.6028013608024003,0.3971986391975997,home,MIL,under,9,0.5,100,0.4810622001515025,MIL,KC,2023 REG,7,4,9,3,7,16,1,0,1,-1,1,1,1,0,0,0,0,0,0,0.5189377998484975,0.4810622001515025
90469,0.47619047619047616,0.5652173913043479,110,-130,0.4564724440500838,0.5435275559499162,away,TOR,over,6.5,0.5391705069124424,-117,0.5153817639191344,MIA,TOR,2023 REG,9,3,11,6,9,20,0,1,-3,3,1,1,1,0,0,0,0,0,0,0.5153817639191344,0.4846182360808656
90469,0.47619047619047616,0.5652173913043479,110,-130,0.4564724440500838,0.5435275559499162,home,MIA,under,6.5,0.504950495049505,-102,0.4846182360808656,MIA,TOR,2023 REG,9,3,11,6,9,20,0,1,-3,3,1,1,1,0,0,0,0,0,0,0.5153817639191344,0.4846182360808656
90470,0.5951417004048584,0.4444444444444444,-147,125,0.5715823348467713,0.42841766515322866,away,CWS,over,8,0.5073891625615764,-103,0.4837652908580103,HOU,CWS,2023 REG,7,3,13,6,9,20,0,1,-3,3,1,1,1,0,0,0,0,0,0,0.4837652908580103,0.5162347091419897
90470,0.5951417004048584,0.4444444444444444,-147,125,0.5715823348467713,0.42841766515322866,home,HOU,under,8,0.5391705069124424,-117,0.5162347091419897,HOU,CWS,2023 REG,7,3,13,6,9,20,0,1,-3,3,1,1,1,0,0,0,0,0,0,0.4837652908580103,0.5162347091419897
90471,0.5833333333333333,0.45454545454545453,-140,120,0.5612373737373737,0.4387626262626263,away,MIA,over,8.5,0.5238095238095238,-110,0.5012646084074657,LAA,MIA,2023 REG,10,2,16,6,8,26,0,1,-4,4,1,1,0,0,0,0,0,0,0,0.5012646084074657,0.4987353915925343
90471,0.5833333333333333,0.45454545454545453,-140,120,0.5612373737373737,0.4387626262626263,home,LAA,under,8.5,0.5192307692307692,-108,0.4987353915925343,LAA,MIA,2023 REG,10,2,16,6,8,26,0,1,-4,4,1,1,0,0,0,0,0,0,0,0.5012646084074657,0.4987353915925343
90472,0.5121951219512195,0.5348837209302326,-105,-115,0.48808156828023186,0.5119184317197681,away,CLE,over,8,0.5238095238095238,-110,0.5000596729920038,BAL,CLE,2023 REG,12,8,17,12,20,29,0,1,-4,4,1,1,1,1,1,1,1,1,0,0.5000596729920038,0.4999403270079962
90472,0.5121951219512195,0.5348837209302326,-105,-115,0.48808156828023186,0.5119184317197681,home,BAL,under,8,0.5215311004784688,-109,0.4999403270079962,BAL,CLE,2023 REG,12,8,17,12,20,29,0,1,-4,4,1,1,1,1,1,1,1,1,0,0.5000596729920038,0.4999403270079962
90473,0.5652173913043479,0.47619047619047616,-130,110,0.5418129444594474,0.4581870555405526,away,SF,over,8.5,0.5454545454545454,-120,0.5206611570247933,SD,SF,2023 REG,7,2,10,7,9,17,0,1,-5,5,1,1,0,0,0,0,0,0,0,0.5206611570247933,0.4793388429752067
90473,0.5652173913043479,0.47619047619047616,-130,110,0.5418129444594474,0.4581870555405526,home,SD,under,8.5,0.5,100,0.4793388429752067,SD,SF,2023 REG,7,2,10,7,9,17,0,1,-5,5,1,1,0,0,0,0,0,0,0,0.5206611570247933,0.4793388429752067
90474,0.574468085106383,0.46511627906976744,-135,115,0.5517281312179562,0.44827186878204384,away,ARI,over,8.5,0.5454545454545454,-120,0.5206611570247933,SF,ARI,2023 REG,5,3,5,4,7,10,0,1,-1,1,1,1,1,0,0,0,0,0,0,0.5206611570247933,0.4793388429752067
90474,0.574468085106383,0.46511627906976744,-135,115,0.5517281312179562,0.44827186878204384,home,SF,under,8.5,0.5,100,0.4793388429752067,SF,ARI,2023 REG,5,3,5,4,7,10,0,1,-1,1,1,1,1,0,0,0,0,0,0,0.5206611570247933,0.4793388429752067
90475,0.6197718631178707,0.4166666666666667,-163,140,0.597188287624032,0.402811712375968,away,BOS,over,9,0.49751243781094534,101,0.47511256217505476,BAL,BOS,2023 REG,11,6,11,8,14,22,0,1,-2,2,1,1,1,1,1,1,0,0,0,0.47511256217505476,0.5248874378249453
90475,0.6197718631178707,0.4166666666666667,-163,140,0.597188287624032,0.402811712375968,home,BAL,under,9,0.5475113122171946,-121,0.5248874378249453,BAL,BOS,2023 REG,11,6,11,8,14,22,0,1,-2,2,1,1,1,1,1,1,0,0,0,0.47511256217505476,0.5248874378249453
90476,0.5348837209302326,0.5,-115,100,0.5162249864791779,0.4837750135208221,away,TOR,over,8,0.5238095238095238,-110,0.4988662131519274,MIN,TOR,2023 REG,14,9,10,7,16,24,1,0,2,-2,1,1,1,1,1,1,1,0,0,0.4988662131519274,0.5011337868480725
90476,0.5348837209302326,0.5,-115,100,0.5162249864791779,0.4837750135208221,home,MIN,under,8,0.5238095238095238,-110,0.5011337868480725,MIN,TOR,2023 REG,14,9,10,7,16,24,1,0,2,-2,1,1,1,1,1,1,1,0,0,0.4988662131519274,0.5011337868480725
90477,0.574468085106383,0.46511627906976744,-135,115,0.5517281312179562,0.44827186878204384,away,MIL,over,8.5,0.5391705069124424,-117,0.5140669063204599,SEA,MIL,2023 REG,7,3,9,5,8,16,0,1,-2,2,1,1,1,0,0,0,0,0,0,0.5140669063204599,0.4859330936795401
90477,0.574468085106383,0.46511627906976744,-135,115,0.5517281312179562,0.44827186878204384,home,SEA,under,8.5,0.5073891625615764,-103,0.4859330936795401,SEA,MIL,2023 REG,7,3,9,5,8,16,0,1,-2,2,1,1,1,0,0,0,0,0,0,0.5140669063204599,0.4859330936795401
90478,0.5238095238095238,0.5192307692307692,-110,-108,0.5012646084074657,0.4987353915925343,away,HOU,over,7.5,0.5121951219512195,-105,0.48808156828023186,MIL,HOU,2023 REG,6,2,15,12,14,21,0,1,-10,10,1,1,0,0,0,0,0,0,0,0.48808156828023186,0.5119184317197681
90478,0.5238095238095238,0.5192307692307692,-110,-108,0.5012646084074657,0.4987353915925343,home,MIL,under,7.5,0.5348837209302326,-115,0.5119184317197681,MIL,HOU,2023 REG,6,2,15,12,14,21,0,1,-10,10,1,1,0,0,0,0,0,0,0,0.48808156828023186,0.5119184317197681
90479,0.7333333333333333,0.3076923076923077,-275,225,0.7032478632478633,0.29675213675213674,away,MIA,over,7.5,0.5348837209302326,-115,0.5109810284308424,ATL,MIA,2023 REG,12,11,2,0,11,14,1,0,11,-11,0,0,0,0,0,0,0,0,0,0.5109810284308424,0.48901897156915763
90479,0.7333333333333333,0.3076923076923077,-275,225,0.7032478632478633,0.29675213675213674,home,ATL,under,7.5,0.5098039215686274,-104,0.48901897156915763,ATL,MIA,2023 REG,12,11,2,0,11,14,1,0,11,-11,0,0,0,0,0,0,0,0,0,0.5109810284308424,0.48901897156915763
90480,0.5121951219512195,0.5348837209302326,-105,-115,0.48808156828023186,0.5119184317197681,away,TEX,over,9.5,0.5348837209302326,-115,0.5097020142727117,BOS,TEX,2023 REG,10,4,9,2,6,19,1,0,2,-2,1,1,0,0,0,0,0,0,0,0.5097020142727117,0.49029798572728833
90480,0.5121951219512195,0.5348837209302326,-105,-115,0.48808156828023186,0.5119184317197681,home,BOS,under,9.5,0.5121951219512195,-105,0.49029798572728833,BOS,TEX,2023 REG,10,4,9,2,6,19,1,0,2,-2,1,1,0,0,0,0,0,0,0,0.5097020142727117,0.49029798572728833
90481,0.7275204359673024,0.3125,-267,220,0.6984047509447691,0.30159524905523094,away,OAK,over,9,0.5454545454545454,-120,0.5206611570247933,BOS,OAK,2023 REG,15,10,9,3,13,24,1,0,7,-7,1,1,1,0,0,0,0,0,0,0.5206611570247933,0.4793388429752067
90481,0.7275204359673024,0.3125,-267,220,0.6984047509447691,0.30159524905523094,home,BOS,under,9,0.5,100,0.4793388429752067,BOS,OAK,2023 REG,15,10,9,3,13,24,1,0,7,-7,1,1,1,0,0,0,0,0,0,0.5206611570247933,0.4793388429752067
90482,0.6062992125984252,0.4347826086956522,-154,130,0.581391336695717,0.41860866330428304,away,ARI,over,9,0.5121951219512195,-105,0.48919479393107135,MIA,ARI,2023 REG,11,5,6,1,6,17,1,0,4,-4,1,0,0,0,0,0,0,0,0,0.48919479393107135,0.5108052060689287
90482,0.6062992125984252,0.4347826086956522,-154,130,0.581391336695717,0.41860866330428304,home,MIA,under,9,0.5327102803738317,-114,0.5108052060689287,MIA,ARI,2023 REG,11,5,6,1,6,17,1,0,4,-4,1,0,0,0,0,0,0,0,0,0.48919479393107135,0.5108052060689287
90483,0.5348837209302326,0.5073891625615764,-115,-103,0.5122726437136835,0.48772735628631647,away,CIN,over,8,0.5238095238095238,-110,0.4988662131519274,NYM,CIN,2023 REG,5,3,8,5,8,13,0,1,-2,2,1,1,1,0,0,0,0,0,0,0.4988662131519274,0.5011337868480725
90483,0.5348837209302326,0.5073891625615764,-115,-103,0.5122726437136835,0.48772735628631647,home,NYM,under,8,0.5238095238095238,-110,0.5011337868480725,NYM,CIN,2023 REG,5,3,8,5,8,13,0,1,-2,2,1,1,1,0,0,0,0,0,0,0.4988662131519274,0.5011337868480725
90484,0.6183206106870228,0.42194092827004215,-162,137,0.5934260713318911,0.40657392866810893,away,CIN,over,10,0.5327102803738317,-114,0.5075272610403079,CHC,CIN,2023 REG,7,5,8,3,8,15,1,0,2,-2,1,1,1,0,0,0,0,0,0,0.5075272610403079,0.4924727389596921
90484,0.6183206106870228,0.42194092827004215,-162,137,0.5934260713318911,0.40657392866810893,home,CHC,under,10,0.5145631067961165,-106,0.4924727389596921,CHC,CIN,2023 REG,7,5,8,3,8,15,1,0,2,-2,1,1,1,0,0,0,0,0,0,0.5075272610403079,0.4924727389596921
90485,0.5348837209302326,0.5121951219512195,-115,-105,0.5097020142727117,0.49029798572728833,away,NYM,over,8.5,0.5412844036697247,-118,0.5189377998484975,CHC,NYM,2023 REG,8,7,6,2,9,14,1,0,5,-5,1,1,0,0,0,0,0,0,0,0.5189377998484975,0.4810622001515025
90485,0.5348837209302326,0.5121951219512195,-115,-105,0.5097020142727117,0.49029798572728833,home,CHC,under,8.5,0.5,100,0.4810622001515025,CHC,NYM,2023 REG,8,7,6,2,9,14,1,0,5,-5,1,1,0,0,0,0,0,0,0,0.5189377998484975,0.4810622001515025
90486,0.5,0.5348837209302326,100,-115,0.4825581395348837,0.5174418604651163,away,MIA,over,11.5,0.5,100,0.4772727272727273,COL,MIA,2023 REG,7,5,11,3,8,18,1,0,2,-2,1,1,1,0,0,0,0,0,0,0.4772727272727273,0.5227272727272727
90486,0.5,0.5348837209302326,100,-115,0.4825581395348837,0.5174418604651163,home,COL,under,11.5,0.5454545454545454,-120,0.5227272727272727,COL,MIA,2023 REG,7,5,11,3,8,18,1,0,2,-2,1,1,1,0,0,0,0,0,0,0.4772727272727273,0.5227272727272727
90487,0.5884773662551441,0.4504504504504505,-143,122,0.5655692272061728,0.43443077279382725,away,STL,over,10,0.5348837209302326,-115,0.5097020142727117,TEX,STL,2023 REG,11,4,6,3,7,17,1,0,1,-1,1,1,1,0,0,0,0,0,0,0.5097020142727117,0.49029798572728833
90487,0.5884773662551441,0.4504504504504505,-143,122,0.5655692272061728,0.43443077279382725,home,TEX,under,10,0.5121951219512195,-105,0.49029798572728833,TEX,STL,2023 REG,11,4,6,3,7,17,1,0,1,-1,1,1,1,0,0,0,0,0,0,0.5097020142727117,0.49029798572728833
90488,0.574468085106383,0.46511627906976744,-135,115,0.5517281312179562,0.44827186878204384,away,LAD,over,9,0.5348837209302326,-115,0.5097020142727117,STL,LAD,2023 REG,8,6,9,5,11,17,1,0,1,-1,1,1,1,1,1,0,0,0,0,0.5097020142727117,0.49029798572728833
90488,0.574468085106383,0.46511627906976744,-135,115,0.5517281312179562,0.44827186878204384,home,STL,under,9,0.5121951219512195,-105,0.49029798572728833,STL,LAD,2023 REG,8,6,9,5,11,17,1,0,1,-1,1,1,1,1,1,0,0,0,0,0.5097020142727117,0.49029798572728833
90489,0.4854368932038835,0.5555555555555556,106,-125,0.465537646233282,0.534462353766718,away,HOU,over,8.5,0.5238095238095238,-110,0.4988662131519274,BAL,HOU,2023 REG,8,6,10,7,13,18,0,1,-1,1,1,1,1,1,1,1,0,0,0,0.4988662131519274,0.5011337868480725
90489,0.4854368932038835,0.5555555555555556,106,-125,0.465537646233282,0.534462353766718,home,BAL,under,8.5,0.5238095238095238,-110,0.5011337868480725,BAL,HOU,2023 REG,8,6,10,7,13,18,0,1,-1,1,1,1,1,1,1,1,0,0,0,0.4988662131519274,0.5011337868480725
90490,0.4166666666666667,0.6153846153846154,140,-160,0.40331196581196577,0.5966880341880343,away,SF,over,11,0.5348837209302326,-115,0.5097020142727117,COL,SF,2023 REG,9,4,14,10,14,23,0,1,-6,6,1,1,1,1,0,0,0,0,0,0.5097020142727117,0.49029798572728833
90490,0.4166666666666667,0.6153846153846154,140,-160,0.40331196581196577,0.5966880341880343,home,COL,under,11,0.5121951219512195,-105,0.49029798572728833,COL,SF,2023 REG,9,4,14,10,14,23,0,1,-6,6,1,1,1,1,0,0,0,0,0,0.5097020142727117,0.49029798572728833
90491,0.6923076923076923,0.3508771929824561,-225,185,0.6624104640298972,0.33758953597010277,away,NYM,over,10.5,0.5283018867924528,-112,0.5031902949311281,ATL,NYM,2023 REG,9,4,14,10,14,23,0,1,-6,6,1,1,1,1,0,0,0,0,0,0.5031902949311281,0.4968097050688719
90491,0.6923076923076923,0.3508771929824561,-225,185,0.6624104640298972,0.33758953597010277,home,ATL,under,10.5,0.5192307692307692,-108,0.4968097050688719,ATL,NYM,2023 REG,9,4,14,10,14,23,0,1,-6,6,1,1,1,1,0,0,0,0,0,0.5031902949311281,0.4968097050688719
90492,0.7023809523809524,0.3389830508474576,-236,195,0.6733276643990929,0.32667233560090714,away,WSH,over,10.5,0.5121951219512195,-105,0.48808156828023186,CIN,WSH,2023 REG,4,3,12,7,10,16,0,1,-4,4,1,1,1,0,0,0,0,0,0,0.48808156828023186,0.5119184317197681
90492,0.7023809523809524,0.3389830508474576,-236,195,0.6733276643990929,0.32667233560090714,home,CIN,under,10.5,0.5348837209302326,-115,0.5119184317197681,CIN,WSH,2023 REG,4,3,12,7,10,16,0,1,-4,4,1,1,1,0,0,0,0,0,0,0.48808156828023186,0.5119184317197681
90493,0.5238095238095238,0.5192307692307692,-110,-108,0.5012646084074657,0.4987353915925343,away,TEX,over,8,0.5305164319248826,-113,0.5066009958897986,NYY,TEX,2023 REG,8,5,12,3,8,20,1,0,2,-2,1,1,1,0,0,0,0,0,0,0.5066009958897986,0.49339900411020143
90493,0.5238095238095238,0.5192307692307692,-110,-108,0.5012646084074657,0.4987353915925343,home,NYY,under,8,0.5145631067961165,-106,0.49339900411020143,NYY,TEX,2023 REG,8,5,12,3,8,20,1,0,2,-2,1,1,1,0,0,0,0,0,0,0.5066009958897986,0.49339900411020143
90494,0.5901639344262295,0.4484304932735426,-144,123,0.5673868951280033,0.43261310487199667,away,ARI,over,8.5,0.5121951219512195,-105,0.48808156828023186,STL,ARI,2023 REG,6,3,5,6,9,11,0,1,-3,3,1,1,1,0,0,0,0,0,0,0.48808156828023186,0.5119184317197681
90494,0.5901639344262295,0.4484304932735426,-144,123,0.5673868951280033,0.43261310487199667,home,STL,under,8.5,0.5348837209302326,-115,0.5119184317197681,STL,ARI,2023 REG,6,3,5,6,9,11,0,1,-3,3,1,1,1,0,0,0,0,0,0,0.48808156828023186,0.5119184317197681
90495,0.38167938931297707,0.6551724137931035,162,-190,0.3676138156083661,0.6323861843916339,away,NYM,over,9.5,0.504950495049505,-102,0.4837488699364985,OAK,NYM,2023 REG,5,2,5,3,5,10,0,1,-1,1,1,1,0,0,0,0,0,0,0,0.4837488699364985,0.5162511300635015
90495,0.38167938931297707,0.6551724137931035,162,-190,0.3676138156083661,0.6323861843916339,home,OAK,under,9.5,0.5370370370370371,-116,0.5162511300635015,OAK,NYM,2023 REG,5,2,5,3,5,10,0,1,-1,1,1,1,0,0,0,0,0,0,0,0.4837488699364985,0.5162511300635015
90496,0.4291845493562232,0.6062992125984252,133,-154,0.41395546697225394,0.5860445330277461,away,MIN,over,8.5,0.5238095238095238,-110,0.5000596729920038,CLE,MIN,2023 REG,8,2,1,0,2,9,1,0,2,-2,0,0,0,0,0,0,0,0,0,0.5000596729920038,0.4999403270079962
90496,0.4291845493562232,0.6062992125984252,133,-154,0.41395546697225394,0.5860445330277461,home,CLE,under,8.5,0.5215311004784688,-109,0.4999403270079962,CLE,MIN,2023 REG,8,2,1,0,2,9,1,0,2,-2,0,0,0,0,0,0,0,0,0,0.5000596729920038,0.4999403270079962
90497,0.6491228070175439,0.390625,-185,156,0.6233215989535241,0.3766784010464759,away,NYY,over,7.5,0.5348837209302326,-115,0.5097020142727117,TB,NYY,2023 REG,9,2,8,3,5,17,0,1,-1,1,1,1,0,0,0,0,0,0,0,0.5097020142727117,0.49029798572728833
90497,0.6491228070175439,0.390625,-185,156,0.6233215989535241,0.3766784010464759,home,TB,under,7.5,0.5121951219512195,-105,0.49029798572728833,TB,NYY,2023 REG,9,2,8,3,5,17,0,1,-1,1,1,1,0,0,0,0,0,0,0,0.5097020142727117,0.49029798572728833
90498,0.37453183520599254,0.6666666666666666,167,-200,0.359101684691888,0.640898315308112,away,SF,over,8.5,0.5073891625615764,-103,0.4826927225525911,OAK,SF,2023 REG,11,8,9,6,14,20,1,0,2,-2,1,1,1,1,1,1,0,0,0,0.4826927225525911,0.5173072774474089
90498,0.37453183520599254,0.6666666666666666,167,-200,0.359101684691888,0.640898315308112,home,OAK,under,8.5,0.5412844036697247,-118,0.5173072774474089,OAK,SF,2023 REG,11,8,9,6,14,20,1,0,2,-2,1,1,1,1,1,1,0,0,0,0.4826927225525911,0.5173072774474089
90499,0.6428571428571428,0.39370078740157477,-180,154,0.6193556162622529,0.3806443837377471,away,CLE,over,7,0.5454545454545454,-120,0.5206611570247933,TB,CLE,2023 REG,8,2,15,9,11,23,0,1,-7,7,1,1,0,0,0,0,0,0,0,0.5206611570247933,0.4793388429752067
90499,0.6428571428571428,0.39370078740157477,-180,154,0.6193556162622529,0.3806443837377471,home,TB,under,7,0.5,100,0.4793388429752067,TB,CLE,2023 REG,8,2,15,9,11,23,0,1,-7,7,1,1,0,0,0,0,0,0,0,0.5206611570247933,0.4793388429752067
90500,0.5633187772925764,0.47619047619047616,-129,110,0.5410624729287608,0.45893752707123925,away,LAD,over,8.5,0.5,100,0.47935779816513757,SD,LAD,2023 REG,10,5,11,10,15,21,0,1,-5,5,1,1,1,1,1,0,0,0,0,0.47935779816513757,0.5206422018348624
90500,0.5633187772925764,0.47619047619047616,-129,110,0.5410624729287608,0.45893752707123925,home,SD,under,8.5,0.5412844036697247,-118,0.5206422018348624,SD,LAD,2023 REG,10,5,11,10,15,21,0,1,-5,5,1,1,1,1,1,0,0,0,0,0.47935779816513757,0.5206422018348624
90501,0.46511627906976744,0.574468085106383,115,-135,0.44670494689481377,0.5532950531051862,away,PHI,over,11,0.5454545454545454,-120,0.5206611570247933,COL,PHI,2023 REG,10,3,7,6,9,17,0,1,-3,3,1,1,1,0,0,0,0,0,0,0.5206611570247933,0.4793388429752067
90501,0.46511627906976744,0.574468085106383,115,-135,0.44670494689481377,0.5532950531051862,home,COL,under,11,0.5,100,0.4793388429752067,COL,PHI,2023 REG,10,3,7,6,9,17,0,1,-3,3,1,1,1,0,0,0,0,0,0,0.5206611570247933,0.4793388429752067
90502,0.5121951219512195,0.5348837209302326,-105,-115,0.48808156828023186,0.5119184317197681,away,CHC,over,9.5,0.5,100,0.4772727272727273,CWS,CHC,2023 REG,5,3,13,7,10,18,0,1,-4,4,1,1,1,0,0,0,0,0,0,0.4772727272727273,0.5227272727272727
90502,0.5121951219512195,0.5348837209302326,-105,-115,0.48808156828023186,0.5119184317197681,home,CWS,under,9.5,0.5454545454545454,-120,0.5227272727272727,CWS,CHC,2023 REG,5,3,13,7,10,18,0,1,-4,4,1,1,1,0,0,0,0,0,0,0.4772727272727273,0.5227272727272727
90503,0.574468085106383,0.46511627906976744,-135,115,0.5517281312179562,0.44827186878204384,away,PIT,over,10,0.5098039215686274,-104,0.48483656587239576,MIN,PIT,2023 REG,5,2,2,0,2,7,1,0,2,-2,0,0,0,0,0,0,0,0,0,0.48483656587239576,0.5151634341276042
90503,0.574468085106383,0.46511627906976744,-135,115,0.5517281312179562,0.44827186878204384,home,MIN,under,10,0.5391705069124424,-117,0.5151634341276042,MIN,PIT,2023 REG,5,2,2,0,2,7,1,0,2,-2,0,0,0,0,0,0,0,0,0,0.48483656587239576,0.5151634341276042
90504,0.6923076923076923,0.3508771929824561,-225,185,0.6624104640298972,0.33758953597010277,away,PIT,over,7.5,0.5215311004784688,-109,0.4978845547971712,SEA,PIT,2023 REG,11,5,2,0,5,13,1,0,5,-5,0,0,0,0,0,0,0,0,0,0.4978845547971712,0.5021154452028288
90504,0.6923076923076923,0.3508771929824561,-225,185,0.6624104640298972,0.33758953597010277,home,SEA,under,7.5,0.5238095238095238,-110,0.5021154452028288,SEA,PIT,2023 REG,11,5,2,0,5,13,1,0,5,-5,0,0,0,0,0,0,0,0,0,0.4978845547971712,0.5021154452028288
90505,0.5454545454545454,0.5,-120,100,0.5206611570247933,0.4793388429752067,away,BAL,over,8,0.5238095238095238,-110,0.4988662131519274,CLE,BAL,2023 REG,13,9,10,8,17,23,1,0,1,-1,1,1,1,1,1,1,1,1,0,0.4988662131519274,0.5011337868480725
90505,0.5454545454545454,0.5,-120,100,0.5206611570247933,0.4793388429752067,home,CLE,under,8,0.5238095238095238,-110,0.5011337868480725,CLE,BAL,2023 REG,13,9,10,8,17,23,1,0,1,-1,1,1,1,1,1,1,1,1,0,0.4988662131519274,0.5011337868480725
90506,0.5833333333333333,0.45454545454545453,-140,120,0.5612373737373737,0.4387626262626263,away,STL,over,9.5,0.5348837209302326,-115,0.5097020142727117,TEX,STL,2023 REG,12,6,7,4,10,19,1,0,2,-2,1,1,1,1,0,0,0,0,0,0.5097020142727117,0.49029798572728833
90506,0.5833333333333333,0.45454545454545453,-140,120,0.5612373737373737,0.4387626262626263,home,TEX,under,9.5,0.5121951219512195,-105,0.49029798572728833,TEX,STL,2023 REG,12,6,7,4,10,19,1,0,2,-2,1,1,1,1,0,0,0,0,0,0.5097020142727117,0.49029798572728833
90507,0.3921568627450981,0.6491228070175439,155,-185,0.37596875695582666,0.6240312430441733,away,BOS,over,10,0.5145631067961165,-106,0.49023796582517226,WSH,BOS,2023 REG,10,10,11,7,17,21,1,0,3,-3,1,1,1,1,1,1,1,0,0,0.49023796582517226,0.5097620341748277
90507,0.3921568627450981,0.6491228070175439,155,-185,0.37596875695582666,0.6240312430441733,home,WSH,under,10,0.5327102803738317,-114,0.5097620341748277,WSH,BOS,2023 REG,10,10,11,7,17,21,1,0,3,-3,1,1,1,1,1,1,1,0,0,0.49023796582517226,0.5097620341748277
90508,0.33783783783783783,0.7014925373134329,196,-235,0.32455054893538154,0.6754494510646185,away,ATL,over,9.5,0.5121951219512195,-105,0.48808156828023186,OAK,ATL,2023 REG,3,2,7,4,6,10,0,1,-2,2,1,1,0,0,0,0,0,0,0,0.48808156828023186,0.5119184317197681
90508,0.33783783783783783,0.7014925373134329,196,-235,0.32455054893538154,0.6754494510646185,home,OAK,under,9.5,0.5348837209302326,-115,0.5119184317197681,OAK,ATL,2023 REG,3,2,7,4,6,10,0,1,-2,2,1,1,0,0,0,0,0,0,0,0.48808156828023186,0.5119184317197681
90509,0.5348837209302326,0.5,-115,100,0.5162249864791779,0.4837750135208221,away,DET,over,8.5,0.5348837209302326,-115,0.5109810284308424,KC,DET,2023 REG,9,4,10,6,10,19,0,1,-2,2,1,1,1,1,0,0,0,0,0,0.5109810284308424,0.48901897156915763
90509,0.5348837209302326,0.5,-115,100,0.5162249864791779,0.4837750135208221,home,KC,under,8.5,0.5098039215686274,-104,0.48901897156915763,KC,DET,2023 REG,9,4,10,6,10,19,0,1,-2,2,1,1,1,1,0,0,0,0,0,0.5109810284308424,0.48901897156915763
90510,0.5412844036697247,0.5,-118,100,0.5189377998484975,0.4810622001515025,away,HOU,over,10,0.5238095238095238,-110,0.4988662131519274,TOR,HOU,2023 REG,12,4,19,11,15,31,0,1,-7,7,1,1,1,1,0,0,0,0,0,0.4988662131519274,0.5011337868480725
90510,0.5412844036697247,0.5,-118,100,0.5189377998484975,0.4810622001515025,home,TOR,under,10,0.5238095238095238,-110,0.5011337868480725,TOR,HOU,2023 REG,12,4,19,11,15,31,0,1,-7,7,1,1,1,1,0,0,0,0,0,0.4988662131519274,0.5011337868480725
90511,0.613899613899614,0.42194092827004215,-159,137,0.5918971188997093,0.4081028811002907,away,CWS,over,9,0.5121951219512195,-105,0.48919479393107135,TOR,CWS,2023 REG,8,5,3,2,7,11,1,0,3,-3,1,1,0,0,0,0,0,0,0,0.48919479393107135,0.5108052060689287
90511,0.613899613899614,0.42194092827004215,-159,137,0.5918971188997093,0.4081028811002907,home,TOR,under,9,0.5327102803738317,-114,0.5108052060689287,TOR,CWS,2023 REG,8,5,3,2,7,11,1,0,3,-3,1,1,0,0,0,0,0,0,0,0.48919479393107135,0.5108052060689287
90512,0.6296296296296295,0.4065040650406504,-170,146,0.606878784837231,0.393121215162769,away,PHI,over,8.5,0.5412844036697247,-118,0.5136310900085983,LAD,PHI,2023 REG,15,13,9,4,17,24,1,0,9,-9,1,1,1,1,0,0,0,0,0,0.5136310900085983,0.4863689099914017
90512,0.6296296296296295,0.4065040650406504,-170,146,0.606878784837231,0.393121215162769,home,LAD,under,8.5,0.5098039215686274,-104,0.4863689099914017,LAD,PHI,2023 REG,15,13,9,4,17,24,1,0,9,-9,1,1,1,1,0,0,0,0,0,0.5136310900085983,0.4863689099914017
90513,0.7333333333333333,0.3076923076923077,-275,225,0.7032478632478633,0.29675213675213674,away,PIT,over,8.5,0.5,100,0.4772727272727273,SD,PIT,2023 REG,6,4,13,8,12,19,0,1,-4,4,1,1,1,1,0,0,0,0,0,0.4772727272727273,0.5227272727272727
90513,0.7333333333333333,0.3076923076923077,-275,225,0.7032478632478633,0.29675213675213674,home,SD,under,8.5,0.5454545454545454,-120,0.5227272727272727,SD,PIT,2023 REG,6,4,13,8,12,19,0,1,-4,4,1,1,1,1,0,0,0,0,0,0.4772727272727273,0.5227272727272727
90514,0.5348837209302326,0.5121951219512195,-115,-105,0.5097020142727117,0.49029798572728833,away,SF,over,7.5,0.5,100,0.4772727272727273,MIL,SF,2023 REG,5,1,6,3,4,11,0,1,-2,2,1,0,0,0,0,0,0,0,0,0.4772727272727273,0.5227272727272727
90514,0.5348837209302326,0.5121951219512195,-115,-105,0.5097020142727117,0.49029798572728833,home,MIL,under,7.5,0.5454545454545454,-120,0.5227272727272727,MIL,SF,2023 REG,5,1,6,3,4,11,0,1,-2,2,1,0,0,0,0,0,0,0,0,0.4772727272727273,0.5227272727272727
90515,0.4464285714285714,0.5934959349593496,124,-146,0.42860513107682097,0.571394868923179,away,TB,over,8.5,0.5145631067961165,-106,0.4913668392989033,LAA,TB,2023 REG,9,7,8,6,13,17,1,0,1,-1,1,1,1,1,1,1,0,0,0,0.4913668392989033,0.5086331607010968
90515,0.4464285714285714,0.5934959349593496,124,-146,0.42860513107682097,0.571394868923179,home,LAA,under,8.5,0.5305164319248826,-113,0.5086331607010968,LAA,TB,2023 REG,9,7,8,6,13,17,1,0,1,-1,1,1,1,1,1,1,0,0,0,0.4913668392989033,0.5086331607010968
90516,0.6575342465753424,0.38314176245210724,-192,161,0.6307883776257865,0.36921162237421346,away,CIN,over,8.5,0.5238095238095238,-110,0.4988662131519274,ATL,CIN,2023 REG,10,5,12,4,9,22,1,0,1,-1,1,1,1,1,0,0,0,0,0,0.4988662131519274,0.5011337868480725
90516,0.6575342465753424,0.38314176245210724,-192,161,0.6307883776257865,0.36921162237421346,home,ATL,under,8.5,0.5238095238095238,-110,0.5011337868480725,ATL,CIN,2023 REG,10,5,12,4,9,22,1,0,1,-1,1,1,1,1,0,0,0,0,0,0.4988662131519274,0.5011337868480725
90517,0.5555555555555556,0.48780487804878053,-125,105,0.5314664257753688,0.46853357422463116,away,CIN,over,9,0.5391705069124424,-117,0.5140669063204599,PIT,CIN,2023 REG,3,4,7,2,6,10,1,0,2,-2,1,1,0,0,0,0,0,0,0,0.5140669063204599,0.4859330936795401
90517,0.5555555555555556,0.48780487804878053,-125,105,0.5314664257753688,0.46853357422463116,home,PIT,under,9,0.5073891625615764,-103,0.4859330936795401,PIT,CIN,2023 REG,3,4,7,2,6,10,1,0,2,-2,1,1,0,0,0,0,0,0,0,0.5140669063204599,0.4859330936795401
90518,0.6666666666666666,0.3717472118959108,-200,169,0.641057414291615,0.358942585708385,away,NYM,over,8.5,0.5348837209302326,-115,0.5097020142727117,BAL,NYM,2023 REG,6,2,4,0,2,10,1,0,2,-2,0,0,0,0,0,0,0,0,0,0.5097020142727117,0.49029798572728833
90518,0.6666666666666666,0.3717472118959108,-200,169,0.641057414291615,0.358942585708385,home,BAL,under,8.5,0.5121951219512195,-105,0.49029798572728833,BAL,NYM,2023 REG,6,2,4,0,2,10,1,0,2,-2,0,0,0,0,0,0,0,0,0,0.5097020142727117,0.49029798572728833
90519,0.4,0.6363636363636364,150,-175,0.3854545454545455,0.6145454545454545,away,SF,over,12,0.5215311004784688,-109,0.4978845547971712,COL,SF,2023 REG,9,4,9,6,10,18,0,1,-2,2,1,1,1,1,0,0,0,0,0,0.4978845547971712,0.5021154452028288
90519,0.4,0.6363636363636364,150,-175,0.3854545454545455,0.6145454545454545,home,COL,under,12,0.5238095238095238,-110,0.5021154452028288,COL,SF,2023 REG,9,4,9,6,10,18,0,1,-2,2,1,1,1,1,0,0,0,0,0,0.4978845547971712,0.5021154452028288
90520,0.4347826086956522,0.6062992125984252,130,-154,0.4169209472634447,0.5830790527365552,away,NYY,over,9.5,0.504950495049505,-102,0.47949844489399435,KC,NYY,2023 REG,15,12,8,5,17,23,1,0,7,-7,1,1,1,1,1,0,0,0,0,0.47949844489399435,0.5205015551060057
90520,0.4347826086956522,0.6062992125984252,130,-154,0.4169209472634447,0.5830790527365552,home,KC,under,9.5,0.5454545454545454,-120,0.5205015551060057,KC,NYY,2023 REG,15,12,8,5,17,23,1,0,7,-7,1,1,1,1,1,0,0,0,0,0.47949844489399435,0.5205015551060057
90521,0.613899613899614,0.425531914893617,-159,135,0.589692613597978,0.410307386402022,away,TEX,over,7.5,0.5,100,0.4772727272727273,SEA,TEX,2023 REG,6,5,7,0,5,13,1,0,5,-5,0,0,0,0,0,0,0,0,0,0.4772727272727273,0.5227272727272727
90521,0.613899613899614,0.425531914893617,-159,135,0.589692613597978,0.410307386402022,home,SEA,under,7.5,0.5454545454545454,-120,0.5227272727272727,SEA,TEX,2023 REG,6,5,7,0,5,13,1,0,5,-5,0,0,0,0,0,0,0,0,0,0.4772727272727273,0.5227272727272727
90522,0.7014925373134329,0.3389830508474576,-235,195,0.6730992142751963,0.32690078572480374,away,COL,over,8.5,0.5121951219512195,-105,0.48808156828023186,SF,COL,2023 REG,11,5,9,3,8,20,1,0,2,-2,1,1,1,0,0,0,0,0,0,0.48808156828023186,0.5119184317197681
90522,0.7014925373134329,0.3389830508474576,-235,195,0.6730992142751963,0.32690078572480374,home,SF,under,8.5,0.5348837209302326,-115,0.5119184317197681,SF,COL,2023 REG,11,5,9,3,8,20,1,0,2,-2,1,1,1,0,0,0,0,0,0,0.48808156828023186,0.5119184317197681
90523,0.5815899581589958,0.4504504504504505,-139,122,0.5629555782564308,0.43704442174356917,away,TOR,over,9.5,0.49504950495049505,102,0.47499799484898986,LAA,TOR,2023 REG,4,3,9,4,7,13,0,1,-1,1,1,1,1,0,0,0,0,0,0,0.47499799484898986,0.5250020051510101
90523,0.5815899581589958,0.4504504504504505,-139,122,0.5629555782564308,0.43704442174356917,home,LAA,under,9.5,0.5454545454545454,-120,0.5250020051510101,LAA,TOR,2023 REG,4,3,9,4,7,13,0,1,-1,1,1,1,1,0,0,0,0,0,0,0.47499799484898986,0.5250020051510101
90524,0.4807692307692307,0.5555555555555556,108,-125,0.4633053911900066,0.5366946088099934,away,LAA,over,8.5,0.5121951219512195,-105,0.48919479393107135,DET,LAA,2023 REG,1,0,11,6,6,12,0,1,-6,6,0,0,0,0,0,0,0,0,0,0.48919479393107135,0.5108052060689287
90524,0.4807692307692307,0.5555555555555556,108,-125,0.4633053911900066,0.5366946088099934,home,DET,under,8.5,0.5327102803738317,-114,0.5108052060689287,DET,LAA,2023 REG,1,0,11,6,6,12,0,1,-6,6,0,0,0,0,0,0,0,0,0,0.48919479393107135,0.5108052060689287
90525,0.48309178743961345,0.5555555555555556,107,-125,0.4644215734322854,0.5355784265677146,away,TOR,over,8.5,0.5348837209302326,-115,0.5097020142727117,NYM,TOR,2023 REG,6,1,10,2,3,16,0,1,-1,1,1,0,0,0,0,0,0,0,0,0.5097020142727117,0.49029798572728833
90525,0.48309178743961345,0.5555555555555556,107,-125,0.4644215734322854,0.5355784265677146,home,NYM,under,8.5,0.5121951219512195,-105,0.49029798572728833,NYM,TOR,2023 REG,6,1,10,2,3,16,0,1,-1,1,1,0,0,0,0,0,0,0,0,0.5097020142727117,0.49029798572728833
90526,0.5024875621890548,0.5348837209302326,-101,-115,0.48370895723856705,0.5162910427614329,away,NYY,over,7.5,0.504950495049505,-102,0.48054649490447493,TB,NYY,2023 REG,10,8,11,7,15,21,1,0,1,-1,1,1,1,1,1,1,1,0,0,0.48054649490447493,0.5194535050955251
90526,0.5024875621890548,0.5348837209302326,-101,-115,0.48370895723856705,0.5162910427614329,home,TB,under,7.5,0.5433789954337899,-119,0.5194535050955251,TB,NYY,2023 REG,10,8,11,7,15,21,1,0,1,-1,1,1,1,1,1,1,1,0,0,0.48054649490447493,0.5194535050955251
90527,0.6363636363636364,0.4,-175,150,0.6132231404958678,0.3867768595041322,away,NYY,over,8,0.5348837209302326,-115,0.5097020142727117,TOR,NYY,2023 REG,9,3,9,6,9,18,0,1,-3,3,1,1,1,0,0,0,0,0,0,0.5097020142727117,0.49029798572728833
90527,0.6363636363636364,0.4,-175,150,0.6132231404958678,0.3867768595041322,home,TOR,under,8,0.5121951219512195,-105,0.49029798572728833,TOR,NYY,2023 REG,9,3,9,6,9,18,0,1,-3,3,1,1,1,0,0,0,0,0,0,0.5097020142727117,0.49029798572728833
90528,0.3921568627450981,0.6503496503496503,155,-186,0.3754876419236281,0.6245123580763718,away,MIN,over,9,0.5348837209302326,-115,0.5097020142727117,CWS,MIN,2023 REG,6,2,10,10,12,16,0,1,-8,8,1,1,0,0,0,0,0,0,0,0.5097020142727117,0.49029798572728833
90528,0.3921568627450981,0.6503496503496503,155,-186,0.3754876419236281,0.6245123580763718,home,CWS,under,9,0.5121951219512195,-105,0.49029798572728833,CWS,MIN,2023 REG,6,2,10,10,12,16,0,1,-8,8,1,1,0,0,0,0,0,0,0,0.5097020142727117,0.49029798572728833
90529,0.5238095238095238,0.5145631067961165,-110,-106,0.5037095744446646,0.4962904255553354,away,CIN,over,8.5,0.5,100,0.4772727272727273,KC,CIN,2023 REG,8,4,10,5,9,18,0,1,-1,1,1,1,1,1,0,0,0,0,0,0.4772727272727273,0.5227272727272727
90529,0.5238095238095238,0.5145631067961165,-110,-106,0.5037095744446646,0.4962904255553354,home,KC,under,8.5,0.5454545454545454,-120,0.5227272727272727,KC,CIN,2023 REG,8,4,10,5,9,18,0,1,-1,1,1,1,1,1,0,0,0,0,0,0.4772727272727273,0.5227272727272727
90530,0.6610169491525424,0.3802281368821293,-195,163,0.6337532482143695,0.3662467517856305,away,KC,over,9,0.5121951219512195,-105,0.48808156828023186,MIN,KC,2023 REG,10,9,5,3,12,15,1,0,6,-6,1,1,1,0,0,0,0,0,0,0.48808156828023186,0.5119184317197681
90530,0.6610169491525424,0.3802281368821293,-195,163,0.6337532482143695,0.3662467517856305,home,MIN,under,9,0.5348837209302326,-115,0.5119184317197681,MIN,KC,2023 REG,10,9,5,3,12,15,1,0,6,-6,1,1,1,0,0,0,0,0,0,0.48808156828023186,0.5119184317197681
90531,0.425531914893617,0.6153846153846154,135,-160,0.4081206254135181,0.5918793745864819,away,ATL,over,10.5,0.5121951219512195,-105,0.48808156828023186,MIL,ATL,2023 REG,7,2,7,4,6,14,0,1,-2,2,1,1,0,0,0,0,0,0,0,0.48808156828023186,0.5119184317197681
90531,0.425531914893617,0.6153846153846154,135,-160,0.4081206254135181,0.5918793745864819,home,MIL,under,10.5,0.5348837209302326,-115,0.5119184317197681,MIL,ATL,2023 REG,7,2,7,4,6,14,0,1,-2,2,1,1,0,0,0,0,0,0,0,0.48808156828023186,0.5119184317197681
90532,0.6376811594202898,0.4,-176,150,0.6136525939928585,0.38634740600714146,away,LAA,over,9.5,0.5348837209302326,-115,0.5097020142727117,ATL,LAA,2023 REG,12,12,8,5,17,20,1,0,7,-7,1,1,1,1,1,0,0,0,0,0.5097020142727117,0.49029798572728833
90532,0.6376811594202898,0.4,-176,150,0.6136525939928585,0.38634740600714146,home,ATL,under,9.5,0.5121951219512195,-105,0.49029798572728833,ATL,LAA,2023 REG,12,12,8,5,17,20,1,0,7,-7,1,1,1,1,1,0,0,0,0,0.5097020142727117,0.49029798572728833
90533,0.5,0.5348837209302326,100,-115,0.4825581395348837,0.5174418604651163,away,HOU,over,8,0.5238095238095238,-110,0.5000596729920038,MIN,HOU,2023 REG,2,1,11,5,6,13,0,1,-4,4,1,0,0,0,0,0,0,0,0,0.5000596729920038,0.4999403270079962
90533,0.5,0.5348837209302326,100,-115,0.4825581395348837,0.5174418604651163,home,MIN,under,8,0.5215311004784688,-109,0.4999403270079962,MIN,HOU,2023 REG,2,1,11,5,6,13,0,1,-4,4,1,0,0,0,0,0,0,0,0,0.5000596729920038,0.4999403270079962
90534,0.6226415094339623,0.41152263374485604,-165,143,0.6013694957565848,0.3986305042434152,away,SF,over,8.5,0.5348837209302326,-115,0.5097020142727117,LAD,SF,2023 REG,6,0,16,15,15,22,0,1,-15,15,0,0,0,0,0,0,0,0,0,0.5097020142727117,0.49029798572728833
90534,0.6226415094339623,0.41152263374485604,-165,143,0.6013694957565848,0.3986305042434152,home,LAD,under,8.5,0.5121951219512195,-105,0.49029798572728833,LAD,SF,2023 REG,6,0,16,15,15,22,0,1,-15,15,0,0,0,0,0,0,0,0,0,0.5097020142727117,0.49029798572728833
90535,0.5780590717299579,0.45454545454545453,-137,120,0.5592117295369979,0.44078827046300206,away,CLE,over,9,0.5348837209302326,-115,0.5097020142727117,BAL,CLE,2023 REG,11,8,11,5,13,22,1,0,3,-3,1,1,1,1,1,0,0,0,0,0.5097020142727117,0.49029798572728833
90535,0.5780590717299579,0.45454545454545453,-137,120,0.5592117295369979,0.44078827046300206,home,BAL,under,9,0.5121951219512195,-105,0.49029798572728833,BAL,CLE,2023 REG,11,8,11,5,13,22,1,0,3,-3,1,1,1,1,1,0,0,0,0,0.5097020142727117,0.49029798572728833
90536,0.574468085106383,0.46511627906976744,-135,115,0.5517281312179562,0.44827186878204384,away,MIN,over,8.5,0.5454545454545454,-120,0.5206611570247933,LAD,MIN,2023 REG,9,7,8,3,10,17,1,0,4,-4,1,1,1,0,0,0,0,0,0,0.5206611570247933,0.4793388429752067
90536,0.574468085106383,0.46511627906976744,-135,115,0.5517281312179562,0.44827186878204384,home,LAD,under,8.5,0.5,100,0.4793388429752067,LAD,MIN,2023 REG,9,7,8,3,10,17,1,0,4,-4,1,1,1,0,0,0,0,0,0,0.5206611570247933,0.4793388429752067
90537,0.31746031746031744,0.7222222222222222,215,-260,0.3048626858150668,0.6951373141849332,away,TEX,over,7.5,0.5283018867924528,-112,0.5031902949311281,OAK,TEX,2023 REG,3,1,13,6,7,16,0,1,-5,5,1,0,0,0,0,0,0,0,0,0.5031902949311281,0.4968097050688719
90537,0.31746031746031744,0.7222222222222222,215,-260,0.3048626858150668,0.6951373141849332,home,OAK,under,7.5,0.5192307692307692,-108,0.4968097050688719,OAK,TEX,2023 REG,3,1,13,6,7,16,0,1,-5,5,1,0,0,0,0,0,0,0,0,0.5031902949311281,0.4968097050688719
90538,0.7237569060773481,0.31746031746031744,-262,215,0.6939256558926289,0.3060743441073711,away,COL,over,7.5,0.5283018867924528,-112,0.5044173060022736,LAD,COL,2023 REG,7,5,7,2,7,14,1,0,3,-3,1,1,0,0,0,0,0,0,0,0.5044173060022736,0.49558269399772636
90538,0.7237569060773481,0.31746031746031744,-262,215,0.6939256558926289,0.3060743441073711,home,LAD,under,7.5,0.5169082125603864,-107,0.49558269399772636,LAD,COL,2023 REG,7,5,7,2,7,14,1,0,3,-3,1,1,0,0,0,0,0,0,0,0.5044173060022736,0.49558269399772636
90539,0.37037037037037035,0.6666666666666666,170,-200,0.35665294924554186,0.6433470507544581,away,BOS,over,10,0.5098039215686274,-104,0.48592421718142587,KC,BOS,2023 REG,17,13,5,2,15,22,1,0,11,-11,1,1,0,0,0,0,0,0,0,0.48592421718142587,0.5140757828185741
90539,0.37037037037037035,0.6666666666666666,170,-200,0.35665294924554186,0.6433470507544581,home,KC,under,10,0.5370370370370371,-116,0.5140757828185741,KC,BOS,2023 REG,17,13,5,2,15,22,1,0,11,-11,1,1,0,0,0,0,0,0,0,0.48592421718142587,0.5140757828185741
90540,0.4608294930875576,0.5780590717299579,117,-137,0.44290849547579936,0.5570915045242006,away,TEX,over,8.5,0.5454545454545454,-120,0.5206611570247933,NYM,TEX,2023 REG,7,1,6,2,3,13,0,1,-1,1,1,0,0,0,0,0,0,0,0,0.5206611570247933,0.4793388429752067
90540,0.4608294930875576,0.5780590717299579,117,-137,0.44290849547579936,0.5570915045242006,home,NYM,under,8.5,0.5,100,0.4793388429752067,NYM,TEX,2023 REG,7,1,6,2,3,13,0,1,-1,1,1,0,0,0,0,0,0,0,0,0.5206611570247933,0.4793388429752067
90541,0.5238095238095238,0.5145631067961165,-110,-106,0.5037095744446646,0.4962904255553354,away,CHC,over,10,0.5121951219512195,-105,0.48808156828023186,STL,CHC,2023 REG,5,1,10,5,6,15,0,1,-4,4,1,0,0,0,0,0,0,0,0,0.48808156828023186,0.5119184317197681
90541,0.5238095238095238,0.5145631067961165,-110,-106,0.5037095744446646,0.4962904255553354,home,STL,under,10,0.5348837209302326,-115,0.5119184317197681,STL,CHC,2023 REG,5,1,10,5,6,15,0,1,-4,4,1,0,0,0,0,0,0,0,0,0.48808156828023186,0.5119184317197681
90542,0.3508771929824561,0.6923076923076923,185,-225,0.3357246016525795,0.6642753983474206,away,ATL,over,10.5,0.5370370370370371,-116,0.5118817074154765,NYM,ATL,2023 REG,6,3,22,21,24,28,0,1,-18,18,1,1,1,0,0,0,0,0,0,0.5118817074154765,0.48811829258452355
90542,0.3508771929824561,0.6923076923076923,185,-225,0.3357246016525795,0.6642753983474206,home,NYM,under,10.5,0.5098039215686274,-104,0.48811829258452355,NYM,ATL,2023 REG,6,3,22,21,24,28,0,1,-18,18,1,1,1,0,0,0,0,0,0,0.5118817074154765,0.48811829258452355
90543,0.5283018867924528,0.5121951219512195,-112,-105,0.5069072406637203,0.4930927593362797,away,PIT,over,8.5,0.5327102803738317,-114,0.5075272610403079,STL,PIT,2023 REG,6,2,7,4,6,13,0,1,-2,2,1,1,0,0,0,0,0,0,0,0.5075272610403079,0.4924727389596921
90543,0.5283018867924528,0.5121951219512195,-112,-105,0.5069072406637203,0.4930927593362797,home,STL,under,8.5,0.5145631067961165,-106,0.4924727389596921,STL,PIT,2023 REG,6,2,7,4,6,13,0,1,-2,2,1,1,0,0,0,0,0,0,0,0.5075272610403079,0.4924727389596921
90544,0.5,0.5412844036697247,100,-118,0.47935779816513757,0.5206422018348624,away,CHC,over,9,0.5348837209302326,-115,0.5097020142727117,PIT,CHC,2023 REG,7,2,5,1,3,12,1,0,1,-1,1,0,0,0,0,0,0,0,0,0.5097020142727117,0.49029798572728833
90544,0.5,0.5412844036697247,100,-118,0.47935779816513757,0.5206422018348624,home,PIT,under,9,0.5121951219512195,-105,0.49029798572728833,PIT,CHC,2023 REG,7,2,5,1,3,12,1,0,1,-1,1,0,0,0,0,0,0,0,0,0.5097020142727117,0.49029798572728833
90545,0.7333333333333333,0.3105590062111801,-275,222,0.7011456176673567,0.2988543823326433,away,OAK,over,8,0.5283018867924528,-112,0.5044173060022736,MIN,OAK,2023 REG,4,1,4,2,3,8,0,1,-1,1,1,0,0,0,0,0,0,0,0,0.5044173060022736,0.49558269399772636
90545,0.7333333333333333,0.3105590062111801,-275,222,0.7011456176673567,0.2988543823326433,home,MIN,under,8,0.5169082125603864,-107,0.49558269399772636,MIN,OAK,2023 REG,4,1,4,2,3,8,0,1,-1,1,1,0,0,0,0,0,0,0,0,0.5044173060022736,0.49558269399772636
90546,0.38314176245210724,0.6527777777777778,161,-188,0.3693794865019597,0.6306205134980403,away,SEA,over,7.5,0.5348837209302326,-115,0.5097020142727117,OAK,SEA,2023 REG,6,2,11,7,9,17,0,1,-5,5,1,1,0,0,0,0,0,0,0,0.5097020142727117,0.49029798572728833
90546,0.38314176245210724,0.6527777777777778,161,-188,0.3693794865019597,0.6306205134980403,home,OAK,under,7.5,0.5121951219512195,-105,0.49029798572728833,OAK,SEA,2023 REG,6,2,11,7,9,17,0,1,-5,5,1,1,0,0,0,0,0,0,0,0.5097020142727117,0.49029798572728833
90547,0.6610169491525424,0.37735849056603776,-195,165,0.6356501330673793,0.3643498669326207,away,OAK,over,9,0.5412844036697247,-118,0.5162581740877563,BAL,OAK,2023 REG,8,4,15,8,12,23,0,1,-4,4,1,1,1,1,0,0,0,0,0,0.5162581740877563,0.4837418259122437
90547,0.6610169491525424,0.37735849056603776,-195,165,0.6356501330673793,0.3643498669326207,home,BAL,under,9,0.504950495049505,-102,0.4837418259122437,BAL,OAK,2023 REG,8,4,15,8,12,23,0,1,-4,4,1,1,1,1,0,0,0,0,0,0.5162581740877563,0.4837418259122437
90548,0.48780487804878053,0.5555555555555556,105,-125,0.4666534470222751,0.5333465529777248,away,TB,over,8.5,0.5454545454545454,-120,0.5206611570247933,MIN,TB,2023 REG,5,4,9,5,9,14,0,1,-1,1,1,1,1,1,0,0,0,0,0,0.5206611570247933,0.4793388429752067
90548,0.48780487804878053,0.5555555555555556,105,-125,0.4666534470222751,0.5333465529777248,home,MIN,under,8.5,0.5,100,0.4793388429752067,MIN,TB,2023 REG,5,4,9,5,9,14,0,1,-1,1,1,1,1,1,0,0,0,0,0,0.5206611570247933,0.4793388429752067
90549,0.5652173913043479,0.47619047619047616,-130,110,0.5418129444594474,0.4581870555405526,away,SEA,over,7.5,0.5348837209302326,-115,0.5097020142727117,SD,SEA,2023 REG,4,1,8,4,5,12,0,1,-3,3,1,0,0,0,0,0,0,0,0,0.5097020142727117,0.49029798572728833
90549,0.5652173913043479,0.47619047619047616,-130,110,0.5418129444594474,0.4581870555405526,home,SD,under,7.5,0.5121951219512195,-105,0.49029798572728833,SD,SEA,2023 REG,4,1,8,4,5,12,0,1,-3,3,1,0,0,0,0,0,0,0,0,0.5097020142727117,0.49029798572728833
90550,0.574468085106383,0.46511627906976744,-135,115,0.5517281312179562,0.44827186878204384,away,HOU,over,7,0.5024875621890548,-101,0.4794401874631478,SEA,HOU,2023 REG,8,4,7,6,10,15,0,1,-2,2,1,1,1,1,0,0,0,0,0,0.4794401874631478,0.5205598125368522
90550,0.574468085106383,0.46511627906976744,-135,115,0.5517281312179562,0.44827186878204384,home,SEA,under,7,0.5433789954337899,-119,0.5205598125368522,SEA,HOU,2023 REG,8,4,7,6,10,15,0,1,-2,2,1,1,1,1,0,0,0,0,0,0.4794401874631478,0.5205598125368522
90551,0.6108949416342413,0.425531914893617,-157,135,0.5886419592417365,0.41135804075826354,away,BOS,over,9,0.5454545454545454,-120,0.5193043049216726,PHI,BOS,2023 REG,10,4,10,7,11,20,0,1,-3,3,1,1,1,1,0,0,0,0,0,0.5193043049216726,0.48069569507832743
90551,0.6108949416342413,0.425531914893617,-157,135,0.5886419592417365,0.41135804075826354,home,PHI,under,9,0.5024875621890548,-101,0.48069569507832743,PHI,BOS,2023 REG,10,4,10,7,11,20,0,1,-3,3,1,1,1,1,0,0,0,0,0,0.5193043049216726,0.48069569507832743
90552,0.5652173913043479,0.47619047619047616,-130,110,0.5418129444594474,0.4581870555405526,away,MIL,over,9,0.5,100,0.4772727272727273,CHC,MIL,2023 REG,5,2,10,6,8,15,0,1,-4,4,1,1,0,0,0,0,0,0,0,0.4772727272727273,0.5227272727272727
90552,0.5652173913043479,0.47619047619047616,-130,110,0.5418129444594474,0.4581870555405526,home,CHC,under,9,0.5454545454545454,-120,0.5227272727272727,CHC,MIL,2023 REG,5,2,10,6,8,15,0,1,-4,4,1,1,0,0,0,0,0,0,0,0.4772727272727273,0.5227272727272727
90553,0.5121951219512195,0.5305164319248826,-105,-113,0.4903184724049234,0.5096815275950766,away,NYM,over,8.5,0.5348837209302326,-115,0.5097020142727117,STL,NYM,2023 REG,5,2,13,13,15,18,0,1,-11,11,1,1,0,0,0,0,0,0,0,0.5097020142727117,0.49029798572728833
90553,0.5121951219512195,0.5305164319248826,-105,-113,0.4903184724049234,0.5096815275950766,home,STL,under,8.5,0.5121951219512195,-105,0.49029798572728833,STL,NYM,2023 REG,5,2,13,13,15,18,0,1,-11,11,1,1,0,0,0,0,0,0,0,0.5097020142727117,0.49029798572728833
90554,0.6000000000000001,0.43859649122807015,-150,128,0.5768421052631579,0.42315789473684207,away,SD,over,8.5,0.5348837209302326,-115,0.5097020142727117,PHI,SD,2023 REG,10,7,7,6,13,17,1,0,1,-1,1,1,1,1,1,1,0,0,0,0.5097020142727117,0.49029798572728833
90554,0.6000000000000001,0.43859649122807015,-150,128,0.5768421052631579,0.42315789473684207,home,PHI,under,8.5,0.5121951219512195,-105,0.49029798572728833,PHI,SD,2023 REG,10,7,7,6,13,17,1,0,1,-1,1,1,1,1,1,1,0,0,0,0.5097020142727117,0.49029798572728833
90555,0.425531914893617,0.6108949416342413,135,-157,0.41003112488176247,0.5899688751182375,away,TB,over,8.5,0.5215311004784688,-109,0.49907282342437215,BOS,TB,2023 REG,5,2,10,4,6,15,0,1,-2,2,1,1,0,0,0,0,0,0,0,0.49907282342437215,0.5009271765756278
90555,0.425531914893617,0.6108949416342413,135,-157,0.41003112488176247,0.5899688751182375,home,BOS,under,8.5,0.5215311004784688,-109,0.5009271765756278,BOS,TB,2023 REG,5,2,10,4,6,15,0,1,-2,2,1,1,0,0,0,0,0,0,0,0.49907282342437215,0.5009271765756278
90556,0.4,0.6389891696750902,150,-177,0.3844043321299639,0.6155956678700361,away,TB,over,8,0.5121951219512195,-105,0.48808156828023186,CLE,TB,2023 REG,8,3,5,2,5,13,1,0,1,-1,1,1,0,0,0,0,0,0,0,0.48808156828023186,0.5119184317197681
90556,0.4,0.6389891696750902,150,-177,0.3844043321299639,0.6155956678700361,home,CLE,under,8,0.5348837209302326,-115,0.5119184317197681,CLE,TB,2023 REG,8,3,5,2,5,13,1,0,1,-1,1,1,0,0,0,0,0,0,0,0.48808156828023186,0.5119184317197681
90557,0.4366812227074236,0.6031746031746031,129,-152,0.419276931929246,0.580723068070754,away,BAL,over,8,0.5215311004784688,-109,0.49907282342437215,DET,BAL,2023 REG,8,4,9,7,11,17,0,1,-3,3,1,1,1,1,0,0,0,0,0,0.49907282342437215,0.5009271765756278
90557,0.4366812227074236,0.6031746031746031,129,-152,0.419276931929246,0.580723068070754,home,DET,under,8,0.5215311004784688,-109,0.5009271765756278,DET,BAL,2023 REG,8,4,9,7,11,17,0,1,-3,3,1,1,1,1,0,0,0,0,0,0.49907282342437215,0.5009271765756278
90558,0.35460992907801414,0.6923076923076923,182,-225,0.3379724746859196,0.6620275253140804,away,TEX,over,7.5,0.5348837209302326,-115,0.5084354177277668,KC,TEX,2023 REG,1,0,5,4,4,6,0,1,-4,4,0,0,0,0,0,0,0,0,0,0.5084354177277668,0.4915645822722332
90558,0.35460992907801414,0.6923076923076923,182,-225,0.3379724746859196,0.6620275253140804,home,KC,under,7.5,0.5145631067961165,-106,0.4915645822722332,KC,TEX,2023 REG,1,0,5,4,4,6,0,1,-4,4,0,0,0,0,0,0,0,0,0,0.5084354177277668,0.4915645822722332
90559,0.7354497354497355,0.3105590062111801,-278,222,0.7016126185668399,0.2983873814331601,away,KC,over,8,0.5348837209302326,-115,0.5097020142727117,MIN,KC,2023 REG,5,5,4,0,5,9,1,0,5,-5,0,0,0,0,0,0,0,0,0,0.5097020142727117,0.49029798572728833
90559,0.7354497354497355,0.3105590062111801,-278,222,0.7016126185668399,0.2983873814331601,home,MIN,under,8,0.5121951219512195,-105,0.49029798572728833,MIN,KC,2023 REG,5,5,4,0,5,9,1,0,5,-5,0,0,0,0,0,0,0,0,0,0.5097020142727117,0.49029798572728833
90560,0.5370370370370371,0.5024875621890548,-116,-101,0.5158108633785803,0.4841891366214197,away,SD,over,9,0.5327102803738317,-114,0.508788710910954,NYM,SD,2023 REG,8,5,6,2,7,14,1,0,3,-3,1,1,0,0,0,0,0,0,0,0.508788710910954,0.491211289089046
90560,0.5370370370370371,0.5024875621890548,-116,-101,0.5158108633785803,0.4841891366214197,home,NYM,under,9,0.5121951219512195,-105,0.491211289089046,NYM,SD,2023 REG,8,5,6,2,7,14,1,0,3,-3,1,1,0,0,0,0,0,0,0,0.508788710910954,0.491211289089046
90561,0.5951417004048584,0.4424778761061947,-147,126,0.5727527216715597,0.42724727832844034,away,CIN,over,8.5,0.5348837209302326,-115,0.5097020142727117,PIT,CIN,2023 REG,6,4,5,2,6,11,1,0,2,-2,1,1,0,0,0,0,0,0,0,0.5097020142727117,0.49029798572728833
90561,0.5951417004048584,0.4424778761061947,-147,126,0.5727527216715597,0.42724727832844034,home,PIT,under,8.5,0.5121951219512195,-105,0.49029798572728833,PIT,CIN,2023 REG,6,4,5,2,6,11,1,0,2,-2,1,1,0,0,0,0,0,0,0,0.5097020142727117,0.49029798572728833
90562,0.3389830508474576,0.7014925373134329,195,-235,0.3252625124878337,0.6747374875121663,away,CWS,over,9,0.5238095238095238,-110,0.4988662131519274,OAK,CWS,2023 REG,11,7,10,6,13,21,1,0,1,-1,1,1,1,1,1,1,0,0,0,0.4988662131519274,0.5011337868480725
90562,0.3389830508474576,0.7014925373134329,195,-235,0.3252625124878337,0.6747374875121663,home,OAK,under,9,0.5238095238095238,-110,0.5011337868480725,OAK,CWS,2023 REG,11,7,10,6,13,21,1,0,1,-1,1,1,1,1,1,1,0,0,0,0.4988662131519274,0.5011337868480725
90563,0.5391705069124424,0.5024875621890548,-117,-101,0.5167097046779946,0.4832902953220054,away,PHI,over,9,0.5260663507109005,-111,0.5010269332605688,CIN,PHI,2023 REG,10,6,9,2,8,19,1,0,4,-4,1,1,0,0,0,0,0,0,0,0.5010269332605688,0.4989730667394312
90563,0.5391705069124424,0.5024875621890548,-117,-101,0.5167097046779946,0.4832902953220054,home,CIN,under,9,0.5215311004784688,-109,0.4989730667394312,CIN,PHI,2023 REG,10,6,9,2,8,19,1,0,4,-4,1,1,0,0,0,0,0,0,0,0.5010269332605688,0.4989730667394312
90564,0.425531914893617,0.6124031007751938,135,-158,0.4093893550345486,0.5906106449654513,away,SF,over,8.5,0.5454545454545454,-120,0.5206611570247933,PIT,SF,2023 REG,7,1,3,3,4,10,0,1,-2,2,1,0,0,0,0,0,0,0,0,0.5206611570247933,0.4793388429752067
90564,0.425531914893617,0.6124031007751938,135,-158,0.4093893550345486,0.5906106449654513,home,PIT,under,8.5,0.5,100,0.4793388429752067,PIT,SF,2023 REG,7,1,3,3,4,10,0,1,-2,2,1,0,0,0,0,0,0,0,0,0.5206611570247933,0.4793388429752067
90565,0.4444444444444444,0.5918367346938775,125,-145,0.42831947593852354,0.5716805240614764,away,SD,over,10.5,0.5348837209302326,-115,0.5097020142727117,CIN,SD,2023 REG,10,7,9,5,12,19,1,0,2,-2,1,1,1,1,1,0,0,0,0,0.5097020142727117,0.49029798572728833
90565,0.4444444444444444,0.5918367346938775,125,-145,0.42831947593852354,0.5716805240614764,home,CIN,under,10.5,0.5121951219512195,-105,0.49029798572728833,CIN,SD,2023 REG,10,7,9,5,12,19,1,0,2,-2,1,1,1,1,1,0,0,0,0,0.5097020142727117,0.49029798572728833
90566,0.6774193548387096,0.35714285714285715,-210,180,0.6540062434963579,0.34599375650364206,away,CIN,over,8.5,0.5327102803738317,-114,0.508788710910954,SD,CIN,2023 REG,16,8,8,3,11,24,1,0,5,-5,1,1,1,0,0,0,0,0,0,0.508788710910954,0.491211289089046
90566,0.6774193548387096,0.35714285714285715,-210,180,0.6540062434963579,0.34599375650364206,home,SD,under,8.5,0.5121951219512195,-105,0.491211289089046,SD,CIN,2023 REG,16,8,8,3,11,24,1,0,5,-5,1,1,1,0,0,0,0,0,0,0.508788710910954,0.491211289089046
90567,0.38167938931297707,0.6551724137931035,162,-190,0.3676138156083661,0.6323861843916339,away,MIN,over,9.5,0.5,100,0.4772727272727273,KC,MIN,2023 REG,18,10,12,7,17,30,1,0,3,-3,1,1,1,1,1,1,1,0,0,0.4772727272727273,0.5227272727272727
90567,0.38167938931297707,0.6551724137931035,162,-190,0.3676138156083661,0.6323861843916339,home,KC,under,9.5,0.5454545454545454,-120,0.5227272727272727,KC,MIN,2023 REG,18,10,12,7,17,30,1,0,3,-3,1,1,1,1,1,1,1,0,0,0.4772727272727273,0.5227272727272727
90568,0.5121951219512195,0.5305164319248826,-105,-113,0.4903184724049234,0.5096815275950766,away,SEA,over,8,0.5327102803738317,-114,0.5075272610403079,TB,SEA,2023 REG,8,7,7,4,11,15,1,0,3,-3,1,1,1,1,0,0,0,0,0,0.5075272610403079,0.4924727389596921
90568,0.5121951219512195,0.5305164319248826,-105,-113,0.4903184724049234,0.5096815275950766,home,TB,under,8,0.5145631067961165,-106,0.4924727389596921,TB,SEA,2023 REG,8,7,7,4,11,15,1,0,3,-3,1,1,1,1,0,0,0,0,0,0.5075272610403079,0.4924727389596921
90569,0.574468085106383,0.4608294930875576,-135,117,0.5541907529524172,0.44580924704758285,away,TOR,over,9,0.5098039215686274,-104,0.4870219861770517,PHI,TOR,2023 REG,9,8,7,4,12,16,1,0,4,-4,1,1,1,1,0,0,0,0,0,0.4870219861770517,0.5129780138229483
90569,0.574468085106383,0.4608294930875576,-135,117,0.5541907529524172,0.44580924704758285,home,PHI,under,9,0.5348837209302326,-115,0.5129780138229483,PHI,TOR,2023 REG,9,8,7,4,12,16,1,0,4,-4,1,1,1,1,0,0,0,0,0,0.4870219861770517,0.5129780138229483
90570,0.6551724137931035,0.3846153846153846,-190,160,0.6291045458703008,0.37089545412969915,away,CIN,over,10.5,0.5305164319248826,-113,0.5053568787472517,LAD,CIN,2023 REG,2,3,6,2,5,8,1,0,1,-1,1,1,0,0,0,0,0,0,0,0.5053568787472517,0.49464312125274834
90570,0.6551724137931035,0.3846153846153846,-190,160,0.6291045458703008,0.37089545412969915,home,LAD,under,10.5,0.5169082125603864,-107,0.49464312125274834,LAD,CIN,2023 REG,2,3,6,2,5,8,1,0,1,-1,1,1,0,0,0,0,0,0,0,0.5053568787472517,0.49464312125274834
90571,0.5918367346938775,0.4504504504504505,-145,122,0.566809625118663,0.43319037488133705,away,TB,over,8.5,0.5454545454545454,-120,0.5179608869977906,HOU,TB,2023 REG,18,17,7,4,21,25,1,0,13,-13,1,1,1,1,0,0,0,0,0,0.5179608869977906,0.48203911300220936
90571,0.5918367346938775,0.4504504504504505,-145,122,0.566809625118663,0.43319037488133705,home,HOU,under,8.5,0.504950495049505,-102,0.48203911300220936,HOU,TB,2023 REG,18,17,7,4,21,25,1,0,13,-13,1,1,1,1,0,0,0,0,0,0.5179608869977906,0.48203911300220936
90572,0.3333333333333333,0.7118155619596541,200,-247,0.31828370156900415,0.6817162984309959,away,LAD,over,12,0.5121951219512195,-105,0.48808156828023186,COL,LAD,2023 REG,9,4,9,1,5,18,1,0,3,-3,1,0,0,0,0,0,0,0,0,0.48808156828023186,0.5119184317197681
90572,0.3333333333333333,0.7118155619596541,200,-247,0.31828370156900415,0.6817162984309959,home,COL,under,12,0.5348837209302326,-115,0.5119184317197681,COL,LAD,2023 REG,9,4,9,1,5,18,1,0,3,-3,1,0,0,0,0,0,0,0,0,0.48808156828023186,0.5119184317197681
90573,0.42016806722689076,0.6108949416342413,138,-157,0.4071163828314571,0.5928836171685429,away,TB,over,7,0.5412844036697247,-118,0.5162581740877563,CWS,TB,2023 REG,11,5,16,14,19,27,0,1,-9,9,1,1,1,1,1,0,0,0,0,0.5162581740877563,0.4837418259122437
90573,0.42016806722689076,0.6108949416342413,138,-157,0.4071163828314571,0.5928836171685429,home,CWS,under,7,0.504950495049505,-102,0.4837418259122437,CWS,TB,2023 REG,11,5,16,14,19,27,0,1,-9,9,1,1,1,1,1,0,0,0,0,0.5162581740877563,0.4837418259122437
90574,0.5121951219512195,0.5348837209302326,-105,-115,0.48808156828023186,0.5119184317197681,away,MIN,over,8,0.5238095238095238,-110,0.5000596729920038,CLE,MIN,2023 REG,13,6,20,20,26,33,0,1,-14,14,1,1,1,1,1,1,0,0,0,0.5000596729920038,0.4999403270079962
90574,0.5121951219512195,0.5348837209302326,-105,-115,0.48808156828023186,0.5119184317197681,home,CLE,under,8,0.5215311004784688,-109,0.4999403270079962,CLE,MIN,2023 REG,13,6,20,20,26,33,0,1,-14,14,1,1,1,1,1,1,0,0,0,0.5000596729920038,0.4999403270079962
90575,0.35211267605633806,0.6923076923076923,184,-225,0.33647170128027104,0.663528298719729,away,LAD,over,10,0.5121951219512195,-105,0.48808156828023186,WSH,LAD,2023 REG,9,3,14,7,10,23,0,1,-4,4,1,1,1,0,0,0,0,0,0,0.48808156828023186,0.5119184317197681
90575,0.35211267605633806,0.6923076923076923,184,-225,0.33647170128027104,0.663528298719729,home,WSH,under,10,0.5348837209302326,-115,0.5119184317197681,WSH,LAD,2023 REG,9,3,14,7,10,23,0,1,-4,4,1,1,1,0,0,0,0,0,0,0.48808156828023186,0.5119184317197681
90576,0.5454545454545454,0.5,-120,100,0.5206611570247933,0.4793388429752067,away,PIT,over,8.5,0.5475113122171946,-121,0.5214983313199976,NYM,PIT,2023 REG,9,8,7,3,11,16,1,0,5,-5,1,1,1,0,0,0,0,0,0,0.5214983313199976,0.47850166868000243
90576,0.5454545454545454,0.5,-120,100,0.5206611570247933,0.4793388429752067,home,NYM,under,8.5,0.5,100,0.47850166868000243,NYM,PIT,2023 REG,9,8,7,3,11,16,1,0,5,-5,1,1,1,0,0,0,0,0,0,0.5214983313199976,0.47850166868000243
90577,0.5967741935483871,0.4347826086956522,-148,130,0.5779419083382347,0.42205809166176533,away,SF,over,8,0.5121951219512195,-105,0.48919479393107135,MIL,SF,2023 REG,4,1,19,15,16,23,0,1,-14,14,1,0,0,0,0,0,0,0,0,0.48919479393107135,0.5108052060689287
90577,0.5967741935483871,0.4347826086956522,-148,130,0.5779419083382347,0.42205809166176533,home,MIL,under,8,0.5327102803738317,-114,0.5108052060689287,MIL,SF,2023 REG,4,1,19,15,16,23,0,1,-14,14,1,0,0,0,0,0,0,0,0,0.48919479393107135,0.5108052060689287
90578,0.6923076923076923,0.35714285714285715,-225,180,0.658072696534235,0.34192730346576505,away,MIL,over,9,0.5215311004784688,-109,0.4978845547971712,LAD,MIL,2023 REG,10,6,2,2,8,12,1,0,4,-4,1,1,0,0,0,0,0,0,0,0.4978845547971712,0.5021154452028288
90578,0.6923076923076923,0.35714285714285715,-225,180,0.658072696534235,0.34192730346576505,home,LAD,under,9,0.5238095238095238,-110,0.5021154452028288,LAD,MIL,2023 REG,10,6,2,2,8,12,1,0,4,-4,1,1,0,0,0,0,0,0,0,0.4978845547971712,0.5021154452028288
90579,0.5555555555555556,0.48780487804878053,-125,105,0.5314664257753688,0.46853357422463116,away,MIN,over,8,0.5348837209302326,-115,0.5097020142727117,HOU,MIN,2023 REG,8,5,14,7,12,22,0,1,-2,2,1,1,1,1,1,0,0,0,0,0.5097020142727117,0.49029798572728833
90579,0.5555555555555556,0.48780487804878053,-125,105,0.5314664257753688,0.46853357422463116,home,HOU,under,8,0.5121951219512195,-105,0.49029798572728833,HOU,MIN,2023 REG,8,5,14,7,12,22,0,1,-2,2,1,1,1,1,1,0,0,0,0,0.5097020142727117,0.49029798572728833
90580,0.5833333333333333,0.45454545454545453,-140,120,0.5612373737373737,0.4387626262626263,away,BAL,over,8,0.5238095238095238,-110,0.4988662131519274,TB,BAL,2023 REG,7,3,2,0,3,9,1,0,3,-3,0,0,0,0,0,0,0,0,0,0.4988662131519274,0.5011337868480725
90580,0.5833333333333333,0.45454545454545453,-140,120,0.5612373737373737,0.4387626262626263,home,TB,under,8,0.5238095238095238,-110,0.5011337868480725,TB,BAL,2023 REG,7,3,2,0,3,9,1,0,3,-3,0,0,0,0,0,0,0,0,0,0.4988662131519274,0.5011337868480725
90581,0.5454545454545454,0.5,-120,100,0.5206611570247933,0.4793388429752067,away,TB,over,9.5,0.5238095238095238,-110,0.4988662131519274,ARI,TB,2023 REG,8,1,9,6,7,17,0,1,-5,5,1,0,0,0,0,0,0,0,0,0.4988662131519274,0.5011337868480725
90581,0.5454545454545454,0.5,-120,100,0.5206611570247933,0.4793388429752067,home,ARI,under,9.5,0.5238095238095238,-110,0.5011337868480725,ARI,TB,2023 REG,8,1,9,6,7,17,0,1,-5,5,1,0,0,0,0,0,0,0,0,0.4988662131519274,0.5011337868480725
90582,0.6551724137931035,0.3846153846153846,-190,160,0.6291045458703008,0.37089545412969915,away,DET,over,9,0.5348837209302326,-115,0.5109810284308424,STL,DET,2023 REG,9,5,13,6,11,22,0,1,-1,1,1,1,1,1,1,0,0,0,0,0.5109810284308424,0.48901897156915763
90582,0.6551724137931035,0.3846153846153846,-190,160,0.6291045458703008,0.37089545412969915,home,STL,under,9,0.5098039215686274,-104,0.48901897156915763,STL,DET,2023 REG,9,5,13,6,11,22,0,1,-1,1,1,1,1,1,1,0,0,0,0,0.5109810284308424,0.48901897156915763
90583,0.6575342465753424,0.37735849056603776,-192,165,0.6345910769481337,0.36540892305186634,away,WSH,over,8.5,0.5348837209302326,-115,0.5097020142727117,NYM,WSH,2023 REG,8,5,8,1,6,16,1,0,4,-4,1,0,0,0,0,0,0,0,0,0.5097020142727117,0.49029798572728833
90583,0.6575342465753424,0.37735849056603776,-192,165,0.6345910769481337,0.36540892305186634,home,NYM,under,8.5,0.5121951219512195,-105,0.49029798572728833,NYM,WSH,2023 REG,8,5,8,1,6,16,1,0,4,-4,1,0,0,0,0,0,0,0,0,0.5097020142727117,0.49029798572728833
90584,0.5073891625615764,0.5348837209302326,-103,-115,0.4859403596076043,0.5140596403923957,away,MIL,over,10,0.5215311004784688,-109,0.49670754937970685,CIN,MIL,2023 REG,2,0,6,1,1,8,0,1,-1,1,0,0,0,0,0,0,0,0,0,0.49670754937970685,0.5032924506202932
90584,0.5073891625615764,0.5348837209302326,-103,-115,0.4859403596076043,0.5140596403923957,home,CIN,under,10,0.5260663507109005,-111,0.5032924506202932,CIN,MIL,2023 REG,2,0,6,1,1,8,0,1,-1,1,0,0,0,0,0,0,0,0,0,0.49670754937970685,0.5032924506202932
90585,0.7601918465227817,0.2777777777777778,-317,260,0.731327647713963,0.26867235228603703,away,WSH,over,7.5,0.49751243781094534,101,0.47511256217505476,MIN,WSH,2023 REG,9,4,15,10,14,24,0,1,-6,6,1,1,1,1,0,0,0,0,0,0.47511256217505476,0.5248874378249453
90585,0.7601918465227817,0.2777777777777778,-317,260,0.731327647713963,0.26867235228603703,home,MIN,under,7.5,0.5475113122171946,-121,0.5248874378249453,MIN,WSH,2023 REG,9,4,15,10,14,24,0,1,-6,6,1,1,1,1,0,0,0,0,0,0.47511256217505476,0.5248874378249453
90586,0.6575342465753424,0.38167938931297707,-192,162,0.6317499380460364,0.3682500619539636,away,STL,over,8.5,0.5098039215686274,-104,0.48483656587239576,SD,STL,2023 REG,6,2,6,5,7,12,0,1,-3,3,1,1,0,0,0,0,0,0,0,0.48483656587239576,0.5151634341276042
90586,0.6575342465753424,0.38167938931297707,-192,162,0.6317499380460364,0.3682500619539636,home,SD,under,8.5,0.5391705069124424,-117,0.5151634341276042,SD,STL,2023 REG,6,2,6,5,7,12,0,1,-3,3,1,1,0,0,0,0,0,0,0,0.48483656587239576,0.5151634341276042
90587,0.5850622406639003,0.45454545454545453,-141,120,0.5618892737571823,0.43811072624281766,away,TOR,over,8.5,0.5495495495495495,-122,0.5223196169142115,SEA,TOR,2023 REG,5,3,6,4,7,11,0,1,-1,1,1,1,1,0,0,0,0,0,0,0.5223196169142115,0.47768038308578853
90587,0.5850622406639003,0.45454545454545453,-141,120,0.5618892737571823,0.43811072624281766,home,SEA,under,8.5,0.5,100,0.47768038308578853,SEA,TOR,2023 REG,5,3,6,4,7,11,0,1,-1,1,1,1,1,0,0,0,0,0,0,0.5223196169142115,0.47768038308578853
90588,0.47619047619047616,0.5652173913043479,110,-130,0.4564724440500838,0.5435275559499162,away,CLE,over,8.5,0.5454545454545454,-120,0.5206611570247933,LAA,CLE,2023 REG,9,3,9,2,5,18,1,0,1,-1,1,1,0,0,0,0,0,0,0,0.5206611570247933,0.4793388429752067
90588,0.47619047619047616,0.5652173913043479,110,-130,0.4564724440500838,0.5435275559499162,home,LAA,under,8.5,0.5,100,0.4793388429752067,LAA,CLE,2023 REG,9,3,9,2,5,18,1,0,1,-1,1,1,0,0,0,0,0,0,0,0.5206611570247933,0.4793388429752067
90589,0.5,0.5454545454545454,100,-120,0.4772727272727273,0.5227272727272727,away,HOU,over,8,0.5121951219512195,-105,0.48808156828023186,SEA,HOU,2023 REG,8,3,14,8,11,22,0,1,-5,5,1,1,1,0,0,0,0,0,0,0.48808156828023186,0.5119184317197681
90589,0.5,0.5454545454545454,100,-120,0.4772727272727273,0.5227272727272727,home,SEA,under,8,0.5348837209302326,-115,0.5119184317197681,SEA,HOU,2023 REG,8,3,14,8,11,22,0,1,-5,5,1,1,1,0,0,0,0,0,0,0.48808156828023186,0.5119184317197681
90590,0.5192307692307692,0.5238095238095238,-108,-110,0.49688292476754015,0.5031170752324599,away,BAL,over,9,0.5169082125603864,-107,0.49353874091423283,MIL,BAL,2023 REG,8,3,10,6,9,18,0,1,-3,3,1,1,1,0,0,0,0,0,0,0.49353874091423283,0.5064612590857671
90590,0.5192307692307692,0.5238095238095238,-108,-110,0.49688292476754015,0.5031170752324599,home,MIL,under,9,0.5283018867924528,-112,0.5064612590857671,MIL,BAL,2023 REG,8,3,10,6,9,18,0,1,-3,3,1,1,1,0,0,0,0,0,0,0.49353874091423283,0.5064612590857671
90591,0.613899613899614,0.425531914893617,-159,135,0.589692613597978,0.410307386402022,away,PIT,over,9,0.5121951219512195,-105,0.48808156828023186,STL,PIT,2023 REG,9,3,8,0,3,17,1,0,3,-3,0,0,0,0,0,0,0,0,0,0.48808156828023186,0.5119184317197681
90591,0.613899613899614,0.425531914893617,-159,135,0.589692613597978,0.410307386402022,home,STL,under,9,0.5348837209302326,-115,0.5119184317197681,STL,PIT,2023 REG,9,3,8,0,3,17,1,0,3,-3,0,0,0,0,0,0,0,0,0,0.48808156828023186,0.5119184317197681
90592,0.5145631067961165,0.5238095238095238,-106,-110,0.4948179667757384,0.5051820332242616,away,BAL,over,8.5,0.5348837209302326,-115,0.5097020142727117,NYY,BAL,2023 REG,11,6,12,3,9,23,1,0,3,-3,1,1,1,0,0,0,0,0,0,0.5097020142727117,0.49029798572728833
90592,0.5145631067961165,0.5238095238095238,-106,-110,0.4948179667757384,0.5051820332242616,home,NYY,under,8.5,0.5121951219512195,-105,0.49029798572728833,NYY,BAL,2023 REG,11,6,12,3,9,23,1,0,3,-3,1,1,1,0,0,0,0,0,0,0.5097020142727117,0.49029798572728833
90593,0.5,0.5454545454545454,100,-120,0.4772727272727273,0.5227272727272727,away,BOS,over,8.5,0.5121951219512195,-105,0.48808156828023186,SF,BOS,2023 REG,11,3,5,2,5,16,1,0,1,-1,1,1,0,0,0,0,0,0,0,0.48808156828023186,0.5119184317197681
90593,0.5,0.5454545454545454,100,-120,0.4772727272727273,0.5227272727272727,home,SF,under,8.5,0.5348837209302326,-115,0.5119184317197681,SF,BOS,2023 REG,11,3,5,2,5,16,1,0,1,-1,1,1,0,0,0,0,0,0,0,0.48808156828023186,0.5119184317197681
90594,0.6774193548387096,0.36363636363636365,-210,175,0.6496074165168858,0.3503925834831142,away,WSH,over,8.5,0.5145631067961165,-106,0.49023796582517226,SD,WSH,2023 REG,8,3,11,8,11,19,0,1,-5,5,1,1,1,0,0,0,0,0,0,0.49023796582517226,0.5097620341748277
90594,0.6774193548387096,0.36363636363636365,-210,175,0.6496074165168858,0.3503925834831142,home,SD,under,8.5,0.5327102803738317,-114,0.5097620341748277,SD,WSH,2023 REG,8,3,11,8,11,19,0,1,-5,5,1,1,1,0,0,0,0,0,0,0.49023796582517226,0.5097620341748277
90595,0.5412844036697247,0.504950495049505,-118,-102,0.5162581740877563,0.4837418259122437,away,CLE,over,9.5,0.5145631067961165,-106,0.49023796582517226,CIN,CLE,2023 REG,6,0,7,3,3,13,0,1,-3,3,0,0,0,0,0,0,0,0,0,0.49023796582517226,0.5097620341748277
90595,0.5412844036697247,0.504950495049505,-118,-102,0.5162581740877563,0.4837418259122437,home,CIN,under,9.5,0.5327102803738317,-114,0.5097620341748277,CIN,CLE,2023 REG,6,0,7,3,3,13,0,1,-3,3,0,0,0,0,0,0,0,0,0,0.49023796582517226,0.5097620341748277
90596,0.4,0.6376811594202898,150,-176,0.384927536231884,0.615072463768116,away,BAL,over,8.5,0.5454545454545454,-120,0.5179608869977906,OAK,BAL,2023 REG,6,2,9,7,9,15,0,1,-5,5,1,1,0,0,0,0,0,0,0,0.5179608869977906,0.48203911300220936
90596,0.4,0.6376811594202898,150,-176,0.384927536231884,0.615072463768116,home,OAK,under,8.5,0.504950495049505,-102,0.48203911300220936,OAK,BAL,2023 REG,6,2,9,7,9,15,0,1,-5,5,1,1,0,0,0,0,0,0,0,0.5179608869977906,0.48203911300220936
90597,0.607843137254902,0.43103448275862066,-155,132,0.5842116427368785,0.41578835726312147,away,SD,over,9,0.5454545454545454,-120,0.5193043049216726,LAD,SD,2023 REG,11,11,5,2,13,16,1,0,9,-9,1,1,0,0,0,0,0,0,0,0.5193043049216726,0.48069569507832743
90597,0.607843137254902,0.43103448275862066,-155,132,0.5842116427368785,0.41578835726312147,home,LAD,under,9,0.5024875621890548,-101,0.48069569507832743,LAD,SD,2023 REG,11,11,5,2,13,16,1,0,9,-9,1,1,0,0,0,0,0,0,0,0.5193043049216726,0.48069569507832743
90598,0.6428571428571428,0.3921568627450981,-180,155,0.6203481392557023,0.3796518607442977,away,HOU,over,7.5,0.5283018867924528,-112,0.5044173060022736,TB,HOU,2023 REG,5,0,11,5,5,16,0,1,-5,5,0,0,0,0,0,0,0,0,0,0.5044173060022736,0.49558269399772636
90598,0.6428571428571428,0.3921568627450981,-180,155,0.6203481392557023,0.3796518607442977,home,TB,under,7.5,0.5169082125603864,-107,0.49558269399772636,TB,HOU,2023 REG,5,0,11,5,5,16,0,1,-5,5,0,0,0,0,0,0,0,0,0,0.5044173060022736,0.49558269399772636
90599,0.5867768595041323,0.45454545454545453,-142,120,0.5625298818386723,0.43747011816132775,away,BAL,over,8.5,0.5121951219512195,-105,0.48808156828023186,ARI,BAL,2023 REG,9,5,14,8,13,23,0,1,-3,3,1,1,1,1,1,0,0,0,0,0.48808156828023186,0.5119184317197681
90599,0.5867768595041323,0.45454545454545453,-142,120,0.5625298818386723,0.43747011816132775,home,ARI,under,8.5,0.5348837209302326,-115,0.5119184317197681,ARI,BAL,2023 REG,9,5,14,8,13,23,0,1,-3,3,1,1,1,1,1,0,0,0,0,0.48808156828023186,0.5119184317197681
90600,0.5121951219512195,0.5348837209302326,-105,-115,0.48808156828023186,0.5119184317197681,away,NYY,over,9.5,0.5348837209302326,-115,0.5097020142727117,BOS,NYY,2023 REG,9,5,12,8,13,21,0,1,-3,3,1,1,1,1,1,0,0,0,0,0.5097020142727117,0.49029798572728833
90600,0.5121951219512195,0.5348837209302326,-105,-115,0.48808156828023186,0.5119184317197681,home,BOS,under,9.5,0.5121951219512195,-105,0.49029798572728833,BOS,NYY,2023 REG,9,5,12,8,13,21,0,1,-3,3,1,1,1,1,1,0,0,0,0,0.5097020142727117,0.49029798572728833
90601,0.6825396825396826,0.3508771929824561,-215,185,0.6597313389293339,0.3402686610706661,away,OAK,over,8,0.5348837209302326,-115,0.5097020142727117,MIA,OAK,2023 REG,14,12,8,1,13,22,1,0,11,-11,1,0,0,0,0,0,0,0,0,0.5097020142727117,0.49029798572728833
90601,0.6825396825396826,0.3508771929824561,-215,185,0.6597313389293339,0.3402686610706661,home,MIA,under,8,0.5121951219512195,-105,0.49029798572728833,MIA,OAK,2023 REG,14,12,8,1,13,22,1,0,11,-11,1,0,0,0,0,0,0,0,0,0.5097020142727117,0.49029798572728833
90602,0.6453900709219857,0.3921568627450981,-182,155,0.6211576527396834,0.3788423472603166,away,NYY,over,8.5,0.5348837209302326,-115,0.5097020142727117,TB,NYY,2023 REG,7,5,8,4,9,15,1,0,1,-1,1,1,1,1,0,0,0,0,0,0.5097020142727117,0.49029798572728833
90602,0.6453900709219857,0.3921568627450981,-182,155,0.6211576527396834,0.3788423472603166,home,TB,under,8.5,0.5121951219512195,-105,0.49029798572728833,TB,NYY,2023 REG,7,5,8,4,9,15,1,0,1,-1,1,1,1,1,0,0,0,0,0,0.5097020142727117,0.49029798572728833
90603,0.5475113122171946,0.49019607843137253,-121,104,0.5268660892829112,0.47313391071708877,away,ARI,over,8,0.5215311004784688,-109,0.4978845547971712,SD,ARI,2023 REG,3,1,3,3,4,6,0,1,-2,2,1,0,0,0,0,0,0,0,0,0.4978845547971712,0.5021154452028288
90603,0.5475113122171946,0.49019607843137253,-121,104,0.5268660892829112,0.47313391071708877,home,SD,under,8,0.5238095238095238,-110,0.5021154452028288,SD,ARI,2023 REG,3,1,3,3,4,6,0,1,-2,2,1,0,0,0,0,0,0,0,0,0.4978845547971712,0.5021154452028288
90604,0.6644295302013422,0.37593984962406013,-198,166,0.6376069221294306,0.3623930778705694,away,WSH,over,9,0.5348837209302326,-115,0.5097020142727117,STL,WSH,2023 REG,6,5,8,7,12,14,0,1,-2,2,1,1,1,1,1,0,0,0,0,0.5097020142727117,0.49029798572728833
90604,0.6644295302013422,0.37593984962406013,-198,166,0.6376069221294306,0.3623930778705694,home,STL,under,9,0.5121951219512195,-105,0.49029798572728833,STL,WSH,2023 REG,6,5,8,7,12,14,0,1,-2,2,1,1,1,1,1,0,0,0,0,0.5097020142727117,0.49029798572728833
90605,0.5098039215686274,0.5348837209302326,-104,-115,0.4870219861770517,0.5129780138229483,away,CIN,over,9,0.5454545454545454,-120,0.5206611570247933,STL,CIN,2023 REG,6,2,17,19,21,23,0,1,-17,17,1,1,0,0,0,0,0,0,0,0.5206611570247933,0.4793388429752067
90605,0.5098039215686274,0.5348837209302326,-104,-115,0.4870219861770517,0.5129780138229483,home,STL,under,9,0.5,100,0.4793388429752067,STL,CIN,2023 REG,6,2,17,19,21,23,0,1,-17,17,1,1,0,0,0,0,0,0,0,0.5206611570247933,0.4793388429752067
90606,0.6551724137931035,0.3846153846153846,-190,160,0.6291045458703008,0.37089545412969915,away,WSH,over,8.5,0.5238095238095238,-110,0.4988662131519274,MIL,WSH,2023 REG,7,5,6,3,8,13,1,0,2,-2,1,1,1,0,0,0,0,0,0,0.4988662131519274,0.5011337868480725
90606,0.6551724137931035,0.3846153846153846,-190,160,0.6291045458703008,0.37089545412969915,home,MIL,under,8.5,0.5238095238095238,-110,0.5011337868480725,MIL,WSH,2023 REG,7,5,6,3,8,13,1,0,2,-2,1,1,1,0,0,0,0,0,0,0.4988662131519274,0.5011337868480725
90607,0.3508771929824561,0.6923076923076923,185,-225,0.3357246016525795,0.6642753983474206,away,HOU,over,9,0.5454545454545454,-120,0.5206611570247933,ARI,HOU,2023 REG,6,1,9,8,9,15,0,1,-7,7,1,0,0,0,0,0,0,0,0,0.5206611570247933,0.4793388429752067
90607,0.3508771929824561,0.6923076923076923,185,-225,0.3357246016525795,0.6642753983474206,home,ARI,under,9,0.5,100,0.4793388429752067,ARI,HOU,2023 REG,6,1,9,8,9,15,0,1,-7,7,1,0,0,0,0,0,0,0,0,0.5206611570247933,0.4793388429752067
90608,0.5454545454545454,0.5,-120,100,0.5206611570247933,0.4793388429752067,away,ARI,over,10,0.5348837209302326,-115,0.5097020142727117,LAA,ARI,2023 REG,3,1,9,3,4,12,0,1,-2,2,1,0,0,0,0,0,0,0,0,0.5097020142727117,0.49029798572728833
90608,0.5454545454545454,0.5,-120,100,0.5206611570247933,0.4793388429752067,home,LAA,under,10,0.5121951219512195,-105,0.49029798572728833,LAA,ARI,2023 REG,3,1,9,3,4,12,0,1,-2,2,1,0,0,0,0,0,0,0,0,0.5097020142727117,0.49029798572728833
90609,0.3921568627450981,0.6428571428571428,155,-180,0.37842588015598405,0.6215741198440159,away,BOS,over,9,0.5,100,0.4772727272727273,OAK,BOS,2023 REG,7,3,5,0,3,12,1,0,3,-3,0,0,0,0,0,0,0,0,0,0.4772727272727273,0.5227272727272727
90609,0.3921568627450981,0.6428571428571428,155,-180,0.37842588015598405,0.6215741198440159,home,OAK,under,9,0.5454545454545454,-120,0.5227272727272727,OAK,BOS,2023 REG,7,3,5,0,3,12,1,0,3,-3,0,0,0,0,0,0,0,0,0,0.4772727272727273,0.5227272727272727
90610,0.6226415094339623,0.41152263374485604,-165,143,0.6013694957565848,0.3986305042434152,away,CIN,over,7.5,0.5454545454545454,-120,0.5206611570247933,CHC,CIN,2023 REG,9,5,14,8,13,23,0,1,-3,3,1,1,1,1,1,0,0,0,0,0.5206611570247933,0.4793388429752067
90610,0.6226415094339623,0.41152263374485604,-165,143,0.6013694957565848,0.3986305042434152,home,CHC,under,7.5,0.5,100,0.4793388429752067,CHC,CIN,2023 REG,9,5,14,8,13,23,0,1,-3,3,1,1,1,1,1,0,0,0,0,0.5206611570247933,0.4793388429752067
90611,0.6610169491525424,0.3802281368821293,-195,163,0.6337532482143695,0.3662467517856305,away,CIN,over,7,0.5475113122171946,-121,0.5242087833606768,PHI,CIN,2023 REG,10,5,6,2,7,16,1,0,3,-3,1,1,0,0,0,0,0,0,0,0.5242087833606768,0.4757912166393232
90611,0.6610169491525424,0.3802281368821293,-195,163,0.6337532482143695,0.3662467517856305,home,PHI,under,7,0.49504950495049505,102,0.4757912166393232,PHI,CIN,2023 REG,10,5,6,2,7,16,1,0,3,-3,1,1,0,0,0,0,0,0,0,0.5242087833606768,0.4757912166393232
90612,0.5238095238095238,0.5238095238095238,-110,-110,0.4988662131519274,0.5011337868480725,away,BAL,over,9.5,0.5,100,0.47935779816513757,PHI,BAL,2023 REG,9,6,8,4,10,17,1,0,2,-2,1,1,1,1,0,0,0,0,0,0.47935779816513757,0.5206422018348624
90612,0.5238095238095238,0.5238095238095238,-110,-110,0.4988662131519274,0.5011337868480725,home,PHI,under,9.5,0.5412844036697247,-118,0.5206422018348624,PHI,BAL,2023 REG,9,6,8,4,10,17,1,0,2,-2,1,1,1,1,0,0,0,0,0,0.47935779816513757,0.5206422018348624
90613,0.6296296296296295,0.41152263374485604,-170,143,0.6037189452827312,0.3962810547172688,away,BOS,over,9,0.5238095238095238,-110,0.4988662131519274,TOR,BOS,2023 REG,10,6,13,7,13,23,0,1,-1,1,1,1,1,1,1,1,0,0,0,0.4988662131519274,0.5011337868480725
90613,0.6296296296296295,0.41152263374485604,-170,143,0.6037189452827312,0.3962810547172688,home,TOR,under,9,0.5238095238095238,-110,0.5011337868480725,TOR,BOS,2023 REG,10,6,13,7,13,23,0,1,-1,1,1,1,1,1,1,1,0,0,0,0.4988662131519274,0.5011337868480725
90614,0.5726495726495727,0.4672897196261683,-134,114,0.5497783539959433,0.4502216460040567,away,MIN,over,8.5,0.5348837209302326,-115,0.5097020142727117,CIN,MIN,2023 REG,6,3,9,5,8,15,0,1,-2,2,1,1,1,0,0,0,0,0,0,0.5097020142727117,0.49029798572728833
90614,0.5726495726495727,0.4672897196261683,-134,114,0.5497783539959433,0.4502216460040567,home,CIN,under,8.5,0.5121951219512195,-105,0.49029798572728833,CIN,MIN,2023 REG,6,3,9,5,8,15,0,1,-2,2,1,1,1,0,0,0,0,0,0,0.5097020142727117,0.49029798572728833
90615,0.5555555555555556,0.48780487804878053,-125,105,0.5314664257753688,0.46853357422463116,away,CHC,over,9,0.5215311004784688,-109,0.4978845547971712,MIA,CHC,2023 REG,12,7,9,6,13,21,1,0,1,-1,1,1,1,1,1,1,0,0,0,0.4978845547971712,0.5021154452028288
90615,0.5555555555555556,0.48780487804878053,-125,105,0.5314664257753688,0.46853357422463116,home,MIA,under,9,0.5238095238095238,-110,0.5021154452028288,MIA,CHC,2023 REG,12,7,9,6,13,21,1,0,1,-1,1,1,1,1,1,1,0,0,0,0.4978845547971712,0.5021154452028288
90616,0.6108949416342413,0.42372881355932196,-157,136,0.5897434647261112,0.41025653527388883,away,DET,over,9,0.5073891625615764,-103,0.4837652908580103,CWS,DET,2023 REG,6,3,6,0,3,12,1,0,3,-3,0,0,0,0,0,0,0,0,0,0.4837652908580103,0.5162347091419897
90616,0.6108949416342413,0.42372881355932196,-157,136,0.5897434647261112,0.41025653527388883,home,CWS,under,9,0.5391705069124424,-117,0.5162347091419897,CWS,DET,2023 REG,6,3,6,0,3,12,1,0,3,-3,0,0,0,0,0,0,0,0,0,0.4837652908580103,0.5162347091419897
90617,0.5918367346938775,0.4444444444444444,-145,125,0.5703642001018094,0.42963579989819056,away,BOS,over,8,0.5327102803738317,-114,0.508788710910954,TOR,BOS,2023 REG,4,3,5,0,3,9,1,0,3,-3,0,0,0,0,0,0,0,0,0,0.508788710910954,0.491211289089046
90617,0.5918367346938775,0.4444444444444444,-145,125,0.5703642001018094,0.42963579989819056,home,TOR,under,8,0.5121951219512195,-105,0.491211289089046,TOR,BOS,2023 REG,4,3,5,0,3,9,1,0,3,-3,0,0,0,0,0,0,0,0,0,0.508788710910954,0.491211289089046
90618,0.425531914893617,0.6153846153846154,135,-160,0.4081206254135181,0.5918793745864819,away,ARI,over,12.5,0.5348837209302326,-115,0.5097020142727117,COL,ARI,2023 REG,10,5,14,8,13,24,0,1,-3,3,1,1,1,1,1,0,0,0,0,0.5097020142727117,0.49029798572728833
90618,0.425531914893617,0.6153846153846154,135,-160,0.4081206254135181,0.5918793745864819,home,COL,under,12.5,0.5121951219512195,-105,0.49029798572728833,COL,ARI,2023 REG,10,5,14,8,13,24,0,1,-3,3,1,1,1,1,1,0,0,0,0,0.5097020142727117,0.49029798572728833
90619,0.6212121212121212,0.42194092827004215,-164,137,0.5944049238065348,0.40559507619346524,away,CWS,over,8.5,0.5,100,0.4772727272727273,CLE,CWS,2023 REG,9,4,7,2,6,16,1,0,2,-2,1,1,0,0,0,0,0,0,0,0.4772727272727273,0.5227272727272727
90619,0.6212121212121212,0.42194092827004215,-164,137,0.5944049238065348,0.40559507619346524,home,CLE,under,8.5,0.5454545454545454,-120,0.5227272727272727,CLE,CWS,2023 REG,9,4,7,2,6,16,1,0,2,-2,1,1,0,0,0,0,0,0,0,0.4772727272727273,0.5227272727272727
90620,0.6226415094339623,0.41152263374485604,-165,143,0.6013694957565848,0.3986305042434152,away,KC,over,7.5,0.5192307692307692,-108,0.49688292476754015,MIA,KC,2023 REG,7,6,5,1,7,12,1,0,5,-5,1,0,0,0,0,0,0,0,0,0.49688292476754015,0.5031170752324599
90620,0.6226415094339623,0.41152263374485604,-165,143,0.6013694957565848,0.3986305042434152,home,MIA,under,7.5,0.5238095238095238,-110,0.5031170752324599,MIA,KC,2023 REG,7,6,5,1,7,12,1,0,5,-5,1,0,0,0,0,0,0,0,0,0.49688292476754015,0.5031170752324599
90621,0.6453900709219857,0.38759689922480617,-182,158,0.6241006079194462,0.3758993920805538,away,DET,over,9,0.5121951219512195,-105,0.48808156828023186,PHI,DET,2023 REG,3,1,3,0,1,6,1,0,1,-1,0,0,0,0,0,0,0,0,0,0.48808156828023186,0.5119184317197681
90621,0.6453900709219857,0.38759689922480617,-182,158,0.6241006079194462,0.3758993920805538,home,PHI,under,9,0.5348837209302326,-115,0.5119184317197681,PHI,DET,2023 REG,3,1,3,0,1,6,1,0,1,-1,0,0,0,0,0,0,0,0,0,0.48808156828023186,0.5119184317197681
90622,0.5833333333333333,0.45454545454545453,-140,120,0.5612373737373737,0.4387626262626263,away,BOS,over,9,0.5,100,0.4772727272727273,TOR,BOS,2023 REG,3,0,9,5,5,12,0,1,-5,5,0,0,0,0,0,0,0,0,0,0.4772727272727273,0.5227272727272727
90622,0.5833333333333333,0.45454545454545453,-140,120,0.5612373737373737,0.4387626262626263,home,TOR,under,9,0.5454545454545454,-120,0.5227272727272727,TOR,BOS,2023 REG,3,0,9,5,5,12,0,1,-5,5,0,0,0,0,0,0,0,0,0,0.4772727272727273,0.5227272727272727
90623,0.45454545454545453,0.5918367346938775,120,-145,0.433462641254849,0.566537358745151,away,CLE,over,9,0.5121951219512195,-105,0.48808156828023186,KC,CLE,2023 REG,5,1,14,14,15,19,0,1,-13,13,1,0,0,0,0,0,0,0,0,0.48808156828023186,0.5119184317197681
90623,0.45454545454545453,0.5918367346938775,120,-145,0.433462641254849,0.566537358745151,home,KC,under,9,0.5348837209302326,-115,0.5119184317197681,KC,CLE,2023 REG,5,1,14,14,15,19,0,1,-13,13,1,0,0,0,0,0,0,0,0,0.48808156828023186,0.5119184317197681
90624,0.6363636363636364,0.4081632653061224,-175,145,0.6080283353010626,0.3919716646989374,away,SF,over,7.5,0.5238095238095238,-110,0.4988662131519274,SD,SF,2023 REG,6,6,5,1,7,11,1,0,5,-5,1,0,0,0,0,0,0,0,0,0.4988662131519274,0.5011337868480725
90624,0.6363636363636364,0.4081632653061224,-175,145,0.6080283353010626,0.3919716646989374,home,SD,under,7.5,0.5238095238095238,-110,0.5011337868480725,SD,SF,2023 REG,6,6,5,1,7,11,1,0,5,-5,1,0,0,0,0,0,0,0,0,0.4988662131519274,0.5011337868480725
90625,0.4081632653061224,0.6296296296296295,145,-170,0.39273759390377466,0.6072624060962253,away,SD,over,8.5,0.5370370370370371,-116,0.5131785224377817,OAK,SD,2023 REG,6,1,13,10,11,19,0,1,-9,9,1,0,0,0,0,0,0,0,0,0.5131785224377817,0.4868214775622183
90625,0.4081632653061224,0.6296296296296295,145,-170,0.39273759390377466,0.6072624060962253,home,OAK,under,8.5,0.5073891625615764,-103,0.4868214775622183,OAK,SD,2023 REG,6,1,13,10,11,19,0,1,-9,9,1,0,0,0,0,0,0,0,0,0.5131785224377817,0.4868214775622183
90626,0.5555555555555556,0.48309178743961345,-125,107,0.5340848094471283,0.46591519055287167,away,PIT,over,7.5,0.5145631067961165,-106,0.4913668392989033,MIA,PIT,2023 REG,10,6,5,4,10,15,1,0,2,-2,1,1,1,1,0,0,0,0,0,0.4913668392989033,0.5086331607010968
90626,0.5555555555555556,0.48309178743961345,-125,107,0.5340848094471283,0.46591519055287167,home,MIA,under,7.5,0.5305164319248826,-113,0.5086331607010968,MIA,PIT,2023 REG,10,6,5,4,10,15,1,0,2,-2,1,1,1,1,0,0,0,0,0,0.4913668392989033,0.5086331607010968
90627,0.6666666666666666,0.37735849056603776,-200,165,0.6373165618448637,0.36268343815513626,away,BAL,over,7.5,0.5454545454545454,-120,0.5206611570247933,TB,BAL,2023 REG,7,5,7,6,11,14,0,1,-1,1,1,1,1,1,1,0,0,0,0,0.5206611570247933,0.4793388429752067
90627,0.6666666666666666,0.37735849056603776,-200,165,0.6373165618448637,0.36268343815513626,home,TB,under,7.5,0.5,100,0.4793388429752067,TB,BAL,2023 REG,7,5,7,6,11,14,0,1,-1,1,1,1,1,1,1,0,0,0,0,0.5206611570247933,0.4793388429752067
90628,0.45454545454545453,0.5867768595041323,120,-142,0.43576258452291505,0.564237415477085,away,STL,over,11.5,0.5121951219512195,-105,0.48919479393107135,COL,STL,2023 REG,13,7,6,4,11,19,1,0,3,-3,1,1,1,1,0,0,0,0,0,0.48919479393107135,0.5108052060689287
90628,0.45454545454545453,0.5867768595041323,120,-142,0.43576258452291505,0.564237415477085,home,COL,under,11.5,0.5327102803738317,-114,0.5108052060689287,COL,STL,2023 REG,13,7,6,4,11,19,1,0,3,-3,1,1,1,1,0,0,0,0,0,0.48919479393107135,0.5108052060689287
90629,0.5833333333333333,0.45454545454545453,-140,120,0.5612373737373737,0.4387626262626263,away,SD,over,9,0.5283018867924528,-112,0.5044173060022736,NYM,SD,2023 REG,5,2,9,4,6,14,0,1,-2,2,1,1,0,0,0,0,0,0,0,0.5044173060022736,0.49558269399772636
90629,0.5833333333333333,0.45454545454545453,-140,120,0.5612373737373737,0.4387626262626263,home,NYM,under,9,0.5169082125603864,-107,0.49558269399772636,NYM,SD,2023 REG,5,2,9,4,6,14,0,1,-2,2,1,1,0,0,0,0,0,0,0,0.5044173060022736,0.49558269399772636
90630,0.6296296296296295,0.4081632653061224,-170,145,0.6058341031886005,0.39416589681139946,away,CLE,over,9,0.5,100,0.47522522522522526,TEX,CLE,2023 REG,5,2,8,0,2,13,1,0,2,-2,0,0,0,0,0,0,0,0,0,0.47522522522522526,0.5247747747747747
90630,0.6296296296296295,0.4081632653061224,-170,145,0.6058341031886005,0.39416589681139946,home,TEX,under,9,0.5495495495495495,-122,0.5247747747747747,TEX,CLE,2023 REG,5,2,8,0,2,13,1,0,2,-2,0,0,0,0,0,0,0,0,0,0.47522522522522526,0.5247747747747747
90631,0.6000000000000001,0.43859649122807015,-150,128,0.5768421052631579,0.42315789473684207,away,NYM,over,9,0.5238095238095238,-110,0.4988662131519274,STL,NYM,2023 REG,6,1,13,7,8,19,0,1,-6,6,1,0,0,0,0,0,0,0,0,0.4988662131519274,0.5011337868480725
90631,0.6000000000000001,0.43859649122807015,-150,128,0.5768421052631579,0.42315789473684207,home,STL,under,9,0.5238095238095238,-110,0.5011337868480725,STL,NYM,2023 REG,6,1,13,7,8,19,0,1,-6,6,1,0,0,0,0,0,0,0,0,0.4988662131519274,0.5011337868480725
90632,0.6923076923076923,0.35211267605633806,-225,184,0.6615551295941329,0.3384448704058671,away,OAK,over,8,0.5121951219512195,-105,0.48808156828023186,MIN,OAK,2023 REG,8,11,8,3,14,16,1,0,8,-8,1,1,1,0,0,0,0,0,0,0.48808156828023186,0.5119184317197681
90632,0.6923076923076923,0.35211267605633806,-225,184,0.6615551295941329,0.3384448704058671,home,MIN,under,8,0.5348837209302326,-115,0.5119184317197681,MIN,OAK,2023 REG,8,11,8,3,14,16,1,0,8,-8,1,1,1,0,0,0,0,0,0,0.48808156828023186,0.5119184317197681
90633,0.5121951219512195,0.5348837209302326,-105,-115,0.48808156828023186,0.5119184317197681,away,SD,over,9.5,0.5348837209302326,-115,0.5097020142727117,PHI,SD,2023 REG,7,3,11,8,11,18,0,1,-5,5,1,1,1,0,0,0,0,0,0,0.5097020142727117,0.49029798572728833
90633,0.5121951219512195,0.5348837209302326,-105,-115,0.48808156828023186,0.5119184317197681,home,PHI,under,9.5,0.5121951219512195,-105,0.49029798572728833,PHI,SD,2023 REG,7,3,11,8,11,18,0,1,-5,5,1,1,1,0,0,0,0,0,0,0.5097020142727117,0.49029798572728833
90634,0.576271186440678,0.4629629629629629,-136,116,0.553661676614851,0.446338323385149,away,CLE,over,9,0.5,100,0.4772727272727273,CWS,CLE,2023 REG,12,7,6,2,9,18,1,0,5,-5,1,1,0,0,0,0,0,0,0,0.4772727272727273,0.5227272727272727
90634,0.576271186440678,0.4629629629629629,-136,116,0.553661676614851,0.446338323385149,home,CWS,under,9,0.5454545454545454,-120,0.5227272727272727,CWS,CLE,2023 REG,12,7,6,2,9,18,1,0,5,-5,1,1,0,0,0,0,0,0,0,0.4772727272727273,0.5227272727272727
90635,0.6666666666666666,0.37037037037037035,-200,170,0.6419753086419753,0.3580246913580247,away,STL,over,10.5,0.5121951219512195,-105,0.48808156828023186,ATL,STL,2023 REG,11,6,12,10,16,23,0,1,-4,4,1,1,1,1,1,1,0,0,0,0.48808156828023186,0.5119184317197681
90635,0.6666666666666666,0.37037037037037035,-200,170,0.6419753086419753,0.3580246913580247,home,ATL,under,10.5,0.5348837209302326,-115,0.5119184317197681,ATL,STL,2023 REG,11,6,12,10,16,23,0,1,-4,4,1,1,1,1,1,1,0,0,0,0.48808156828023186,0.5119184317197681
90636,0.48780487804878053,0.5555555555555556,105,-125,0.4666534470222751,0.5333465529777248,away,NYM,over,9,0.5283018867924528,-112,0.5044173060022736,SF,NYM,2023 REG,8,5,8,4,9,16,1,0,1,-1,1,1,1,1,0,0,0,0,0,0.5044173060022736,0.49558269399772636
90636,0.48780487804878053,0.5555555555555556,105,-125,0.4666534470222751,0.5333465529777248,home,SF,under,9,0.5169082125603864,-107,0.49558269399772636,SF,NYM,2023 REG,8,5,8,4,9,16,1,0,1,-1,1,1,1,1,0,0,0,0,0,0.5044173060022736,0.49558269399772636
90637,0.5454545454545454,0.49504950495049505,-120,102,0.5233614270517961,0.4766385729482039,away,HOU,over,7.5,0.5454545454545454,-120,0.5206611570247933,SEA,HOU,2023 REG,8,6,10,2,8,18,1,0,4,-4,1,1,0,0,0,0,0,0,0,0.5206611570247933,0.4793388429752067
90637,0.5454545454545454,0.49504950495049505,-120,102,0.5233614270517961,0.4766385729482039,home,SEA,under,7.5,0.5,100,0.4793388429752067,SEA,HOU,2023 REG,8,6,10,2,8,18,1,0,4,-4,1,1,0,0,0,0,0,0,0,0.5206611570247933,0.4793388429752067
90638,0.5073891625615764,0.5348837209302326,-103,-115,0.4859403596076043,0.5140596403923957,away,NYY,over,9,0.5348837209302326,-115,0.5097020142727117,BOS,NYY,2023 REG,11,6,4,2,8,15,1,0,4,-4,1,1,0,0,0,0,0,0,0,0.5097020142727117,0.49029798572728833
90638,0.5073891625615764,0.5348837209302326,-103,-115,0.4859403596076043,0.5140596403923957,home,BOS,under,9,0.5121951219512195,-105,0.49029798572728833,BOS,NYY,2023 REG,11,6,4,2,8,15,1,0,4,-4,1,1,0,0,0,0,0,0,0,0.5097020142727117,0.49029798572728833
90639,0.5,0.5454545454545454,100,-120,0.4772727272727273,0.5227272727272727,away,SEA,over,8,0.5348837209302326,-115,0.5097020142727117,BAL,SEA,2023 REG,7,3,3,2,5,10,1,0,1,-1,1,1,0,0,0,0,0,0,0,0.5097020142727117,0.49029798572728833
90639,0.5,0.5454545454545454,100,-120,0.4772727272727273,0.5227272727272727,home,BAL,under,8,0.5121951219512195,-105,0.49029798572728833,BAL,SEA,2023 REG,7,3,3,2,5,10,1,0,1,-1,1,1,0,0,0,0,0,0,0,0.5097020142727117,0.49029798572728833
90640,0.5348837209302326,0.5121951219512195,-115,-105,0.5097020142727117,0.49029798572728833,away,PHI,over,8.5,0.5238095238095238,-110,0.4988662131519274,MIA,PHI,2023 REG,7,2,6,4,6,13,0,1,-2,2,1,1,0,0,0,0,0,0,0,0.4988662131519274,0.5011337868480725
90640,0.5348837209302326,0.5121951219512195,-115,-105,0.5097020142727117,0.49029798572728833,home,MIA,under,8.5,0.5238095238095238,-110,0.5011337868480725,MIA,PHI,2023 REG,7,2,6,4,6,13,0,1,-2,2,1,1,0,0,0,0,0,0,0,0.4988662131519274,0.5011337868480725
90641,0.4854368932038835,0.5555555555555556,106,-125,0.465537646233282,0.534462353766718,away,TOR,over,9,0.504950495049505,-102,0.4826715732667395,BAL,TOR,2023 REG,17,11,15,6,17,32,1,0,5,-5,1,1,1,1,1,1,0,0,0,0.4826715732667395,0.5173284267332605
90641,0.4854368932038835,0.5555555555555556,106,-125,0.465537646233282,0.534462353766718,home,BAL,under,9,0.5391705069124424,-117,0.5173284267332605,BAL,TOR,2023 REG,17,11,15,6,17,32,1,0,5,-5,1,1,1,1,1,1,0,0,0,0.4826715732667395,0.5173284267332605
90642,0.6721311475409836,0.37037037037037035,-205,170,0.6435645535349916,0.35643544646500835,away,CLE,over,8.5,0.5238095238095238,-110,0.4988662131519274,CHC,CLE,2023 REG,13,10,5,1,11,18,1,0,9,-9,1,0,0,0,0,0,0,0,0,0.4988662131519274,0.5011337868480725
90642,0.6721311475409836,0.37037037037037035,-205,170,0.6435645535349916,0.35643544646500835,home,CHC,under,8.5,0.5238095238095238,-110,0.5011337868480725,CHC,CLE,2023 REG,13,10,5,1,11,18,1,0,9,-9,1,0,0,0,0,0,0,0,0,0.4988662131519274,0.5011337868480725
90643,0.47619047619047616,0.5652173913043479,110,-130,0.4564724440500838,0.5435275559499162,away,ATL,over,8,0.5238095238095238,-110,0.4988662131519274,PHI,ATL,2023 REG,4,1,6,5,6,10,0,1,-4,4,1,0,0,0,0,0,0,0,0,0.4988662131519274,0.5011337868480725
90643,0.47619047619047616,0.5652173913043479,110,-130,0.4564724440500838,0.5435275559499162,home,PHI,under,8,0.5238095238095238,-110,0.5011337868480725,PHI,ATL,2023 REG,4,1,6,5,6,10,0,1,-4,4,1,0,0,0,0,0,0,0,0,0.4988662131519274,0.5011337868480725
90644,0.4587155963302753,0.5833333333333333,118,-140,0.4394270964845833,0.5605729035154168,away,CLE,over,9,0.5348837209302326,-115,0.5097020142727117,LAA,CLE,2023 REG,6,6,4,2,8,10,1,0,4,-4,1,1,0,0,0,0,0,0,0,0.5097020142727117,0.49029798572728833
90644,0.4587155963302753,0.5833333333333333,118,-140,0.4394270964845833,0.5605729035154168,home,LAA,under,9,0.5121951219512195,-105,0.49029798572728833,LAA,CLE,2023 REG,6,6,4,2,8,10,1,0,4,-4,1,1,0,0,0,0,0,0,0,0.5097020142727117,0.49029798572728833
90645,0.5867768595041323,0.45454545454545453,-142,120,0.5625298818386723,0.43747011816132775,away,MIA,over,9,0.5,100,0.4772727272727273,PHI,MIA,2023 REG,5,2,7,3,5,12,0,1,-1,1,1,1,0,0,0,0,0,0,0,0.4772727272727273,0.5227272727272727
90645,0.5867768595041323,0.45454545454545453,-142,120,0.5625298818386723,0.43747011816132775,home,PHI,under,9,0.5454545454545454,-120,0.5227272727272727,PHI,MIA,2023 REG,5,2,7,3,5,12,0,1,-1,1,1,1,0,0,0,0,0,0,0,0.4772727272727273,0.5227272727272727
90646,0.46511627906976744,0.574468085106383,115,-135,0.44670494689481377,0.5532950531051862,away,NYY,over,8.5,0.5348837209302326,-115,0.5097020142727117,CIN,NYY,2023 REG,6,1,6,4,5,12,0,1,-3,3,1,0,0,0,0,0,0,0,0,0.5097020142727117,0.49029798572728833
90646,0.46511627906976744,0.574468085106383,115,-135,0.44670494689481377,0.5532950531051862,home,CIN,under,8.5,0.5121951219512195,-105,0.49029798572728833,CIN,NYY,2023 REG,6,1,6,4,5,12,0,1,-3,3,1,0,0,0,0,0,0,0,0,0.5097020142727117,0.49029798572728833
90647,0.5884773662551441,0.45454545454545453,-143,120,0.5631594099815408,0.4368405900184592,away,NYY,over,8,0.5238095238095238,-110,0.4988662131519274,MIA,NYY,2023 REG,6,4,14,9,13,20,0,1,-5,5,1,1,1,1,0,0,0,0,0,0.4988662131519274,0.5011337868480725
90647,0.5884773662551441,0.45454545454545453,-143,120,0.5631594099815408,0.4368405900184592,home,MIA,under,8,0.5238095238095238,-110,0.5011337868480725,MIA,NYY,2023 REG,6,4,14,9,13,20,0,1,-5,5,1,1,1,1,0,0,0,0,0,0.4988662131519274,0.5011337868480725
90648,0.5192307692307692,0.5215311004784688,-108,-109,0.49806595226635714,0.5019340477336429,away,LAD,over,9.5,0.5098039215686274,-104,0.48592421718142587,SD,LAD,2023 REG,7,2,12,8,10,19,0,1,-6,6,1,1,0,0,0,0,0,0,0,0.48592421718142587,0.5140757828185741
90648,0.5192307692307692,0.5215311004784688,-108,-109,0.49806595226635714,0.5019340477336429,home,SD,under,9.5,0.5370370370370371,-116,0.5140757828185741,SD,LAD,2023 REG,7,2,12,8,10,19,0,1,-6,6,1,1,0,0,0,0,0,0,0,0.48592421718142587,0.5140757828185741
90649,0.6610169491525424,0.3802281368821293,-195,163,0.6337532482143695,0.3662467517856305,away,MIL,over,9.5,0.5,100,0.4772727272727273,PHI,MIL,2023 REG,12,4,4,3,7,16,1,0,1,-1,1,1,1,0,0,0,0,0,0,0.4772727272727273,0.5227272727272727
90649,0.6610169491525424,0.3802281368821293,-195,163,0.6337532482143695,0.3662467517856305,home,PHI,under,9.5,0.5454545454545454,-120,0.5227272727272727,PHI,MIL,2023 REG,12,4,4,3,7,16,1,0,1,-1,1,1,1,0,0,0,0,0,0,0.4772727272727273,0.5227272727272727
90650,0.6226415094339623,0.4166666666666667,-165,140,0.5981666073335706,0.40183339266642937,away,PIT,over,8.5,0.5348837209302326,-115,0.5097020142727117,TB,PIT,2023 REG,6,4,5,1,5,11,1,0,3,-3,1,0,0,0,0,0,0,0,0,0.5097020142727117,0.49029798572728833
90650,0.6226415094339623,0.4166666666666667,-165,140,0.5981666073335706,0.40183339266642937,home,TB,under,8.5,0.5121951219512195,-105,0.49029798572728833,TB,PIT,2023 REG,6,4,5,1,5,11,1,0,3,-3,1,0,0,0,0,0,0,0,0,0.5097020142727117,0.49029798572728833
90651,0.5798319327731092,0.4566210045662101,-138,119,0.5586953556603946,0.44130464433960537,away,SEA,over,8.5,0.5073891625615764,-103,0.4837652908580103,CLE,SEA,2023 REG,9,2,11,3,5,20,0,1,-1,1,1,1,0,0,0,0,0,0,0,0.4837652908580103,0.5162347091419897
90651,0.5798319327731092,0.4566210045662101,-138,119,0.5586953556603946,0.44130464433960537,home,CLE,under,8.5,0.5391705069124424,-117,0.5162347091419897,CLE,SEA,2023 REG,9,2,11,3,5,20,0,1,-1,1,1,1,0,0,0,0,0,0,0,0.4837652908580103,0.5162347091419897
90652,0.6000000000000001,0.4347826086956522,-150,130,0.5791304347826086,0.4208695652173914,away,HOU,over,9,0.5454545454545454,-120,0.5206611570247933,TOR,HOU,2023 REG,5,3,5,2,5,10,1,0,1,-1,1,1,0,0,0,0,0,0,0,0.5206611570247933,0.4793388429752067
90652,0.6000000000000001,0.4347826086956522,-150,130,0.5791304347826086,0.4208695652173914,home,TOR,under,9,0.5,100,0.4793388429752067,TOR,HOU,2023 REG,5,3,5,2,5,10,1,0,1,-1,1,1,0,0,0,0,0,0,0,0.5206611570247933,0.4793388429752067
90653,0.576271186440678,0.46511627906976744,-136,115,0.552420782587201,0.44757921741279905,away,TEX,over,9,0.5,100,0.4772727272727273,HOU,TEX,2023 REG,8,4,9,3,7,17,1,0,1,-1,1,1,1,0,0,0,0,0,0,0.4772727272727273,0.5227272727272727
90653,0.576271186440678,0.46511627906976744,-136,115,0.552420782587201,0.44757921741279905,home,HOU,under,9,0.5454545454545454,-120,0.5227272727272727,HOU,TEX,2023 REG,8,4,9,3,7,17,1,0,1,-1,1,1,1,0,0,0,0,0,0,0.4772727272727273,0.5227272727272727
90654,0.4291845493562232,0.6108949416342413,133,-157,0.4119830510770539,0.5880169489229461,away,LAD,over,9.5,0.5,100,0.4772727272727273,ARI,LAD,2023 REG,10,4,9,5,9,19,0,1,-1,1,1,1,1,1,0,0,0,0,0,0.4772727272727273,0.5227272727272727
90654,0.4291845493562232,0.6108949416342413,133,-157,0.4119830510770539,0.5880169489229461,home,ARI,under,9.5,0.5454545454545454,-120,0.5227272727272727,ARI,LAD,2023 REG,10,4,9,5,9,19,0,1,-1,1,1,1,1,1,0,0,0,0,0,0.4772727272727273,0.5227272727272727
90655,0.607843137254902,0.4347826086956522,-155,130,0.5819333701084867,0.41806662989151333,away,TEX,over,7.5,0.5283018867924528,-112,0.5031902949311281,TOR,TEX,2023 REG,4,2,11,9,11,15,0,1,-7,7,1,1,0,0,0,0,0,0,0,0.5031902949311281,0.4968097050688719
90655,0.607843137254902,0.4347826086956522,-155,130,0.5819333701084867,0.41806662989151333,home,TOR,under,7.5,0.5192307692307692,-108,0.4968097050688719,TOR,TEX,2023 REG,4,2,11,9,11,15,0,1,-7,7,1,1,0,0,0,0,0,0,0,0.5031902949311281,0.4968097050688719
90656,0.6296296296296295,0.4065040650406504,-170,146,0.606878784837231,0.393121215162769,away,OAK,over,10.5,0.5391705069124424,-117,0.5140669063204599,KC,OAK,2023 REG,7,4,9,5,9,16,0,1,-1,1,1,1,1,1,0,0,0,0,0,0.5140669063204599,0.4859330936795401
90656,0.6296296296296295,0.4065040650406504,-170,146,0.606878784837231,0.393121215162769,home,KC,under,10.5,0.5073891625615764,-103,0.4859330936795401,KC,OAK,2023 REG,7,4,9,5,9,16,0,1,-1,1,1,1,1,1,0,0,0,0,0,0.5140669063204599,0.4859330936795401
90657,0.5,0.5348837209302326,100,-115,0.4825581395348837,0.5174418604651163,away,SD,over,8,0.5391705069124424,-117,0.5140669063204599,SF,SD,2023 REG,6,7,10,4,11,16,1,0,3,-3,1,1,1,1,0,0,0,0,0,0.5140669063204599,0.4859330936795401
90657,0.5,0.5348837209302326,100,-115,0.4825581395348837,0.5174418604651163,home,SF,under,8,0.5073891625615764,-103,0.4859330936795401,SF,SD,2023 REG,6,7,10,4,11,16,1,0,3,-3,1,1,1,1,0,0,0,0,0,0.5140669063204599,0.4859330936795401
90658,0.5348837209302326,0.5073891625615764,-115,-103,0.5122726437136835,0.48772735628631647,away,PHI,over,9,0.5,100,0.4772727272727273,SF,PHI,2023 REG,10,6,6,3,9,16,1,0,3,-3,1,1,1,0,0,0,0,0,0,0.4772727272727273,0.5227272727272727
90658,0.5348837209302326,0.5073891625615764,-115,-103,0.5122726437136835,0.48772735628631647,home,SF,under,9,0.5454545454545454,-120,0.5227272727272727,SF,PHI,2023 REG,10,6,6,3,9,16,1,0,3,-3,1,1,1,0,0,0,0,0,0,0.4772727272727273,0.5227272727272727
90659,0.5689655172413793,0.49019607843137253,-132,104,0.5353046093586068,0.4646953906413932,away,PHI,over,8,0.5121951219512195,-105,0.48808156828023186,NYM,PHI,2023 REG,10,11,8,4,15,18,1,0,7,-7,1,1,1,1,0,0,0,0,0,0.48808156828023186,0.5119184317197681
90659,0.5689655172413793,0.49019607843137253,-132,104,0.5353046093586068,0.4646953906413932,home,NYM,under,8,0.5348837209302326,-115,0.5119184317197681,NYM,PHI,2023 REG,10,11,8,4,15,18,1,0,7,-7,1,1,1,1,0,0,0,0,0,0.48808156828023186,0.5119184317197681
90660,0.6153846153846154,0.425531914893617,-160,135,0.5902052121364724,0.40979478786352763,away,CHC,over,9,0.5121951219512195,-105,0.48808156828023186,PHI,CHC,2023 REG,13,12,6,3,15,19,1,0,9,-9,1,1,1,0,0,0,0,0,0,0.48808156828023186,0.5119184317197681
90660,0.6153846153846154,0.425531914893617,-160,135,0.5902052121364724,0.40979478786352763,home,PHI,under,9,0.5348837209302326,-115,0.5119184317197681,PHI,CHC,2023 REG,13,12,6,3,15,19,1,0,9,-9,1,1,1,0,0,0,0,0,0,0.48808156828023186,0.5119184317197681
90661,0.5652173913043479,0.47619047619047616,-130,110,0.5418129444594474,0.4581870555405526,away,CHC,over,9,0.5412844036697247,-118,0.5189377998484975,LAA,CHC,2023 REG,8,3,5,1,4,13,1,0,2,-2,1,0,0,0,0,0,0,0,0,0.5189377998484975,0.4810622001515025
90661,0.5652173913043479,0.47619047619047616,-130,110,0.5418129444594474,0.4581870555405526,home,LAA,under,9,0.5,100,0.4810622001515025,LAA,CHC,2023 REG,8,3,5,1,4,13,1,0,2,-2,1,0,0,0,0,0,0,0,0,0.5189377998484975,0.4810622001515025
90662,0.7333333333333333,0.3076923076923077,-275,225,0.7032478632478633,0.29675213675213674,away,COL,over,8,0.5121951219512195,-105,0.48808156828023186,SF,COL,2023 REG,13,9,7,1,10,20,1,0,8,-8,1,0,0,0,0,0,0,0,0,0.48808156828023186,0.5119184317197681
90662,0.7333333333333333,0.3076923076923077,-275,225,0.7032478632478633,0.29675213675213674,home,SF,under,8,0.5348837209302326,-115,0.5119184317197681,SF,COL,2023 REG,13,9,7,1,10,20,1,0,8,-8,1,0,0,0,0,0,0,0,0,0.48808156828023186,0.5119184317197681
90663,0.4291845493562232,0.607843137254902,133,-155,0.41329283836432396,0.586707161635676,away,MIA,over,8.5,0.5238095238095238,-110,0.4988662131519274,WSH,MIA,2023 REG,3,1,13,6,7,16,0,1,-5,5,1,0,0,0,0,0,0,0,0,0.4988662131519274,0.5011337868480725
90663,0.4291845493562232,0.607843137254902,133,-155,0.41329283836432396,0.586707161635676,home,WSH,under,8.5,0.5238095238095238,-110,0.5011337868480725,WSH,MIA,2023 REG,3,1,13,6,7,16,0,1,-5,5,1,0,0,0,0,0,0,0,0,0.4988662131519274,0.5011337868480725
90664,0.607843137254902,0.4347826086956522,-155,130,0.5819333701084867,0.41806662989151333,away,KC,over,9,0.5475113122171946,-121,0.5242087833606768,CWS,KC,2023 REG,5,1,10,7,8,15,0,1,-6,6,1,0,0,0,0,0,0,0,0,0.5242087833606768,0.4757912166393232
90664,0.607843137254902,0.4347826086956522,-155,130,0.5819333701084867,0.41806662989151333,home,CWS,under,9,0.49504950495049505,102,0.4757912166393232,CWS,KC,2023 REG,5,1,10,7,8,15,0,1,-6,6,1,0,0,0,0,0,0,0,0,0.5242087833606768,0.4757912166393232
90665,0.5192307692307692,0.5238095238095238,-108,-110,0.49688292476754015,0.5031170752324599,away,LAD,over,9.5,0.5238095238095238,-110,0.4988662131519274,BAL,LAD,2023 REG,7,4,11,6,10,18,0,1,-2,2,1,1,1,1,0,0,0,0,0,0.4988662131519274,0.5011337868480725
90665,0.5192307692307692,0.5238095238095238,-108,-110,0.49688292476754015,0.5031170752324599,home,BAL,under,9.5,0.5238095238095238,-110,0.5011337868480725,BAL,LAD,2023 REG,7,4,11,6,10,18,0,1,-2,2,1,1,1,1,0,0,0,0,0,0.4988662131519274,0.5011337868480725
90666,0.6491228070175439,0.38759689922480617,-185,158,0.6252872082286499,0.3747127917713501,away,OAK,over,9.5,0.5121951219512195,-105,0.48808156828023186,PIT,OAK,2023 REG,9,5,17,9,14,26,0,1,-4,4,1,1,1,1,1,0,0,0,0,0.48808156828023186,0.5119184317197681
90666,0.6491228070175439,0.38759689922480617,-185,158,0.6252872082286499,0.3747127917713501,home,PIT,under,9.5,0.5348837209302326,-115,0.5119184317197681,PIT,OAK,2023 REG,9,5,17,9,14,26,0,1,-4,4,1,1,1,1,1,0,0,0,0,0.48808156828023186,0.5119184317197681
90667,0.47619047619047616,0.5652173913043479,110,-130,0.4564724440500838,0.5435275559499162,away,BOS,over,8.5,0.5238095238095238,-110,0.5000596729920038,ARI,BOS,2023 REG,7,2,14,7,9,21,0,1,-5,5,1,1,0,0,0,0,0,0,0,0.5000596729920038,0.4999403270079962
90667,0.47619047619047616,0.5652173913043479,110,-130,0.4564724440500838,0.5435275559499162,home,ARI,under,8.5,0.5215311004784688,-109,0.4999403270079962,ARI,BOS,2023 REG,7,2,14,7,9,21,0,1,-5,5,1,1,0,0,0,0,0,0,0,0.5000596729920038,0.4999403270079962
90668,0.48780487804878053,0.5555555555555556,105,-125,0.4666534470222751,0.5333465529777248,away,CIN,over,11,0.5121951219512195,-105,0.48919479393107135,COL,CIN,2023 REG,12,9,12,8,17,24,1,0,1,-1,1,1,1,1,1,1,1,1,0,0.48919479393107135,0.5108052060689287
90668,0.48780487804878053,0.5555555555555556,105,-125,0.4666534470222751,0.5333465529777248,home,COL,under,11,0.5327102803738317,-114,0.5108052060689287,COL,CIN,2023 REG,12,9,12,8,17,24,1,0,1,-1,1,1,1,1,1,1,1,1,0,0.48919479393107135,0.5108052060689287
90669,0.45248868778280543,0.5815899581589958,121,-139,0.43706848599918496,0.5629315140008151,away,TB,over,9.5,0.5,100,0.4772727272727273,CWS,TB,2023 REG,4,3,11,12,15,15,0,1,-9,9,1,1,1,0,0,0,0,0,0,0.4772727272727273,0.5227272727272727
90669,0.45248868778280543,0.5815899581589958,121,-139,0.43706848599918496,0.5629315140008151,home,CWS,under,9.5,0.5454545454545454,-120,0.5227272727272727,CWS,TB,2023 REG,4,3,11,12,15,15,0,1,-9,9,1,1,1,0,0,0,0,0,0,0.4772727272727273,0.5227272727272727
90670,0.7058823529411764,0.3333333333333333,-240,200,0.6782006920415226,0.32179930795847744,away,OAK,over,8.5,0.5215311004784688,-109,0.4978845547971712,TEX,OAK,2023 REG,7,4,8,5,9,15,0,1,-1,1,1,1,1,1,0,0,0,0,0,0.4978845547971712,0.5021154452028288
90670,0.7058823529411764,0.3333333333333333,-240,200,0.6782006920415226,0.32179930795847744,home,TEX,under,8.5,0.5238095238095238,-110,0.5021154452028288,TEX,OAK,2023 REG,7,4,8,5,9,15,0,1,-1,1,1,1,1,1,0,0,0,0,0,0.4978845547971712,0.5021154452028288
90671,0.5121951219512195,0.5348837209302326,-105,-115,0.48808156828023186,0.5119184317197681,away,TEX,over,8.5,0.5073891625615764,-103,0.4826927225525911,TOR,TEX,2023 REG,7,3,9,6,9,16,0,1,-3,3,1,1,1,0,0,0,0,0,0,0.4826927225525911,0.5173072774474089
90671,0.5121951219512195,0.5348837209302326,-105,-115,0.48808156828023186,0.5119184317197681,home,TOR,under,8.5,0.5412844036697247,-118,0.5173072774474089,TOR,TEX,2023 REG,7,3,9,6,9,16,0,1,-3,3,1,1,1,0,0,0,0,0,0,0.4826927225525911,0.5173072774474089
90672,0.574468085106383,0.46511627906976744,-135,115,0.5517281312179562,0.44827186878204384,away,COL,over,9.5,0.5,100,0.4772727272727273,WSH,COL,2023 REG,10,6,15,5,11,25,1,0,1,-1,1,1,1,1,1,0,0,0,0,0.4772727272727273,0.5227272727272727
90672,0.574468085106383,0.46511627906976744,-135,115,0.5517281312179562,0.44827186878204384,home,WSH,under,9.5,0.5454545454545454,-120,0.5227272727272727,WSH,COL,2023 REG,10,6,15,5,11,25,1,0,1,-1,1,1,1,1,1,0,0,0,0,0.4772727272727273,0.5227272727272727
90673,0.7777777777777779,0.26666666666666666,-350,275,0.7432098765432099,0.2567901234567901,away,COL,over,8.5,0.5348837209302326,-115,0.5097020142727117,LAD,COL,2023 REG,10,8,5,3,11,15,1,0,5,-5,1,1,1,0,0,0,0,0,0,0.5097020142727117,0.49029798572728833
90673,0.7777777777777779,0.26666666666666666,-350,275,0.7432098765432099,0.2567901234567901,home,LAD,under,8.5,0.5121951219512195,-105,0.49029798572728833,LAD,COL,2023 REG,10,8,5,3,11,15,1,0,5,-5,1,1,1,0,0,0,0,0,0,0.5097020142727117,0.49029798572728833
90674,0.4,0.6363636363636364,150,-175,0.3854545454545455,0.6145454545454545,away,PHI,over,9.5,0.504950495049505,-102,0.4826715732667395,OAK,PHI,2023 REG,9,2,9,3,5,18,0,1,-1,1,1,1,0,0,0,0,0,0,0,0.4826715732667395,0.5173284267332605
90674,0.4,0.6363636363636364,150,-175,0.3854545454545455,0.6145454545454545,home,OAK,under,9.5,0.5391705069124424,-117,0.5173284267332605,OAK,PHI,2023 REG,9,2,9,3,5,18,0,1,-1,1,1,1,0,0,0,0,0,0,0,0.4826715732667395,0.5173284267332605
90675,0.5,0.5391705069124424,100,-117,0.4804147465437788,0.5195852534562212,away,NYY,over,8,0.5121951219512195,-105,0.48808156828023186,TOR,NYY,2023 REG,10,3,3,0,3,13,1,0,3,-3,0,0,0,0,0,0,0,0,0,0.48808156828023186,0.5119184317197681
90675,0.5,0.5391705069124424,100,-117,0.4804147465437788,0.5195852534562212,home,TOR,under,8,0.5348837209302326,-115,0.5119184317197681,TOR,NYY,2023 REG,10,3,3,0,3,13,1,0,3,-3,0,0,0,0,0,0,0,0,0,0.48808156828023186,0.5119184317197681
90676,0.3921568627450981,0.6491228070175439,155,-185,0.37596875695582666,0.6240312430441733,away,TEX,over,9,0.5348837209302326,-115,0.5097020142727117,LAA,TEX,2023 REG,8,1,9,5,6,17,0,1,-4,4,1,0,0,0,0,0,0,0,0,0.5097020142727117,0.49029798572728833
90676,0.3921568627450981,0.6491228070175439,155,-185,0.37596875695582666,0.6240312430441733,home,LAA,under,9,0.5121951219512195,-105,0.49029798572728833,LAA,TEX,2023 REG,8,1,9,5,6,17,0,1,-4,4,1,0,0,0,0,0,0,0,0,0.5097020142727117,0.49029798572728833
90677,0.5,0.5454545454545454,100,-120,0.4772727272727273,0.5227272727272727,away,ARI,over,7,0.5454545454545454,-120,0.5206611570247933,CHC,ARI,2023 REG,3,0,4,1,1,7,0,1,-1,1,0,0,0,0,0,0,0,0,0,0.5206611570247933,0.4793388429752067
90677,0.5,0.5454545454545454,100,-120,0.4772727272727273,0.5227272727272727,home,CHC,under,7,0.5,100,0.4793388429752067,CHC,ARI,2023 REG,3,0,4,1,1,7,0,1,-1,1,0,0,0,0,0,0,0,0,0,0.5206611570247933,0.4793388429752067
90678,0.38759689922480617,0.6491228070175439,158,-185,0.3733644549448255,0.6266355450551745,away,PHI,over,9,0.5412844036697247,-118,0.5149381613977361,PIT,PHI,2023 REG,11,7,8,6,13,19,1,0,1,-1,1,1,1,1,1,1,0,0,0,0.5149381613977361,0.48506183860226393
90678,0.38759689922480617,0.6491228070175439,158,-185,0.3733644549448255,0.6266355450551745,home,PIT,under,9,0.5073891625615764,-103,0.48506183860226393,PIT,PHI,2023 REG,11,7,8,6,13,19,1,0,1,-1,1,1,1,1,1,1,0,0,0,0.5149381613977361,0.48506183860226393
90679,0.6363636363636364,0.4065040650406504,-175,146,0.6090841900154538,0.3909158099845462,away,SEA,over,8.5,0.5121951219512195,-105,0.48808156828023186,SF,SEA,2023 REG,8,2,7,0,2,15,1,0,2,-2,0,0,0,0,0,0,0,0,0,0.48808156828023186,0.5119184317197681
90679,0.6363636363636364,0.4065040650406504,-175,146,0.6090841900154538,0.3909158099845462,home,SF,under,8.5,0.5348837209302326,-115,0.5119184317197681,SF,SEA,2023 REG,8,2,7,0,2,15,1,0,2,-2,0,0,0,0,0,0,0,0,0,0.48808156828023186,0.5119184317197681
90680,0.6551724137931035,0.3921568627450981,-190,155,0.6241635774404887,0.37583642255951133,away,KC,over,8,0.5238095238095238,-110,0.4988662131519274,MIA,KC,2023 REG,8,6,3,1,7,11,1,0,5,-5,1,0,0,0,0,0,0,0,0,0.4988662131519274,0.5011337868480725
90680,0.6551724137931035,0.3921568627450981,-190,155,0.6241635774404887,0.37583642255951133,home,MIA,under,8,0.5238095238095238,-110,0.5011337868480725,MIA,KC,2023 REG,8,6,3,1,7,11,1,0,5,-5,1,0,0,0,0,0,0,0,0,0.4988662131519274,0.5011337868480725
90681,0.6551724137931035,0.38759689922480617,-190,158,0.6271511397468869,0.37284886025311315,away,NYM,over,7.5,0.504950495049505,-102,0.4826715732667395,PHI,NYM,2023 REG,11,7,9,5,12,20,1,0,2,-2,1,1,1,1,1,0,0,0,0,0.4826715732667395,0.5173284267332605
90681,0.6551724137931035,0.38759689922480617,-190,158,0.6271511397468869,0.37284886025311315,home,PHI,under,7.5,0.5391705069124424,-117,0.5173284267332605,PHI,NYM,2023 REG,11,7,9,5,12,20,1,0,2,-2,1,1,1,1,1,0,0,0,0,0.4826715732667395,0.5173284267332605
90682,0.45454545454545453,0.5833333333333333,120,-140,0.43732782369146006,0.5626721763085399,away,MIL,over,8,0.5348837209302326,-115,0.5097020142727117,PIT,MIL,2023 REG,7,8,12,11,19,19,0,1,-3,3,1,1,1,1,1,1,1,1,0,0.5097020142727117,0.49029798572728833
90682,0.45454545454545453,0.5833333333333333,120,-140,0.43732782369146006,0.5626721763085399,home,PIT,under,8,0.5121951219512195,-105,0.49029798572728833,PIT,MIL,2023 REG,7,8,12,11,19,19,0,1,-3,3,1,1,1,1,1,1,1,1,0,0.5097020142727117,0.49029798572728833
90683,0.5555555555555556,0.47619047619047616,-125,110,0.5379188712522047,0.4620811287477953,away,TEX,over,9.5,0.5215311004784688,-109,0.4978845547971712,LAA,TEX,2023 REG,13,8,17,16,24,30,0,1,-8,8,1,1,1,1,1,1,1,1,0,0.4978845547971712,0.5021154452028288
90683,0.5555555555555556,0.47619047619047616,-125,110,0.5379188712522047,0.4620811287477953,home,LAA,under,9.5,0.5238095238095238,-110,0.5021154452028288,LAA,TEX,2023 REG,13,8,17,16,24,30,0,1,-8,8,1,1,1,1,1,1,1,1,0,0.4978845547971712,0.5021154452028288
90684,0.7206703910614525,0.3225806451612903,-258,210,0.6895006498729954,0.3104993501270046,away,STL,over,8,0.5454545454545454,-120,0.5193043049216726,MIL,STL,2023 REG,8,3,6,0,3,14,1,0,3,-3,0,0,0,0,0,0,0,0,0,0.5193043049216726,0.48069569507832743
90684,0.7206703910614525,0.3225806451612903,-258,210,0.6895006498729954,0.3104993501270046,home,MIL,under,8,0.5024875621890548,-101,0.48069569507832743,MIL,STL,2023 REG,8,3,6,0,3,14,1,0,3,-3,0,0,0,0,0,0,0,0,0,0.5193043049216726,0.48069569507832743
90685,0.5555555555555556,0.48780487804878053,-125,105,0.5314664257753688,0.46853357422463116,away,BAL,over,8.5,0.5454545454545454,-120,0.5206611570247933,BOS,BAL,2023 REG,11,9,15,10,19,26,0,1,-1,1,1,1,1,1,1,1,1,1,1,0.5206611570247933,0.4793388429752067
90685,0.5555555555555556,0.48780487804878053,-125,105,0.5314664257753688,0.46853357422463116,home,BOS,under,8.5,0.5,100,0.4793388429752067,BOS,BAL,2023 REG,11,9,15,10,19,26,0,1,-1,1,1,1,1,1,1,1,1,1,1,0.5206611570247933,0.4793388429752067
90686,0.5,0.5348837209302326,100,-115,0.4825581395348837,0.5174418604651163,away,SD,over,8.5,0.5454545454545454,-120,0.5206611570247933,SF,SD,2023 REG,8,4,10,3,7,18,1,0,1,-1,1,1,1,0,0,0,0,0,0,0.5206611570247933,0.4793388429752067
90686,0.5,0.5348837209302326,100,-115,0.4825581395348837,0.5174418604651163,home,SF,under,8.5,0.5,100,0.4793388429752067,SF,SD,2023 REG,8,4,10,3,7,18,1,0,1,-1,1,1,1,0,0,0,0,0,0,0.5206611570247933,0.4793388429752067
90687,0.6721311475409836,0.3623188405797102,-205,176,0.6489762374926485,0.35102376250735146,away,OAK,over,8,0.5348837209302326,-115,0.5097020142727117,MIL,OAK,2023 REG,10,6,6,8,14,16,0,1,-2,2,1,1,1,1,1,1,0,0,0,0.5097020142727117,0.49029798572728833
90687,0.6721311475409836,0.3623188405797102,-205,176,0.6489762374926485,0.35102376250735146,home,MIL,under,8,0.5121951219512195,-105,0.49029798572728833,MIL,OAK,2023 REG,10,6,6,8,14,16,0,1,-2,2,1,1,1,1,1,1,0,0,0,0.5097020142727117,0.49029798572728833
90688,0.45454545454545453,0.5833333333333333,120,-140,0.43732782369146006,0.5626721763085399,away,PHI,over,9,0.5024875621890548,-101,0.48049269377245407,ARI,PHI,2023 REG,8,3,20,15,18,28,0,1,-12,12,1,1,1,0,0,0,0,0,0,0.48049269377245407,0.5195073062275459
90688,0.45454545454545453,0.5833333333333333,120,-140,0.43732782369146006,0.5626721763085399,home,ARI,under,9,0.5412844036697247,-118,0.5195073062275459,ARI,PHI,2023 REG,8,3,20,15,18,28,0,1,-12,12,1,1,1,0,0,0,0,0,0,0.48049269377245407,0.5195073062275459
90689,0.4444444444444444,0.5918367346938775,125,-145,0.42831947593852354,0.5716805240614764,away,STL,over,10,0.5238095238095238,-110,0.4988662131519274,CWS,STL,2023 REG,7,0,8,3,3,15,0,1,-3,3,0,0,0,0,0,0,0,0,0,0.4988662131519274,0.5011337868480725
90689,0.4444444444444444,0.5918367346938775,125,-145,0.42831947593852354,0.5716805240614764,home,CWS,under,10,0.5238095238095238,-110,0.5011337868480725,CWS,STL,2023 REG,7,0,8,3,3,15,0,1,-3,3,0,0,0,0,0,0,0,0,0,0.4988662131519274,0.5011337868480725
90690,0.3436426116838488,0.7032640949554896,191,-237,0.3275234685088184,0.6724765314911816,away,ATL,over,9.5,0.5238095238095238,-110,0.4988662131519274,WSH,ATL,2023 REG,10,3,6,2,5,16,1,0,1,-1,1,1,0,0,0,0,0,0,0,0.4988662131519274,0.5011337868480725
90690,0.3436426116838488,0.7032640949554896,191,-237,0.3275234685088184,0.6724765314911816,home,WSH,under,9.5,0.5238095238095238,-110,0.5011337868480725,WSH,ATL,2023 REG,10,3,6,2,5,16,1,0,1,-1,1,1,0,0,0,0,0,0,0,0.4988662131519274,0.5011337868480725
90691,0.5555555555555556,0.48780487804878053,-125,105,0.5314664257753688,0.46853357422463116,away,LAA,over,9.5,0.5391705069124424,-117,0.5140669063204599,MIL,LAA,2023 REG,3,0,5,3,3,8,0,1,-3,3,0,0,0,0,0,0,0,0,0,0.5140669063204599,0.4859330936795401
90691,0.5555555555555556,0.48780487804878053,-125,105,0.5314664257753688,0.46853357422463116,home,MIL,under,9.5,0.5073891625615764,-103,0.4859330936795401,MIL,LAA,2023 REG,3,0,5,3,3,8,0,1,-3,3,0,0,0,0,0,0,0,0,0,0.5140669063204599,0.4859330936795401
90692,0.6240601503759399,0.4166666666666667,-166,140,0.5986441668079975,0.4013558331920025,away,LAA,over,8.5,0.5238095238095238,-110,0.4988662131519274,BAL,LAA,2023 REG,10,5,13,6,11,23,0,1,-1,1,1,1,1,1,1,0,0,0,0,0.4988662131519274,0.5011337868480725
90692,0.6240601503759399,0.4166666666666667,-166,140,0.5986441668079975,0.4013558331920025,home,BAL,under,8.5,0.5238095238095238,-110,0.5011337868480725,BAL,LAA,2023 REG,10,5,13,6,11,23,0,1,-1,1,1,1,1,1,1,0,0,0,0,0.4988662131519274,0.5011337868480725
90693,0.3333333333333333,0.7058823529411764,200,-240,0.32026143790849676,0.6797385620915033,away,HOU,over,7.5,0.5098039215686274,-104,0.4870219861770517,OAK,HOU,2023 REG,7,4,9,6,10,16,0,1,-2,2,1,1,1,1,0,0,0,0,0,0.4870219861770517,0.5129780138229483
90693,0.3333333333333333,0.7058823529411764,200,-240,0.32026143790849676,0.6797385620915033,home,OAK,under,7.5,0.5348837209302326,-115,0.5129780138229483,OAK,HOU,2023 REG,7,4,9,6,10,16,0,1,-2,2,1,1,1,1,0,0,0,0,0,0.4870219861770517,0.5129780138229483
90694,0.607843137254902,0.425531914893617,-155,135,0.5875563408509002,0.41244365914909975,away,CWS,over,8.5,0.5348837209302326,-115,0.5097020142727117,MIN,CWS,2023 REG,10,3,6,1,4,16,1,0,2,-2,1,0,0,0,0,0,0,0,0,0.5097020142727117,0.49029798572728833
90694,0.607843137254902,0.425531914893617,-155,135,0.5875563408509002,0.41244365914909975,home,MIN,under,8.5,0.5121951219512195,-105,0.49029798572728833,MIN,CWS,2023 REG,10,3,6,1,4,16,1,0,2,-2,1,0,0,0,0,0,0,0,0,0.5097020142727117,0.49029798572728833
90695,0.6363636363636364,0.4,-175,150,0.6132231404958678,0.3867768595041322,away,COL,over,9.5,0.5348837209302326,-115,0.5097020142727117,ARI,COL,2023 REG,9,5,10,4,9,19,1,0,1,-1,1,1,1,1,0,0,0,0,0,0.5097020142727117,0.49029798572728833
90695,0.6363636363636364,0.4,-175,150,0.6132231404958678,0.3867768595041322,home,ARI,under,9.5,0.5121951219512195,-105,0.49029798572728833,ARI,COL,2023 REG,9,5,10,4,9,19,1,0,1,-1,1,1,1,1,0,0,0,0,0,0.5097020142727117,0.49029798572728833
90696,0.5121951219512195,0.5348837209302326,-105,-115,0.48808156828023186,0.5119184317197681,away,PIT,over,8,0.5121951219512195,-105,0.48808156828023186,BAL,PIT,2023 REG,8,0,7,4,4,15,0,1,-4,4,0,0,0,0,0,0,0,0,0,0.48808156828023186,0.5119184317197681
90696,0.5121951219512195,0.5348837209302326,-105,-115,0.48808156828023186,0.5119184317197681,home,BAL,under,8,0.5348837209302326,-115,0.5119184317197681,BAL,PIT,2023 REG,8,0,7,4,4,15,0,1,-4,4,0,0,0,0,0,0,0,0,0,0.48808156828023186,0.5119184317197681
90697,0.6183206106870228,0.4166666666666667,-162,140,0.5966872559874133,0.40331274401258665,away,NYY,over,7.5,0.5,100,0.4772727272727273,NYM,NYY,2023 REG,9,6,11,7,13,20,0,1,-1,1,1,1,1,1,1,1,0,0,0,0.4772727272727273,0.5227272727272727
90697,0.6183206106870228,0.4166666666666667,-162,140,0.5966872559874133,0.40331274401258665,home,NYM,under,7.5,0.5454545454545454,-120,0.5227272727272727,NYM,NYY,2023 REG,9,6,11,7,13,20,0,1,-1,1,1,1,1,1,1,1,0,0,0,0.4772727272727273,0.5227272727272727
90698,0.6666666666666666,0.37037037037037035,-200,170,0.6419753086419753,0.3580246913580247,away,TEX,over,9,0.5098039215686274,-104,0.48592421718142587,SD,TEX,2023 REG,13,5,8,3,8,21,1,0,2,-2,1,1,1,0,0,0,0,0,0,0.48592421718142587,0.5140757828185741
90698,0.6666666666666666,0.37037037037037035,-200,170,0.6419753086419753,0.3580246913580247,home,SD,under,9,0.5370370370370371,-116,0.5140757828185741,SD,TEX,2023 REG,13,5,8,3,8,21,1,0,2,-2,1,1,1,0,0,0,0,0,0,0.48592421718142587,0.5140757828185741
90699,0.613899613899614,0.42016806722689076,-159,138,0.5929854776095975,0.4070145223904025,away,CIN,over,9,0.5327102803738317,-114,0.508788710910954,PIT,CIN,2023 REG,8,2,8,1,3,16,1,0,1,-1,1,0,0,0,0,0,0,0,0,0.508788710910954,0.491211289089046
90699,0.613899613899614,0.42016806722689076,-159,138,0.5929854776095975,0.4070145223904025,home,PIT,under,9,0.5121951219512195,-105,0.491211289089046,PIT,CIN,2023 REG,8,2,8,1,3,16,1,0,1,-1,1,0,0,0,0,0,0,0,0,0.508788710910954,0.491211289089046
90700,0.5454545454545454,0.5,-120,100,0.5206611570247933,0.4793388429752067,away,NYM,over,9.5,0.5073891625615764,-103,0.4837652908580103,BOS,NYM,2023 REG,10,8,8,6,14,18,1,0,2,-2,1,1,1,1,1,1,0,0,0,0.4837652908580103,0.5162347091419897
90700,0.5454545454545454,0.5,-120,100,0.5206611570247933,0.4793388429752067,home,BOS,under,9.5,0.5391705069124424,-117,0.5162347091419897,BOS,NYM,2023 REG,10,8,8,6,14,18,1,0,2,-2,1,1,1,1,1,1,0,0,0,0.4837652908580103,0.5162347091419897
90701,0.607843137254902,0.425531914893617,-155,135,0.5875563408509002,0.41244365914909975,away,BAL,over,7.5,0.5238095238095238,-110,0.4988662131519274,SF,BAL,2023 REG,6,2,4,3,5,10,0,1,-1,1,1,1,0,0,0,0,0,0,0,0.4988662131519274,0.5011337868480725
90701,0.607843137254902,0.425531914893617,-155,135,0.5875563408509002,0.41244365914909975,home,SF,under,7.5,0.5238095238095238,-110,0.5011337868480725,SF,BAL,2023 REG,6,2,4,3,5,10,0,1,-1,1,1,1,0,0,0,0,0,0,0,0.4988662131519274,0.5011337868480725
90702,0.5454545454545454,0.5,-120,100,0.5206611570247933,0.4793388429752067,away,NYM,over,7.5,0.5215311004784688,-109,0.4978845547971712,HOU,NYM,2023 REG,5,1,14,11,12,19,0,1,-10,10,1,0,0,0,0,0,0,0,0,0.4978845547971712,0.5021154452028288
90702,0.5454545454545454,0.5,-120,100,0.5206611570247933,0.4793388429752067,home,HOU,under,7.5,0.5238095238095238,-110,0.5021154452028288,HOU,NYM,2023 REG,5,1,14,11,12,19,0,1,-10,10,1,0,0,0,0,0,0,0,0,0.4978845547971712,0.5021154452028288
90703,0.42372881355932196,0.6108949416342413,136,-157,0.409057730850185,0.590942269149815,away,CLE,over,9.5,0.504950495049505,-102,0.48160416005266615,WSH,CLE,2023 REG,8,3,7,4,7,15,0,1,-1,1,1,1,1,0,0,0,0,0,0,0.48160416005266615,0.5183958399473338
90703,0.42372881355932196,0.6108949416342413,136,-157,0.409057730850185,0.590942269149815,home,WSH,under,9.5,0.5412844036697247,-118,0.5183958399473338,WSH,CLE,2023 REG,8,3,7,4,7,15,0,1,-1,1,1,1,1,0,0,0,0,0,0,0.48160416005266615,0.5183958399473338
90704,0.6666666666666666,0.37037037037037035,-200,170,0.6419753086419753,0.3580246913580247,away,KC,over,8.5,0.5348837209302326,-115,0.5097020142727117,NYY,KC,2023 REG,5,5,9,4,9,14,1,0,1,-1,1,1,1,1,0,0,0,0,0,0.5097020142727117,0.49029798572728833
90704,0.6666666666666666,0.37037037037037035,-200,170,0.6419753086419753,0.3580246913580247,home,NYY,under,8.5,0.5121951219512195,-105,0.49029798572728833,NYY,KC,2023 REG,5,5,9,4,9,14,1,0,1,-1,1,1,1,1,0,0,0,0,0,0.5097020142727117,0.49029798572728833
90705,0.6062992125984252,0.43103448275862066,-154,132,0.5836638225000588,0.41633617749994123,away,PIT,over,9,0.5121951219512195,-105,0.48808156828023186,BAL,PIT,2023 REG,9,6,7,3,9,16,1,0,3,-3,1,1,1,0,0,0,0,0,0,0.48808156828023186,0.5119184317197681
90705,0.6062992125984252,0.43103448275862066,-154,132,0.5836638225000588,0.41633617749994123,home,BAL,under,9,0.5348837209302326,-115,0.5119184317197681,BAL,PIT,2023 REG,9,6,7,3,9,16,1,0,3,-3,1,1,1,0,0,0,0,0,0,0.48808156828023186,0.5119184317197681
90706,0.5238095238095238,0.5192307692307692,-110,-108,0.5012646084074657,0.4987353915925343,away,BOS,over,8.5,0.5412844036697247,-118,0.5162581740877563,HOU,BOS,2023 REG,12,5,9,7,12,21,0,1,-2,2,1,1,1,1,1,0,0,0,0,0.5162581740877563,0.4837418259122437
90706,0.5238095238095238,0.5192307692307692,-110,-108,0.5012646084074657,0.4987353915925343,home,HOU,under,8.5,0.504950495049505,-102,0.4837418259122437,HOU,BOS,2023 REG,12,5,9,7,12,21,0,1,-2,2,1,1,1,1,1,0,0,0,0,0.5162581740877563,0.4837418259122437
90707,0.7014925373134329,0.3389830508474576,-235,195,0.6730992142751963,0.32690078572480374,away,OAK,over,7.5,0.5454545454545454,-120,0.5179608869977906,MIA,OAK,2023 REG,12,7,6,5,12,18,1,0,2,-2,1,1,1,1,1,0,0,0,0,0.5179608869977906,0.48203911300220936
90707,0.7014925373134329,0.3389830508474576,-235,195,0.6730992142751963,0.32690078572480374,home,MIA,under,7.5,0.504950495049505,-102,0.48203911300220936,MIA,OAK,2023 REG,12,7,6,5,12,18,1,0,2,-2,1,1,1,1,1,0,0,0,0,0.5179608869977906,0.48203911300220936
90708,0.4444444444444444,0.5967741935483871,125,-148,0.42612504978096366,0.5738749502190363,away,MIL,over,8,0.5098039215686274,-104,0.48592421718142587,MIA,MIL,2023 REG,5,1,15,16,17,20,0,1,-15,15,1,0,0,0,0,0,0,0,0,0.48592421718142587,0.5140757828185741
90708,0.4444444444444444,0.5967741935483871,125,-148,0.42612504978096366,0.5738749502190363,home,MIA,under,8,0.5370370370370371,-116,0.5140757828185741,MIA,MIL,2023 REG,5,1,15,16,17,20,0,1,-15,15,1,0,0,0,0,0,0,0,0,0.48592421718142587,0.5140757828185741
90709,0.7222222222222222,0.3225806451612903,-260,210,0.6898645957785743,0.3101354042214257,away,DET,over,8.5,0.5348837209302326,-115,0.5097020142727117,LAD,DET,2023 REG,11,3,6,2,5,17,1,0,1,-1,1,1,0,0,0,0,0,0,0,0.5097020142727117,0.49029798572728833
90709,0.7222222222222222,0.3225806451612903,-260,210,0.6898645957785743,0.3101354042214257,home,LAD,under,8.5,0.5121951219512195,-105,0.49029798572728833,LAD,DET,2023 REG,11,3,6,2,5,17,1,0,1,-1,1,1,0,0,0,0,0,0,0,0.5097020142727117,0.49029798572728833
90710,0.3846153846153846,0.6491228070175439,160,-185,0.37163915706425826,0.6283608429357417,away,CHC,over,8.5,0.5391705069124424,-117,0.5153817639191344,PIT,CHC,2023 REG,6,4,10,5,9,16,0,1,-1,1,1,1,1,1,0,0,0,0,0,0.5153817639191344,0.4846182360808656
90710,0.3846153846153846,0.6491228070175439,160,-185,0.37163915706425826,0.6283608429357417,home,PIT,under,8.5,0.504950495049505,-102,0.4846182360808656,PIT,CHC,2023 REG,6,4,10,5,9,16,0,1,-1,1,1,1,1,1,0,0,0,0,0,0.5153817639191344,0.4846182360808656
90711,0.696969696969697,0.3448275862068966,-230,190,0.6678382571799499,0.33216174282005007,away,WSH,over,9,0.5,100,0.4772727272727273,NYM,WSH,2023 REG,11,5,6,2,7,17,1,0,3,-3,1,1,0,0,0,0,0,0,0,0.4772727272727273,0.5227272727272727
90711,0.696969696969697,0.3448275862068966,-230,190,0.6678382571799499,0.33216174282005007,home,NYM,under,9,0.5454545454545454,-120,0.5227272727272727,NYM,WSH,2023 REG,11,5,6,2,7,17,1,0,3,-3,1,1,0,0,0,0,0,0,0,0.4772727272727273,0.5227272727272727
90712,0.6721311475409836,0.37037037037037035,-205,170,0.6435645535349916,0.35643544646500835,away,STL,over,8.5,0.5412844036697247,-118,0.5175913212324037,SD,STL,2023 REG,18,12,6,2,14,24,1,0,10,-10,1,1,0,0,0,0,0,0,0,0.5175913212324037,0.4824086787675963
90712,0.6721311475409836,0.37037037037037035,-205,170,0.6435645535349916,0.35643544646500835,home,SD,under,8.5,0.5024875621890548,-101,0.4824086787675963,SD,STL,2023 REG,18,12,6,2,14,24,1,0,10,-10,1,1,0,0,0,0,0,0,0,0.5175913212324037,0.4824086787675963
90713,0.4587155963302753,0.5833333333333333,118,-140,0.4394270964845833,0.5605729035154168,away,CWS,over,11.5,0.5391705069124424,-117,0.5127649394825569,COL,CWS,2023 REG,8,5,14,10,15,22,0,1,-5,5,1,1,1,1,1,0,0,0,0,0.5127649394825569,0.48723506051744314
90713,0.4587155963302753,0.5833333333333333,118,-140,0.4394270964845833,0.5605729035154168,home,COL,under,11.5,0.5098039215686274,-104,0.48723506051744314,COL,CWS,2023 REG,8,5,14,10,15,22,0,1,-5,5,1,1,1,1,1,0,0,0,0,0.5127649394825569,0.48723506051744314
90714,0.5192307692307692,0.5238095238095238,-108,-110,0.49688292476754015,0.5031170752324599,away,TOR,over,9.5,0.5283018867924528,-112,0.5044173060022736,BOS,TOR,2023 REG,10,4,14,5,9,24,0,1,-1,1,1,1,1,1,0,0,0,0,0,0.5044173060022736,0.49558269399772636
90714,0.5192307692307692,0.5238095238095238,-108,-110,0.49688292476754015,0.5031170752324599,home,BOS,under,9.5,0.5169082125603864,-107,0.49558269399772636,BOS,TOR,2023 REG,10,4,14,5,9,24,0,1,-1,1,1,1,1,1,0,0,0,0,0,0.5044173060022736,0.49558269399772636
90715,0.5,0.5454545454545454,100,-120,0.4772727272727273,0.5227272727272727,away,LAA,over,8,0.5098039215686274,-104,0.48375889301574193,BAL,LAA,2023 REG,6,5,17,9,14,23,0,1,-4,4,1,1,1,1,1,0,0,0,0,0.48375889301574193,0.5162411069842581
90715,0.5,0.5454545454545454,100,-120,0.4772727272727273,0.5227272727272727,home,BAL,under,8,0.5412844036697247,-118,0.5162411069842581,BAL,LAA,2023 REG,6,5,17,9,14,23,0,1,-4,4,1,1,1,1,1,0,0,0,0,0.48375889301574193,0.5162411069842581
90716,0.47619047619047616,0.5652173913043479,110,-130,0.4564724440500838,0.5435275559499162,away,ARI,over,8.5,0.5454545454545454,-120,0.5206611570247933,PIT,ARI,2023 REG,3,3,9,8,11,12,0,1,-5,5,1,1,1,0,0,0,0,0,0,0.5206611570247933,0.4793388429752067
90716,0.47619047619047616,0.5652173913043479,110,-130,0.4564724440500838,0.5435275559499162,home,PIT,under,8.5,0.5,100,0.4793388429752067,PIT,ARI,2023 REG,3,3,9,8,11,12,0,1,-5,5,1,1,1,0,0,0,0,0,0,0.5206611570247933,0.4793388429752067
90717,0.5238095238095238,0.5238095238095238,-110,-110,0.4988662131519274,0.5011337868480725,away,BOS,over,7.5,0.5238095238095238,-110,0.4988662131519274,CLE,BOS,2023 REG,10,4,10,5,9,20,0,1,-1,1,1,1,1,1,0,0,0,0,0,0.4988662131519274,0.5011337868480725
90717,0.5238095238095238,0.5238095238095238,-110,-110,0.4988662131519274,0.5011337868480725,home,CLE,under,7.5,0.5238095238095238,-110,0.5011337868480725,CLE,BOS,2023 REG,10,4,10,5,9,20,0,1,-1,1,1,1,1,1,0,0,0,0,0,0.4988662131519274,0.5011337868480725
90718,0.5901639344262295,0.4444444444444444,-144,125,0.569739317387799,0.43026068261220096,away,MIL,over,7.5,0.5192307692307692,-108,0.49571111079951763,SD,MIL,2023 REG,12,10,12,3,13,24,1,0,7,-7,1,1,1,0,0,0,0,0,0,0.49571111079951763,0.5042888892004824
90718,0.5901639344262295,0.4444444444444444,-144,125,0.569739317387799,0.43026068261220096,home,SD,under,7.5,0.5260663507109005,-111,0.5042888892004824,SD,MIL,2023 REG,12,10,12,3,13,24,1,0,7,-7,1,1,1,0,0,0,0,0,0,0.49571111079951763,0.5042888892004824
90719,0.5901639344262295,0.4484304932735426,-144,123,0.5673868951280033,0.43261310487199667,away,KC,over,9.5,0.5348837209302326,-115,0.5109810284308424,ARI,KC,2023 REG,10,4,14,5,9,24,0,1,-1,1,1,1,1,1,0,0,0,0,0,0.5109810284308424,0.48901897156915763
90719,0.5901639344262295,0.4484304932735426,-144,123,0.5673868951280033,0.43261310487199667,home,ARI,under,9.5,0.5098039215686274,-104,0.48901897156915763,ARI,KC,2023 REG,10,4,14,5,9,24,0,1,-1,1,1,1,1,1,0,0,0,0,0,0.5109810284308424,0.48901897156915763
90720,0.6031746031746031,0.43859649122807015,-152,128,0.5779793398841018,0.4220206601158982,away,BAL,over,8.5,0.5238095238095238,-110,0.4988662131519274,TB,BAL,2023 REG,3,3,8,5,8,11,0,1,-2,2,1,1,1,0,0,0,0,0,0,0.4988662131519274,0.5011337868480725
90720,0.6031746031746031,0.43859649122807015,-152,128,0.5779793398841018,0.4220206601158982,home,TB,under,8.5,0.5238095238095238,-110,0.5011337868480725,TB,BAL,2023 REG,3,3,8,5,8,11,0,1,-2,2,1,1,1,0,0,0,0,0,0,0.4988662131519274,0.5011337868480725
90721,0.5967741935483871,0.4444444444444444,-148,125,0.5721759741010521,0.42782402589894786,away,BAL,over,7.5,0.5348837209302326,-115,0.5097020142727117,SEA,BAL,2023 REG,12,9,4,2,11,16,1,0,7,-7,1,1,0,0,0,0,0,0,0,0.5097020142727117,0.49029798572728833
90721,0.5967741935483871,0.4444444444444444,-148,125,0.5721759741010521,0.42782402589894786,home,SEA,under,7.5,0.5121951219512195,-105,0.49029798572728833,SEA,BAL,2023 REG,12,9,4,2,11,16,1,0,7,-7,1,1,0,0,0,0,0,0,0,0.5097020142727117,0.49029798572728833
90722,0.4166666666666667,0.6226415094339623,140,-165,0.4002882599580712,0.5997117400419287,away,MIA,over,8,0.5305164319248826,-113,0.5053568787472517,WSH,MIA,2023 REG,8,5,9,8,13,17,0,1,-3,3,1,1,1,1,1,0,0,0,0,0.5053568787472517,0.49464312125274834
90722,0.4166666666666667,0.6226415094339623,140,-165,0.4002882599580712,0.5997117400419287,home,WSH,under,8,0.5169082125603864,-107,0.49464312125274834,WSH,MIA,2023 REG,8,5,9,8,13,17,0,1,-3,3,1,1,1,1,1,0,0,0,0,0.5053568787472517,0.49464312125274834
90723,0.5192307692307692,0.5215311004784688,-108,-109,0.49806595226635714,0.5019340477336429,away,BOS,over,8,0.5238095238095238,-110,0.4988662131519274,SEA,BOS,2023 REG,9,4,9,6,10,18,0,1,-2,2,1,1,1,1,0,0,0,0,0,0.4988662131519274,0.5011337868480725
90723,0.5192307692307692,0.5215311004784688,-108,-109,0.49806595226635714,0.5019340477336429,home,SEA,under,8,0.5238095238095238,-110,0.5011337868480725,SEA,BOS,2023 REG,9,4,9,6,10,18,0,1,-2,2,1,1,1,1,0,0,0,0,0,0.4988662131519274,0.5011337868480725
90724,0.6031746031746031,0.43103448275862066,-152,132,0.582540551341865,0.417459448658135,away,MIL,over,9,0.5215311004784688,-109,0.49670754937970685,SD,MIL,2023 REG,6,3,6,4,7,12,0,1,-1,1,1,1,1,0,0,0,0,0,0,0.49670754937970685,0.5032924506202932
90724,0.6031746031746031,0.43103448275862066,-152,132,0.582540551341865,0.417459448658135,home,SD,under,9,0.5260663507109005,-111,0.5032924506202932,SD,MIL,2023 REG,6,3,6,4,7,12,0,1,-1,1,1,1,1,0,0,0,0,0,0,0.49670754937970685,0.5032924506202932
90725,0.5555555555555556,0.48780487804878053,-125,105,0.5314664257753688,0.46853357422463116,away,HOU,over,9,0.5024875621890548,-101,0.47839724939301687,STL,HOU,2023 REG,11,7,11,10,17,22,0,1,-3,3,1,1,1,1,1,1,1,0,0,0.47839724939301687,0.5216027506069831
90725,0.5555555555555556,0.48780487804878053,-125,105,0.5314664257753688,0.46853357422463116,home,STL,under,9,0.5454545454545454,-120,0.5216027506069831,STL,HOU,2023 REG,11,7,11,10,17,22,0,1,-3,3,1,1,1,1,1,1,1,0,0,0.47839724939301687,0.5216027506069831
90726,0.5475113122171946,0.49504950495049505,-121,102,0.5242087833606768,0.4757912166393232,away,DET,over,7,0.5215311004784688,-109,0.4978845547971712,CLE,DET,2023 REG,5,2,8,4,6,13,0,1,-2,2,1,1,0,0,0,0,0,0,0,0.4978845547971712,0.5021154452028288
90726,0.5475113122171946,0.49504950495049505,-121,102,0.5242087833606768,0.4757912166393232,home,CLE,under,7,0.5238095238095238,-110,0.5021154452028288,CLE,DET,2023 REG,5,2,8,4,6,13,0,1,-2,2,1,1,0,0,0,0,0,0,0,0.4978845547971712,0.5021154452028288
90727,0.48780487804878053,0.5555555555555556,105,-125,0.4666534470222751,0.5333465529777248,away,HOU,over,9.5,0.5,100,0.4783105022831051,LAA,HOU,2023 REG,8,4,8,5,9,16,0,1,-1,1,1,1,1,1,0,0,0,0,0,0.4783105022831051,0.5216894977168949
90727,0.48780487804878053,0.5555555555555556,105,-125,0.4666534470222751,0.5333465529777248,home,LAA,under,9.5,0.5433789954337899,-119,0.5216894977168949,LAA,HOU,2023 REG,8,4,8,5,9,16,0,1,-1,1,1,1,1,1,0,0,0,0,0,0.4783105022831051,0.5216894977168949
90728,0.5283018867924528,0.5169082125603864,-112,-107,0.5044173060022736,0.49558269399772636,away,CHC,over,8.5,0.5238095238095238,-110,0.4988662131519274,TOR,CHC,2023 REG,8,4,7,5,9,15,0,1,-1,1,1,1,1,1,0,0,0,0,0,0.4988662131519274,0.5011337868480725
90728,0.5283018867924528,0.5169082125603864,-112,-107,0.5044173060022736,0.49558269399772636,home,TOR,under,8.5,0.5238095238095238,-110,0.5011337868480725,TOR,CHC,2023 REG,8,4,7,5,9,15,0,1,-1,1,1,1,1,1,0,0,0,0,0,0.4988662131519274,0.5011337868480725
90729,0.6666666666666666,0.37037037037037035,-200,170,0.6419753086419753,0.3580246913580247,away,COL,over,10,0.5238095238095238,-110,0.4988662131519274,CIN,COL,2023 REG,11,8,8,6,14,19,1,0,2,-2,1,1,1,1,1,1,0,0,0,0.4988662131519274,0.5011337868480725
90729,0.6666666666666666,0.37037037037037035,-200,170,0.6419753086419753,0.3580246913580247,home,CIN,under,10,0.5238095238095238,-110,0.5011337868480725,CIN,COL,2023 REG,11,8,8,6,14,19,1,0,2,-2,1,1,1,1,1,1,0,0,0,0.4988662131519274,0.5011337868480725
90730,0.42016806722689076,0.6124031007751938,138,-158,0.4064827025201325,0.5935172974798675,away,TB,over,8.5,0.5238095238095238,-110,0.5000596729920038,CWS,TB,2023 REG,7,2,9,3,5,16,0,1,-1,1,1,1,0,0,0,0,0,0,0,0.5000596729920038,0.4999403270079962
90730,0.42016806722689076,0.6124031007751938,138,-158,0.4064827025201325,0.5935172974798675,home,CWS,under,8.5,0.5215311004784688,-109,0.4999403270079962,CWS,TB,2023 REG,7,2,9,3,5,16,0,1,-1,1,1,1,0,0,0,0,0,0,0,0.5000596729920038,0.4999403270079962
90731,0.5495495495495495,0.49019607843137253,-122,104,0.5277073575960698,0.4722926424039302,away,BOS,over,7.5,0.5412844036697247,-118,0.5189377998484975,SD,BOS,2023 REG,3,2,7,4,6,10,0,1,-2,2,1,1,0,0,0,0,0,0,0,0.5189377998484975,0.4810622001515025
90731,0.5495495495495495,0.49019607843137253,-122,104,0.5277073575960698,0.4722926424039302,home,SD,under,7.5,0.5,100,0.4810622001515025,SD,BOS,2023 REG,3,2,7,4,6,10,0,1,-2,2,1,1,0,0,0,0,0,0,0,0.5189377998484975,0.4810622001515025
90732,0.5305164319248826,0.5121951219512195,-113,-105,0.5078572507605655,0.49214274923943446,away,HOU,over,7.5,0.5238095238095238,-110,0.4988662131519274,MIN,HOU,2023 REG,12,9,7,6,15,19,1,0,3,-3,1,1,1,1,1,1,0,0,0,0.4988662131519274,0.5011337868480725
90732,0.5305164319248826,0.5121951219512195,-113,-105,0.5078572507605655,0.49214274923943446,home,MIN,under,7.5,0.5238095238095238,-110,0.5011337868480725,MIN,HOU,2023 REG,12,9,7,6,15,19,1,0,3,-3,1,1,1,1,1,1,0,0,0,0.4988662131519274,0.5011337868480725
90733,0.5798319327731092,0.4587155963302753,-138,118,0.557480844469466,0.442519155530534,away,SF,over,8,0.5,100,0.47935779816513757,CWS,SF,2023 REG,5,3,14,12,15,19,0,1,-9,9,1,1,1,0,0,0,0,0,0,0.47935779816513757,0.5206422018348624
90733,0.5798319327731092,0.4587155963302753,-138,118,0.557480844469466,0.442519155530534,home,CWS,under,8,0.5412844036697247,-118,0.5206422018348624,CWS,SF,2023 REG,5,3,14,12,15,19,0,1,-9,9,1,1,1,0,0,0,0,0,0,0.47935779816513757,0.5206422018348624
90734,0.5652173913043479,0.47619047619047616,-130,110,0.5418129444594474,0.4581870555405526,away,CWS,over,8.5,0.5348837209302326,-115,0.5097020142727117,NYY,CWS,2023 REG,6,3,2,0,3,8,1,0,3,-3,0,0,0,0,0,0,0,0,0,0.5097020142727117,0.49029798572728833
90734,0.5652173913043479,0.47619047619047616,-130,110,0.5418129444594474,0.4581870555405526,home,NYY,under,8.5,0.5121951219512195,-105,0.49029798572728833,NYY,CWS,2023 REG,6,3,2,0,3,8,1,0,3,-3,0,0,0,0,0,0,0,0,0,0.5097020142727117,0.49029798572728833
90735,0.5,0.5454545454545454,100,-120,0.4772727272727273,0.5227272727272727,away,STL,over,9,0.5098039215686274,-104,0.48592421718142587,NYM,STL,2023 REG,8,6,5,1,7,13,1,0,5,-5,1,0,0,0,0,0,0,0,0,0.48592421718142587,0.5140757828185741
90735,0.5,0.5454545454545454,100,-120,0.4772727272727273,0.5227272727272727,home,NYM,under,9,0.5370370370370371,-116,0.5140757828185741,NYM,STL,2023 REG,8,6,5,1,7,13,1,0,5,-5,1,0,0,0,0,0,0,0,0,0.48592421718142587,0.5140757828185741
90736,0.3333333333333333,0.7142857142857143,200,-250,0.31746031746031744,0.6825396825396826,away,LAD,over,9.5,0.5238095238095238,-110,0.4988662131519274,KC,LAD,2023 REG,9,3,11,9,12,20,0,1,-6,6,1,1,1,0,0,0,0,0,0,0.4988662131519274,0.5011337868480725
90736,0.3333333333333333,0.7142857142857143,200,-250,0.31746031746031744,0.6825396825396826,home,KC,under,9.5,0.5238095238095238,-110,0.5011337868480725,KC,LAD,2023 REG,9,3,11,9,12,20,0,1,-6,6,1,1,1,0,0,0,0,0,0,0.4988662131519274,0.5011337868480725
90737,0.7058823529411764,0.33783783783783783,-240,196,0.6750210418030487,0.32497895819695133,away,LAA,over,8,0.5098039215686274,-104,0.48592421718142587,SEA,LAA,2023 REG,10,5,12,8,13,22,0,1,-3,3,1,1,1,1,1,0,0,0,0,0.48592421718142587,0.5140757828185741
90737,0.7058823529411764,0.33783783783783783,-240,196,0.6750210418030487,0.32497895819695133,home,SEA,under,8,0.5370370370370371,-116,0.5140757828185741,SEA,LAA,2023 REG,10,5,12,8,13,22,0,1,-3,3,1,1,1,1,1,0,0,0,0,0.48592421718142587,0.5140757828185741
90738,0.7142857142857143,0.3205128205128205,-250,212,0.6894296180010466,0.31057038199895337,away,DET,over,7.5,0.5238095238095238,-110,0.5000596729920038,HOU,DET,2023 REG,11,8,7,2,10,18,1,0,6,-6,1,1,0,0,0,0,0,0,0,0.5000596729920038,0.4999403270079962
90738,0.7142857142857143,0.3205128205128205,-250,212,0.6894296180010466,0.31057038199895337,home,HOU,under,7.5,0.5215311004784688,-109,0.4999403270079962,HOU,DET,2023 REG,11,8,7,2,10,18,1,0,6,-6,1,1,0,0,0,0,0,0,0,0.5000596729920038,0.4999403270079962
90739,0.4166666666666667,0.6226415094339623,140,-165,0.4002882599580712,0.5997117400419287,away,LAA,over,10,0.5238095238095238,-110,0.5000596729920038,KC,LAA,2023 REG,11,10,12,9,19,23,1,0,1,-1,1,1,1,1,1,1,1,1,1,0.5000596729920038,0.4999403270079962
90739,0.4166666666666667,0.6226415094339623,140,-165,0.4002882599580712,0.5997117400419287,home,KC,under,10,0.5215311004784688,-109,0.4999403270079962,KC,LAA,2023 REG,11,10,12,9,19,23,1,0,1,-1,1,1,1,1,1,1,1,1,1,0.5000596729920038,0.4999403270079962
90740,0.5726495726495727,0.4672897196261683,-134,114,0.5497783539959433,0.4502216460040567,away,DET,over,9.5,0.5348837209302326,-115,0.5097020142727117,BOS,DET,2023 REG,12,6,7,3,9,19,1,0,3,-3,1,1,1,0,0,0,0,0,0,0.5097020142727117,0.49029798572728833
90740,0.5726495726495727,0.4672897196261683,-134,114,0.5497783539959433,0.4502216460040567,home,BOS,under,9.5,0.5121951219512195,-105,0.49029798572728833,BOS,DET,2023 REG,12,6,7,3,9,19,1,0,3,-3,1,1,1,0,0,0,0,0,0,0.5097020142727117,0.49029798572728833
90741,0.5238095238095238,0.5238095238095238,-110,-110,0.4988662131519274,0.5011337868480725,away,SF,over,9,0.5121951219512195,-105,0.48808156828023186,DET,SF,2023 REG,12,5,4,1,6,16,1,0,4,-4,1,0,0,0,0,0,0,0,0,0.48808156828023186,0.5119184317197681
90741,0.5238095238095238,0.5238095238095238,-110,-110,0.4988662131519274,0.5011337868480725,home,DET,under,9,0.5348837209302326,-115,0.5119184317197681,DET,SF,2023 REG,12,5,4,1,6,16,1,0,4,-4,1,0,0,0,0,0,0,0,0,0.48808156828023186,0.5119184317197681
90742,0.647887323943662,0.3861003861003861,-184,159,0.6258671174362505,0.37413288256374955,away,CWS,over,9,0.5327102803738317,-114,0.508788710910954,TB,CWS,2023 REG,10,8,10,7,15,20,1,0,1,-1,1,1,1,1,1,1,1,0,0,0.508788710910954,0.491211289089046
90742,0.647887323943662,0.3861003861003861,-184,159,0.6258671174362505,0.37413288256374955,home,TB,under,9,0.5121951219512195,-105,0.491211289089046,TB,CWS,2023 REG,10,8,10,7,15,20,1,0,1,-1,1,1,1,1,1,1,1,0,0,0.508788710910954,0.491211289089046
90743,0.6428571428571428,0.3921568627450981,-180,155,0.6203481392557023,0.3796518607442977,away,COL,over,8.5,0.5098039215686274,-104,0.48592421718142587,PIT,COL,2023 REG,7,2,4,0,2,11,1,0,2,-2,0,0,0,0,0,0,0,0,0,0.48592421718142587,0.5140757828185741
90743,0.6428571428571428,0.3921568627450981,-180,155,0.6203481392557023,0.3796518607442977,home,PIT,under,8.5,0.5370370370370371,-116,0.5140757828185741,PIT,COL,2023 REG,7,2,4,0,2,11,1,0,2,-2,0,0,0,0,0,0,0,0,0,0.48592421718142587,0.5140757828185741
90744,0.5652173913043479,0.47619047619047616,-130,110,0.5418129444594474,0.4581870555405526,away,SEA,over,9.5,0.5,100,0.47935779816513757,TEX,SEA,2023 REG,8,8,8,5,13,16,1,0,3,-3,1,1,1,1,1,0,0,0,0,0.47935779816513757,0.5206422018348624
90744,0.5652173913043479,0.47619047619047616,-130,110,0.5418129444594474,0.4581870555405526,home,TEX,under,9.5,0.5412844036697247,-118,0.5206422018348624,TEX,SEA,2023 REG,8,8,8,5,13,16,1,0,3,-3,1,1,1,1,1,0,0,0,0,0.47935779816513757,0.5206422018348624
90745,0.6240601503759399,0.41152263374485604,-166,143,0.6018543527667214,0.3981456472332786,away,BOS,over,8.5,0.5454545454545454,-120,0.5206611570247933,MIL,BOS,2023 REG,8,3,8,5,8,16,0,1,-2,2,1,1,1,0,0,0,0,0,0,0.5206611570247933,0.4793388429752067
90745,0.6240601503759399,0.41152263374485604,-166,143,0.6018543527667214,0.3981456472332786,home,MIL,under,8.5,0.5,100,0.4793388429752067,MIL,BOS,2023 REG,8,3,8,5,8,16,0,1,-2,2,1,1,1,0,0,0,0,0,0,0.5206611570247933,0.4793388429752067
90746,0.696969696969697,0.3448275862068966,-230,190,0.6678382571799499,0.33216174282005007,away,KC,over,8.5,0.5192307692307692,-108,0.49688292476754015,HOU,KC,2023 REG,8,5,5,7,12,13,0,1,-2,2,1,1,1,1,1,0,0,0,0,0.49688292476754015,0.5031170752324599
90746,0.696969696969697,0.3448275862068966,-230,190,0.6678382571799499,0.33216174282005007,home,HOU,under,8.5,0.5238095238095238,-110,0.5031170752324599,HOU,KC,2023 REG,8,5,5,7,12,13,0,1,-2,2,1,1,1,1,1,0,0,0,0,0.49688292476754015,0.5031170752324599
90747,0.6000000000000001,0.43859649122807015,-150,128,0.5768421052631579,0.42315789473684207,away,CHC,over,8.5,0.5454545454545454,-120,0.5206611570247933,NYY,CHC,2023 REG,11,4,6,7,11,17,0,1,-3,3,1,1,1,1,0,0,0,0,0,0.5206611570247933,0.4793388429752067
90747,0.6000000000000001,0.43859649122807015,-150,128,0.5768421052631579,0.42315789473684207,home,NYY,under,8.5,0.5,100,0.4793388429752067,NYY,CHC,2023 REG,11,4,6,7,11,17,0,1,-3,3,1,1,1,1,0,0,0,0,0,0.5206611570247933,0.4793388429752067
90748,0.4587155963302753,0.5815899581589958,118,-139,0.4402268098673069,0.5597731901326931,away,NYY,over,8,0.5098039215686274,-104,0.4870219861770517,OAK,NYY,2023 REG,5,2,7,1,3,12,1,0,1,-1,1,0,0,0,0,0,0,0,0,0.4870219861770517,0.5129780138229483
90748,0.4587155963302753,0.5815899581589958,118,-139,0.4402268098673069,0.5597731901326931,home,OAK,under,8,0.5348837209302326,-115,0.5129780138229483,OAK,NYY,2023 REG,5,2,7,1,3,12,1,0,1,-1,1,0,0,0,0,0,0,0,0,0.4870219861770517,0.5129780138229483
90749,0.47619047619047616,0.5652173913043479,110,-130,0.4564724440500838,0.5435275559499162,away,CLE,over,8.5,0.5098039215686274,-104,0.4870219861770517,LAA,CLE,2023 REG,5,3,13,6,9,18,0,1,-3,3,1,1,1,0,0,0,0,0,0,0.4870219861770517,0.5129780138229483
90749,0.47619047619047616,0.5652173913043479,110,-130,0.4564724440500838,0.5435275559499162,home,LAA,under,8.5,0.5348837209302326,-115,0.5129780138229483,LAA,CLE,2023 REG,5,3,13,6,9,18,0,1,-3,3,1,1,1,0,0,0,0,0,0,0.4870219861770517,0.5129780138229483
90750,0.47619047619047616,0.5652173913043479,110,-130,0.4564724440500838,0.5435275559499162,away,MIL,over,8.5,0.5238095238095238,-110,0.4988662131519274,PIT,MIL,2023 REG,11,8,9,7,15,20,1,0,1,-1,1,1,1,1,1,1,1,0,0,0.4988662131519274,0.5011337868480725
90750,0.47619047619047616,0.5652173913043479,110,-130,0.4564724440500838,0.5435275559499162,home,PIT,under,8.5,0.5238095238095238,-110,0.5011337868480725,PIT,MIL,2023 REG,11,8,9,7,15,20,1,0,1,-1,1,1,1,1,1,1,1,0,0,0.4988662131519274,0.5011337868480725
90751,0.5,0.5454545454545454,100,-120,0.4772727272727273,0.5227272727272727,away,SEA,over,8.5,0.5475113122171946,-121,0.5214983313199976,DET,SEA,2023 REG,7,2,11,9,11,18,0,1,-7,7,1,1,0,0,0,0,0,0,0,0.5214983313199976,0.47850166868000243
90751,0.5,0.5454545454545454,100,-120,0.4772727272727273,0.5227272727272727,home,DET,under,8.5,0.5,100,0.47850166868000243,DET,SEA,2023 REG,7,2,11,9,11,18,0,1,-7,7,1,1,0,0,0,0,0,0,0,0.5214983313199976,0.47850166868000243
90752,0.5098039215686274,0.5305164319248826,-104,-113,0.4892484472386027,0.5107515527613973,away,MIA,over,7.5,0.5391705069124424,-117,0.5140669063204599,CHC,MIA,2023 REG,11,4,9,5,9,20,0,1,-1,1,1,1,1,1,0,0,0,0,0,0.5140669063204599,0.4859330936795401
90752,0.5098039215686274,0.5305164319248826,-104,-113,0.4892484472386027,0.5107515527613973,home,CHC,under,7.5,0.5073891625615764,-103,0.4859330936795401,CHC,MIA,2023 REG,11,4,9,5,9,20,0,1,-1,1,1,1,1,1,0,0,0,0,0,0.5140669063204599,0.4859330936795401
90753,0.4854368932038835,0.5555555555555556,106,-125,0.465537646233282,0.534462353766718,away,SF,over,8,0.5283018867924528,-112,0.5044173060022736,STL,SF,2023 REG,10,3,12,4,7,22,0,1,-1,1,1,1,1,0,0,0,0,0,0,0.5044173060022736,0.49558269399772636
90753,0.4854368932038835,0.5555555555555556,106,-125,0.465537646233282,0.534462353766718,home,STL,under,8,0.5169082125603864,-107,0.49558269399772636,STL,SF,2023 REG,10,3,12,4,7,22,0,1,-1,1,1,1,1,0,0,0,0,0,0,0.5044173060022736,0.49558269399772636
90754,0.6108949416342413,0.425531914893617,-157,135,0.5886419592417365,0.41135804075826354,away,COL,over,10,0.5238095238095238,-110,0.4988662131519274,ARI,COL,2023 REG,10,6,3,0,6,13,1,0,6,-6,0,0,0,0,0,0,0,0,0,0.4988662131519274,0.5011337868480725
90754,0.6108949416342413,0.425531914893617,-157,135,0.5886419592417365,0.41135804075826354,home,ARI,under,10,0.5238095238095238,-110,0.5011337868480725,ARI,COL,2023 REG,10,6,3,0,6,13,1,0,6,-6,0,0,0,0,0,0,0,0,0,0.4988662131519274,0.5011337868480725
90755,0.5867768595041323,0.45454545454545453,-142,120,0.5625298818386723,0.43747011816132775,away,MIA,over,8,0.5121951219512195,-105,0.48808156828023186,NYM,MIA,2023 REG,6,2,7,4,6,13,0,1,-2,2,1,1,0,0,0,0,0,0,0,0.48808156828023186,0.5119184317197681
90755,0.5867768595041323,0.45454545454545453,-142,120,0.5625298818386723,0.43747011816132775,home,NYM,under,8,0.5348837209302326,-115,0.5119184317197681,NYM,MIA,2023 REG,6,2,7,4,6,13,0,1,-2,2,1,1,0,0,0,0,0,0,0,0.48808156828023186,0.5119184317197681
90756,0.5967741935483871,0.4444444444444444,-148,125,0.5721759741010521,0.42782402589894786,away,CWS,over,9,0.5,100,0.4772727272727273,LAD,CWS,2023 REG,9,5,8,4,9,17,1,0,1,-1,1,1,1,1,0,0,0,0,0,0.4772727272727273,0.5227272727272727
90756,0.5967741935483871,0.4444444444444444,-148,125,0.5721759741010521,0.42782402589894786,home,LAD,under,9,0.5454545454545454,-120,0.5227272727272727,LAD,CWS,2023 REG,9,5,8,4,9,17,1,0,1,-1,1,1,1,1,0,0,0,0,0,0.4772727272727273,0.5227272727272727
90757,0.5884773662551441,0.4504504504504505,-143,122,0.5655692272061728,0.43443077279382725,away,CWS,over,7.5,0.5145631067961165,-106,0.4913668392989033,HOU,CWS,2023 REG,4,2,11,3,5,15,0,1,-1,1,1,1,0,0,0,0,0,0,0,0.4913668392989033,0.5086331607010968
90757,0.5884773662551441,0.4504504504504505,-143,122,0.5655692272061728,0.43443077279382725,home,HOU,under,7.5,0.5305164319248826,-113,0.5086331607010968,HOU,CWS,2023 REG,4,2,11,3,5,15,0,1,-1,1,1,1,0,0,0,0,0,0,0,0.4913668392989033,0.5086331607010968
90758,0.5652173913043479,0.47619047619047616,-130,110,0.5418129444594474,0.4581870555405526,away,MIL,over,6.5,0.5283018867924528,-112,0.5044173060022736,CHC,MIL,2023 REG,8,1,7,0,1,15,1,0,1,-1,0,0,0,0,0,0,0,0,0,0.5044173060022736,0.49558269399772636
90758,0.5652173913043479,0.47619047619047616,-130,110,0.5418129444594474,0.4581870555405526,home,CHC,under,6.5,0.5169082125603864,-107,0.49558269399772636,CHC,MIL,2023 REG,8,1,7,0,1,15,1,0,1,-1,0,0,0,0,0,0,0,0,0,0.5044173060022736,0.49558269399772636
90759,0.3472222222222222,0.6923076923076923,188,-225,0.3334965574548908,0.6665034425451092,away,MIN,over,8.5,0.5495495495495495,-122,0.5250401592387142,CWS,MIN,2023 REG,11,7,9,6,13,20,1,0,1,-1,1,1,1,1,1,1,0,0,0,0.5250401592387142,0.47495984076128583
90759,0.3472222222222222,0.6923076923076923,188,-225,0.3334965574548908,0.6665034425451092,home,CWS,under,8.5,0.49504950495049505,102,0.47495984076128583,CWS,MIN,2023 REG,11,7,9,6,13,20,1,0,1,-1,1,1,1,1,1,1,0,0,0,0.5250401592387142,0.47495984076128583
90760,0.6875,0.3508771929824561,-220,185,0.6611156798245614,0.33888432017543857,away,OAK,over,8.5,0.5098039215686274,-104,0.48375889301574193,DET,OAK,2023 REG,4,3,14,12,15,18,0,1,-9,9,1,1,1,0,0,0,0,0,0,0.48375889301574193,0.5162411069842581
90760,0.6875,0.3508771929824561,-220,185,0.6611156798245614,0.33888432017543857,home,DET,under,8.5,0.5412844036697247,-118,0.5162411069842581,DET,OAK,2023 REG,4,3,14,12,15,18,0,1,-9,9,1,1,1,0,0,0,0,0,0,0.48375889301574193,0.5162411069842581
90761,0.4132231404958678,0.6323529411764706,142,-172,0.394390048895728,0.6056099511042721,away,SF,over,11.5,0.5192307692307692,-108,0.4922613780899187,COL,SF,2023 REG,10,5,10,2,7,20,1,0,3,-3,1,1,0,0,0,0,0,0,0,0.4922613780899187,0.5077386219100812
90761,0.4132231404958678,0.6323529411764706,142,-172,0.394390048895728,0.6056099511042721,home,COL,under,11.5,0.5327102803738317,-114,0.5077386219100812,COL,SF,2023 REG,10,5,10,2,7,20,1,0,3,-3,1,1,0,0,0,0,0,0,0,0.4922613780899187,0.5077386219100812
90762,0.6363636363636364,0.4081632653061224,-175,145,0.6080283353010626,0.3919716646989374,away,PIT,over,8.5,0.5433789954337899,-119,0.5198077604720502,CHC,PIT,2023 REG,10,6,11,8,14,21,0,1,-2,2,1,1,1,1,1,1,0,0,0,0.5198077604720502,0.48019223952794976
90762,0.6363636363636364,0.4081632653061224,-175,145,0.6080283353010626,0.3919716646989374,home,CHC,under,8.5,0.5,100,0.48019223952794976,CHC,PIT,2023 REG,10,6,11,8,14,21,0,1,-2,2,1,1,1,1,1,1,0,0,0,0.5198077604720502,0.48019223952794976
90763,0.6551724137931035,0.38167938931297707,-190,162,0.6310281289994645,0.3689718710005355,away,CLE,over,8.5,0.5348837209302326,-115,0.5097020142727117,ARI,CLE,2023 REG,11,5,7,1,6,18,1,0,4,-4,1,0,0,0,0,0,0,0,0,0.5097020142727117,0.49029798572728833
90763,0.6551724137931035,0.38167938931297707,-190,162,0.6310281289994645,0.3689718710005355,home,ARI,under,8.5,0.5121951219512195,-105,0.49029798572728833,ARI,CLE,2023 REG,11,5,7,1,6,18,1,0,4,-4,1,0,0,0,0,0,0,0,0,0.5097020142727117,0.49029798572728833
90764,0.5454545454545454,0.5,-120,100,0.5206611570247933,0.4793388429752067,away,PIT,over,7.5,0.5348837209302326,-115,0.5097020142727117,SF,PIT,2023 REG,12,4,14,9,13,26,0,1,-5,5,1,1,1,1,0,0,0,0,0,0.5097020142727117,0.49029798572728833
90764,0.5454545454545454,0.5,-120,100,0.5206611570247933,0.4793388429752067,home,SF,under,7.5,0.5121951219512195,-105,0.49029798572728833,SF,PIT,2023 REG,12,4,14,9,13,26,0,1,-5,5,1,1,1,1,0,0,0,0,0,0.5097020142727117,0.49029798572728833
90765,0.4629629629629629,0.5833333333333333,116,-140,0.44152949245541834,0.5584705075445817,away,TB,over,7.5,0.5121951219512195,-105,0.48808156828023186,BOS,TB,2023 REG,3,0,10,5,5,13,0,1,-5,5,0,0,0,0,0,0,0,0,0,0.48808156828023186,0.5119184317197681
90765,0.4629629629629629,0.5833333333333333,116,-140,0.44152949245541834,0.5584705075445817,home,BOS,under,7.5,0.5348837209302326,-115,0.5119184317197681,BOS,TB,2023 REG,3,0,10,5,5,13,0,1,-5,5,0,0,0,0,0,0,0,0,0,0.48808156828023186,0.5119184317197681
90766,0.5884773662551441,0.4444444444444444,-143,125,0.5691036258022998,0.4308963741977002,away,CHC,over,9,0.5024875621890548,-101,0.47839724939301687,LAD,CHC,2023 REG,5,2,4,1,3,9,1,0,1,-1,1,0,0,0,0,0,0,0,0,0.47839724939301687,0.5216027506069831
90766,0.5884773662551441,0.4444444444444444,-143,125,0.5691036258022998,0.4308963741977002,home,LAD,under,9,0.5454545454545454,-120,0.5216027506069831,LAD,CHC,2023 REG,5,2,4,1,3,9,1,0,1,-1,1,0,0,0,0,0,0,0,0,0.47839724939301687,0.5216027506069831
90767,0.46511627906976744,0.5726495726495727,115,-134,0.4475507666421673,0.5524492333578327,away,TB,over,8.5,0.5238095238095238,-110,0.4988662131519274,TOR,TB,2023 REG,6,1,11,8,9,17,0,1,-7,7,1,0,0,0,0,0,0,0,0,0.4988662131519274,0.5011337868480725
90767,0.46511627906976744,0.5726495726495727,115,-134,0.4475507666421673,0.5524492333578327,home,TOR,under,8.5,0.5238095238095238,-110,0.5011337868480725,TOR,TB,2023 REG,6,1,11,8,9,17,0,1,-7,7,1,0,0,0,0,0,0,0,0,0.4988662131519274,0.5011337868480725
90768,0.5454545454545454,0.5,-120,100,0.5206611570247933,0.4793388429752067,away,NYM,over,7.5,0.5192307692307692,-108,0.49455035168025013,MIA,NYM,2023 REG,10,3,10,8,11,20,0,1,-5,5,1,1,1,0,0,0,0,0,0,0.49455035168025013,0.5054496483197499
90768,0.5454545454545454,0.5,-120,100,0.5206611570247933,0.4793388429752067,home,MIA,under,7.5,0.5283018867924528,-112,0.5054496483197499,MIA,NYM,2023 REG,10,3,10,8,11,20,0,1,-5,5,1,1,1,0,0,0,0,0,0,0.49455035168025013,0.5054496483197499
90769,0.6428571428571428,0.39370078740157477,-180,154,0.6193556162622529,0.3806443837377471,away,OAK,over,8,0.5192307692307692,-108,0.49571111079951763,CLE,OAK,2023 REG,6,6,3,1,7,9,1,0,5,-5,1,0,0,0,0,0,0,0,0,0.49571111079951763,0.5042888892004824
90769,0.6428571428571428,0.39370078740157477,-180,154,0.6193556162622529,0.3806443837377471,home,CLE,under,8,0.5260663507109005,-111,0.5042888892004824,CLE,OAK,2023 REG,6,6,3,1,7,9,1,0,5,-5,1,0,0,0,0,0,0,0,0,0.49571111079951763,0.5042888892004824
90770,0.6515679442508712,0.390625,-187,156,0.6240763743034393,0.3759236256965607,away,HOU,over,8.5,0.5,100,0.47935779816513757,TB,HOU,2023 REG,14,8,6,3,11,20,1,0,5,-5,1,1,1,0,0,0,0,0,0,0.47935779816513757,0.5206422018348624
90770,0.6515679442508712,0.390625,-187,156,0.6240763743034393,0.3759236256965607,home,TB,under,8.5,0.5412844036697247,-118,0.5206422018348624,TB,HOU,2023 REG,14,8,6,3,11,20,1,0,5,-5,1,1,1,0,0,0,0,0,0,0.47935779816513757,0.5206422018348624
90771,0.5495495495495495,0.4926108374384236,-122,103,0.5263803278714742,0.47361967212852585,away,MIA,over,7.5,0.5169082125603864,-107,0.49353874091423283,CLE,MIA,2023 REG,13,7,8,4,11,21,1,0,3,-3,1,1,1,1,0,0,0,0,0,0.49353874091423283,0.5064612590857671
90771,0.5495495495495495,0.4926108374384236,-122,103,0.5263803278714742,0.47361967212852585,home,CLE,under,7.5,0.5283018867924528,-112,0.5064612590857671,CLE,MIA,2023 REG,13,7,8,4,11,21,1,0,3,-3,1,1,1,1,0,0,0,0,0,0.49353874091423283,0.5064612590857671
90772,0.4273504273504274,0.607843137254902,134,-155,0.412310442476355,0.5876895575236449,away,CWS,over,8.5,0.5412844036697247,-118,0.5136310900085983,DET,CWS,2023 REG,3,3,17,12,15,20,0,1,-9,9,1,1,1,0,0,0,0,0,0,0.5136310900085983,0.4863689099914017
90772,0.4273504273504274,0.607843137254902,134,-155,0.412310442476355,0.5876895575236449,home,DET,under,8.5,0.5098039215686274,-104,0.4863689099914017,DET,CWS,2023 REG,3,3,17,12,15,20,0,1,-9,9,1,1,1,0,0,0,0,0,0,0.5136310900085983,0.4863689099914017
90773,0.6825396825396826,0.35714285714285715,-215,180,0.6554547745023935,0.34454522549760647,away,DET,over,7.5,0.5238095238095238,-110,0.5024811857109994,MIN,DET,2023 REG,7,4,12,8,12,19,0,1,-4,4,1,1,1,1,0,0,0,0,0,0.5024811857109994,0.4975188142890006
90773,0.6825396825396826,0.35714285714285715,-215,180,0.6554547745023935,0.34454522549760647,home,MIN,under,7.5,0.5169082125603864,-107,0.4975188142890006,MIN,DET,2023 REG,7,4,12,8,12,19,0,1,-4,4,1,1,1,1,0,0,0,0,0,0.5024811857109994,0.4975188142890006
90774,0.574468085106383,0.4672897196261683,-135,114,0.550479558983428,0.44952044101657196,away,CHC,over,8.5,0.5348837209302326,-115,0.5097020142727117,MIL,CHC,2023 REG,6,4,5,0,4,11,1,0,4,-4,0,0,0,0,0,0,0,0,0,0.5097020142727117,0.49029798572728833
90774,0.574468085106383,0.4672897196261683,-135,114,0.550479558983428,0.44952044101657196,home,MIL,under,8.5,0.5121951219512195,-105,0.49029798572728833,MIL,CHC,2023 REG,6,4,5,0,4,11,1,0,4,-4,0,0,0,0,0,0,0,0,0,0.5097020142727117,0.49029798572728833
90775,0.4854368932038835,0.5535714285714286,106,-124,0.4665008146721786,0.5334991853278215,away,TOR,over,8,0.5412844036697247,-118,0.5149381613977361,CWS,TOR,2023 REG,7,3,6,4,7,13,0,1,-1,1,1,1,1,0,0,0,0,0,0,0.5149381613977361,0.48506183860226393
90775,0.4854368932038835,0.5535714285714286,106,-124,0.4665008146721786,0.5334991853278215,home,CWS,under,8,0.5073891625615764,-103,0.48506183860226393,CWS,TOR,2023 REG,7,3,6,4,7,13,0,1,-1,1,1,1,1,0,0,0,0,0,0,0.5149381613977361,0.48506183860226393
90776,0.5901639344262295,0.4444444444444444,-144,125,0.569739317387799,0.43026068261220096,away,MIN,over,9,0.5024875621890548,-101,0.47839724939301687,NYY,MIN,2023 REG,4,2,13,11,13,17,0,1,-9,9,1,1,0,0,0,0,0,0,0,0.47839724939301687,0.5216027506069831
90776,0.5901639344262295,0.4444444444444444,-144,125,0.569739317387799,0.43026068261220096,home,NYY,under,9,0.5454545454545454,-120,0.5216027506069831,NYY,MIN,2023 REG,4,2,13,11,13,17,0,1,-9,9,1,1,0,0,0,0,0,0,0,0.47839724939301687,0.5216027506069831
90777,0.5454545454545454,0.5,-120,100,0.5206611570247933,0.4793388429752067,away,ARI,over,8,0.5391705069124424,-117,0.5140669063204599,TOR,ARI,2023 REG,8,5,10,2,7,18,1,0,3,-3,1,1,0,0,0,0,0,0,0,0.5140669063204599,0.4859330936795401
90777,0.5454545454545454,0.5,-120,100,0.5206611570247933,0.4793388429752067,home,TOR,under,8,0.5073891625615764,-103,0.4859330936795401,TOR,ARI,2023 REG,8,5,10,2,7,18,1,0,3,-3,1,1,0,0,0,0,0,0,0,0.5140669063204599,0.4859330936795401
90778,0.576271186440678,0.4629629629629629,-136,116,0.553661676614851,0.446338323385149,away,CLE,over,9,0.5348837209302326,-115,0.5097020142727117,TEX,CLE,2023 REG,8,6,9,5,11,17,1,0,1,-1,1,1,1,1,1,0,0,0,0,0.5097020142727117,0.49029798572728833
90778,0.576271186440678,0.4629629629629629,-136,116,0.553661676614851,0.446338323385149,home,TEX,under,9,0.5121951219512195,-105,0.49029798572728833,TEX,CLE,2023 REG,8,6,9,5,11,17,1,0,1,-1,1,1,1,1,1,0,0,0,0,0.5097020142727117,0.49029798572728833
90779,0.5145631067961165,0.5238095238095238,-106,-110,0.4948179667757384,0.5051820332242616,away,TEX,over,8.5,0.5412844036697247,-118,0.5175913212324037,CIN,TEX,2023 REG,7,5,5,3,8,12,1,0,2,-2,1,1,1,0,0,0,0,0,0,0.5175913212324037,0.4824086787675963
90779,0.5145631067961165,0.5238095238095238,-106,-110,0.4948179667757384,0.5051820332242616,home,CIN,under,8.5,0.5024875621890548,-101,0.4824086787675963,CIN,TEX,2023 REG,7,5,5,3,8,12,1,0,2,-2,1,1,1,0,0,0,0,0,0,0.5175913212324037,0.4824086787675963
90780,0.6402877697841727,0.4,-178,150,0.6144920035194866,0.38550799648051337,away,KC,over,9.5,0.5238095238095238,-110,0.5000596729920038,LAA,KC,2023 REG,12,8,12,11,19,24,0,1,-3,3,1,1,1,1,1,1,1,1,0,0.5000596729920038,0.4999403270079962
90780,0.6402877697841727,0.4,-178,150,0.6144920035194866,0.38550799648051337,home,LAA,under,9.5,0.5215311004784688,-109,0.4999403270079962,LAA,KC,2023 REG,12,8,12,11,19,24,0,1,-3,3,1,1,1,1,1,1,1,1,0,0.5000596729920038,0.4999403270079962
90781,0.5238095238095238,0.5238095238095238,-110,-110,0.4988662131519274,0.5011337868480725,away,BOS,over,8,0.5348837209302326,-115,0.5097020142727117,SF,BOS,2023 REG,11,4,8,3,7,19,1,0,1,-1,1,1,1,0,0,0,0,0,0,0.5097020142727117,0.49029798572728833
90781,0.5238095238095238,0.5238095238095238,-110,-110,0.4988662131519274,0.5011337868480725,home,SF,under,8,0.5121951219512195,-105,0.49029798572728833,SF,BOS,2023 REG,11,4,8,3,7,19,1,0,1,-1,1,1,1,0,0,0,0,0,0,0.5097020142727117,0.49029798572728833
90782,0.6774193548387096,0.36363636363636365,-210,175,0.6496074165168858,0.3503925834831142,away,MIL,over,8.5,0.5238095238095238,-110,0.4988662131519274,TEX,MIL,2023 REG,8,2,7,6,8,15,0,1,-4,4,1,1,0,0,0,0,0,0,0,0.4988662131519274,0.5011337868480725
90782,0.6774193548387096,0.36363636363636365,-210,175,0.6496074165168858,0.3503925834831142,home,TEX,under,8.5,0.5238095238095238,-110,0.5011337868480725,TEX,MIL,2023 REG,8,2,7,6,8,15,0,1,-4,4,1,1,0,0,0,0,0,0,0,0.4988662131519274,0.5011337868480725
90783,0.3436426116838488,0.7005988023952096,191,-234,0.3284393766051346,0.6715606233948654,away,TEX,over,8.5,0.5515695067264574,-123,0.527200976088429,OAK,TEX,2023 REG,6,3,7,5,8,13,0,1,-2,2,1,1,1,0,0,0,0,0,0,0.527200976088429,0.472799023911571
90783,0.3436426116838488,0.7005988023952096,191,-234,0.3284393766051346,0.6715606233948654,home,OAK,under,8.5,0.4926108374384236,103,0.472799023911571,OAK,TEX,2023 REG,6,3,7,5,8,13,0,1,-2,2,1,1,1,0,0,0,0,0,0,0.527200976088429,0.472799023911571
90784,0.696969696969697,0.3448275862068966,-230,190,0.6678382571799499,0.33216174282005007,away,STL,over,8.5,0.5454545454545454,-120,0.5179608869977906,PHI,STL,2023 REG,12,12,3,1,13,15,1,0,11,-11,1,0,0,0,0,0,0,0,0,0.5179608869977906,0.48203911300220936
90784,0.696969696969697,0.3448275862068966,-230,190,0.6678382571799499,0.33216174282005007,home,PHI,under,8.5,0.504950495049505,-102,0.48203911300220936,PHI,STL,2023 REG,12,12,3,1,13,15,1,0,11,-11,1,0,0,0,0,0,0,0,0,0.5179608869977906,0.48203911300220936
90785,0.5121951219512195,0.5348837209302326,-105,-115,0.48808156828023186,0.5119184317197681,away,CWS,over,11.5,0.5283018867924528,-112,0.5031902949311281,COL,CWS,2023 REG,13,11,11,5,16,24,1,0,6,-6,1,1,1,1,1,0,0,0,0,0.5031902949311281,0.4968097050688719
90785,0.5121951219512195,0.5348837209302326,-105,-115,0.48808156828023186,0.5119184317197681,home,COL,under,11.5,0.5192307692307692,-108,0.4968097050688719,COL,CWS,2023 REG,13,11,11,5,16,24,1,0,6,-6,1,1,1,1,1,0,0,0,0,0.5031902949311281,0.4968097050688719
90786,0.5215311004784688,0.5145631067961165,-109,-106,0.5027068488376564,0.4972931511623436,away,DET,over,7.5,0.49019607843137253,104,0.46874141813588177,CLE,DET,2023 REG,4,0,8,5,5,12,0,1,-5,5,0,0,0,0,0,0,0,0,0,0.46874141813588177,0.5312585818641182
90786,0.5215311004784688,0.5145631067961165,-109,-106,0.5027068488376564,0.4972931511623436,home,CLE,under,7.5,0.5535714285714286,-124,0.5312585818641182,CLE,DET,2023 REG,4,0,8,5,5,12,0,1,-5,5,0,0,0,0,0,0,0,0,0,0.46874141813588177,0.5312585818641182
90787,0.3802281368821293,0.6610169491525424,163,-195,0.3645455946636229,0.6354544053363771,away,ATL,over,9.5,0.5238095238095238,-110,0.4988662131519274,NYM,ATL,2023 REG,7,0,11,7,7,18,0,1,-7,7,0,0,0,0,0,0,0,0,0,0.4988662131519274,0.5011337868480725
90787,0.3802281368821293,0.6610169491525424,163,-195,0.3645455946636229,0.6354544053363771,home,NYM,under,9.5,0.5238095238095238,-110,0.5011337868480725,NYM,ATL,2023 REG,7,0,11,7,7,18,0,1,-7,7,0,0,0,0,0,0,0,0,0,0.4988662131519274,0.5011337868480725
90788,0.5918367346938775,0.4444444444444444,-145,125,0.5703642001018094,0.42963579989819056,away,PHI,over,7.5,0.5348837209302326,-115,0.5122726437136835,LAD,PHI,2023 REG,17,13,2,1,14,19,1,0,12,-12,1,0,0,0,0,0,0,0,0,0.5122726437136835,0.48772735628631647
90788,0.5918367346938775,0.4444444444444444,-145,125,0.5703642001018094,0.42963579989819056,home,LAD,under,7.5,0.5073891625615764,-103,0.48772735628631647,LAD,PHI,2023 REG,17,13,2,1,14,19,1,0,12,-12,1,0,0,0,0,0,0,0,0,0.5122726437136835,0.48772735628631647
90789,0.47619047619047616,0.5652173913043479,110,-130,0.4564724440500838,0.5435275559499162,away,SEA,over,9,0.5348837209302326,-115,0.5097020142727117,ARI,SEA,2023 REG,10,2,10,5,7,20,0,1,-3,3,1,1,0,0,0,0,0,0,0,0.5097020142727117,0.49029798572728833
90789,0.47619047619047616,0.5652173913043479,110,-130,0.4564724440500838,0.5435275559499162,home,ARI,under,9,0.5121951219512195,-105,0.49029798572728833,ARI,SEA,2023 REG,10,2,10,5,7,20,0,1,-3,3,1,1,0,0,0,0,0,0,0,0.5097020142727117,0.49029798572728833
90790,0.5555555555555556,0.48780487804878053,-125,105,0.5314664257753688,0.46853357422463116,away,TOR,over,8,0.5238095238095238,-110,0.4988662131519274,TB,TOR,2023 REG,12,7,10,6,13,22,1,0,1,-1,1,1,1,1,1,1,0,0,0,0.4988662131519274,0.5011337868480725
90790,0.5555555555555556,0.48780487804878053,-125,105,0.5314664257753688,0.46853357422463116,home,TB,under,8,0.5238095238095238,-110,0.5011337868480725,TB,TOR,2023 REG,12,7,10,6,13,22,1,0,1,-1,1,1,1,1,1,1,0,0,0,0.4988662131519274,0.5011337868480725
90791,0.46511627906976744,0.574468085106383,115,-135,0.44670494689481377,0.5532950531051862,away,MIA,over,11.5,0.5121951219512195,-105,0.48808156828023186,COL,MIA,2023 REG,7,5,11,4,9,18,1,0,1,-1,1,1,1,1,0,0,0,0,0,0.48808156828023186,0.5119184317197681
90791,0.46511627906976744,0.574468085106383,115,-135,0.44670494689481377,0.5532950531051862,home,COL,under,11.5,0.5348837209302326,-115,0.5119184317197681,COL,MIA,2023 REG,7,5,11,4,9,18,1,0,1,-1,1,1,1,1,0,0,0,0,0,0.48808156828023186,0.5119184317197681
90792,0.5833333333333333,0.45454545454545453,-140,120,0.5612373737373737,0.4387626262626263,away,MIL,over,9,0.5283018867924528,-112,0.5044173060022736,SF,MIL,2023 REG,13,3,12,7,10,25,0,1,-4,4,1,1,1,0,0,0,0,0,0,0.5044173060022736,0.49558269399772636
90792,0.5833333333333333,0.45454545454545453,-140,120,0.5612373737373737,0.4387626262626263,home,SF,under,9,0.5169082125603864,-107,0.49558269399772636,SF,MIL,2023 REG,13,3,12,7,10,25,0,1,-4,4,1,1,1,0,0,0,0,0,0,0.5044173060022736,0.49558269399772636
90793,0.5884773662551441,0.4444444444444444,-143,125,0.5691036258022998,0.4308963741977002,away,CWS,over,8,0.5073891625615764,-103,0.4837652908580103,CLE,CWS,2023 REG,4,0,4,6,6,8,0,1,-6,6,0,0,0,0,0,0,0,0,0,0.4837652908580103,0.5162347091419897
90793,0.5884773662551441,0.4444444444444444,-143,125,0.5691036258022998,0.4308963741977002,home,CLE,under,8,0.5391705069124424,-117,0.5162347091419897,CLE,CWS,2023 REG,4,0,4,6,6,8,0,1,-6,6,0,0,0,0,0,0,0,0,0,0.4837652908580103,0.5162347091419897
90794,0.6575342465753424,0.38167938931297707,-192,162,0.6317499380460364,0.3682500619539636,away,MIA,over,9,0.5348837209302326,-115,0.5097020142727117,PHI,MIA,2023 REG,7,8,10,4,12,17,1,0,4,-4,1,1,1,1,0,0,0,0,0,0.5097020142727117,0.49029798572728833
90794,0.6575342465753424,0.38167938931297707,-192,162,0.6317499380460364,0.3682500619539636,home,PHI,under,9,0.5121951219512195,-105,0.49029798572728833,PHI,MIA,2023 REG,7,8,10,4,12,17,1,0,4,-4,1,1,1,1,0,0,0,0,0,0.5097020142727117,0.49029798572728833
90795,0.4504504504504505,0.5884773662551441,122,-143,0.4329153978803628,0.5670846021196372,away,ATL,over,9.5,0.5454545454545454,-120,0.5206611570247933,NYM,ATL,2023 REG,10,7,7,6,13,17,1,0,1,-1,1,1,1,1,1,1,0,0,0,0.5206611570247933,0.4793388429752067
90795,0.4504504504504505,0.5884773662551441,122,-143,0.4329153978803628,0.5670846021196372,home,NYM,under,9.5,0.5,100,0.4793388429752067,NYM,ATL,2023 REG,10,7,7,6,13,17,1,0,1,-1,1,1,1,1,1,1,0,0,0,0.5206611570247933,0.4793388429752067
90796,0.6491228070175439,0.39370078740157477,-185,154,0.6213250352016247,0.37867496479837526,away,BAL,over,8,0.5238095238095238,-110,0.5000596729920038,SD,BAL,2023 REG,8,5,5,2,7,13,1,0,3,-3,1,1,0,0,0,0,0,0,0,0.5000596729920038,0.4999403270079962
90796,0.6491228070175439,0.39370078740157477,-185,154,0.6213250352016247,0.37867496479837526,home,SD,under,8,0.5215311004784688,-109,0.4999403270079962,SD,BAL,2023 REG,8,5,5,2,7,13,1,0,3,-3,1,1,0,0,0,0,0,0,0,0.5000596729920038,0.4999403270079962
90797,0.6296296296296295,0.4081632653061224,-170,145,0.6058341031886005,0.39416589681139946,away,PIT,over,9,0.504950495049505,-102,0.48160416005266615,CHC,PIT,2023 REG,12,14,5,1,15,17,1,0,13,-13,1,0,0,0,0,0,0,0,0,0.48160416005266615,0.5183958399473338
90797,0.6296296296296295,0.4081632653061224,-170,145,0.6058341031886005,0.39416589681139946,home,CHC,under,9,0.5412844036697247,-118,0.5183958399473338,CHC,PIT,2023 REG,12,14,5,1,15,17,1,0,13,-13,1,0,0,0,0,0,0,0,0,0.48160416005266615,0.5183958399473338
90798,0.5454545454545454,0.5,-120,100,0.5206611570247933,0.4793388429752067,away,TEX,over,8.5,0.5348837209302326,-115,0.5097020142727117,ARI,TEX,2023 REG,9,6,13,3,9,22,1,0,3,-3,1,1,1,0,0,0,0,0,0,0.5097020142727117,0.49029798572728833
90798,0.5454545454545454,0.5,-120,100,0.5206611570247933,0.4793388429752067,home,ARI,under,8.5,0.5121951219512195,-105,0.49029798572728833,ARI,TEX,2023 REG,9,6,13,3,9,22,1,0,3,-3,1,1,1,0,0,0,0,0,0,0.5097020142727117,0.49029798572728833
90799,0.42372881355932196,0.6108949416342413,136,-157,0.409057730850185,0.590942269149815,away,BAL,over,7.5,0.5348837209302326,-115,0.5097020142727117,DET,BAL,2023 REG,5,4,11,6,10,16,0,1,-2,2,1,1,1,1,0,0,0,0,0,0.5097020142727117,0.49029798572728833
90799,0.42372881355932196,0.6108949416342413,136,-157,0.409057730850185,0.590942269149815,home,DET,under,7.5,0.5121951219512195,-105,0.49029798572728833,DET,BAL,2023 REG,5,4,11,6,10,16,0,1,-2,2,1,1,1,1,0,0,0,0,0,0.5097020142727117,0.49029798572728833
90800,0.5652173913043479,0.47619047619047616,-130,110,0.5418129444594474,0.4581870555405526,away,PHI,over,9,0.5283018867924528,-112,0.5031902949311281,SD,PHI,2023 REG,10,8,3,0,8,13,1,0,8,-8,0,0,0,0,0,0,0,0,0,0.5031902949311281,0.4968097050688719
90800,0.5652173913043479,0.47619047619047616,-130,110,0.5418129444594474,0.4581870555405526,home,SD,under,9,0.5192307692307692,-108,0.4968097050688719,SD,PHI,2023 REG,10,8,3,0,8,13,1,0,8,-8,0,0,0,0,0,0,0,0,0,0.5031902949311281,0.4968097050688719
90801,0.5121951219512195,0.5348837209302326,-105,-115,0.48808156828023186,0.5119184317197681,away,CHC,over,9,0.5238095238095238,-110,0.4988662131519274,ARI,CHC,2023 REG,12,7,12,6,13,24,1,0,1,-1,1,1,1,1,1,1,0,0,0,0.4988662131519274,0.5011337868480725
90801,0.5121951219512195,0.5348837209302326,-105,-115,0.48808156828023186,0.5119184317197681,home,ARI,under,9,0.5238095238095238,-110,0.5011337868480725,ARI,CHC,2023 REG,12,7,12,6,13,24,1,0,1,-1,1,1,1,1,1,1,0,0,0,0.4988662131519274,0.5011337868480725
90802,0.3472222222222222,0.6923076923076923,188,-225,0.3334965574548908,0.6665034425451092,away,ATL,over,8.5,0.5412844036697247,-118,0.5136310900085983,ARI,ATL,2023 REG,6,2,11,5,7,17,0,1,-3,3,1,1,0,0,0,0,0,0,0,0.5136310900085983,0.4863689099914017
90802,0.3472222222222222,0.6923076923076923,188,-225,0.3334965574548908,0.6665034425451092,home,ARI,under,8.5,0.5098039215686274,-104,0.4863689099914017,ARI,ATL,2023 REG,6,2,11,5,7,17,0,1,-3,3,1,1,0,0,0,0,0,0,0,0.5136310900085983,0.4863689099914017
90803,0.607843137254902,0.43103448275862066,-155,132,0.5842116427368785,0.41578835726312147,away,MIN,over,8,0.504950495049505,-102,0.4826715732667395,LAA,MIN,2023 REG,9,4,7,2,6,16,1,0,2,-2,1,1,0,0,0,0,0,0,0,0.4826715732667395,0.5173284267332605
90803,0.607843137254902,0.43103448275862066,-155,132,0.5842116427368785,0.41578835726312147,home,LAA,under,8,0.5391705069124424,-117,0.5173284267332605,LAA,MIN,2023 REG,9,4,7,2,6,16,1,0,2,-2,1,1,0,0,0,0,0,0,0,0.4826715732667395,0.5173284267332605
90804,0.5238095238095238,0.5215311004784688,-110,-109,0.5000596729920038,0.4999403270079962,away,STL,over,8.5,0.5454545454545454,-120,0.5206611570247933,SF,STL,2023 REG,13,7,8,3,10,21,1,0,4,-4,1,1,1,0,0,0,0,0,0,0.5206611570247933,0.4793388429752067
90804,0.5238095238095238,0.5215311004784688,-110,-109,0.5000596729920038,0.4999403270079962,home,SF,under,8.5,0.5,100,0.4793388429752067,SF,STL,2023 REG,13,7,8,3,10,21,1,0,4,-4,1,1,1,0,0,0,0,0,0,0.5206611570247933,0.4793388429752067
90805,0.6108949416342413,0.43103448275862066,-157,132,0.5852804683670066,0.41471953163299335,away,SD,over,9,0.5283018867924528,-112,0.5056562298022652,ATL,SD,2023 REG,5,1,8,4,5,13,0,1,-3,3,1,0,0,0,0,0,0,0,0,0.5056562298022652,0.4943437701977348
90805,0.6108949416342413,0.43103448275862066,-157,132,0.5852804683670066,0.41471953163299335,home,ATL,under,9,0.5145631067961165,-106,0.4943437701977348,ATL,SD,2023 REG,5,1,8,4,5,13,0,1,-3,3,1,0,0,0,0,0,0,0,0,0.5056562298022652,0.4943437701977348
90806,0.47619047619047616,0.5652173913043479,110,-130,0.4564724440500838,0.5435275559499162,away,PHI,over,9,0.5305164319248826,-113,0.5066009958897986,ARI,PHI,2023 REG,7,4,13,5,9,20,0,1,-1,1,1,1,1,1,0,0,0,0,0,0.5066009958897986,0.49339900411020143
90806,0.47619047619047616,0.5652173913043479,110,-130,0.4564724440500838,0.5435275559499162,home,ARI,under,9,0.5145631067961165,-106,0.49339900411020143,ARI,PHI,2023 REG,7,4,13,5,9,20,0,1,-1,1,1,1,1,1,0,0,0,0,0,0.5066009958897986,0.49339900411020143
90807,0.6666666666666666,0.37037037037037035,-200,170,0.6419753086419753,0.3580246913580247,away,MIA,over,8.5,0.5454545454545454,-120,0.5206611570247933,SD,MIA,2023 REG,7,6,7,2,8,14,1,0,4,-4,1,1,0,0,0,0,0,0,0,0.5206611570247933,0.4793388429752067
90807,0.6666666666666666,0.37037037037037035,-200,170,0.6419753086419753,0.3580246913580247,home,SD,under,8.5,0.5,100,0.4793388429752067,SD,MIA,2023 REG,7,6,7,2,8,14,1,0,4,-4,1,1,0,0,0,0,0,0,0,0.5206611570247933,0.4793388429752067
90808,0.5652173913043479,0.47619047619047616,-130,110,0.5418129444594474,0.4581870555405526,away,BAL,over,8.5,0.5,100,0.4762443438914027,MIL,BAL,2023 REG,8,4,8,3,7,16,1,0,1,-1,1,1,1,0,0,0,0,0,0,0.4762443438914027,0.5237556561085973
90808,0.5652173913043479,0.47619047619047616,-130,110,0.5418129444594474,0.4581870555405526,home,MIL,under,8.5,0.5475113122171946,-121,0.5237556561085973,MIL,BAL,2023 REG,8,4,8,3,7,16,1,0,1,-1,1,1,1,0,0,0,0,0,0,0.4762443438914027,0.5237556561085973
90809,0.5305164319248826,0.5098039215686274,-113,-104,0.5091258218555558,0.49087417814444423,away,SEA,over,8.5,0.5370370370370371,-116,0.5131785224377817,TOR,SEA,2023 REG,8,3,6,2,5,14,1,0,1,-1,1,1,0,0,0,0,0,0,0,0.5131785224377817,0.4868214775622183
90809,0.5305164319248826,0.5098039215686274,-113,-104,0.5091258218555558,0.49087417814444423,home,TOR,under,8.5,0.5073891625615764,-103,0.4868214775622183,TOR,SEA,2023 REG,8,3,6,2,5,14,1,0,1,-1,1,1,0,0,0,0,0,0,0,0.5131785224377817,0.4868214775622183
90810,0.5454545454545454,0.5,-120,100,0.5206611570247933,0.4793388429752067,away,MIA,over,8.5,0.5238095238095238,-110,0.4988662131519274,BAL,MIA,2023 REG,11,6,11,5,11,22,1,0,1,-1,1,1,1,1,1,0,0,0,0,0.4988662131519274,0.5011337868480725
90810,0.5454545454545454,0.5,-120,100,0.5206611570247933,0.4793388429752067,home,BAL,under,8.5,0.5238095238095238,-110,0.5011337868480725,BAL,MIA,2023 REG,11,6,11,5,11,22,1,0,1,-1,1,1,1,1,1,0,0,0,0,0.4988662131519274,0.5011337868480725
90811,0.4347826086956522,0.6000000000000001,130,-150,0.4196597353497164,0.5803402646502835,away,SEA,over,9,0.5,100,0.47935779816513757,CHC,SEA,2023 REG,8,3,6,2,5,14,1,0,1,-1,1,1,0,0,0,0,0,0,0,0.47935779816513757,0.5206422018348624
90811,0.4347826086956522,0.6000000000000001,130,-150,0.4196597353497164,0.5803402646502835,home,CHC,under,9,0.5412844036697247,-118,0.5206422018348624,CHC,SEA,2023 REG,8,3,6,2,5,14,1,0,1,-1,1,1,0,0,0,0,0,0,0,0.47935779816513757,0.5206422018348624
90812,0.4926108374384236,0.5495495495495495,103,-122,0.4718421738975501,0.5281578261024499,away,MIN,over,8.5,0.5495495495495495,-122,0.5250401592387142,CLE,MIN,2023 REG,3,0,3,2,2,6,0,1,-2,2,0,0,0,0,0,0,0,0,0,0.5250401592387142,0.47495984076128583
90812,0.4926108374384236,0.5495495495495495,103,-122,0.4718421738975501,0.5281578261024499,home,CLE,under,8.5,0.49504950495049505,102,0.47495984076128583,CLE,MIN,2023 REG,3,0,3,2,2,6,0,1,-2,2,0,0,0,0,0,0,0,0,0,0.5250401592387142,0.47495984076128583
90813,0.6923076923076923,0.3508771929824561,-225,185,0.6624104640298972,0.33758953597010277,away,KC,over,8,0.5238095238095238,-110,0.4988662131519274,CLE,KC,2023 REG,7,1,10,4,5,17,0,1,-3,3,1,0,0,0,0,0,0,0,0,0.4988662131519274,0.5011337868480725
90813,0.6923076923076923,0.3508771929824561,-225,185,0.6624104640298972,0.33758953597010277,home,CLE,under,8,0.5238095238095238,-110,0.5011337868480725,CLE,KC,2023 REG,7,1,10,4,5,17,0,1,-3,3,1,0,0,0,0,0,0,0,0,0.4988662131519274,0.5011337868480725
90814,0.607843137254902,0.4347826086956522,-155,130,0.5819333701084867,0.41806662989151333,away,CHC,over,9,0.504950495049505,-102,0.48160416005266615,TOR,CHC,2023 REG,5,2,10,6,8,15,0,1,-4,4,1,1,0,0,0,0,0,0,0,0.48160416005266615,0.5183958399473338
90814,0.607843137254902,0.4347826086956522,-155,130,0.5819333701084867,0.41806662989151333,home,TOR,under,9,0.5412844036697247,-118,0.5183958399473338,TOR,CHC,2023 REG,5,2,10,6,8,15,0,1,-4,4,1,1,0,0,0,0,0,0,0,0.48160416005266615,0.5183958399473338
90815,0.5884773662551441,0.4484304932735426,-143,123,0.5667579262855877,0.43324207371441226,away,KC,over,8.5,0.5073891625615764,-103,0.4837652908580103,SF,KC,2023 REG,12,5,8,6,11,20,0,1,-1,1,1,1,1,1,1,0,0,0,0,0.4837652908580103,0.5162347091419897
90815,0.5884773662551441,0.4484304932735426,-143,123,0.5667579262855877,0.43324207371441226,home,SF,under,8.5,0.5391705069124424,-117,0.5162347091419897,SF,KC,2023 REG,12,5,8,6,11,20,0,1,-1,1,1,1,1,1,1,0,0,0,0,0.4837652908580103,0.5162347091419897
90816,0.6491228070175439,0.3921568627450981,-185,155,0.6223272319084604,0.3776727680915396,away,NYY,over,8.5,0.5348837209302326,-115,0.5097020142727117,TOR,NYY,2023 REG,13,6,7,0,6,20,1,0,6,-6,0,0,0,0,0,0,0,0,0,0.5097020142727117,0.49029798572728833
90816,0.6491228070175439,0.3921568627450981,-185,155,0.6223272319084604,0.3776727680915396,home,TOR,under,8.5,0.5121951219512195,-105,0.49029798572728833,TOR,NYY,2023 REG,13,6,7,0,6,20,1,0,6,-6,0,0,0,0,0,0,0,0,0,0.5097020142727117,0.49029798572728833
90817,0.5918367346938775,0.4444444444444444,-145,125,0.5703642001018094,0.42963579989819056,away,LAD,over,8.5,0.5454545454545454,-120,0.5206611570247933,LAA,LAD,2023 REG,2,0,6,2,2,8,0,1,-2,2,0,0,0,0,0,0,0,0,0,0.5206611570247933,0.4793388429752067
90817,0.5918367346938775,0.4444444444444444,-145,125,0.5703642001018094,0.42963579989819056,home,LAA,under,8.5,0.5,100,0.4793388429752067,LAA,LAD,2023 REG,2,0,6,2,2,8,0,1,-2,2,0,0,0,0,0,0,0,0,0,0.5206611570247933,0.4793388429752067
90818,0.3921568627450981,0.6453900709219857,155,-182,0.37743257503251615,0.6225674249674839,away,LAD,over,9,0.5145631067961165,-106,0.4913668392989033,KC,LAD,2023 REG,15,9,6,1,10,21,1,0,8,-8,1,0,0,0,0,0,0,0,0,0.4913668392989033,0.5086331607010968
90818,0.3921568627450981,0.6453900709219857,155,-182,0.37743257503251615,0.6225674249674839,home,KC,under,9,0.5305164319248826,-113,0.5086331607010968,KC,LAD,2023 REG,15,9,6,1,10,21,1,0,8,-8,1,0,0,0,0,0,0,0,0,0.4913668392989033,0.5086331607010968
90819,0.49504950495049505,0.5495495495495495,102,-122,0.47297076509898783,0.5270292349010122,away,BOS,over,7.5,0.5391705069124424,-117,0.5140669063204599,BAL,BOS,2023 REG,3,0,4,3,3,7,0,1,-3,3,0,0,0,0,0,0,0,0,0,0.5140669063204599,0.4859330936795401
90819,0.49504950495049505,0.5495495495495495,102,-122,0.47297076509898783,0.5270292349010122,home,BAL,under,7.5,0.5073891625615764,-103,0.4859330936795401,BAL,BOS,2023 REG,3,0,4,3,3,7,0,1,-3,3,0,0,0,0,0,0,0,0,0,0.5140669063204599,0.4859330936795401
90820,0.5283018867924528,0.5121951219512195,-112,-105,0.5069072406637203,0.4930927593362797,away,HOU,over,8.5,0.5145631067961165,-106,0.49023796582517226,ATL,HOU,2023 REG,8,3,11,6,9,19,0,1,-3,3,1,1,1,0,0,0,0,0,0,0.49023796582517226,0.5097620341748277
90820,0.5283018867924528,0.5121951219512195,-112,-105,0.5069072406637203,0.4930927593362797,home,ATL,under,8.5,0.5327102803738317,-114,0.5097620341748277,ATL,HOU,2023 REG,8,3,11,6,9,19,0,1,-3,3,1,1,1,0,0,0,0,0,0,0.49023796582517226,0.5097620341748277
90821,0.5348837209302326,0.5121951219512195,-115,-105,0.5097020142727117,0.49029798572728833,away,CHC,over,7.5,0.5412844036697247,-118,0.5149381613977361,MIL,CHC,2023 REG,6,6,8,5,11,14,1,0,1,-1,1,1,1,1,1,0,0,0,0,0.5149381613977361,0.48506183860226393
90821,0.5348837209302326,0.5121951219512195,-115,-105,0.5097020142727117,0.49029798572728833,home,MIL,under,7.5,0.5073891625615764,-103,0.48506183860226393,MIL,CHC,2023 REG,6,6,8,5,11,14,1,0,1,-1,1,1,1,1,1,0,0,0,0,0.5149381613977361,0.48506183860226393
90822,0.5967741935483871,0.4444444444444444,-148,125,0.5721759741010521,0.42782402589894786,away,BOS,over,9,0.5454545454545454,-120,0.5206611570247933,CHC,BOS,2023 REG,5,5,13,11,16,18,0,1,-6,6,1,1,1,1,1,0,0,0,0,0.5206611570247933,0.4793388429752067
90822,0.5967741935483871,0.4444444444444444,-148,125,0.5721759741010521,0.42782402589894786,home,CHC,under,9,0.5,100,0.4793388429752067,CHC,BOS,2023 REG,5,5,13,11,16,18,0,1,-6,6,1,1,1,1,1,0,0,0,0,0.5206611570247933,0.4793388429752067
90823,0.5475113122171946,0.49019607843137253,-121,104,0.5268660892829112,0.47313391071708877,away,SEA,over,8,0.5121951219512195,-105,0.48919479393107135,NYY,SEA,2023 REG,5,2,11,10,12,16,0,1,-8,8,1,1,0,0,0,0,0,0,0,0.48919479393107135,0.5108052060689287
90823,0.5475113122171946,0.49019607843137253,-121,104,0.5268660892829112,0.47313391071708877,home,NYY,under,8,0.5327102803738317,-114,0.5108052060689287,NYY,SEA,2023 REG,5,2,11,10,12,16,0,1,-8,8,1,1,0,0,0,0,0,0,0,0.48919479393107135,0.5108052060689287
90824,0.5348837209302326,0.5121951219512195,-115,-105,0.5097020142727117,0.49029798572728833,away,BOS,over,9,0.5238095238095238,-110,0.5012646084074657,NYY,BOS,2023 REG,8,5,9,6,11,17,0,1,-1,1,1,1,1,1,1,0,0,0,0,0.5012646084074657,0.4987353915925343
90824,0.5348837209302326,0.5121951219512195,-115,-105,0.5097020142727117,0.49029798572728833,home,NYY,under,9,0.5192307692307692,-108,0.4987353915925343,NYY,BOS,2023 REG,8,5,9,6,11,17,0,1,-1,1,1,1,1,1,1,0,0,0,0,0.5012646084074657,0.4987353915925343
90825,0.4716981132075471,0.5689655172413793,112,-132,0.45251715544861953,0.5474828445513804,away,LAA,over,9,0.5283018867924528,-112,0.5069072406637203,OAK,LAA,2023 REG,10,10,9,6,16,19,1,0,4,-4,1,1,1,1,1,1,0,0,0,0.5069072406637203,0.4930927593362797
90825,0.4716981132075471,0.5689655172413793,112,-132,0.45251715544861953,0.5474828445513804,home,OAK,under,9,0.5121951219512195,-105,0.4930927593362797,OAK,LAA,2023 REG,10,10,9,6,16,19,1,0,4,-4,1,1,1,1,1,1,0,0,0,0.5069072406637203,0.4930927593362797
90826,0.5169082125603864,0.5238095238095238,-107,-110,0.49586088023391106,0.5041391197660889,away,TEX,over,8.5,0.5348837209302326,-115,0.5097020142727117,NYY,TEX,2023 REG,6,2,10,4,6,16,0,1,-2,2,1,1,0,0,0,0,0,0,0,0.5097020142727117,0.49029798572728833
90826,0.5169082125603864,0.5238095238095238,-107,-110,0.49586088023391106,0.5041391197660889,home,NYY,under,8.5,0.5121951219512195,-105,0.49029798572728833,NYY,TEX,2023 REG,6,2,10,4,6,16,0,1,-2,2,1,1,0,0,0,0,0,0,0,0.5097020142727117,0.49029798572728833
90827,0.5454545454545454,0.49019607843137253,-120,104,0.526008750607681,0.47399124939231896,away,HOU,over,8,0.5391705069124424,-117,0.5153817639191344,CLE,HOU,2023 REG,11,5,4,0,5,15,1,0,5,-5,0,0,0,0,0,0,0,0,0,0.5153817639191344,0.4846182360808656
90827,0.5454545454545454,0.49019607843137253,-120,104,0.526008750607681,0.47399124939231896,home,CLE,under,8,0.504950495049505,-102,0.4846182360808656,CLE,HOU,2023 REG,11,5,4,0,5,15,1,0,5,-5,0,0,0,0,0,0,0,0,0,0.5153817639191344,0.4846182360808656
90828,0.5454545454545454,0.48780487804878053,-120,105,0.5273130417254586,0.47268695827454144,away,CIN,over,8.5,0.504950495049505,-102,0.48054649490447493,HOU,CIN,2023 REG,7,3,13,10,13,20,0,1,-7,7,1,1,1,0,0,0,0,0,0,0.48054649490447493,0.5194535050955251
90828,0.5454545454545454,0.48780487804878053,-120,105,0.5273130417254586,0.47268695827454144,home,HOU,under,8.5,0.5433789954337899,-119,0.5194535050955251,HOU,CIN,2023 REG,7,3,13,10,13,20,0,1,-7,7,1,1,1,0,0,0,0,0,0,0.48054649490447493,0.5194535050955251
90829,0.48309178743961345,0.5555555555555556,107,-125,0.4644215734322854,0.5355784265677146,away,SF,over,8,0.5454545454545454,-120,0.5206611570247933,MIL,SF,2023 REG,7,7,7,5,12,14,1,0,2,-2,1,1,1,1,1,0,0,0,0,0.5206611570247933,0.4793388429752067
90829,0.48309178743961345,0.5555555555555556,107,-125,0.4644215734322854,0.5355784265677146,home,MIL,under,8,0.5,100,0.4793388429752067,MIL,SF,2023 REG,7,7,7,5,12,14,1,0,2,-2,1,1,1,1,1,0,0,0,0,0.5206611570247933,0.4793388429752067
90830,0.6363636363636364,0.40485829959514175,-175,147,0.6101314952989593,0.38986850470104073,away,LAA,over,7.5,0.5,100,0.4783105022831051,SEA,LAA,2023 REG,13,11,7,2,13,20,1,0,9,-9,1,1,0,0,0,0,0,0,0,0.4783105022831051,0.5216894977168949
90830,0.6363636363636364,0.40485829959514175,-175,147,0.6101314952989593,0.38986850470104073,home,SEA,under,7.5,0.5433789954337899,-119,0.5216894977168949,SEA,LAA,2023 REG,13,11,7,2,13,20,1,0,9,-9,1,1,0,0,0,0,0,0,0,0.4783105022831051,0.5216894977168949
90831,0.576271186440678,0.46511627906976744,-136,115,0.552420782587201,0.44757921741279905,away,CLE,over,8.5,0.5454545454545454,-120,0.5206611570247933,HOU,CLE,2023 REG,10,3,7,2,5,17,1,0,1,-1,1,1,0,0,0,0,0,0,0,0.5206611570247933,0.4793388429752067
90831,0.576271186440678,0.46511627906976744,-136,115,0.552420782587201,0.44757921741279905,home,HOU,under,8.5,0.5,100,0.4793388429752067,HOU,CLE,2023 REG,10,3,7,2,5,17,1,0,1,-1,1,1,0,0,0,0,0,0,0,0.5206611570247933,0.4793388429752067
90832,0.48309178743961345,0.5594713656387665,107,-127,0.46252987773991294,0.5374701222600871,away,PIT,over,11,0.5238095238095238,-110,0.4988662131519274,COL,PIT,2023 REG,5,3,18,14,17,23,0,1,-11,11,1,1,1,0,0,0,0,0,0,0.4988662131519274,0.5011337868480725
90832,0.48309178743961345,0.5594713656387665,107,-127,0.46252987773991294,0.5374701222600871,home,COL,under,11,0.5238095238095238,-110,0.5011337868480725,COL,PIT,2023 REG,5,3,18,14,17,23,0,1,-11,11,1,1,1,0,0,0,0,0,0,0.4988662131519274,0.5011337868480725
90833,0.607843137254902,0.4347826086956522,-155,130,0.5819333701084867,0.41806662989151333,away,CWS,over,8.5,0.5238095238095238,-110,0.4988662131519274,BOS,CWS,2023 REG,8,0,5,1,1,13,0,1,-1,1,0,0,0,0,0,0,0,0,0,0.4988662131519274,0.5011337868480725
90833,0.607843137254902,0.4347826086956522,-155,130,0.5819333701084867,0.41806662989151333,home,BOS,under,8.5,0.5238095238095238,-110,0.5011337868480725,BOS,CWS,2023 REG,8,0,5,1,1,13,0,1,-1,1,0,0,0,0,0,0,0,0,0,0.4988662131519274,0.5011337868480725
90834,0.6363636363636364,0.4065040650406504,-175,146,0.6090841900154538,0.3909158099845462,away,DET,over,8.5,0.5454545454545454,-120,0.5206611570247933,CWS,DET,2023 REG,9,6,4,2,8,13,1,0,4,-4,1,1,0,0,0,0,0,0,0,0.5206611570247933,0.4793388429752067
90834,0.6363636363636364,0.4065040650406504,-175,146,0.6090841900154538,0.3909158099845462,home,CWS,under,8.5,0.5,100,0.4793388429752067,CWS,DET,2023 REG,9,6,4,2,8,13,1,0,4,-4,1,1,0,0,0,0,0,0,0,0.5206611570247933,0.4793388429752067
90835,0.5918367346938775,0.45454545454545453,-145,120,0.5643860512665178,0.43561394873348225,away,KC,over,8.5,0.5305164319248826,-113,0.5066009958897986,DET,KC,2023 REG,2,0,5,1,1,7,0,1,-1,1,0,0,0,0,0,0,0,0,0,0.5066009958897986,0.49339900411020143
90835,0.5918367346938775,0.45454545454545453,-145,120,0.5643860512665178,0.43561394873348225,home,DET,under,8.5,0.5145631067961165,-106,0.49339900411020143,DET,KC,2023 REG,2,0,5,1,1,7,0,1,-1,1,0,0,0,0,0,0,0,0,0,0.5066009958897986,0.49339900411020143
90836,0.5121951219512195,0.5348837209302326,-105,-115,0.48808156828023186,0.5119184317197681,away,BOS,over,8.5,0.5327102803738317,-114,0.5075272610403079,CWS,BOS,2023 REG,10,5,9,4,9,19,1,0,1,-1,1,1,1,1,0,0,0,0,0,0.5075272610403079,0.4924727389596921
90836,0.5121951219512195,0.5348837209302326,-105,-115,0.48808156828023186,0.5119184317197681,home,CWS,under,8.5,0.5145631067961165,-106,0.4924727389596921,CWS,BOS,2023 REG,10,5,9,4,9,19,1,0,1,-1,1,1,1,1,0,0,0,0,0,0.5075272610403079,0.4924727389596921
90837,0.4,0.6389891696750902,150,-177,0.3844043321299639,0.6155956678700361,away,TEX,over,8.5,0.5121951219512195,-105,0.48808156828023186,DET,TEX,2023 REG,5,0,10,5,5,15,0,1,-5,5,0,0,0,0,0,0,0,0,0,0.48808156828023186,0.5119184317197681
90837,0.4,0.6389891696750902,150,-177,0.3844043321299639,0.6155956678700361,home,DET,under,8.5,0.5348837209302326,-115,0.5119184317197681,DET,TEX,2023 REG,5,0,10,5,5,15,0,1,-5,5,0,0,0,0,0,0,0,0,0,0.48808156828023186,0.5119184317197681
90838,0.6575342465753424,0.3802281368821293,-192,163,0.6327041862197444,0.36729581378025555,away,PIT,over,8.5,0.5454545454545454,-120,0.5233614270517961,STL,PIT,2023 REG,7,3,10,6,9,17,0,1,-3,3,1,1,1,0,0,0,0,0,0,0.5233614270517961,0.4766385729482039
90838,0.6575342465753424,0.3802281368821293,-192,163,0.6327041862197444,0.36729581378025555,home,STL,under,8.5,0.49504950495049505,102,0.4766385729482039,STL,PIT,2023 REG,7,3,10,6,9,17,0,1,-3,3,1,1,1,0,0,0,0,0,0,0.5233614270517961,0.4766385729482039
90839,0.574468085106383,0.46511627906976744,-135,115,0.5517281312179562,0.44827186878204384,away,PIT,over,8,0.5370370370370371,-116,0.5131785224377817,SF,PIT,2023 REG,18,14,9,4,18,27,1,0,10,-10,1,1,1,1,0,0,0,0,0,0.5131785224377817,0.4868214775622183
90839,0.574468085106383,0.46511627906976744,-135,115,0.5517281312179562,0.44827186878204384,home,SF,under,8,0.5073891625615764,-103,0.4868214775622183,SF,PIT,2023 REG,18,14,9,4,18,27,1,0,10,-10,1,1,1,1,0,0,0,0,0,0.5131785224377817,0.4868214775622183
90840,0.5884773662551441,0.45248868778280543,-143,121,0.5643697706690257,0.4356302293309743,away,WSH,over,11.5,0.5391705069124424,-117,0.5127649394825569,COL,WSH,2023 REG,10,7,8,6,13,18,1,0,1,-1,1,1,1,1,1,1,0,0,0,0.5127649394825569,0.48723506051744314
90840,0.5884773662551441,0.45248868778280543,-143,121,0.5643697706690257,0.4356302293309743,home,COL,under,11.5,0.5098039215686274,-104,0.48723506051744314,COL,WSH,2023 REG,10,7,8,6,13,18,1,0,1,-1,1,1,1,1,1,1,0,0,0,0.5127649394825569,0.48723506051744314
90841,0.5121951219512195,0.5238095238095238,-105,-110,0.4937537180249852,0.5062462819750149,away,SEA,over,7.5,0.5348837209302326,-115,0.5097020142727117,TEX,SEA,2023 REG,7,2,3,0,2,10,1,0,2,-2,0,0,0,0,0,0,0,0,0,0.5097020142727117,0.49029798572728833
90841,0.5121951219512195,0.5238095238095238,-105,-110,0.4937537180249852,0.5062462819750149,home,TEX,under,7.5,0.5121951219512195,-105,0.49029798572728833,TEX,SEA,2023 REG,7,2,3,0,2,10,1,0,2,-2,0,0,0,0,0,0,0,0,0,0.5097020142727117,0.49029798572728833
90842,0.5833333333333333,0.46511627906976744,-140,115,0.5550710594315246,0.44492894056847543,away,DET,over,8.5,0.5238095238095238,-110,0.4988662131519274,CLE,DET,2023 REG,7,4,6,1,5,13,1,0,3,-3,1,0,0,0,0,0,0,0,0,0.4988662131519274,0.5011337868480725
90842,0.5833333333333333,0.46511627906976744,-140,115,0.5550710594315246,0.44492894056847543,home,CLE,under,8.5,0.5238095238095238,-110,0.5011337868480725,CLE,DET,2023 REG,7,4,6,1,5,13,1,0,3,-3,1,0,0,0,0,0,0,0,0,0.4988662131519274,0.5011337868480725
90843,0.6923076923076923,0.3472222222222222,-225,188,0.6649408284023669,0.3350591715976331,away,KC,over,9.5,0.5145631067961165,-106,0.49023796582517226,CHC,KC,2023 REG,9,6,10,4,10,19,1,0,2,-2,1,1,1,1,0,0,0,0,0,0.49023796582517226,0.5097620341748277
90843,0.6923076923076923,0.3472222222222222,-225,188,0.6649408284023669,0.3350591715976331,home,CHC,under,9.5,0.5327102803738317,-114,0.5097620341748277,CHC,KC,2023 REG,9,6,10,4,10,19,1,0,2,-2,1,1,1,1,0,0,0,0,0,0.49023796582517226,0.5097620341748277
90844,0.5652173913043479,0.47619047619047616,-130,110,0.5418129444594474,0.4581870555405526,away,PIT,over,8,0.5073891625615764,-103,0.48484779035144243,PHI,PIT,2023 REG,8,7,11,6,13,19,1,0,1,-1,1,1,1,1,1,1,0,0,0,0.48484779035144243,0.5151522096485576
90844,0.5652173913043479,0.47619047619047616,-130,110,0.5418129444594474,0.4581870555405526,home,PHI,under,8,0.5370370370370371,-116,0.5151522096485576,PHI,PIT,2023 REG,8,7,11,6,13,19,1,0,1,-1,1,1,1,1,1,1,0,0,0,0.48484779035144243,0.5151522096485576
90845,0.5,0.5454545454545454,100,-120,0.4772727272727273,0.5227272727272727,away,SD,over,7,0.5073891625615764,-103,0.4826927225525911,SF,SD,2023 REG,7,2,9,1,3,16,1,0,1,-1,1,0,0,0,0,0,0,0,0,0.4826927225525911,0.5173072774474089
90845,0.5,0.5454545454545454,100,-120,0.4772727272727273,0.5227272727272727,home,SF,under,7,0.5412844036697247,-118,0.5173072774474089,SF,SD,2023 REG,7,2,9,1,3,16,1,0,1,-1,1,0,0,0,0,0,0,0,0,0.4826927225525911,0.5173072774474089
90846,0.574468085106383,0.46511627906976744,-135,115,0.5517281312179562,0.44827186878204384,away,CWS,over,8.5,0.5454545454545454,-120,0.5206611570247933,NYM,CWS,2023 REG,10,11,12,10,21,22,1,0,1,-1,1,1,1,1,1,1,1,1,1,0.5206611570247933,0.4793388429752067
90846,0.574468085106383,0.46511627906976744,-135,115,0.5517281312179562,0.44827186878204384,home,NYM,under,8.5,0.5,100,0.4793388429752067,NYM,CWS,2023 REG,10,11,12,10,21,22,1,0,1,-1,1,1,1,1,1,1,1,1,1,0.5206611570247933,0.4793388429752067
90847,0.7058823529411764,0.3333333333333333,-240,200,0.6782006920415226,0.32179930795847744,away,COL,over,10.5,0.5145631067961165,-106,0.4913668392989033,ATL,COL,2023 REG,7,8,7,1,9,14,1,0,7,-7,1,0,0,0,0,0,0,0,0,0.4913668392989033,0.5086331607010968
90847,0.7058823529411764,0.3333333333333333,-240,200,0.6782006920415226,0.32179930795847744,home,ATL,under,10.5,0.5305164319248826,-113,0.5086331607010968,ATL,COL,2023 REG,7,8,7,1,9,14,1,0,7,-7,1,0,0,0,0,0,0,0,0,0.4913668392989033,0.5086331607010968
90848,0.5726495726495727,0.4672897196261683,-134,114,0.5497783539959433,0.4502216460040567,away,SF,over,7.5,0.5348837209302326,-115,0.5097020142727117,SD,SF,2023 REG,10,4,4,0,4,14,1,0,4,-4,0,0,0,0,0,0,0,0,0,0.5097020142727117,0.49029798572728833
90848,0.5726495726495727,0.4672897196261683,-134,114,0.5497783539959433,0.4502216460040567,home,SD,under,7.5,0.5121951219512195,-105,0.49029798572728833,SD,SF,2023 REG,10,4,4,0,4,14,1,0,4,-4,0,0,0,0,0,0,0,0,0,0.5097020142727117,0.49029798572728833
90849,0.6923076923076923,0.3508771929824561,-225,185,0.6624104640298972,0.33758953597010277,away,LAA,over,10,0.5238095238095238,-110,0.4988662131519274,ATL,LAA,2023 REG,4,1,10,4,5,14,0,1,-3,3,1,0,0,0,0,0,0,0,0,0.4988662131519274,0.5011337868480725
90849,0.6923076923076923,0.3508771929824561,-225,185,0.6624104640298972,0.33758953597010277,home,ATL,under,10,0.5238095238095238,-110,0.5011337868480725,ATL,LAA,2023 REG,4,1,10,4,5,14,0,1,-3,3,1,0,0,0,0,0,0,0,0,0.4988662131519274,0.5011337868480725
90850,0.6168582375478928,0.42194092827004215,-161,137,0.592924652503113,0.407075347496887,away,BAL,over,9,0.49751243781094534,101,0.476135829221149,ATL,BAL,2023 REG,4,3,5,2,5,9,1,0,1,-1,1,1,0,0,0,0,0,0,0,0.476135829221149,0.523864170778851
90850,0.6168582375478928,0.42194092827004215,-161,137,0.592924652503113,0.407075347496887,home,ATL,under,9,0.5454545454545454,-120,0.523864170778851,ATL,BAL,2023 REG,4,3,5,2,5,9,1,0,1,-1,1,1,0,0,0,0,0,0,0,0.476135829221149,0.523864170778851
90851,0.5121951219512195,0.5348837209302326,-105,-115,0.48808156828023186,0.5119184317197681,away,HOU,over,8,0.5348837209302326,-115,0.5097020142727117,TOR,HOU,2023 REG,5,3,6,2,5,11,1,0,1,-1,1,1,0,0,0,0,0,0,0,0.5097020142727117,0.49029798572728833
90851,0.5121951219512195,0.5348837209302326,-105,-115,0.48808156828023186,0.5119184317197681,home,TOR,under,8,0.5121951219512195,-105,0.49029798572728833,TOR,HOU,2023 REG,5,3,6,2,5,11,1,0,1,-1,1,1,0,0,0,0,0,0,0,0.5097020142727117,0.49029798572728833
90852,0.7777777777777779,0.273972602739726,-350,265,0.7375274818197193,0.2624725181802807,away,STL,over,9,0.5348837209302326,-115,0.5097020142727117,ATL,STL,2023 REG,10,6,14,11,17,24,0,1,-5,5,1,1,1,1,1,1,0,0,0,0.5097020142727117,0.49029798572728833
90852,0.7777777777777779,0.273972602739726,-350,265,0.7375274818197193,0.2624725181802807,home,ATL,under,9,0.5121951219512195,-105,0.49029798572728833,ATL,STL,2023 REG,10,6,14,11,17,24,0,1,-5,5,1,1,1,1,1,1,0,0,0,0.5097020142727117,0.49029798572728833
90853,0.425531914893617,0.609375,135,-156,0.4106779085559077,0.5893220914440923,away,PHI,over,9,0.5454545454545454,-120,0.5206611570247933,WSH,PHI,2023 REG,10,3,14,11,14,24,0,1,-8,8,1,1,1,0,0,0,0,0,0,0.5206611570247933,0.4793388429752067
90853,0.425531914893617,0.609375,135,-156,0.4106779085559077,0.5893220914440923,home,WSH,under,9,0.5,100,0.4793388429752067,WSH,PHI,2023 REG,10,3,14,11,14,24,0,1,-8,8,1,1,1,0,0,0,0,0,0,0.5206611570247933,0.4793388429752067
90854,0.6551724137931035,0.38759689922480617,-190,158,0.6271511397468869,0.37284886025311315,away,PIT,over,9.5,0.5,100,0.4772727272727273,LAA,PIT,2023 REG,5,0,7,3,3,12,0,1,-3,3,0,0,0,0,0,0,0,0,0,0.4772727272727273,0.5227272727272727
90854,0.6551724137931035,0.38759689922480617,-190,158,0.6271511397468869,0.37284886025311315,home,LAA,under,9.5,0.5454545454545454,-120,0.5227272727272727,LAA,PIT,2023 REG,5,0,7,3,3,12,0,1,-3,3,0,0,0,0,0,0,0,0,0,0.4772727272727273,0.5227272727272727
90855,0.5145631067961165,0.5215311004784688,-106,-109,0.4959903593635629,0.5040096406364372,away,TB,over,9,0.5454545454545454,-120,0.5206611570247933,NYM,TB,2023 REG,8,3,6,2,5,14,1,0,1,-1,1,1,0,0,0,0,0,0,0,0.5206611570247933,0.4793388429752067
90855,0.5145631067961165,0.5215311004784688,-106,-109,0.4959903593635629,0.5040096406364372,home,NYM,under,9,0.5,100,0.4793388429752067,NYM,TB,2023 REG,8,3,6,2,5,14,1,0,1,-1,1,1,0,0,0,0,0,0,0,0.5206611570247933,0.4793388429752067
90856,0.574468085106383,0.46511627906976744,-135,115,0.5517281312179562,0.44827186878204384,away,NYY,over,8.5,0.5348837209302326,-115,0.5109810284308424,BOS,NYY,2023 REG,8,4,5,1,5,13,1,0,3,-3,1,0,0,0,0,0,0,0,0,0.5109810284308424,0.48901897156915763
90856,0.574468085106383,0.46511627906976744,-135,115,0.5517281312179562,0.44827186878204384,home,BOS,under,8.5,0.5098039215686274,-104,0.48901897156915763,BOS,NYY,2023 REG,8,4,5,1,5,13,1,0,3,-3,1,0,0,0,0,0,0,0,0,0.5109810284308424,0.48901897156915763
90857,0.46511627906976744,0.5652173913043479,115,-130,0.4510075951748301,0.54899240482517,away,TB,over,9,0.5,100,0.4772727272727273,NYY,TB,2023 REG,12,7,9,8,15,21,0,1,-1,1,1,1,1,1,1,1,1,0,0,0.4772727272727273,0.5227272727272727
90857,0.46511627906976744,0.5652173913043479,115,-130,0.4510075951748301,0.54899240482517,home,NYY,under,9,0.5454545454545454,-120,0.5227272727272727,NYY,TB,2023 REG,12,7,9,8,15,21,0,1,-1,1,1,1,1,1,1,1,1,0,0,0.4772727272727273,0.5227272727272727
90858,0.5454545454545454,0.49504950495049505,-120,102,0.5233614270517961,0.4766385729482039,away,MIL,over,9.5,0.5121951219512195,-105,0.48919479393107135,CIN,MIL,2023 REG,6,2,3,0,2,9,1,0,2,-2,0,0,0,0,0,0,0,0,0,0.48919479393107135,0.5108052060689287
90858,0.5454545454545454,0.49504950495049505,-120,102,0.5233614270517961,0.4766385729482039,home,CIN,under,9.5,0.5327102803738317,-114,0.5108052060689287,CIN,MIL,2023 REG,6,2,3,0,2,9,1,0,2,-2,0,0,0,0,0,0,0,0,0,0.48919479393107135,0.5108052060689287
90859,0.4347826086956522,0.6000000000000001,130,-150,0.4196597353497164,0.5803402646502835,away,SD,over,10,0.5121951219512195,-105,0.48808156828023186,WSH,SD,2023 REG,9,5,4,3,8,13,1,0,2,-2,1,1,1,0,0,0,0,0,0,0.48808156828023186,0.5119184317197681
90859,0.4347826086956522,0.6000000000000001,130,-150,0.4196597353497164,0.5803402646502835,home,WSH,under,10,0.5348837209302326,-115,0.5119184317197681,WSH,SD,2023 REG,9,5,4,3,8,13,1,0,2,-2,1,1,1,0,0,0,0,0,0,0.48808156828023186,0.5119184317197681
90860,0.5901639344262295,0.4484304932735426,-144,123,0.5673868951280033,0.43261310487199667,away,CWS,over,9.5,0.5238095238095238,-110,0.4988662131519274,CLE,CWS,2023 REG,7,4,12,7,11,19,0,1,-3,3,1,1,1,1,0,0,0,0,0,0.4988662131519274,0.5011337868480725
90860,0.5901639344262295,0.4484304932735426,-144,123,0.5673868951280033,0.43261310487199667,home,CLE,under,9.5,0.5238095238095238,-110,0.5011337868480725,CLE,CWS,2023 REG,7,4,12,7,11,19,0,1,-3,3,1,1,1,1,0,0,0,0,0,0.4988662131519274,0.5011337868480725
90861,0.6402877697841727,0.3921568627450981,-178,155,0.6195138683805389,0.3804861316194611,away,NYM,over,8,0.5391705069124424,-117,0.5140669063204599,SD,NYM,2023 REG,5,3,3,1,4,8,1,0,2,-2,1,0,0,0,0,0,0,0,0,0.5140669063204599,0.4859330936795401
90861,0.6402877697841727,0.3921568627450981,-178,155,0.6195138683805389,0.3804861316194611,home,SD,under,8,0.5073891625615764,-103,0.4859330936795401,SD,NYM,2023 REG,5,3,3,1,4,8,1,0,2,-2,1,0,0,0,0,0,0,0,0,0.5140669063204599,0.4859330936795401
90862,0.726027397260274,0.31746031746031744,-265,215,0.6944541249288857,0.3055458750711143,away,OAK,over,8.5,0.5,100,0.4772727272727273,SF,OAK,2023 REG,4,2,5,1,3,9,1,0,1,-1,1,0,0,0,0,0,0,0,0,0.4772727272727273,0.5227272727272727
90862,0.726027397260274,0.31746031746031744,-265,215,0.6944541249288857,0.3055458750711143,home,SF,under,8.5,0.5454545454545454,-120,0.5227272727272727,SF,OAK,2023 REG,4,2,5,1,3,9,1,0,1,-1,1,0,0,0,0,0,0,0,0,0.4772727272727273,0.5227272727272727
90863,0.6551724137931035,0.37735849056603776,-190,165,0.6338590626612524,0.36614093733874764,away,KC,over,8,0.5391705069124424,-117,0.5167097046779946,BAL,KC,2023 REG,8,3,7,2,5,15,1,0,1,-1,1,1,0,0,0,0,0,0,0,0.5167097046779946,0.4832902953220054
90863,0.6551724137931035,0.37735849056603776,-190,165,0.6338590626612524,0.36614093733874764,home,BAL,under,8,0.5024875621890548,-101,0.4832902953220054,BAL,KC,2023 REG,8,3,7,2,5,15,1,0,1,-1,1,1,0,0,0,0,0,0,0,0.5167097046779946,0.4832902953220054
90864,0.42372881355932196,0.6153846153846154,136,-160,0.4071553267186705,0.5928446732813295,away,NYY,over,8,0.5238095238095238,-110,0.4988662131519274,PIT,NYY,2023 REG,8,3,4,2,5,12,1,0,1,-1,1,1,0,0,0,0,0,0,0,0.4988662131519274,0.5011337868480725
90864,0.42372881355932196,0.6153846153846154,136,-160,0.4071553267186705,0.5928446732813295,home,PIT,under,8,0.5238095238095238,-110,0.5011337868480725,PIT,NYY,2023 REG,8,3,4,2,5,12,1,0,1,-1,1,1,0,0,0,0,0,0,0,0.4988662131519274,0.5011337868480725
90865,0.47619047619047616,0.5652173913043479,110,-130,0.4564724440500838,0.5435275559499162,away,MIL,over,9,0.5121951219512195,-105,0.48808156828023186,WSH,MIL,2023 REG,5,3,4,2,5,9,1,0,1,-1,1,1,0,0,0,0,0,0,0,0.48808156828023186,0.5119184317197681
90865,0.47619047619047616,0.5652173913043479,110,-130,0.4564724440500838,0.5435275559499162,home,WSH,under,9,0.5348837209302326,-115,0.5119184317197681,WSH,MIL,2023 REG,5,3,4,2,5,9,1,0,1,-1,1,1,0,0,0,0,0,0,0,0.48808156828023186,0.5119184317197681
90866,0.6363636363636364,0.4081632653061224,-175,145,0.6080283353010626,0.3919716646989374,away,TOR,over,8,0.5348837209302326,-115,0.5097020142727117,TB,TOR,2023 REG,5,6,8,3,9,13,1,0,3,-3,1,1,1,0,0,0,0,0,0,0.5097020142727117,0.49029798572728833
90866,0.6363636363636364,0.4081632653061224,-175,145,0.6080283353010626,0.3919716646989374,home,TB,under,8,0.5121951219512195,-105,0.49029798572728833,TB,TOR,2023 REG,5,6,8,3,9,13,1,0,3,-3,1,1,1,0,0,0,0,0,0,0.5097020142727117,0.49029798572728833
90867,0.4694835680751174,0.574468085106383,113,-135,0.44884898911666654,0.5511510108833335,away,TOR,over,9.5,0.5121951219512195,-105,0.48808156828023186,BOS,TOR,2023 REG,14,7,8,6,13,22,1,0,1,-1,1,1,1,1,1,1,0,0,0,0.48808156828023186,0.5119184317197681
90867,0.4694835680751174,0.574468085106383,113,-135,0.44884898911666654,0.5511510108833335,home,BOS,under,9.5,0.5348837209302326,-115,0.5119184317197681,BOS,TOR,2023 REG,14,7,8,6,13,22,1,0,1,-1,1,1,1,1,1,1,0,0,0,0.48808156828023186,0.5119184317197681
90868,0.4132231404958678,0.626865671641791,142,-168,0.39665751564559554,0.6033424843544044,away,ATL,over,9.5,0.5283018867924528,-112,0.5031902949311281,PHI,ATL,2023 REG,8,8,11,10,18,19,0,1,-2,2,1,1,1,1,1,1,1,1,0,0.5031902949311281,0.4968097050688719
90868,0.4132231404958678,0.626865671641791,142,-168,0.39665751564559554,0.6033424843544044,away,ATL,over,10.5,0.5073891625615764,-103,0.4837652908580103,PHI,ATL,2023 REG,8,8,11,10,18,19,0,1,-2,2,1,1,1,1,1,1,1,1,0,0.5031902949311281,0.4968097050688719
90868,0.4132231404958678,0.626865671641791,142,-168,0.39665751564559554,0.6033424843544044,home,PHI,under,9.5,0.5192307692307692,-108,0.4968097050688719,PHI,ATL,2023 REG,8,8,11,10,18,19,0,1,-2,2,1,1,1,1,1,1,1,1,0,0.5031902949311281,0.4968097050688719
90868,0.4132231404958678,0.626865671641791,142,-168,0.39665751564559554,0.6033424843544044,home,PHI,under,10.5,0.5391705069124424,-117,0.5162347091419897,PHI,ATL,2023 REG,8,8,11,10,18,19,0,1,-2,2,1,1,1,1,1,1,1,1,0,0.5031902949311281,0.4968097050688719
90869,0.4672897196261683,0.5726495726495727,114,-134,0.44862649893656975,0.5513735010634302,away,CHC,over,9.5,0.504950495049505,-102,0.4826715732667395,CIN,CHC,2023 REG,9,5,16,12,17,25,0,1,-7,7,1,1,1,1,1,0,0,0,0,0.4826715732667395,0.5173284267332605
90869,0.4672897196261683,0.5726495726495727,114,-134,0.44862649893656975,0.5513735010634302,home,CIN,under,9.5,0.5391705069124424,-117,0.5173284267332605,CIN,CHC,2023 REG,9,5,16,12,17,25,0,1,-7,7,1,1,1,1,1,0,0,0,0,0.4826715732667395,0.5173284267332605
90870,0.5121951219512195,0.5348837209302326,-105,-115,0.48808156828023186,0.5119184317197681,away,ARI,over,8,0.5238095238095238,-110,0.4988662131519274,SF,ARI,2023 REG,10,7,12,6,13,22,1,0,1,-1,1,1,1,1,1,1,0,0,0,0.4988662131519274,0.5011337868480725
90870,0.5121951219512195,0.5348837209302326,-105,-115,0.48808156828023186,0.5119184317197681,home,SF,under,8,0.5238095238095238,-110,0.5011337868480725,SF,ARI,2023 REG,10,7,12,6,13,22,1,0,1,-1,1,1,1,1,1,1,0,0,0,0.4988662131519274,0.5011337868480725
90871,0.47619047619047616,0.5555555555555556,110,-125,0.46107331821617537,0.5389266817838246,away,HOU,over,9,0.5121951219512195,-105,0.48808156828023186,LAA,HOU,2023 REG,11,6,7,4,10,18,1,0,2,-2,1,1,1,1,0,0,0,0,0,0.48808156828023186,0.5119184317197681
90871,0.47619047619047616,0.5555555555555556,110,-125,0.46107331821617537,0.5389266817838246,home,LAA,under,9,0.5348837209302326,-115,0.5119184317197681,LAA,HOU,2023 REG,11,6,7,4,10,18,1,0,2,-2,1,1,1,1,0,0,0,0,0,0.48808156828023186,0.5119184317197681
90872,0.5098039215686274,0.5283018867924528,-104,-112,0.4903774310316062,0.5096225689683938,away,SF,over,10,0.5238095238095238,-110,0.4988662131519274,ARI,SF,2023 REG,12,7,11,5,12,23,1,0,2,-2,1,1,1,1,1,0,0,0,0,0.4988662131519274,0.5011337868480725
90872,0.5098039215686274,0.5283018867924528,-104,-112,0.4903774310316062,0.5096225689683938,home,ARI,under,10,0.5238095238095238,-110,0.5011337868480725,ARI,SF,2023 REG,12,7,11,5,12,23,1,0,2,-2,1,1,1,1,1,0,0,0,0,0.4988662131519274,0.5011337868480725
90873,0.6363636363636364,0.4,-175,150,0.6132231404958678,0.3867768595041322,away,LAA,over,8.5,0.5454545454545454,-120,0.5206611570247933,STL,LAA,2023 REG,10,7,16,11,18,26,0,1,-4,4,1,1,1,1,1,1,1,0,0,0.5206611570247933,0.4793388429752067
90873,0.6363636363636364,0.4,-175,150,0.6132231404958678,0.3867768595041322,home,STL,under,8.5,0.5,100,0.4793388429752067,STL,LAA,2023 REG,10,7,16,11,18,26,0,1,-4,4,1,1,1,1,1,1,1,0,0,0.5206611570247933,0.4793388429752067
90874,0.574468085106383,0.46511627906976744,-135,115,0.5517281312179562,0.44827186878204384,away,MIA,over,9,0.5121951219512195,-105,0.48808156828023186,PIT,MIA,2023 REG,6,3,3,0,3,9,1,0,3,-3,0,0,0,0,0,0,0,0,0,0.48808156828023186,0.5119184317197681
90874,0.574468085106383,0.46511627906976744,-135,115,0.5517281312179562,0.44827186878204384,home,PIT,under,9,0.5348837209302326,-115,0.5119184317197681,PIT,MIA,2023 REG,6,3,3,0,3,9,1,0,3,-3,0,0,0,0,0,0,0,0,0,0.48808156828023186,0.5119184317197681
90875,0.7142857142857143,0.3225806451612903,-250,210,0.6879526003949967,0.3120473996050033,away,PIT,over,9,0.5238095238095238,-110,0.5012646084074657,LAD,PIT,2023 REG,6,6,9,4,10,15,1,0,2,-2,1,1,1,1,0,0,0,0,0,0.5012646084074657,0.4987353915925343
90875,0.7142857142857143,0.3225806451612903,-250,210,0.6879526003949967,0.3120473996050033,home,LAD,under,9,0.5192307692307692,-108,0.4987353915925343,LAD,PIT,2023 REG,6,6,9,4,10,15,1,0,2,-2,1,1,1,1,0,0,0,0,0,0.5012646084074657,0.4987353915925343
90876,0.5238095238095238,0.5192307692307692,-110,-108,0.5012646084074657,0.4987353915925343,away,PHI,over,8.5,0.5327102803738317,-114,0.508788710910954,WSH,PHI,2023 REG,7,2,10,4,6,17,0,1,-2,2,1,1,0,0,0,0,0,0,0,0.508788710910954,0.491211289089046
90876,0.5238095238095238,0.5192307692307692,-110,-108,0.5012646084074657,0.4987353915925343,home,WSH,under,8.5,0.5121951219512195,-105,0.491211289089046,WSH,PHI,2023 REG,7,2,10,4,6,17,0,1,-2,2,1,1,0,0,0,0,0,0,0,0.508788710910954,0.491211289089046
90877,0.607843137254902,0.4347826086956522,-155,130,0.5819333701084867,0.41806662989151333,away,NYM,over,8.5,0.5238095238095238,-110,0.4988662131519274,MIA,NYM,2023 REG,8,4,11,3,7,19,1,0,1,-1,1,1,1,0,0,0,0,0,0,0.4988662131519274,0.5011337868480725
90877,0.607843137254902,0.4347826086956522,-155,130,0.5819333701084867,0.41806662989151333,home,MIA,under,8.5,0.5238095238095238,-110,0.5011337868480725,MIA,NYM,2023 REG,8,4,11,3,7,19,1,0,1,-1,1,1,1,0,0,0,0,0,0,0.4988662131519274,0.5011337868480725
90878,0.2631578947368421,0.7752808988764045,280,-345,0.25304242273335614,0.7469575772666439,away,HOU,over,8.5,0.5327102803738317,-114,0.5075272610403079,OAK,HOU,2023 REG,6,3,8,6,9,14,0,1,-3,3,1,1,1,0,0,0,0,0,0,0.5075272610403079,0.4924727389596921
90878,0.2631578947368421,0.7752808988764045,280,-345,0.25304242273335614,0.7469575772666439,home,OAK,under,8.5,0.5145631067961165,-106,0.4924727389596921,OAK,HOU,2023 REG,6,3,8,6,9,14,0,1,-3,3,1,1,1,0,0,0,0,0,0,0.5075272610403079,0.4924727389596921
90879,0.5884773662551441,0.45454545454545453,-143,120,0.5631594099815408,0.4368405900184592,away,PIT,over,9.5,0.5,100,0.4772727272727273,STL,PIT,2023 REG,8,6,8,4,10,16,1,0,2,-2,1,1,1,1,0,0,0,0,0,0.4772727272727273,0.5227272727272727
90879,0.5884773662551441,0.45454545454545453,-143,120,0.5631594099815408,0.4368405900184592,home,STL,under,9.5,0.5454545454545454,-120,0.5227272727272727,STL,PIT,2023 REG,8,6,8,4,10,16,1,0,2,-2,1,1,1,1,0,0,0,0,0,0.4772727272727273,0.5227272727272727
90880,0.5348837209302326,0.504950495049505,-115,-102,0.5135770472666521,0.4864229527333479,away,ARI,over,12,0.5121951219512195,-105,0.48919479393107135,COL,ARI,2023 REG,8,4,16,11,15,24,0,1,-7,7,1,1,1,1,0,0,0,0,0,0.48919479393107135,0.5108052060689287
90880,0.5348837209302326,0.504950495049505,-115,-102,0.5135770472666521,0.4864229527333479,home,COL,under,12,0.5327102803738317,-114,0.5108052060689287,COL,ARI,2023 REG,8,4,16,11,15,24,0,1,-7,7,1,1,1,1,0,0,0,0,0,0.48919479393107135,0.5108052060689287
90881,0.6774193548387096,0.37037037037037035,-210,170,0.6450456700196554,0.3549543299803446,away,KC,over,9,0.5121951219512195,-105,0.48808156828023186,CLE,KC,2023 REG,8,5,5,1,6,13,1,0,4,-4,1,0,0,0,0,0,0,0,0,0.48808156828023186,0.5119184317197681
90881,0.6774193548387096,0.37037037037037035,-210,170,0.6450456700196554,0.3549543299803446,home,CLE,under,9,0.5348837209302326,-115,0.5119184317197681,CLE,KC,2023 REG,8,5,5,1,6,13,1,0,4,-4,1,0,0,0,0,0,0,0,0,0.48808156828023186,0.5119184317197681
90882,0.5454545454545454,0.5,-120,100,0.5206611570247933,0.4793388429752067,away,CWS,over,10,0.5348837209302326,-115,0.5097020142727117,KC,CWS,2023 REG,4,4,14,6,10,18,0,1,-2,2,1,1,1,1,0,0,0,0,0,0.5097020142727117,0.49029798572728833
90882,0.5454545454545454,0.5,-120,100,0.5206611570247933,0.4793388429752067,home,KC,under,10,0.5121951219512195,-105,0.49029798572728833,KC,CWS,2023 REG,4,4,14,6,10,18,0,1,-2,2,1,1,1,1,0,0,0,0,0,0.5097020142727117,0.49029798572728833
90883,0.5,0.5454545454545454,100,-120,0.4772727272727273,0.5227272727272727,away,NYM,over,9.5,0.5192307692307692,-108,0.49688292476754015,PIT,NYM,2023 REG,3,1,8,5,6,11,0,1,-4,4,1,0,0,0,0,0,0,0,0,0.49688292476754015,0.5031170752324599
90883,0.5,0.5454545454545454,100,-120,0.4772727272727273,0.5227272727272727,home,PIT,under,9.5,0.5238095238095238,-110,0.5031170752324599,PIT,NYM,2023 REG,3,1,8,5,6,11,0,1,-4,4,1,0,0,0,0,0,0,0,0,0.49688292476754015,0.5031170752324599
90884,0.726027397260274,0.3125,-265,220,0.6980554513041847,0.30194454869581533,away,WSH,over,8.5,0.5238095238095238,-110,0.4988662131519274,HOU,WSH,2023 REG,9,6,6,1,7,15,1,0,5,-5,1,0,0,0,0,0,0,0,0,0.4988662131519274,0.5011337868480725
90884,0.726027397260274,0.3125,-265,220,0.6980554513041847,0.30194454869581533,home,HOU,under,8.5,0.5238095238095238,-110,0.5011337868480725,HOU,WSH,2023 REG,9,6,6,1,7,15,1,0,5,-5,1,0,0,0,0,0,0,0,0,0.4988662131519274,0.5011337868480725
90885,0.41493775933609955,0.6254681647940076,141,-167,0.39817181571364846,0.6018281842863515,away,MIN,over,9,0.5,100,0.4783105022831051,CWS,MIN,2023 REG,5,3,3,2,5,8,1,0,1,-1,1,1,0,0,0,0,0,0,0,0.4783105022831051,0.5216894977168949
90885,0.41493775933609955,0.6254681647940076,141,-167,0.39817181571364846,0.6018281842863515,home,CWS,under,9,0.5433789954337899,-119,0.5216894977168949,CWS,MIN,2023 REG,5,3,3,2,5,8,1,0,1,-1,1,1,0,0,0,0,0,0,0,0.4783105022831051,0.5216894977168949
90886,0.4166666666666667,0.6226415094339623,140,-165,0.4002882599580712,0.5997117400419287,away,MIA,over,10.5,0.5412844036697247,-118,0.5189377998484975,COL,MIA,2023 REG,4,2,14,10,12,18,0,1,-8,8,1,1,0,0,0,0,0,0,0,0.5189377998484975,0.4810622001515025
90886,0.4166666666666667,0.6226415094339623,140,-165,0.4002882599580712,0.5997117400419287,home,COL,under,10.5,0.5,100,0.4810622001515025,COL,MIA,2023 REG,4,2,14,10,12,18,0,1,-8,8,1,1,0,0,0,0,0,0,0,0.5189377998484975,0.4810622001515025
90887,0.6575342465753424,0.3846153846153846,-192,160,0.6298194205869192,0.3701805794130808,away,NYY,over,9,0.5348837209302326,-115,0.5097020142727117,ATL,NYY,2023 REG,15,11,11,3,14,26,1,0,8,-8,1,1,1,0,0,0,0,0,0,0.5097020142727117,0.49029798572728833
90887,0.6575342465753424,0.3846153846153846,-192,160,0.6298194205869192,0.3701805794130808,home,ATL,under,9,0.5121951219512195,-105,0.49029798572728833,ATL,NYY,2023 REG,15,11,11,3,14,26,1,0,8,-8,1,1,1,0,0,0,0,0,0,0.5097020142727117,0.49029798572728833
90888,0.6153846153846154,0.425531914893617,-160,135,0.5902052121364724,0.40979478786352763,away,BAL,over,8,0.5121951219512195,-105,0.48808156828023186,SEA,BAL,2023 REG,4,0,4,1,1,8,0,1,-1,1,0,0,0,0,0,0,0,0,0,0.48808156828023186,0.5119184317197681
90888,0.6153846153846154,0.425531914893617,-160,135,0.5902052121364724,0.40979478786352763,home,SEA,under,8,0.5348837209302326,-115,0.5119184317197681,SEA,BAL,2023 REG,4,0,4,1,1,8,0,1,-1,1,0,0,0,0,0,0,0,0,0,0.48808156828023186,0.5119184317197681
90889,0.5348837209302326,0.5121951219512195,-115,-105,0.5097020142727117,0.49029798572728833,away,TOR,over,8,0.5121951219512195,-105,0.48808156828023186,NYY,TOR,2023 REG,6,1,10,7,8,16,0,1,-6,6,1,0,0,0,0,0,0,0,0,0.48808156828023186,0.5119184317197681
90889,0.5348837209302326,0.5121951219512195,-115,-105,0.5097020142727117,0.49029798572728833,home,NYY,under,8,0.5348837209302326,-115,0.5119184317197681,NYY,TOR,2023 REG,6,1,10,7,8,16,0,1,-6,6,1,0,0,0,0,0,0,0,0,0.48808156828023186,0.5119184317197681
90890,0.6551724137931035,0.3846153846153846,-190,160,0.6291045458703008,0.37089545412969915,away,COL,over,8.5,0.5454545454545454,-120,0.5206611570247933,HOU,COL,2023 REG,13,4,3,1,5,16,1,0,3,-3,1,0,0,0,0,0,0,0,0,0.5206611570247933,0.4793388429752067
90890,0.6551724137931035,0.3846153846153846,-190,160,0.6291045458703008,0.37089545412969915,home,HOU,under,8.5,0.5,100,0.4793388429752067,HOU,COL,2023 REG,13,4,3,1,5,16,1,0,3,-3,1,0,0,0,0,0,0,0,0,0.5206611570247933,0.4793388429752067
90891,0.4166666666666667,0.6226415094339623,140,-165,0.4002882599580712,0.5997117400419287,away,MIN,over,8.5,0.5283018867924528,-112,0.5031902949311281,DET,MIN,2023 REG,8,3,2,0,3,10,1,0,3,-3,0,0,0,0,0,0,0,0,0,0.5031902949311281,0.4968097050688719
90891,0.4166666666666667,0.6226415094339623,140,-165,0.4002882599580712,0.5997117400419287,home,DET,under,8.5,0.5192307692307692,-108,0.4968097050688719,DET,MIN,2023 REG,8,3,2,0,3,10,1,0,3,-3,0,0,0,0,0,0,0,0,0,0.5031902949311281,0.4968097050688719
90892,0.7058823529411764,0.33557046979865773,-240,198,0.6766215368895289,0.32337846311047114,away,KC,over,10.5,0.5192307692307692,-108,0.49455035168025013,BOS,KC,2023 REG,8,2,7,0,2,15,1,0,2,-2,0,0,0,0,0,0,0,0,0,0.49455035168025013,0.5054496483197499
90892,0.7058823529411764,0.33557046979865773,-240,198,0.6766215368895289,0.32337846311047114,home,BOS,under,10.5,0.5283018867924528,-112,0.5054496483197499,BOS,KC,2023 REG,8,2,7,0,2,15,1,0,2,-2,0,0,0,0,0,0,0,0,0,0.49455035168025013,0.5054496483197499
90893,0.6108949416342413,0.425531914893617,-157,135,0.5886419592417365,0.41135804075826354,away,TB,over,9,0.5098039215686274,-104,0.48483656587239576,NYM,TB,2023 REG,6,5,10,8,13,16,0,1,-3,3,1,1,1,1,1,0,0,0,0,0.48483656587239576,0.5151634341276042
90893,0.6108949416342413,0.425531914893617,-157,135,0.5886419592417365,0.41135804075826354,home,NYM,under,9,0.5391705069124424,-117,0.5151634341276042,NYM,TB,2023 REG,6,5,10,8,13,16,0,1,-3,3,1,1,1,1,1,0,0,0,0,0.48483656587239576,0.5151634341276042
90894,0.6575342465753424,0.37735849056603776,-192,165,0.6345910769481337,0.36540892305186634,away,LAA,over,8.5,0.5305164319248826,-113,0.5066009958897986,TEX,LAA,2023 REG,13,12,1,0,12,14,1,0,12,-12,0,0,0,0,0,0,0,0,0,0.5066009958897986,0.49339900411020143
90894,0.6575342465753424,0.37735849056603776,-192,165,0.6345910769481337,0.36540892305186634,home,TEX,under,8.5,0.5145631067961165,-106,0.49339900411020143,TEX,LAA,2023 REG,13,12,1,0,12,14,1,0,12,-12,0,0,0,0,0,0,0,0,0,0.5066009958897986,0.49339900411020143
90895,0.5454545454545454,0.5,-120,100,0.5206611570247933,0.4793388429752067,away,OAK,over,8.5,0.5348837209302326,-115,0.5097020142727117,LAA,OAK,2023 REG,3,3,8,7,10,11,0,1,-4,4,1,1,1,0,0,0,0,0,0,0.5097020142727117,0.49029798572728833
90895,0.5454545454545454,0.5,-120,100,0.5206611570247933,0.4793388429752067,home,LAA,under,8.5,0.5121951219512195,-105,0.49029798572728833,LAA,OAK,2023 REG,3,3,8,7,10,11,0,1,-4,4,1,1,1,0,0,0,0,0,0,0.5097020142727117,0.49029798572728833
90896,0.425531914893617,0.607843137254902,135,-155,0.4113297650431834,0.5886702349568166,away,HOU,over,9.5,0.5121951219512195,-105,0.48919479393107135,PIT,HOU,2023 REG,3,0,12,7,7,15,0,1,-7,7,0,0,0,0,0,0,0,0,0,0.48919479393107135,0.5108052060689287
90896,0.425531914893617,0.607843137254902,135,-155,0.4113297650431834,0.5886702349568166,home,PIT,under,9.5,0.5327102803738317,-114,0.5108052060689287,PIT,HOU,2023 REG,3,0,12,7,7,15,0,1,-7,7,0,0,0,0,0,0,0,0,0,0.48919479393107135,0.5108052060689287
90897,0.5726495726495727,0.4716981132075471,-134,112,0.5472538892954956,0.45274611070450443,away,OAK,over,9.5,0.5305164319248826,-113,0.5041247242695369,CWS,OAK,2023 REG,9,6,4,2,8,13,1,0,4,-4,1,1,0,0,0,0,0,0,0,0.5041247242695369,0.4958752757304631
90897,0.5726495726495727,0.4716981132075471,-134,112,0.5472538892954956,0.45274611070450443,home,CWS,under,9.5,0.5192307692307692,-108,0.4958752757304631,CWS,OAK,2023 REG,9,6,4,2,8,13,1,0,4,-4,1,1,0,0,0,0,0,0,0,0.5041247242695369,0.4958752757304631
90898,0.3508771929824561,0.6825396825396826,185,-215,0.33915197350100396,0.660848026498996,away,TB,over,9,0.5348837209302326,-115,0.5097020142727117,OAK,TB,2023 REG,6,2,5,1,3,11,1,0,1,-1,1,0,0,0,0,0,0,0,0,0.5097020142727117,0.49029798572728833
90898,0.3508771929824561,0.6825396825396826,185,-215,0.33915197350100396,0.660848026498996,home,OAK,under,9,0.5121951219512195,-105,0.49029798572728833,OAK,TB,2023 REG,6,2,5,1,3,11,1,0,1,-1,1,0,0,0,0,0,0,0,0,0.5097020142727117,0.49029798572728833
90899,0.4444444444444444,0.5918367346938775,125,-145,0.42831947593852354,0.5716805240614764,away,ATL,over,10.5,0.5238095238095238,-110,0.4988662131519274,BOS,ATL,2023 REG,12,7,9,1,8,21,1,0,6,-6,1,0,0,0,0,0,0,0,0,0.4988662131519274,0.5011337868480725
90899,0.4444444444444444,0.5918367346938775,125,-145,0.42831947593852354,0.5716805240614764,home,BOS,under,10.5,0.5238095238095238,-110,0.5011337868480725,BOS,ATL,2023 REG,12,7,9,1,8,21,1,0,6,-6,1,0,0,0,0,0,0,0,0,0.4988662131519274,0.5011337868480725
90900,0.5412844036697247,0.5,-118,100,0.5189377998484975,0.4810622001515025,away,MIN,over,8.5,0.5238095238095238,-110,0.4988662131519274,PHI,MIN,2023 REG,5,0,10,3,3,15,0,1,-3,3,0,0,0,0,0,0,0,0,0,0.4988662131519274,0.5011337868480725
90900,0.5412844036697247,0.5,-118,100,0.5189377998484975,0.4810622001515025,home,PHI,under,8.5,0.5238095238095238,-110,0.5011337868480725,PHI,MIN,2023 REG,5,0,10,3,3,15,0,1,-3,3,0,0,0,0,0,0,0,0,0,0.4988662131519274,0.5011337868480725
90901,0.5370370370370371,0.504950495049505,-116,-102,0.514488177212783,0.48551182278721705,away,SD,over,8,0.5348837209302326,-115,0.5097020142727117,MIL,SD,2023 REG,10,7,7,3,10,17,1,0,4,-4,1,1,1,0,0,0,0,0,0,0.5097020142727117,0.49029798572728833
90901,0.5370370370370371,0.504950495049505,-116,-102,0.514488177212783,0.48551182278721705,home,MIL,under,8,0.5121951219512195,-105,0.49029798572728833,MIL,SD,2023 REG,10,7,7,3,10,17,1,0,4,-4,1,1,1,0,0,0,0,0,0,0.5097020142727117,0.49029798572728833
90902,0.5454545454545454,0.5,-120,100,0.5206611570247933,0.4793388429752067,away,TEX,over,8,0.504950495049505,-102,0.4826715732667395,CLE,TEX,2023 REG,11,2,6,1,3,17,1,0,1,-1,1,0,0,0,0,0,0,0,0,0.4826715732667395,0.5173284267332605
90902,0.5454545454545454,0.5,-120,100,0.5206611570247933,0.4793388429752067,home,CLE,under,8,0.5391705069124424,-117,0.5173284267332605,CLE,TEX,2023 REG,11,2,6,1,3,17,1,0,1,-1,1,0,0,0,0,0,0,0,0,0.4826715732667395,0.5173284267332605
90903,0.6551724137931035,0.3846153846153846,-190,160,0.6291045458703008,0.37089545412969915,away,DET,over,8.5,0.5454545454545454,-120,0.5206611570247933,MIN,DET,2023 REG,7,5,7,3,8,14,1,0,2,-2,1,1,1,0,0,0,0,0,0,0.5206611570247933,0.4793388429752067
90903,0.6551724137931035,0.3846153846153846,-190,160,0.6291045458703008,0.37089545412969915,home,MIN,under,8.5,0.5,100,0.4793388429752067,MIN,DET,2023 REG,7,5,7,3,8,14,1,0,2,-2,1,1,1,0,0,0,0,0,0,0.5206611570247933,0.4793388429752067
90904,0.7142857142857143,0.3278688524590164,-250,205,0.6841753094680495,0.3158246905319505,away,LAA,over,8,0.5348837209302326,-115,0.5097020142727117,TB,LAA,2023 REG,8,3,10,8,11,18,0,1,-5,5,1,1,1,0,0,0,0,0,0,0.5097020142727117,0.49029798572728833
90904,0.7142857142857143,0.3278688524590164,-250,205,0.6841753094680495,0.3158246905319505,home,TB,under,8,0.5121951219512195,-105,0.49029798572728833,TB,LAA,2023 REG,8,3,10,8,11,18,0,1,-5,5,1,1,1,0,0,0,0,0,0,0.5097020142727117,0.49029798572728833
90905,0.7340425531914894,0.3067484662576687,-276,226,0.7041002091277456,0.2958997908722544,away,SEA,over,9.5,0.49504950495049505,102,0.47297076509898783,TOR,SEA,2023 REG,3,1,6,0,1,9,1,0,1,-1,0,0,0,0,0,0,0,0,0,0.47297076509898783,0.5270292349010122
90905,0.7340425531914894,0.3067484662576687,-276,226,0.7041002091277456,0.2958997908722544,home,TOR,under,9.5,0.5495495495495495,-122,0.5270292349010122,TOR,SEA,2023 REG,3,1,6,0,1,9,1,0,1,-1,0,0,0,0,0,0,0,0,0,0.47297076509898783,0.5270292349010122
90906,0.5454545454545454,0.49751243781094534,-120,101,0.5220180091279142,0.4779819908720858,away,TB,over,7.5,0.5121951219512195,-105,0.48808156828023186,NYY,TB,2023 REG,13,7,6,2,9,19,1,0,5,-5,1,1,0,0,0,0,0,0,0,0.48808156828023186,0.5119184317197681
90906,0.5454545454545454,0.49751243781094534,-120,101,0.5220180091279142,0.4779819908720858,home,NYY,under,7.5,0.5348837209302326,-115,0.5119184317197681,NYY,TB,2023 REG,13,7,6,2,9,19,1,0,5,-5,1,1,0,0,0,0,0,0,0,0.48808156828023186,0.5119184317197681
90907,0.5348837209302326,0.5121951219512195,-115,-105,0.5097020142727117,0.49029798572728833,away,WSH,over,9.5,0.5,100,0.4772727272727273,KC,WSH,2023 REG,13,10,15,12,22,28,0,1,-2,2,1,1,1,1,1,1,1,1,1,0.4772727272727273,0.5227272727272727
90907,0.5348837209302326,0.5121951219512195,-115,-105,0.5097020142727117,0.49029798572728833,home,KC,under,9.5,0.5454545454545454,-120,0.5227272727272727,KC,WSH,2023 REG,13,10,15,12,22,28,0,1,-2,2,1,1,1,1,1,1,1,1,1,0.4772727272727273,0.5227272727272727
90908,0.3802281368821293,0.6551724137931035,163,-190,0.36676785145428414,0.6332321485457159,away,SD,over,11.5,0.5145631067961165,-106,0.4913668392989033,COL,SD,2023 REG,8,5,7,4,9,15,1,0,1,-1,1,1,1,1,0,0,0,0,0,0.4913668392989033,0.5086331607010968
90908,0.3802281368821293,0.6551724137931035,163,-190,0.36676785145428414,0.6332321485457159,home,COL,under,11.5,0.5305164319248826,-113,0.5086331607010968,COL,SD,2023 REG,8,5,7,4,9,15,1,0,1,-1,1,1,1,1,0,0,0,0,0,0.4913668392989033,0.5086331607010968
90909,0.45454545454545453,0.5798319327731092,120,-138,0.4389193694006528,0.5610806305993472,away,SF,over,8.5,0.5348837209302326,-115,0.5097020142727117,ARI,SF,2023 REG,4,2,3,1,3,7,1,0,1,-1,1,0,0,0,0,0,0,0,0,0.5097020142727117,0.49029798572728833
90909,0.45454545454545453,0.5798319327731092,120,-138,0.4389193694006528,0.5610806305993472,home,ARI,under,8.5,0.5121951219512195,-105,0.49029798572728833,ARI,SF,2023 REG,4,2,3,1,3,7,1,0,1,-1,1,0,0,0,0,0,0,0,0,0.5097020142727117,0.49029798572728833
90910,0.5726495726495727,0.4629629629629629,-134,116,0.5522560693500865,0.44774393064991347,away,PHI,over,7.5,0.5,100,0.4772727272727273,HOU,PHI,2023 REG,6,1,12,6,7,18,0,1,-5,5,1,0,0,0,0,0,0,0,0,0.4772727272727273,0.5227272727272727
90910,0.5726495726495727,0.4629629629629629,-134,116,0.5522560693500865,0.44774393064991347,home,HOU,under,7.5,0.5454545454545454,-120,0.5227272727272727,HOU,PHI,2023 REG,6,1,12,6,7,18,0,1,-5,5,1,0,0,0,0,0,0,0,0,0.4772727272727273,0.5227272727272727
90911,0.5391705069124424,0.5,-117,100,0.5180509248444435,0.4819490751555565,away,SEA,over,9,0.5348837209302326,-115,0.5097020142727117,BAL,SEA,2023 REG,11,6,8,4,10,19,1,0,2,-2,1,1,1,1,0,0,0,0,0,0.5097020142727117,0.49029798572728833
90911,0.5391705069124424,0.5,-117,100,0.5180509248444435,0.4819490751555565,home,BAL,under,9,0.5121951219512195,-105,0.49029798572728833,BAL,SEA,2023 REG,11,6,8,4,10,19,1,0,2,-2,1,1,1,1,0,0,0,0,0,0.5097020142727117,0.49029798572728833
90912,0.6108949416342413,0.425531914893617,-157,135,0.5886419592417365,0.41135804075826354,away,LAA,over,9.5,0.5145631067961165,-106,0.4925063625223866,NYY,LAA,2023 REG,4,2,8,5,7,12,0,1,-3,3,1,1,0,0,0,0,0,0,0,0.4925063625223866,0.5074936374776133
90912,0.6108949416342413,0.425531914893617,-157,135,0.5886419592417365,0.41135804075826354,home,NYY,under,9.5,0.5283018867924528,-112,0.5074936374776133,NYY,LAA,2023 REG,4,2,8,5,7,12,0,1,-3,3,1,1,0,0,0,0,0,0,0,0.4925063625223866,0.5074936374776133
90913,0.7267759562841529,0.3105590062111801,-266,222,0.6996418032137743,0.30035819678622566,away,ARI,over,7.5,0.5412844036697247,-118,0.5175913212324037,LAD,ARI,2023 REG,8,10,5,1,11,13,1,0,9,-9,1,0,0,0,0,0,0,0,0,0.5175913212324037,0.4824086787675963
90913,0.7267759562841529,0.3105590062111801,-266,222,0.6996418032137743,0.30035819678622566,home,LAD,under,7.5,0.5024875621890548,-101,0.4824086787675963,LAD,ARI,2023 REG,8,10,5,1,11,13,1,0,9,-9,1,0,0,0,0,0,0,0,0,0.5175913212324037,0.4824086787675963
90914,0.6336996336996338,0.4065040650406504,-173,146,0.6082225645345452,0.39177743546545485,away,NYM,over,9.5,0.5238095238095238,-110,0.4988662131519274,BAL,NYM,2023 REG,12,7,7,3,10,19,1,0,4,-4,1,1,1,0,0,0,0,0,0,0.4988662131519274,0.5011337868480725
90914,0.6336996336996338,0.4065040650406504,-173,146,0.6082225645345452,0.39177743546545485,home,BAL,under,9.5,0.5238095238095238,-110,0.5011337868480725,BAL,NYM,2023 REG,12,7,7,3,10,19,1,0,4,-4,1,1,1,0,0,0,0,0,0,0.4988662131519274,0.5011337868480725
90915,0.425531914893617,0.607843137254902,135,-155,0.4113297650431834,0.5886702349568166,away,LAD,over,9.5,0.5121951219512195,-105,0.48808156828023186,ARI,LAD,2023 REG,17,12,11,8,20,28,1,0,4,-4,1,1,1,1,1,1,1,1,0,0.48808156828023186,0.5119184317197681
90915,0.425531914893617,0.607843137254902,135,-155,0.4113297650431834,0.5886702349568166,home,ARI,under,9.5,0.5348837209302326,-115,0.5119184317197681,ARI,LAD,2023 REG,17,12,11,8,20,28,1,0,4,-4,1,1,1,1,1,1,1,1,0,0.48808156828023186,0.5119184317197681
90916,0.574468085106383,0.46511627906976744,-135,115,0.5517281312179562,0.44827186878204384,away,HOU,over,8.5,0.5121951219512195,-105,0.48808156828023186,SEA,HOU,2023 REG,11,3,6,1,4,17,1,0,2,-2,1,0,0,0,0,0,0,0,0,0.48808156828023186,0.5119184317197681
90916,0.574468085106383,0.46511627906976744,-135,115,0.5517281312179562,0.44827186878204384,home,SEA,under,8.5,0.5348837209302326,-115,0.5119184317197681,SEA,HOU,2023 REG,11,3,6,1,4,17,1,0,2,-2,1,0,0,0,0,0,0,0,0,0.48808156828023186,0.5119184317197681
90917,0.3278688524590164,0.7142857142857143,205,-250,0.3140476830345145,0.6859523169654855,away,HOU,over,9.5,0.5145631067961165,-106,0.4913668392989033,KC,HOU,2023 REG,7,1,8,7,8,15,0,1,-6,6,1,0,0,0,0,0,0,0,0,0.4913668392989033,0.5086331607010968
90917,0.3278688524590164,0.7142857142857143,205,-250,0.3140476830345145,0.6859523169654855,home,KC,under,9.5,0.5305164319248826,-113,0.5086331607010968,KC,HOU,2023 REG,7,1,8,7,8,15,0,1,-6,6,1,0,0,0,0,0,0,0,0,0.4913668392989033,0.5086331607010968
90918,0.5454545454545454,0.5,-120,100,0.5206611570247933,0.4793388429752067,away,TB,over,9,0.5454545454545454,-120,0.5206611570247933,BAL,TB,2023 REG,9,5,5,4,9,14,1,0,1,-1,1,1,1,1,0,0,0,0,0,0.5206611570247933,0.4793388429752067
90918,0.5454545454545454,0.5,-120,100,0.5206611570247933,0.4793388429752067,home,BAL,under,9,0.5,100,0.4793388429752067,BAL,TB,2023 REG,9,5,5,4,9,14,1,0,1,-1,1,1,1,1,0,0,0,0,0,0.5206611570247933,0.4793388429752067
90919,0.607843137254902,0.4347826086956522,-155,130,0.5819333701084867,0.41806662989151333,away,PIT,over,10.5,0.5412844036697247,-118,0.5123367705354521,CIN,PIT,2023 REG,6,4,7,2,6,13,1,0,2,-2,1,1,0,0,0,0,0,0,0,0.5123367705354521,0.4876632294645479
90919,0.607843137254902,0.4347826086956522,-155,130,0.5819333701084867,0.41806662989151333,home,CIN,under,10.5,0.5121951219512195,-105,0.4876632294645479,CIN,PIT,2023 REG,6,4,7,2,6,13,1,0,2,-2,1,1,0,0,0,0,0,0,0,0.5123367705354521,0.4876632294645479
90920,0.46511627906976744,0.574468085106383,115,-135,0.44670494689481377,0.5532950531051862,away,HOU,over,7.5,0.5412844036697247,-118,0.5189377998484975,CWS,HOU,2023 REG,7,3,9,4,7,16,0,1,-1,1,1,1,1,0,0,0,0,0,0,0.5189377998484975,0.4810622001515025
90920,0.46511627906976744,0.574468085106383,115,-135,0.44670494689481377,0.5532950531051862,home,CWS,under,7.5,0.5,100,0.4810622001515025,CWS,HOU,2023 REG,7,3,9,4,7,16,0,1,-1,1,1,1,1,0,0,0,0,0,0,0.5189377998484975,0.4810622001515025
90921,0.696969696969697,0.3448275862068966,-230,190,0.6678382571799499,0.33216174282005007,away,OAK,over,9,0.5121951219512195,-105,0.48808156828023186,STL,OAK,2023 REG,8,7,8,5,12,16,1,0,2,-2,1,1,1,1,1,0,0,0,0,0.48808156828023186,0.5119184317197681
90921,0.696969696969697,0.3448275862068966,-230,190,0.6678382571799499,0.33216174282005007,home,STL,under,9,0.5348837209302326,-115,0.5119184317197681,STL,OAK,2023 REG,8,7,8,5,12,16,1,0,2,-2,1,1,1,1,1,0,0,0,0,0.48808156828023186,0.5119184317197681
90922,0.7142857142857143,0.3333333333333333,-250,200,0.6802721088435374,0.3197278911564626,away,KC,over,9,0.5121951219512195,-105,0.48808156828023186,TOR,KC,2023 REG,9,5,9,4,9,18,1,0,1,-1,1,1,1,1,0,0,0,0,0,0.48808156828023186,0.5119184317197681
90922,0.7142857142857143,0.3333333333333333,-250,200,0.6802721088435374,0.3197278911564626,home,TOR,under,9,0.5348837209302326,-115,0.5119184317197681,TOR,KC,2023 REG,9,5,9,4,9,18,1,0,1,-1,1,1,1,1,0,0,0,0,0,0.48808156828023186,0.5119184317197681
90923,0.49504950495049505,0.5454545454545454,102,-120,0.47499799484898986,0.5250020051510101,away,ATL,over,8,0.5121951219512195,-105,0.48808156828023186,MIA,ATL,2023 REG,17,16,9,2,18,26,1,0,14,-14,1,1,0,0,0,0,0,0,0,0.48808156828023186,0.5119184317197681
90923,0.49504950495049505,0.5454545454545454,102,-120,0.47499799484898986,0.5250020051510101,home,MIA,under,8,0.5348837209302326,-115,0.5119184317197681,MIA,ATL,2023 REG,17,16,9,2,18,26,1,0,14,-14,1,1,0,0,0,0,0,0,0,0.48808156828023186,0.5119184317197681
90924,0.5850622406639003,0.45454545454545453,-141,120,0.5618892737571823,0.43811072624281766,away,OAK,over,10,0.5121951219512195,-105,0.48808156828023186,KC,OAK,2023 REG,10,8,17,12,20,27,0,1,-4,4,1,1,1,1,1,1,1,1,0,0.48808156828023186,0.5119184317197681
90924,0.5850622406639003,0.45454545454545453,-141,120,0.5618892737571823,0.43811072624281766,home,KC,under,10,0.5348837209302326,-115,0.5119184317197681,KC,OAK,2023 REG,10,8,17,12,20,27,0,1,-4,4,1,1,1,1,1,1,1,1,0,0.48808156828023186,0.5119184317197681
90925,0.46511627906976744,0.574468085106383,115,-135,0.44670494689481377,0.5532950531051862,away,TEX,over,9,0.5098039215686274,-104,0.48375889301574193,PIT,TEX,2023 REG,11,6,7,4,10,18,1,0,2,-2,1,1,1,1,0,0,0,0,0,0.48375889301574193,0.5162411069842581
90925,0.46511627906976744,0.574468085106383,115,-135,0.44670494689481377,0.5532950531051862,home,PIT,under,9,0.5412844036697247,-118,0.5162411069842581,PIT,TEX,2023 REG,11,6,7,4,10,18,1,0,2,-2,1,1,1,1,0,0,0,0,0,0.48375889301574193,0.5162411069842581
90926,0.48309178743961345,0.5555555555555556,107,-125,0.4644215734322854,0.5355784265677146,away,TOR,over,8,0.5121951219512195,-105,0.48808156828023186,CLE,TOR,2023 REG,3,1,9,0,1,12,1,0,1,-1,0,0,0,0,0,0,0,0,0,0.48808156828023186,0.5119184317197681
90926,0.48309178743961345,0.5555555555555556,107,-125,0.4644215734322854,0.5355784265677146,home,CLE,under,8,0.5348837209302326,-115,0.5119184317197681,CLE,TOR,2023 REG,3,1,9,0,1,12,1,0,1,-1,0,0,0,0,0,0,0,0,0,0.48808156828023186,0.5119184317197681
90927,0.48309178743961345,0.5594713656387665,107,-127,0.46252987773991294,0.5374701222600871,away,MIL,over,8,0.5121951219512195,-105,0.48808156828023186,SF,MIL,2023 REG,5,6,7,4,10,12,1,0,2,-2,1,1,1,1,0,0,0,0,0,0.48808156828023186,0.5119184317197681
90927,0.48309178743961345,0.5594713656387665,107,-127,0.46252987773991294,0.5374701222600871,home,SF,under,8,0.5348837209302326,-115,0.5119184317197681,SF,MIL,2023 REG,5,6,7,4,10,12,1,0,2,-2,1,1,1,1,0,0,0,0,0,0.48808156828023186,0.5119184317197681
90928,0.6402877697841727,0.4,-178,150,0.6144920035194866,0.38550799648051337,away,CWS,over,9.5,0.5370370370370371,-116,0.5118817074154765,ATL,CWS,2023 REG,5,1,14,8,9,19,0,1,-7,7,1,0,0,0,0,0,0,0,0,0.5118817074154765,0.48811829258452355
90928,0.6402877697841727,0.4,-178,150,0.6144920035194866,0.38550799648051337,home,ATL,under,9.5,0.5098039215686274,-104,0.48811829258452355,ATL,CWS,2023 REG,5,1,14,8,9,19,0,1,-7,7,1,0,0,0,0,0,0,0,0,0.5118817074154765,0.48811829258452355
90929,0.3921568627450981,0.6389891696750902,155,-177,0.37994273238423987,0.6200572676157601,away,ATL,over,10.5,0.5238095238095238,-110,0.5000596729920038,CLE,ATL,2023 REG,7,1,19,8,9,26,0,1,-7,7,1,0,0,0,0,0,0,0,0,0.5000596729920038,0.4999403270079962
90929,0.3921568627450981,0.6389891696750902,155,-177,0.37994273238423987,0.6200572676157601,home,CLE,under,10.5,0.5215311004784688,-109,0.4999403270079962,CLE,ATL,2023 REG,7,1,19,8,9,26,0,1,-7,7,1,0,0,0,0,0,0,0,0,0.5000596729920038,0.4999403270079962
90930,0.425531914893617,0.613899613899614,135,-159,0.40875254093905067,0.5912474590609493,away,HOU,over,12.5,0.5391705069124424,-117,0.5127649394825569,COL,HOU,2023 REG,2,1,8,4,5,10,0,1,-3,3,1,0,0,0,0,0,0,0,0,0.5127649394825569,0.48723506051744314
90930,0.425531914893617,0.613899613899614,135,-159,0.40875254093905067,0.5912474590609493,home,COL,under,12.5,0.5098039215686274,-104,0.48723506051744314,COL,HOU,2023 REG,2,1,8,4,5,10,0,1,-3,3,1,0,0,0,0,0,0,0,0,0.5127649394825569,0.48723506051744314
90931,0.4,0.6376811594202898,150,-176,0.384927536231884,0.615072463768116,away,SF,over,8.5,0.5348837209302326,-115,0.5097020142727117,OAK,SF,2023 REG,6,2,3,1,3,9,1,0,1,-1,1,0,0,0,0,0,0,0,0,0.5097020142727117,0.49029798572728833
90931,0.4,0.6376811594202898,150,-176,0.384927536231884,0.615072463768116,home,OAK,under,8.5,0.5121951219512195,-105,0.49029798572728833,OAK,SF,2023 REG,6,2,3,1,3,9,1,0,1,-1,1,0,0,0,0,0,0,0,0,0.5097020142727117,0.49029798572728833
90932,0.5708154506437768,0.46511627906976744,-133,115,0.5503050641549297,0.44969493584507025,away,TOR,over,10,0.5283018867924528,-112,0.5044173060022736,LAA,TOR,2023 REG,13,11,13,12,23,26,0,1,-1,1,1,1,1,1,1,1,1,1,1,0.5044173060022736,0.49558269399772636
90932,0.5708154506437768,0.46511627906976744,-133,115,0.5503050641549297,0.44969493584507025,home,LAA,under,10,0.5169082125603864,-107,0.49558269399772636,LAA,TOR,2023 REG,13,11,13,12,23,26,0,1,-1,1,1,1,1,1,1,1,1,1,1,0.5044173060022736,0.49558269399772636
90933,0.5238095238095238,0.5238095238095238,-110,-110,0.4988662131519274,0.5011337868480725,away,TB,over,8.5,0.5098039215686274,-104,0.48483656587239576,SF,TB,2023 REG,9,7,3,0,7,12,1,0,7,-7,0,0,0,0,0,0,0,0,0,0.48483656587239576,0.5151634341276042
90933,0.5238095238095238,0.5238095238095238,-110,-110,0.4988662131519274,0.5011337868480725,home,SF,under,8.5,0.5391705069124424,-117,0.5151634341276042,SF,TB,2023 REG,9,7,3,0,7,12,1,0,7,-7,0,0,0,0,0,0,0,0,0,0.48483656587239576,0.5151634341276042
90934,0.607843137254902,0.43859649122807015,-155,128,0.5796151277848601,0.42038487221513987,away,WSH,over,9,0.5348837209302326,-115,0.5097020142727117,ARI,WSH,2023 REG,9,8,16,9,17,25,0,1,-1,1,1,1,1,1,1,1,1,1,0,0.5097020142727117,0.49029798572728833
90934,0.607843137254902,0.43859649122807015,-155,128,0.5796151277848601,0.42038487221513987,home,ARI,under,9,0.5121951219512195,-105,0.49029798572728833,ARI,WSH,2023 REG,9,8,16,9,17,25,0,1,-1,1,1,1,1,1,1,1,1,1,0,0.5097020142727117,0.49029798572728833
90935,0.5,0.5454545454545454,100,-120,0.4772727272727273,0.5227272727272727,away,ATL,over,8.5,0.5121951219512195,-105,0.48808156828023186,PHI,ATL,2023 REG,12,6,10,7,13,22,0,1,-1,1,1,1,1,1,1,1,0,0,0,0.48808156828023186,0.5119184317197681
90935,0.5,0.5454545454545454,100,-120,0.4772727272727273,0.5227272727272727,home,PHI,under,8.5,0.5348837209302326,-115,0.5119184317197681,PHI,ATL,2023 REG,12,6,10,7,13,22,0,1,-1,1,1,1,1,1,1,1,0,0,0,0.48808156828023186,0.5119184317197681
90936,0.5215311004784688,0.5238095238095238,-109,-110,0.4978845547971712,0.5021154452028288,away,BAL,over,9,0.5454545454545454,-120,0.5206611570247933,CWS,BAL,2023 REG,13,7,11,6,13,24,1,0,1,-1,1,1,1,1,1,1,0,0,0,0.5206611570247933,0.4793388429752067
90936,0.5215311004784688,0.5238095238095238,-109,-110,0.4978845547971712,0.5021154452028288,home,CWS,under,9,0.5,100,0.4793388429752067,CWS,BAL,2023 REG,13,7,11,6,13,24,1,0,1,-1,1,1,1,1,1,1,0,0,0,0.5206611570247933,0.4793388429752067
90937,0.5726495726495727,0.46511627906976744,-134,115,0.5510229738017454,0.44897702619825464,away,NYM,over,8.5,0.5391705069124424,-117,0.5153817639191344,PIT,NYM,2023 REG,8,2,3,1,3,11,1,0,1,-1,1,0,0,0,0,0,0,0,0,0.5153817639191344,0.4846182360808656
90937,0.5726495726495727,0.46511627906976744,-134,115,0.5510229738017454,0.44897702619825464,home,PIT,under,8.5,0.504950495049505,-102,0.4846182360808656,PIT,NYM,2023 REG,8,2,3,1,3,11,1,0,1,-1,1,0,0,0,0,0,0,0,0,0.5153817639191344,0.4846182360808656
90938,0.48309178743961345,0.5555555555555556,107,-125,0.4644215734322854,0.5355784265677146,away,HOU,over,9,0.5238095238095238,-110,0.4988662131519274,MIA,HOU,2023 REG,8,5,8,6,11,16,0,1,-1,1,1,1,1,1,1,0,0,0,0,0.4988662131519274,0.5011337868480725
90938,0.48309178743961345,0.5555555555555556,107,-125,0.4644215734322854,0.5355784265677146,home,MIA,under,9,0.5238095238095238,-110,0.5011337868480725,MIA,HOU,2023 REG,8,5,8,6,11,16,0,1,-1,1,1,1,1,1,1,0,0,0,0,0.4988662131519274,0.5011337868480725
90939,0.6183206106870228,0.42372881355932196,-162,136,0.5923205850079852,0.40767941499201477,away,MIA,over,9,0.5238095238095238,-110,0.4988662131519274,LAD,MIA,2023 REG,6,3,5,1,4,11,1,0,2,-2,1,0,0,0,0,0,0,0,0,0.4988662131519274,0.5011337868480725
90939,0.6183206106870228,0.42372881355932196,-162,136,0.5923205850079852,0.40767941499201477,home,LAD,under,9,0.5238095238095238,-110,0.5011337868480725,LAD,MIA,2023 REG,6,3,5,1,4,11,1,0,2,-2,1,0,0,0,0,0,0,0,0,0.4988662131519274,0.5011337868480725
90940,0.6226415094339623,0.4166666666666667,-165,140,0.5981666073335706,0.40183339266642937,away,KC,over,7.5,0.49751243781094534,101,0.47511256217505476,MIA,KC,2023 REG,11,9,9,6,15,20,1,0,3,-3,1,1,1,1,1,1,0,0,0,0.47511256217505476,0.5248874378249453
90940,0.6226415094339623,0.4166666666666667,-165,140,0.5981666073335706,0.40183339266642937,home,MIA,under,7.5,0.5475113122171946,-121,0.5248874378249453,MIA,KC,2023 REG,11,9,9,6,15,20,1,0,3,-3,1,1,1,1,1,1,0,0,0,0.47511256217505476,0.5248874378249453
90941,0.6491228070175439,0.3846153846153846,-185,160,0.6272225773610816,0.37277742263891844,away,PHI,over,8.5,0.5454545454545454,-120,0.5193043049216726,NYM,PHI,2023 REG,4,4,6,2,6,10,1,0,2,-2,1,1,0,0,0,0,0,0,0,0.5193043049216726,0.48069569507832743
90941,0.6491228070175439,0.3846153846153846,-185,160,0.6272225773610816,0.37277742263891844,home,NYM,under,8.5,0.5024875621890548,-101,0.48069569507832743,NYM,PHI,2023 REG,4,4,6,2,6,10,1,0,2,-2,1,1,0,0,0,0,0,0,0,0.5193043049216726,0.48069569507832743
90942,0.4444444444444444,0.5967741935483871,125,-148,0.42612504978096366,0.5738749502190363,away,NYM,over,9,0.5454545454545454,-120,0.5233614270517961,WSH,NYM,2023 REG,10,3,11,2,5,21,1,0,1,-1,1,1,0,0,0,0,0,0,0,0.5233614270517961,0.4766385729482039
90942,0.4444444444444444,0.5967741935483871,125,-148,0.42612504978096366,0.5738749502190363,home,WSH,under,9,0.49504950495049505,102,0.4766385729482039,WSH,NYM,2023 REG,10,3,11,2,5,21,1,0,1,-1,1,1,0,0,0,0,0,0,0,0.5233614270517961,0.4766385729482039
90943,0.5412844036697247,0.5,-118,100,0.5189377998484975,0.4810622001515025,away,SD,over,10.5,0.5192307692307692,-108,0.49688292476754015,PHI,SD,2023 REG,12,9,5,4,13,17,1,0,5,-5,1,1,1,1,0,0,0,0,0,0.49688292476754015,0.5031170752324599
90943,0.5412844036697247,0.5,-118,100,0.5189377998484975,0.4810622001515025,home,PHI,under,10.5,0.5238095238095238,-110,0.5031170752324599,PHI,SD,2023 REG,12,9,5,4,13,17,1,0,5,-5,1,1,1,1,0,0,0,0,0,0.49688292476754015,0.5031170752324599
90944,0.6503496503496503,0.3846153846153846,-186,160,0.6276101520856765,0.3723898479143235,away,OAK,over,8,0.5412844036697247,-118,0.5189377998484975,CLE,OAK,2023 REG,13,7,9,6,13,22,1,0,1,-1,1,1,1,1,1,1,0,0,0,0.5189377998484975,0.4810622001515025
90944,0.6503496503496503,0.3846153846153846,-186,160,0.6276101520856765,0.3723898479143235,home,CLE,under,8,0.5,100,0.4810622001515025,CLE,OAK,2023 REG,13,7,9,6,13,22,1,0,1,-1,1,1,1,1,1,1,0,0,0,0.5189377998484975,0.4810622001515025
90945,0.5454545454545454,0.5,-120,100,0.5206611570247933,0.4793388429752067,away,ARI,over,8,0.5024875621890548,-101,0.48049269377245407,MIL,ARI,2023 REG,3,1,11,9,10,14,0,1,-8,8,1,0,0,0,0,0,0,0,0,0.48049269377245407,0.5195073062275459
90945,0.5454545454545454,0.5,-120,100,0.5206611570247933,0.4793388429752067,home,MIL,under,8,0.5412844036697247,-118,0.5195073062275459,MIL,ARI,2023 REG,3,1,11,9,10,14,0,1,-8,8,1,0,0,0,0,0,0,0,0,0.48049269377245407,0.5195073062275459
90946,0.6226415094339623,0.41493775933609955,-165,141,0.5992430968035465,0.4007569031964535,away,STL,over,7.5,0.5238095238095238,-110,0.4988662131519274,SEA,STL,2023 REG,7,5,9,4,9,16,1,0,1,-1,1,1,1,1,0,0,0,0,0,0.4988662131519274,0.5011337868480725
90946,0.6226415094339623,0.41493775933609955,-165,141,0.5992430968035465,0.4007569031964535,home,SEA,under,7.5,0.5238095238095238,-110,0.5011337868480725,SEA,STL,2023 REG,7,5,9,4,9,16,1,0,1,-1,1,1,1,1,0,0,0,0,0,0.4988662131519274,0.5011337868480725
90947,0.5348837209302326,0.5024875621890548,-115,-101,0.514894429959451,0.485105570040549,away,SD,over,8,0.5327102803738317,-114,0.508788710910954,CHC,SD,2023 REG,8,3,9,5,8,17,0,1,-2,2,1,1,1,0,0,0,0,0,0,0.508788710910954,0.491211289089046
90947,0.5348837209302326,0.5024875621890548,-115,-101,0.514894429959451,0.485105570040549,home,CHC,under,8,0.5121951219512195,-105,0.491211289089046,CHC,SD,2023 REG,8,3,9,5,8,17,0,1,-2,2,1,1,1,0,0,0,0,0,0,0.508788710910954,0.491211289089046
90948,0.5,0.5412844036697247,100,-118,0.47935779816513757,0.5206422018348624,away,TB,over,8,0.5121951219512195,-105,0.48808156828023186,BOS,TB,2023 REG,11,7,13,9,16,24,0,1,-2,2,1,1,1,1,1,1,1,0,0,0.48808156828023186,0.5119184317197681
90948,0.5,0.5412844036697247,100,-118,0.47935779816513757,0.5206422018348624,home,BOS,under,8,0.5348837209302326,-115,0.5119184317197681,BOS,TB,2023 REG,11,7,13,9,16,24,0,1,-2,2,1,1,1,1,1,1,1,0,0,0.48808156828023186,0.5119184317197681
90949,0.46511627906976744,0.574468085106383,115,-135,0.44670494689481377,0.5532950531051862,away,MIA,over,9,0.5348837209302326,-115,0.5097020142727117,BOS,MIA,2023 REG,8,2,7,6,8,15,0,1,-4,4,1,1,0,0,0,0,0,0,0,0.5097020142727117,0.49029798572728833
90949,0.46511627906976744,0.574468085106383,115,-135,0.44670494689481377,0.5532950531051862,home,BOS,under,9,0.5121951219512195,-105,0.49029798572728833,BOS,MIA,2023 REG,8,2,7,6,8,15,0,1,-4,4,1,1,0,0,0,0,0,0,0,0.5097020142727117,0.49029798572728833
90950,0.6575342465753424,0.3802281368821293,-192,163,0.6327041862197444,0.36729581378025555,away,SF,over,8,0.5348837209302326,-115,0.5097020142727117,HOU,SF,2023 REG,3,0,7,2,2,10,0,1,-2,2,0,0,0,0,0,0,0,0,0,0.5097020142727117,0.49029798572728833
90950,0.6575342465753424,0.3802281368821293,-192,163,0.6327041862197444,0.36729581378025555,home,HOU,under,8,0.5121951219512195,-105,0.49029798572728833,HOU,SF,2023 REG,3,0,7,2,2,10,0,1,-2,2,0,0,0,0,0,0,0,0,0,0.5097020142727117,0.49029798572728833
90951,0.4629629629629629,0.5726495726495727,116,-134,0.44647567795715937,0.5535243220428406,away,TOR,over,8,0.5098039215686274,-104,0.4870219861770517,STL,TOR,2023 REG,10,4,3,1,5,13,1,0,3,-3,1,0,0,0,0,0,0,0,0,0.4870219861770517,0.5129780138229483
90951,0.4629629629629629,0.5726495726495727,116,-134,0.44647567795715937,0.5535243220428406,home,STL,under,8,0.5348837209302326,-115,0.5129780138229483,STL,TOR,2023 REG,10,4,3,1,5,13,1,0,3,-3,1,0,0,0,0,0,0,0,0,0.4870219861770517,0.5129780138229483
90952,0.45454545454545453,0.5884773662551441,120,-143,0.43498962690881876,0.5650103730911813,away,ATL,over,9.5,0.5238095238095238,-110,0.4988662131519274,MIL,ATL,2023 REG,8,4,7,3,7,15,1,0,1,-1,1,1,1,0,0,0,0,0,0,0.4988662131519274,0.5011337868480725
90952,0.45454545454545453,0.5884773662551441,120,-143,0.43498962690881876,0.5650103730911813,home,MIL,under,9.5,0.5238095238095238,-110,0.5011337868480725,MIL,ATL,2023 REG,8,4,7,3,7,15,1,0,1,-1,1,1,1,0,0,0,0,0,0,0.4988662131519274,0.5011337868480725
90953,0.3508771929824561,0.6923076923076923,185,-225,0.3357246016525795,0.6642753983474206,away,SF,over,10.5,0.5348837209302326,-115,0.5097020142727117,COL,SF,2023 REG,6,3,2,2,5,8,1,0,1,-1,1,1,0,0,0,0,0,0,0,0.5097020142727117,0.49029798572728833
90953,0.3508771929824561,0.6923076923076923,185,-225,0.3357246016525795,0.6642753983474206,home,COL,under,10.5,0.5121951219512195,-105,0.49029798572728833,COL,SF,2023 REG,6,3,2,2,5,8,1,0,1,-1,1,1,0,0,0,0,0,0,0,0.5097020142727117,0.49029798572728833
90954,0.45454545454545453,0.5833333333333333,120,-140,0.43732782369146006,0.5626721763085399,away,LAD,over,9.5,0.5024875621890548,-101,0.47839724939301687,TEX,LAD,2023 REG,9,3,18,16,19,27,0,1,-13,13,1,1,1,0,0,0,0,0,0,0.47839724939301687,0.5216027506069831
90954,0.45454545454545453,0.5833333333333333,120,-140,0.43732782369146006,0.5626721763085399,home,TEX,under,9.5,0.5454545454545454,-120,0.5216027506069831,TEX,LAD,2023 REG,9,3,18,16,19,27,0,1,-13,13,1,1,1,0,0,0,0,0,0,0.47839724939301687,0.5216027506069831
90955,0.5412844036697247,0.5,-118,100,0.5189377998484975,0.4810622001515025,away,OAK,over,12,0.5348837209302326,-115,0.5097020142727117,COL,OAK,2023 REG,12,3,13,11,14,25,0,1,-8,8,1,1,1,0,0,0,0,0,0,0.5097020142727117,0.49029798572728833
90955,0.5412844036697247,0.5,-118,100,0.5189377998484975,0.4810622001515025,home,COL,under,12,0.5121951219512195,-105,0.49029798572728833,COL,OAK,2023 REG,12,3,13,11,14,25,0,1,-8,8,1,1,1,0,0,0,0,0,0,0.5097020142727117,0.49029798572728833
90956,0.4484304932735426,0.5850622406639003,123,-141,0.43341133007289556,0.5665886699271044,away,NYY,over,10.5,0.5121951219512195,-105,0.48808156828023186,CIN,NYY,2023 REG,5,4,13,7,11,18,0,1,-3,3,1,1,1,1,0,0,0,0,0,0.48808156828023186,0.5119184317197681
90956,0.4484304932735426,0.5850622406639003,123,-141,0.43341133007289556,0.5665886699271044,home,CIN,under,10.5,0.5348837209302326,-115,0.5119184317197681,CIN,NYY,2023 REG,5,4,13,7,11,18,0,1,-3,3,1,1,1,1,0,0,0,0,0,0.48808156828023186,0.5119184317197681
90957,0.5145631067961165,0.5238095238095238,-106,-110,0.4948179667757384,0.5051820332242616,away,TEX,over,8.5,0.5238095238095238,-110,0.4988662131519274,SF,TEX,2023 REG,3,1,6,2,3,9,0,1,-1,1,1,0,0,0,0,0,0,0,0,0.4988662131519274,0.5011337868480725
90957,0.5145631067961165,0.5238095238095238,-106,-110,0.4948179667757384,0.5051820332242616,home,SF,under,8.5,0.5238095238095238,-110,0.5011337868480725,SF,TEX,2023 REG,3,1,6,2,3,9,0,1,-1,1,1,0,0,0,0,0,0,0,0,0.4988662131519274,0.5011337868480725
90958,0.37735849056603776,0.6621621621621622,165,-196,0.36244503670633965,0.6375549632936603,away,SD,over,12.5,0.5121951219512195,-105,0.48808156828023186,COL,SD,2023 REG,5,1,14,11,12,19,0,1,-10,10,1,0,0,0,0,0,0,0,0,0.48808156828023186,0.5119184317197681
90958,0.37735849056603776,0.6621621621621622,165,-196,0.36244503670633965,0.6375549632936603,home,COL,under,12.5,0.5348837209302326,-115,0.5119184317197681,COL,SD,2023 REG,5,1,14,11,12,19,0,1,-10,10,1,0,0,0,0,0,0,0,0,0.48808156828023186,0.5119184317197681
90959,0.607843137254902,0.4347826086956522,-155,130,0.5819333701084867,0.41806662989151333,away,CIN,over,9,0.5433789954337899,-119,0.5198077604720502,LAA,CIN,2023 REG,6,3,7,4,7,13,0,1,-1,1,1,1,1,0,0,0,0,0,0,0.5198077604720502,0.48019223952794976
90959,0.607843137254902,0.4347826086956522,-155,130,0.5819333701084867,0.41806662989151333,home,LAA,under,9,0.5,100,0.48019223952794976,LAA,CIN,2023 REG,6,3,7,4,7,13,0,1,-1,1,1,1,1,0,0,0,0,0,0,0.5198077604720502,0.48019223952794976
90960,0.5594713656387665,0.47619047619047616,-127,110,0.5395195862893665,0.46048041371063353,away,BOS,over,9,0.49504950495049505,102,0.47297076509898783,NYY,BOS,2023 REG,6,3,7,1,4,13,1,0,2,-2,1,0,0,0,0,0,0,0,0,0.47297076509898783,0.5270292349010122
90960,0.5594713656387665,0.47619047619047616,-127,110,0.5395195862893665,0.46048041371063353,home,NYY,under,9,0.5495495495495495,-122,0.5270292349010122,NYY,BOS,2023 REG,6,3,7,1,4,13,1,0,2,-2,1,0,0,0,0,0,0,0,0,0.47297076509898783,0.5270292349010122
90961,0.390625,0.646643109540636,156,-183,0.3760671447106891,0.6239328552893109,away,CHC,over,8.5,0.5327102803738317,-114,0.508788710910954,WSH,CHC,2023 REG,6,4,6,3,7,12,1,0,1,-1,1,1,1,0,0,0,0,0,0,0.508788710910954,0.491211289089046
90961,0.390625,0.646643109540636,156,-183,0.3760671447106891,0.6239328552893109,home,WSH,under,8.5,0.5121951219512195,-105,0.491211289089046,WSH,CHC,2023 REG,6,4,6,3,7,12,1,0,1,-1,1,1,1,0,0,0,0,0,0,0.508788710910954,0.491211289089046
90962,0.7032640949554896,0.3367003367003367,-237,197,0.6751585450966444,0.3248414549033556,away,MIA,over,8,0.5283018867924528,-112,0.5044173060022736,CLE,MIA,2023 REG,4,1,7,6,7,11,0,1,-5,5,1,0,0,0,0,0,0,0,0,0.5044173060022736,0.49558269399772636
90962,0.7032640949554896,0.3367003367003367,-237,197,0.6751585450966444,0.3248414549033556,home,CLE,under,8,0.5169082125603864,-107,0.49558269399772636,CLE,MIA,2023 REG,4,1,7,6,7,11,0,1,-5,5,1,0,0,0,0,0,0,0,0,0.5044173060022736,0.49558269399772636
90963,0.5348837209302326,0.5073891625615764,-115,-103,0.5122726437136835,0.48772735628631647,away,MIN,over,8.5,0.5238095238095238,-110,0.4988662131519274,BAL,MIN,2023 REG,4,1,13,8,9,17,0,1,-7,7,1,0,0,0,0,0,0,0,0,0.4988662131519274,0.5011337868480725
90963,0.5348837209302326,0.5073891625615764,-115,-103,0.5122726437136835,0.48772735628631647,home,BAL,under,8.5,0.5238095238095238,-110,0.5011337868480725,BAL,MIN,2023 REG,4,1,13,8,9,17,0,1,-7,7,1,0,0,0,0,0,0,0,0,0.4988662131519274,0.5011337868480725
90964,0.6666666666666666,0.3717472118959108,-200,169,0.641057414291615,0.358942585708385,away,DET,over,7.5,0.5024875621890548,-101,0.48049269377245407,CLE,DET,2023 REG,7,2,9,0,2,16,1,0,2,-2,0,0,0,0,0,0,0,0,0,0.48049269377245407,0.5195073062275459
90964,0.6666666666666666,0.3717472118959108,-200,169,0.641057414291615,0.358942585708385,home,CLE,under,7.5,0.5412844036697247,-118,0.5195073062275459,CLE,DET,2023 REG,7,2,9,0,2,16,1,0,2,-2,0,0,0,0,0,0,0,0,0,0.48049269377245407,0.5195073062275459
90965,0.425531914893617,0.613899613899614,135,-159,0.40875254093905067,0.5912474590609493,away,SD,over,8.5,0.5327102803738317,-114,0.508788710910954,SEA,SD,2023 REG,10,6,4,1,7,14,1,0,5,-5,1,0,0,0,0,0,0,0,0,0.508788710910954,0.491211289089046
90965,0.425531914893617,0.613899613899614,135,-159,0.40875254093905067,0.5912474590609493,home,SEA,under,8.5,0.5121951219512195,-105,0.491211289089046,SEA,SD,2023 REG,10,6,4,1,7,14,1,0,5,-5,1,0,0,0,0,0,0,0,0,0.508788710910954,0.491211289089046
90966,0.4347826086956522,0.607843137254902,130,-155,0.41624967567367205,0.583750324326328,away,ATL,over,7.5,0.5,100,0.47522522522522526,SF,ATL,2023 REG,6,1,7,5,6,13,0,1,-4,4,1,0,0,0,0,0,0,0,0,0.47522522522522526,0.5247747747747747
90966,0.4347826086956522,0.607843137254902,130,-155,0.41624967567367205,0.583750324326328,home,SF,under,7.5,0.5495495495495495,-122,0.5247747747747747,SF,ATL,2023 REG,6,1,7,5,6,13,0,1,-4,4,1,0,0,0,0,0,0,0,0,0.47522522522522526,0.5247747747747747
90967,0.5967741935483871,0.4444444444444444,-148,125,0.5721759741010521,0.42782402589894786,away,SEA,over,9,0.5,100,0.47935779816513757,TEX,SEA,2023 REG,19,16,11,6,22,30,1,0,10,-10,1,1,1,1,1,1,0,0,0,0.47935779816513757,0.5206422018348624
90967,0.5967741935483871,0.4444444444444444,-148,125,0.5721759741010521,0.42782402589894786,home,TEX,under,9,0.5412844036697247,-118,0.5206422018348624,TEX,SEA,2023 REG,19,16,11,6,22,30,1,0,10,-10,1,1,1,1,1,1,0,0,0,0.47935779816513757,0.5206422018348624
90968,0.5555555555555556,0.48780487804878053,-125,105,0.5314664257753688,0.46853357422463116,away,STL,over,10,0.5238095238095238,-110,0.4988662131519274,CIN,STL,2023 REG,10,4,9,9,13,19,0,1,-5,5,1,1,1,1,0,0,0,0,0,0.4988662131519274,0.5011337868480725
90968,0.5555555555555556,0.48780487804878053,-125,105,0.5314664257753688,0.46853357422463116,home,CIN,under,10,0.5238095238095238,-110,0.5011337868480725,CIN,STL,2023 REG,10,4,9,9,13,19,0,1,-5,5,1,1,1,1,0,0,0,0,0,0.4988662131519274,0.5011337868480725
90969,0.7297297297297298,0.3125,-270,220,0.6989134404674946,0.3010865595325054,away,PIT,over,10,0.5238095238095238,-110,0.4988662131519274,ATL,PIT,2023 REG,7,5,7,2,7,14,1,0,3,-3,1,1,0,0,0,0,0,0,0,0.4988662131519274,0.5011337868480725
90969,0.7297297297297298,0.3125,-270,220,0.6989134404674946,0.3010865595325054,home,ATL,under,10,0.5238095238095238,-110,0.5011337868480725,ATL,PIT,2023 REG,7,5,7,2,7,14,1,0,3,-3,1,1,0,0,0,0,0,0,0,0.4988662131519274,0.5011337868480725
90970,0.47619047619047616,0.5652173913043479,110,-130,0.4564724440500838,0.5435275559499162,away,HOU,over,9,0.5238095238095238,-110,0.4988662131519274,ARI,HOU,2023 REG,5,0,6,1,1,11,0,1,-1,1,0,0,0,0,0,0,0,0,0,0.4988662131519274,0.5011337868480725
90970,0.47619047619047616,0.5652173913043479,110,-130,0.4564724440500838,0.5435275559499162,home,ARI,under,9,0.5238095238095238,-110,0.5011337868480725,ARI,HOU,2023 REG,5,0,6,1,1,11,0,1,-1,1,0,0,0,0,0,0,0,0,0,0.4988662131519274,0.5011337868480725
90971,0.5652173913043479,0.47619047619047616,-130,110,0.5418129444594474,0.4581870555405526,away,HOU,over,7.5,0.5215311004784688,-109,0.4978845547971712,MIN,HOU,2023 REG,11,3,5,2,5,16,1,0,1,-1,1,1,0,0,0,0,0,0,0,0.4978845547971712,0.5021154452028288
90971,0.5652173913043479,0.47619047619047616,-130,110,0.5418129444594474,0.4581870555405526,home,MIN,under,7.5,0.5238095238095238,-110,0.5021154452028288,MIN,HOU,2023 REG,11,3,5,2,5,16,1,0,1,-1,1,1,0,0,0,0,0,0,0,0.4978845547971712,0.5021154452028288
90972,0.47619047619047616,0.5652173913043479,110,-130,0.4564724440500838,0.5435275559499162,away,HOU,over,10,0.5238095238095238,-110,0.4988662131519274,BOS,HOU,2023 REG,7,4,12,7,11,19,0,1,-3,3,1,1,1,1,0,0,0,0,0,0.4988662131519274,0.5011337868480725
90972,0.47619047619047616,0.5652173913043479,110,-130,0.4564724440500838,0.5435275559499162,home,BOS,under,10,0.5238095238095238,-110,0.5011337868480725,BOS,HOU,2023 REG,7,4,12,7,11,19,0,1,-3,3,1,1,1,1,0,0,0,0,0,0.4988662131519274,0.5011337868480725
90973,0.5283018867924528,0.5098039215686274,-112,-104,0.5081705163375425,0.4918294836624575,away,NYM,over,8.5,0.5454545454545454,-120,0.5233614270517961,MIL,NYM,2023 REG,10,10,3,0,10,13,1,0,10,-10,0,0,0,0,0,0,0,0,0,0.5233614270517961,0.4766385729482039
90973,0.5283018867924528,0.5098039215686274,-112,-104,0.5081705163375425,0.4918294836624575,home,MIL,under,8.5,0.49504950495049505,102,0.4766385729482039,MIL,NYM,2023 REG,10,10,3,0,10,13,1,0,10,-10,0,0,0,0,0,0,0,0,0,0.5233614270517961,0.4766385729482039
90974,0.5454545454545454,0.5,-120,100,0.5206611570247933,0.4793388429752067,away,LAD,over,9.5,0.5,100,0.4772727272727273,ATL,LAD,2023 REG,5,4,12,3,7,17,1,0,1,-1,1,1,1,0,0,0,0,0,0,0.4772727272727273,0.5227272727272727
90974,0.5454545454545454,0.5,-120,100,0.5206611570247933,0.4793388429752067,home,ATL,under,9.5,0.5454545454545454,-120,0.5227272727272727,ATL,LAD,2023 REG,5,4,12,3,7,17,1,0,1,-1,1,1,1,0,0,0,0,0,0,0.4772727272727273,0.5227272727272727
90975,0.4444444444444444,0.5918367346938775,125,-145,0.42831947593852354,0.5716805240614764,away,MIN,over,8,0.5121951219512195,-105,0.48808156828023186,LAA,MIN,2023 REG,10,5,6,4,9,16,1,0,1,-1,1,1,1,1,0,0,0,0,0,0.48808156828023186,0.5119184317197681
90975,0.4444444444444444,0.5918367346938775,125,-145,0.42831947593852354,0.5716805240614764,home,LAA,under,8,0.5348837209302326,-115,0.5119184317197681,LAA,MIN,2023 REG,10,5,6,4,9,16,1,0,1,-1,1,1,1,1,0,0,0,0,0,0.48808156828023186,0.5119184317197681
90976,0.49019607843137253,0.5412844036697247,104,-118,0.47476446955828566,0.5252355304417143,away,BAL,over,9,0.5145631067961165,-106,0.4913668392989033,CWS,BAL,2023 REG,6,3,7,6,9,13,0,1,-3,3,1,1,1,0,0,0,0,0,0,0.4913668392989033,0.5086331607010968
90976,0.49019607843137253,0.5412844036697247,104,-118,0.47476446955828566,0.5252355304417143,home,CWS,under,9,0.5305164319248826,-113,0.5086331607010968,CWS,BAL,2023 REG,6,3,7,6,9,13,0,1,-3,3,1,1,1,0,0,0,0,0,0,0.4913668392989033,0.5086331607010968
90977,0.7032640949554896,0.3333333333333333,-237,200,0.6775264376722522,0.3224735623277478,away,COL,over,8,0.5305164319248826,-113,0.5066009958897986,SEA,COL,2023 REG,8,9,6,2,11,14,1,0,7,-7,1,1,0,0,0,0,0,0,0,0.5066009958897986,0.49339900411020143
90977,0.7032640949554896,0.3333333333333333,-237,200,0.6775264376722522,0.3224735623277478,home,SEA,under,8,0.5145631067961165,-106,0.49339900411020143,SEA,COL,2023 REG,8,9,6,2,11,14,1,0,7,-7,1,1,0,0,0,0,0,0,0,0.5066009958897986,0.49339900411020143
90978,0.6688741721854304,0.37037037037037035,-202,170,0.6426245112706233,0.35737548872937674,away,COL,over,9.5,0.5073891625615764,-103,0.4826927225525911,STL,COL,2023 REG,8,0,5,1,1,13,0,1,-1,1,0,0,0,0,0,0,0,0,0,0.4826927225525911,0.5173072774474089
90978,0.6688741721854304,0.37037037037037035,-202,170,0.6426245112706233,0.35737548872937674,home,STL,under,9.5,0.5412844036697247,-118,0.5173072774474089,STL,COL,2023 REG,8,0,5,1,1,13,0,1,-1,1,0,0,0,0,0,0,0,0,0,0.4826927225525911,0.5173072774474089
90979,0.4504504504504505,0.5850622406639003,122,-141,0.43445374274128346,0.5655462572587165,away,TB,over,8,0.5454545454545454,-120,0.5206611570247933,BOS,TB,2023 REG,6,1,8,4,5,14,0,1,-3,3,1,0,0,0,0,0,0,0,0,0.5206611570247933,0.4793388429752067
90979,0.4504504504504505,0.5850622406639003,122,-141,0.43445374274128346,0.5655462572587165,home,BOS,under,8,0.5,100,0.4793388429752067,BOS,TB,2023 REG,6,1,8,4,5,14,0,1,-3,3,1,0,0,0,0,0,0,0,0,0.5206611570247933,0.4793388429752067
90980,0.4444444444444444,0.5918367346938775,125,-145,0.42831947593852354,0.5716805240614764,away,ATL,over,9.5,0.5305164319248826,-113,0.5066009958897986,DET,ATL,2023 REG,6,5,10,6,11,16,0,1,-1,1,1,1,1,1,1,0,0,0,0,0.5066009958897986,0.49339900411020143
90980,0.4444444444444444,0.5918367346938775,125,-145,0.42831947593852354,0.5716805240614764,home,DET,under,9.5,0.5145631067961165,-106,0.49339900411020143,DET,ATL,2023 REG,6,5,10,6,11,16,0,1,-1,1,1,1,1,1,1,0,0,0,0,0.5066009958897986,0.49339900411020143
90981,0.5780590717299579,0.4629629629629629,-137,116,0.5543459124348938,0.44565408756510616,away,LAA,over,9,0.5475113122171946,-121,0.5214983313199976,MIL,LAA,2023 REG,8,2,9,1,3,17,1,0,1,-1,1,0,0,0,0,0,0,0,0,0.5214983313199976,0.47850166868000243
90981,0.5780590717299579,0.4629629629629629,-137,116,0.5543459124348938,0.44565408756510616,home,MIL,under,9,0.5,100,0.47850166868000243,MIL,LAA,2023 REG,8,2,9,1,3,17,1,0,1,-1,1,0,0,0,0,0,0,0,0,0.5214983313199976,0.47850166868000243
90982,0.6000000000000001,0.4444444444444444,-150,125,0.5733333333333334,0.42666666666666664,away,SF,over,11,0.5238095238095238,-110,0.4988662131519274,CHC,SF,2023 REG,11,8,10,2,10,21,1,0,6,-6,1,1,0,0,0,0,0,0,0,0.4988662131519274,0.5011337868480725
90982,0.6000000000000001,0.4444444444444444,-150,125,0.5733333333333334,0.42666666666666664,home,CHC,under,11,0.5238095238095238,-110,0.5011337868480725,CHC,SF,2023 REG,11,8,10,2,10,21,1,0,6,-6,1,1,0,0,0,0,0,0,0,0.4988662131519274,0.5011337868480725
90983,0.5073891625615764,0.5348837209302326,-103,-115,0.4859403596076043,0.5140596403923957,away,LAA,over,9,0.5238095238095238,-110,0.4988662131519274,NYM,LAA,2023 REG,7,3,9,5,8,16,0,1,-2,2,1,1,1,0,0,0,0,0,0,0.4988662131519274,0.5011337868480725
90983,0.5073891625615764,0.5348837209302326,-103,-115,0.4859403596076043,0.5140596403923957,home,NYM,under,9,0.5238095238095238,-110,0.5011337868480725,NYM,LAA,2023 REG,7,3,9,5,8,16,0,1,-2,2,1,1,1,0,0,0,0,0,0,0.4988662131519274,0.5011337868480725
90984,0.6774193548387096,0.36363636363636365,-210,175,0.6496074165168858,0.3503925834831142,away,NYY,over,9.5,0.5348837209302326,-115,0.5097020142727117,ATL,NYY,2023 REG,3,2,4,0,2,7,1,0,2,-2,0,0,0,0,0,0,0,0,0,0.5097020142727117,0.49029798572728833
90984,0.6774193548387096,0.36363636363636365,-210,175,0.6496074165168858,0.3503925834831142,home,ATL,under,9.5,0.5121951219512195,-105,0.49029798572728833,ATL,NYY,2023 REG,3,2,4,0,2,7,1,0,2,-2,0,0,0,0,0,0,0,0,0,0.5097020142727117,0.49029798572728833
90985,0.5652173913043479,0.47619047619047616,-130,110,0.5418129444594474,0.4581870555405526,away,BAL,over,9.5,0.5,100,0.4772727272727273,PHI,BAL,2023 REG,8,4,8,3,7,16,1,0,1,-1,1,1,1,0,0,0,0,0,0,0.4772727272727273,0.5227272727272727
90985,0.5652173913043479,0.47619047619047616,-130,110,0.5418129444594474,0.4581870555405526,home,PHI,under,9.5,0.5454545454545454,-120,0.5227272727272727,PHI,BAL,2023 REG,8,4,8,3,7,16,1,0,1,-1,1,1,1,0,0,0,0,0,0,0.4772727272727273,0.5227272727272727
90986,0.47619047619047616,0.5652173913043479,110,-130,0.4564724440500838,0.5435275559499162,away,CLE,over,9.5,0.5,100,0.4772727272727273,CWS,CLE,2023 REG,12,7,9,2,9,21,1,0,5,-5,1,1,0,0,0,0,0,0,0,0.4772727272727273,0.5227272727272727
90986,0.47619047619047616,0.5652173913043479,110,-130,0.4564724440500838,0.5435275559499162,home,CWS,under,9.5,0.5454545454545454,-120,0.5227272727272727,CWS,CLE,2023 REG,12,7,9,2,9,21,1,0,5,-5,1,1,0,0,0,0,0,0,0,0.4772727272727273,0.5227272727272727
90987,0.5098039215686274,0.5348837209302326,-104,-115,0.4870219861770517,0.5129780138229483,away,TOR,over,8.5,0.5348837209302326,-115,0.5097020142727117,MIN,TOR,2023 REG,5,0,7,3,3,12,0,1,-3,3,0,0,0,0,0,0,0,0,0,0.5097020142727117,0.49029798572728833
90987,0.5098039215686274,0.5348837209302326,-104,-115,0.4870219861770517,0.5129780138229483,home,MIN,under,8.5,0.5121951219512195,-105,0.49029798572728833,MIN,TOR,2023 REG,5,0,7,3,3,12,0,1,-3,3,0,0,0,0,0,0,0,0,0,0.5097020142727117,0.49029798572728833
90988,0.4807692307692307,0.5594713656387665,108,-127,0.46142279018846283,0.5385772098115371,away,MIN,over,8.5,0.5454545454545454,-120,0.5206611570247933,STL,MIN,2023 REG,10,7,4,3,10,14,1,0,4,-4,1,1,1,0,0,0,0,0,0,0.5206611570247933,0.4793388429752067
90988,0.4807692307692307,0.5594713656387665,108,-127,0.46142279018846283,0.5385772098115371,home,STL,under,8.5,0.5,100,0.4793388429752067,STL,MIN,2023 REG,10,7,4,3,10,14,1,0,4,-4,1,1,1,0,0,0,0,0,0,0.5206611570247933,0.4793388429752067
90989,0.45454545454545453,0.5850622406639003,120,-141,0.4365419567230205,0.5634580432769796,away,CHC,over,8.5,0.5348837209302326,-115,0.5084354177277668,WSH,CHC,2023 REG,9,4,8,1,5,17,1,0,3,-3,1,0,0,0,0,0,0,0,0,0.5084354177277668,0.4915645822722332
90989,0.45454545454545453,0.5850622406639003,120,-141,0.4365419567230205,0.5634580432769796,home,WSH,under,8.5,0.5145631067961165,-106,0.4915645822722332,WSH,CHC,2023 REG,9,4,8,1,5,17,1,0,3,-3,1,0,0,0,0,0,0,0,0,0.5084354177277668,0.4915645822722332
90990,0.7435897435897436,0.29850746268656714,-290,235,0.7122866927688971,0.2877133072311029,away,OAK,over,9,0.504950495049505,-102,0.4826715732667395,HOU,OAK,2023 REG,3,0,7,4,4,10,0,1,-4,4,0,0,0,0,0,0,0,0,0,0.4826715732667395,0.5173284267332605
90990,0.7435897435897436,0.29850746268656714,-290,235,0.7122866927688971,0.2877133072311029,home,HOU,under,9,0.5391705069124424,-117,0.5173284267332605,HOU,OAK,2023 REG,3,0,7,4,4,10,0,1,-4,4,0,0,0,0,0,0,0,0,0,0.4826715732667395,0.5173284267332605
90991,0.5238095238095238,0.5145631067961165,-110,-106,0.5037095744446646,0.4962904255553354,away,TEX,over,8.5,0.5145631067961165,-106,0.4913668392989033,LAA,TEX,2023 REG,6,1,15,10,11,21,0,1,-9,9,1,0,0,0,0,0,0,0,0,0.4913668392989033,0.5086331607010968
90991,0.5238095238095238,0.5145631067961165,-110,-106,0.5037095744446646,0.4962904255553354,home,LAA,under,8.5,0.5305164319248826,-113,0.5086331607010968,LAA,TEX,2023 REG,6,1,15,10,11,21,0,1,-9,9,1,0,0,0,0,0,0,0,0,0.4913668392989033,0.5086331607010968
90992,0.6515679442508712,0.3891050583657587,-187,157,0.6250667195494433,0.37493328045055674,away,COL,over,8.5,0.5391705069124424,-117,0.5153817639191344,SEA,COL,2023 REG,7,5,7,3,8,14,1,0,2,-2,1,1,1,0,0,0,0,0,0,0.5153817639191344,0.4846182360808656
90992,0.6515679442508712,0.3891050583657587,-187,157,0.6250667195494433,0.37493328045055674,home,SEA,under,8.5,0.504950495049505,-102,0.4846182360808656,SEA,COL,2023 REG,7,5,7,3,8,14,1,0,2,-2,1,1,1,0,0,0,0,0,0,0.5153817639191344,0.4846182360808656
90993,0.5652173913043479,0.47619047619047616,-130,110,0.5418129444594474,0.4581870555405526,away,LAD,over,9.5,0.5073891625615764,-103,0.4837652908580103,TEX,LAD,2023 REG,4,5,13,11,16,17,0,1,-6,6,1,1,1,1,1,0,0,0,0,0.4837652908580103,0.5162347091419897
90993,0.5652173913043479,0.47619047619047616,-130,110,0.5418129444594474,0.4581870555405526,home,TEX,under,9.5,0.5391705069124424,-117,0.5162347091419897,TEX,LAD,2023 REG,4,5,13,11,16,17,0,1,-6,6,1,1,1,1,1,0,0,0,0,0.4837652908580103,0.5162347091419897
90994,0.6551724137931035,0.3846153846153846,-190,160,0.6291045458703008,0.37089545412969915,away,WSH,over,9.5,0.5238095238095238,-110,0.5000596729920038,ATL,WSH,2023 REG,6,6,9,4,10,15,1,0,2,-2,1,1,1,1,0,0,0,0,0,0.5000596729920038,0.4999403270079962
90994,0.6551724137931035,0.3846153846153846,-190,160,0.6291045458703008,0.37089545412969915,home,ATL,under,9.5,0.5215311004784688,-109,0.4999403270079962,ATL,WSH,2023 REG,6,6,9,4,10,15,1,0,2,-2,1,1,1,1,0,0,0,0,0,0.5000596729920038,0.4999403270079962
90995,0.4854368932038835,0.5535714285714286,106,-124,0.4665008146721786,0.5334991853278215,away,HOU,over,8.5,0.5305164319248826,-113,0.5066009958897986,SEA,HOU,2023 REG,12,7,9,5,12,21,1,0,2,-2,1,1,1,1,1,0,0,0,0,0.5066009958897986,0.49339900411020143
90995,0.4854368932038835,0.5535714285714286,106,-124,0.4665008146721786,0.5334991853278215,home,SEA,under,8.5,0.5145631067961165,-106,0.49339900411020143,SEA,HOU,2023 REG,12,7,9,5,12,21,1,0,2,-2,1,1,1,1,1,0,0,0,0,0.5066009958897986,0.49339900411020143
90996,0.574468085106383,0.46511627906976744,-135,115,0.5517281312179562,0.44827186878204384,away,BAL,over,9.5,0.5,100,0.4772727272727273,TOR,BAL,2023 REG,11,5,11,6,11,22,0,1,-1,1,1,1,1,1,1,0,0,0,0,0.4772727272727273,0.5227272727272727
90996,0.574468085106383,0.46511627906976744,-135,115,0.5517281312179562,0.44827186878204384,home,TOR,under,9.5,0.5454545454545454,-120,0.5227272727272727,TOR,BAL,2023 REG,11,5,11,6,11,22,0,1,-1,1,1,1,1,1,1,0,0,0,0,0.4772727272727273,0.5227272727272727
90997,0.46511627906976744,0.574468085106383,115,-135,0.44670494689481377,0.5532950531051862,away,MIA,over,9,0.5121951219512195,-105,0.48808156828023186,PIT,MIA,2023 REG,12,3,14,7,10,26,0,1,-4,4,1,1,1,0,0,0,0,0,0,0.48808156828023186,0.5119184317197681
90997,0.46511627906976744,0.574468085106383,115,-135,0.44670494689481377,0.5532950531051862,home,PIT,under,9,0.5348837209302326,-115,0.5119184317197681,PIT,MIA,2023 REG,12,3,14,7,10,26,0,1,-4,4,1,1,1,0,0,0,0,0,0,0.48808156828023186,0.5119184317197681
90998,0.5633187772925764,0.47619047619047616,-129,110,0.5410624729287608,0.45893752707123925,away,STL,over,8,0.5238095238095238,-110,0.4988662131519274,SEA,STL,2023 REG,6,5,3,2,7,9,1,0,3,-3,1,1,0,0,0,0,0,0,0,0.4988662131519274,0.5011337868480725
90998,0.5633187772925764,0.47619047619047616,-129,110,0.5410624729287608,0.45893752707123925,home,SEA,under,8,0.5238095238095238,-110,0.5011337868480725,SEA,STL,2023 REG,6,5,3,2,7,9,1,0,3,-3,1,1,0,0,0,0,0,0,0,0.4988662131519274,0.5011337868480725
90999,0.6666666666666666,0.373134328358209,-200,168,0.6401326699834162,0.3598673300165838,away,NYM,over,10,0.5348837209302326,-115,0.5097020142727117,ATL,NYM,2023 REG,12,7,3,0,7,15,1,0,7,-7,0,0,0,0,0,0,0,0,0,0.5097020142727117,0.49029798572728833
90999,0.6666666666666666,0.373134328358209,-200,168,0.6401326699834162,0.3598673300165838,home,ATL,under,10,0.5121951219512195,-105,0.49029798572728833,ATL,NYM,2023 REG,12,7,3,0,7,15,1,0,7,-7,0,0,0,0,0,0,0,0,0,0.5097020142727117,0.49029798572728833
91000,0.5867768595041323,0.45454545454545453,-142,120,0.5625298818386723,0.43747011816132775,away,SF,over,8.5,0.5215311004784688,-109,0.4978845547971712,LAA,SF,2023 REG,4,4,5,1,5,9,1,0,3,-3,1,0,0,0,0,0,0,0,0,0.4978845547971712,0.5021154452028288
91000,0.5867768595041323,0.45454545454545453,-142,120,0.5625298818386723,0.43747011816132775,home,LAA,under,8.5,0.5238095238095238,-110,0.5021154452028288,LAA,SF,2023 REG,4,4,5,1,5,9,1,0,3,-3,1,0,0,0,0,0,0,0,0,0.4978845547971712,0.5021154452028288
91001,0.6666666666666666,0.37037037037037035,-200,170,0.6419753086419753,0.3580246913580247,away,DET,over,10,0.5348837209302326,-115,0.5097020142727117,BOS,DET,2023 REG,8,2,12,6,8,20,0,1,-4,4,1,1,0,0,0,0,0,0,0,0.5097020142727117,0.49029798572728833
91001,0.6666666666666666,0.37037037037037035,-200,170,0.6419753086419753,0.3580246913580247,home,BOS,under,10,0.5121951219512195,-105,0.49029798572728833,BOS,DET,2023 REG,8,2,12,6,8,20,0,1,-4,4,1,1,0,0,0,0,0,0,0,0.5097020142727117,0.49029798572728833
91002,0.5348837209302326,0.5073891625615764,-115,-103,0.5122726437136835,0.48772735628631647,away,BOS,over,9.5,0.5348837209302326,-115,0.5097020142727117,LAA,BOS,2023 REG,5,2,4,1,3,9,1,0,1,-1,1,0,0,0,0,0,0,0,0,0.5097020142727117,0.49029798572728833
91002,0.5348837209302326,0.5073891625615764,-115,-103,0.5122726437136835,0.48772735628631647,home,LAA,under,9.5,0.5121951219512195,-105,0.49029798572728833,LAA,BOS,2023 REG,5,2,4,1,3,9,1,0,1,-1,1,0,0,0,0,0,0,0,0,0.5097020142727117,0.49029798572728833
91003,0.4065040650406504,0.6296296296296295,146,-170,0.3918155712722439,0.608184428727756,away,ATL,over,9,0.5412844036697247,-118,0.5189377998484975,TEX,ATL,2023 REG,10,0,12,12,12,22,0,1,-12,12,0,0,0,0,0,0,0,0,0,0.5189377998484975,0.4810622001515025
91003,0.4065040650406504,0.6296296296296295,146,-170,0.3918155712722439,0.608184428727756,home,TEX,under,9,0.5,100,0.4810622001515025,TEX,ATL,2023 REG,10,0,12,12,12,22,0,1,-12,12,0,0,0,0,0,0,0,0,0,0.5189377998484975,0.4810622001515025
91004,0.5833333333333333,0.45454545454545453,-140,120,0.5612373737373737,0.4387626262626263,away,TOR,over,8.5,0.5121951219512195,-105,0.48808156828023186,NYM,TOR,2023 REG,7,4,7,6,10,14,0,1,-2,2,1,1,1,1,0,0,0,0,0,0.48808156828023186,0.5119184317197681
91004,0.5833333333333333,0.45454545454545453,-140,120,0.5612373737373737,0.4387626262626263,home,NYM,under,8.5,0.5348837209302326,-115,0.5119184317197681,NYM,TOR,2023 REG,7,4,7,6,10,14,0,1,-2,2,1,1,1,1,0,0,0,0,0,0.48808156828023186,0.5119184317197681
91005,0.4347826086956522,0.607843137254902,130,-155,0.41624967567367205,0.583750324326328,away,MIN,over,8.5,0.5391705069124424,-117,0.5127649394825569,DET,MIN,2023 REG,17,9,7,5,14,24,1,0,4,-4,1,1,1,1,1,0,0,0,0,0.5127649394825569,0.48723506051744314
91005,0.4347826086956522,0.607843137254902,130,-155,0.41624967567367205,0.583750324326328,home,DET,under,8.5,0.5098039215686274,-104,0.48723506051744314,DET,MIN,2023 REG,17,9,7,5,14,24,1,0,4,-4,1,1,1,1,1,0,0,0,0,0.5127649394825569,0.48723506051744314
91006,0.607843137254902,0.4347826086956522,-155,130,0.5819333701084867,0.41806662989151333,away,PHI,over,10,0.5391705069124424,-117,0.5140669063204599,ATL,PHI,2023 REG,11,4,7,6,10,18,0,1,-2,2,1,1,1,1,0,0,0,0,0,0.5140669063204599,0.4859330936795401
91006,0.607843137254902,0.4347826086956522,-155,130,0.5819333701084867,0.41806662989151333,home,ATL,under,10,0.5073891625615764,-103,0.4859330936795401,ATL,PHI,2023 REG,11,4,7,6,10,18,0,1,-2,2,1,1,1,1,0,0,0,0,0,0.5140669063204599,0.4859330936795401
91007,0.6774193548387096,0.37037037037037035,-210,170,0.6450456700196554,0.3549543299803446,away,CLE,over,8,0.5238095238095238,-110,0.5000596729920038,TB,CLE,2023 REG,7,9,10,8,17,17,1,0,1,-1,1,1,1,1,1,1,1,1,0,0.5000596729920038,0.4999403270079962
91007,0.6774193548387096,0.37037037037037035,-210,170,0.6450456700196554,0.3549543299803446,home,TB,under,8,0.5215311004784688,-109,0.4999403270079962,TB,CLE,2023 REG,7,9,10,8,17,17,1,0,1,-1,1,1,1,1,1,1,1,1,0,0.5000596729920038,0.4999403270079962
91008,0.37735849056603776,0.6610169491525424,165,-195,0.36287719255902645,0.6371228074409736,away,LAD,over,9,0.49504950495049505,102,0.4739797934813417,CLE,LAD,2023 REG,12,8,6,3,11,18,1,0,5,-5,1,1,1,0,0,0,0,0,0,0.4739797934813417,0.5260202065186583
91008,0.37735849056603776,0.6610169491525424,165,-195,0.36287719255902645,0.6371228074409736,home,CLE,under,9,0.5475113122171946,-121,0.5260202065186583,CLE,LAD,2023 REG,12,8,6,3,11,18,1,0,5,-5,1,1,1,0,0,0,0,0,0,0.4739797934813417,0.5260202065186583
91009,0.5098039215686274,0.5348837209302326,-104,-115,0.4870219861770517,0.5129780138229483,away,PHI,over,9,0.5169082125603864,-107,0.49353874091423283,SF,PHI,2023 REG,11,7,8,4,11,19,1,0,3,-3,1,1,1,1,0,0,0,0,0,0.49353874091423283,0.5064612590857671
91009,0.5098039215686274,0.5348837209302326,-104,-115,0.4870219861770517,0.5129780138229483,home,SF,under,9,0.5283018867924528,-112,0.5064612590857671,SF,PHI,2023 REG,11,7,8,4,11,19,1,0,3,-3,1,1,1,1,0,0,0,0,0,0.49353874091423283,0.5064612590857671
91010,0.5412844036697247,0.504950495049505,-118,-102,0.5162581740877563,0.4837418259122437,away,TEX,over,7.5,0.5215311004784688,-109,0.4955416477869355,SEA,TEX,2023 REG,8,3,3,2,5,11,1,0,1,-1,1,1,0,0,0,0,0,0,0,0.4955416477869355,0.5044583522130646
91010,0.5412844036697247,0.504950495049505,-118,-102,0.5162581740877563,0.4837418259122437,home,SEA,under,7.5,0.5283018867924528,-112,0.5044583522130646,SEA,TEX,2023 REG,8,3,3,2,5,11,1,0,1,-1,1,1,0,0,0,0,0,0,0,0.4955416477869355,0.5044583522130646
91011,0.5215311004784688,0.5145631067961165,-109,-106,0.5027068488376564,0.4972931511623436,away,TOR,over,9,0.5348837209302326,-115,0.5097020142727117,HOU,TOR,2023 REG,8,2,8,4,6,16,0,1,-2,2,1,1,0,0,0,0,0,0,0,0.5097020142727117,0.49029798572728833
91011,0.5215311004784688,0.5145631067961165,-109,-106,0.5027068488376564,0.4972931511623436,home,HOU,under,9,0.5121951219512195,-105,0.49029798572728833,HOU,TOR,2023 REG,8,2,8,4,6,16,0,1,-2,2,1,1,0,0,0,0,0,0,0,0.5097020142727117,0.49029798572728833
91012,0.5967741935483871,0.4444444444444444,-148,125,0.5721759741010521,0.42782402589894786,away,MIL,over,8.5,0.5454545454545454,-120,0.5206611570247933,NYY,MIL,2023 REG,4,2,11,9,11,15,0,1,-7,7,1,1,0,0,0,0,0,0,0,0.5206611570247933,0.4793388429752067
91012,0.5967741935483871,0.4444444444444444,-148,125,0.5721759741010521,0.42782402589894786,home,NYY,under,8.5,0.5,100,0.4793388429752067,NYY,MIL,2023 REG,4,2,11,9,11,15,0,1,-7,7,1,1,0,0,0,0,0,0,0,0.5206611570247933,0.4793388429752067
91013,0.607843137254902,0.4347826086956522,-155,130,0.5819333701084867,0.41806662989151333,away,NYY,over,9.5,0.5238095238095238,-110,0.4988662131519274,TOR,NYY,2023 REG,8,4,8,7,11,16,0,1,-3,3,1,1,1,1,0,0,0,0,0,0.4988662131519274,0.5011337868480725
91013,0.607843137254902,0.4347826086956522,-155,130,0.5819333701084867,0.41806662989151333,home,TOR,under,9.5,0.5238095238095238,-110,0.5011337868480725,TOR,NYY,2023 REG,8,4,8,7,11,16,0,1,-3,3,1,1,1,1,0,0,0,0,0,0.4988662131519274,0.5011337868480725
91014,0.6254681647940076,0.4081632653061224,-167,145,0.6044327759298813,0.3955672240701187,away,PIT,over,7,0.5327102803738317,-114,0.5075272610403079,MIA,PIT,2023 REG,9,2,5,0,2,14,1,0,2,-2,0,0,0,0,0,0,0,0,0,0.5075272610403079,0.4924727389596921
91014,0.6254681647940076,0.4081632653061224,-167,145,0.6044327759298813,0.3955672240701187,home,MIA,under,7,0.5145631067961165,-106,0.4924727389596921,MIA,PIT,2023 REG,9,2,5,0,2,14,1,0,2,-2,0,0,0,0,0,0,0,0,0,0.5075272610403079,0.4924727389596921
91015,0.607843137254902,0.43103448275862066,-155,132,0.5842116427368785,0.41578835726312147,away,MIN,over,8,0.5348837209302326,-115,0.5097020142727117,TEX,MIN,2023 REG,3,1,7,5,6,10,0,1,-4,4,1,0,0,0,0,0,0,0,0,0.5097020142727117,0.49029798572728833
91015,0.607843137254902,0.43103448275862066,-155,132,0.5842116427368785,0.41578835726312147,home,TEX,under,8,0.5121951219512195,-105,0.49029798572728833,TEX,MIN,2023 REG,3,1,7,5,6,10,0,1,-4,4,1,0,0,0,0,0,0,0,0,0.5097020142727117,0.49029798572728833
91016,0.6363636363636364,0.4,-175,150,0.6132231404958678,0.3867768595041322,away,MIA,over,7.5,0.49504950495049505,102,0.47297076509898783,TB,MIA,2023 REG,5,1,11,7,8,16,0,1,-6,6,1,0,0,0,0,0,0,0,0,0.47297076509898783,0.5270292349010122
91016,0.6363636363636364,0.4,-175,150,0.6132231404958678,0.3867768595041322,home,TB,under,7.5,0.5495495495495495,-122,0.5270292349010122,TB,MIA,2023 REG,5,1,11,7,8,16,0,1,-6,6,1,0,0,0,0,0,0,0,0,0.47297076509898783,0.5270292349010122
91017,0.5,0.5391705069124424,100,-117,0.4804147465437788,0.5195852534562212,away,TOR,over,8,0.5238095238095238,-110,0.4988662131519274,HOU,TOR,2023 REG,10,9,5,2,11,15,1,0,7,-7,1,1,0,0,0,0,0,0,0,0.4988662131519274,0.5011337868480725
91017,0.5,0.5391705069124424,100,-117,0.4804147465437788,0.5195852534562212,home,HOU,under,8,0.5238095238095238,-110,0.5011337868480725,HOU,TOR,2023 REG,10,9,5,2,11,15,1,0,7,-7,1,1,0,0,0,0,0,0,0,0.4988662131519274,0.5011337868480725
91018,0.4291845493562232,0.6108949416342413,133,-157,0.4119830510770539,0.5880169489229461,away,ATL,over,11.5,0.5121951219512195,-105,0.48808156828023186,CIN,ATL,2023 REG,9,11,16,10,21,25,1,0,1,-1,1,1,1,1,1,1,1,1,1,0.48808156828023186,0.5119184317197681
91018,0.4291845493562232,0.6108949416342413,133,-157,0.4119830510770539,0.5880169489229461,home,CIN,under,11.5,0.5348837209302326,-115,0.5119184317197681,CIN,ATL,2023 REG,9,11,16,10,21,25,1,0,1,-1,1,1,1,1,1,1,1,1,1,0.48808156828023186,0.5119184317197681
91019,0.5918367346938775,0.4444444444444444,-145,125,0.5703642001018094,0.42963579989819056,away,SD,over,7.5,0.5238095238095238,-110,0.4988662131519274,NYY,SD,2023 REG,12,10,5,7,17,17,1,0,3,-3,1,1,1,1,1,1,1,0,0,0.4988662131519274,0.5011337868480725
91019,0.5918367346938775,0.4444444444444444,-145,125,0.5703642001018094,0.42963579989819056,home,NYY,under,7.5,0.5238095238095238,-110,0.5011337868480725,NYY,SD,2023 REG,12,10,5,7,17,17,1,0,3,-3,1,1,1,1,1,1,1,0,0,0.4988662131519274,0.5011337868480725
91020,0.782608695652174,0.2631578947368421,-360,280,0.7467913640433788,0.25320863595662124,away,KC,over,7.5,0.5454545454545454,-120,0.5206611570247933,TB,KC,2023 REG,10,5,9,6,11,19,0,1,-1,1,1,1,1,1,1,0,0,0,0,0.5206611570247933,0.4793388429752067
91020,0.782608695652174,0.2631578947368421,-360,280,0.7467913640433788,0.25320863595662124,home,TB,under,7.5,0.5,100,0.4793388429752067,TB,KC,2023 REG,10,5,9,6,11,19,0,1,-1,1,1,1,1,1,1,0,0,0,0,0.5206611570247933,0.4793388429752067
91021,0.6644295302013422,0.37735849056603776,-198,165,0.636664335194828,0.363335664805172,away,LAA,over,8.5,0.5454545454545454,-120,0.5206611570247933,TEX,LAA,2023 REG,11,7,8,3,10,19,1,0,4,-4,1,1,1,0,0,0,0,0,0,0.5206611570247933,0.4793388429752067
91021,0.6644295302013422,0.37735849056603776,-198,165,0.636664335194828,0.363335664805172,home,TEX,under,8.5,0.5,100,0.4793388429752067,TEX,LAA,2023 REG,11,7,8,3,10,19,1,0,4,-4,1,1,1,0,0,0,0,0,0,0.5206611570247933,0.4793388429752067
91022,0.5454545454545454,0.5,-120,100,0.5206611570247933,0.4793388429752067,away,LAD,over,9,0.5,100,0.4772727272727273,NYM,LAD,2023 REG,3,1,11,5,6,14,0,1,-4,4,1,0,0,0,0,0,0,0,0,0.4772727272727273,0.5227272727272727
91022,0.5454545454545454,0.5,-120,100,0.5206611570247933,0.4793388429752067,home,NYM,under,9,0.5454545454545454,-120,0.5227272727272727,NYM,LAD,2023 REG,3,1,11,5,6,14,0,1,-4,4,1,0,0,0,0,0,0,0,0,0.4772727272727273,0.5227272727272727
91023,0.7409326424870467,0.29850746268656714,-286,235,0.7117101811407941,0.2882898188592059,away,WSH,over,9,0.5215311004784688,-109,0.4978845547971712,PHI,WSH,2023 REG,10,8,11,4,12,21,1,0,4,-4,1,1,1,1,0,0,0,0,0,0.4978845547971712,0.5021154452028288
91023,0.7409326424870467,0.29850746268656714,-286,235,0.7117101811407941,0.2882898188592059,home,PHI,under,9,0.5238095238095238,-110,0.5021154452028288,PHI,WSH,2023 REG,10,8,11,4,12,21,1,0,4,-4,1,1,1,1,0,0,0,0,0,0.4978845547971712,0.5021154452028288
91024,0.5884773662551441,0.4504504504504505,-143,122,0.5655692272061728,0.43443077279382725,away,OAK,over,10,0.5121951219512195,-105,0.48808156828023186,CWS,OAK,2023 REG,11,5,9,8,13,20,0,1,-3,3,1,1,1,1,1,0,0,0,0,0.48808156828023186,0.5119184317197681
91024,0.5884773662551441,0.4504504504504505,-143,122,0.5655692272061728,0.43443077279382725,home,CWS,under,10,0.5348837209302326,-115,0.5119184317197681,CWS,OAK,2023 REG,11,5,9,8,13,20,0,1,-3,3,1,1,1,1,1,0,0,0,0,0.48808156828023186,0.5119184317197681
91025,0.696969696969697,0.3448275862068966,-230,190,0.6678382571799499,0.33216174282005007,away,COL,over,8.5,0.5327102803738317,-114,0.5075272610403079,CHC,COL,2023 REG,9,6,8,3,9,17,1,0,3,-3,1,1,1,0,0,0,0,0,0,0.5075272610403079,0.4924727389596921
91025,0.696969696969697,0.3448275862068966,-230,190,0.6678382571799499,0.33216174282005007,home,CHC,under,8.5,0.5145631067961165,-106,0.4924727389596921,CHC,COL,2023 REG,9,6,8,3,9,17,1,0,3,-3,1,1,1,0,0,0,0,0,0,0.5075272610403079,0.4924727389596921
91026,0.3278688524590164,0.7142857142857143,205,-250,0.3140476830345145,0.6859523169654855,away,ATL,over,9,0.5238095238095238,-110,0.4988662131519274,OAK,ATL,2023 REG,8,7,6,2,9,14,1,0,5,-5,1,1,0,0,0,0,0,0,0,0.4988662131519274,0.5011337868480725
91026,0.3278688524590164,0.7142857142857143,205,-250,0.3140476830345145,0.6859523169654855,home,OAK,under,9,0.5238095238095238,-110,0.5011337868480725,OAK,ATL,2023 REG,8,7,6,2,9,14,1,0,5,-5,1,1,0,0,0,0,0,0,0,0.4988662131519274,0.5011337868480725
91027,0.607843137254902,0.425531914893617,-155,135,0.5875563408509002,0.41244365914909975,away,WSH,over,9,0.5412844036697247,-118,0.5175913212324037,CHC,WSH,2023 REG,11,8,10,3,11,21,1,0,5,-5,1,1,1,0,0,0,0,0,0,0.5175913212324037,0.4824086787675963
91027,0.607843137254902,0.425531914893617,-155,135,0.5875563408509002,0.41244365914909975,home,CHC,under,9,0.5024875621890548,-101,0.4824086787675963,CHC,WSH,2023 REG,11,8,10,3,11,21,1,0,5,-5,1,1,1,0,0,0,0,0,0,0.5175913212324037,0.4824086787675963
91028,0.607843137254902,0.425531914893617,-155,135,0.5875563408509002,0.41244365914909975,away,MIA,over,7,0.5348837209302326,-115,0.5109810284308424,SEA,MIA,2023 REG,8,9,7,3,12,15,1,0,6,-6,1,1,1,0,0,0,0,0,0,0.5109810284308424,0.48901897156915763
91028,0.607843137254902,0.425531914893617,-155,135,0.5875563408509002,0.41244365914909975,home,SEA,under,7,0.5098039215686274,-104,0.48901897156915763,SEA,MIA,2023 REG,8,9,7,3,12,15,1,0,6,-6,1,1,1,0,0,0,0,0,0,0.5109810284308424,0.48901897156915763
91029,0.6000000000000001,0.4347826086956522,-150,130,0.5791304347826086,0.4208695652173914,away,BOS,over,8,0.5412844036697247,-118,0.5175913212324037,SD,BOS,2023 REG,5,1,8,6,7,13,0,1,-5,5,1,0,0,0,0,0,0,0,0,0.5175913212324037,0.4824086787675963
91029,0.6000000000000001,0.4347826086956522,-150,130,0.5791304347826086,0.4208695652173914,home,SD,under,8,0.5024875621890548,-101,0.4824086787675963,SD,BOS,2023 REG,5,1,8,6,7,13,0,1,-5,5,1,0,0,0,0,0,0,0,0,0.5175913212324037,0.4824086787675963
91030,0.7304582210242588,0.30303030303030304,-271,230,0.7059962533186355,0.29400374668136453,away,COL,over,8,0.5348837209302326,-115,0.5109810284308424,NYM,COL,2023 REG,5,1,5,0,1,10,1,0,1,-1,0,0,0,0,0,0,0,0,0,0.5109810284308424,0.48901897156915763
91030,0.7304582210242588,0.30303030303030304,-271,230,0.7059962533186355,0.29400374668136453,home,NYM,under,8,0.5098039215686274,-104,0.48901897156915763,NYM,COL,2023 REG,5,1,5,0,1,10,1,0,1,-1,0,0,0,0,0,0,0,0,0,0.5109810284308424,0.48901897156915763
91031,0.3508771929824561,0.6875,185,-220,0.3374115112342259,0.662588488765774,away,ARI,over,9,0.5121951219512195,-105,0.48808156828023186,OAK,ARI,2023 REG,4,2,10,5,7,14,0,1,-3,3,1,1,0,0,0,0,0,0,0,0.48808156828023186,0.5119184317197681
91031,0.3508771929824561,0.6875,185,-220,0.3374115112342259,0.662588488765774,home,OAK,under,9,0.5348837209302326,-115,0.5119184317197681,OAK,ARI,2023 REG,4,2,10,5,7,14,0,1,-3,3,1,1,0,0,0,0,0,0,0,0.48808156828023186,0.5119184317197681
91032,0.5867768595041323,0.45454545454545453,-142,120,0.5625298818386723,0.43747011816132775,away,HOU,over,8,0.5121951219512195,-105,0.4903184724049234,TOR,HOU,2023 REG,5,5,4,1,6,9,1,0,4,-4,1,0,0,0,0,0,0,0,0,0.4903184724049234,0.5096815275950766
91032,0.5867768595041323,0.45454545454545453,-142,120,0.5625298818386723,0.43747011816132775,home,TOR,under,8,0.5305164319248826,-113,0.5096815275950766,TOR,HOU,2023 REG,5,5,4,1,6,9,1,0,4,-4,1,0,0,0,0,0,0,0,0,0.4903184724049234,0.5096815275950766
91033,0.49751243781094534,0.5454545454545454,101,-120,0.476135829221149,0.523864170778851,away,CLE,over,7.5,0.5348837209302326,-115,0.5097020142727117,NYY,CLE,2023 REG,8,4,9,3,7,17,1,0,1,-1,1,1,1,0,0,0,0,0,0,0.5097020142727117,0.49029798572728833
91033,0.49751243781094534,0.5454545454545454,101,-120,0.476135829221149,0.523864170778851,home,NYY,under,7.5,0.5121951219512195,-105,0.49029798572728833,NYY,CLE,2023 REG,8,4,9,3,7,17,1,0,1,-1,1,1,1,0,0,0,0,0,0,0.5097020142727117,0.49029798572728833
91034,0.37037037037037035,0.6721311475409836,170,-205,0.35462906744023925,0.6453709325597607,away,MIN,over,8.5,0.5,100,0.4762443438914027,OAK,MIN,2023 REG,7,4,10,5,9,17,0,1,-1,1,1,1,1,1,0,0,0,0,0,0.4762443438914027,0.5237556561085973
91034,0.37037037037037035,0.6721311475409836,170,-205,0.35462906744023925,0.6453709325597607,home,OAK,under,8.5,0.5475113122171946,-121,0.5237556561085973,OAK,MIN,2023 REG,7,4,10,5,9,17,0,1,-1,1,1,1,1,1,0,0,0,0,0,0.4762443438914027,0.5237556561085973
91035,0.6376811594202898,0.40322580645161293,-176,148,0.6115955579947286,0.38840444200527136,away,KC,over,8.5,0.5305164319248826,-113,0.5078572507605655,TEX,KC,2023 REG,11,11,4,2,13,15,1,0,9,-9,1,1,0,0,0,0,0,0,0,0.5078572507605655,0.49214274923943446
91035,0.6376811594202898,0.40322580645161293,-176,148,0.6115955579947286,0.38840444200527136,home,TEX,under,8.5,0.5121951219512195,-105,0.49214274923943446,TEX,KC,2023 REG,11,11,4,2,13,15,1,0,9,-9,1,1,0,0,0,0,0,0,0,0.5078572507605655,0.49214274923943446
91036,0.5348837209302326,0.5121951219512195,-115,-105,0.5097020142727117,0.49029798572728833,away,TOR,over,9,0.5348837209302326,-115,0.5097020142727117,TEX,TOR,2023 REG,8,4,9,2,6,17,1,0,2,-2,1,1,0,0,0,0,0,0,0,0.5097020142727117,0.49029798572728833
91036,0.5348837209302326,0.5121951219512195,-115,-105,0.5097020142727117,0.49029798572728833,home,TEX,under,9,0.5121951219512195,-105,0.49029798572728833,TEX,TOR,2023 REG,8,4,9,2,6,17,1,0,2,-2,1,1,0,0,0,0,0,0,0,0.5097020142727117,0.49029798572728833
91037,0.6621621621621622,0.37878787878787884,-196,164,0.6350465945060539,0.36495340549394606,away,COL,over,8.5,0.5169082125603864,-107,0.49353874091423283,TEX,COL,2023 REG,15,11,13,5,16,28,1,0,6,-6,1,1,1,1,1,0,0,0,0,0.49353874091423283,0.5064612590857671
91037,0.6621621621621622,0.37878787878787884,-196,164,0.6350465945060539,0.36495340549394606,home,TEX,under,8.5,0.5283018867924528,-112,0.5064612590857671,TEX,COL,2023 REG,15,11,13,5,16,28,1,0,6,-6,1,1,1,1,1,0,0,0,0,0.49353874091423283,0.5064612590857671
91038,0.35460992907801414,0.6875,182,-220,0.3396773301141794,0.6603226698858207,away,TOR,over,8.5,0.5,100,0.4783105022831051,KC,TOR,2023 REG,8,3,11,6,9,19,0,1,-3,3,1,1,1,0,0,0,0,0,0,0.4783105022831051,0.5216894977168949
91038,0.35460992907801414,0.6875,182,-220,0.3396773301141794,0.6603226698858207,home,KC,under,8.5,0.5433789954337899,-119,0.5216894977168949,KC,TOR,2023 REG,8,3,11,6,9,19,0,1,-3,3,1,1,1,0,0,0,0,0,0,0.4783105022831051,0.5216894977168949
91039,0.6402877697841727,0.3921568627450981,-178,155,0.6195138683805389,0.3804861316194611,away,TOR,over,8,0.5348837209302326,-115,0.5097020142727117,TB,TOR,2023 REG,12,7,8,3,10,20,1,0,4,-4,1,1,1,0,0,0,0,0,0,0.5097020142727117,0.49029798572728833
91039,0.6402877697841727,0.3921568627450981,-178,155,0.6195138683805389,0.3804861316194611,home,TB,under,8,0.5121951219512195,-105,0.49029798572728833,TB,TOR,2023 REG,12,7,8,3,10,20,1,0,4,-4,1,1,1,0,0,0,0,0,0,0.5097020142727117,0.49029798572728833
91040,0.48309178743961345,0.5555555555555556,107,-125,0.4644215734322854,0.5355784265677146,away,BOS,over,9,0.5283018867924528,-112,0.5031902949311281,NYY,BOS,2023 REG,10,3,12,8,11,22,0,1,-5,5,1,1,1,0,0,0,0,0,0,0.5031902949311281,0.4968097050688719
91040,0.48309178743961345,0.5555555555555556,107,-125,0.4644215734322854,0.5355784265677146,home,NYY,under,9,0.5192307692307692,-108,0.4968097050688719,NYY,BOS,2023 REG,10,3,12,8,11,22,0,1,-5,5,1,1,1,0,0,0,0,0,0,0.5031902949311281,0.4968097050688719
91041,0.3412969283276451,0.696969696969697,193,-230,0.3282366466561973,0.6717633533438028,away,CLE,over,9,0.5215311004784688,-109,0.49670754937970685,WSH,CLE,2023 REG,13,7,9,6,13,22,1,0,1,-1,1,1,1,1,1,1,0,0,0,0.49670754937970685,0.5032924506202932
91041,0.3412969283276451,0.696969696969697,193,-230,0.3282366466561973,0.6717633533438028,home,WSH,under,9,0.5260663507109005,-111,0.5032924506202932,WSH,CLE,2023 REG,13,7,9,6,13,22,1,0,1,-1,1,1,1,1,1,1,0,0,0,0.49670754937970685,0.5032924506202932
91042,0.7058823529411764,0.3333333333333333,-240,200,0.6782006920415226,0.32179930795847744,away,OAK,over,8.5,0.5121951219512195,-105,0.48808156828023186,SEA,OAK,2023 REG,4,1,9,3,4,13,0,1,-2,2,1,0,0,0,0,0,0,0,0,0.48808156828023186,0.5119184317197681
91042,0.7058823529411764,0.3333333333333333,-240,200,0.6782006920415226,0.32179930795847744,home,SEA,under,8.5,0.5348837209302326,-115,0.5119184317197681,SEA,OAK,2023 REG,4,1,9,3,4,13,0,1,-2,2,1,0,0,0,0,0,0,0,0,0.48808156828023186,0.5119184317197681
91043,0.5535714285714286,0.48780487804878053,-124,105,0.53066668740667,0.46933331259333,away,ARI,over,8,0.5433789954337899,-119,0.5184560714286826,MIN,ARI,2023 REG,7,3,9,2,5,16,1,0,1,-1,1,1,0,0,0,0,0,0,0,0.5184560714286826,0.48154392857131745
91043,0.5535714285714286,0.48780487804878053,-124,105,0.53066668740667,0.46933331259333,home,MIN,under,8,0.5024875621890548,-101,0.48154392857131745,MIN,ARI,2023 REG,7,3,9,2,5,16,1,0,1,-1,1,1,0,0,0,0,0,0,0,0.5184560714286826,0.48154392857131745
91044,0.46511627906976744,0.574468085106383,115,-135,0.44670494689481377,0.5532950531051862,away,TOR,over,8,0.5192307692307692,-108,0.49455035168025013,KC,TOR,2023 REG,10,9,10,5,14,20,1,0,4,-4,1,1,1,1,1,0,0,0,0,0.49455035168025013,0.5054496483197499
91044,0.46511627906976744,0.574468085106383,115,-135,0.44670494689481377,0.5532950531051862,home,KC,under,8,0.5283018867924528,-112,0.5054496483197499,KC,TOR,2023 REG,10,9,10,5,14,20,1,0,4,-4,1,1,1,1,1,0,0,0,0,0.49455035168025013,0.5054496483197499
91045,0.48780487804878053,0.5555555555555556,105,-125,0.4666534470222751,0.5333465529777248,away,ATL,over,8,0.5391705069124424,-117,0.5153817639191344,STL,ATL,2023 REG,12,4,10,8,12,22,0,1,-4,4,1,1,1,1,0,0,0,0,0,0.5153817639191344,0.4846182360808656
91045,0.48780487804878053,0.5555555555555556,105,-125,0.4666534470222751,0.5333465529777248,home,STL,under,8,0.504950495049505,-102,0.4846182360808656,STL,ATL,2023 REG,12,4,10,8,12,22,0,1,-4,4,1,1,1,1,0,0,0,0,0,0.5153817639191344,0.4846182360808656
91046,0.4672897196261683,0.574468085106383,114,-135,0.4477767267604901,0.5522232732395099,away,BAL,over,8,0.5454545454545454,-120,0.5206611570247933,CLE,BAL,2023 REG,1,1,9,2,3,10,0,1,-1,1,1,0,0,0,0,0,0,0,0,0.5206611570247933,0.4793388429752067
91046,0.4672897196261683,0.574468085106383,114,-135,0.4477767267604901,0.5522232732395099,home,CLE,under,8,0.5,100,0.4793388429752067,CLE,BAL,2023 REG,1,1,9,2,3,10,0,1,-1,1,1,0,0,0,0,0,0,0,0,0.5206611570247933,0.4793388429752067
91047,0.6363636363636364,0.4,-175,150,0.6132231404958678,0.3867768595041322,away,CIN,over,8,0.5283018867924528,-112,0.5044173060022736,STL,CIN,2023 REG,11,7,7,4,11,18,1,0,3,-3,1,1,1,1,0,0,0,0,0,0.5044173060022736,0.49558269399772636
91047,0.6363636363636364,0.4,-175,150,0.6132231404958678,0.3867768595041322,home,STL,under,8,0.5169082125603864,-107,0.49558269399772636,STL,CIN,2023 REG,11,7,7,4,11,18,1,0,3,-3,1,1,1,1,0,0,0,0,0,0.5044173060022736,0.49558269399772636
91048,0.5454545454545454,0.5,-120,100,0.5206611570247933,0.4793388429752067,away,OAK,over,11.5,0.5391705069124424,-117,0.5127649394825569,COL,OAK,2023 REG,6,2,5,0,2,11,1,0,2,-2,0,0,0,0,0,0,0,0,0,0.5127649394825569,0.48723506051744314
91048,0.5454545454545454,0.5,-120,100,0.5206611570247933,0.4793388429752067,home,COL,under,11.5,0.5098039215686274,-104,0.48723506051744314,COL,OAK,2023 REG,6,2,5,0,2,11,1,0,2,-2,0,0,0,0,0,0,0,0,0,0.5127649394825569,0.48723506051744314
91049,0.6721311475409836,0.37037037037037035,-205,170,0.6435645535349916,0.35643544646500835,away,PIT,over,9.5,0.5215311004784688,-109,0.4978845547971712,ATL,PIT,2023 REG,12,8,6,2,10,18,1,0,6,-6,1,1,0,0,0,0,0,0,0,0.4978845547971712,0.5021154452028288
91049,0.6721311475409836,0.37037037037037035,-205,170,0.6435645535349916,0.35643544646500835,home,ATL,under,9.5,0.5238095238095238,-110,0.5021154452028288,ATL,PIT,2023 REG,12,8,6,2,10,18,1,0,6,-6,1,1,0,0,0,0,0,0,0,0.4978845547971712,0.5021154452028288
91050,0.6226415094339623,0.4166666666666667,-165,140,0.5981666073335706,0.40183339266642937,away,CHC,over,8.5,0.5283018867924528,-112,0.5044173060022736,SF,CHC,2023 REG,1,0,5,4,4,6,0,1,-4,4,0,0,0,0,0,0,0,0,0,0.5044173060022736,0.49558269399772636
91050,0.6226415094339623,0.4166666666666667,-165,140,0.5981666073335706,0.40183339266642937,home,SF,under,8.5,0.5169082125603864,-107,0.49558269399772636,SF,CHC,2023 REG,1,0,5,4,4,6,0,1,-4,4,0,0,0,0,0,0,0,0,0,0.5044173060022736,0.49558269399772636
91051,0.7530864197530864,0.2857142857142857,-305,250,0.7238661353887691,0.2761338646112309,away,COL,over,8.5,0.5121951219512195,-105,0.48919479393107135,LAD,COL,2023 REG,11,6,6,1,7,17,1,0,5,-5,1,0,0,0,0,0,0,0,0,0.48919479393107135,0.5108052060689287
91051,0.7530864197530864,0.2857142857142857,-305,250,0.7238661353887691,0.2761338646112309,home,LAD,under,8.5,0.5327102803738317,-114,0.5108052060689287,LAD,COL,2023 REG,11,6,6,1,7,17,1,0,5,-5,1,0,0,0,0,0,0,0,0,0.48919479393107135,0.5108052060689287
91052,0.5454545454545454,0.5,-120,100,0.5206611570247933,0.4793388429752067,away,TEX,over,7.5,0.5348837209302326,-115,0.5097020142727117,SEA,TEX,2023 REG,4,1,4,0,1,8,1,0,1,-1,0,0,0,0,0,0,0,0,0,0.5097020142727117,0.49029798572728833
91052,0.5454545454545454,0.5,-120,100,0.5206611570247933,0.4793388429752067,home,SEA,under,7.5,0.5121951219512195,-105,0.49029798572728833,SEA,TEX,2023 REG,4,1,4,0,1,8,1,0,1,-1,0,0,0,0,0,0,0,0,0,0.5097020142727117,0.49029798572728833
91053,0.7354497354497355,0.3076923076923077,-278,225,0.7037209312341587,0.2962790687658413,away,COL,over,8.5,0.5348837209302326,-115,0.5097020142727117,TB,COL,2023 REG,8,5,8,3,8,16,1,0,2,-2,1,1,1,0,0,0,0,0,0,0.5097020142727117,0.49029798572728833
91053,0.7354497354497355,0.3076923076923077,-278,225,0.7037209312341587,0.2962790687658413,home,TB,under,8.5,0.5121951219512195,-105,0.49029798572728833,TB,COL,2023 REG,8,5,8,3,8,16,1,0,2,-2,1,1,1,0,0,0,0,0,0,0.5097020142727117,0.49029798572728833
91054,0.696969696969697,0.3389830508474576,-230,195,0.6719117212183469,0.32808827878165314,away,COL,over,9,0.5238095238095238,-110,0.5012646084074657,BOS,COL,2023 REG,9,3,6,4,7,15,0,1,-1,1,1,1,1,0,0,0,0,0,0,0.5012646084074657,0.4987353915925343
91054,0.696969696969697,0.3389830508474576,-230,195,0.6719117212183469,0.32808827878165314,home,BOS,under,9,0.5192307692307692,-108,0.4987353915925343,BOS,COL,2023 REG,9,3,6,4,7,15,0,1,-1,1,1,1,1,0,0,0,0,0,0,0.5012646084074657,0.4987353915925343
91055,0.43103448275862066,0.607843137254902,132,-155,0.4142768879252058,0.5857231120747942,away,SD,over,8,0.5412844036697247,-118,0.5189377998484975,WSH,SD,2023 REG,9,4,12,7,11,21,0,1,-3,3,1,1,1,1,0,0,0,0,0,0.5189377998484975,0.4810622001515025
91055,0.43103448275862066,0.607843137254902,132,-155,0.4142768879252058,0.5857231120747942,home,WSH,under,8,0.5,100,0.4810622001515025,WSH,SD,2023 REG,9,4,12,7,11,21,0,1,-3,3,1,1,1,1,0,0,0,0,0,0.5189377998484975,0.4810622001515025
91056,0.6666666666666666,0.373134328358209,-200,168,0.6401326699834162,0.3598673300165838,away,KC,over,10,0.5238095238095238,-110,0.4988662131519274,CLE,KC,2023 REG,9,8,12,3,11,21,1,0,5,-5,1,1,1,0,0,0,0,0,0,0.4988662131519274,0.5011337868480725
91056,0.6666666666666666,0.373134328358209,-200,168,0.6401326699834162,0.3598673300165838,home,CLE,under,10,0.5238095238095238,-110,0.5011337868480725,CLE,KC,2023 REG,9,8,12,3,11,21,1,0,5,-5,1,1,1,0,0,0,0,0,0,0.4988662131519274,0.5011337868480725
91057,0.75,0.2898550724637681,-300,245,0.720108695652174,0.27989130434782605,away,COL,over,8,0.5348837209302326,-115,0.5097020142727117,SEA,COL,2023 REG,4,1,3,0,1,7,1,0,1,-1,0,0,0,0,0,0,0,0,0,0.5097020142727117,0.49029798572728833
91057,0.75,0.2898550724637681,-300,245,0.720108695652174,0.27989130434782605,home,SEA,under,8,0.5121951219512195,-105,0.49029798572728833,SEA,COL,2023 REG,4,1,3,0,1,7,1,0,1,-1,0,0,0,0,0,0,0,0,0,0.5097020142727117,0.49029798572728833
91058,0.47619047619047616,0.5652173913043479,110,-130,0.4564724440500838,0.5435275559499162,away,PHI,over,9,0.5,100,0.4783105022831051,CLE,PHI,2023 REG,9,5,8,8,13,17,0,1,-3,3,1,1,1,1,1,0,0,0,0,0.4783105022831051,0.5216894977168949
91058,0.47619047619047616,0.5652173913043479,110,-130,0.4564724440500838,0.5435275559499162,home,CLE,under,9,0.5433789954337899,-119,0.5216894977168949,CLE,PHI,2023 REG,9,5,8,8,13,17,0,1,-3,3,1,1,1,1,1,0,0,0,0,0.4783105022831051,0.5216894977168949
91059,0.5,0.5454545454545454,100,-120,0.4772727272727273,0.5227272727272727,away,DET,over,9,0.5238095238095238,-110,0.4988662131519274,LAA,DET,2023 REG,6,3,7,5,8,13,0,1,-2,2,1,1,1,0,0,0,0,0,0,0.4988662131519274,0.5011337868480725
91059,0.5,0.5454545454545454,100,-120,0.4772727272727273,0.5227272727272727,home,LAA,under,9,0.5238095238095238,-110,0.5011337868480725,LAA,DET,2023 REG,6,3,7,5,8,13,0,1,-2,2,1,1,1,0,0,0,0,0,0,0.4988662131519274,0.5011337868480725
91060,0.4347826086956522,0.6031746031746031,130,-152,0.418279473099889,0.581720526900111,away,BAL,over,9,0.5169082125603864,-107,0.49353874091423283,KC,BAL,2023 REG,13,6,6,0,6,19,1,0,6,-6,0,0,0,0,0,0,0,0,0,0.49353874091423283,0.5064612590857671
91060,0.4347826086956522,0.6031746031746031,130,-152,0.418279473099889,0.581720526900111,home,KC,under,9,0.5283018867924528,-112,0.5064612590857671,KC,BAL,2023 REG,13,6,6,0,6,19,1,0,6,-6,0,0,0,0,0,0,0,0,0,0.49353874091423283,0.5064612590857671
91061,0.5024875621890548,0.5391705069124424,-101,-117,0.4815549006007403,0.5184450993992598,away,SF,over,8.5,0.5121951219512195,-105,0.48808156828023186,LAA,SF,2023 REG,9,3,11,8,11,20,0,1,-5,5,1,1,1,0,0,0,0,0,0,0.48808156828023186,0.5119184317197681
91061,0.5024875621890548,0.5391705069124424,-101,-117,0.4815549006007403,0.5184450993992598,home,LAA,under,8.5,0.5348837209302326,-115,0.5119184317197681,LAA,SF,2023 REG,9,3,11,8,11,20,0,1,-5,5,1,1,1,0,0,0,0,0,0,0.48808156828023186,0.5119184317197681
91062,0.46511627906976744,0.574468085106383,115,-135,0.44670494689481377,0.5532950531051862,away,CLE,over,9,0.5073891625615764,-103,0.4859403596076043,DET,CLE,2023 REG,14,4,8,3,7,22,1,0,1,-1,1,1,1,0,0,0,0,0,0,0.4859403596076043,0.5140596403923957
91062,0.46511627906976744,0.574468085106383,115,-135,0.44670494689481377,0.5532950531051862,home,DET,under,9,0.5348837209302326,-115,0.5140596403923957,DET,CLE,2023 REG,14,4,8,3,7,22,1,0,1,-1,1,1,1,0,0,0,0,0,0,0.4859403596076043,0.5140596403923957
91063,0.6000000000000001,0.4347826086956522,-150,130,0.5791304347826086,0.4208695652173914,away,COL,over,9.5,0.5121951219512195,-105,0.48808156828023186,WSH,COL,2023 REG,5,5,6,4,9,11,1,0,1,-1,1,1,1,1,0,0,0,0,0,0.48808156828023186,0.5119184317197681
91063,0.6000000000000001,0.4347826086956522,-150,130,0.5791304347826086,0.4208695652173914,home,WSH,under,9.5,0.5348837209302326,-115,0.5119184317197681,WSH,COL,2023 REG,5,5,6,4,9,11,1,0,1,-1,1,1,1,1,0,0,0,0,0,0.48808156828023186,0.5119184317197681
91064,0.504950495049505,0.5348837209302326,-102,-115,0.48483618797062755,0.5151638120293724,away,TOR,over,8.5,0.5454545454545454,-120,0.5206611570247933,BAL,TOR,2023 REG,6,1,9,3,4,15,0,1,-2,2,1,0,0,0,0,0,0,0,0,0.5206611570247933,0.4793388429752067
91064,0.504950495049505,0.5348837209302326,-102,-115,0.48483618797062755,0.5151638120293724,home,BAL,under,8.5,0.5,100,0.4793388429752067,BAL,TOR,2023 REG,6,1,9,3,4,15,0,1,-2,2,1,0,0,0,0,0,0,0,0,0.5206611570247933,0.4793388429752067
91065,0.5283018867924528,0.5098039215686274,-112,-104,0.5081705163375425,0.4918294836624575,away,NYM,over,8.5,0.5454545454545454,-120,0.5206611570247933,SF,NYM,2023 REG,5,0,13,7,7,18,0,1,-7,7,0,0,0,0,0,0,0,0,0,0.5206611570247933,0.4793388429752067
91065,0.5283018867924528,0.5098039215686274,-112,-104,0.5081705163375425,0.4918294836624575,home,SF,under,8.5,0.5,100,0.4793388429752067,SF,NYM,2023 REG,5,0,13,7,7,18,0,1,-7,7,0,0,0,0,0,0,0,0,0,0.5206611570247933,0.4793388429752067
91066,0.4166666666666667,0.6226415094339623,140,-165,0.4002882599580712,0.5997117400419287,away,SD,over,8,0.5348837209302326,-115,0.5097020142727117,PIT,SD,2023 REG,9,7,7,1,8,16,1,0,6,-6,1,0,0,0,0,0,0,0,0,0.5097020142727117,0.49029798572728833
91066,0.4166666666666667,0.6226415094339623,140,-165,0.4002882599580712,0.5997117400419287,home,PIT,under,8,0.5121951219512195,-105,0.49029798572728833,PIT,SD,2023 REG,9,7,7,1,8,16,1,0,6,-6,1,0,0,0,0,0,0,0,0,0.5097020142727117,0.49029798572728833
91067,0.5169082125603864,0.5260663507109005,-107,-111,0.4946943078742622,0.5053056921257377,away,TOR,over,7.5,0.5238095238095238,-110,0.4988662131519274,STL,TOR,2023 REG,15,9,19,10,19,34,0,1,-1,1,1,1,1,1,1,1,1,1,1,0.4988662131519274,0.5011337868480725
91067,0.5169082125603864,0.5260663507109005,-107,-111,0.4946943078742622,0.5053056921257377,home,STL,under,7.5,0.5238095238095238,-110,0.5011337868480725,STL,TOR,2023 REG,15,9,19,10,19,34,0,1,-1,1,1,1,1,1,1,1,1,1,1,0.4988662131519274,0.5011337868480725
91068,0.5454545454545454,0.49751243781094534,-120,101,0.5220180091279142,0.4779819908720858,away,SEA,over,10.5,0.5327102803738317,-114,0.508788710910954,CHC,SEA,2023 REG,18,14,11,9,23,29,1,0,5,-5,1,1,1,1,1,1,1,1,1,0.508788710910954,0.491211289089046
91068,0.5454545454545454,0.49751243781094534,-120,101,0.5220180091279142,0.4779819908720858,home,CHC,under,10.5,0.5121951219512195,-105,0.491211289089046,CHC,SEA,2023 REG,18,14,11,9,23,29,1,0,5,-5,1,1,1,1,1,1,1,1,1,0.508788710910954,0.491211289089046
91069,0.5,0.5454545454545454,100,-120,0.4772727272727273,0.5227272727272727,away,TB,over,8.5,0.5433789954337899,-119,0.5184560714286826,CLE,TB,2023 REG,13,7,10,6,13,23,1,0,1,-1,1,1,1,1,1,1,0,0,0,0.5184560714286826,0.48154392857131745
91069,0.5,0.5454545454545454,100,-120,0.4772727272727273,0.5227272727272727,home,CLE,under,8.5,0.5024875621890548,-101,0.48154392857131745,CLE,TB,2023 REG,13,7,10,6,13,23,1,0,1,-1,1,1,1,1,1,1,0,0,0,0.5184560714286826,0.48154392857131745
91070,0.6721311475409836,0.37037037037037035,-205,170,0.6435645535349916,0.35643544646500835,away,CIN,over,8.5,0.5348837209302326,-115,0.5097020142727117,PHI,CIN,2023 REG,7,4,6,6,10,13,0,1,-2,2,1,1,1,1,0,0,0,0,0,0.5097020142727117,0.49029798572728833
91070,0.6721311475409836,0.37037037037037035,-205,170,0.6435645535349916,0.35643544646500835,home,PHI,under,8.5,0.5121951219512195,-105,0.49029798572728833,PHI,CIN,2023 REG,7,4,6,6,10,13,0,1,-2,2,1,1,1,1,0,0,0,0,0,0.5097020142727117,0.49029798572728833
91071,0.47619047619047616,0.5652173913043479,110,-130,0.4564724440500838,0.5435275559499162,away,CWS,over,8.5,0.5238095238095238,-110,0.5012646084074657,PIT,CWS,2023 REG,19,13,11,9,22,30,1,0,4,-4,1,1,1,1,1,1,1,1,1,0.5012646084074657,0.4987353915925343
91071,0.47619047619047616,0.5652173913043479,110,-130,0.4564724440500838,0.5435275559499162,home,PIT,under,8.5,0.5192307692307692,-108,0.4987353915925343,PIT,CWS,2023 REG,19,13,11,9,22,30,1,0,4,-4,1,1,1,1,1,1,1,1,1,0.5012646084074657,0.4987353915925343
91072,0.5348837209302326,0.5,-115,100,0.5162249864791779,0.4837750135208221,away,CWS,over,8.5,0.5495495495495495,-122,0.5250401592387142,CIN,CWS,2023 REG,8,4,7,5,9,15,0,1,-1,1,1,1,1,1,0,0,0,0,0,0.5250401592387142,0.47495984076128583
91072,0.5348837209302326,0.5,-115,100,0.5162249864791779,0.4837750135208221,home,CIN,under,8.5,0.49504950495049505,102,0.47495984076128583,CIN,CWS,2023 REG,8,4,7,5,9,15,0,1,-1,1,1,1,1,1,0,0,0,0,0,0.5250401592387142,0.47495984076128583
91073,0.4166666666666667,0.6226415094339623,140,-165,0.4002882599580712,0.5997117400419287,away,SD,over,9,0.5192307692307692,-108,0.49455035168025013,ARI,SD,2023 REG,5,5,14,10,15,19,0,1,-5,5,1,1,1,1,1,0,0,0,0,0.49455035168025013,0.5054496483197499
91073,0.4166666666666667,0.6226415094339623,140,-165,0.4002882599580712,0.5997117400419287,home,ARI,under,9,0.5283018867924528,-112,0.5054496483197499,ARI,SD,2023 REG,5,5,14,10,15,19,0,1,-5,5,1,1,1,1,1,0,0,0,0,0.49455035168025013,0.5054496483197499
91074,0.5726495726495727,0.46511627906976744,-134,115,0.5510229738017454,0.44897702619825464,away,TOR,over,8.5,0.5169082125603864,-107,0.49353874091423283,NYY,TOR,2023 REG,5,1,8,6,7,13,0,1,-5,5,1,0,0,0,0,0,0,0,0,0.49353874091423283,0.5064612590857671
91074,0.5726495726495727,0.46511627906976744,-134,115,0.5510229738017454,0.44897702619825464,home,NYY,under,8.5,0.5283018867924528,-112,0.5064612590857671,NYY,TOR,2023 REG,5,1,8,6,7,13,0,1,-5,5,1,0,0,0,0,0,0,0,0,0.49353874091423283,0.5064612590857671
91075,0.5780590717299579,0.46511627906976744,-137,115,0.5531011685250534,0.4468988314749466,away,SF,over,8,0.5412844036697247,-118,0.5189377998484975,NYY,SF,2023 REG,7,6,3,0,6,10,1,0,6,-6,0,0,0,0,0,0,0,0,0,0.5189377998484975,0.4810622001515025
91075,0.5780590717299579,0.46511627906976744,-137,115,0.5531011685250534,0.4468988314749466,home,NYY,under,8,0.5,100,0.4810622001515025,NYY,SF,2023 REG,7,6,3,0,6,10,1,0,6,-6,0,0,0,0,0,0,0,0,0,0.5189377998484975,0.4810622001515025
91076,0.5121951219512195,0.5238095238095238,-105,-110,0.4937537180249852,0.5062462819750149,away,NYY,over,9,0.5098039215686274,-104,0.4870219861770517,LAD,NYY,2023 REG,7,3,6,6,9,13,0,1,-3,3,1,1,1,0,0,0,0,0,0,0.4870219861770517,0.5129780138229483
91076,0.5121951219512195,0.5238095238095238,-105,-110,0.4937537180249852,0.5062462819750149,home,LAD,under,9,0.5348837209302326,-115,0.5129780138229483,LAD,NYY,2023 REG,7,3,6,6,9,13,0,1,-3,3,1,1,1,0,0,0,0,0,0,0.4870219861770517,0.5129780138229483
91077,0.425531914893617,0.6153846153846154,135,-160,0.4081206254135181,0.5918793745864819,away,MIN,over,13,0.5073891625615764,-103,0.48484779035144243,COL,MIN,2023 REG,4,3,9,2,5,13,1,0,1,-1,1,1,0,0,0,0,0,0,0,0.48484779035144243,0.5151522096485576
91077,0.425531914893617,0.6153846153846154,135,-160,0.4081206254135181,0.5918793745864819,home,COL,under,13,0.5370370370370371,-116,0.5151522096485576,COL,MIN,2023 REG,4,3,9,2,5,13,1,0,1,-1,1,1,0,0,0,0,0,0,0,0.48484779035144243,0.5151522096485576
91078,0.6825396825396826,0.35714285714285715,-215,180,0.6554547745023935,0.34454522549760647,away,BAL,over,8.5,0.5098039215686274,-104,0.4870219861770517,ATL,BAL,2023 REG,11,4,12,9,13,23,0,1,-5,5,1,1,1,1,0,0,0,0,0,0.4870219861770517,0.5129780138229483
91078,0.6825396825396826,0.35714285714285715,-215,180,0.6554547745023935,0.34454522549760647,home,ATL,under,8.5,0.5348837209302326,-115,0.5129780138229483,ATL,BAL,2023 REG,11,4,12,9,13,23,0,1,-5,5,1,1,1,1,0,0,0,0,0,0.4870219861770517,0.5129780138229483
91079,0.5121951219512195,0.5348837209302326,-105,-115,0.48808156828023186,0.5119184317197681,away,CIN,over,9.5,0.5,100,0.4772727272727273,KC,CIN,2023 REG,15,4,7,7,11,22,0,1,-3,3,1,1,1,1,0,0,0,0,0,0.4772727272727273,0.5227272727272727
91079,0.5121951219512195,0.5348837209302326,-105,-115,0.48808156828023186,0.5119184317197681,home,KC,under,9.5,0.5454545454545454,-120,0.5227272727272727,KC,CIN,2023 REG,15,4,7,7,11,22,0,1,-3,3,1,1,1,1,0,0,0,0,0,0.4772727272727273,0.5227272727272727
91080,0.5412844036697247,0.5,-118,100,0.5189377998484975,0.4810622001515025,away,CIN,over,9.5,0.5238095238095238,-110,0.4988662131519274,MIL,CIN,2023 REG,7,3,6,2,5,13,1,0,1,-1,1,1,0,0,0,0,0,0,0,0.4988662131519274,0.5011337868480725
91080,0.5412844036697247,0.5,-118,100,0.5189377998484975,0.4810622001515025,home,MIL,under,9.5,0.5238095238095238,-110,0.5011337868480725,MIL,CIN,2023 REG,7,3,6,2,5,13,1,0,1,-1,1,1,0,0,0,0,0,0,0,0.4988662131519274,0.5011337868480725
91081,0.6551724137931035,0.390625,-190,156,0.6251672116527942,0.3748327883472058,away,CWS,over,8,0.5169082125603864,-107,0.49353874091423283,TB,CWS,2023 REG,5,4,3,1,5,8,1,0,3,-3,1,0,0,0,0,0,0,0,0,0.49353874091423283,0.5064612590857671
91081,0.6551724137931035,0.390625,-190,156,0.6251672116527942,0.3748327883472058,home,TB,under,8,0.5283018867924528,-112,0.5064612590857671,TB,CWS,2023 REG,5,4,3,1,5,8,1,0,3,-3,1,0,0,0,0,0,0,0,0,0.49353874091423283,0.5064612590857671
91082,0.6428571428571428,0.4,-180,150,0.6153061224489796,0.38469387755102036,away,LAA,over,9,0.5121951219512195,-105,0.48808156828023186,TEX,LAA,2023 REG,3,0,8,2,2,11,0,1,-2,2,0,0,0,0,0,0,0,0,0,0.48808156828023186,0.5119184317197681
91082,0.6428571428571428,0.4,-180,150,0.6153061224489796,0.38469387755102036,home,TEX,under,9,0.5348837209302326,-115,0.5119184317197681,TEX,LAA,2023 REG,3,0,8,2,2,11,0,1,-2,2,0,0,0,0,0,0,0,0,0,0.48808156828023186,0.5119184317197681
91083,0.5169082125603864,0.5238095238095238,-107,-110,0.49586088023391106,0.5041391197660889,away,TB,over,8.5,0.5454545454545454,-120,0.5206611570247933,HOU,TB,2023 REG,8,3,6,4,7,14,0,1,-1,1,1,1,1,0,0,0,0,0,0,0.5206611570247933,0.4793388429752067
91083,0.5169082125603864,0.5238095238095238,-107,-110,0.49586088023391106,0.5041391197660889,home,HOU,under,8.5,0.5,100,0.4793388429752067,HOU,TB,2023 REG,8,3,6,4,7,14,0,1,-1,1,1,1,1,0,0,0,0,0,0,0.5206611570247933,0.4793388429752067
91084,0.5412844036697247,0.504950495049505,-118,-102,0.5162581740877563,0.4837418259122437,away,ARI,over,7,0.5535714285714286,-124,0.5293429871948779,NYM,ARI,2023 REG,10,11,4,1,12,14,1,0,10,-10,1,0,0,0,0,0,0,0,0,0.5293429871948779,0.47065701280512207
91084,0.5412844036697247,0.504950495049505,-118,-102,0.5162581740877563,0.4837418259122437,home,NYM,under,7,0.49019607843137253,104,0.47065701280512207,NYM,ARI,2023 REG,10,11,4,1,12,14,1,0,10,-10,1,0,0,0,0,0,0,0,0,0.5293429871948779,0.47065701280512207
91085,0.6226415094339623,0.4166666666666667,-165,140,0.5981666073335706,0.40183339266642937,away,BAL,over,8.5,0.5348837209302326,-115,0.5097020142727117,MIN,BAL,2023 REG,5,1,5,3,4,10,0,1,-2,2,1,0,0,0,0,0,0,0,0,0.5097020142727117,0.49029798572728833
91085,0.6226415094339623,0.4166666666666667,-165,140,0.5981666073335706,0.40183339266642937,home,MIN,under,8.5,0.5121951219512195,-105,0.49029798572728833,MIN,BAL,2023 REG,5,1,5,3,4,10,0,1,-2,2,1,0,0,0,0,0,0,0,0,0.5097020142727117,0.49029798572728833
91086,0.6296296296296295,0.4098360655737705,-170,144,0.6047808585756369,0.3952191414243631,away,DET,over,7.5,0.5238095238095238,-110,0.4988662131519274,BAL,DET,2023 REG,3,2,7,1,3,10,1,0,1,-1,1,0,0,0,0,0,0,0,0,0.4988662131519274,0.5011337868480725
91086,0.6296296296296295,0.4098360655737705,-170,144,0.6047808585756369,0.3952191414243631,home,BAL,under,7.5,0.5238095238095238,-110,0.5011337868480725,BAL,DET,2023 REG,3,2,7,1,3,10,1,0,1,-1,1,0,0,0,0,0,0,0,0,0.4988662131519274,0.5011337868480725
91087,0.7142857142857143,0.3225806451612903,-250,210,0.6879526003949967,0.3120473996050033,away,PIT,over,8,0.5215311004784688,-109,0.4978845547971712,PHI,PIT,2023 REG,5,2,11,3,5,16,0,1,-1,1,1,1,0,0,0,0,0,0,0,0.4978845547971712,0.5021154452028288
91087,0.7142857142857143,0.3225806451612903,-250,210,0.6879526003949967,0.3120473996050033,home,PHI,under,8,0.5238095238095238,-110,0.5021154452028288,PHI,PIT,2023 REG,5,2,11,3,5,16,0,1,-1,1,1,1,0,0,0,0,0,0,0,0.4978845547971712,0.5021154452028288
91088,0.5918367346938775,0.4444444444444444,-145,125,0.5703642001018094,0.42963579989819056,away,TOR,over,8.5,0.5238095238095238,-110,0.4988662131519274,TEX,TOR,2023 REG,15,11,9,7,18,24,1,0,4,-4,1,1,1,1,1,1,1,0,0,0.4988662131519274,0.5011337868480725
91088,0.5918367346938775,0.4444444444444444,-145,125,0.5703642001018094,0.42963579989819056,home,TEX,under,8.5,0.5238095238095238,-110,0.5011337868480725,TEX,TOR,2023 REG,15,11,9,7,18,24,1,0,4,-4,1,1,1,1,1,1,1,0,0,0.4988662131519274,0.5011337868480725
91089,0.43859649122807015,0.6000000000000001,128,-150,0.4216682056017235,0.5783317943982764,away,TOR,over,9,0.5,100,0.4772727272727273,TEX,TOR,2023 REG,6,1,3,2,3,9,0,1,-1,1,1,0,0,0,0,0,0,0,0,0.4772727272727273,0.5227272727272727
91089,0.43859649122807015,0.6000000000000001,128,-150,0.4216682056017235,0.5783317943982764,home,TEX,under,9,0.5454545454545454,-120,0.5227272727272727,TEX,TOR,2023 REG,6,1,3,2,3,9,0,1,-1,1,1,0,0,0,0,0,0,0,0,0.4772727272727273,0.5227272727272727
91090,0.574468085106383,0.46511627906976744,-135,115,0.5517281312179562,0.44827186878204384,away,TB,over,9,0.5454545454545454,-120,0.5206611570247933,HOU,TB,2023 REG,10,2,12,8,10,22,0,1,-6,6,1,1,0,0,0,0,0,0,0,0.5206611570247933,0.4793388429752067
91090,0.574468085106383,0.46511627906976744,-135,115,0.5517281312179562,0.44827186878204384,home,HOU,under,9,0.5,100,0.4793388429752067,HOU,TB,2023 REG,10,2,12,8,10,22,0,1,-6,6,1,1,0,0,0,0,0,0,0,0.5206611570247933,0.4793388429752067
91091,0.46511627906976744,0.574468085106383,115,-135,0.44670494689481377,0.5532950531051862,away,LAD,over,8.5,0.5238095238095238,-110,0.5000596729920038,LAA,LAD,2023 REG,5,0,6,2,2,11,0,1,-2,2,0,0,0,0,0,0,0,0,0,0.5000596729920038,0.4999403270079962
91091,0.46511627906976744,0.574468085106383,115,-135,0.44670494689481377,0.5532950531051862,home,LAA,under,8.5,0.5215311004784688,-109,0.4999403270079962,LAA,LAD,2023 REG,5,0,6,2,2,11,0,1,-2,2,0,0,0,0,0,0,0,0,0,0.5000596729920038,0.4999403270079962
91092,0.40322580645161293,0.6363636363636364,148,-175,0.387262321445464,0.612737678554536,away,DET,over,8,0.5238095238095238,-110,0.4988662131519274,KC,DET,2023 REG,13,11,11,10,21,24,1,0,1,-1,1,1,1,1,1,1,1,1,1,0.4988662131519274,0.5011337868480725
91092,0.40322580645161293,0.6363636363636364,148,-175,0.387262321445464,0.612737678554536,home,KC,under,8,0.5238095238095238,-110,0.5011337868480725,KC,DET,2023 REG,13,11,11,10,21,24,1,0,1,-1,1,1,1,1,1,1,1,1,1,0.4988662131519274,0.5011337868480725
91093,0.4166666666666667,0.6226415094339623,140,-165,0.4002882599580712,0.5997117400419287,away,SF,over,9.5,0.5348837209302326,-115,0.5109810284308424,WSH,SF,2023 REG,7,5,5,3,8,12,1,0,2,-2,1,1,1,0,0,0,0,0,0,0.5109810284308424,0.48901897156915763
91093,0.4166666666666667,0.6226415094339623,140,-165,0.4002882599580712,0.5997117400419287,home,WSH,under,9.5,0.5098039215686274,-104,0.48901897156915763,WSH,SF,2023 REG,7,5,5,3,8,12,1,0,2,-2,1,1,1,0,0,0,0,0,0,0.5109810284308424,0.48901897156915763
91094,0.6212121212121212,0.4166666666666667,-164,140,0.5976813590449954,0.4023186409550046,away,CLE,over,8.5,0.5121951219512195,-105,0.48919479393107135,TOR,CLE,2023 REG,6,2,8,5,7,14,0,1,-3,3,1,1,0,0,0,0,0,0,0,0.48919479393107135,0.5108052060689287
91094,0.6212121212121212,0.4166666666666667,-164,140,0.5976813590449954,0.4023186409550046,home,TOR,under,8.5,0.5327102803738317,-114,0.5108052060689287,TOR,CLE,2023 REG,6,2,8,5,7,14,0,1,-3,3,1,1,0,0,0,0,0,0,0,0.48919479393107135,0.5108052060689287
91095,0.6000000000000001,0.43859649122807015,-150,128,0.5768421052631579,0.42315789473684207,away,LAA,over,7.5,0.5073891625615764,-103,0.4826927225525911,SD,LAA,2023 REG,11,8,6,5,13,17,1,0,3,-3,1,1,1,1,1,0,0,0,0,0.4826927225525911,0.5173072774474089
91095,0.6000000000000001,0.43859649122807015,-150,128,0.5768421052631579,0.42315789473684207,home,SD,under,7.5,0.5412844036697247,-118,0.5173072774474089,SD,LAA,2023 REG,11,8,6,5,13,17,1,0,3,-3,1,1,1,1,1,0,0,0,0,0.4826927225525911,0.5173072774474089
91096,0.6389891696750902,0.4,-177,150,0.614075512518083,0.385924487481917,away,PIT,over,8.5,0.5348837209302326,-115,0.5097020142727117,MIN,PIT,2023 REG,11,4,8,7,11,19,0,1,-3,3,1,1,1,1,0,0,0,0,0,0.5097020142727117,0.49029798572728833
91096,0.6389891696750902,0.4,-177,150,0.614075512518083,0.385924487481917,home,MIN,under,8.5,0.5121951219512195,-105,0.49029798572728833,MIN,PIT,2023 REG,11,4,8,7,11,19,0,1,-3,3,1,1,1,1,0,0,0,0,0,0.5097020142727117,0.49029798572728833
91097,0.5192307692307692,0.5238095238095238,-108,-110,0.49688292476754015,0.5031170752324599,away,TOR,over,9,0.5,100,0.4772727272727273,BAL,TOR,2023 REG,10,5,6,3,8,16,1,0,2,-2,1,1,1,0,0,0,0,0,0,0.4772727272727273,0.5227272727272727
91097,0.5192307692307692,0.5238095238095238,-108,-110,0.49688292476754015,0.5031170752324599,home,BAL,under,9,0.5454545454545454,-120,0.5227272727272727,BAL,TOR,2023 REG,10,5,6,3,8,16,1,0,2,-2,1,1,1,0,0,0,0,0,0,0.4772727272727273,0.5227272727272727
91098,0.4347826086956522,0.6031746031746031,130,-152,0.418279473099889,0.581720526900111,away,LAA,over,13,0.5121951219512195,-105,0.48808156828023186,COL,LAA,2023 REG,5,4,8,3,7,13,1,0,1,-1,1,1,1,0,0,0,0,0,0,0.48808156828023186,0.5119184317197681
91098,0.4347826086956522,0.6031746031746031,130,-152,0.418279473099889,0.581720526900111,home,COL,under,13,0.5348837209302326,-115,0.5119184317197681,COL,LAA,2023 REG,5,4,8,3,7,13,1,0,1,-1,1,1,1,0,0,0,0,0,0,0.48808156828023186,0.5119184317197681
91099,0.5555555555555556,0.48780487804878053,-125,105,0.5314664257753688,0.46853357422463116,away,NYM,over,10.5,0.5121951219512195,-105,0.48808156828023186,STL,NYM,2023 REG,15,7,7,3,10,22,1,0,4,-4,1,1,1,0,0,0,0,0,0,0.48808156828023186,0.5119184317197681
91099,0.5555555555555556,0.48780487804878053,-125,105,0.5314664257753688,0.46853357422463116,home,STL,under,10.5,0.5348837209302326,-115,0.5119184317197681,STL,NYM,2023 REG,15,7,7,3,10,22,1,0,4,-4,1,1,1,0,0,0,0,0,0,0.48808156828023186,0.5119184317197681
91100,0.5614035087719298,0.47846889952153115,-128,109,0.5390189988527938,0.4609810011472062,away,PHI,over,8.5,0.5238095238095238,-110,0.5000596729920038,TEX,PHI,2023 REG,8,2,9,1,3,17,1,0,1,-1,1,0,0,0,0,0,0,0,0,0.5000596729920038,0.4999403270079962
91100,0.5614035087719298,0.47846889952153115,-128,109,0.5390189988527938,0.4609810011472062,home,TEX,under,8.5,0.5215311004784688,-109,0.4999403270079962,TEX,PHI,2023 REG,8,2,9,1,3,17,1,0,1,-1,1,0,0,0,0,0,0,0,0,0.5000596729920038,0.4999403270079962
91101,0.6000000000000001,0.4424778761061947,-150,126,0.5745132743362832,0.4254867256637168,away,BOS,over,9,0.5348837209302326,-115,0.5097020142727117,MIN,BOS,2023 REG,10,6,3,0,6,13,1,0,6,-6,0,0,0,0,0,0,0,0,0,0.5097020142727117,0.49029798572728833
91101,0.6000000000000001,0.4424778761061947,-150,126,0.5745132743362832,0.4254867256637168,home,MIN,under,9,0.5121951219512195,-105,0.49029798572728833,MIN,BOS,2023 REG,10,6,3,0,6,13,1,0,6,-6,0,0,0,0,0,0,0,0,0,0.5097020142727117,0.49029798572728833
91102,0.5495495495495495,0.49019607843137253,-122,104,0.5277073575960698,0.4722926424039302,away,TEX,over,7.5,0.5,100,0.4772727272727273,CHC,TEX,2023 REG,14,10,7,3,13,21,1,0,7,-7,1,1,1,0,0,0,0,0,0,0.4772727272727273,0.5227272727272727
91102,0.5495495495495495,0.49019607843137253,-122,104,0.5277073575960698,0.4722926424039302,home,CHC,under,7.5,0.5454545454545454,-120,0.5227272727272727,CHC,TEX,2023 REG,14,10,7,3,13,21,1,0,7,-7,1,1,1,0,0,0,0,0,0,0.4772727272727273,0.5227272727272727
91103,0.4854368932038835,0.5535714285714286,106,-124,0.4665008146721786,0.5334991853278215,away,SD,over,8.5,0.5238095238095238,-110,0.5012646084074657,SF,SD,2023 REG,3,0,11,10,10,14,0,1,-10,10,0,0,0,0,0,0,0,0,0,0.5012646084074657,0.4987353915925343
91103,0.4854368932038835,0.5535714285714286,106,-124,0.4665008146721786,0.5334991853278215,home,SF,under,8.5,0.5192307692307692,-108,0.4987353915925343,SF,SD,2023 REG,3,0,11,10,10,14,0,1,-10,10,0,0,0,0,0,0,0,0,0,0.5012646084074657,0.4987353915925343
91104,0.6363636363636364,0.4,-175,150,0.6132231404958678,0.3867768595041322,away,LAA,over,8,0.5283018867924528,-112,0.5031902949311281,SD,LAA,2023 REG,5,5,6,3,8,11,1,0,2,-2,1,1,1,0,0,0,0,0,0,0.5031902949311281,0.4968097050688719
91104,0.6363636363636364,0.4,-175,150,0.6132231404958678,0.3867768595041322,home,SD,under,8,0.5192307692307692,-108,0.4968097050688719,SD,LAA,2023 REG,5,5,6,3,8,11,1,0,2,-2,1,1,1,0,0,0,0,0,0,0.5031902949311281,0.4968097050688719
91105,0.5412844036697247,0.5,-118,100,0.5189377998484975,0.4810622001515025,away,DET,over,9.5,0.5238095238095238,-110,0.4988662131519274,WSH,DET,2023 REG,9,5,6,2,7,15,1,0,3,-3,1,1,0,0,0,0,0,0,0,0.4988662131519274,0.5011337868480725
91105,0.5412844036697247,0.5,-118,100,0.5189377998484975,0.4810622001515025,home,WSH,under,9.5,0.5238095238095238,-110,0.5011337868480725,WSH,DET,2023 REG,9,5,6,2,7,15,1,0,3,-3,1,1,0,0,0,0,0,0,0,0.4988662131519274,0.5011337868480725
91106,0.5652173913043479,0.47619047619047616,-130,110,0.5418129444594474,0.4581870555405526,away,TB,over,8,0.5,100,0.4772727272727273,BAL,TB,2023 REG,4,3,7,4,7,11,0,1,-1,1,1,1,1,0,0,0,0,0,0,0.4772727272727273,0.5227272727272727
91106,0.5652173913043479,0.47619047619047616,-130,110,0.5418129444594474,0.4581870555405526,home,BAL,under,8,0.5454545454545454,-120,0.5227272727272727,BAL,TB,2023 REG,4,3,7,4,7,11,0,1,-1,1,1,1,1,0,0,0,0,0,0,0.4772727272727273,0.5227272727272727
91107,0.6226415094339623,0.4166666666666667,-165,140,0.5981666073335706,0.40183339266642937,away,DET,over,8.5,0.5348837209302326,-115,0.5097020142727117,CWS,DET,2023 REG,4,2,3,1,3,7,1,0,1,-1,1,0,0,0,0,0,0,0,0,0.5097020142727117,0.49029798572728833
91107,0.6226415094339623,0.4166666666666667,-165,140,0.5981666073335706,0.40183339266642937,home,CWS,under,8.5,0.5121951219512195,-105,0.49029798572728833,CWS,DET,2023 REG,4,2,3,1,3,7,1,0,1,-1,1,0,0,0,0,0,0,0,0,0.5097020142727117,0.49029798572728833
91108,0.49019607843137253,0.5495495495495495,104,-122,0.4707129274603323,0.5292870725396677,away,NYY,over,7,0.5348837209302326,-115,0.5097020142727117,MIA,NYY,2023 REG,11,8,6,7,15,17,1,0,1,-1,1,1,1,1,1,1,1,0,0,0.5097020142727117,0.49029798572728833
91108,0.49019607843137253,0.5495495495495495,104,-122,0.4707129274603323,0.5292870725396677,home,MIA,under,7,0.5121951219512195,-105,0.49029798572728833,MIA,NYY,2023 REG,11,8,6,7,15,17,1,0,1,-1,1,1,1,1,1,1,1,0,0,0.5097020142727117,0.49029798572728833
91109,0.425531914893617,0.6108949416342413,135,-157,0.41003112488176247,0.5899688751182375,away,MIL,over,12,0.5192307692307692,-108,0.49688292476754015,COL,MIL,2023 REG,11,9,13,6,15,24,1,0,3,-3,1,1,1,1,1,1,0,0,0,0.49688292476754015,0.5031170752324599
91109,0.425531914893617,0.6108949416342413,135,-157,0.41003112488176247,0.5899688751182375,home,COL,under,12,0.5238095238095238,-110,0.5031170752324599,COL,MIL,2023 REG,11,9,13,6,15,24,1,0,3,-3,1,1,1,1,1,1,0,0,0,0.49688292476754015,0.5031170752324599
91110,0.609375,0.4291845493562232,-156,133,0.5858777746110515,0.4141222253889485,away,STL,over,8.5,0.5348837209302326,-115,0.5097020142727117,ARI,STL,2023 REG,15,7,15,11,18,30,0,1,-4,4,1,1,1,1,1,1,1,0,0,0.5097020142727117,0.49029798572728833
91110,0.609375,0.4291845493562232,-156,133,0.5858777746110515,0.4141222253889485,home,ARI,under,8.5,0.5121951219512195,-105,0.49029798572728833,ARI,STL,2023 REG,15,7,15,11,18,30,0,1,-4,4,1,1,1,1,1,1,1,0,0,0.5097020142727117,0.49029798572728833
91111,0.5689655172413793,0.4694835680751174,-132,113,0.5470893135268209,0.4529106864731791,away,SD,over,7.5,0.5238095238095238,-110,0.5012646084074657,NYM,SD,2023 REG,7,5,2,0,5,9,1,0,5,-5,0,0,0,0,0,0,0,0,0,0.5012646084074657,0.4987353915925343
91111,0.5689655172413793,0.4694835680751174,-132,113,0.5470893135268209,0.4529106864731791,home,NYM,under,7.5,0.5192307692307692,-108,0.4987353915925343,NYM,SD,2023 REG,7,5,2,0,5,9,1,0,5,-5,0,0,0,0,0,0,0,0,0,0.5012646084074657,0.4987353915925343
91112,0.6774193548387096,0.37037037037037035,-210,170,0.6450456700196554,0.3549543299803446,away,LAA,over,8,0.5260663507109005,-111,0.5022370601254724,SEA,LAA,2023 REG,11,8,4,0,8,15,1,0,8,-8,0,0,0,0,0,0,0,0,0,0.5022370601254724,0.4977629398745276
91112,0.6774193548387096,0.37037037037037035,-210,170,0.6450456700196554,0.3549543299803446,home,SEA,under,8,0.5192307692307692,-108,0.4977629398745276,SEA,LAA,2023 REG,11,8,4,0,8,15,1,0,8,-8,0,0,0,0,0,0,0,0,0,0.5022370601254724,0.4977629398745276
91113,0.43103448275862066,0.607843137254902,132,-155,0.4142768879252058,0.5857231120747942,away,MIA,over,9,0.5121951219512195,-105,0.48808156828023186,WSH,MIA,2023 REG,8,2,12,4,6,20,0,1,-2,2,1,1,0,0,0,0,0,0,0,0.48808156828023186,0.5119184317197681
91113,0.43103448275862066,0.607843137254902,132,-155,0.4142768879252058,0.5857231120747942,home,WSH,under,9,0.5348837209302326,-115,0.5119184317197681,WSH,MIA,2023 REG,8,2,12,4,6,20,0,1,-2,2,1,1,0,0,0,0,0,0,0,0.48808156828023186,0.5119184317197681
91114,0.4484304932735426,0.5918367346938775,123,-145,0.43037344037335423,0.5696265596266458,away,SF,over,9.5,0.5121951219512195,-105,0.48808156828023186,ARI,SF,2023 REG,9,2,8,6,8,17,0,1,-4,4,1,1,0,0,0,0,0,0,0,0.48808156828023186,0.5119184317197681
91114,0.4484304932735426,0.5918367346938775,123,-145,0.43037344037335423,0.5696265596266458,home,ARI,under,9.5,0.5348837209302326,-115,0.5119184317197681,ARI,SF,2023 REG,9,2,8,6,8,17,0,1,-4,4,1,1,0,0,0,0,0,0,0,0.48808156828023186,0.5119184317197681
91115,0.5726495726495727,0.46511627906976744,-134,115,0.5510229738017454,0.44897702619825464,away,BOS,over,8,0.5454545454545454,-120,0.5206611570247933,BAL,BOS,2023 REG,7,5,14,2,7,21,1,0,3,-3,1,1,0,0,0,0,0,0,0,0.5206611570247933,0.4793388429752067
91115,0.5726495726495727,0.46511627906976744,-134,115,0.5510229738017454,0.44897702619825464,home,BAL,under,8,0.5,100,0.4793388429752067,BAL,BOS,2023 REG,7,5,14,2,7,21,1,0,3,-3,1,1,0,0,0,0,0,0,0,0.5206611570247933,0.4793388429752067
91116,0.6875,0.35714285714285715,-220,180,0.6568080357142857,0.3431919642857143,away,OAK,over,9,0.5238095238095238,-110,0.4988662131519274,SEA,OAK,2023 REG,5,3,5,2,5,10,1,0,1,-1,1,1,0,0,0,0,0,0,0,0.4988662131519274,0.5011337868480725
91116,0.6875,0.35714285714285715,-220,180,0.6568080357142857,0.3431919642857143,home,SEA,under,9,0.5238095238095238,-110,0.5011337868480725,SEA,OAK,2023 REG,5,3,5,2,5,10,1,0,1,-1,1,1,0,0,0,0,0,0,0,0.4988662131519274,0.5011337868480725
91117,0.6363636363636364,0.4,-175,150,0.6132231404958678,0.3867768595041322,away,TOR,over,7,0.5454545454545454,-120,0.5206611570247933,NYY,TOR,2023 REG,7,3,7,2,5,14,1,0,1,-1,1,1,0,0,0,0,0,0,0,0.5206611570247933,0.4793388429752067
91117,0.6363636363636364,0.4,-175,150,0.6132231404958678,0.3867768595041322,home,NYY,under,7,0.5,100,0.4793388429752067,NYY,TOR,2023 REG,7,3,7,2,5,14,1,0,1,-1,1,1,0,0,0,0,0,0,0,0.5206611570247933,0.4793388429752067
91118,0.6774193548387096,0.3597122302158273,-210,178,0.6522657004469266,0.34773429955307344,away,ARI,over,9,0.5121951219512195,-105,0.48808156828023186,ATL,ARI,2023 REG,8,7,6,5,12,14,1,0,2,-2,1,1,1,1,1,0,0,0,0,0.48808156828023186,0.5119184317197681
91118,0.6774193548387096,0.3597122302158273,-210,178,0.6522657004469266,0.34773429955307344,home,ATL,under,9,0.5348837209302326,-115,0.5119184317197681,ATL,ARI,2023 REG,8,7,6,5,12,14,1,0,2,-2,1,1,1,1,1,0,0,0,0,0.48808156828023186,0.5119184317197681
91119,0.6363636363636364,0.40485829959514175,-175,147,0.6101314952989593,0.38986850470104073,away,MIL,over,8,0.5238095238095238,-110,0.4988662131519274,SD,MIL,2023 REG,5,0,4,1,1,9,0,1,-1,1,0,0,0,0,0,0,0,0,0,0.4988662131519274,0.5011337868480725
91119,0.6363636363636364,0.40485829959514175,-175,147,0.6101314952989593,0.38986850470104073,home,SD,under,8,0.5238095238095238,-110,0.5011337868480725,SD,MIL,2023 REG,5,0,4,1,1,9,0,1,-1,1,0,0,0,0,0,0,0,0,0,0.4988662131519274,0.5011337868480725
91120,0.6453900709219857,0.3921568627450981,-182,155,0.6211576527396834,0.3788423472603166,away,TEX,over,9,0.5348837209302326,-115,0.5109810284308424,SD,TEX,2023 REG,9,4,4,0,4,13,1,0,4,-4,0,0,0,0,0,0,0,0,0,0.5109810284308424,0.48901897156915763
91120,0.6453900709219857,0.3921568627450981,-182,155,0.6211576527396834,0.3788423472603166,home,SD,under,9,0.5098039215686274,-104,0.48901897156915763,SD,TEX,2023 REG,9,4,4,0,4,13,1,0,4,-4,0,0,0,0,0,0,0,0,0,0.5109810284308424,0.48901897156915763
91121,0.4347826086956522,0.607843137254902,130,-155,0.41624967567367205,0.583750324326328,away,LAD,over,9.5,0.5192307692307692,-108,0.49455035168025013,WSH,LAD,2023 REG,6,5,10,8,13,16,0,1,-3,3,1,1,1,1,1,0,0,0,0,0.49455035168025013,0.5054496483197499
91121,0.4347826086956522,0.607843137254902,130,-155,0.41624967567367205,0.583750324326328,home,WSH,under,9.5,0.5283018867924528,-112,0.5054496483197499,WSH,LAD,2023 REG,6,5,10,8,13,16,0,1,-3,3,1,1,1,1,1,0,0,0,0,0.49455035168025013,0.5054496483197499
91122,0.5633187772925764,0.47619047619047616,-129,110,0.5410624729287608,0.45893752707123925,away,CIN,over,9,0.5348837209302326,-115,0.5097020142727117,MIL,CIN,2023 REG,7,1,4,0,1,11,1,0,1,-1,0,0,0,0,0,0,0,0,0,0.5097020142727117,0.49029798572728833
91122,0.5633187772925764,0.47619047619047616,-129,110,0.5410624729287608,0.45893752707123925,home,MIL,under,9,0.5121951219512195,-105,0.49029798572728833,MIL,CIN,2023 REG,7,1,4,0,1,11,1,0,1,-1,0,0,0,0,0,0,0,0,0,0.5097020142727117,0.49029798572728833
91123,0.48780487804878053,0.5495495495495495,105,-122,0.4695832060495952,0.5304167939504048,away,SEA,over,10,0.5121951219512195,-105,0.48808156828023186,BOS,SEA,2023 REG,9,1,15,10,11,24,0,1,-9,9,1,0,0,0,0,0,0,0,0,0.48808156828023186,0.5119184317197681
91123,0.48780487804878053,0.5495495495495495,105,-122,0.4695832060495952,0.5304167939504048,home,BOS,under,10,0.5348837209302326,-115,0.5119184317197681,BOS,SEA,2023 REG,9,1,15,10,11,24,0,1,-9,9,1,0,0,0,0,0,0,0,0,0.48808156828023186,0.5119184317197681
91124,0.7297297297297298,0.3125,-270,220,0.6989134404674946,0.3010865595325054,away,LAA,over,8,0.5348837209302326,-115,0.5109810284308424,MIN,LAA,2023 REG,7,8,9,6,14,16,1,0,2,-2,1,1,1,1,1,1,0,0,0,0.5109810284308424,0.48901897156915763
91124,0.7297297297297298,0.3125,-270,220,0.6989134404674946,0.3010865595325054,home,MIN,under,8,0.5098039215686274,-104,0.48901897156915763,MIN,LAA,2023 REG,7,8,9,6,14,16,1,0,2,-2,1,1,1,1,1,1,0,0,0,0.5109810284308424,0.48901897156915763
91125,0.30303030303030304,0.7368421052631579,230,-280,0.2909477550625876,0.7090522449374124,away,LAD,over,11,0.5391705069124424,-117,0.5153817639191344,COL,LAD,2023 REG,3,0,8,5,5,11,0,1,-5,5,0,0,0,0,0,0,0,0,0,0.5153817639191344,0.4846182360808656
91125,0.30303030303030304,0.7368421052631579,230,-280,0.2909477550625876,0.7090522449374124,home,COL,under,11,0.504950495049505,-102,0.4846182360808656,COL,LAD,2023 REG,3,0,8,5,5,11,0,1,-5,5,0,0,0,0,0,0,0,0,0,0.5153817639191344,0.4846182360808656
91126,0.5283018867924528,0.5192307692307692,-112,-108,0.5031902949311281,0.4968097050688719,away,MIL,over,8.5,0.5412844036697247,-118,0.5149381613977361,STL,MIL,2023 REG,6,0,10,6,6,16,0,1,-6,6,0,0,0,0,0,0,0,0,0,0.5149381613977361,0.48506183860226393
91126,0.5283018867924528,0.5192307692307692,-112,-108,0.5031902949311281,0.4968097050688719,home,STL,under,8.5,0.5073891625615764,-103,0.48506183860226393,STL,MIL,2023 REG,6,0,10,6,6,16,0,1,-6,6,0,0,0,0,0,0,0,0,0,0.5149381613977361,0.48506183860226393
91127,0.4464285714285714,0.5918367346938775,124,-145,0.42934584548104954,0.5706541545189505,away,TOR,over,10,0.5412844036697247,-118,0.5149381613977361,CIN,TOR,2023 REG,4,1,3,0,1,7,1,0,1,-1,0,0,0,0,0,0,0,0,0,0.5149381613977361,0.48506183860226393
91127,0.4464285714285714,0.5918367346938775,124,-145,0.42934584548104954,0.5706541545189505,home,CIN,under,10,0.5073891625615764,-103,0.48506183860226393,CIN,TOR,2023 REG,4,1,3,0,1,7,1,0,1,-1,0,0,0,0,0,0,0,0,0,0.5149381613977361,0.48506183860226393
91128,0.5652173913043479,0.47619047619047616,-130,110,0.5418129444594474,0.4581870555405526,away,ARI,over,9,0.5238095238095238,-110,0.4988662131519274,SF,ARI,2023 REG,6,2,10,5,7,16,0,1,-3,3,1,1,0,0,0,0,0,0,0,0.4988662131519274,0.5011337868480725
91128,0.5652173913043479,0.47619047619047616,-130,110,0.5418129444594474,0.4581870555405526,home,SF,under,9,0.5238095238095238,-110,0.5011337868480725,SF,ARI,2023 REG,6,2,10,5,7,16,0,1,-3,3,1,1,0,0,0,0,0,0,0,0.4988662131519274,0.5011337868480725
91129,0.609375,0.425531914893617,-156,135,0.5881035987367021,0.41189640126329785,away,CWS,over,8,0.5305164319248826,-113,0.5066009958897986,MIN,CWS,2023 REG,9,9,8,4,13,17,1,0,5,-5,1,1,1,1,0,0,0,0,0,0.5066009958897986,0.49339900411020143
91129,0.609375,0.425531914893617,-156,135,0.5881035987367021,0.41189640126329785,home,MIN,under,8,0.5145631067961165,-106,0.49339900411020143,MIN,CWS,2023 REG,9,9,8,4,13,17,1,0,5,-5,1,1,1,1,0,0,0,0,0,0.5066009958897986,0.49339900411020143
91130,0.4,0.6402877697841727,150,-178,0.383884892086331,0.6161151079136691,away,LAD,over,8,0.5238095238095238,-110,0.4988662131519274,SF,LAD,2023 REG,5,2,8,1,3,13,1,0,1,-1,1,0,0,0,0,0,0,0,0,0.4988662131519274,0.5011337868480725
91130,0.4,0.6402877697841727,150,-178,0.383884892086331,0.6161151079136691,home,SF,under,8,0.5238095238095238,-110,0.5011337868480725,SF,LAD,2023 REG,5,2,8,1,3,13,1,0,1,-1,1,0,0,0,0,0,0,0,0,0.4988662131519274,0.5011337868480725
91131,0.6875,0.3508771929824561,-220,185,0.6611156798245614,0.33888432017543857,away,CIN,over,9.5,0.5238095238095238,-110,0.4988662131519274,LAD,CIN,2023 REG,12,5,8,6,11,20,0,1,-1,1,1,1,1,1,1,0,0,0,0,0.4988662131519274,0.5011337868480725
91131,0.6875,0.3508771929824561,-220,185,0.6611156798245614,0.33888432017543857,home,LAD,under,9.5,0.5238095238095238,-110,0.5011337868480725,LAD,CIN,2023 REG,12,5,8,6,11,20,0,1,-1,1,1,1,1,1,1,0,0,0,0,0.4988662131519274,0.5011337868480725
91132,0.47619047619047616,0.5652173913043479,110,-130,0.4564724440500838,0.5435275559499162,away,STL,over,9.5,0.5121951219512195,-105,0.48808156828023186,CIN,STL,2023 REG,7,1,6,2,3,13,0,1,-1,1,1,0,0,0,0,0,0,0,0,0.48808156828023186,0.5119184317197681
91132,0.47619047619047616,0.5652173913043479,110,-130,0.4564724440500838,0.5435275559499162,home,CIN,under,9.5,0.5348837209302326,-115,0.5119184317197681,CIN,STL,2023 REG,7,1,6,2,3,13,0,1,-1,1,1,0,0,0,0,0,0,0,0,0.48808156828023186,0.5119184317197681
91133,0.6551724137931035,0.37878787878787884,-190,164,0.6329225669297013,0.3670774330702987,away,LAA,over,9,0.5348837209302326,-115,0.5097020142727117,TOR,LAA,2023 REG,8,2,8,3,5,16,0,1,-1,1,1,1,0,0,0,0,0,0,0,0.5097020142727117,0.49029798572728833
91133,0.6551724137931035,0.37878787878787884,-190,164,0.6329225669297013,0.3670774330702987,home,TOR,under,9,0.5121951219512195,-105,0.49029798572728833,TOR,LAA,2023 REG,8,2,8,3,5,16,0,1,-1,1,1,1,0,0,0,0,0,0,0,0.5097020142727117,0.49029798572728833
91134,0.7333333333333333,0.3125,-275,220,0.6997222222222221,0.30027777777777787,away,PIT,over,9.5,0.5121951219512195,-105,0.48808156828023186,LAD,PIT,2023 REG,11,7,12,9,16,23,0,1,-2,2,1,1,1,1,1,1,1,0,0,0.48808156828023186,0.5119184317197681
91134,0.7333333333333333,0.3125,-275,220,0.6997222222222221,0.30027777777777787,home,LAD,under,9.5,0.5348837209302326,-115,0.5119184317197681,LAD,PIT,2023 REG,11,7,12,9,16,23,0,1,-2,2,1,1,1,1,1,1,1,0,0,0.48808156828023186,0.5119184317197681
91135,0.49504950495049505,0.5454545454545454,102,-120,0.47499799484898986,0.5250020051510101,away,SD,over,7.5,0.5238095238095238,-110,0.4988662131519274,MIA,SD,2023 REG,4,1,11,10,11,15,0,1,-9,9,1,0,0,0,0,0,0,0,0,0.4988662131519274,0.5011337868480725
91135,0.49504950495049505,0.5454545454545454,102,-120,0.47499799484898986,0.5250020051510101,home,MIA,under,7.5,0.5238095238095238,-110,0.5011337868480725,MIA,SD,2023 REG,4,1,11,10,11,15,0,1,-9,9,1,0,0,0,0,0,0,0,0,0.4988662131519274,0.5011337868480725
91136,0.6183206106870228,0.42016806722689076,-162,138,0.5945222678547557,0.4054777321452443,away,MIA,over,7.5,0.5121951219512195,-105,0.48808156828023186,MIL,MIA,2023 REG,5,3,2,1,4,7,1,0,2,-2,1,0,0,0,0,0,0,0,0,0.48808156828023186,0.5119184317197681
91136,0.6183206106870228,0.42016806722689076,-162,138,0.5945222678547557,0.4054777321452443,home,MIL,under,7.5,0.5348837209302326,-115,0.5119184317197681,MIL,MIA,2023 REG,5,3,2,1,4,7,1,0,2,-2,1,0,0,0,0,0,0,0,0,0.48808156828023186,0.5119184317197681
91137,0.5967741935483871,0.4444444444444444,-148,125,0.5721759741010521,0.42782402589894786,away,PIT,over,8.5,0.5145631067961165,-106,0.49023796582517226,NYM,PIT,2023 REG,7,4,9,7,11,16,0,1,-3,3,1,1,1,1,0,0,0,0,0,0.49023796582517226,0.5097620341748277
91137,0.5967741935483871,0.4444444444444444,-148,125,0.5721759741010521,0.42782402589894786,home,NYM,under,8.5,0.5327102803738317,-114,0.5097620341748277,NYM,PIT,2023 REG,7,4,9,7,11,16,0,1,-3,3,1,1,1,1,0,0,0,0,0,0.49023796582517226,0.5097620341748277
91138,0.576271186440678,0.4629629629629629,-136,116,0.553661676614851,0.446338323385149,away,MIA,over,8,0.5412844036697247,-118,0.5189377998484975,BAL,MIA,2023 REG,11,5,5,2,7,16,1,0,3,-3,1,1,0,0,0,0,0,0,0,0.5189377998484975,0.4810622001515025
91138,0.576271186440678,0.4629629629629629,-136,116,0.553661676614851,0.446338323385149,home,BAL,under,8,0.5,100,0.4810622001515025,BAL,MIA,2023 REG,11,5,5,2,7,16,1,0,3,-3,1,1,0,0,0,0,0,0,0,0.5189377998484975,0.4810622001515025
91139,0.574468085106383,0.46511627906976744,-135,115,0.5517281312179562,0.44827186878204384,away,MIA,over,9.5,0.5348837209302326,-115,0.5097020142727117,BOS,MIA,2023 REG,9,1,19,10,11,28,0,1,-9,9,1,0,0,0,0,0,0,0,0,0.5097020142727117,0.49029798572728833
91139,0.574468085106383,0.46511627906976744,-135,115,0.5517281312179562,0.44827186878204384,home,BOS,under,9.5,0.5121951219512195,-105,0.49029798572728833,BOS,MIA,2023 REG,9,1,19,10,11,28,0,1,-9,9,1,0,0,0,0,0,0,0,0,0.5097020142727117,0.49029798572728833
91140,0.5833333333333333,0.45454545454545453,-140,120,0.5612373737373737,0.4387626262626263,away,NYY,over,8.5,0.5348837209302326,-115,0.5097020142727117,HOU,NYY,2023 REG,7,1,8,6,7,15,0,1,-5,5,1,0,0,0,0,0,0,0,0,0.5097020142727117,0.49029798572728833
91140,0.5833333333333333,0.45454545454545453,-140,120,0.5612373737373737,0.4387626262626263,home,HOU,under,8.5,0.5121951219512195,-105,0.49029798572728833,HOU,NYY,2023 REG,7,1,8,6,7,15,0,1,-5,5,1,0,0,0,0,0,0,0,0,0.5097020142727117,0.49029798572728833
91141,0.37735849056603776,0.6598639455782314,165,-194,0.36331228824744566,0.6366877117525543,away,HOU,over,8.5,0.5238095238095238,-110,0.5000596729920038,OAK,HOU,2023 REG,6,4,6,1,5,12,1,0,3,-3,1,0,0,0,0,0,0,0,0,0.5000596729920038,0.4999403270079962
91141,0.37735849056603776,0.6598639455782314,165,-194,0.36331228824744566,0.6366877117525543,home,OAK,under,8.5,0.5215311004784688,-109,0.4999403270079962,OAK,HOU,2023 REG,6,4,6,1,5,12,1,0,3,-3,1,0,0,0,0,0,0,0,0,0.5000596729920038,0.4999403270079962
91142,0.7647058823529411,0.273972602739726,-325,265,0.735128217282078,0.264871782717922,away,OAK,over,8.5,0.5238095238095238,-110,0.5000596729920038,LAA,OAK,2023 REG,10,8,7,7,15,17,1,0,1,-1,1,1,1,1,1,1,1,0,0,0.5000596729920038,0.4999403270079962
91142,0.7647058823529411,0.273972602739726,-325,265,0.735128217282078,0.264871782717922,home,LAA,under,8.5,0.5215311004784688,-109,0.4999403270079962,LAA,OAK,2023 REG,10,8,7,7,15,17,1,0,1,-1,1,1,1,1,1,1,1,0,0,0.5000596729920038,0.4999403270079962
91143,0.3846153846153846,0.6575342465753424,160,-192,0.3684039880035665,0.6315960119964334,away,BAL,over,8.5,0.5121951219512195,-105,0.48808156828023186,OAK,BAL,2023 REG,4,1,17,12,13,21,0,1,-11,11,1,0,0,0,0,0,0,0,0,0.48808156828023186,0.5119184317197681
91143,0.3846153846153846,0.6575342465753424,160,-192,0.3684039880035665,0.6315960119964334,home,OAK,under,8.5,0.5348837209302326,-115,0.5119184317197681,OAK,BAL,2023 REG,4,1,17,12,13,21,0,1,-11,11,1,0,0,0,0,0,0,0,0,0.48808156828023186,0.5119184317197681
91144,0.4166666666666667,0.6226415094339623,140,-165,0.4002882599580712,0.5997117400419287,away,PIT,over,8.5,0.5098039215686274,-104,0.4870219861770517,WSH,PIT,2023 REG,15,7,6,2,9,21,1,0,5,-5,1,1,0,0,0,0,0,0,0,0.4870219861770517,0.5129780138229483
91144,0.4166666666666667,0.6226415094339623,140,-165,0.4002882599580712,0.5997117400419287,home,WSH,under,8.5,0.5348837209302326,-115,0.5129780138229483,WSH,PIT,2023 REG,15,7,6,2,9,21,1,0,5,-5,1,1,0,0,0,0,0,0,0,0.4870219861770517,0.5129780138229483
91145,0.6453900709219857,0.3891050583657587,-182,157,0.6231272569845053,0.37687274301549467,away,MIN,over,8.5,0.5348837209302326,-115,0.5097020142727117,NYY,MIN,2023 REG,8,3,7,4,7,15,0,1,-1,1,1,1,1,0,0,0,0,0,0,0.5097020142727117,0.49029798572728833
91145,0.6453900709219857,0.3891050583657587,-182,157,0.6231272569845053,0.37687274301549467,home,NYY,under,8.5,0.5121951219512195,-105,0.49029798572728833,NYY,MIN,2023 REG,8,3,7,4,7,15,0,1,-1,1,1,1,1,0,0,0,0,0,0,0.5097020142727117,0.49029798572728833
91146,0.49751243781094534,0.5433789954337899,101,-119,0.4771684411717736,0.5228315588282264,away,MIN,over,7,0.5412844036697247,-118,0.5189377998484975,MIA,MIN,2023 REG,7,5,6,2,7,13,1,0,3,-3,1,1,0,0,0,0,0,0,0,0.5189377998484975,0.4810622001515025
91146,0.49751243781094534,0.5433789954337899,101,-119,0.4771684411717736,0.5228315588282264,home,MIA,under,7,0.5,100,0.4810622001515025,MIA,MIN,2023 REG,7,5,6,2,7,13,1,0,3,-3,1,1,0,0,0,0,0,0,0,0.5189377998484975,0.4810622001515025
91147,0.5726495726495727,0.46511627906976744,-134,115,0.5510229738017454,0.44897702619825464,away,LAA,over,8,0.5433789954337899,-119,0.5198077604720502,TEX,LAA,2023 REG,6,3,8,5,8,14,0,1,-2,2,1,1,1,0,0,0,0,0,0,0.5198077604720502,0.48019223952794976
91147,0.5726495726495727,0.46511627906976744,-134,115,0.5510229738017454,0.44897702619825464,home,TEX,under,8,0.5,100,0.48019223952794976,TEX,LAA,2023 REG,6,3,8,5,8,14,0,1,-2,2,1,1,1,0,0,0,0,0,0,0.5198077604720502,0.48019223952794976
91148,0.6491228070175439,0.3921568627450981,-185,155,0.6223272319084604,0.3776727680915396,away,CLE,over,7.5,0.5348837209302326,-115,0.5097020142727117,HOU,CLE,2023 REG,6,2,0,0,2,6,1,0,2,-2,0,0,0,0,0,0,0,0,0,0.5097020142727117,0.49029798572728833
91148,0.6491228070175439,0.3921568627450981,-185,155,0.6223272319084604,0.3776727680915396,home,HOU,under,7.5,0.5121951219512195,-105,0.49029798572728833,HOU,CLE,2023 REG,6,2,0,0,2,6,1,0,2,-2,0,0,0,0,0,0,0,0,0,0.5097020142727117,0.49029798572728833
91149,0.5652173913043479,0.47619047619047616,-130,110,0.5418129444594474,0.4581870555405526,away,WSH,over,7.5,0.5348837209302326,-115,0.5109810284308424,MIA,WSH,2023 REG,8,4,9,3,7,17,1,0,1,-1,1,1,1,0,0,0,0,0,0,0.5109810284308424,0.48901897156915763
91149,0.5652173913043479,0.47619047619047616,-130,110,0.5418129444594474,0.4581870555405526,home,MIA,under,7.5,0.5098039215686274,-104,0.48901897156915763,MIA,WSH,2023 REG,8,4,9,3,7,17,1,0,1,-1,1,1,1,0,0,0,0,0,0,0.5109810284308424,0.48901897156915763
91150,0.6226415094339623,0.41152263374485604,-165,143,0.6013694957565848,0.3986305042434152,away,CLE,over,7.5,0.5348837209302326,-115,0.5097020142727117,SD,CLE,2023 REG,8,6,9,3,9,17,1,0,3,-3,1,1,1,0,0,0,0,0,0,0.5097020142727117,0.49029798572728833
91150,0.6226415094339623,0.41152263374485604,-165,143,0.6013694957565848,0.3986305042434152,home,SD,under,7.5,0.5121951219512195,-105,0.49029798572728833,SD,CLE,2023 REG,8,6,9,3,9,17,1,0,3,-3,1,1,1,0,0,0,0,0,0,0.5097020142727117,0.49029798572728833
91151,0.4504504504504505,0.5918367346938775,122,-145,0.43140216885390636,0.5685978311460936,away,TEX,over,9.5,0.5283018867924528,-112,0.5044173060022736,BOS,TEX,2023 REG,13,10,12,6,16,25,1,0,4,-4,1,1,1,1,1,1,0,0,0,0.5044173060022736,0.49558269399772636
91151,0.4504504504504505,0.5918367346938775,122,-145,0.43140216885390636,0.5685978311460936,home,BOS,under,9.5,0.5169082125603864,-107,0.49558269399772636,BOS,TEX,2023 REG,13,10,12,6,16,25,1,0,4,-4,1,1,1,1,1,1,0,0,0,0.5044173060022736,0.49558269399772636
91152,0.6363636363636364,0.4016064257028112,-175,149,0.6122008695940788,0.3877991304059212,away,MIA,over,7.5,0.5370370370370371,-116,0.5118817074154765,NYM,MIA,2023 REG,8,5,5,2,7,13,1,0,3,-3,1,1,0,0,0,0,0,0,0,0.5118817074154765,0.48811829258452355
91152,0.6363636363636364,0.4016064257028112,-175,149,0.6122008695940788,0.3877991304059212,home,NYM,under,7.5,0.5098039215686274,-104,0.48811829258452355,NYM,MIA,2023 REG,8,5,5,2,7,13,1,0,3,-3,1,1,0,0,0,0,0,0,0,0.5118817074154765,0.48811829258452355
91153,0.5967741935483871,0.4444444444444444,-148,125,0.5721759741010521,0.42782402589894786,away,WSH,over,9,0.5348837209302326,-115,0.5097020142727117,PIT,WSH,2023 REG,11,5,6,1,6,17,1,0,4,-4,1,0,0,0,0,0,0,0,0,0.5097020142727117,0.49029798572728833
91153,0.5967741935483871,0.4444444444444444,-148,125,0.5721759741010521,0.42782402589894786,home,PIT,under,9,0.5121951219512195,-105,0.49029798572728833,PIT,WSH,2023 REG,11,5,6,1,6,17,1,0,4,-4,1,0,0,0,0,0,0,0,0,0.5097020142727117,0.49029798572728833
91154,0.5815899581589958,0.45248868778280543,-139,121,0.5617701598915884,0.4382298401084116,away,PIT,over,11.5,0.5348837209302326,-115,0.5097020142727117,COL,PIT,2023 REG,10,3,16,14,17,26,0,1,-11,11,1,1,1,0,0,0,0,0,0,0.5097020142727117,0.49029798572728833
91154,0.5815899581589958,0.45248868778280543,-139,121,0.5617701598915884,0.4382298401084116,home,COL,under,11.5,0.5121951219512195,-105,0.49029798572728833,COL,PIT,2023 REG,10,3,16,14,17,26,0,1,-11,11,1,1,1,0,0,0,0,0,0,0.5097020142727117,0.49029798572728833
91155,0.48309178743961345,0.5555555555555556,107,-125,0.4644215734322854,0.5355784265677146,away,PIT,over,9.5,0.5238095238095238,-110,0.5000596729920038,KC,PIT,2023 REG,4,1,6,4,5,10,0,1,-3,3,1,0,0,0,0,0,0,0,0,0.5000596729920038,0.4999403270079962
91155,0.48309178743961345,0.5555555555555556,107,-125,0.4644215734322854,0.5355784265677146,home,KC,under,9.5,0.5215311004784688,-109,0.4999403270079962,KC,PIT,2023 REG,4,1,6,4,5,10,0,1,-3,3,1,0,0,0,0,0,0,0,0,0.5000596729920038,0.4999403270079962
91156,0.4347826086956522,0.6031746031746031,130,-152,0.418279473099889,0.581720526900111,away,NYM,over,8,0.5454545454545454,-120,0.5206611570247933,MIL,NYM,2023 REG,13,9,8,0,9,21,1,0,9,-9,0,0,0,0,0,0,0,0,0,0.5206611570247933,0.4793388429752067
91156,0.4347826086956522,0.6031746031746031,130,-152,0.418279473099889,0.581720526900111,home,MIL,under,8,0.5,100,0.4793388429752067,MIL,NYM,2023 REG,13,9,8,0,9,21,1,0,9,-9,0,0,0,0,0,0,0,0,0,0.5206611570247933,0.4793388429752067
91157,0.35714285714285715,0.6875,180,-220,0.3411989795918367,0.6588010204081634,away,HOU,over,8.5,0.5305164319248826,-113,0.5053568787472517,OAK,HOU,2023 REG,6,1,5,3,4,11,0,1,-2,2,1,0,0,0,0,0,0,0,0,0.5053568787472517,0.49464312125274834
91157,0.35714285714285715,0.6875,180,-220,0.3411989795918367,0.6588010204081634,home,OAK,under,8.5,0.5169082125603864,-107,0.49464312125274834,OAK,HOU,2023 REG,6,1,5,3,4,11,0,1,-2,2,1,0,0,0,0,0,0,0,0,0.5053568787472517,0.49464312125274834
91158,0.7214484679665738,0.3205128205128205,-259,212,0.6911755606792114,0.3088244393207886,away,KC,over,9.5,0.5024875621890548,-101,0.47839724939301687,PHI,KC,2023 REG,9,5,11,7,12,20,0,1,-2,2,1,1,1,1,1,0,0,0,0,0.47839724939301687,0.5216027506069831
91158,0.7214484679665738,0.3205128205128205,-259,212,0.6911755606792114,0.3088244393207886,home,PHI,under,9.5,0.5454545454545454,-120,0.5216027506069831,PHI,KC,2023 REG,9,5,11,7,12,20,0,1,-2,2,1,1,1,1,1,0,0,0,0,0.47839724939301687,0.5216027506069831
91159,0.6527777777777778,0.38167938931297707,-188,162,0.6302849048157573,0.3697150951842427,away,PIT,over,8,0.5412844036697247,-118,0.5149381613977361,TB,PIT,2023 REG,5,3,4,2,5,9,1,0,1,-1,1,1,0,0,0,0,0,0,0,0.5149381613977361,0.48506183860226393
91159,0.6527777777777778,0.38167938931297707,-188,162,0.6302849048157573,0.3697150951842427,home,TB,under,8,0.5073891625615764,-103,0.48506183860226393,TB,PIT,2023 REG,5,3,4,2,5,9,1,0,1,-1,1,1,0,0,0,0,0,0,0,0.5149381613977361,0.48506183860226393
91160,0.504950495049505,0.5412844036697247,-102,-118,0.48160416005266615,0.5183958399473338,away,BAL,over,9,0.5348837209302326,-115,0.5097020142727117,HOU,BAL,2023 REG,5,2,6,1,3,11,1,0,1,-1,1,0,0,0,0,0,0,0,0,0.5097020142727117,0.49029798572728833
91160,0.504950495049505,0.5412844036697247,-102,-118,0.48160416005266615,0.5183958399473338,home,HOU,under,9,0.5121951219512195,-105,0.49029798572728833,HOU,BAL,2023 REG,5,2,6,1,3,11,1,0,1,-1,1,0,0,0,0,0,0,0,0,0.5097020142727117,0.49029798572728833
91161,0.34965034965034963,0.6923076923076923,186,-225,0.33497970560907625,0.6650202943909238,away,NYM,over,8.5,0.5192307692307692,-108,0.49571111079951763,DET,NYM,2023 REG,12,8,5,1,9,17,1,0,7,-7,1,0,0,0,0,0,0,0,0,0.49571111079951763,0.5042888892004824
91161,0.34965034965034963,0.6923076923076923,186,-225,0.33497970560907625,0.6650202943909238,home,DET,under,8.5,0.5260663507109005,-111,0.5042888892004824,DET,NYM,2023 REG,12,8,5,1,9,17,1,0,7,-7,1,0,0,0,0,0,0,0,0,0.49571111079951763,0.5042888892004824
91162,0.5348837209302326,0.5098039215686274,-115,-104,0.5109810284308424,0.48901897156915763,away,SEA,over,7.5,0.49019607843137253,104,0.46874141813588177,HOU,SEA,2023 REG,5,1,13,10,11,18,0,1,-9,9,1,0,0,0,0,0,0,0,0,0.46874141813588177,0.5312585818641182
91162,0.5348837209302326,0.5098039215686274,-115,-104,0.5109810284308424,0.48901897156915763,home,HOU,under,7.5,0.5535714285714286,-124,0.5312585818641182,HOU,SEA,2023 REG,5,1,13,10,11,18,0,1,-9,9,1,0,0,0,0,0,0,0,0,0.46874141813588177,0.5312585818641182
91163,0.3076923076923077,0.7275204359673024,225,-267,0.2968576173355046,0.7031423826644954,away,TB,over,9.5,0.5391705069124424,-117,0.5140669063204599,CIN,TB,2023 REG,5,0,12,8,8,17,0,1,-8,8,0,0,0,0,0,0,0,0,0,0.5140669063204599,0.4859330936795401
91163,0.3076923076923077,0.7275204359673024,225,-267,0.2968576173355046,0.7031423826644954,home,CIN,under,9.5,0.5073891625615764,-103,0.4859330936795401,CIN,TB,2023 REG,5,0,12,8,8,17,0,1,-8,8,0,0,0,0,0,0,0,0,0,0.5140669063204599,0.4859330936795401
91164,0.5,0.5454545454545454,100,-120,0.4772727272727273,0.5227272727272727,away,NYM,over,9,0.5454545454545454,-120,0.5206611570247933,WSH,NYM,2023 REG,4,2,10,3,5,14,0,1,-1,1,1,1,0,0,0,0,0,0,0,0.5206611570247933,0.4793388429752067
91164,0.5,0.5454545454545454,100,-120,0.4772727272727273,0.5227272727272727,home,WSH,under,9,0.5,100,0.4793388429752067,WSH,NYM,2023 REG,4,2,10,3,5,14,0,1,-1,1,1,1,0,0,0,0,0,0,0,0.5206611570247933,0.4793388429752067
91165,0.574468085106383,0.46511627906976744,-135,115,0.5517281312179562,0.44827186878204384,away,NYM,over,11,0.5,100,0.4772727272727273,BOS,NYM,2023 REG,15,6,6,1,7,21,1,0,5,-5,1,0,0,0,0,0,0,0,0,0.4772727272727273,0.5227272727272727
91165,0.574468085106383,0.46511627906976744,-135,115,0.5517281312179562,0.44827186878204384,home,BOS,under,11,0.5454545454545454,-120,0.5227272727272727,BOS,NYM,2023 REG,15,6,6,1,7,21,1,0,5,-5,1,0,0,0,0,0,0,0,0,0.4772727272727273,0.5227272727272727
91166,0.6183206106870228,0.42016806722689076,-162,138,0.5945222678547557,0.4054777321452443,away,PHI,over,8.5,0.5260663507109005,-111,0.5010269332605688,NYY,PHI,2023 REG,4,1,10,4,5,14,0,1,-3,3,1,0,0,0,0,0,0,0,0,0.5010269332605688,0.4989730667394312
91166,0.6183206106870228,0.42016806722689076,-162,138,0.5945222678547557,0.4054777321452443,home,NYY,under,8.5,0.5215311004784688,-109,0.4989730667394312,NYY,PHI,2023 REG,4,1,10,4,5,14,0,1,-3,3,1,0,0,0,0,0,0,0,0,0.5010269332605688,0.4989730667394312
91167,0.7530864197530864,0.2777777777777778,-305,260,0.7298430117360157,0.27015698826398427,away,COL,over,8.5,0.5238095238095238,-110,0.4988662131519274,PHI,COL,2023 REG,8,9,7,3,12,15,1,0,6,-6,1,1,1,0,0,0,0,0,0,0.4988662131519274,0.5011337868480725
91167,0.7530864197530864,0.2777777777777778,-305,260,0.7298430117360157,0.27015698826398427,home,PHI,under,8.5,0.5238095238095238,-110,0.5011337868480725,PHI,COL,2023 REG,8,9,7,3,12,15,1,0,6,-6,1,1,1,0,0,0,0,0,0,0.4988662131519274,0.5011337868480725
91168,0.48780487804878053,0.5555555555555556,105,-125,0.4666534470222751,0.5333465529777248,away,SEA,over,8,0.5391705069124424,-117,0.5140669063204599,TB,SEA,2023 REG,4,0,5,1,1,9,0,1,-1,1,0,0,0,0,0,0,0,0,0,0.5140669063204599,0.4859330936795401
91168,0.48780487804878053,0.5555555555555556,105,-125,0.4666534470222751,0.5333465529777248,home,TB,under,8,0.5073891625615764,-103,0.4859330936795401,TB,SEA,2023 REG,4,0,5,1,1,9,0,1,-1,1,0,0,0,0,0,0,0,0,0,0.5140669063204599,0.4859330936795401
91169,0.4366812227074236,0.601593625498008,129,-151,0.4199673151941347,0.5800326848058652,away,TB,over,8.5,0.5073891625615764,-103,0.4826927225525911,DET,TB,2023 REG,12,4,7,2,6,19,1,0,2,-2,1,1,0,0,0,0,0,0,0,0.4826927225525911,0.5173072774474089
91169,0.4366812227074236,0.601593625498008,129,-151,0.4199673151941347,0.5800326848058652,home,DET,under,8.5,0.5412844036697247,-118,0.5173072774474089,DET,TB,2023 REG,12,4,7,2,6,19,1,0,2,-2,1,1,0,0,0,0,0,0,0,0.4826927225525911,0.5173072774474089
91170,0.37037037037037035,0.6721311475409836,170,-205,0.35462906744023925,0.6453709325597607,away,SD,over,9.5,0.504950495049505,-102,0.4826715732667395,CWS,SD,2023 REG,7,1,7,2,3,14,0,1,-1,1,1,0,0,0,0,0,0,0,0,0.4826715732667395,0.5173284267332605
91170,0.37037037037037035,0.6721311475409836,170,-205,0.35462906744023925,0.6453709325597607,home,CWS,under,9.5,0.5391705069124424,-117,0.5173284267332605,CWS,SD,2023 REG,7,1,7,2,3,14,0,1,-1,1,1,0,0,0,0,0,0,0,0,0.4826715732667395,0.5173284267332605
91171,0.4444444444444444,0.5934959349593496,125,-146,0.42758205359831375,0.5724179464016863,away,TB,over,9,0.5348837209302326,-115,0.5097020142727117,DET,TB,2023 REG,3,0,13,8,8,16,0,1,-8,8,0,0,0,0,0,0,0,0,0,0.5097020142727117,0.49029798572728833
91171,0.4444444444444444,0.5934959349593496,125,-146,0.42758205359831375,0.5724179464016863,home,DET,under,9,0.5121951219512195,-105,0.49029798572728833,DET,TB,2023 REG,3,0,13,8,8,16,0,1,-8,8,0,0,0,0,0,0,0,0,0,0.5097020142727117,0.49029798572728833
91172,0.5555555555555556,0.48780487804878053,-125,105,0.5314664257753688,0.46853357422463116,away,MIL,over,9,0.5454545454545454,-120,0.5206611570247933,CIN,MIL,2023 REG,1,0,7,3,3,8,0,1,-3,3,0,0,0,0,0,0,0,0,0,0.5206611570247933,0.4793388429752067
91172,0.5555555555555556,0.48780487804878053,-125,105,0.5314664257753688,0.46853357422463116,home,CIN,under,9,0.5,100,0.4793388429752067,CIN,MIL,2023 REG,1,0,7,3,3,8,0,1,-3,3,0,0,0,0,0,0,0,0,0,0.5206611570247933,0.4793388429752067
91173,0.574468085106383,0.46511627906976744,-135,115,0.5517281312179562,0.44827186878204384,away,STL,over,10.5,0.5238095238095238,-110,0.4988662131519274,BOS,STL,2023 REG,10,3,4,4,7,14,0,1,-1,1,1,1,1,0,0,0,0,0,0,0.4988662131519274,0.5011337868480725
91173,0.574468085106383,0.46511627906976744,-135,115,0.5517281312179562,0.44827186878204384,home,BOS,under,10.5,0.5238095238095238,-110,0.5011337868480725,BOS,STL,2023 REG,10,3,4,4,7,14,0,1,-1,1,1,1,1,0,0,0,0,0,0,0.4988662131519274,0.5011337868480725
91174,0.5391705069124424,0.504950495049505,-117,-102,0.5153817639191344,0.4846182360808656,away,NYM,over,9.5,0.5283018867924528,-112,0.5031902949311281,KC,NYM,2023 REG,13,9,5,2,11,18,1,0,7,-7,1,1,0,0,0,0,0,0,0,0.5031902949311281,0.4968097050688719
91174,0.5391705069124424,0.504950495049505,-117,-102,0.5153817639191344,0.4846182360808656,home,KC,under,9.5,0.5192307692307692,-108,0.4968097050688719,KC,NYM,2023 REG,13,9,5,2,11,18,1,0,7,-7,1,1,0,0,0,0,0,0,0,0.5031902949311281,0.4968097050688719
91175,0.6825396825396826,0.35714285714285715,-215,180,0.6554547745023935,0.34454522549760647,away,PIT,over,7.5,0.5348837209302326,-115,0.5097020142727117,MIL,PIT,2023 REG,4,1,6,4,5,10,0,1,-3,3,1,0,0,0,0,0,0,0,0,0.5097020142727117,0.49029798572728833
91175,0.6825396825396826,0.35714285714285715,-215,180,0.6554547745023935,0.34454522549760647,home,MIL,under,7.5,0.5121951219512195,-105,0.49029798572728833,MIL,PIT,2023 REG,4,1,6,4,5,10,0,1,-3,3,1,0,0,0,0,0,0,0,0,0.5097020142727117,0.49029798572728833
91176,0.726027397260274,0.3125,-265,220,0.6980554513041847,0.30194454869581533,away,WSH,over,9,0.5348837209302326,-115,0.5097020142727117,PHI,WSH,2023 REG,10,4,8,5,9,18,0,1,-1,1,1,1,1,1,0,0,0,0,0,0.5097020142727117,0.49029798572728833
91176,0.726027397260274,0.3125,-265,220,0.6980554513041847,0.30194454869581533,home,PHI,under,9,0.5121951219512195,-105,0.49029798572728833,PHI,WSH,2023 REG,10,4,8,5,9,18,0,1,-1,1,1,1,1,1,0,0,0,0,0,0.5097020142727117,0.49029798572728833
91177,0.6491228070175439,0.38759689922480617,-185,158,0.6252872082286499,0.3747127917713501,away,ARI,over,7.5,0.5348837209302326,-115,0.5097020142727117,LAD,ARI,2023 REG,16,9,6,1,10,22,1,0,8,-8,1,0,0,0,0,0,0,0,0,0.5097020142727117,0.49029798572728833
91177,0.6491228070175439,0.38759689922480617,-185,158,0.6252872082286499,0.3747127917713501,home,LAD,under,7.5,0.5121951219512195,-105,0.49029798572728833,LAD,ARI,2023 REG,16,9,6,1,10,22,1,0,8,-8,1,0,0,0,0,0,0,0,0,0.5097020142727117,0.49029798572728833
91178,0.7333333333333333,0.3076923076923077,-275,225,0.7032478632478633,0.29675213675213674,away,WSH,over,8,0.5238095238095238,-110,0.5000596729920038,MIL,WSH,2023 REG,14,9,9,5,14,23,1,0,4,-4,1,1,1,1,1,0,0,0,0,0.5000596729920038,0.4999403270079962
91178,0.7333333333333333,0.3076923076923077,-275,225,0.7032478632478633,0.29675213675213674,home,MIL,under,8,0.5215311004784688,-109,0.4999403270079962,MIL,WSH,2023 REG,14,9,9,5,14,23,1,0,4,-4,1,1,1,1,1,0,0,0,0,0.5000596729920038,0.4999403270079962
91179,0.5454545454545454,0.5,-120,100,0.5206611570247933,0.4793388429752067,away,BAL,over,9.5,0.5238095238095238,-110,0.4988662131519274,PHI,BAL,2023 REG,7,2,5,3,5,12,0,1,-1,1,1,1,0,0,0,0,0,0,0,0.4988662131519274,0.5011337868480725
91179,0.5454545454545454,0.5,-120,100,0.5206611570247933,0.4793388429752067,home,PHI,under,9.5,0.5238095238095238,-110,0.5011337868480725,PHI,BAL,2023 REG,7,2,5,3,5,12,0,1,-1,1,1,1,0,0,0,0,0,0,0,0.4988662131519274,0.5011337868480725
91180,0.4716981132075471,0.5652173913043479,112,-130,0.4542851393811816,0.5457148606188185,away,TB,over,8,0.5283018867924528,-112,0.5044173060022736,BAL,TB,2023 REG,7,4,8,2,6,15,1,0,2,-2,1,1,0,0,0,0,0,0,0,0.5044173060022736,0.49558269399772636
91180,0.4716981132075471,0.5652173913043479,112,-130,0.4542851393811816,0.5457148606188185,home,BAL,under,8,0.5169082125603864,-107,0.49558269399772636,BAL,TB,2023 REG,7,4,8,2,6,15,1,0,2,-2,1,1,0,0,0,0,0,0,0,0.5044173060022736,0.49558269399772636
91181,0.6062992125984252,0.4347826086956522,-154,130,0.581391336695717,0.41860866330428304,away,BAL,over,9,0.5024875621890548,-101,0.47839724939301687,MIN,BAL,2023 REG,4,2,17,15,17,21,0,1,-13,13,1,1,0,0,0,0,0,0,0,0.47839724939301687,0.5216027506069831
91181,0.6062992125984252,0.4347826086956522,-154,130,0.581391336695717,0.41860866330428304,home,MIN,under,9,0.5454545454545454,-120,0.5216027506069831,MIN,BAL,2023 REG,4,2,17,15,17,21,0,1,-13,13,1,1,0,0,0,0,0,0,0,0.47839724939301687,0.5216027506069831
91182,0.5633187772925764,0.47619047619047616,-129,110,0.5410624729287608,0.45893752707123925,away,PHI,over,9,0.5024875621890548,-101,0.48049269377245407,ATL,PHI,2023 REG,4,1,9,2,3,13,0,1,-1,1,1,0,0,0,0,0,0,0,0,0.48049269377245407,0.5195073062275459
91182,0.5633187772925764,0.47619047619047616,-129,110,0.5410624729287608,0.45893752707123925,home,ATL,under,9,0.5412844036697247,-118,0.5195073062275459,ATL,PHI,2023 REG,4,1,9,2,3,13,0,1,-1,1,1,0,0,0,0,0,0,0,0,0.48049269377245407,0.5195073062275459
91183,0.4807692307692307,0.5575221238938054,108,-126,0.46235992564277106,0.5376400743572289,away,TB,over,7.5,0.5121951219512195,-105,0.48808156828023186,MIA,TB,2023 REG,4,0,5,3,3,9,0,1,-3,3,0,0,0,0,0,0,0,0,0,0.48808156828023186,0.5119184317197681
91183,0.4807692307692307,0.5575221238938054,108,-126,0.46235992564277106,0.5376400743572289,home,MIA,under,7.5,0.5348837209302326,-115,0.5119184317197681,MIA,TB,2023 REG,4,0,5,3,3,9,0,1,-3,3,0,0,0,0,0,0,0,0,0,0.48808156828023186,0.5119184317197681
91184,0.4,0.6428571428571428,150,-180,0.38285714285714295,0.617142857142857,away,CLE,over,9.5,0.5098039215686274,-104,0.48592421718142587,WSH,CLE,2023 REG,11,4,11,6,10,22,0,1,-2,2,1,1,1,1,0,0,0,0,0,0.48592421718142587,0.5140757828185741
91184,0.4,0.6428571428571428,150,-180,0.38285714285714295,0.617142857142857,home,WSH,under,9.5,0.5370370370370371,-116,0.5140757828185741,WSH,CLE,2023 REG,11,4,11,6,10,22,0,1,-2,2,1,1,1,1,0,0,0,0,0,0.48592421718142587,0.5140757828185741
91185,0.4132231404958678,0.6296296296296295,142,-170,0.3955153842456623,0.6044846157543378,away,SF,over,12,0.5121951219512195,-105,0.48919479393107135,COL,SF,2023 REG,9,9,7,5,14,16,1,0,4,-4,1,1,1,1,1,0,0,0,0,0.48919479393107135,0.5108052060689287
91185,0.4132231404958678,0.6296296296296295,142,-170,0.3955153842456623,0.6044846157543378,home,COL,under,12,0.5327102803738317,-114,0.5108052060689287,COL,SF,2023 REG,9,9,7,5,14,16,1,0,4,-4,1,1,1,1,1,0,0,0,0,0.48919479393107135,0.5108052060689287
91186,0.38759689922480617,0.6491228070175439,158,-185,0.3733644549448255,0.6266355450551745,away,MIN,over,7.5,0.5283018867924528,-112,0.5044173060022736,OAK,MIN,2023 REG,7,4,6,5,9,13,0,1,-1,1,1,1,1,1,0,0,0,0,0,0.5044173060022736,0.49558269399772636
91186,0.38759689922480617,0.6491228070175439,158,-185,0.3733644549448255,0.6266355450551745,home,OAK,under,7.5,0.5169082125603864,-107,0.49558269399772636,OAK,MIN,2023 REG,7,4,6,5,9,13,0,1,-1,1,1,1,1,1,0,0,0,0,0,0.5044173060022736,0.49558269399772636
91187,0.6428571428571428,0.3921568627450981,-180,155,0.6203481392557023,0.3796518607442977,away,CHC,over,8,0.5145631067961165,-106,0.4913668392989033,SD,CHC,2023 REG,10,6,2,0,6,12,1,0,6,-6,0,0,0,0,0,0,0,0,0,0.4913668392989033,0.5086331607010968
91187,0.6428571428571428,0.3921568627450981,-180,155,0.6203481392557023,0.3796518607442977,home,SD,under,8,0.5305164319248826,-113,0.5086331607010968,SD,CHC,2023 REG,10,6,2,0,6,12,1,0,6,-6,0,0,0,0,0,0,0,0,0,0.4913668392989033,0.5086331607010968
91188,0.5454545454545454,0.49504950495049505,-120,102,0.5233614270517961,0.4766385729482039,away,NYY,over,9,0.5121951219512195,-105,0.48919479393107135,BOS,NYY,2023 REG,10,5,6,0,5,16,1,0,5,-5,0,0,0,0,0,0,0,0,0,0.48919479393107135,0.5108052060689287
91188,0.5454545454545454,0.49504950495049505,-120,102,0.5233614270517961,0.4766385729482039,home,BOS,under,9,0.5327102803738317,-114,0.5108052060689287,BOS,NYY,2023 REG,10,5,6,0,5,16,1,0,5,-5,0,0,0,0,0,0,0,0,0,0.48919479393107135,0.5108052060689287
91189,0.5098039215686274,0.5327102803738317,-104,-114,0.4881300146960012,0.5118699853039987,away,PHI,over,9.5,0.5238095238095238,-110,0.5000596729920038,CIN,PHI,2023 REG,14,13,5,0,13,19,1,0,13,-13,0,0,0,0,0,0,0,0,0,0.5000596729920038,0.4999403270079962
91189,0.5098039215686274,0.5327102803738317,-104,-114,0.4881300146960012,0.5118699853039987,home,CIN,under,9.5,0.5215311004784688,-109,0.4999403270079962,CIN,PHI,2023 REG,14,13,5,0,13,19,1,0,13,-13,0,0,0,0,0,0,0,0,0,0.5000596729920038,0.4999403270079962
91190,0.5073891625615764,0.5348837209302326,-103,-115,0.4859403596076043,0.5140596403923957,away,MIN,over,7.5,0.5327102803738317,-114,0.5075272610403079,DET,MIN,2023 REG,11,6,6,0,6,17,1,0,6,-6,0,0,0,0,0,0,0,0,0,0.5075272610403079,0.4924727389596921
91190,0.5073891625615764,0.5348837209302326,-103,-115,0.4859403596076043,0.5140596403923957,home,DET,under,7.5,0.5145631067961165,-106,0.4924727389596921,DET,MIN,2023 REG,11,6,6,0,6,17,1,0,6,-6,0,0,0,0,0,0,0,0,0,0.5075272610403079,0.4924727389596921
91191,0.5348837209302326,0.5098039215686274,-115,-104,0.5109810284308424,0.48901897156915763,away,SF,over,9.5,0.5073891625615764,-103,0.4837652908580103,CIN,SF,2023 REG,12,5,2,1,6,14,1,0,4,-4,1,0,0,0,0,0,0,0,0,0.4837652908580103,0.5162347091419897
91191,0.5348837209302326,0.5098039215686274,-115,-104,0.5109810284308424,0.48901897156915763,home,CIN,under,9.5,0.5391705069124424,-117,0.5162347091419897,CIN,SF,2023 REG,12,5,2,1,6,14,1,0,4,-4,1,0,0,0,0,0,0,0,0,0.4837652908580103,0.5162347091419897
91192,0.6774193548387096,0.36363636363636365,-210,175,0.6496074165168858,0.3503925834831142,away,PIT,over,8.5,0.5169082125603864,-107,0.49353874091423283,LAD,PIT,2023 REG,7,5,4,2,7,11,1,0,3,-3,1,1,0,0,0,0,0,0,0,0.49353874091423283,0.5064612590857671
91192,0.6774193548387096,0.36363636363636365,-210,175,0.6496074165168858,0.3503925834831142,home,LAD,under,8.5,0.5283018867924528,-112,0.5064612590857671,LAD,PIT,2023 REG,7,5,4,2,7,11,1,0,3,-3,1,1,0,0,0,0,0,0,0,0.49353874091423283,0.5064612590857671
91193,0.5652173913043479,0.4716981132075471,-130,112,0.5443521061454507,0.4556478938545493,away,MIN,over,8.5,0.5475113122171946,-121,0.5214983313199976,LAA,MIN,2023 REG,8,2,12,6,8,20,0,1,-4,4,1,1,0,0,0,0,0,0,0,0.5214983313199976,0.47850166868000243
91193,0.5652173913043479,0.4716981132075471,-130,112,0.5443521061454507,0.4556478938545493,home,LAA,under,8.5,0.5,100,0.47850166868000243,LAA,MIN,2023 REG,8,2,12,6,8,20,0,1,-4,4,1,1,0,0,0,0,0,0,0,0.5214983313199976,0.47850166868000243
91194,0.6825396825396826,0.35460992907801414,-215,182,0.6571835984196672,0.3428164015803328,away,COL,over,7,0.5391705069124424,-117,0.5153817639191344,SD,COL,2023 REG,7,2,17,7,9,24,0,1,-5,5,1,1,0,0,0,0,0,0,0,0.5153817639191344,0.4846182360808656
91194,0.6825396825396826,0.35460992907801414,-215,182,0.6571835984196672,0.3428164015803328,home,SD,under,7,0.504950495049505,-102,0.4846182360808656,SD,COL,2023 REG,7,2,17,7,9,24,0,1,-5,5,1,1,0,0,0,0,0,0,0,0.5153817639191344,0.4846182360808656
91195,0.5555555555555556,0.4854368932038835,-125,106,0.5327819729114227,0.4672180270885773,away,MIN,over,7.5,0.5121951219512195,-105,0.48808156828023186,SEA,MIN,2023 REG,8,5,5,0,5,13,1,0,5,-5,0,0,0,0,0,0,0,0,0,0.48808156828023186,0.5119184317197681
91195,0.5555555555555556,0.4854368932038835,-125,106,0.5327819729114227,0.4672180270885773,home,SEA,under,7.5,0.5348837209302326,-115,0.5119184317197681,SEA,MIN,2023 REG,8,5,5,0,5,13,1,0,5,-5,0,0,0,0,0,0,0,0,0,0.48808156828023186,0.5119184317197681
91196,0.6774193548387096,0.35714285714285715,-210,180,0.6540062434963579,0.34599375650364206,away,WSH,over,8,0.5391705069124424,-117,0.5140669063204599,NYM,WSH,2023 REG,4,1,8,4,5,12,0,1,-3,3,1,0,0,0,0,0,0,0,0,0.5140669063204599,0.4859330936795401
91196,0.6774193548387096,0.35714285714285715,-210,180,0.6540062434963579,0.34599375650364206,home,NYM,under,8,0.5073891625615764,-103,0.4859330936795401,NYM,WSH,2023 REG,4,1,8,4,5,12,0,1,-3,3,1,0,0,0,0,0,0,0,0,0.5140669063204599,0.4859330936795401
91197,0.5121951219512195,0.5348837209302326,-105,-115,0.48808156828023186,0.5119184317197681,away,NYM,over,8.5,0.504950495049505,-102,0.47949844489399435,NYY,NYM,2023 REG,5,3,12,9,12,17,0,1,-6,6,1,1,1,0,0,0,0,0,0,0.47949844489399435,0.5205015551060057
91197,0.5121951219512195,0.5348837209302326,-105,-115,0.48808156828023186,0.5119184317197681,home,NYY,under,8.5,0.5454545454545454,-120,0.5205015551060057,NYY,NYM,2023 REG,5,3,12,9,12,17,0,1,-6,6,1,1,1,0,0,0,0,0,0,0.47949844489399435,0.5205015551060057
91198,0.5815899581589958,0.4587155963302753,-139,118,0.5581486524100054,0.44185134758999456,away,SF,over,8,0.5348837209302326,-115,0.5097020142727117,SD,SF,2023 REG,13,7,9,3,10,22,1,0,4,-4,1,1,1,0,0,0,0,0,0,0.5097020142727117,0.49029798572728833
91198,0.5815899581589958,0.4587155963302753,-139,118,0.5581486524100054,0.44185134758999456,home,SD,under,8,0.5121951219512195,-105,0.49029798572728833,SD,SF,2023 REG,13,7,9,3,10,22,1,0,4,-4,1,1,1,0,0,0,0,0,0,0.5097020142727117,0.49029798572728833
91199,0.5348837209302326,0.5098039215686274,-115,-104,0.5109810284308424,0.48901897156915763,away,ARI,over,11,0.5348837209302326,-115,0.5097020142727117,CIN,ARI,2023 REG,9,9,7,6,15,16,1,0,3,-3,1,1,1,1,1,1,0,0,0,0.5097020142727117,0.49029798572728833
91199,0.5348837209302326,0.5098039215686274,-115,-104,0.5109810284308424,0.48901897156915763,home,CIN,under,11,0.5121951219512195,-105,0.49029798572728833,CIN,ARI,2023 REG,9,9,7,6,15,16,1,0,3,-3,1,1,1,1,1,1,0,0,0,0.5097020142727117,0.49029798572728833
91200,0.6666666666666666,0.37037037037037035,-200,170,0.6419753086419753,0.3580246913580247,away,WSH,over,8,0.5238095238095238,-110,0.4988662131519274,HOU,WSH,2023 REG,7,1,11,4,5,18,0,1,-3,3,1,0,0,0,0,0,0,0,0,0.4988662131519274,0.5011337868480725
91200,0.6666666666666666,0.37037037037037035,-200,170,0.6419753086419753,0.3580246913580247,home,HOU,under,8,0.5238095238095238,-110,0.5011337868480725,HOU,WSH,2023 REG,7,1,11,4,5,18,0,1,-3,3,1,0,0,0,0,0,0,0,0,0.4988662131519274,0.5011337868480725
91201,0.7590361445783133,0.28169014084507044,-315,255,0.7281234219075522,0.2718765780924478,away,OAK,over,8.5,0.5348837209302326,-115,0.5097020142727117,HOU,OAK,2023 REG,6,2,10,6,8,16,0,1,-4,4,1,1,0,0,0,0,0,0,0,0.5097020142727117,0.49029798572728833
91201,0.7590361445783133,0.28169014084507044,-315,255,0.7281234219075522,0.2718765780924478,home,HOU,under,8.5,0.5121951219512195,-105,0.49029798572728833,HOU,OAK,2023 REG,6,2,10,6,8,16,0,1,-4,4,1,1,0,0,0,0,0,0,0,0.5097020142727117,0.49029798572728833
91202,0.7198879551820728,0.3205128205128205,-257,212,0.6908039233793066,0.30919607662069337,away,OAK,over,8.5,0.5454545454545454,-120,0.5233614270517961,TEX,OAK,2023 REG,18,18,7,3,21,25,1,0,15,-15,1,1,1,0,0,0,0,0,0,0.5233614270517961,0.4766385729482039
91202,0.7198879551820728,0.3205128205128205,-257,212,0.6908039233793066,0.30919607662069337,home,TEX,under,8.5,0.49504950495049505,102,0.4766385729482039,TEX,OAK,2023 REG,18,18,7,3,21,25,1,0,15,-15,1,1,1,0,0,0,0,0,0,0.5233614270517961,0.4766385729482039
91203,0.4672897196261683,0.574468085106383,114,-135,0.4477767267604901,0.5522232732395099,away,SD,over,8,0.504950495049505,-102,0.48160416005266615,SF,SD,2023 REG,3,0,7,4,4,10,0,1,-4,4,0,0,0,0,0,0,0,0,0,0.48160416005266615,0.5183958399473338
91203,0.4672897196261683,0.574468085106383,114,-135,0.4477767267604901,0.5522232732395099,home,SF,under,8,0.5412844036697247,-118,0.5183958399473338,SF,SD,2023 REG,3,0,7,4,4,10,0,1,-4,4,0,0,0,0,0,0,0,0,0,0.48160416005266615,0.5183958399473338
91204,0.4166666666666667,0.6226415094339623,140,-165,0.4002882599580712,0.5997117400419287,away,TEX,over,9,0.5215311004784688,-109,0.4978845547971712,ARI,TEX,2023 REG,7,4,5,3,7,12,1,0,1,-1,1,1,1,0,0,0,0,0,0,0.4978845547971712,0.5021154452028288
91204,0.4166666666666667,0.6226415094339623,140,-165,0.4002882599580712,0.5997117400419287,home,ARI,under,9,0.5238095238095238,-110,0.5021154452028288,ARI,TEX,2023 REG,7,4,5,3,7,12,1,0,1,-1,1,1,1,0,0,0,0,0,0,0.4978845547971712,0.5021154452028288
91205,0.47619047619047616,0.5652173913043479,110,-130,0.4564724440500838,0.5435275559499162,away,DET,over,7.5,0.5121951219512195,-105,0.48808156828023186,LAA,DET,2023 REG,6,2,15,11,13,21,0,1,-9,9,1,1,0,0,0,0,0,0,0,0.48808156828023186,0.5119184317197681
91205,0.47619047619047616,0.5652173913043479,110,-130,0.4564724440500838,0.5435275559499162,home,LAA,under,7.5,0.5348837209302326,-115,0.5119184317197681,LAA,DET,2023 REG,6,2,15,11,13,21,0,1,-9,9,1,1,0,0,0,0,0,0,0,0.48808156828023186,0.5119184317197681
91206,0.425531914893617,0.6153846153846154,135,-160,0.4081206254135181,0.5918793745864819,away,STL,over,9,0.5121951219512195,-105,0.48808156828023186,WSH,STL,2023 REG,10,3,7,0,3,17,1,0,3,-3,0,0,0,0,0,0,0,0,0,0.48808156828023186,0.5119184317197681
91206,0.425531914893617,0.6153846153846154,135,-160,0.4081206254135181,0.5918793745864819,home,WSH,under,9,0.5348837209302326,-115,0.5119184317197681,WSH,STL,2023 REG,10,3,7,0,3,17,1,0,3,-3,0,0,0,0,0,0,0,0,0,0.48808156828023186,0.5119184317197681
91207,0.5901639344262295,0.4504504504504505,-144,122,0.5661947892531068,0.43380521074689316,away,MIN,over,8,0.5327102803738317,-114,0.5075272610403079,MIL,MIN,2023 REG,11,8,10,7,15,21,1,0,1,-1,1,1,1,1,1,1,1,0,0,0.5075272610403079,0.4924727389596921
91207,0.5901639344262295,0.4504504504504505,-144,122,0.5661947892531068,0.43380521074689316,home,MIL,under,8,0.5145631067961165,-106,0.4924727389596921,MIL,MIN,2023 REG,11,8,10,7,15,21,1,0,1,-1,1,1,1,1,1,1,1,0,0,0.5075272610403079,0.4924727389596921
91208,0.40322580645161293,0.6323529411764706,148,-172,0.3888795372467405,0.6111204627532595,away,TOR,over,10.5,0.5098039215686274,-104,0.4870219861770517,KC,TOR,2023 REG,4,1,11,4,5,15,0,1,-3,3,1,0,0,0,0,0,0,0,0,0.4870219861770517,0.5129780138229483
91208,0.40322580645161293,0.6323529411764706,148,-172,0.3888795372467405,0.6111204627532595,home,KC,under,10.5,0.5348837209302326,-115,0.5129780138229483,KC,TOR,2023 REG,4,1,11,4,5,15,0,1,-3,3,1,0,0,0,0,0,0,0,0,0.4870219861770517,0.5129780138229483
91209,0.5652173913043479,0.47619047619047616,-130,110,0.5418129444594474,0.4581870555405526,away,TOR,over,10,0.5121951219512195,-105,0.48808156828023186,LAD,TOR,2023 REG,8,1,11,8,9,19,0,1,-7,7,1,0,0,0,0,0,0,0,0,0.48808156828023186,0.5119184317197681
91209,0.5652173913043479,0.47619047619047616,-130,110,0.5418129444594474,0.4581870555405526,home,LAD,under,10,0.5348837209302326,-115,0.5119184317197681,LAD,TOR,2023 REG,8,1,11,8,9,19,0,1,-7,7,1,0,0,0,0,0,0,0,0,0.48808156828023186,0.5119184317197681
91210,0.626865671641791,0.41152263374485604,-168,143,0.6028013608024003,0.3971986391975997,away,STL,over,8.5,0.5348837209302326,-115,0.5097020142727117,TB,STL,2023 REG,12,4,6,2,6,18,1,0,2,-2,1,1,0,0,0,0,0,0,0,0.5097020142727117,0.49029798572728833
91210,0.626865671641791,0.41152263374485604,-168,143,0.6028013608024003,0.3971986391975997,home,TB,under,8.5,0.5121951219512195,-105,0.49029798572728833,TB,STL,2023 REG,12,4,6,2,6,18,1,0,2,-2,1,1,0,0,0,0,0,0,0,0.5097020142727117,0.49029798572728833
91211,0.37037037037037035,0.6666666666666666,170,-200,0.35665294924554186,0.6433470507544581,away,TOR,over,12,0.5238095238095238,-110,0.4988662131519274,COL,TOR,2023 REG,11,9,17,13,22,28,0,1,-4,4,1,1,1,1,1,1,1,1,1,0.4988662131519274,0.5011337868480725
91211,0.37037037037037035,0.6666666666666666,170,-200,0.35665294924554186,0.6433470507544581,home,COL,under,12,0.5238095238095238,-110,0.5011337868480725,COL,TOR,2023 REG,11,9,17,13,22,28,0,1,-4,4,1,1,1,1,1,1,1,1,1,0.4988662131519274,0.5011337868480725
91212,0.7142857142857143,0.3333333333333333,-250,200,0.6802721088435374,0.3197278911564626,away,COL,over,8.5,0.5555555555555556,-125,0.5219410829971887,CHC,COL,2023 REG,7,6,6,0,6,13,1,0,6,-6,0,0,0,0,0,0,0,0,0,0.5219410829971887,0.47805891700281133
91212,0.7142857142857143,0.3333333333333333,-250,200,0.6802721088435374,0.3197278911564626,home,CHC,under,8.5,0.504950495049505,-102,0.47805891700281133,CHC,COL,2023 REG,7,6,6,0,6,13,1,0,6,-6,0,0,0,0,0,0,0,0,0,0.5219410829971887,0.47805891700281133
91213,0.5121951219512195,0.5305164319248826,-105,-113,0.4903184724049234,0.5096815275950766,away,BOS,over,9,0.5391705069124424,-117,0.5153817639191344,ARI,BOS,2023 REG,3,1,6,2,3,9,0,1,-1,1,1,0,0,0,0,0,0,0,0,0.5153817639191344,0.4846182360808656
91213,0.5121951219512195,0.5305164319248826,-105,-113,0.4903184724049234,0.5096815275950766,home,ARI,under,9,0.504950495049505,-102,0.4846182360808656,ARI,BOS,2023 REG,3,1,6,2,3,9,0,1,-1,1,1,0,0,0,0,0,0,0,0,0.5153817639191344,0.4846182360808656
91214,0.5121951219512195,0.5348837209302326,-105,-115,0.48808156828023186,0.5119184317197681,away,DET,over,7.5,0.5348837209302326,-115,0.5097020142727117,CLE,DET,2023 REG,4,1,8,4,5,12,0,1,-3,3,1,0,0,0,0,0,0,0,0,0.5097020142727117,0.49029798572728833
91214,0.5121951219512195,0.5348837209302326,-105,-115,0.48808156828023186,0.5119184317197681,home,CLE,under,7.5,0.5121951219512195,-105,0.49029798572728833,CLE,DET,2023 REG,4,1,8,4,5,12,0,1,-3,3,1,0,0,0,0,0,0,0,0,0.5097020142727117,0.49029798572728833
91215,0.5867768595041323,0.45454545454545453,-142,120,0.5625298818386723,0.43747011816132775,away,STL,over,9.5,0.5348837209302326,-115,0.5097020142727117,CIN,STL,2023 REG,10,7,1,1,8,11,1,0,6,-6,1,0,0,0,0,0,0,0,0,0.5097020142727117,0.49029798572728833
91215,0.5867768595041323,0.45454545454545453,-142,120,0.5625298818386723,0.43747011816132775,home,CIN,under,9.5,0.5121951219512195,-105,0.49029798572728833,CIN,STL,2023 REG,10,7,1,1,8,11,1,0,6,-6,1,0,0,0,0,0,0,0,0,0.5097020142727117,0.49029798572728833
91216,0.43859649122807015,0.6000000000000001,128,-150,0.4216682056017235,0.5783317943982764,away,ATL,over,9,0.5121951219512195,-105,0.48808156828023186,CLE,ATL,2023 REG,8,2,7,4,6,15,0,1,-2,2,1,1,0,0,0,0,0,0,0,0.48808156828023186,0.5119184317197681
91216,0.43859649122807015,0.6000000000000001,128,-150,0.4216682056017235,0.5783317943982764,home,CLE,under,9,0.5348837209302326,-115,0.5119184317197681,CLE,ATL,2023 REG,8,2,7,4,6,15,0,1,-2,2,1,1,0,0,0,0,0,0,0,0.48808156828023186,0.5119184317197681
91217,0.4716981132075471,0.5652173913043479,112,-130,0.4542851393811816,0.5457148606188185,away,TB,over,7.5,0.5348837209302326,-115,0.5097020142727117,SEA,TB,2023 REG,6,4,16,15,19,22,0,1,-11,11,1,1,1,1,0,0,0,0,0,0.5097020142727117,0.49029798572728833
91217,0.4716981132075471,0.5652173913043479,112,-130,0.4542851393811816,0.5457148606188185,home,SEA,under,7.5,0.5121951219512195,-105,0.49029798572728833,SEA,TB,2023 REG,6,4,16,15,19,22,0,1,-11,11,1,1,1,1,0,0,0,0,0,0.5097020142727117,0.49029798572728833
91218,0.49019607843137253,0.5475113122171946,104,-121,0.47171206340756505,0.5282879365924349,away,BOS,over,8.5,0.5121951219512195,-105,0.48808156828023186,CWS,BOS,2023 REG,8,1,4,3,4,12,0,1,-2,2,1,0,0,0,0,0,0,0,0,0.48808156828023186,0.5119184317197681
91218,0.49019607843137253,0.5475113122171946,104,-121,0.47171206340756505,0.5282879365924349,home,CWS,under,8.5,0.5348837209302326,-115,0.5119184317197681,CWS,BOS,2023 REG,8,1,4,3,4,12,0,1,-2,2,1,0,0,0,0,0,0,0,0,0.48808156828023186,0.5119184317197681
91219,0.7058823529411764,0.3333333333333333,-240,200,0.6782006920415226,0.32179930795847744,away,KC,over,8.5,0.5,100,0.4804147465437788,MIN,KC,2023 REG,10,2,6,3,5,16,0,1,-1,1,1,1,0,0,0,0,0,0,0,0.4804147465437788,0.5195852534562212
91219,0.7058823529411764,0.3333333333333333,-240,200,0.6782006920415226,0.32179930795847744,home,MIN,under,8.5,0.5391705069124424,-117,0.5195852534562212,MIN,KC,2023 REG,10,2,6,3,5,16,0,1,-1,1,1,1,0,0,0,0,0,0,0,0.4804147465437788,0.5195852534562212
91220,0.5348837209302326,0.5121951219512195,-115,-105,0.5097020142727117,0.49029798572728833,away,LAD,over,8.5,0.5454545454545454,-120,0.5206611570247933,NYM,LAD,2023 REG,6,2,4,1,3,10,1,0,1,-1,1,0,0,0,0,0,0,0,0,0.5206611570247933,0.4793388429752067
91220,0.5348837209302326,0.5121951219512195,-115,-105,0.5097020142727117,0.49029798572728833,home,NYM,under,8.5,0.5,100,0.4793388429752067,NYM,LAD,2023 REG,6,2,4,1,3,10,1,0,1,-1,1,0,0,0,0,0,0,0,0,0.5206611570247933,0.4793388429752067
91221,0.607843137254902,0.4347826086956522,-155,130,0.5819333701084867,0.41806662989151333,away,CWS,over,8.5,0.5348837209302326,-115,0.5097020142727117,MIN,CWS,2023 REG,13,5,11,4,9,24,1,0,1,-1,1,1,1,1,0,0,0,0,0,0.5097020142727117,0.49029798572728833
91221,0.607843137254902,0.4347826086956522,-155,130,0.5819333701084867,0.41806662989151333,home,MIN,under,8.5,0.5121951219512195,-105,0.49029798572728833,MIN,CWS,2023 REG,13,5,11,4,9,24,1,0,1,-1,1,1,1,1,0,0,0,0,0,0.5097020142727117,0.49029798572728833
91222,0.5348837209302326,0.5121951219512195,-115,-105,0.5097020142727117,0.49029798572728833,away,NYY,over,8.5,0.5121951219512195,-105,0.48808156828023186,DET,NYY,2023 REG,7,1,7,4,5,14,0,1,-3,3,1,0,0,0,0,0,0,0,0,0.48808156828023186,0.5119184317197681
91222,0.5348837209302326,0.5121951219512195,-115,-105,0.5097020142727117,0.49029798572728833,home,DET,under,8.5,0.5348837209302326,-115,0.5119184317197681,DET,NYY,2023 REG,7,1,7,4,5,14,0,1,-3,3,1,0,0,0,0,0,0,0,0,0.48808156828023186,0.5119184317197681
91223,0.6503496503496503,0.3921568627450981,-186,155,0.6227055544208978,0.3772944455791022,away,MIA,over,10,0.5121951219512195,-105,0.48808156828023186,ATL,MIA,2023 REG,14,16,8,4,20,22,1,0,12,-12,1,1,1,1,0,0,0,0,0,0.48808156828023186,0.5119184317197681
91223,0.6503496503496503,0.3921568627450981,-186,155,0.6227055544208978,0.3772944455791022,home,ATL,under,10,0.5348837209302326,-115,0.5119184317197681,ATL,MIA,2023 REG,14,16,8,4,20,22,1,0,12,-12,1,1,1,1,0,0,0,0,0,0.48808156828023186,0.5119184317197681
91224,0.6363636363636364,0.4,-175,150,0.6132231404958678,0.3867768595041322,away,WSH,over,9,0.5454545454545454,-120,0.5206611570247933,STL,WSH,2023 REG,13,8,4,4,12,17,1,0,4,-4,1,1,1,1,0,0,0,0,0,0.5206611570247933,0.4793388429752067
91224,0.6363636363636364,0.4,-175,150,0.6132231404958678,0.3867768595041322,home,STL,under,9,0.5,100,0.4793388429752067,STL,WSH,2023 REG,13,8,4,4,12,17,1,0,4,-4,1,1,1,1,0,0,0,0,0,0.5206611570247933,0.4793388429752067
91225,0.5867768595041323,0.45454545454545453,-142,120,0.5625298818386723,0.43747011816132775,away,CHC,over,9.5,0.5192307692307692,-108,0.49455035168025013,ATL,CHC,2023 REG,6,5,6,3,8,12,1,0,2,-2,1,1,1,0,0,0,0,0,0,0.49455035168025013,0.5054496483197499
91225,0.5867768595041323,0.45454545454545453,-142,120,0.5625298818386723,0.43747011816132775,home,ATL,under,9.5,0.5283018867924528,-112,0.5054496483197499,ATL,CHC,2023 REG,6,5,6,3,8,12,1,0,2,-2,1,1,1,0,0,0,0,0,0,0.49455035168025013,0.5054496483197499
91226,0.5594713656387665,0.47619047619047616,-127,110,0.5395195862893665,0.46048041371063353,away,STL,over,9.5,0.5238095238095238,-110,0.4988662131519274,NYM,STL,2023 REG,6,7,8,8,15,14,0,1,-1,1,1,1,1,1,1,1,1,0,0,0.4988662131519274,0.5011337868480725
91226,0.5594713656387665,0.47619047619047616,-127,110,0.5395195862893665,0.46048041371063353,home,NYM,under,9.5,0.5238095238095238,-110,0.5011337868480725,NYM,STL,2023 REG,6,7,8,8,15,14,0,1,-1,1,1,1,1,1,1,1,1,0,0,0.4988662131519274,0.5011337868480725
91227,0.4716981132075471,0.5652173913043479,112,-130,0.4542851393811816,0.5457148606188185,away,CLE,over,8,0.5327102803738317,-114,0.508788710910954,OAK,CLE,2023 REG,4,4,9,6,10,13,0,1,-2,2,1,1,1,1,0,0,0,0,0,0.508788710910954,0.491211289089046
91227,0.4716981132075471,0.5652173913043479,112,-130,0.4542851393811816,0.5457148606188185,home,OAK,under,8,0.5121951219512195,-105,0.491211289089046,OAK,CLE,2023 REG,4,4,9,6,10,13,0,1,-2,2,1,1,1,1,0,0,0,0,0,0.508788710910954,0.491211289089046
91228,0.5145631067961165,0.5238095238095238,-106,-110,0.4948179667757384,0.5051820332242616,away,HOU,over,8,0.5121951219512195,-105,0.48808156828023186,CLE,HOU,2023 REG,14,10,15,9,19,29,1,0,1,-1,1,1,1,1,1,1,1,1,1,0.48808156828023186,0.5119184317197681
91228,0.5145631067961165,0.5238095238095238,-106,-110,0.4948179667757384,0.5051820332242616,home,CLE,under,8,0.5348837209302326,-115,0.5119184317197681,CLE,HOU,2023 REG,14,10,15,9,19,29,1,0,1,-1,1,1,1,1,1,1,1,1,1,0.48808156828023186,0.5119184317197681
91229,0.4672897196261683,0.5780590717299579,114,-137,0.4460986956279785,0.5539013043720216,away,MIA,over,10.5,0.5121951219512195,-105,0.48808156828023186,CIN,MIA,2023 REG,6,5,5,2,7,11,1,0,3,-3,1,1,0,0,0,0,0,0,0,0.48808156828023186,0.5119184317197681
91229,0.4672897196261683,0.5780590717299579,114,-137,0.4460986956279785,0.5539013043720216,home,CIN,under,10.5,0.5348837209302326,-115,0.5119184317197681,CIN,MIA,2023 REG,6,5,5,2,7,11,1,0,3,-3,1,1,0,0,0,0,0,0,0,0.48808156828023186,0.5119184317197681
91230,0.6363636363636364,0.4,-175,150,0.6132231404958678,0.3867768595041322,away,MIA,over,8.5,0.5412844036697247,-118,0.5162581740877563,BAL,MIA,2023 REG,5,5,8,4,9,13,1,0,1,-1,1,1,1,1,0,0,0,0,0,0.5162581740877563,0.4837418259122437
91230,0.6363636363636364,0.4,-175,150,0.6132231404958678,0.3867768595041322,home,BAL,under,8.5,0.504950495049505,-102,0.4837418259122437,BAL,MIA,2023 REG,5,5,8,4,9,13,1,0,1,-1,1,1,1,1,0,0,0,0,0,0.5162581740877563,0.4837418259122437
91231,0.646643109540636,0.3861003861003861,-183,159,0.6254697537020952,0.37453024629790477,away,MIA,over,9,0.5238095238095238,-110,0.5000596729920038,CHC,MIA,2023 REG,10,4,6,2,6,16,1,0,2,-2,1,1,0,0,0,0,0,0,0,0.5000596729920038,0.4999403270079962
91231,0.646643109540636,0.3861003861003861,-183,159,0.6254697537020952,0.37453024629790477,home,CHC,under,9,0.5215311004784688,-109,0.4999403270079962,CHC,MIA,2023 REG,10,4,6,2,6,16,1,0,2,-2,1,1,0,0,0,0,0,0,0,0.5000596729920038,0.4999403270079962
91232,0.48780487804878053,0.5555555555555556,105,-125,0.4666534470222751,0.5333465529777248,away,CHC,over,9,0.5454545454545454,-120,0.5193043049216726,PIT,CHC,2023 REG,5,0,10,8,8,15,0,1,-8,8,0,0,0,0,0,0,0,0,0,0.5193043049216726,0.48069569507832743
91232,0.48780487804878053,0.5555555555555556,105,-125,0.4666534470222751,0.5333465529777248,home,PIT,under,9,0.5024875621890548,-101,0.48069569507832743,PIT,CHC,2023 REG,5,0,10,8,8,15,0,1,-8,8,0,0,0,0,0,0,0,0,0,0.5193043049216726,0.48069569507832743
91233,0.5348837209302326,0.5121951219512195,-115,-105,0.5097020142727117,0.49029798572728833,away,SEA,over,8,0.5238095238095238,-110,0.4988662131519274,MIN,SEA,2023 REG,8,4,9,3,7,17,1,0,1,-1,1,1,1,0,0,0,0,0,0,0.4988662131519274,0.5011337868480725
91233,0.5348837209302326,0.5121951219512195,-115,-105,0.5097020142727117,0.49029798572728833,home,MIN,under,8,0.5238095238095238,-110,0.5011337868480725,MIN,SEA,2023 REG,8,4,9,3,7,17,1,0,1,-1,1,1,1,0,0,0,0,0,0,0.4988662131519274,0.5011337868480725
91234,0.696969696969697,0.34602076124567477,-230,189,0.6670066503347409,0.33299334966525906,away,KC,over,9.5,0.504950495049505,-102,0.48160416005266615,PHI,KC,2023 REG,13,9,6,6,15,19,1,0,3,-3,1,1,1,1,1,1,0,0,0,0.48160416005266615,0.5183958399473338
91234,0.696969696969697,0.34602076124567477,-230,189,0.6670066503347409,0.33299334966525906,home,PHI,under,9.5,0.5412844036697247,-118,0.5183958399473338,PHI,KC,2023 REG,13,9,6,6,15,19,1,0,3,-3,1,1,1,1,1,1,0,0,0,0.48160416005266615,0.5183958399473338
91235,0.7395833333333334,0.29411764705882354,-284,240,0.7146586499183007,0.28534135008169925,away,OAK,over,8.5,0.5454545454545454,-120,0.5206611570247933,LAD,OAK,2023 REG,14,8,5,2,10,19,1,0,6,-6,1,1,0,0,0,0,0,0,0,0.5206611570247933,0.4793388429752067
91235,0.7395833333333334,0.29411764705882354,-284,240,0.7146586499183007,0.28534135008169925,home,LAD,under,8.5,0.5,100,0.4793388429752067,LAD,OAK,2023 REG,14,8,5,2,10,19,1,0,6,-6,1,1,0,0,0,0,0,0,0,0.5206611570247933,0.4793388429752067
91236,0.45248868778280543,0.5901639344262295,121,-144,0.4331888587289435,0.5668111412710565,away,PIT,over,9.5,0.5238095238095238,-110,0.49651307063705985,WSH,PIT,2023 REG,8,3,10,6,9,18,0,1,-3,3,1,1,1,0,0,0,0,0,0,0.49651307063705985,0.5034869293629401
91236,0.45248868778280543,0.5901639344262295,121,-144,0.4331888587289435,0.5668111412710565,home,WSH,under,9.5,0.5283018867924528,-112,0.5034869293629401,WSH,PIT,2023 REG,8,3,10,6,9,18,0,1,-3,3,1,1,1,0,0,0,0,0,0,0.49651307063705985,0.5034869293629401
91237,0.47619047619047616,0.5652173913043479,110,-130,0.4564724440500838,0.5435275559499162,away,HOU,over,9.5,0.5073891625615764,-103,0.4837652908580103,MIL,HOU,2023 REG,9,6,5,0,6,14,1,0,6,-6,0,0,0,0,0,0,0,0,0,0.4837652908580103,0.5162347091419897
91237,0.47619047619047616,0.5652173913043479,110,-130,0.4564724440500838,0.5435275559499162,home,MIL,under,9.5,0.5391705069124424,-117,0.5162347091419897,MIL,HOU,2023 REG,9,6,5,0,6,14,1,0,6,-6,0,0,0,0,0,0,0,0,0,0.4837652908580103,0.5162347091419897
91238,0.607843137254902,0.43103448275862066,-155,132,0.5842116427368785,0.41578835726312147,away,MIN,over,7,0.5192307692307692,-108,0.49571111079951763,MIA,MIN,2023 REG,3,1,3,0,1,6,1,0,1,-1,0,0,0,0,0,0,0,0,0,0.49571111079951763,0.5042888892004824
91238,0.607843137254902,0.43103448275862066,-155,132,0.5842116427368785,0.41578835726312147,home,MIA,under,7,0.5260663507109005,-111,0.5042888892004824,MIA,MIN,2023 REG,3,1,3,0,1,6,1,0,1,-1,0,0,0,0,0,0,0,0,0,0.49571111079951763,0.5042888892004824
91239,0.6108949416342413,0.4291845493562232,-157,133,0.5864105833248914,0.4135894166751086,away,CWS,over,8,0.504950495049505,-102,0.47949844489399435,HOU,CWS,2023 REG,7,6,11,3,9,18,1,0,3,-3,1,1,1,0,0,0,0,0,0,0.47949844489399435,0.5205015551060057
91239,0.6108949416342413,0.4291845493562232,-157,133,0.5864105833248914,0.4135894166751086,home,HOU,under,8,0.5454545454545454,-120,0.5205015551060057,HOU,CWS,2023 REG,7,6,11,3,9,18,1,0,3,-3,1,1,1,0,0,0,0,0,0,0.47949844489399435,0.5205015551060057
91240,0.6551724137931035,0.3846153846153846,-190,160,0.6291045458703008,0.37089545412969915,away,CWS,over,9,0.504950495049505,-102,0.48054649490447493,DET,CWS,2023 REG,6,3,4,1,4,10,1,0,2,-2,1,0,0,0,0,0,0,0,0,0.48054649490447493,0.5194535050955251
91240,0.6551724137931035,0.3846153846153846,-190,160,0.6291045458703008,0.37089545412969915,home,DET,under,9,0.5433789954337899,-119,0.5194535050955251,DET,CWS,2023 REG,6,3,4,1,4,10,1,0,2,-2,1,0,0,0,0,0,0,0,0,0.48054649490447493,0.5194535050955251
91241,0.5215311004784688,0.5169082125603864,-109,-107,0.5014838032476784,0.4985161967523216,away,LAD,over,11,0.5412844036697247,-118,0.5175913212324037,CHC,LAD,2023 REG,6,2,9,6,8,15,0,1,-4,4,1,1,0,0,0,0,0,0,0,0.5175913212324037,0.4824086787675963
91241,0.5215311004784688,0.5169082125603864,-109,-107,0.5014838032476784,0.4985161967523216,home,CHC,under,11,0.5024875621890548,-101,0.4824086787675963,CHC,LAD,2023 REG,6,2,9,6,8,15,0,1,-4,4,1,1,0,0,0,0,0,0,0,0.5175913212324037,0.4824086787675963
91242,0.7058823529411764,0.3333333333333333,-240,200,0.6782006920415226,0.32179930795847744,away,DET,over,7.5,0.5454545454545454,-120,0.5206611570247933,PHI,DET,2023 REG,6,3,5,2,5,11,1,0,1,-1,1,1,0,0,0,0,0,0,0,0.5206611570247933,0.4793388429752067
91242,0.7058823529411764,0.3333333333333333,-240,200,0.6782006920415226,0.32179930795847744,home,PHI,under,7.5,0.5,100,0.4793388429752067,PHI,DET,2023 REG,6,3,5,2,5,11,1,0,1,-1,1,1,0,0,0,0,0,0,0,0.5206611570247933,0.4793388429752067
91243,0.46511627906976744,0.574468085106383,115,-135,0.44670494689481377,0.5532950531051862,away,ARI,over,8,0.5169082125603864,-107,0.49353874091423283,DET,ARI,2023 REG,11,6,11,11,17,22,0,1,-5,5,1,1,1,1,1,1,0,0,0,0.49353874091423283,0.5064612590857671
91243,0.46511627906976744,0.574468085106383,115,-135,0.44670494689481377,0.5532950531051862,home,DET,under,8,0.5283018867924528,-112,0.5064612590857671,DET,ARI,2023 REG,11,6,11,11,17,22,0,1,-5,5,1,1,1,1,1,1,0,0,0,0.49353874091423283,0.5064612590857671
91244,0.7142857142857143,0.3225806451612903,-250,210,0.6879526003949967,0.3120473996050033,away,DET,over,8,0.5169082125603864,-107,0.49353874091423283,MIN,DET,2023 REG,7,1,9,7,8,16,0,1,-6,6,1,0,0,0,0,0,0,0,0,0.49353874091423283,0.5064612590857671
91244,0.7142857142857143,0.3225806451612903,-250,210,0.6879526003949967,0.3120473996050033,home,MIN,under,8,0.5283018867924528,-112,0.5064612590857671,MIN,DET,2023 REG,7,1,9,7,8,16,0,1,-6,6,1,0,0,0,0,0,0,0,0,0.49353874091423283,0.5064612590857671
91245,0.37037037037037035,0.6666666666666666,170,-200,0.35665294924554186,0.6433470507544581,away,LAD,over,12,0.5,100,0.4772727272727273,COL,LAD,2023 REG,9,3,18,14,17,27,0,1,-11,11,1,1,1,0,0,0,0,0,0,0.4772727272727273,0.5227272727272727
91245,0.37037037037037035,0.6666666666666666,170,-200,0.35665294924554186,0.6433470507544581,home,COL,under,12,0.5454545454545454,-120,0.5227272727272727,COL,LAD,2023 REG,9,3,18,14,17,27,0,1,-11,11,1,1,1,0,0,0,0,0,0,0.4772727272727273,0.5227272727272727
91246,0.6183206106870228,0.425531914893617,-162,135,0.5912056902898333,0.4087943097101667,away,CIN,over,11,0.5192307692307692,-108,0.49455035168025013,CHC,CIN,2023 REG,16,16,9,6,22,25,1,0,10,-10,1,1,1,1,1,1,0,0,0,0.49455035168025013,0.5054496483197499
91246,0.6183206106870228,0.425531914893617,-162,135,0.5912056902898333,0.4087943097101667,home,CHC,under,11,0.5283018867924528,-112,0.5054496483197499,CHC,CIN,2023 REG,16,16,9,6,22,25,1,0,10,-10,1,1,1,1,1,1,0,0,0,0.49455035168025013,0.5054496483197499
91247,0.47619047619047616,0.5652173913043479,110,-130,0.4564724440500838,0.5435275559499162,away,CLE,over,9,0.5454545454545454,-120,0.5206611570247933,PIT,CLE,2023 REG,4,0,12,11,11,16,0,1,-11,11,0,0,0,0,0,0,0,0,0,0.5206611570247933,0.4793388429752067
91247,0.47619047619047616,0.5652173913043479,110,-130,0.4564724440500838,0.5435275559499162,home,PIT,under,9,0.5,100,0.4793388429752067,PIT,CLE,2023 REG,4,0,12,11,11,16,0,1,-11,11,0,0,0,0,0,0,0,0,0,0.5206611570247933,0.4793388429752067
91248,0.5145631067961165,0.5283018867924528,-106,-112,0.4925063625223866,0.5074936374776133,away,MIN,over,8,0.5412844036697247,-118,0.5162581740877563,MIL,MIN,2023 REG,8,7,7,3,10,15,1,0,4,-4,1,1,1,0,0,0,0,0,0,0.5162581740877563,0.4837418259122437
91248,0.5145631067961165,0.5283018867924528,-106,-112,0.4925063625223866,0.5074936374776133,home,MIL,under,8,0.504950495049505,-102,0.4837418259122437,MIL,MIN,2023 REG,8,7,7,3,10,15,1,0,4,-4,1,1,1,0,0,0,0,0,0,0.5162581740877563,0.4837418259122437
91249,0.696969696969697,0.3389830508474576,-230,195,0.6719117212183469,0.32808827878165314,away,WSH,over,8.5,0.504950495049505,-102,0.47949844489399435,NYM,WSH,2023 REG,16,9,8,8,17,24,1,0,1,-1,1,1,1,1,1,1,1,1,0,0.47949844489399435,0.5205015551060057
91249,0.696969696969697,0.3389830508474576,-230,195,0.6719117212183469,0.32808827878165314,home,NYM,under,8.5,0.5454545454545454,-120,0.5205015551060057,NYM,WSH,2023 REG,16,9,8,8,17,24,1,0,1,-1,1,1,1,1,1,1,1,1,0,0.47949844489399435,0.5205015551060057
91250,0.6000000000000001,0.4347826086956522,-150,130,0.5791304347826086,0.4208695652173914,away,LAA,over,8.5,0.5412844036697247,-118,0.5175913212324037,STL,LAA,2023 REG,4,1,8,5,6,12,0,1,-4,4,1,0,0,0,0,0,0,0,0,0.5175913212324037,0.4824086787675963
91250,0.6000000000000001,0.4347826086956522,-150,130,0.5791304347826086,0.4208695652173914,home,STL,under,8.5,0.5024875621890548,-101,0.4824086787675963,STL,LAA,2023 REG,4,1,8,5,6,12,0,1,-4,4,1,0,0,0,0,0,0,0,0,0.5175913212324037,0.4824086787675963
91251,0.48780487804878053,0.5555555555555556,105,-125,0.4666534470222751,0.5333465529777248,away,TB,over,9,0.5121951219512195,-105,0.48808156828023186,BOS,TB,2023 REG,6,2,7,6,8,13,0,1,-4,4,1,1,0,0,0,0,0,0,0,0.48808156828023186,0.5119184317197681
91251,0.48780487804878053,0.5555555555555556,105,-125,0.4666534470222751,0.5333465529777248,home,BOS,under,9,0.5348837209302326,-115,0.5119184317197681,BOS,TB,2023 REG,6,2,7,6,8,13,0,1,-4,4,1,1,0,0,0,0,0,0,0,0.48808156828023186,0.5119184317197681
91252,0.6503496503496503,0.3921568627450981,-186,155,0.6227055544208978,0.3772944455791022,away,SEA,over,8.5,0.5348837209302326,-115,0.5097020142727117,HOU,SEA,2023 REG,12,6,15,7,13,27,0,1,-1,1,1,1,1,1,1,1,0,0,0,0.5097020142727117,0.49029798572728833
91252,0.6503496503496503,0.3921568627450981,-186,155,0.6227055544208978,0.3772944455791022,home,HOU,under,8.5,0.5121951219512195,-105,0.49029798572728833,HOU,SEA,2023 REG,12,6,15,7,13,27,0,1,-1,1,1,1,1,1,1,1,0,0,0,0.5097020142727117,0.49029798572728833
91253,0.574468085106383,0.46511627906976744,-135,115,0.5517281312179562,0.44827186878204384,away,CWS,over,9.5,0.504950495049505,-102,0.48160416005266615,CIN,CWS,2023 REG,8,5,8,3,8,16,1,0,2,-2,1,1,1,0,0,0,0,0,0,0.48160416005266615,0.5183958399473338
91253,0.574468085106383,0.46511627906976744,-135,115,0.5517281312179562,0.44827186878204384,home,CIN,under,9.5,0.5412844036697247,-118,0.5183958399473338,CIN,CWS,2023 REG,8,5,8,3,8,16,1,0,2,-2,1,1,1,0,0,0,0,0,0,0.48160416005266615,0.5183958399473338
91254,0.6774193548387096,0.37037037037037035,-210,170,0.6450456700196554,0.3549543299803446,away,LAA,over,7.5,0.5348837209302326,-115,0.5097020142727117,MIN,LAA,2023 REG,5,0,7,1,1,12,0,1,-1,1,0,0,0,0,0,0,0,0,0,0.5097020142727117,0.49029798572728833
91254,0.6774193548387096,0.37037037037037035,-210,170,0.6450456700196554,0.3549543299803446,home,MIN,under,7.5,0.5121951219512195,-105,0.49029798572728833,MIN,LAA,2023 REG,5,0,7,1,1,12,0,1,-1,1,0,0,0,0,0,0,0,0,0,0.5097020142727117,0.49029798572728833
91255,0.5780590717299579,0.4608294930875576,-137,117,0.5555791840506346,0.44442081594936544,away,WSH,over,9.5,0.5098039215686274,-104,0.48592421718142587,CHC,WSH,2023 REG,9,5,11,7,12,20,0,1,-2,2,1,1,1,1,1,0,0,0,0,0.48592421718142587,0.5140757828185741
91255,0.5780590717299579,0.4608294930875576,-137,117,0.5555791840506346,0.44442081594936544,home,CHC,under,9.5,0.5370370370370371,-116,0.5140757828185741,CHC,WSH,2023 REG,9,5,11,7,12,20,0,1,-2,2,1,1,1,1,1,0,0,0,0,0.48592421718142587,0.5140757828185741
91256,0.6666666666666666,0.37735849056603776,-200,165,0.6373165618448637,0.36268343815513626,away,LAA,over,8,0.5475113122171946,-121,0.5214983313199976,SD,LAA,2023 REG,12,10,14,3,13,26,1,0,7,-7,1,1,1,0,0,0,0,0,0,0.5214983313199976,0.47850166868000243
91256,0.6666666666666666,0.37735849056603776,-200,165,0.6373165618448637,0.36268343815513626,home,SD,under,8,0.5,100,0.47850166868000243,SD,LAA,2023 REG,12,10,14,3,13,26,1,0,7,-7,1,1,1,0,0,0,0,0,0,0.5214983313199976,0.47850166868000243
91257,0.5833333333333333,0.4587155963302753,-140,118,0.5588047910295616,0.4411952089704384,away,CWS,over,9,0.5454545454545454,-120,0.5206611570247933,LAA,CWS,2023 REG,11,7,9,9,16,20,0,1,-2,2,1,1,1,1,1,1,1,0,0,0.5206611570247933,0.4793388429752067
91257,0.5833333333333333,0.4587155963302753,-140,118,0.5588047910295616,0.4411952089704384,home,LAA,under,9,0.5,100,0.4793388429752067,LAA,CWS,2023 REG,11,7,9,9,16,20,0,1,-2,2,1,1,1,1,1,1,1,0,0,0.5206611570247933,0.4793388429752067
91258,0.5652173913043479,0.47619047619047616,-130,110,0.5418129444594474,0.4581870555405526,away,KC,over,8.5,0.5238095238095238,-110,0.5000596729920038,OAK,KC,2023 REG,10,6,6,4,10,16,1,0,2,-2,1,1,1,1,0,0,0,0,0,0.5000596729920038,0.4999403270079962
91258,0.5652173913043479,0.47619047619047616,-130,110,0.5418129444594474,0.4581870555405526,home,OAK,under,8.5,0.5215311004784688,-109,0.4999403270079962,OAK,KC,2023 REG,10,6,6,4,10,16,1,0,2,-2,1,1,1,1,0,0,0,0,0,0.5000596729920038,0.4999403270079962
91259,0.504950495049505,0.5348837209302326,-102,-115,0.48483618797062755,0.5151638120293724,away,LAD,over,7.5,0.5327102803738317,-114,0.508788710910954,SD,LAD,2023 REG,8,5,4,2,7,12,1,0,3,-3,1,1,0,0,0,0,0,0,0,0.508788710910954,0.491211289089046
91259,0.504950495049505,0.5348837209302326,-102,-115,0.48483618797062755,0.5151638120293724,home,SD,under,7.5,0.5121951219512195,-105,0.491211289089046,SD,LAD,2023 REG,8,5,4,2,7,12,1,0,3,-3,1,1,0,0,0,0,0,0,0,0.508788710910954,0.491211289089046
91260,0.4166666666666667,0.6240601503759399,140,-166,0.39969715956558066,0.6003028404344193,away,CLE,over,8.5,0.5238095238095238,-110,0.4988662131519274,LAA,CLE,2023 REG,3,2,8,1,3,11,1,0,1,-1,1,0,0,0,0,0,0,0,0,0.4988662131519274,0.5011337868480725
91260,0.4166666666666667,0.6240601503759399,140,-166,0.39969715956558066,0.6003028404344193,home,LAA,under,8.5,0.5238095238095238,-110,0.5011337868480725,LAA,CLE,2023 REG,3,2,8,1,3,11,1,0,1,-1,1,0,0,0,0,0,0,0,0,0.4988662131519274,0.5011337868480725
91261,0.5348837209302326,0.5,-115,100,0.5162249864791779,0.4837750135208221,away,STL,over,8,0.5073891625615764,-103,0.4837652908580103,CLE,STL,2023 REG,7,4,8,3,7,15,1,0,1,-1,1,1,1,0,0,0,0,0,0,0.4837652908580103,0.5162347091419897
91261,0.5348837209302326,0.5,-115,100,0.5162249864791779,0.4837750135208221,home,CLE,under,8,0.5391705069124424,-117,0.5162347091419897,CLE,STL,2023 REG,7,4,8,3,7,15,1,0,1,-1,1,1,1,0,0,0,0,0,0,0.4837652908580103,0.5162347091419897
91262,0.5475113122171946,0.48780487804878053,-121,105,0.5281752985421585,0.4718247014578415,away,LAD,over,8.5,0.5238095238095238,-110,0.4988662131519274,MIL,LAD,2023 REG,8,9,6,3,12,14,1,0,6,-6,1,1,1,0,0,0,0,0,0,0.4988662131519274,0.5011337868480725
91262,0.5475113122171946,0.48780487804878053,-121,105,0.5281752985421585,0.4718247014578415,home,MIL,under,8.5,0.5238095238095238,-110,0.5011337868480725,MIL,LAD,2023 REG,8,9,6,3,12,14,1,0,6,-6,1,1,1,0,0,0,0,0,0,0.4988662131519274,0.5011337868480725
91263,0.5798319327731092,0.4608294930875576,-138,117,0.5562551396270082,0.44374486037299177,away,LAD,over,9,0.5454545454545454,-120,0.5206611570247933,SD,LAD,2023 REG,11,7,14,13,20,25,0,1,-6,6,1,1,1,1,1,1,1,0,0,0.5206611570247933,0.4793388429752067
91263,0.5798319327731092,0.4608294930875576,-138,117,0.5562551396270082,0.44374486037299177,home,SD,under,9,0.5,100,0.4793388429752067,SD,LAD,2023 REG,11,7,14,13,20,25,0,1,-6,6,1,1,1,1,1,1,1,0,0,0.5206611570247933,0.4793388429752067
91264,0.7142857142857143,0.32573289902280134,-250,207,0.6857009904939174,0.3142990095060826,away,OAK,over,9.5,0.5192307692307692,-108,0.49571111079951763,NYY,OAK,2023 REG,10,11,8,3,14,18,1,0,8,-8,1,1,1,0,0,0,0,0,0,0.49571111079951763,0.5042888892004824
91264,0.7142857142857143,0.32573289902280134,-250,207,0.6857009904939174,0.3142990095060826,home,NYY,under,9.5,0.5260663507109005,-111,0.5042888892004824,NYY,OAK,2023 REG,10,11,8,3,14,18,1,0,8,-8,1,1,1,0,0,0,0,0,0,0.49571111079951763,0.5042888892004824
91265,0.6774193548387096,0.36363636363636365,-210,175,0.6496074165168858,0.3503925834831142,away,WSH,over,8,0.5121951219512195,-105,0.48808156828023186,MIA,WSH,2023 REG,7,2,5,3,5,12,0,1,-1,1,1,1,0,0,0,0,0,0,0,0.48808156828023186,0.5119184317197681
91265,0.6774193548387096,0.36363636363636365,-210,175,0.6496074165168858,0.3503925834831142,home,MIA,under,8,0.5348837209302326,-115,0.5119184317197681,MIA,WSH,2023 REG,7,2,5,3,5,12,0,1,-1,1,1,1,0,0,0,0,0,0,0,0.48808156828023186,0.5119184317197681
91266,0.7142857142857143,0.3278688524590164,-250,205,0.6841753094680495,0.3158246905319505,away,KC,over,7.5,0.5,100,0.4772727272727273,TB,KC,2023 REG,17,11,11,3,14,28,1,0,8,-8,1,1,1,0,0,0,0,0,0,0.4772727272727273,0.5227272727272727
91266,0.7142857142857143,0.3278688524590164,-250,205,0.6841753094680495,0.3158246905319505,home,TB,under,7.5,0.5454545454545454,-120,0.5227272727272727,TB,KC,2023 REG,17,11,11,3,14,28,1,0,8,-8,1,1,1,0,0,0,0,0,0,0.4772727272727273,0.5227272727272727
91267,0.4081632653061224,0.6226415094339623,145,-165,0.3955898878611898,0.6044101121388101,away,TEX,over,8.5,0.5454545454545454,-120,0.5206611570247933,OAK,TEX,2023 REG,14,9,12,7,16,26,1,0,2,-2,1,1,1,1,1,1,1,0,0,0.5206611570247933,0.4793388429752067
91267,0.4081632653061224,0.6226415094339623,145,-165,0.3955898878611898,0.6044101121388101,home,OAK,under,8.5,0.5,100,0.4793388429752067,OAK,TEX,2023 REG,14,9,12,7,16,26,1,0,2,-2,1,1,1,1,1,1,1,0,0,0.5206611570247933,0.4793388429752067
91268,0.5348837209302326,0.5121951219512195,-115,-105,0.5097020142727117,0.49029798572728833,away,CIN,over,8,0.5348837209302326,-115,0.5097020142727117,STL,CIN,2023 REG,7,3,10,4,7,17,0,1,-1,1,1,1,1,0,0,0,0,0,0,0.5097020142727117,0.49029798572728833
91268,0.5348837209302326,0.5121951219512195,-115,-105,0.5097020142727117,0.49029798572728833,home,STL,under,8,0.5121951219512195,-105,0.49029798572728833,STL,CIN,2023 REG,7,3,10,4,7,17,0,1,-1,1,1,1,1,0,0,0,0,0,0,0.5097020142727117,0.49029798572728833
91269,0.6363636363636364,0.4081632653061224,-175,145,0.6080283353010626,0.3919716646989374,away,COL,over,8.5,0.5433789954337899,-119,0.5171177654451503,PIT,COL,2023 REG,4,1,11,10,11,15,0,1,-9,9,1,0,0,0,0,0,0,0,0,0.5171177654451503,0.4828822345548497
91269,0.6363636363636364,0.4081632653061224,-175,145,0.6080283353010626,0.3919716646989374,home,PIT,under,8.5,0.504950495049505,-102,0.4828822345548497,PIT,COL,2023 REG,4,1,11,10,11,15,0,1,-9,9,1,0,0,0,0,0,0,0,0,0.5171177654451503,0.4828822345548497
91270,0.3968253968253968,0.6453900709219857,152,-182,0.380073227084372,0.6199267729156279,away,NYY,over,8,0.5098039215686274,-104,0.4870219861770517,TEX,NYY,2023 REG,6,2,8,4,6,14,0,1,-2,2,1,1,0,0,0,0,0,0,0,0.4870219861770517,0.5129780138229483
91270,0.3968253968253968,0.6453900709219857,152,-182,0.380073227084372,0.6199267729156279,home,TEX,under,8,0.5348837209302326,-115,0.5129780138229483,TEX,NYY,2023 REG,6,2,8,4,6,14,0,1,-2,2,1,1,0,0,0,0,0,0,0,0.4870219861770517,0.5129780138229483
91271,0.6226415094339623,0.41152263374485604,-165,143,0.6013694957565848,0.3986305042434152,away,MIN,over,7.5,0.5,100,0.47935779816513757,TB,MIN,2023 REG,7,7,4,0,7,11,1,0,7,-7,0,0,0,0,0,0,0,0,0,0.47935779816513757,0.5206422018348624
91271,0.6226415094339623,0.41152263374485604,-165,143,0.6013694957565848,0.3986305042434152,home,TB,under,7.5,0.5412844036697247,-118,0.5206422018348624,TB,MIN,2023 REG,7,7,4,0,7,11,1,0,7,-7,0,0,0,0,0,0,0,0,0,0.47935779816513757,0.5206422018348624
91272,0.4608294930875576,0.5780590717299579,117,-137,0.44290849547579936,0.5570915045242006,away,TOR,over,8.5,0.5348837209302326,-115,0.5109810284308424,NYY,TOR,2023 REG,6,1,6,5,6,12,0,1,-4,4,1,0,0,0,0,0,0,0,0,0.5109810284308424,0.48901897156915763
91272,0.4608294930875576,0.5780590717299579,117,-137,0.44290849547579936,0.5570915045242006,home,NYY,under,8.5,0.5098039215686274,-104,0.48901897156915763,NYY,TOR,2023 REG,6,1,6,5,6,12,0,1,-4,4,1,0,0,0,0,0,0,0,0,0.5109810284308424,0.48901897156915763
91273,0.5815899581589958,0.4629629629629629,-139,116,0.5556784266278149,0.44432157337218514,away,LAA,over,8.5,0.5121951219512195,-105,0.48808156828023186,NYM,LAA,2023 REG,4,1,6,3,4,10,0,1,-2,2,1,0,0,0,0,0,0,0,0,0.48808156828023186,0.5119184317197681
91273,0.5815899581589958,0.4629629629629629,-139,116,0.5556784266278149,0.44432157337218514,home,NYM,under,8.5,0.5348837209302326,-115,0.5119184317197681,NYM,LAA,2023 REG,4,1,6,3,4,10,0,1,-2,2,1,0,0,0,0,0,0,0,0,0.48808156828023186,0.5119184317197681
91274,0.4166666666666667,0.6226415094339623,140,-165,0.4002882599580712,0.5997117400419287,away,MIL,over,10,0.5348837209302326,-115,0.5097020142727117,CIN,MIL,2023 REG,3,4,7,5,9,10,0,1,-1,1,1,1,1,1,0,0,0,0,0,0.5097020142727117,0.49029798572728833
91274,0.4166666666666667,0.6226415094339623,140,-165,0.4002882599580712,0.5997117400419287,home,CIN,under,10,0.5121951219512195,-105,0.49029798572728833,CIN,MIL,2023 REG,3,4,7,5,9,10,0,1,-1,1,1,1,1,1,0,0,0,0,0,0.5097020142727117,0.49029798572728833
91275,0.6666666666666666,0.37037037037037035,-200,170,0.6419753086419753,0.3580246913580247,away,DET,over,7.5,0.5348837209302326,-115,0.5097020142727117,CLE,DET,2023 REG,7,2,13,6,8,20,0,1,-4,4,1,1,0,0,0,0,0,0,0,0.5097020142727117,0.49029798572728833
91275,0.6666666666666666,0.37037037037037035,-200,170,0.6419753086419753,0.3580246913580247,home,CLE,under,7.5,0.5121951219512195,-105,0.49029798572728833,CLE,DET,2023 REG,7,2,13,6,8,20,0,1,-4,4,1,1,0,0,0,0,0,0,0,0.5097020142727117,0.49029798572728833
91276,0.7402597402597403,0.29850746268656714,-285,235,0.7115619406761102,0.2884380593238898,away,PIT,over,8.5,0.5024875621890548,-101,0.4794401874631478,SD,PIT,2023 REG,11,5,3,1,6,14,1,0,4,-4,1,0,0,0,0,0,0,0,0,0.4794401874631478,0.5205598125368522
91276,0.7402597402597403,0.29850746268656714,-285,235,0.7115619406761102,0.2884380593238898,home,SD,under,8.5,0.5433789954337899,-119,0.5205598125368522,SD,PIT,2023 REG,11,5,3,1,6,14,1,0,4,-4,1,0,0,0,0,0,0,0,0,0.4794401874631478,0.5205598125368522
91277,0.5918367346938775,0.4484304932735426,-145,123,0.5680051099784656,0.43199489002153435,away,CHC,over,9.5,0.5,100,0.4772727272727273,ATL,CHC,2023 REG,8,7,13,6,13,21,1,0,1,-1,1,1,1,1,1,1,0,0,0,0.4772727272727273,0.5227272727272727
91277,0.5918367346938775,0.4484304932735426,-145,123,0.5680051099784656,0.43199489002153435,home,ATL,under,9.5,0.5454545454545454,-120,0.5227272727272727,ATL,CHC,2023 REG,8,7,13,6,13,21,1,0,1,-1,1,1,1,1,1,1,0,0,0,0.4772727272727273,0.5227272727272727
91278,0.5454545454545454,0.49504950495049505,-120,102,0.5233614270517961,0.4766385729482039,away,MIN,over,9,0.5283018867924528,-112,0.5056562298022652,BOS,MIN,2023 REG,14,11,10,5,16,24,1,0,6,-6,1,1,1,1,1,0,0,0,0,0.5056562298022652,0.4943437701977348
91278,0.5454545454545454,0.49504950495049505,-120,102,0.5233614270517961,0.4766385729482039,home,BOS,under,9,0.5145631067961165,-106,0.4943437701977348,BOS,MIN,2023 REG,14,11,10,5,16,24,1,0,6,-6,1,1,1,1,1,0,0,0,0,0.5056562298022652,0.4943437701977348
91279,0.3333333333333333,0.7058823529411764,200,-240,0.32026143790849676,0.6797385620915033,away,LAD,over,9,0.5348837209302326,-115,0.5097020142727117,KC,LAD,2023 REG,7,6,9,4,10,16,1,0,2,-2,1,1,1,1,0,0,0,0,0,0.5097020142727117,0.49029798572728833
91279,0.3333333333333333,0.7058823529411764,200,-240,0.32026143790849676,0.6797385620915033,home,KC,under,9,0.5121951219512195,-105,0.49029798572728833,KC,LAD,2023 REG,7,6,9,4,10,16,1,0,2,-2,1,1,1,1,0,0,0,0,0,0.5097020142727117,0.49029798572728833
91280,0.6296296296296295,0.40322580645161293,-170,148,0.6089428735784769,0.3910571264215231,away,PIT,over,8.5,0.5391705069124424,-117,0.5140669063204599,MIL,PIT,2023 REG,6,5,4,2,7,10,1,0,3,-3,1,1,0,0,0,0,0,0,0,0.5140669063204599,0.4859330936795401
91280,0.6296296296296295,0.40322580645161293,-170,148,0.6089428735784769,0.3910571264215231,home,MIL,under,8.5,0.5073891625615764,-103,0.4859330936795401,MIL,PIT,2023 REG,6,5,4,2,7,10,1,0,3,-3,1,1,0,0,0,0,0,0,0,0.5140669063204599,0.4859330936795401
91281,0.7041420118343195,0.3389830508474576,-238,195,0.6737758434370918,0.32622415656290815,away,CLE,over,8.5,0.5348837209302326,-115,0.5097020142727117,TOR,CLE,2023 REG,8,7,13,10,17,21,0,1,-3,3,1,1,1,1,1,1,1,0,0,0.5097020142727117,0.49029798572728833
91281,0.7041420118343195,0.3389830508474576,-238,195,0.6737758434370918,0.32622415656290815,home,TOR,under,8.5,0.5121951219512195,-105,0.49029798572728833,TOR,CLE,2023 REG,8,7,13,10,17,21,0,1,-3,3,1,1,1,1,1,1,1,0,0,0.5097020142727117,0.49029798572728833
91282,0.7142857142857143,0.3333333333333333,-250,200,0.6802721088435374,0.3197278911564626,away,CWS,over,9,0.5348837209302326,-115,0.5097020142727117,BAL,CWS,2023 REG,14,9,10,3,12,24,1,0,6,-6,1,1,1,0,0,0,0,0,0,0.5097020142727117,0.49029798572728833
91282,0.7142857142857143,0.3333333333333333,-250,200,0.6802721088435374,0.3197278911564626,home,BAL,under,9,0.5121951219512195,-105,0.49029798572728833,BAL,CWS,2023 REG,14,9,10,3,12,24,1,0,6,-6,1,1,1,0,0,0,0,0,0,0.5097020142727117,0.49029798572728833
91283,0.47619047619047616,0.5652173913043479,110,-130,0.4564724440500838,0.5435275559499162,away,CHC,over,9,0.5412844036697247,-118,0.5149381613977361,PIT,CHC,2023 REG,4,1,12,10,11,16,0,1,-9,9,1,0,0,0,0,0,0,0,0,0.5149381613977361,0.48506183860226393
91283,0.47619047619047616,0.5652173913043479,110,-130,0.4564724440500838,0.5435275559499162,home,PIT,under,9,0.5073891625615764,-103,0.48506183860226393,PIT,CHC,2023 REG,4,1,12,10,11,16,0,1,-9,9,1,0,0,0,0,0,0,0,0,0.5149381613977361,0.48506183860226393
91284,0.5833333333333333,0.4608294930875576,-140,117,0.5575716845878136,0.4424283154121864,away,SEA,over,9,0.5495495495495495,-122,0.5236866555946829,LAA,SEA,2023 REG,6,2,16,6,8,22,0,1,-4,4,1,1,0,0,0,0,0,0,0,0.5236866555946829,0.47631334440531714
91284,0.5833333333333333,0.4608294930875576,-140,117,0.5575716845878136,0.4424283154121864,home,LAA,under,9,0.49751243781094534,101,0.47631334440531714,LAA,SEA,2023 REG,6,2,16,6,8,22,0,1,-4,4,1,1,0,0,0,0,0,0,0,0.5236866555946829,0.47631334440531714
91285,0.3076923076923077,0.7333333333333333,225,-275,0.29506903353057207,0.7049309664694279,away,TB,over,9,0.5391705069124424,-117,0.5153817639191344,KC,TB,2023 REG,7,1,8,6,7,15,0,1,-5,5,1,0,0,0,0,0,0,0,0,0.5153817639191344,0.4846182360808656
91285,0.3076923076923077,0.7333333333333333,225,-275,0.29506903353057207,0.7049309664694279,home,KC,under,9,0.504950495049505,-102,0.4846182360808656,KC,TB,2023 REG,7,1,8,6,7,15,0,1,-5,5,1,0,0,0,0,0,0,0,0,0.5153817639191344,0.4846182360808656
91286,0.5833333333333333,0.45454545454545453,-140,120,0.5612373737373737,0.4387626262626263,away,CLE,over,8,0.5348837209302326,-115,0.5097020142727117,MIN,CLE,2023 REG,10,7,9,6,13,19,1,0,1,-1,1,1,1,1,1,1,0,0,0,0.5097020142727117,0.49029798572728833
91286,0.5833333333333333,0.45454545454545453,-140,120,0.5612373737373737,0.4387626262626263,home,MIN,under,8,0.5121951219512195,-105,0.49029798572728833,MIN,CLE,2023 REG,10,7,9,6,13,19,1,0,1,-1,1,1,1,1,1,1,0,0,0,0.5097020142727117,0.49029798572728833
91287,0.3448275862068966,0.696969696969697,190,-230,0.3304147299391057,0.6695852700608943,away,PHI,over,9,0.5121951219512195,-105,0.49145275161909474,WSH,PHI,2023 REG,9,4,6,3,7,15,1,0,1,-1,1,1,1,0,0,0,0,0,0,0.49145275161909474,0.5085472483809053
91287,0.3448275862068966,0.696969696969697,190,-230,0.3304147299391057,0.6695852700608943,home,WSH,under,9,0.5283018867924528,-112,0.5085472483809053,WSH,PHI,2023 REG,9,4,6,3,7,15,1,0,1,-1,1,1,1,0,0,0,0,0,0,0.49145275161909474,0.5085472483809053
91288,0.6515679442508712,0.390625,-187,156,0.6240763743034393,0.3759236256965607,away,COL,over,7.5,0.5098039215686274,-104,0.48592421718142587,CLE,COL,2023 REG,10,4,7,1,5,17,1,0,3,-3,1,0,0,0,0,0,0,0,0,0.48592421718142587,0.5140757828185741
91288,0.6515679442508712,0.390625,-187,156,0.6240763743034393,0.3759236256965607,home,CLE,under,7.5,0.5370370370370371,-116,0.5140757828185741,CLE,COL,2023 REG,10,4,7,1,5,17,1,0,3,-3,1,0,0,0,0,0,0,0,0,0.48592421718142587,0.5140757828185741
91289,0.5121951219512195,0.5238095238095238,-105,-110,0.4937537180249852,0.5062462819750149,away,LAD,over,9,0.5348837209302326,-115,0.5097020142727117,PHI,LAD,2023 REG,8,5,7,4,9,15,1,0,1,-1,1,1,1,1,0,0,0,0,0,0.5097020142727117,0.49029798572728833
91289,0.5121951219512195,0.5238095238095238,-105,-110,0.4937537180249852,0.5062462819750149,home,PHI,under,9,0.5121951219512195,-105,0.49029798572728833,PHI,LAD,2023 REG,8,5,7,4,9,15,1,0,1,-1,1,1,1,1,0,0,0,0,0,0.5097020142727117,0.49029798572728833
91290,0.5121951219512195,0.5283018867924528,-105,-112,0.49145275161909474,0.5085472483809053,away,BOS,over,9.5,0.5,100,0.4772727272727273,LAA,BOS,2023 REG,7,7,8,3,10,15,1,0,4,-4,1,1,1,0,0,0,0,0,0,0.4772727272727273,0.5227272727272727
91290,0.5121951219512195,0.5283018867924528,-105,-112,0.49145275161909474,0.5085472483809053,home,LAA,under,9.5,0.5454545454545454,-120,0.5227272727272727,LAA,BOS,2023 REG,7,7,8,3,10,15,1,0,4,-4,1,1,1,0,0,0,0,0,0,0.4772727272727273,0.5227272727272727
91291,0.3448275862068966,0.6923076923076923,190,-225,0.3320223177535901,0.6679776822464099,away,TOR,over,8,0.5238095238095238,-110,0.4988662131519274,DET,TOR,2023 REG,5,2,0,0,2,5,1,0,2,-2,0,0,0,0,0,0,0,0,0,0.4988662131519274,0.5011337868480725
91291,0.3448275862068966,0.6923076923076923,190,-225,0.3320223177535901,0.6679776822464099,home,DET,under,8,0.5238095238095238,-110,0.5011337868480725,DET,TOR,2023 REG,5,2,0,0,2,5,1,0,2,-2,0,0,0,0,0,0,0,0,0,0.4988662131519274,0.5011337868480725
91292,0.5098039215686274,0.5348837209302326,-104,-115,0.4870219861770517,0.5129780138229483,away,CHC,over,9,0.5348837209302326,-115,0.5097020142727117,NYM,CHC,2023 REG,8,4,7,3,7,15,1,0,1,-1,1,1,1,0,0,0,0,0,0,0.5097020142727117,0.49029798572728833
91292,0.5098039215686274,0.5348837209302326,-104,-115,0.4870219861770517,0.5129780138229483,home,NYM,under,9,0.5121951219512195,-105,0.49029798572728833,NYM,CHC,2023 REG,8,4,7,3,7,15,1,0,1,-1,1,1,1,0,0,0,0,0,0,0.5097020142727117,0.49029798572728833
91293,0.607843137254902,0.4291845493562232,-155,133,0.5853361120599043,0.4146638879400957,away,LAA,over,8.5,0.5121951219512195,-105,0.48808156828023186,NYY,LAA,2023 REG,9,9,7,3,12,16,1,0,6,-6,1,1,1,0,0,0,0,0,0,0.48808156828023186,0.5119184317197681
91293,0.607843137254902,0.4291845493562232,-155,133,0.5853361120599043,0.4146638879400957,home,NYY,under,8.5,0.5348837209302326,-115,0.5119184317197681,NYY,LAA,2023 REG,9,9,7,3,12,16,1,0,6,-6,1,1,1,0,0,0,0,0,0,0.48808156828023186,0.5119184317197681
91294,0.5,0.5412844036697247,100,-118,0.47935779816513757,0.5206422018348624,away,ARI,over,10,0.5121951219512195,-105,0.48808156828023186,WSH,ARI,2023 REG,7,2,15,6,8,22,0,1,-4,4,1,1,0,0,0,0,0,0,0,0.48808156828023186,0.5119184317197681
91294,0.5,0.5412844036697247,100,-118,0.47935779816513757,0.5206422018348624,home,WSH,under,10,0.5348837209302326,-115,0.5119184317197681,WSH,ARI,2023 REG,7,2,15,6,8,22,0,1,-4,4,1,1,0,0,0,0,0,0,0,0.48808156828023186,0.5119184317197681
91295,0.425531914893617,0.613899613899614,135,-159,0.40875254093905067,0.5912474590609493,away,NYY,over,9,0.5283018867924528,-112,0.5031902949311281,CWS,NYY,2023 REG,6,1,13,7,8,19,0,1,-6,6,1,0,0,0,0,0,0,0,0,0.5031902949311281,0.4968097050688719
91295,0.425531914893617,0.613899613899614,135,-159,0.40875254093905067,0.5912474590609493,home,CWS,under,9,0.5192307692307692,-108,0.4968097050688719,CWS,NYY,2023 REG,6,1,13,7,8,19,0,1,-6,6,1,0,0,0,0,0,0,0,0,0.5031902949311281,0.4968097050688719
91296,0.609375,0.43103448275862066,-156,132,0.5847504714439656,0.41524952855603436,away,DET,over,8,0.5121951219512195,-105,0.48808156828023186,TEX,DET,2023 REG,12,5,11,8,13,23,0,1,-3,3,1,1,1,1,1,0,0,0,0,0.48808156828023186,0.5119184317197681
91296,0.609375,0.43103448275862066,-156,132,0.5847504714439656,0.41524952855603436,home,TEX,under,8,0.5348837209302326,-115,0.5119184317197681,TEX,DET,2023 REG,12,5,11,8,13,23,0,1,-3,3,1,1,1,1,1,0,0,0,0,0.48808156828023186,0.5119184317197681
91297,0.5260663507109005,0.5121951219512195,-111,-105,0.5059382774147141,0.4940617225852859,away,SF,over,8.5,0.5215311004784688,-109,0.4978845547971712,MIA,SF,2023 REG,9,4,7,2,6,16,1,0,2,-2,1,1,0,0,0,0,0,0,0,0.4978845547971712,0.5021154452028288
91297,0.5260663507109005,0.5121951219512195,-111,-105,0.5059382774147141,0.4940617225852859,home,MIA,under,8.5,0.5238095238095238,-110,0.5021154452028288,MIA,SF,2023 REG,9,4,7,2,6,16,1,0,2,-2,1,1,0,0,0,0,0,0,0,0.4978845547971712,0.5021154452028288
91298,0.6240601503759399,0.4132231404958678,-166,142,0.6007931342679697,0.39920686573203035,away,LAD,over,9,0.5,100,0.4772727272727273,SD,LAD,2023 REG,11,8,6,3,11,17,1,0,5,-5,1,1,1,0,0,0,0,0,0,0.4772727272727273,0.5227272727272727
91298,0.6240601503759399,0.4132231404958678,-166,142,0.6007931342679697,0.39920686573203035,home,SD,under,9,0.5454545454545454,-120,0.5227272727272727,SD,LAD,2023 REG,11,8,6,3,11,17,1,0,5,-5,1,1,1,0,0,0,0,0,0,0.4772727272727273,0.5227272727272727
91299,0.5515695067264574,0.49019607843137253,-123,104,0.5285328835228112,0.47146711647718875,away,PHI,over,9,0.5073891625615764,-103,0.4837652908580103,LAD,PHI,2023 REG,11,10,10,6,16,21,1,0,4,-4,1,1,1,1,1,1,0,0,0,0.4837652908580103,0.5162347091419897
91299,0.5515695067264574,0.49019607843137253,-123,104,0.5285328835228112,0.47146711647718875,home,LAD,under,9,0.5391705069124424,-117,0.5162347091419897,LAD,PHI,2023 REG,11,10,10,6,16,21,1,0,4,-4,1,1,1,1,1,1,0,0,0,0.4837652908580103,0.5162347091419897
91300,0.6774193548387096,0.36363636363636365,-210,175,0.6496074165168858,0.3503925834831142,away,MIN,over,7.5,0.5169082125603864,-107,0.49353874091423283,TOR,MIN,2023 REG,12,7,10,6,13,22,1,0,1,-1,1,1,1,1,1,1,0,0,0,0.49353874091423283,0.5064612590857671
91300,0.6774193548387096,0.36363636363636365,-210,175,0.6496074165168858,0.3503925834831142,home,TOR,under,7.5,0.5283018867924528,-112,0.5064612590857671,TOR,MIN,2023 REG,12,7,10,6,13,22,1,0,1,-1,1,1,1,1,1,1,0,0,0,0.49353874091423283,0.5064612590857671
91301,0.4424778761061947,0.6000000000000001,126,-150,0.42368235570522356,0.5763176442947764,away,CLE,over,9,0.5,100,0.4772727272727273,KC,CLE,2023 REG,10,6,8,2,8,18,1,0,4,-4,1,1,0,0,0,0,0,0,0,0.4772727272727273,0.5227272727272727
91301,0.4424778761061947,0.6000000000000001,126,-150,0.42368235570522356,0.5763176442947764,home,KC,under,9,0.5454545454545454,-120,0.5227272727272727,KC,CLE,2023 REG,10,6,8,2,8,18,1,0,4,-4,1,1,0,0,0,0,0,0,0,0.4772727272727273,0.5227272727272727
91302,0.4444444444444444,0.5901639344262295,125,-144,0.4290629427241449,0.5709370572758551,away,MIN,over,7.5,0.5305164319248826,-113,0.5066009958897986,CWS,MIN,2023 REG,7,3,5,7,10,12,0,1,-4,4,1,1,1,0,0,0,0,0,0,0.5066009958897986,0.49339900411020143
91302,0.4444444444444444,0.5901639344262295,125,-144,0.4290629427241449,0.5709370572758551,home,CWS,under,7.5,0.5145631067961165,-106,0.49339900411020143,CWS,MIN,2023 REG,7,3,5,7,10,12,0,1,-4,4,1,1,1,0,0,0,0,0,0,0.5066009958897986,0.49339900411020143
91303,0.5327102803738317,0.5121951219512195,-114,-105,0.508788710910954,0.491211289089046,away,BAL,over,8.5,0.5121951219512195,-105,0.48808156828023186,SD,BAL,2023 REG,13,10,11,3,13,24,1,0,7,-7,1,1,1,0,0,0,0,0,0,0.48808156828023186,0.5119184317197681
91303,0.5327102803738317,0.5121951219512195,-114,-105,0.508788710910954,0.491211289089046,home,SD,under,8.5,0.5348837209302326,-115,0.5119184317197681,SD,BAL,2023 REG,13,10,11,3,13,24,1,0,7,-7,1,1,1,0,0,0,0,0,0,0.48808156828023186,0.5119184317197681
91304,0.3125,0.7297297297297298,220,-270,0.29930320945945943,0.7006967905405406,away,TEX,over,8.5,0.5283018867924528,-112,0.5031902949311281,OAK,TEX,2023 REG,7,2,4,0,2,11,1,0,2,-2,0,0,0,0,0,0,0,0,0,0.5031902949311281,0.4968097050688719
91304,0.3125,0.7297297297297298,220,-270,0.29930320945945943,0.7006967905405406,home,OAK,under,8.5,0.5192307692307692,-108,0.4968097050688719,OAK,TEX,2023 REG,7,2,4,0,2,11,1,0,2,-2,0,0,0,0,0,0,0,0,0,0.5031902949311281,0.4968097050688719
91305,0.5652173913043479,0.47619047619047616,-130,110,0.5418129444594474,0.4581870555405526,away,LAA,over,7.5,0.5073891625615764,-103,0.4859403596076043,HOU,LAA,2023 REG,10,6,9,2,8,19,1,0,4,-4,1,1,0,0,0,0,0,0,0,0.4859403596076043,0.5140596403923957
91305,0.5652173913043479,0.47619047619047616,-130,110,0.5418129444594474,0.4581870555405526,home,HOU,under,7.5,0.5348837209302326,-115,0.5140596403923957,HOU,LAA,2023 REG,10,6,9,2,8,19,1,0,4,-4,1,1,0,0,0,0,0,0,0,0.4859403596076043,0.5140596403923957
91306,0.5121951219512195,0.5348837209302326,-105,-115,0.48808156828023186,0.5119184317197681,away,CIN,over,10,0.5169082125603864,-107,0.49353874091423283,KC,CIN,2023 REG,8,4,5,5,9,13,0,1,-1,1,1,1,1,1,0,0,0,0,0,0.49353874091423283,0.5064612590857671
91306,0.5121951219512195,0.5348837209302326,-105,-115,0.48808156828023186,0.5119184317197681,home,KC,under,10,0.5283018867924528,-112,0.5064612590857671,KC,CIN,2023 REG,8,4,5,5,9,13,0,1,-1,1,1,1,1,1,0,0,0,0,0,0.49353874091423283,0.5064612590857671
91307,0.4347826086956522,0.607843137254902,130,-155,0.41624967567367205,0.583750324326328,away,HOU,over,8.5,0.5454545454545454,-120,0.5206611570247933,CWS,HOU,2023 REG,3,1,8,5,6,11,0,1,-4,4,1,0,0,0,0,0,0,0,0,0.5206611570247933,0.4793388429752067
91307,0.4347826086956522,0.607843137254902,130,-155,0.41624967567367205,0.583750324326328,home,CWS,under,8.5,0.5,100,0.4793388429752067,CWS,HOU,2023 REG,3,1,8,5,6,11,0,1,-4,4,1,0,0,0,0,0,0,0,0,0.5206611570247933,0.4793388429752067
91308,0.4484304932735426,0.5901639344262295,123,-144,0.43112357502252374,0.5688764249774763,away,BAL,over,9,0.49751243781094534,101,0.476135829221149,WSH,BAL,2023 REG,6,0,4,4,4,10,0,1,-4,4,0,0,0,0,0,0,0,0,0,0.476135829221149,0.523864170778851
91308,0.4484304932735426,0.5901639344262295,123,-144,0.43112357502252374,0.5688764249774763,home,WSH,under,9,0.5454545454545454,-120,0.523864170778851,WSH,BAL,2023 REG,6,0,4,4,4,10,0,1,-4,4,0,0,0,0,0,0,0,0,0,0.476135829221149,0.523864170778851
91309,0.5238095238095238,0.5215311004784688,-110,-109,0.5000596729920038,0.4999403270079962,away,ATL,over,9,0.5454545454545454,-120,0.5206611570247933,LAD,ATL,2023 REG,11,3,5,1,4,16,1,0,2,-2,1,0,0,0,0,0,0,0,0,0.5206611570247933,0.4793388429752067
91309,0.5238095238095238,0.5215311004784688,-110,-109,0.5000596729920038,0.4999403270079962,home,LAD,under,9,0.5,100,0.4793388429752067,LAD,ATL,2023 REG,11,3,5,1,4,16,1,0,2,-2,1,0,0,0,0,0,0,0,0,0.5206611570247933,0.4793388429752067
91310,0.5348837209302326,0.5121951219512195,-115,-105,0.5097020142727117,0.49029798572728833,away,NYM,over,9.5,0.5305164319248826,-113,0.5053568787472517,PHI,NYM,2023 REG,8,5,3,1,6,11,1,0,4,-4,1,0,0,0,0,0,0,0,0,0.5053568787472517,0.49464312125274834
91310,0.5348837209302326,0.5121951219512195,-115,-105,0.5097020142727117,0.49029798572728833,home,PHI,under,9.5,0.5169082125603864,-107,0.49464312125274834,PHI,NYM,2023 REG,8,5,3,1,6,11,1,0,4,-4,1,0,0,0,0,0,0,0,0,0.5053568787472517,0.49464312125274834
91311,0.6551724137931035,0.3846153846153846,-190,160,0.6291045458703008,0.37089545412969915,away,NYM,over,8.5,0.504950495049505,-102,0.4826715732667395,ATL,NYM,2023 REG,19,13,14,10,23,33,1,0,3,-3,1,1,1,1,1,1,1,1,1,0.4826715732667395,0.5173284267332605
91311,0.6551724137931035,0.3846153846153846,-190,160,0.6291045458703008,0.37089545412969915,home,ATL,under,8.5,0.5391705069124424,-117,0.5173284267332605,ATL,NYM,2023 REG,19,13,14,10,23,33,1,0,3,-3,1,1,1,1,1,1,1,1,1,0.4826715732667395,0.5173284267332605
91312,0.3076923076923077,0.7267759562841529,225,-266,0.2970866880072429,0.7029133119927571,away,TB,over,8.5,0.5260663507109005,-111,0.5034588790373798,WSH,TB,2023 REG,6,2,11,7,9,17,0,1,-5,5,1,1,0,0,0,0,0,0,0,0.5034588790373798,0.49654112096262015
91312,0.3076923076923077,0.7267759562841529,225,-266,0.2970866880072429,0.7029133119927571,home,WSH,under,8.5,0.5169082125603864,-107,0.49654112096262015,WSH,TB,2023 REG,6,2,11,7,9,17,0,1,-5,5,1,1,0,0,0,0,0,0,0,0.5034588790373798,0.49654112096262015
91313,0.609375,0.425531914893617,-156,135,0.5881035987367021,0.41189640126329785,away,KC,over,10,0.5169082125603864,-107,0.4946943078742622,ARI,KC,2023 REG,7,5,10,4,9,17,1,0,1,-1,1,1,1,1,0,0,0,0,0,0.4946943078742622,0.5053056921257377
91313,0.609375,0.425531914893617,-156,135,0.5881035987367021,0.41189640126329785,home,ARI,under,10,0.5260663507109005,-111,0.5053056921257377,ARI,KC,2023 REG,7,5,10,4,9,17,1,0,1,-1,1,1,1,1,0,0,0,0,0,0.4946943078742622,0.5053056921257377
91314,0.43103448275862066,0.607843137254902,132,-155,0.4142768879252058,0.5857231120747942,away,LAA,over,7.5,0.5454545454545454,-120,0.5179608869977906,OAK,LAA,2023 REG,5,0,11,6,6,16,0,1,-6,6,0,0,0,0,0,0,0,0,0,0.5179608869977906,0.48203911300220936
91314,0.43103448275862066,0.607843137254902,132,-155,0.4142768879252058,0.5857231120747942,home,OAK,under,7.5,0.504950495049505,-102,0.48203911300220936,OAK,LAA,2023 REG,5,0,11,6,6,16,0,1,-6,6,0,0,0,0,0,0,0,0,0,0.5179608869977906,0.48203911300220936
91315,0.7333333333333333,0.3076923076923077,-275,225,0.7032478632478633,0.29675213675213674,away,COL,over,8,0.5370370370370371,-116,0.5118817074154765,SD,COL,2023 REG,15,11,13,9,20,28,1,0,2,-2,1,1,1,1,1,1,1,1,1,0.5118817074154765,0.48811829258452355
91315,0.7333333333333333,0.3076923076923077,-275,225,0.7032478632478633,0.29675213675213674,home,SD,under,8,0.5098039215686274,-104,0.48811829258452355,SD,COL,2023 REG,15,11,13,9,20,28,1,0,2,-2,1,1,1,1,1,1,1,1,1,0.5118817074154765,0.48811829258452355
91316,0.5327102803738317,0.5121951219512195,-114,-105,0.508788710910954,0.491211289089046,away,MIA,over,7.5,0.5073891625615764,-103,0.4837652908580103,SEA,MIA,2023 REG,10,8,1,1,9,11,1,0,7,-7,1,0,0,0,0,0,0,0,0,0.4837652908580103,0.5162347091419897
91316,0.5327102803738317,0.5121951219512195,-114,-105,0.508788710910954,0.491211289089046,home,SEA,under,7.5,0.5391705069124424,-117,0.5162347091419897,SEA,MIA,2023 REG,10,8,1,1,9,11,1,0,7,-7,1,0,0,0,0,0,0,0,0,0.4837652908580103,0.5162347091419897
91317,0.607843137254902,0.43103448275862066,-155,132,0.5842116427368785,0.41578835726312147,away,MIL,over,8,0.5238095238095238,-110,0.4988662131519274,LAD,MIL,2023 REG,4,1,5,0,1,9,1,0,1,-1,0,0,0,0,0,0,0,0,0,0.4988662131519274,0.5011337868480725
91317,0.607843137254902,0.43103448275862066,-155,132,0.5842116427368785,0.41578835726312147,home,LAD,under,8,0.5238095238095238,-110,0.5011337868480725,LAD,MIL,2023 REG,4,1,5,0,1,9,1,0,1,-1,0,0,0,0,0,0,0,0,0,0.4988662131519274,0.5011337868480725
91318,0.4444444444444444,0.5918367346938775,125,-145,0.42831947593852354,0.5716805240614764,away,TOR,over,7.5,0.5348837209302326,-115,0.5097020142727117,MIN,TOR,2023 REG,5,1,8,3,4,13,0,1,-2,2,1,0,0,0,0,0,0,0,0,0.5097020142727117,0.49029798572728833
91318,0.4444444444444444,0.5918367346938775,125,-145,0.42831947593852354,0.5716805240614764,home,MIN,under,7.5,0.5121951219512195,-105,0.49029798572728833,MIN,TOR,2023 REG,5,1,8,3,4,13,0,1,-2,2,1,0,0,0,0,0,0,0,0,0.5097020142727117,0.49029798572728833
91319,0.5780590717299579,0.4587155963302753,-137,118,0.5568011412478822,0.44319885875211784,away,HOU,over,8,0.5238095238095238,-110,0.4988662131519274,CLE,HOU,2023 REG,10,4,10,6,10,20,0,1,-2,2,1,1,1,1,0,0,0,0,0,0.4988662131519274,0.5011337868480725
91319,0.5780590717299579,0.4587155963302753,-137,118,0.5568011412478822,0.44319885875211784,home,CLE,under,8,0.5238095238095238,-110,0.5011337868480725,CLE,HOU,2023 REG,10,4,10,6,10,20,0,1,-2,2,1,1,1,1,0,0,0,0,0,0.4988662131519274,0.5011337868480725
91320,0.4807692307692307,0.5575221238938054,108,-126,0.46235992564277106,0.5376400743572289,away,NYM,over,11,0.504950495049505,-102,0.47949844489399435,WSH,NYM,2023 REG,9,3,8,2,5,17,1,0,1,-1,1,1,0,0,0,0,0,0,0,0.47949844489399435,0.5205015551060057
91320,0.4807692307692307,0.5575221238938054,108,-126,0.46235992564277106,0.5376400743572289,home,WSH,under,11,0.5454545454545454,-120,0.5205015551060057,WSH,NYM,2023 REG,9,3,8,2,5,17,1,0,1,-1,1,1,0,0,0,0,0,0,0,0.47949844489399435,0.5205015551060057
91321,0.7674418604651163,0.2777777777777778,-330,260,0.7327384171624303,0.26726158283756973,away,KC,over,8,0.5348837209302326,-115,0.5097020142727117,SEA,KC,2023 REG,6,3,5,2,5,11,1,0,1,-1,1,1,0,0,0,0,0,0,0,0.5097020142727117,0.49029798572728833
91321,0.7674418604651163,0.2777777777777778,-330,260,0.7327384171624303,0.26726158283756973,home,SEA,under,8,0.5121951219512195,-105,0.49029798572728833,SEA,KC,2023 REG,6,3,5,2,5,11,1,0,1,-1,1,1,0,0,0,0,0,0,0,0.5097020142727117,0.49029798572728833
91322,0.4424778761061947,0.6000000000000001,126,-150,0.42368235570522356,0.5763176442947764,away,CWS,over,8,0.5238095238095238,-110,0.5012646084074657,DET,CWS,2023 REG,10,7,4,2,9,14,1,0,5,-5,1,1,0,0,0,0,0,0,0,0.5012646084074657,0.4987353915925343
91322,0.4424778761061947,0.6000000000000001,126,-150,0.42368235570522356,0.5763176442947764,home,DET,under,8,0.5192307692307692,-108,0.4987353915925343,DET,CWS,2023 REG,10,7,4,2,9,14,1,0,5,-5,1,1,0,0,0,0,0,0,0,0.5012646084074657,0.4987353915925343
91323,0.5348837209302326,0.5073891625615764,-115,-103,0.5122726437136835,0.48772735628631647,away,HOU,over,8.5,0.5454545454545454,-120,0.5206611570247933,ATL,HOU,2023 REG,7,4,11,6,10,18,0,1,-2,2,1,1,1,1,0,0,0,0,0,0.5206611570247933,0.4793388429752067
91323,0.5348837209302326,0.5073891625615764,-115,-103,0.5122726437136835,0.48772735628631647,home,ATL,under,8.5,0.5,100,0.4793388429752067,ATL,HOU,2023 REG,7,4,11,6,10,18,0,1,-2,2,1,1,1,1,0,0,0,0,0,0.5206611570247933,0.4793388429752067
91324,0.48780487804878053,0.5475113122171946,105,-121,0.470577468162939,0.529422531837061,away,TB,over,8,0.5121951219512195,-105,0.48808156828023186,CHC,TB,2023 REG,3,1,1,0,1,4,1,0,1,-1,0,0,0,0,0,0,0,0,0,0.48808156828023186,0.5119184317197681
91324,0.48780487804878053,0.5475113122171946,105,-121,0.470577468162939,0.529422531837061,home,CHC,under,8,0.5348837209302326,-115,0.5119184317197681,CHC,TB,2023 REG,3,1,1,0,1,4,1,0,1,-1,0,0,0,0,0,0,0,0,0,0.48808156828023186,0.5119184317197681
91325,0.5918367346938775,0.4464285714285714,-145,124,0.5691899208663057,0.4308100791336943,away,PIT,over,8.5,0.5283018867924528,-112,0.5044173060022736,CIN,PIT,2023 REG,6,6,7,2,8,13,1,0,4,-4,1,1,0,0,0,0,0,0,0,0.5044173060022736,0.49558269399772636
91325,0.5918367346938775,0.4464285714285714,-145,124,0.5691899208663057,0.4308100791336943,home,CIN,under,8.5,0.5169082125603864,-107,0.49558269399772636,CIN,PIT,2023 REG,6,6,7,2,8,13,1,0,4,-4,1,1,0,0,0,0,0,0,0,0.5044173060022736,0.49558269399772636
91326,0.5327102803738317,0.5098039215686274,-114,-104,0.5100625279371946,0.48993747206280536,away,BAL,over,8.5,0.5238095238095238,-110,0.5012646084074657,TOR,BAL,2023 REG,5,3,15,13,16,20,0,1,-10,10,1,1,1,0,0,0,0,0,0,0.5012646084074657,0.4987353915925343
91326,0.5327102803738317,0.5098039215686274,-114,-104,0.5100625279371946,0.48993747206280536,home,TOR,under,8.5,0.5192307692307692,-108,0.4987353915925343,TOR,BAL,2023 REG,5,3,15,13,16,20,0,1,-10,10,1,1,1,0,0,0,0,0,0,0.5012646084074657,0.4987353915925343
91327,0.4366812227074236,0.6031746031746031,129,-152,0.419276931929246,0.580723068070754,away,SF,over,8.5,0.5454545454545454,-120,0.5206611570247933,DET,SF,2023 REG,10,7,11,5,12,21,1,0,2,-2,1,1,1,1,1,0,0,0,0,0.5206611570247933,0.4793388429752067
91327,0.4366812227074236,0.6031746031746031,129,-152,0.419276931929246,0.580723068070754,home,DET,under,8.5,0.5,100,0.4793388429752067,DET,SF,2023 REG,10,7,11,5,12,21,1,0,2,-2,1,1,1,1,1,0,0,0,0,0.5206611570247933,0.4793388429752067
91328,0.7938144329896907,0.25,-385,300,0.7590339037092146,0.24096609629078536,away,COL,over,8.5,0.5121951219512195,-105,0.48808156828023186,LAD,COL,2023 REG,5,2,4,1,3,9,1,0,1,-1,1,0,0,0,0,0,0,0,0,0.48808156828023186,0.5119184317197681
91328,0.7938144329896907,0.25,-385,300,0.7590339037092146,0.24096609629078536,home,LAD,under,8.5,0.5348837209302326,-115,0.5119184317197681,LAD,COL,2023 REG,5,2,4,1,3,9,1,0,1,-1,1,0,0,0,0,0,0,0,0,0.48808156828023186,0.5119184317197681
91329,0.5121951219512195,0.5348837209302326,-105,-115,0.48808156828023186,0.5119184317197681,away,BOS,over,9.5,0.5073891625615764,-103,0.4826927225525911,LAA,BOS,2023 REG,9,4,2,0,4,11,1,0,4,-4,0,0,0,0,0,0,0,0,0,0.4826927225525911,0.5173072774474089
91329,0.5121951219512195,0.5348837209302326,-105,-115,0.48808156828023186,0.5119184317197681,home,LAA,under,9.5,0.5412844036697247,-118,0.5173072774474089,LAA,BOS,2023 REG,9,4,2,0,4,11,1,0,4,-4,0,0,0,0,0,0,0,0,0,0.4826927225525911,0.5173072774474089
91330,0.4566210045662101,0.5815899581589958,119,-139,0.4391730763811846,0.5608269236188155,away,TOR,over,8.5,0.5283018867924528,-112,0.5044173060022736,PIT,TOR,2023 REG,5,2,14,8,10,19,0,1,-6,6,1,1,0,0,0,0,0,0,0,0.5044173060022736,0.49558269399772636
91330,0.4566210045662101,0.5815899581589958,119,-139,0.4391730763811846,0.5608269236188155,home,PIT,under,8.5,0.5169082125603864,-107,0.49558269399772636,PIT,TOR,2023 REG,5,2,14,8,10,19,0,1,-6,6,1,1,0,0,0,0,0,0,0,0.5044173060022736,0.49558269399772636
91331,0.5555555555555556,0.48780487804878053,-125,105,0.5314664257753688,0.46853357422463116,away,BOS,over,7.5,0.5238095238095238,-110,0.4988662131519274,SEA,BOS,2023 REG,8,6,9,2,8,17,1,0,4,-4,1,1,0,0,0,0,0,0,0,0.4988662131519274,0.5011337868480725
91331,0.5555555555555556,0.48780487804878053,-125,105,0.5314664257753688,0.46853357422463116,home,SEA,under,7.5,0.5238095238095238,-110,0.5011337868480725,SEA,BOS,2023 REG,8,6,9,2,8,17,1,0,4,-4,1,1,0,0,0,0,0,0,0,0.4988662131519274,0.5011337868480725
91332,0.5901639344262295,0.4504504504504505,-144,122,0.5661947892531068,0.43380521074689316,away,SF,over,8.5,0.5238095238095238,-110,0.4988662131519274,NYY,SF,2023 REG,10,5,12,7,12,22,0,1,-2,2,1,1,1,1,1,0,0,0,0,0.4988662131519274,0.5011337868480725
91332,0.5901639344262295,0.4504504504504505,-144,122,0.5661947892531068,0.43380521074689316,home,NYY,under,8.5,0.5238095238095238,-110,0.5011337868480725,NYY,SF,2023 REG,10,5,12,7,12,22,0,1,-2,2,1,1,1,1,1,0,0,0,0,0.4988662131519274,0.5011337868480725
91333,0.6000000000000001,0.4444444444444444,-150,125,0.5733333333333334,0.42666666666666664,away,CIN,over,6.5,0.5348837209302326,-115,0.5097020142727117,CHC,CIN,2023 REG,2,0,19,9,9,21,0,1,-9,9,0,0,0,0,0,0,0,0,0,0.5097020142727117,0.49029798572728833
91333,0.6000000000000001,0.4444444444444444,-150,125,0.5733333333333334,0.42666666666666664,home,CHC,under,6.5,0.5121951219512195,-105,0.49029798572728833,CHC,CIN,2023 REG,2,0,19,9,9,21,0,1,-9,9,0,0,0,0,0,0,0,0,0,0.5097020142727117,0.49029798572728833
91334,0.46511627906976744,0.574468085106383,115,-135,0.44670494689481377,0.5532950531051862,away,BOS,over,9,0.5475113122171946,-121,0.5242087833606768,CHC,BOS,2023 REG,9,3,13,8,11,22,0,1,-5,5,1,1,1,0,0,0,0,0,0,0.5242087833606768,0.4757912166393232
91334,0.46511627906976744,0.574468085106383,115,-135,0.44670494689481377,0.5532950531051862,home,CHC,under,9,0.49504950495049505,102,0.4757912166393232,CHC,BOS,2023 REG,9,3,13,8,11,22,0,1,-5,5,1,1,1,0,0,0,0,0,0,0.5242087833606768,0.4757912166393232
91335,0.6240601503759399,0.41152263374485604,-166,143,0.6018543527667214,0.3981456472332786,away,ARI,over,8.5,0.5121951219512195,-105,0.48808156828023186,CHC,ARI,2023 REG,5,2,10,6,8,15,0,1,-4,4,1,1,0,0,0,0,0,0,0,0.48808156828023186,0.5119184317197681
91335,0.6240601503759399,0.41152263374485604,-166,143,0.6018543527667214,0.3981456472332786,home,CHC,under,8.5,0.5348837209302326,-115,0.5119184317197681,CHC,ARI,2023 REG,5,2,10,6,8,15,0,1,-4,4,1,1,0,0,0,0,0,0,0,0.48808156828023186,0.5119184317197681
91336,0.4854368932038835,0.5555555555555556,106,-125,0.465537646233282,0.534462353766718,away,PHI,over,8,0.5348837209302326,-115,0.5097020142727117,CLE,PHI,2023 REG,5,1,2,0,1,7,1,0,1,-1,0,0,0,0,0,0,0,0,0,0.5097020142727117,0.49029798572728833
91336,0.4854368932038835,0.5555555555555556,106,-125,0.465537646233282,0.534462353766718,home,CLE,under,8,0.5121951219512195,-105,0.49029798572728833,CLE,PHI,2023 REG,5,1,2,0,1,7,1,0,1,-1,0,0,0,0,0,0,0,0,0,0.5097020142727117,0.49029798572728833
91337,0.425531914893617,0.607843137254902,135,-155,0.4113297650431834,0.5886702349568166,away,TOR,over,8,0.5215311004784688,-109,0.49907282342437215,MIA,TOR,2023 REG,19,11,7,0,11,26,1,0,11,-11,0,0,0,0,0,0,0,0,0,0.49907282342437215,0.5009271765756278
91337,0.425531914893617,0.607843137254902,135,-155,0.4113297650431834,0.5886702349568166,home,MIA,under,8,0.5215311004784688,-109,0.5009271765756278,MIA,TOR,2023 REG,19,11,7,0,11,26,1,0,11,-11,0,0,0,0,0,0,0,0,0,0.49907282342437215,0.5009271765756278
91338,0.5833333333333333,0.4566210045662101,-140,119,0.5600266362252664,0.4399733637747336,away,LAA,over,7,0.5495495495495495,-122,0.5277073575960698,SEA,LAA,2023 REG,5,3,11,7,10,16,0,1,-4,4,1,1,1,0,0,0,0,0,0,0.5277073575960698,0.4722926424039302
91338,0.5833333333333333,0.4566210045662101,-140,119,0.5600266362252664,0.4399733637747336,home,SEA,under,7,0.49019607843137253,104,0.4722926424039302,SEA,LAA,2023 REG,5,3,11,7,10,16,0,1,-4,4,1,1,1,0,0,0,0,0,0,0.5277073575960698,0.4722926424039302
91339,0.5305164319248826,0.5098039215686274,-113,-104,0.5091258218555558,0.49087417814444423,away,TEX,over,9.5,0.5073891625615764,-103,0.48484779035144243,KC,TEX,2023 REG,9,3,13,12,15,22,0,1,-9,9,1,1,1,0,0,0,0,0,0,0.48484779035144243,0.5151522096485576
91339,0.5305164319248826,0.5098039215686274,-113,-104,0.5091258218555558,0.49087417814444423,home,KC,under,9.5,0.5370370370370371,-116,0.5151522096485576,KC,TEX,2023 REG,9,3,13,12,15,22,0,1,-9,9,1,1,1,0,0,0,0,0,0,0.48484779035144243,0.5151522096485576
91340,0.49504950495049505,0.5454545454545454,102,-120,0.47499799484898986,0.5250020051510101,away,PHI,over,8.5,0.5,100,0.4772727272727273,CLE,PHI,2023 REG,13,6,8,5,11,21,1,0,1,-1,1,1,1,1,1,0,0,0,0,0.4772727272727273,0.5227272727272727
91340,0.49504950495049505,0.5454545454545454,102,-120,0.47499799484898986,0.5250020051510101,home,CLE,under,8.5,0.5454545454545454,-120,0.5227272727272727,CLE,PHI,2023 REG,13,6,8,5,11,21,1,0,1,-1,1,1,1,1,1,0,0,0,0,0.4772727272727273,0.5227272727272727
91341,0.6721311475409836,0.36363636363636365,-205,175,0.6480906892086682,0.3519093107913318,away,CWS,over,9,0.5121951219512195,-105,0.48808156828023186,NYM,CWS,2023 REG,5,5,3,1,6,8,1,0,4,-4,1,0,0,0,0,0,0,0,0,0.48808156828023186,0.5119184317197681
91341,0.6721311475409836,0.36363636363636365,-205,175,0.6480906892086682,0.3519093107913318,home,NYM,under,9,0.5348837209302326,-115,0.5119184317197681,NYM,CWS,2023 REG,5,5,3,1,6,8,1,0,4,-4,1,0,0,0,0,0,0,0,0,0.48808156828023186,0.5119184317197681
91342,0.6254681647940076,0.4098360655737705,-167,144,0.6033864926164085,0.39661350738359147,away,DET,over,9,0.504950495049505,-102,0.48160416005266615,NYY,DET,2023 REG,11,4,6,3,7,17,1,0,1,-1,1,1,1,0,0,0,0,0,0,0.48160416005266615,0.5183958399473338
91342,0.6254681647940076,0.4098360655737705,-167,144,0.6033864926164085,0.39661350738359147,home,NYY,under,9,0.5412844036697247,-118,0.5183958399473338,NYY,DET,2023 REG,11,4,6,3,7,17,1,0,1,-1,1,1,1,0,0,0,0,0,0,0.48160416005266615,0.5183958399473338
91343,0.5918367346938775,0.4484304932735426,-145,123,0.5680051099784656,0.43199489002153435,away,HOU,over,8.5,0.5454545454545454,-120,0.5206611570247933,LAD,HOU,2023 REG,9,3,3,2,5,12,1,0,1,-1,1,1,0,0,0,0,0,0,0,0.5206611570247933,0.4793388429752067
91343,0.5918367346938775,0.4484304932735426,-145,123,0.5680051099784656,0.43199489002153435,home,LAD,under,8.5,0.5,100,0.4793388429752067,LAD,HOU,2023 REG,9,3,3,2,5,12,1,0,1,-1,1,1,0,0,0,0,0,0,0,0.5206611570247933,0.4793388429752067
91344,0.45454545454545453,0.5867768595041323,120,-142,0.43576258452291505,0.564237415477085,away,TOR,over,9.5,0.5,100,0.4772727272727273,CLE,TOR,2023 REG,5,4,10,3,7,15,1,0,1,-1,1,1,1,0,0,0,0,0,0,0.4772727272727273,0.5227272727272727
91344,0.45454545454545453,0.5867768595041323,120,-142,0.43576258452291505,0.564237415477085,home,CLE,under,9.5,0.5454545454545454,-120,0.5227272727272727,CLE,TOR,2023 REG,5,4,10,3,7,15,1,0,1,-1,1,1,1,0,0,0,0,0,0,0.4772727272727273,0.5227272727272727
91345,0.45248868778280543,0.5884773662551441,121,-143,0.43395201174753417,0.5660479882524658,away,HOU,over,8.5,0.5283018867924528,-112,0.5031902949311281,NYY,HOU,2023 REG,9,3,2,1,4,11,1,0,2,-2,1,0,0,0,0,0,0,0,0,0.5031902949311281,0.4968097050688719
91345,0.45248868778280543,0.5884773662551441,121,-143,0.43395201174753417,0.5660479882524658,home,NYY,under,8.5,0.5192307692307692,-108,0.4968097050688719,NYY,HOU,2023 REG,9,3,2,1,4,11,1,0,2,-2,1,0,0,0,0,0,0,0,0,0.5031902949311281,0.4968097050688719
91346,0.6610169491525424,0.3802281368821293,-195,163,0.6337532482143695,0.3662467517856305,away,CWS,over,9.5,0.5348837209302326,-115,0.5109810284308424,TOR,CWS,2023 REG,11,8,4,0,8,15,1,0,8,-8,0,0,0,0,0,0,0,0,0,0.5109810284308424,0.48901897156915763
91346,0.6610169491525424,0.3802281368821293,-195,163,0.6337532482143695,0.3662467517856305,home,TOR,under,9.5,0.5098039215686274,-104,0.48901897156915763,TOR,CWS,2023 REG,11,8,4,0,8,15,1,0,8,-8,0,0,0,0,0,0,0,0,0,0.5109810284308424,0.48901897156915763
91347,0.5884773662551441,0.4484304932735426,-143,123,0.5667579262855877,0.43324207371441226,away,BOS,over,9,0.5145631067961165,-106,0.49023796582517226,HOU,BOS,2023 REG,10,1,25,17,18,35,0,1,-16,16,1,0,0,0,0,0,0,0,0,0.49023796582517226,0.5097620341748277
91347,0.5884773662551441,0.4484304932735426,-143,123,0.5667579262855877,0.43324207371441226,home,HOU,under,9,0.5327102803738317,-114,0.5097620341748277,HOU,BOS,2023 REG,10,1,25,17,18,35,0,1,-16,16,1,0,0,0,0,0,0,0,0,0.49023796582517226,0.5097620341748277
91348,0.37453183520599254,0.6666666666666666,167,-200,0.359101684691888,0.640898315308112,away,CHC,over,8,0.5098039215686274,-104,0.4870219861770517,WSH,CHC,2023 REG,8,2,6,1,3,14,1,0,1,-1,1,0,0,0,0,0,0,0,0,0.4870219861770517,0.5129780138229483
91348,0.37453183520599254,0.6666666666666666,167,-200,0.359101684691888,0.640898315308112,home,WSH,under,8,0.5348837209302326,-115,0.5129780138229483,WSH,CHC,2023 REG,8,2,6,1,3,14,1,0,1,-1,1,0,0,0,0,0,0,0,0,0.4870219861770517,0.5129780138229483
91349,0.3846153846153846,0.6551724137931035,160,-190,0.3693123852275045,0.6306876147724956,away,TB,over,8.5,0.5215311004784688,-109,0.49907282342437215,BAL,TB,2023 REG,7,0,7,3,3,14,0,1,-3,3,0,0,0,0,0,0,0,0,0,0.49907282342437215,0.5009271765756278
91349,0.3846153846153846,0.6551724137931035,160,-190,0.3693123852275045,0.6306876147724956,home,BAL,under,8.5,0.5215311004784688,-109,0.5009271765756278,BAL,TB,2023 REG,7,0,7,3,3,14,0,1,-3,3,0,0,0,0,0,0,0,0,0,0.49907282342437215,0.5009271765756278
91350,0.574468085106383,0.46511627906976744,-135,115,0.5517281312179562,0.44827186878204384,away,CWS,over,7,0.5454545454545454,-120,0.5220180091279142,SEA,CWS,2023 REG,9,3,5,2,5,14,1,0,1,-1,1,1,0,0,0,0,0,0,0,0.5220180091279142,0.4779819908720858
91350,0.574468085106383,0.46511627906976744,-135,115,0.5517281312179562,0.44827186878204384,home,SEA,under,7,0.49751243781094534,101,0.4779819908720858,SEA,CWS,2023 REG,9,3,5,2,5,14,1,0,1,-1,1,1,0,0,0,0,0,0,0,0.5220180091279142,0.4779819908720858
91351,0.5652173913043479,0.4716981132075471,-130,112,0.5443521061454507,0.4556478938545493,away,TOR,over,9,0.5433789954337899,-119,0.5198077604720502,LAA,TOR,2023 REG,10,9,10,5,14,20,1,0,4,-4,1,1,1,1,1,0,0,0,0,0.5198077604720502,0.48019223952794976
91351,0.5652173913043479,0.4716981132075471,-130,112,0.5443521061454507,0.4556478938545493,home,LAA,under,9,0.5,100,0.48019223952794976,LAA,TOR,2023 REG,10,9,10,5,14,20,1,0,4,-4,1,1,1,1,1,0,0,0,0,0.5198077604720502,0.48019223952794976
91352,0.696969696969697,0.3448275862068966,-230,190,0.6678382571799499,0.33216174282005007,away,COL,over,9.5,0.5348837209302326,-115,0.5097020142727117,BOS,COL,2023 REG,10,6,7,3,9,17,1,0,3,-3,1,1,1,0,0,0,0,0,0,0.5097020142727117,0.49029798572728833
91352,0.696969696969697,0.3448275862068966,-230,190,0.6678382571799499,0.33216174282005007,home,BOS,under,9.5,0.5121951219512195,-105,0.49029798572728833,BOS,COL,2023 REG,10,6,7,3,9,17,1,0,3,-3,1,1,1,0,0,0,0,0,0,0.5097020142727117,0.49029798572728833
91353,0.5412844036697247,0.5,-118,100,0.5189377998484975,0.4810622001515025,away,CIN,over,9.5,0.5192307692307692,-108,0.49455035168025013,ARI,CIN,2023 REG,8,7,13,8,15,21,0,1,-1,1,1,1,1,1,1,1,1,0,0,0.49455035168025013,0.5054496483197499
91353,0.5412844036697247,0.5,-118,100,0.5189377998484975,0.4810622001515025,home,ARI,under,9.5,0.5283018867924528,-112,0.5054496483197499,ARI,CIN,2023 REG,8,7,13,8,15,21,0,1,-1,1,1,1,1,1,1,1,1,0,0,0.49455035168025013,0.5054496483197499
91354,0.5348837209302326,0.5098039215686274,-115,-104,0.5109810284308424,0.48901897156915763,away,LAA,over,8.5,0.5238095238095238,-110,0.4988662131519274,NYM,LAA,2023 REG,9,3,4,2,5,13,1,0,1,-1,1,1,0,0,0,0,0,0,0,0.4988662131519274,0.5011337868480725
91354,0.5348837209302326,0.5098039215686274,-115,-104,0.5109810284308424,0.48901897156915763,home,NYM,under,8.5,0.5238095238095238,-110,0.5011337868480725,NYM,LAA,2023 REG,9,3,4,2,5,13,1,0,1,-1,1,1,0,0,0,0,0,0,0,0.4988662131519274,0.5011337868480725
91355,0.5918367346938775,0.45454545454545453,-145,120,0.5643860512665178,0.43561394873348225,away,BAL,over,8,0.5348837209302326,-115,0.5097020142727117,SD,BAL,2023 REG,4,1,9,4,5,13,0,1,-3,3,1,0,0,0,0,0,0,0,0,0.5097020142727117,0.49029798572728833
91355,0.5918367346938775,0.45454545454545453,-145,120,0.5643860512665178,0.43561394873348225,home,SD,under,8,0.5121951219512195,-105,0.49029798572728833,SD,BAL,2023 REG,4,1,9,4,5,13,0,1,-3,3,1,0,0,0,0,0,0,0,0,0.5097020142727117,0.49029798572728833
91356,0.7368421052631579,0.30303030303030304,-280,230,0.7074624359942919,0.2925375640057081,away,OAK,over,9,0.5121951219512195,-105,0.48808156828023186,TOR,OAK,2023 REG,12,7,8,3,10,20,1,0,4,-4,1,1,1,0,0,0,0,0,0,0.48808156828023186,0.5119184317197681
91356,0.7368421052631579,0.30303030303030304,-280,230,0.7074624359942919,0.2925375640057081,home,TOR,under,9,0.5348837209302326,-115,0.5119184317197681,TOR,OAK,2023 REG,12,7,8,3,10,20,1,0,4,-4,1,1,1,0,0,0,0,0,0,0.48808156828023186,0.5119184317197681
91357,0.41493775933609955,0.6212121212121212,141,-164,0.39993780890115316,0.6000621910988468,away,TOR,over,9,0.5145631067961165,-106,0.4925063625223866,PIT,TOR,2023 REG,4,0,8,4,4,12,0,1,-4,4,0,0,0,0,0,0,0,0,0,0.4925063625223866,0.5074936374776133
91357,0.41493775933609955,0.6212121212121212,141,-164,0.39993780890115316,0.6000621910988468,home,PIT,under,9,0.5283018867924528,-112,0.5074936374776133,PIT,TOR,2023 REG,4,0,8,4,4,12,0,1,-4,4,0,0,0,0,0,0,0,0,0,0.4925063625223866,0.5074936374776133
91358,0.4166666666666667,0.6226415094339623,140,-165,0.4002882599580712,0.5997117400419287,away,ATL,over,10,0.5238095238095238,-110,0.4988662131519274,BOS,ATL,2023 REG,8,5,6,3,8,14,1,0,2,-2,1,1,1,0,0,0,0,0,0,0.4988662131519274,0.5011337868480725
91358,0.4166666666666667,0.6226415094339623,140,-165,0.4002882599580712,0.5997117400419287,home,BOS,under,10,0.5238095238095238,-110,0.5011337868480725,BOS,ATL,2023 REG,8,5,6,3,8,14,1,0,2,-2,1,1,1,0,0,0,0,0,0,0.4988662131519274,0.5011337868480725
91359,0.5555555555555556,0.4807692307692307,-125,108,0.5353751187084521,0.4646248812915479,away,CLE,over,8.5,0.5121951219512195,-105,0.48808156828023186,NYY,CLE,2023 REG,6,2,5,3,5,11,0,1,-1,1,1,1,0,0,0,0,0,0,0,0.48808156828023186,0.5119184317197681
91359,0.5555555555555556,0.4807692307692307,-125,108,0.5353751187084521,0.4646248812915479,home,NYY,under,8.5,0.5348837209302326,-115,0.5119184317197681,NYY,CLE,2023 REG,6,2,5,3,5,11,0,1,-1,1,1,1,0,0,0,0,0,0,0,0.48808156828023186,0.5119184317197681
91360,0.7142857142857143,0.3278688524590164,-250,205,0.6841753094680495,0.3158246905319505,away,COL,over,9,0.5121951219512195,-105,0.48808156828023186,CHC,COL,2023 REG,7,4,5,3,7,12,1,0,1,-1,1,1,1,0,0,0,0,0,0,0.48808156828023186,0.5119184317197681
91360,0.7142857142857143,0.3278688524590164,-250,205,0.6841753094680495,0.3158246905319505,home,CHC,under,9,0.5348837209302326,-115,0.5119184317197681,CHC,COL,2023 REG,7,4,5,3,7,12,1,0,1,-1,1,1,1,0,0,0,0,0,0,0.48808156828023186,0.5119184317197681
91361,0.6551724137931035,0.3846153846153846,-190,160,0.6291045458703008,0.37089545412969915,away,MIL,over,8.5,0.5121951219512195,-105,0.48808156828023186,NYM,MIL,2023 REG,9,2,9,3,5,18,0,1,-1,1,1,1,0,0,0,0,0,0,0,0.48808156828023186,0.5119184317197681
91361,0.6551724137931035,0.3846153846153846,-190,160,0.6291045458703008,0.37089545412969915,home,NYM,under,8.5,0.5348837209302326,-115,0.5119184317197681,NYM,MIL,2023 REG,9,2,9,3,5,18,0,1,-1,1,1,1,0,0,0,0,0,0,0,0.48808156828023186,0.5119184317197681
91362,0.6402877697841727,0.4,-178,150,0.6144920035194866,0.38550799648051337,away,NYY,over,7,0.5454545454545454,-120,0.5206611570247933,TB,NYY,2023 REG,7,3,2,0,3,9,1,0,3,-3,0,0,0,0,0,0,0,0,0,0.5206611570247933,0.4793388429752067
91362,0.6402877697841727,0.4,-178,150,0.6144920035194866,0.38550799648051337,home,TB,under,7,0.5,100,0.4793388429752067,TB,NYY,2023 REG,7,3,2,0,3,9,1,0,3,-3,0,0,0,0,0,0,0,0,0,0.5206611570247933,0.4793388429752067
91363,0.44052863436123346,0.5967741935483871,127,-148,0.42409567052439623,0.5759043294756038,away,TOR,over,9.5,0.5121951219512195,-105,0.48919479393107135,BOS,TOR,2023 REG,15,8,7,3,11,22,1,0,5,-5,1,1,1,0,0,0,0,0,0,0.48919479393107135,0.5108052060689287
91363,0.44052863436123346,0.5967741935483871,127,-148,0.42409567052439623,0.5759043294756038,home,BOS,under,9.5,0.5327102803738317,-114,0.5108052060689287,BOS,TOR,2023 REG,15,8,7,3,11,22,1,0,5,-5,1,1,1,0,0,0,0,0,0,0.48919479393107135,0.5108052060689287
91364,0.37593984962406013,0.6666666666666666,166,-200,0.35992236229671926,0.6400776377032807,away,NYM,over,10.5,0.5073891625615764,-103,0.4837652908580103,CIN,NYM,2023 REG,10,5,6,0,5,16,1,0,5,-5,0,0,0,0,0,0,0,0,0,0.4837652908580103,0.5162347091419897
91364,0.37593984962406013,0.6666666666666666,166,-200,0.35992236229671926,0.6400776377032807,home,CIN,under,10.5,0.5391705069124424,-117,0.5162347091419897,CIN,NYM,2023 REG,10,5,6,0,5,16,1,0,5,-5,0,0,0,0,0,0,0,0,0,0.4837652908580103,0.5162347091419897
91365,0.5833333333333333,0.45454545454545453,-140,120,0.5612373737373737,0.4387626262626263,away,MIA,over,7,0.5348837209302326,-115,0.5097020142727117,MIL,MIA,2023 REG,17,12,6,0,12,23,1,0,12,-12,0,0,0,0,0,0,0,0,0,0.5097020142727117,0.49029798572728833
91365,0.5833333333333333,0.45454545454545453,-140,120,0.5612373737373737,0.4387626262626263,home,MIL,under,7,0.5121951219512195,-105,0.49029798572728833,MIL,MIA,2023 REG,17,12,6,0,12,23,1,0,12,-12,0,0,0,0,0,0,0,0,0,0.5097020142727117,0.49029798572728833
91366,0.5121951219512195,0.5327102803738317,-105,-114,0.48919479393107135,0.5108052060689287,away,TOR,over,9.5,0.5,100,0.4772727272727273,CIN,TOR,2023 REG,7,3,12,10,13,19,0,1,-7,7,1,1,1,0,0,0,0,0,0,0.4772727272727273,0.5227272727272727
91366,0.5121951219512195,0.5327102803738317,-105,-114,0.48919479393107135,0.5108052060689287,home,CIN,under,9.5,0.5454545454545454,-120,0.5227272727272727,CIN,TOR,2023 REG,7,3,12,10,13,19,0,1,-7,7,1,1,1,0,0,0,0,0,0,0.4772727272727273,0.5227272727272727
91367,0.6825396825396826,0.35714285714285715,-215,180,0.6554547745023935,0.34454522549760647,away,KC,over,7.5,0.5283018867924528,-112,0.49492081101443036,DET,KC,2023 REG,8,8,4,0,8,12,1,0,8,-8,0,0,0,0,0,0,0,0,0,0.49492081101443036,0.5050791889855697
91367,0.6825396825396826,0.35714285714285715,-215,180,0.6554547745023935,0.34454522549760647,home,DET,under,7.5,0.5348837209302326,-115,0.5050791889855697,DET,KC,2023 REG,8,8,4,0,8,12,1,0,8,-8,0,0,0,0,0,0,0,0,0,0.49492081101443036,0.5050791889855697
91368,0.6197718631178707,0.4184100418410042,-163,139,0.5961077927441193,0.4038922072558807,away,ARI,over,8.5,0.5283018867924528,-112,0.5044173060022736,MIN,ARI,2023 REG,17,12,2,1,13,19,1,0,11,-11,1,0,0,0,0,0,0,0,0,0.5044173060022736,0.49558269399772636
91368,0.6197718631178707,0.4184100418410042,-163,139,0.5961077927441193,0.4038922072558807,home,MIN,under,8.5,0.5169082125603864,-107,0.49558269399772636,MIN,ARI,2023 REG,17,12,2,1,13,19,1,0,11,-11,1,0,0,0,0,0,0,0,0,0.5044173060022736,0.49558269399772636
91369,0.5689655172413793,0.47619047619047616,-132,110,0.5432733140818753,0.4567266859181247,away,PIT,over,9,0.5,100,0.4772727272727273,CIN,PIT,2023 REG,9,3,6,1,4,15,1,0,2,-2,1,0,0,0,0,0,0,0,0,0.4772727272727273,0.5227272727272727
91369,0.5689655172413793,0.47619047619047616,-132,110,0.5432733140818753,0.4567266859181247,home,CIN,under,9,0.5454545454545454,-120,0.5227272727272727,CIN,PIT,2023 REG,9,3,6,1,4,15,1,0,2,-2,1,0,0,0,0,0,0,0,0,0.4772727272727273,0.5227272727272727
91370,0.5652173913043479,0.47619047619047616,-130,110,0.5418129444594474,0.4581870555405526,away,SF,over,8.5,0.5454545454545454,-120,0.5206611570247933,LAD,SF,2023 REG,10,5,8,7,12,18,0,1,-2,2,1,1,1,1,1,0,0,0,0,0.5206611570247933,0.4793388429752067
91370,0.5652173913043479,0.47619047619047616,-130,110,0.5418129444594474,0.4581870555405526,home,LAD,under,8.5,0.5,100,0.4793388429752067,LAD,SF,2023 REG,10,5,8,7,12,18,0,1,-2,2,1,1,1,1,1,0,0,0,0,0.5206611570247933,0.4793388429752067
91371,0.5918367346938775,0.4444444444444444,-145,125,0.5703642001018094,0.42963579989819056,away,NYY,over,8,0.5098039215686274,-104,0.48592421718142587,LAD,NYY,2023 REG,13,8,5,4,12,18,1,0,4,-4,1,1,1,1,0,0,0,0,0,0.48592421718142587,0.5140757828185741
91371,0.5918367346938775,0.4444444444444444,-145,125,0.5703642001018094,0.42963579989819056,home,LAD,under,8,0.5370370370370371,-116,0.5140757828185741,LAD,NYY,2023 REG,13,8,5,4,12,18,1,0,4,-4,1,1,1,1,0,0,0,0,0,0.48592421718142587,0.5140757828185741
91372,0.4444444444444444,0.5901639344262295,125,-144,0.4290629427241449,0.5709370572758551,away,ATL,over,8.5,0.5145631067961165,-106,0.49023796582517226,SD,ATL,2023 REG,6,0,7,2,2,13,0,1,-2,2,0,0,0,0,0,0,0,0,0,0.49023796582517226,0.5097620341748277
91372,0.4444444444444444,0.5901639344262295,125,-144,0.4290629427241449,0.5709370572758551,home,SD,under,8.5,0.5327102803738317,-114,0.5097620341748277,SD,ATL,2023 REG,6,0,7,2,2,13,0,1,-2,2,0,0,0,0,0,0,0,0,0,0.49023796582517226,0.5097620341748277
91373,0.5555555555555556,0.48780487804878053,-125,105,0.5314664257753688,0.46853357422463116,away,DET,over,11.5,0.5348837209302326,-115,0.5097020142727117,COL,DET,2023 REG,14,9,12,14,23,26,0,1,-5,5,1,1,1,1,1,1,1,1,1,0.5097020142727117,0.49029798572728833
91373,0.5555555555555556,0.48780487804878053,-125,105,0.5314664257753688,0.46853357422463116,home,COL,under,11.5,0.5121951219512195,-105,0.49029798572728833,COL,DET,2023 REG,14,9,12,14,23,26,0,1,-5,5,1,1,1,1,1,1,1,1,1,0.5097020142727117,0.49029798572728833
91374,0.7354497354497355,0.29850746268656714,-278,235,0.7104759230637776,0.2895240769362224,away,KC,over,8.5,0.5348837209302326,-115,0.5097020142727117,SD,KC,2023 REG,8,3,9,4,7,17,0,1,-1,1,1,1,1,0,0,0,0,0,0,0.5097020142727117,0.49029798572728833
91374,0.7354497354497355,0.29850746268656714,-278,235,0.7104759230637776,0.2895240769362224,home,SD,under,8.5,0.5121951219512195,-105,0.49029798572728833,SD,KC,2023 REG,8,3,9,4,7,17,0,1,-1,1,1,1,1,0,0,0,0,0,0,0.5097020142727117,0.49029798572728833
91375,0.5967741935483871,0.4444444444444444,-148,125,0.5721759741010521,0.42782402589894786,away,PHI,over,8.5,0.5098039215686274,-104,0.48592421718142587,NYM,PHI,2023 REG,6,2,2,0,2,8,1,0,2,-2,0,0,0,0,0,0,0,0,0,0.48592421718142587,0.5140757828185741
91375,0.5967741935483871,0.4444444444444444,-148,125,0.5721759741010521,0.42782402589894786,home,NYM,under,8.5,0.5370370370370371,-116,0.5140757828185741,NYM,PHI,2023 REG,6,2,2,0,2,8,1,0,2,-2,0,0,0,0,0,0,0,0,0,0.48592421718142587,0.5140757828185741
91376,0.6666666666666666,0.37037037037037035,-200,170,0.6419753086419753,0.3580246913580247,away,COL,over,9.5,0.5238095238095238,-110,0.4988662131519274,ARI,COL,2023 REG,11,7,13,5,12,24,1,0,2,-2,1,1,1,1,1,0,0,0,0,0.4988662131519274,0.5011337868480725
91376,0.6666666666666666,0.37037037037037035,-200,170,0.6419753086419753,0.3580246913580247,home,ARI,under,9.5,0.5238095238095238,-110,0.5011337868480725,ARI,COL,2023 REG,11,7,13,5,12,24,1,0,2,-2,1,1,1,1,1,0,0,0,0,0.4988662131519274,0.5011337868480725
91377,0.425531914893617,0.607843137254902,135,-155,0.4113297650431834,0.5886702349568166,away,ARI,over,9.5,0.5121951219512195,-105,0.48808156828023186,OAK,ARI,2023 REG,12,9,15,8,17,27,1,0,1,-1,1,1,1,1,1,1,1,1,0,0.48808156828023186,0.5119184317197681
91377,0.425531914893617,0.607843137254902,135,-155,0.4113297650431834,0.5886702349568166,home,OAK,under,9.5,0.5348837209302326,-115,0.5119184317197681,OAK,ARI,2023 REG,12,9,15,8,17,27,1,0,1,-1,1,1,1,1,1,1,1,1,0,0.48808156828023186,0.5119184317197681
91378,0.5652173913043479,0.47619047619047616,-130,110,0.5418129444594474,0.4581870555405526,away,HOU,over,8,0.5098039215686274,-104,0.4870219861770517,ATL,HOU,2023 REG,3,2,9,5,7,12,0,1,-3,3,1,1,0,0,0,0,0,0,0,0.4870219861770517,0.5129780138229483
91378,0.5652173913043479,0.47619047619047616,-130,110,0.5418129444594474,0.4581870555405526,home,ATL,under,8,0.5348837209302326,-115,0.5129780138229483,ATL,HOU,2023 REG,3,2,9,5,7,12,0,1,-3,3,1,1,0,0,0,0,0,0,0,0.4870219861770517,0.5129780138229483
91379,0.5833333333333333,0.45454545454545453,-140,120,0.5612373737373737,0.4387626262626263,away,LAA,over,9,0.5348837209302326,-115,0.5097020142727117,TEX,LAA,2023 REG,9,6,7,3,9,16,1,0,3,-3,1,1,1,0,0,0,0,0,0,0.5097020142727117,0.49029798572728833
91379,0.5833333333333333,0.45454545454545453,-140,120,0.5612373737373737,0.4387626262626263,home,TEX,under,9,0.5121951219512195,-105,0.49029798572728833,TEX,LAA,2023 REG,9,6,7,3,9,16,1,0,3,-3,1,1,1,0,0,0,0,0,0,0.5097020142727117,0.49029798572728833
91380,0.4608294930875576,0.5833333333333333,117,-140,0.4404779601747047,0.5595220398252954,away,NYM,over,9,0.5454545454545454,-120,0.5206611570247933,WSH,NYM,2023 REG,7,5,11,11,16,18,0,1,-6,6,1,1,1,1,1,0,0,0,0,0.5206611570247933,0.4793388429752067
91380,0.4608294930875576,0.5833333333333333,117,-140,0.4404779601747047,0.5595220398252954,home,WSH,under,9,0.5,100,0.4793388429752067,WSH,NYM,2023 REG,7,5,11,11,16,18,0,1,-6,6,1,1,1,1,1,0,0,0,0,0.5206611570247933,0.4793388429752067
91381,0.4329004329004329,0.6000000000000001,131,-150,0.4186578212552238,0.5813421787447761,away,CWS,over,9.5,0.5098039215686274,-104,0.4870219861770517,KC,CWS,2023 REG,14,9,6,1,10,20,1,0,8,-8,1,0,0,0,0,0,0,0,0,0.4870219861770517,0.5129780138229483
91381,0.4329004329004329,0.6000000000000001,131,-150,0.4186578212552238,0.5813421787447761,home,KC,under,9.5,0.5348837209302326,-115,0.5129780138229483,KC,CWS,2023 REG,14,9,6,1,10,20,1,0,8,-8,1,0,0,0,0,0,0,0,0,0.4870219861770517,0.5129780138229483
91382,0.37878787878787884,0.6644295302013422,164,-198,0.3624176481101436,0.6375823518898565,away,SEA,over,8.5,0.5073891625615764,-103,0.48484779035144243,CWS,SEA,2023 REG,8,2,15,14,16,23,0,1,-12,12,1,1,0,0,0,0,0,0,0,0.48484779035144243,0.5151522096485576
91382,0.37878787878787884,0.6644295302013422,164,-198,0.3624176481101436,0.6375823518898565,home,CWS,under,8.5,0.5370370370370371,-116,0.5151522096485576,CWS,SEA,2023 REG,8,2,15,14,16,23,0,1,-12,12,1,1,0,0,0,0,0,0,0,0.48484779035144243,0.5151522096485576
91383,0.5918367346938775,0.4504504504504505,-145,122,0.566809625118663,0.43319037488133705,away,LAA,over,9,0.5098039215686274,-104,0.48375889301574193,HOU,LAA,2023 REG,5,1,6,2,3,11,0,1,-1,1,1,0,0,0,0,0,0,0,0,0.48375889301574193,0.5162411069842581
91383,0.5918367346938775,0.4504504504504505,-145,122,0.566809625118663,0.43319037488133705,home,HOU,under,9,0.5412844036697247,-118,0.5162411069842581,HOU,LAA,2023 REG,5,1,6,2,3,11,0,1,-1,1,1,0,0,0,0,0,0,0,0,0.48375889301574193,0.5162411069842581
91384,0.5934959349593496,0.4444444444444444,-146,125,0.5709784740123824,0.42902152598761756,away,MIN,over,8.5,0.5238095238095238,-110,0.4988662131519274,BAL,MIN,2023 REG,3,0,7,1,1,10,0,1,-1,1,0,0,0,0,0,0,0,0,0,0.4988662131519274,0.5011337868480725
91384,0.5934959349593496,0.4444444444444444,-146,125,0.5709784740123824,0.42902152598761756,home,BAL,under,8.5,0.5238095238095238,-110,0.5011337868480725,BAL,MIN,2023 REG,3,0,7,1,1,10,0,1,-1,1,0,0,0,0,0,0,0,0,0,0.4988662131519274,0.5011337868480725
91385,0.5652173913043479,0.47619047619047616,-130,110,0.5418129444594474,0.4581870555405526,away,NYM,over,8,0.5073891625615764,-103,0.4826927225525911,SD,NYM,2023 REG,9,6,5,2,8,14,1,0,4,-4,1,1,0,0,0,0,0,0,0,0.4826927225525911,0.5173072774474089
91385,0.5652173913043479,0.47619047619047616,-130,110,0.5418129444594474,0.4581870555405526,home,SD,under,8,0.5412844036697247,-118,0.5173072774474089,SD,NYM,2023 REG,9,6,5,2,8,14,1,0,4,-4,1,1,0,0,0,0,0,0,0,0.4826927225525911,0.5173072774474089
91386,0.5555555555555556,0.48780487804878053,-125,105,0.5314664257753688,0.46853357422463116,away,MIA,over,7.5,0.5,100,0.4772727272727273,SF,MIA,2023 REG,5,4,6,3,7,11,1,0,1,-1,1,1,1,0,0,0,0,0,0,0.4772727272727273,0.5227272727272727
91386,0.5555555555555556,0.48780487804878053,-125,105,0.5314664257753688,0.46853357422463116,home,SF,under,7.5,0.5454545454545454,-120,0.5227272727272727,SF,MIA,2023 REG,5,4,6,3,7,11,1,0,1,-1,1,1,1,0,0,0,0,0,0,0.4772727272727273,0.5227272727272727
91387,0.5555555555555556,0.48780487804878053,-125,105,0.5314664257753688,0.46853357422463116,away,TEX,over,8.5,0.5495495495495495,-122,0.5223196169142115,MIN,TEX,2023 REG,12,12,8,2,14,20,1,0,10,-10,1,1,0,0,0,0,0,0,0,0.5223196169142115,0.47768038308578853
91387,0.5555555555555556,0.48780487804878053,-125,105,0.5314664257753688,0.46853357422463116,home,MIN,under,8.5,0.5,100,0.47768038308578853,MIN,TEX,2023 REG,12,12,8,2,14,20,1,0,10,-10,1,1,0,0,0,0,0,0,0,0.5223196169142115,0.47768038308578853
91388,0.5967741935483871,0.4444444444444444,-148,125,0.5721759741010521,0.42782402589894786,away,WSH,over,8.5,0.5454545454545454,-120,0.5206611570247933,PIT,WSH,2023 REG,7,2,9,6,8,16,0,1,-4,4,1,1,0,0,0,0,0,0,0,0.5206611570247933,0.4793388429752067
91388,0.5967741935483871,0.4444444444444444,-148,125,0.5721759741010521,0.42782402589894786,home,PIT,under,8.5,0.5,100,0.4793388429752067,PIT,WSH,2023 REG,7,2,9,6,8,16,0,1,-4,4,1,1,0,0,0,0,0,0,0,0.5206611570247933,0.4793388429752067
91389,0.5652173913043479,0.47619047619047616,-130,110,0.5418129444594474,0.4581870555405526,away,MIA,over,9,0.5454545454545454,-120,0.5179608869977906,LAA,MIA,2023 REG,5,0,9,2,2,14,0,1,-2,2,0,0,0,0,0,0,0,0,0,0.5179608869977906,0.48203911300220936
91389,0.5652173913043479,0.47619047619047616,-130,110,0.5418129444594474,0.4581870555405526,home,LAA,under,9,0.504950495049505,-102,0.48203911300220936,LAA,MIA,2023 REG,5,0,9,2,2,14,0,1,-2,2,0,0,0,0,0,0,0,0,0,0.5179608869977906,0.48203911300220936
91390,0.5348837209302326,0.5145631067961165,-115,-106,0.5084354177277668,0.4915645822722332,away,SEA,over,7.5,0.5454545454545454,-120,0.5140092723241282,SD,SEA,2023 REG,17,10,4,3,13,21,1,0,7,-7,1,1,1,0,0,0,0,0,0,0.5140092723241282,0.4859907276758718
91390,0.5348837209302326,0.5145631067961165,-115,-106,0.5084354177277668,0.4915645822722332,home,SD,under,7.5,0.5121951219512195,-105,0.4859907276758718,SD,SEA,2023 REG,17,10,4,3,13,21,1,0,7,-7,1,1,1,0,0,0,0,0,0,0.5140092723241282,0.4859907276758718
91391,0.5815899581589958,0.4587155963302753,-139,118,0.5581486524100054,0.44185134758999456,away,NYY,over,9,0.5121951219512195,-105,0.48808156828023186,LAA,NYY,2023 REG,9,4,8,3,7,17,1,0,1,-1,1,1,1,0,0,0,0,0,0,0.48808156828023186,0.5119184317197681
91391,0.5815899581589958,0.4587155963302753,-139,118,0.5581486524100054,0.44185134758999456,home,LAA,under,9,0.5348837209302326,-115,0.5119184317197681,LAA,NYY,2023 REG,9,4,8,3,7,17,1,0,1,-1,1,1,1,0,0,0,0,0,0,0.48808156828023186,0.5119184317197681
91392,0.574468085106383,0.46511627906976744,-135,115,0.5517281312179562,0.44827186878204384,away,MIL,over,8,0.5145631067961165,-106,0.4913668392989033,CLE,MIL,2023 REG,6,1,10,7,8,16,0,1,-6,6,1,0,0,0,0,0,0,0,0,0.4913668392989033,0.5086331607010968
91392,0.574468085106383,0.46511627906976744,-135,115,0.5517281312179562,0.44827186878204384,home,CLE,under,8,0.5305164319248826,-113,0.5086331607010968,CLE,MIL,2023 REG,6,1,10,7,8,16,0,1,-6,6,1,0,0,0,0,0,0,0,0,0.4913668392989033,0.5086331607010968
91393,0.6688741721854304,0.37037037037037035,-202,170,0.6426245112706233,0.35737548872937674,away,OAK,over,8.5,0.5121951219512195,-105,0.48808156828023186,BAL,OAK,2023 REG,12,12,12,8,20,24,1,0,4,-4,1,1,1,1,1,1,1,1,0,0.48808156828023186,0.5119184317197681
91393,0.6688741721854304,0.37037037037037035,-202,170,0.6426245112706233,0.35737548872937674,home,BAL,under,8.5,0.5348837209302326,-115,0.5119184317197681,BAL,OAK,2023 REG,12,12,12,8,20,24,1,0,4,-4,1,1,1,1,1,1,1,1,0,0.48808156828023186,0.5119184317197681
91394,0.6774193548387096,0.36363636363636365,-210,175,0.6496074165168858,0.3503925834831142,away,DET,over,7.5,0.5238095238095238,-110,0.4988662131519274,SEA,DET,2023 REG,3,0,9,6,6,12,0,1,-6,6,0,0,0,0,0,0,0,0,0,0.4988662131519274,0.5011337868480725
91394,0.6774193548387096,0.36363636363636365,-210,175,0.6496074165168858,0.3503925834831142,home,SEA,under,7.5,0.5238095238095238,-110,0.5011337868480725,SEA,DET,2023 REG,3,0,9,6,6,12,0,1,-6,6,0,0,0,0,0,0,0,0,0,0.4988662131519274,0.5011337868480725
91395,0.6062992125984252,0.4347826086956522,-154,130,0.581391336695717,0.41860866330428304,away,SF,over,19.5,0.5145631067961165,-106,0.4925063625223866,SD,SF,2023 REG,10,6,9,4,10,19,1,0,2,-2,1,1,1,1,0,0,0,0,0,0.4925063625223866,0.5074936374776133
91395,0.6062992125984252,0.4347826086956522,-154,130,0.581391336695717,0.41860866330428304,home,SD,under,19.5,0.5283018867924528,-112,0.5074936374776133,SD,SF,2023 REG,10,6,9,4,10,19,1,0,2,-2,1,1,1,1,0,0,0,0,0,0.4925063625223866,0.5074936374776133
91396,0.4807692307692307,0.5555555555555556,108,-125,0.4633053911900066,0.5366946088099934,away,CLE,over,9,0.5073891625615764,-103,0.4837652908580103,BOS,CLE,2023 REG,8,2,8,5,7,16,0,1,-3,3,1,1,0,0,0,0,0,0,0,0.4837652908580103,0.5162347091419897
91396,0.4807692307692307,0.5555555555555556,108,-125,0.4633053911900066,0.5366946088099934,home,BOS,under,9,0.5391705069124424,-117,0.5162347091419897,BOS,CLE,2023 REG,8,2,8,5,7,16,0,1,-3,3,1,1,0,0,0,0,0,0,0,0.4837652908580103,0.5162347091419897
91397,0.6721311475409836,0.37037037037037035,-205,170,0.6435645535349916,0.35643544646500835,away,BAL,over,8.5,0.5348837209302326,-115,0.5109810284308424,TOR,BAL,2023 REG,12,3,13,8,11,25,0,1,-5,5,1,1,1,0,0,0,0,0,0,0.5109810284308424,0.48901897156915763
91397,0.6721311475409836,0.37037037037037035,-205,170,0.6435645535349916,0.35643544646500835,home,TOR,under,8.5,0.5098039215686274,-104,0.48901897156915763,TOR,BAL,2023 REG,12,3,13,8,11,25,0,1,-5,5,1,1,1,0,0,0,0,0,0,0.5109810284308424,0.48901897156915763
91398,0.5454545454545454,0.49504950495049505,-120,102,0.5233614270517961,0.4766385729482039,away,SD,over,9,0.5348837209302326,-115,0.5097020142727117,HOU,SD,2023 REG,11,7,9,5,12,20,1,0,2,-2,1,1,1,1,1,0,0,0,0,0.5097020142727117,0.49029798572728833
91398,0.5454545454545454,0.49504950495049505,-120,102,0.5233614270517961,0.4766385729482039,home,HOU,under,9,0.5121951219512195,-105,0.49029798572728833,HOU,SD,2023 REG,11,7,9,5,12,20,1,0,2,-2,1,1,1,1,1,0,0,0,0,0.5097020142727117,0.49029798572728833
91399,0.5,0.5454545454545454,100,-120,0.4772727272727273,0.5227272727272727,away,MIN,over,9,0.5169082125603864,-107,0.49239402434819424,BAL,MIN,2023 REG,5,2,6,1,3,11,1,0,1,-1,1,0,0,0,0,0,0,0,0,0.49239402434819424,0.5076059756518058
91399,0.5,0.5454545454545454,100,-120,0.4772727272727273,0.5227272727272727,home,BAL,under,9,0.5305164319248826,-113,0.5076059756518058,BAL,MIN,2023 REG,5,2,6,1,3,11,1,0,1,-1,1,0,0,0,0,0,0,0,0,0.49239402434819424,0.5076059756518058
91400,0.6389891696750902,0.3968253968253968,-177,152,0.6161040495646708,0.3838959504353292,away,SF,over,6.5,0.5433789954337899,-119,0.5184560714286826,NYY,SF,2023 REG,8,5,4,0,5,12,1,0,5,-5,0,0,0,0,0,0,0,0,0,0.5184560714286826,0.48154392857131745
91400,0.6389891696750902,0.3968253968253968,-177,152,0.6161040495646708,0.3838959504353292,home,NYY,under,6.5,0.5024875621890548,-101,0.48154392857131745,NYY,SF,2023 REG,8,5,4,0,5,12,1,0,5,-5,0,0,0,0,0,0,0,0,0,0.5184560714286826,0.48154392857131745
91401,0.47619047619047616,0.5652173913043479,110,-130,0.4564724440500838,0.5435275559499162,away,MIL,over,9,0.5,100,0.4772727272727273,STL,MIL,2023 REG,8,3,9,7,10,17,0,1,-4,4,1,1,1,0,0,0,0,0,0,0.4772727272727273,0.5227272727272727
91401,0.47619047619047616,0.5652173913043479,110,-130,0.4564724440500838,0.5435275559499162,home,STL,under,9,0.5454545454545454,-120,0.5227272727272727,STL,MIL,2023 REG,8,3,9,7,10,17,0,1,-4,4,1,1,1,0,0,0,0,0,0,0.4772727272727273,0.5227272727272727
91402,0.646643109540636,0.390625,-183,156,0.622543943300578,0.37745605669942195,away,DET,over,7,0.5535714285714286,-124,0.528006245601689,TB,DET,2023 REG,13,12,6,2,14,19,1,0,10,-10,1,1,0,0,0,0,0,0,0,0.528006245601689,0.47199375439831104
91402,0.646643109540636,0.390625,-183,156,0.622543943300578,0.37745605669942195,home,TB,under,7,0.4926108374384236,103,0.47199375439831104,TB,DET,2023 REG,13,12,6,2,14,19,1,0,10,-10,1,1,0,0,0,0,0,0,0,0.528006245601689,0.47199375439831104
91403,0.45454545454545453,0.5918367346938775,120,-145,0.433462641254849,0.566537358745151,away,PHI,over,9,0.5454545454545454,-120,0.5206611570247933,MIL,PHI,2023 REG,12,7,7,5,12,19,1,0,2,-2,1,1,1,1,1,0,0,0,0,0.5206611570247933,0.4793388429752067
91403,0.45454545454545453,0.5918367346938775,120,-145,0.433462641254849,0.566537358745151,home,MIL,under,9,0.5,100,0.4793388429752067,MIL,PHI,2023 REG,12,7,7,5,12,19,1,0,2,-2,1,1,1,1,1,0,0,0,0,0.5206611570247933,0.4793388429752067
91404,0.5238095238095238,0.5238095238095238,-110,-110,0.4988662131519274,0.5011337868480725,away,ATL,over,9.5,0.5348837209302326,-115,0.5097020142727117,TEX,ATL,2023 REG,10,7,8,4,11,18,1,0,3,-3,1,1,1,1,0,0,0,0,0,0.5097020142727117,0.49029798572728833
91404,0.5238095238095238,0.5238095238095238,-110,-110,0.4988662131519274,0.5011337868480725,home,TEX,under,9.5,0.5121951219512195,-105,0.49029798572728833,TEX,ATL,2023 REG,10,7,8,4,11,18,1,0,3,-3,1,1,1,1,0,0,0,0,0,0.5097020142727117,0.49029798572728833
91405,0.6254681647940076,0.41152263374485604,-167,143,0.6023315979176397,0.3976684020823603,away,WSH,over,9,0.5412844036697247,-118,0.5149381613977361,CHC,WSH,2023 REG,20,17,9,3,20,29,1,0,14,-14,1,1,1,0,0,0,0,0,0,0.5149381613977361,0.48506183860226393
91405,0.6254681647940076,0.41152263374485604,-167,143,0.6023315979176397,0.3976684020823603,home,CHC,under,9,0.5073891625615764,-103,0.48506183860226393,CHC,WSH,2023 REG,20,17,9,3,20,29,1,0,14,-14,1,1,1,0,0,0,0,0,0,0.5149381613977361,0.48506183860226393
91406,0.3663003663003663,0.6742671009771988,173,-207,0.3514404881767161,0.6485595118232839,away,TB,over,9.5,0.5348837209302326,-115,0.5097020142727117,KC,TB,2023 REG,7,2,11,4,6,18,0,1,-2,2,1,1,0,0,0,0,0,0,0,0.5097020142727117,0.49029798572728833
91406,0.3663003663003663,0.6742671009771988,173,-207,0.3514404881767161,0.6485595118232839,home,KC,under,9.5,0.5121951219512195,-105,0.49029798572728833,KC,TB,2023 REG,7,2,11,4,6,18,0,1,-2,2,1,1,0,0,0,0,0,0,0,0.5097020142727117,0.49029798572728833
91407,0.6794871794871794,0.36101083032490977,-212,177,0.6519693010251187,0.34803069897488126,away,SEA,over,9.5,0.5,100,0.4772727272727273,TOR,SEA,2023 REG,14,8,7,10,18,21,0,1,-2,2,1,1,1,1,1,1,1,1,0,0.4772727272727273,0.5227272727272727
91407,0.6794871794871794,0.36101083032490977,-212,177,0.6519693010251187,0.34803069897488126,home,TOR,under,9.5,0.5454545454545454,-120,0.5227272727272727,TOR,SEA,2023 REG,14,8,7,10,18,21,0,1,-2,2,1,1,1,1,1,1,1,1,0,0.4772727272727273,0.5227272727272727
91408,0.6666666666666666,0.37037037037037035,-200,170,0.6419753086419753,0.3580246913580247,away,KC,over,8.5,0.504950495049505,-102,0.4826715732667395,SD,KC,2023 REG,8,4,8,5,9,16,0,1,-1,1,1,1,1,1,0,0,0,0,0,0.4826715732667395,0.5173284267332605
91408,0.6666666666666666,0.37037037037037035,-200,170,0.6419753086419753,0.3580246913580247,home,SD,under,8.5,0.5391705069124424,-117,0.5173284267332605,SD,KC,2023 REG,8,4,8,5,9,16,0,1,-1,1,1,1,1,1,0,0,0,0,0,0.4826715732667395,0.5173284267332605
91409,0.6323529411764706,0.4081632653061224,-172,145,0.6067323988418897,0.3932676011581103,away,CLE,over,9.5,0.5238095238095238,-110,0.4988662131519274,CIN,CLE,2023 REG,11,7,9,2,9,20,1,0,5,-5,1,1,0,0,0,0,0,0,0,0.4988662131519274,0.5011337868480725
91409,0.6323529411764706,0.4081632653061224,-172,145,0.6067323988418897,0.3932676011581103,home,CIN,under,9.5,0.5238095238095238,-110,0.5011337868480725,CIN,CLE,2023 REG,11,7,9,2,9,20,1,0,5,-5,1,1,0,0,0,0,0,0,0,0.4988662131519274,0.5011337868480725
91410,0.7560975609756098,0.2857142857142857,-310,250,0.7244837256734936,0.2755162743265064,away,COL,over,8.5,0.5348837209302326,-115,0.5109810284308424,BAL,COL,2023 REG,6,5,8,4,9,14,1,0,1,-1,1,1,1,1,0,0,0,0,0,0.5109810284308424,0.48901897156915763
91410,0.7560975609756098,0.2857142857142857,-310,250,0.7244837256734936,0.2755162743265064,home,BAL,under,8.5,0.5098039215686274,-104,0.48901897156915763,BAL,COL,2023 REG,6,5,8,4,9,14,1,0,1,-1,1,1,1,1,0,0,0,0,0,0.5109810284308424,0.48901897156915763
91411,0.4587155963302753,0.574468085106383,118,-135,0.4434937241116247,0.5565062758883753,away,LAA,over,8,0.5238095238095238,-110,0.5024811857109994,BOS,LAA,2023 REG,8,4,9,5,9,17,0,1,-1,1,1,1,1,1,0,0,0,0,0,0.5024811857109994,0.4975188142890006
91411,0.4587155963302753,0.574468085106383,118,-135,0.4434937241116247,0.5565062758883753,home,BOS,under,8,0.5169082125603864,-107,0.4975188142890006,BOS,LAA,2023 REG,8,4,9,5,9,17,0,1,-1,1,1,1,1,1,0,0,0,0,0,0.5024811857109994,0.4975188142890006
91412,0.5121951219512195,0.5348837209302326,-105,-115,0.48808156828023186,0.5119184317197681,away,PHI,over,7.5,0.5238095238095238,-110,0.4988662131519274,SF,PHI,2023 REG,10,4,10,3,7,20,1,0,1,-1,1,1,1,0,0,0,0,0,0,0.4988662131519274,0.5011337868480725
91412,0.5121951219512195,0.5348837209302326,-105,-115,0.48808156828023186,0.5119184317197681,home,SF,under,7.5,0.5238095238095238,-110,0.5011337868480725,SF,PHI,2023 REG,10,4,10,3,7,20,1,0,1,-1,1,1,1,0,0,0,0,0,0,0.4988662131519274,0.5011337868480725
91413,0.5,0.5454545454545454,100,-120,0.4772727272727273,0.5227272727272727,away,STL,over,9,0.5260663507109005,-111,0.5022370601254724,CHC,STL,2023 REG,7,7,9,2,9,16,1,0,5,-5,1,1,0,0,0,0,0,0,0,0.5022370601254724,0.4977629398745276
91413,0.5,0.5454545454545454,100,-120,0.4772727272727273,0.5227272727272727,home,CHC,under,9,0.5192307692307692,-108,0.4977629398745276,CHC,STL,2023 REG,7,7,9,2,9,16,1,0,5,-5,1,1,0,0,0,0,0,0,0,0.5022370601254724,0.4977629398745276
91414,0.6240601503759399,0.41493775933609955,-166,141,0.5997231089766972,0.40027689102330277,away,SEA,over,8.5,0.5098039215686274,-104,0.48483656587239576,LAA,SEA,2023 REG,6,3,8,5,8,14,0,1,-2,2,1,1,1,0,0,0,0,0,0,0.48483656587239576,0.5151634341276042
91414,0.6240601503759399,0.41493775933609955,-166,141,0.5997231089766972,0.40027689102330277,home,LAA,under,8.5,0.5391705069124424,-117,0.5151634341276042,LAA,SEA,2023 REG,6,3,8,5,8,14,0,1,-2,2,1,1,1,0,0,0,0,0,0,0.48483656587239576,0.5151634341276042
91415,0.4444444444444444,0.5918367346938775,125,-145,0.42831947593852354,0.5716805240614764,away,STL,over,8.5,0.5327102803738317,-114,0.5075272610403079,PIT,STL,2023 REG,10,2,5,1,3,15,1,0,1,-1,1,0,0,0,0,0,0,0,0,0.5075272610403079,0.4924727389596921
91415,0.4444444444444444,0.5918367346938775,125,-145,0.42831947593852354,0.5716805240614764,home,PIT,under,8.5,0.5145631067961165,-106,0.4924727389596921,PIT,STL,2023 REG,10,2,5,1,3,15,1,0,1,-1,1,0,0,0,0,0,0,0,0,0.5075272610403079,0.4924727389596921
91416,0.40322580645161293,0.6363636363636364,148,-175,0.387262321445464,0.612737678554536,away,HOU,over,9,0.5121951219512195,-105,0.48808156828023186,DET,HOU,2023 REG,5,4,1,1,5,6,1,0,3,-3,1,0,0,0,0,0,0,0,0,0.48808156828023186,0.5119184317197681
91416,0.40322580645161293,0.6363636363636364,148,-175,0.387262321445464,0.612737678554536,home,DET,under,9,0.5348837209302326,-115,0.5119184317197681,DET,HOU,2023 REG,5,4,1,1,5,6,1,0,3,-3,1,0,0,0,0,0,0,0,0,0.48808156828023186,0.5119184317197681
91417,0.6621621621621622,0.37878787878787884,-196,164,0.6350465945060539,0.36495340549394606,away,PIT,over,7.5,0.5348837209302326,-115,0.5097020142727117,CHC,PIT,2023 REG,12,7,15,13,20,27,0,1,-6,6,1,1,1,1,1,1,1,0,0,0.5097020142727117,0.49029798572728833
91417,0.6621621621621622,0.37878787878787884,-196,164,0.6350465945060539,0.36495340549394606,home,CHC,under,7.5,0.5121951219512195,-105,0.49029798572728833,CHC,PIT,2023 REG,12,7,15,13,20,27,0,1,-6,6,1,1,1,1,1,1,1,0,0,0.5097020142727117,0.49029798572728833
91418,0.5726495726495727,0.4672897196261683,-134,114,0.5497783539959433,0.4502216460040567,away,SEA,over,9,0.5348837209302326,-115,0.5097020142727117,TEX,SEA,2023 REG,8,9,13,8,17,21,1,0,1,-1,1,1,1,1,1,1,1,1,0,0.5097020142727117,0.49029798572728833
91418,0.5726495726495727,0.4672897196261683,-134,114,0.5497783539959433,0.4502216460040567,home,TEX,under,9,0.5121951219512195,-105,0.49029798572728833,TEX,SEA,2023 REG,8,9,13,8,17,21,1,0,1,-1,1,1,1,1,1,1,1,1,0,0.5097020142727117,0.49029798572728833
91419,0.5575221238938054,0.4807692307692307,-126,108,0.5361738465152985,0.46382615348470146,away,CIN,over,8,0.5348837209302326,-115,0.5097020142727117,CHC,CIN,2023 REG,8,5,8,6,11,16,0,1,-1,1,1,1,1,1,1,0,0,0,0,0.5097020142727117,0.49029798572728833
91419,0.5575221238938054,0.4807692307692307,-126,108,0.5361738465152985,0.46382615348470146,home,CHC,under,8,0.5121951219512195,-105,0.49029798572728833,CHC,CIN,2023 REG,8,5,8,6,11,16,0,1,-1,1,1,1,1,1,1,0,0,0,0,0.5097020142727117,0.49029798572728833
91420,0.5726495726495727,0.46511627906976744,-134,115,0.5510229738017454,0.44897702619825464,away,CHC,over,8.5,0.5454545454545454,-120,0.5206611570247933,PHI,CHC,2023 REG,3,1,13,10,11,16,0,1,-9,9,1,0,0,0,0,0,0,0,0,0.5206611570247933,0.4793388429752067
91420,0.5726495726495727,0.46511627906976744,-134,115,0.5510229738017454,0.44897702619825464,home,PHI,under,8.5,0.5,100,0.4793388429752067,PHI,CHC,2023 REG,3,1,13,10,11,16,0,1,-9,9,1,0,0,0,0,0,0,0,0,0.5206611570247933,0.4793388429752067
91421,0.6428571428571428,0.3921568627450981,-180,155,0.6203481392557023,0.3796518607442977,away,DET,over,8,0.5098039215686274,-104,0.48592421718142587,BAL,DET,2023 REG,6,5,2,1,6,8,1,0,4,-4,1,0,0,0,0,0,0,0,0,0.48592421718142587,0.5140757828185741
91421,0.6428571428571428,0.3921568627450981,-180,155,0.6203481392557023,0.3796518607442977,home,BAL,under,8,0.5370370370370371,-116,0.5140757828185741,BAL,DET,2023 REG,6,5,2,1,6,8,1,0,4,-4,1,0,0,0,0,0,0,0,0,0.48592421718142587,0.5140757828185741
91422,0.5,0.5454545454545454,100,-120,0.4772727272727273,0.5227272727272727,away,LAA,over,9.5,0.5348837209302326,-115,0.5097020142727117,BOS,LAA,2023 REG,11,9,9,7,16,20,1,0,2,-2,1,1,1,1,1,1,1,0,0,0.5097020142727117,0.49029798572728833
91422,0.5,0.5454545454545454,100,-120,0.4772727272727273,0.5227272727272727,home,BOS,under,9.5,0.5121951219512195,-105,0.49029798572728833,BOS,LAA,2023 REG,11,9,9,7,16,20,1,0,2,-2,1,1,1,1,1,1,1,0,0,0.5097020142727117,0.49029798572728833
91423,0.6666666666666666,0.37037037037037035,-200,170,0.6419753086419753,0.3580246913580247,away,MIN,over,7.5,0.5370370370370371,-116,0.514488177212783,LAD,MIN,2023 REG,8,1,11,5,6,19,0,1,-4,4,1,0,0,0,0,0,0,0,0,0.514488177212783,0.48551182278721705
91423,0.6666666666666666,0.37037037037037035,-200,170,0.6419753086419753,0.3580246913580247,home,LAD,under,7.5,0.504950495049505,-102,0.48551182278721705,LAD,MIN,2023 REG,8,1,11,5,6,19,0,1,-4,4,1,0,0,0,0,0,0,0,0,0.514488177212783,0.48551182278721705
91424,0.6551724137931035,0.3846153846153846,-190,160,0.6291045458703008,0.37089545412969915,away,DET,over,8,0.5121951219512195,-105,0.48808156828023186,LAD,DET,2023 REG,9,8,6,3,11,15,1,0,5,-5,1,1,1,0,0,0,0,0,0,0.48808156828023186,0.5119184317197681
91424,0.6551724137931035,0.3846153846153846,-190,160,0.6291045458703008,0.37089545412969915,home,LAD,under,8,0.5348837209302326,-115,0.5119184317197681,LAD,DET,2023 REG,9,8,6,3,11,15,1,0,5,-5,1,1,1,0,0,0,0,0,0,0.48808156828023186,0.5119184317197681
91425,0.3846153846153846,0.6551724137931035,160,-190,0.3693123852275045,0.6306876147724956,away,TOR,over,7.5,0.5283018867924528,-112,0.5044173060022736,OAK,TOR,2023 REG,7,1,10,7,8,17,0,1,-6,6,1,0,0,0,0,0,0,0,0,0.5044173060022736,0.49558269399772636
91425,0.3846153846153846,0.6551724137931035,160,-190,0.3693123852275045,0.6306876147724956,home,OAK,under,7.5,0.5169082125603864,-107,0.49558269399772636,OAK,TOR,2023 REG,7,1,10,7,8,17,0,1,-6,6,1,0,0,0,0,0,0,0,0,0.5044173060022736,0.49558269399772636
91426,0.43859649122807015,0.6000000000000001,128,-150,0.4216682056017235,0.5783317943982764,away,CLE,over,9,0.5121951219512195,-105,0.48808156828023186,KC,CLE,2023 REG,6,4,13,3,7,19,1,0,1,-1,1,1,1,0,0,0,0,0,0,0.48808156828023186,0.5119184317197681
91426,0.43859649122807015,0.6000000000000001,128,-150,0.4216682056017235,0.5783317943982764,home,KC,under,9,0.5348837209302326,-115,0.5119184317197681,KC,CLE,2023 REG,6,4,13,3,7,19,1,0,1,-1,1,1,1,0,0,0,0,0,0,0.48808156828023186,0.5119184317197681
91427,0.46511627906976744,0.574468085106383,115,-135,0.44670494689481377,0.5532950531051862,away,DET,over,9,0.5348837209302326,-115,0.5097020142727117,KC,DET,2023 REG,4,0,6,3,3,10,0,1,-3,3,0,0,0,0,0,0,0,0,0,0.5097020142727117,0.49029798572728833
91427,0.46511627906976744,0.574468085106383,115,-135,0.44670494689481377,0.5532950531051862,home,KC,under,9,0.5121951219512195,-105,0.49029798572728833,KC,DET,2023 REG,4,0,6,3,3,10,0,1,-3,3,0,0,0,0,0,0,0,0,0,0.5097020142727117,0.49029798572728833
91428,0.4,0.6428571428571428,150,-180,0.38285714285714295,0.617142857142857,away,TEX,over,10,0.5348837209302326,-115,0.5097020142727117,WSH,TEX,2023 REG,6,2,10,7,9,16,0,1,-5,5,1,1,0,0,0,0,0,0,0,0.5097020142727117,0.49029798572728833
91428,0.4,0.6428571428571428,150,-180,0.38285714285714295,0.617142857142857,home,WSH,under,10,0.5121951219512195,-105,0.49029798572728833,WSH,TEX,2023 REG,6,2,10,7,9,16,0,1,-5,5,1,1,0,0,0,0,0,0,0,0.5097020142727117,0.49029798572728833
91429,0.5918367346938775,0.4504504504504505,-145,122,0.566809625118663,0.43319037488133705,away,SEA,over,8.5,0.5121951219512195,-105,0.48808156828023186,HOU,SEA,2023 REG,4,0,9,2,2,13,0,1,-2,2,0,0,0,0,0,0,0,0,0,0.48808156828023186,0.5119184317197681
91429,0.5918367346938775,0.4504504504504505,-145,122,0.566809625118663,0.43319037488133705,home,HOU,under,8.5,0.5348837209302326,-115,0.5119184317197681,HOU,SEA,2023 REG,4,0,9,2,2,13,0,1,-2,2,0,0,0,0,0,0,0,0,0,0.48808156828023186,0.5119184317197681
91430,0.7354497354497355,0.29850746268656714,-278,235,0.7104759230637776,0.2895240769362224,away,WSH,over,8,0.5391705069124424,-117,0.5153817639191344,SD,WSH,2023 REG,15,13,10,3,16,25,1,0,10,-10,1,1,1,0,0,0,0,0,0,0.5153817639191344,0.4846182360808656
91430,0.7354497354497355,0.29850746268656714,-278,235,0.7104759230637776,0.2895240769362224,home,SD,under,8,0.504950495049505,-102,0.4846182360808656,SD,WSH,2023 REG,15,13,10,3,16,25,1,0,10,-10,1,1,1,0,0,0,0,0,0,0.5153817639191344,0.4846182360808656
91431,0.4347826086956522,0.6062992125984252,130,-154,0.4169209472634447,0.5830790527365552,away,ATL,over,9.5,0.5238095238095238,-110,0.4988662131519274,CHC,ATL,2023 REG,10,8,10,6,14,20,1,0,2,-2,1,1,1,1,1,1,0,0,0,0.4988662131519274,0.5011337868480725
91431,0.4347826086956522,0.6062992125984252,130,-154,0.4169209472634447,0.5830790527365552,home,CHC,under,9.5,0.5238095238095238,-110,0.5011337868480725,CHC,ATL,2023 REG,10,8,10,6,14,20,1,0,2,-2,1,1,1,1,1,1,0,0,0,0.4988662131519274,0.5011337868480725
91432,0.5238095238095238,0.5238095238095238,-110,-110,0.4988662131519274,0.5011337868480725,away,ATL,over,8.5,0.5238095238095238,-110,0.4988662131519274,TB,ATL,2023 REG,6,1,2,2,3,8,0,1,-1,1,1,0,0,0,0,0,0,0,0,0.4988662131519274,0.5011337868480725
91432,0.5238095238095238,0.5238095238095238,-110,-110,0.4988662131519274,0.5011337868480725,home,TB,under,8.5,0.5238095238095238,-110,0.5011337868480725,TB,ATL,2023 REG,6,1,2,2,3,8,0,1,-1,1,1,0,0,0,0,0,0,0,0,0.4988662131519274,0.5011337868480725
91433,0.4854368932038835,0.5555555555555556,106,-125,0.465537646233282,0.534462353766718,away,TEX,over,9,0.5,100,0.4772727272727273,DET,TEX,2023 REG,8,6,13,10,16,21,0,1,-4,4,1,1,1,1,1,1,0,0,0,0.4772727272727273,0.5227272727272727
91433,0.4854368932038835,0.5555555555555556,106,-125,0.465537646233282,0.534462353766718,home,DET,under,9,0.5454545454545454,-120,0.5227272727272727,DET,TEX,2023 REG,8,6,13,10,16,21,0,1,-4,4,1,1,1,1,1,1,0,0,0,0.4772727272727273,0.5227272727272727
91434,0.6402877697841727,0.39370078740157477,-178,154,0.6185253123055287,0.38147468769447135,away,STL,over,9,0.5121951219512195,-105,0.48808156828023186,SD,STL,2023 REG,11,4,8,2,6,19,1,0,2,-2,1,1,0,0,0,0,0,0,0,0.48808156828023186,0.5119184317197681
91434,0.6402877697841727,0.39370078740157477,-178,154,0.6185253123055287,0.38147468769447135,home,SD,under,9,0.5348837209302326,-115,0.5119184317197681,SD,STL,2023 REG,11,4,8,2,6,19,1,0,2,-2,1,1,0,0,0,0,0,0,0,0.48808156828023186,0.5119184317197681
91435,0.5594713656387665,0.47619047619047616,-127,110,0.5395195862893665,0.46048041371063353,away,LAD,over,9.5,0.5098039215686274,-104,0.48483656587239576,TB,LAD,2023 REG,16,11,12,10,21,28,1,0,1,-1,1,1,1,1,1,1,1,1,1,0.48483656587239576,0.5151634341276042
91435,0.5594713656387665,0.47619047619047616,-127,110,0.5395195862893665,0.46048041371063353,home,TB,under,9.5,0.5391705069124424,-117,0.5151634341276042,TB,LAD,2023 REG,16,11,12,10,21,28,1,0,1,-1,1,1,1,1,1,1,1,1,1,0.48483656587239576,0.5151634341276042
91436,0.7014925373134329,0.3389830508474576,-235,195,0.6730992142751963,0.32690078572480374,away,COL,over,9,0.5098039215686274,-104,0.48592421718142587,BAL,COL,2023 REG,10,5,7,4,9,17,1,0,1,-1,1,1,1,1,0,0,0,0,0,0.48592421718142587,0.5140757828185741
91436,0.7014925373134329,0.3389830508474576,-235,195,0.6730992142751963,0.32690078572480374,home,BAL,under,9,0.5370370370370371,-116,0.5140757828185741,BAL,COL,2023 REG,10,5,7,4,9,17,1,0,1,-1,1,1,1,1,0,0,0,0,0,0.48592421718142587,0.5140757828185741
91437,0.5934959349593496,0.4444444444444444,-146,125,0.5709784740123824,0.42902152598761756,away,CIN,over,8,0.5121951219512195,-105,0.48808156828023186,PHI,CIN,2023 REG,6,3,8,2,5,14,1,0,1,-1,1,1,0,0,0,0,0,0,0,0.48808156828023186,0.5119184317197681
91437,0.5934959349593496,0.4444444444444444,-146,125,0.5709784740123824,0.42902152598761756,home,PHI,under,8,0.5348837209302326,-115,0.5119184317197681,PHI,CIN,2023 REG,6,3,8,2,5,14,1,0,1,-1,1,1,0,0,0,0,0,0,0,0.48808156828023186,0.5119184317197681
91438,0.6183206106870228,0.42372881355932196,-162,136,0.5923205850079852,0.40767941499201477,away,CLE,over,7,0.5121951219512195,-105,0.48919479393107135,NYY,CLE,2023 REG,9,4,6,2,6,15,1,0,2,-2,1,1,0,0,0,0,0,0,0,0.48919479393107135,0.5108052060689287
91438,0.6183206106870228,0.42372881355932196,-162,136,0.5923205850079852,0.40767941499201477,home,NYY,under,7,0.5327102803738317,-114,0.5108052060689287,NYY,CLE,2023 REG,9,4,6,2,6,15,1,0,2,-2,1,1,0,0,0,0,0,0,0,0.48919479393107135,0.5108052060689287
91439,0.5555555555555556,0.48780487804878053,-125,105,0.5314664257753688,0.46853357422463116,away,ATL,over,9.5,0.49504950495049505,102,0.4739797934813417,TOR,ATL,2023 REG,9,5,7,2,7,16,1,0,3,-3,1,1,0,0,0,0,0,0,0,0.4739797934813417,0.5260202065186583
91439,0.5555555555555556,0.48780487804878053,-125,105,0.5314664257753688,0.46853357422463116,home,TOR,under,9.5,0.5475113122171946,-121,0.5260202065186583,TOR,ATL,2023 REG,9,5,7,2,7,16,1,0,3,-3,1,1,0,0,0,0,0,0,0,0.4739797934813417,0.5260202065186583
91440,0.5238095238095238,0.5169082125603864,-110,-107,0.5024811857109994,0.4975188142890006,away,STL,over,8,0.5348837209302326,-115,0.5097020142727117,SF,STL,2023 REG,8,4,6,0,4,14,1,0,4,-4,0,0,0,0,0,0,0,0,0,0.5097020142727117,0.49029798572728833
91440,0.5238095238095238,0.5169082125603864,-110,-107,0.5024811857109994,0.4975188142890006,home,SF,under,8,0.5121951219512195,-105,0.49029798572728833,SF,STL,2023 REG,8,4,6,0,4,14,1,0,4,-4,0,0,0,0,0,0,0,0,0,0.5097020142727117,0.49029798572728833
91441,0.48780487804878053,0.5495495495495495,105,-122,0.4695832060495952,0.5304167939504048,away,CWS,over,8.5,0.5348837209302326,-115,0.5109810284308424,OAK,CWS,2023 REG,10,7,12,8,15,22,0,1,-1,1,1,1,1,1,1,1,1,0,0,0.5109810284308424,0.48901897156915763
91441,0.48780487804878053,0.5495495495495495,105,-122,0.4695832060495952,0.5304167939504048,home,OAK,under,8.5,0.5098039215686274,-104,0.48901897156915763,OAK,CWS,2023 REG,10,7,12,8,15,22,0,1,-1,1,1,1,1,1,1,1,1,0,0,0.5109810284308424,0.48901897156915763
91442,0.5238095238095238,0.5238095238095238,-110,-110,0.4988662131519274,0.5011337868480725,away,TEX,over,8.5,0.5024875621890548,-101,0.48049269377245407,CHC,TEX,2023 REG,7,2,10,8,10,17,0,1,-6,6,1,1,0,0,0,0,0,0,0,0.48049269377245407,0.5195073062275459
91442,0.5238095238095238,0.5238095238095238,-110,-110,0.4988662131519274,0.5011337868480725,home,CHC,under,8.5,0.5412844036697247,-118,0.5195073062275459,CHC,TEX,2023 REG,7,2,10,8,10,17,0,1,-6,6,1,1,0,0,0,0,0,0,0,0.48049269377245407,0.5195073062275459
91443,0.6875,0.35460992907801414,-220,182,0.6585494237588654,0.3414505762411346,away,COL,over,8.5,0.5433789954337899,-119,0.5171177654451503,NYM,COL,2023 REG,7,2,9,5,7,16,0,1,-3,3,1,1,0,0,0,0,0,0,0,0.5171177654451503,0.4828822345548497
91443,0.6875,0.35460992907801414,-220,182,0.6585494237588654,0.3414505762411346,home,NYM,under,8.5,0.504950495049505,-102,0.4828822345548497,NYM,COL,2023 REG,7,2,9,5,7,16,0,1,-3,3,1,1,0,0,0,0,0,0,0,0.5171177654451503,0.4828822345548497
91444,0.5918367346938775,0.4444444444444444,-145,125,0.5703642001018094,0.42963579989819056,away,HOU,over,9.5,0.5073891625615764,-103,0.4826927225525911,TEX,HOU,2023 REG,7,3,10,5,8,17,0,1,-2,2,1,1,1,0,0,0,0,0,0,0.4826927225525911,0.5173072774474089
91444,0.5918367346938775,0.4444444444444444,-145,125,0.5703642001018094,0.42963579989819056,home,TEX,under,9.5,0.5412844036697247,-118,0.5173072774474089,TEX,HOU,2023 REG,7,3,10,5,8,17,0,1,-2,2,1,1,1,0,0,0,0,0,0,0.4826927225525911,0.5173072774474089
91445,0.6923076923076923,0.3448275862068966,-225,190,0.6665986533360538,0.33340134666394616,away,MIL,over,8,0.5169082125603864,-107,0.49353874091423283,TB,MIL,2023 REG,5,1,8,0,1,13,1,0,1,-1,0,0,0,0,0,0,0,0,0,0.49353874091423283,0.5064612590857671
91445,0.6923076923076923,0.3448275862068966,-225,190,0.6665986533360538,0.33340134666394616,home,TB,under,8,0.5283018867924528,-112,0.5064612590857671,TB,MIL,2023 REG,5,1,8,0,1,13,1,0,1,-1,0,0,0,0,0,0,0,0,0,0.49353874091423283,0.5064612590857671
91446,0.4608294930875576,0.5780590717299579,117,-137,0.44290849547579936,0.5570915045242006,away,SF,over,9,0.504950495049505,-102,0.47949844489399435,NYM,SF,2023 REG,9,4,8,5,9,17,0,1,-1,1,1,1,1,1,0,0,0,0,0,0.47949844489399435,0.5205015551060057
91446,0.4608294930875576,0.5780590717299579,117,-137,0.44290849547579936,0.5570915045242006,home,NYM,under,9,0.5454545454545454,-120,0.5205015551060057,NYM,SF,2023 REG,9,4,8,5,9,17,0,1,-1,1,1,1,1,1,0,0,0,0,0,0.47949844489399435,0.5205015551060057
91447,0.48780487804878053,0.5555555555555556,105,-125,0.4666534470222751,0.5333465529777248,away,CHC,over,9,0.5,100,0.4772727272727273,DET,CHC,2023 REG,9,8,8,6,14,17,1,0,2,-2,1,1,1,1,1,1,0,0,0,0.4772727272727273,0.5227272727272727
91447,0.48780487804878053,0.5555555555555556,105,-125,0.4666534470222751,0.5333465529777248,home,DET,under,9,0.5454545454545454,-120,0.5227272727272727,DET,CHC,2023 REG,9,8,8,6,14,17,1,0,2,-2,1,1,1,1,1,1,0,0,0,0.4772727272727273,0.5227272727272727
91448,0.6062992125984252,0.4347826086956522,-154,130,0.581391336695717,0.41860866330428304,away,MIN,over,7.5,0.5098039215686274,-104,0.4870219861770517,SEA,MIN,2023 REG,5,3,9,6,9,14,0,1,-3,3,1,1,1,0,0,0,0,0,0,0.4870219861770517,0.5129780138229483
91448,0.6062992125984252,0.4347826086956522,-154,130,0.581391336695717,0.41860866330428304,home,SEA,under,7.5,0.5348837209302326,-115,0.5129780138229483,SEA,MIN,2023 REG,5,3,9,6,9,14,0,1,-3,3,1,1,1,0,0,0,0,0,0,0.4870219861770517,0.5129780138229483
91449,0.6240601503759399,0.4166666666666667,-166,140,0.5986441668079975,0.4013558331920025,away,CHC,over,8,0.5454545454545454,-120,0.5206611570247933,NYY,CHC,2023 REG,2,0,7,3,3,9,0,1,-3,3,0,0,0,0,0,0,0,0,0,0.5206611570247933,0.4793388429752067
91449,0.6240601503759399,0.4166666666666667,-166,140,0.5986441668079975,0.4013558331920025,home,NYY,under,8,0.5,100,0.4793388429752067,NYY,CHC,2023 REG,2,0,7,3,3,9,0,1,-3,3,0,0,0,0,0,0,0,0,0,0.5206611570247933,0.4793388429752067
91450,0.5594713656387665,0.47846889952153115,-127,109,0.5382448736768379,0.46175512632316207,away,ATL,over,9,0.5348837209302326,-115,0.5097020142727117,STL,ATL,2023 REG,6,2,10,5,7,16,0,1,-3,3,1,1,0,0,0,0,0,0,0,0.5097020142727117,0.49029798572728833
91450,0.5594713656387665,0.47846889952153115,-127,109,0.5382448736768379,0.46175512632316207,home,STL,under,9,0.5121951219512195,-105,0.49029798572728833,STL,ATL,2023 REG,6,2,10,5,7,16,0,1,-3,3,1,1,0,0,0,0,0,0,0,0.5097020142727117,0.49029798572728833
91451,0.5555555555555556,0.48780487804878053,-125,105,0.5314664257753688,0.46853357422463116,away,CWS,over,8.5,0.5412844036697247,-118,0.5149381613977361,CLE,CWS,2023 REG,4,3,3,0,3,7,1,0,3,-3,0,0,0,0,0,0,0,0,0,0.5149381613977361,0.48506183860226393
91451,0.5555555555555556,0.48780487804878053,-125,105,0.5314664257753688,0.46853357422463116,home,CLE,under,8.5,0.5073891625615764,-103,0.48506183860226393,CLE,CWS,2023 REG,4,3,3,0,3,7,1,0,3,-3,0,0,0,0,0,0,0,0,0,0.5149381613977361,0.48506183860226393
91452,0.37735849056603776,0.6666666666666666,165,-200,0.36074522368577194,0.639254776314228,away,NYM,over,9,0.5238095238095238,-110,0.4988662131519274,WSH,NYM,2023 REG,7,2,10,8,10,17,0,1,-6,6,1,1,0,0,0,0,0,0,0,0.4988662131519274,0.5011337868480725
91452,0.37735849056603776,0.6666666666666666,165,-200,0.36074522368577194,0.639254776314228,home,WSH,under,9,0.5238095238095238,-110,0.5011337868480725,WSH,NYM,2023 REG,7,2,10,8,10,17,0,1,-6,6,1,1,0,0,0,0,0,0,0,0.4988662131519274,0.5011337868480725
91453,0.6183206106870228,0.42016806722689076,-162,138,0.5945222678547557,0.4054777321452443,away,BOS,over,8,0.5412844036697247,-118,0.5149381613977361,TB,BOS,2023 REG,6,8,11,6,14,17,1,0,2,-2,1,1,1,1,1,1,0,0,0,0.5149381613977361,0.48506183860226393
91453,0.6183206106870228,0.42016806722689076,-162,138,0.5945222678547557,0.4054777321452443,home,TB,under,8,0.5073891625615764,-103,0.48506183860226393,TB,BOS,2023 REG,6,8,11,6,14,17,1,0,2,-2,1,1,1,1,1,1,0,0,0,0.5149381613977361,0.48506183860226393
91454,0.5283018867924528,0.5145631067961165,-112,-106,0.5056562298022652,0.4943437701977348,away,TOR,over,8,0.5454545454545454,-120,0.5206611570247933,TB,TOR,2023 REG,13,5,11,9,14,24,0,1,-4,4,1,1,1,1,1,0,0,0,0,0.5206611570247933,0.4793388429752067
91454,0.5283018867924528,0.5145631067961165,-112,-106,0.5056562298022652,0.4943437701977348,home,TB,under,8,0.5,100,0.4793388429752067,TB,TOR,2023 REG,13,5,11,9,14,24,0,1,-4,4,1,1,1,1,1,0,0,0,0,0.5206611570247933,0.4793388429752067
91455,0.6031746031746031,0.4347826086956522,-152,130,0.5802797769671475,0.4197202230328525,away,SF,over,7.5,0.5073891625615764,-103,0.4837652908580103,MIN,SF,2023 REG,7,7,10,1,8,17,1,0,6,-6,1,0,0,0,0,0,0,0,0,0.4837652908580103,0.5162347091419897
91455,0.6031746031746031,0.4347826086956522,-152,130,0.5802797769671475,0.4197202230328525,home,MIN,under,7.5,0.5391705069124424,-117,0.5162347091419897,MIN,SF,2023 REG,7,7,10,1,8,17,1,0,6,-6,1,0,0,0,0,0,0,0,0,0.4837652908580103,0.5162347091419897
91456,0.782608695652174,0.2597402597402597,-360,285,0.7494660349102693,0.2505339650897307,away,WSH,over,9,0.5121951219512195,-105,0.48808156828023186,ATL,WSH,2023 REG,11,5,10,3,8,21,1,0,2,-2,1,1,1,0,0,0,0,0,0,0.48808156828023186,0.5119184317197681
91456,0.782608695652174,0.2597402597402597,-360,285,0.7494660349102693,0.2505339650897307,home,ATL,under,9,0.5348837209302326,-115,0.5119184317197681,ATL,WSH,2023 REG,11,5,10,3,8,21,1,0,2,-2,1,1,1,0,0,0,0,0,0,0.48808156828023186,0.5119184317197681
91457,0.5575221238938054,0.4807692307692307,-126,108,0.5361738465152985,0.46382615348470146,away,PIT,over,8.5,0.5412844036697247,-118,0.5175913212324037,DET,PIT,2023 REG,10,4,5,0,4,15,1,0,4,-4,0,0,0,0,0,0,0,0,0,0.5175913212324037,0.4824086787675963
91457,0.5575221238938054,0.4807692307692307,-126,108,0.5361738465152985,0.46382615348470146,home,DET,under,8.5,0.5024875621890548,-101,0.4824086787675963,DET,PIT,2023 REG,10,4,5,0,4,15,1,0,4,-4,0,0,0,0,0,0,0,0,0,0.5175913212324037,0.4824086787675963
91458,0.4464285714285714,0.5918367346938775,124,-145,0.42934584548104954,0.5706541545189505,away,LAD,over,8.5,0.5454545454545454,-120,0.5206611570247933,PIT,LAD,2023 REG,12,8,4,1,9,16,1,0,7,-7,1,0,0,0,0,0,0,0,0,0.5206611570247933,0.4793388429752067
91458,0.4464285714285714,0.5918367346938775,124,-145,0.42934584548104954,0.5706541545189505,home,PIT,under,8.5,0.5,100,0.4793388429752067,PIT,LAD,2023 REG,12,8,4,1,9,16,1,0,7,-7,1,0,0,0,0,0,0,0,0,0.5206611570247933,0.4793388429752067
91459,0.45454545454545453,0.5901639344262295,120,-144,0.43422300501287087,0.5657769949871292,away,SF,over,10,0.5238095238095238,-110,0.4988662131519274,PIT,SF,2023 REG,8,4,9,8,12,17,0,1,-4,4,1,1,1,1,0,0,0,0,0,0.4988662131519274,0.5011337868480725
91459,0.45454545454545453,0.5901639344262295,120,-144,0.43422300501287087,0.5657769949871292,home,PIT,under,10,0.5238095238095238,-110,0.5011337868480725,PIT,SF,2023 REG,8,4,9,8,12,17,0,1,-4,4,1,1,1,1,0,0,0,0,0,0.4988662131519274,0.5011337868480725
91460,0.4132231404958678,0.6226415094339623,142,-165,0.3984030372190785,0.6015969627809215,away,CWS,over,9,0.5,100,0.47522522522522526,OAK,CWS,2023 REG,10,7,10,4,11,20,1,0,3,-3,1,1,1,1,0,0,0,0,0,0.47522522522522526,0.5247747747747747
91460,0.4132231404958678,0.6226415094339623,142,-165,0.3984030372190785,0.6015969627809215,home,OAK,under,9,0.5495495495495495,-122,0.5247747747747747,OAK,CWS,2023 REG,10,7,10,4,11,20,1,0,3,-3,1,1,1,1,0,0,0,0,0,0.47522522522522526,0.5247747747747747
91461,0.38167938931297707,0.6587030716723549,162,-193,0.3662662362651405,0.6337337637348595,away,CLE,over,6.5,0.5454545454545454,-120,0.5206611570247933,OAK,CLE,2023 REG,6,4,8,3,7,14,1,0,1,-1,1,1,1,0,0,0,0,0,0,0.5206611570247933,0.4793388429752067
91461,0.38167938931297707,0.6587030716723549,162,-193,0.3662662362651405,0.6337337637348595,home,OAK,under,6.5,0.5,100,0.4793388429752067,OAK,CLE,2023 REG,6,4,8,3,7,14,1,0,1,-1,1,1,1,0,0,0,0,0,0,0.5206611570247933,0.4793388429752067
91463,0.6197718631178707,0.41152263374485604,-163,143,0.60037641449192225,0.39962358550807775,away,TEX,over,8.5,0.5412844036697247,-118,0.5189377998484975,HOU,TEX,2023 REG,6,2,11,6,8,17,0,1,-4,4,1,1,0,0,0,0,0,0,0,0.5189377998484975,0.4810622001515025
91463,0.6197718631178707,0.41152263374485604,-163,143,0.60037641449192225,0.39962358550807775,home,HOU,under,8.5,0.5,100,0.4810622001515025,HOU,TEX,2023 REG,6,2,11,6,8,17,0,1,-4,4,1,1,0,0,0,0,0,0,0,0.5189377998484975,0.4810622001515025
91464,0.49019607843137253,0.5475113122171946,104,-121,0.47171206340756505,0.5282879365924349,away,TEX,over,9,0.5215311004784688,-109,0.4978845547971712,KC,TEX,2023 REG,8,2,12,12,14,20,0,1,-10,10,1,1,0,0,0,0,0,0,0,0.4978845547971712,0.5021154452028288
91464,0.49019607843137253,0.5475113122171946,104,-121,0.47171206340756505,0.5282879365924349,home,KC,under,9,0.5238095238095238,-110,0.5021154452028288,KC,TEX,2023 REG,8,2,12,12,14,20,0,1,-10,10,1,1,0,0,0,0,0,0,0,0.4978845547971712,0.5021154452028288
91465,0.5238095238095238,0.5169082125603864,-110,-107,0.5024811857109994,0.4975188142890006,away,MIN,over,7.5,0.5,100,0.4772727272727273,CLE,MIN,2023 REG,5,4,8,3,7,13,1,0,1,-1,1,1,1,0,0,0,0,0,0,0.4772727272727273,0.5227272727272727
91465,0.5238095238095238,0.5169082125603864,-110,-107,0.5024811857109994,0.4975188142890006,home,CLE,under,7.5,0.5454545454545454,-120,0.5227272727272727,CLE,MIN,2023 REG,5,4,8,3,7,13,1,0,1,-1,1,1,1,0,0,0,0,0,0,0.4772727272727273,0.5227272727272727
91466,0.5169082125603864,0.5215311004784688,-107,-109,0.49703861596542265,0.5029613840345774,away,TOR,over,9,0.5121951219512195,-105,0.48808156828023186,HOU,TOR,2023 REG,8,8,4,1,9,12,1,0,7,-7,1,0,0,0,0,0,0,0,0,0.48808156828023186,0.5119184317197681
91466,0.5169082125603864,0.5215311004784688,-107,-109,0.49703861596542265,0.5029613840345774,home,HOU,under,9,0.5348837209302326,-115,0.5119184317197681,HOU,TOR,2023 REG,8,8,4,1,9,12,1,0,7,-7,1,0,0,0,0,0,0,0,0,0.48808156828023186,0.5119184317197681
91467,0.3846153846153846,0.6503496503496503,160,-186,0.3711672942442173,0.6288327057557828,away,LAD,over,10.5,0.5238095238095238,-110,0.4988662131519274,CIN,LAD,2023 REG,14,9,8,8,17,22,1,0,1,-1,1,1,1,1,1,1,1,1,0,0.4988662131519274,0.5011337868480725
91467,0.3846153846153846,0.6503496503496503,160,-186,0.3711672942442173,0.6288327057557828,home,CIN,under,10.5,0.5238095238095238,-110,0.5011337868480725,CIN,LAD,2023 REG,14,9,8,8,17,22,1,0,1,-1,1,1,1,1,1,1,1,1,0,0.4988662131519274,0.5011337868480725
91468,0.5121951219512195,0.5305164319248826,-105,-113,0.4903184724049234,0.5096815275950766,away,CWS,over,8,0.5238095238095238,-110,0.4988662131519274,DET,CWS,2023 REG,6,6,8,5,11,14,1,0,1,-1,1,1,1,1,1,0,0,0,0,0.4988662131519274,0.5011337868480725
91468,0.5121951219512195,0.5305164319248826,-105,-113,0.4903184724049234,0.5096815275950766,home,DET,under,8,0.5238095238095238,-110,0.5011337868480725,DET,CWS,2023 REG,6,6,8,5,11,14,1,0,1,-1,1,1,1,1,1,0,0,0,0,0.4988662131519274,0.5011337868480725
91469,0.4444444444444444,0.5901639344262295,125,-144,0.4290629427241449,0.5709370572758551,away,STL,over,9,0.5391705069124424,-117,0.5153817639191344,PIT,STL,2023 REG,8,4,6,3,7,14,1,0,1,-1,1,1,1,0,0,0,0,0,0,0.5153817639191344,0.4846182360808656
91469,0.4444444444444444,0.5901639344262295,125,-144,0.4290629427241449,0.5709370572758551,home,PIT,under,9,0.504950495049505,-102,0.4846182360808656,PIT,STL,2023 REG,8,4,6,3,7,14,1,0,1,-1,1,1,1,0,0,0,0,0,0,0.5153817639191344,0.4846182360808656
91470,0.6336996336996338,0.4081632653061224,-173,145,0.6071711299340814,0.3928288700659186,away,BOS,over,8,0.5,100,0.4772727272727273,MIL,BOS,2023 REG,6,5,13,12,17,19,0,1,-7,7,1,1,1,1,1,0,0,0,0,0.4772727272727273,0.5227272727272727
91470,0.6336996336996338,0.4081632653061224,-173,145,0.6071711299340814,0.3928288700659186,home,MIL,under,8,0.5454545454545454,-120,0.5227272727272727,MIL,BOS,2023 REG,6,5,13,12,17,19,0,1,-7,7,1,1,1,1,1,0,0,0,0,0.4772727272727273,0.5227272727272727
91471,0.5145631067961165,0.5260663507109005,-106,-111,0.49365668691386505,0.506343313086135,away,ATL,over,9,0.5,100,0.4783105022831051,NYM,ATL,2023 REG,9,5,6,3,8,15,1,0,2,-2,1,1,1,0,0,0,0,0,0,0.4783105022831051,0.5216894977168949
91471,0.5145631067961165,0.5260663507109005,-106,-111,0.49365668691386505,0.506343313086135,home,NYM,under,9,0.5433789954337899,-119,0.5216894977168949,NYM,ATL,2023 REG,9,5,6,3,8,15,1,0,2,-2,1,1,1,0,0,0,0,0,0,0.4783105022831051,0.5216894977168949
91472,0.6226415094339623,0.4166666666666667,-165,140,0.5981666073335706,0.40183339266642937,away,PHI,over,6.5,0.5238095238095238,-110,0.4988662131519274,NYY,PHI,2023 REG,9,4,5,2,6,14,1,0,2,-2,1,1,0,0,0,0,0,0,0,0.4988662131519274,0.5011337868480725
91472,0.6226415094339623,0.4166666666666667,-165,140,0.5981666073335706,0.40183339266642937,home,NYY,under,6.5,0.5238095238095238,-110,0.5011337868480725,NYY,PHI,2023 REG,9,4,5,2,6,14,1,0,2,-2,1,1,0,0,0,0,0,0,0,0.4988662131519274,0.5011337868480725
91473,0.7142857142857143,0.3278688524590164,-250,205,0.6841753094680495,0.3158246905319505,away,WSH,over,9,0.504950495049505,-102,0.47949844489399435,LAD,WSH,2023 REG,6,6,6,1,7,12,1,0,5,-5,1,0,0,0,0,0,0,0,0,0.47949844489399435,0.5205015551060057
91473,0.7142857142857143,0.3278688524590164,-250,205,0.6841753094680495,0.3158246905319505,home,LAD,under,9,0.5454545454545454,-120,0.5205015551060057,LAD,WSH,2023 REG,6,6,6,1,7,12,1,0,5,-5,1,0,0,0,0,0,0,0,0,0.47949844489399435,0.5205015551060057
91474,0.75,0.2857142857142857,-300,250,0.7232142857142858,0.2767857142857142,away,COL,over,10,0.5169082125603864,-107,0.49353874091423283,ATL,COL,2023 REG,13,10,6,2,12,19,1,0,8,-8,1,1,0,0,0,0,0,0,0,0.49353874091423283,0.5064612590857671
91474,0.75,0.2857142857142857,-300,250,0.7232142857142858,0.2767857142857142,home,ATL,under,10,0.5283018867924528,-112,0.5064612590857671,ATL,COL,2023 REG,13,10,6,2,12,19,1,0,8,-8,1,1,0,0,0,0,0,0,0,0.49353874091423283,0.5064612590857671
91475,0.5,0.5454545454545454,100,-120,0.4772727272727273,0.5227272727272727,away,PHI,over,9.5,0.5348837209302326,-115,0.5097020142727117,CHC,PHI,2023 REG,7,1,7,3,4,14,0,1,-2,2,1,0,0,0,0,0,0,0,0,0.5097020142727117,0.49029798572728833
91475,0.5,0.5454545454545454,100,-120,0.4772727272727273,0.5227272727272727,home,CHC,under,9.5,0.5121951219512195,-105,0.49029798572728833,CHC,PHI,2023 REG,7,1,7,3,4,14,0,1,-2,2,1,0,0,0,0,0,0,0,0,0.5097020142727117,0.49029798572728833
91476,0.5,0.5454545454545454,100,-120,0.4772727272727273,0.5227272727272727,away,TOR,over,7,0.5454545454545454,-120,0.5206611570247933,NYY,TOR,2023 REG,5,1,9,6,7,14,0,1,-5,5,1,0,0,0,0,0,0,0,0,0.5206611570247933,0.4793388429752067
91476,0.5,0.5454545454545454,100,-120,0.4772727272727273,0.5227272727272727,home,NYY,under,7,0.5,100,0.4793388429752067,NYY,TOR,2023 REG,5,1,9,6,7,14,0,1,-5,5,1,0,0,0,0,0,0,0,0,0.5206611570247933,0.4793388429752067
91477,0.5348837209302326,0.5121951219512195,-115,-105,0.5097020142727117,0.49029798572728833,away,BAL,over,8,0.5348837209302326,-115,0.5097020142727117,SEA,BAL,2023 REG,6,3,9,5,8,15,0,1,-2,2,1,1,1,0,0,0,0,0,0,0.5097020142727117,0.49029798572728833
91477,0.5348837209302326,0.5121951219512195,-115,-105,0.5097020142727117,0.49029798572728833,home,SEA,under,8,0.5121951219512195,-105,0.49029798572728833,SEA,BAL,2023 REG,6,3,9,5,8,15,0,1,-2,2,1,1,1,0,0,0,0,0,0,0.5097020142727117,0.49029798572728833
91478,0.5652173913043479,0.47619047619047616,-130,110,0.5418129444594474,0.4581870555405526,away,NYY,over,6.5,0.5475113122171946,-121,0.5228602997583487,MIN,NYY,2023 REG,8,6,8,2,8,16,1,0,4,-4,1,1,0,0,0,0,0,0,0,0.5228602997583487,0.4771397002416513
91478,0.5652173913043479,0.47619047619047616,-130,110,0.5418129444594474,0.4581870555405526,home,MIN,under,6.5,0.49751243781094534,101,0.4771397002416513,MIN,NYY,2023 REG,8,6,8,2,8,16,1,0,4,-4,1,1,0,0,0,0,0,0,0,0.5228602997583487,0.4771397002416513
91479,0.6575342465753424,0.38314176245210724,-192,161,0.6307883776257865,0.36921162237421346,away,DET,over,9,0.5,100,0.4772727272727273,BAL,DET,2023 REG,7,2,5,1,3,12,1,0,1,-1,1,0,0,0,0,0,0,0,0,0.4772727272727273,0.5227272727272727
91479,0.6575342465753424,0.38314176245210724,-192,161,0.6307883776257865,0.36921162237421346,home,BAL,under,9,0.5454545454545454,-120,0.5227272727272727,BAL,DET,2023 REG,7,2,5,1,3,12,1,0,1,-1,1,0,0,0,0,0,0,0,0,0.4772727272727273,0.5227272727272727
91480,0.29411764705882354,0.7468354430379747,240,-295,0.28207262055976523,0.7179273794402348,away,ATL,over,8.5,0.5,100,0.4772727272727273,WSH,ATL,2023 REG,12,5,10,8,13,22,0,1,-3,3,1,1,1,1,1,0,0,0,0,0.4772727272727273,0.5227272727272727
91480,0.29411764705882354,0.7468354430379747,240,-295,0.28207262055976523,0.7179273794402348,away,ATL,over,9.5,0.49504950495049505,102,0.47297076509898783,WSH,ATL,2023 REG,12,5,10,8,13,22,0,1,-3,3,1,1,1,1,1,0,0,0,0,0.4772727272727273,0.5227272727272727
91480,0.29411764705882354,0.7468354430379747,240,-295,0.28207262055976523,0.7179273794402348,home,WSH,under,8.5,0.5454545454545454,-120,0.5227272727272727,WSH,ATL,2023 REG,12,5,10,8,13,22,0,1,-3,3,1,1,1,1,1,0,0,0,0,0.4772727272727273,0.5227272727272727
91480,0.29411764705882354,0.7468354430379747,240,-295,0.28207262055976523,0.7179273794402348,home,WSH,under,9.5,0.5495495495495495,-122,0.5270292349010122,WSH,ATL,2023 REG,12,5,10,8,13,22,0,1,-3,3,1,1,1,1,1,0,0,0,0,0.4772727272727273,0.5227272727272727
91481,0.504950495049505,0.5370370370370371,-102,-116,0.4837488699364985,0.5162511300635015,away,TOR,over,9,0.5098039215686274,-104,0.48375889301574193,TB,TOR,2023 REG,7,6,11,4,10,18,1,0,2,-2,1,1,1,1,0,0,0,0,0,0.48375889301574193,0.5162411069842581
91481,0.504950495049505,0.5370370370370371,-102,-116,0.4837488699364985,0.5162511300635015,home,TB,under,9,0.5412844036697247,-118,0.5162411069842581,TB,TOR,2023 REG,7,6,11,4,10,18,1,0,2,-2,1,1,1,1,0,0,0,0,0,0.48375889301574193,0.5162411069842581
91482,0.4347826086956522,0.607843137254902,130,-155,0.41624967567367205,0.583750324326328,away,DET,over,8.5,0.5192307692307692,-108,0.49455035168025013,KC,DET,2023 REG,5,2,8,3,5,13,0,1,-1,1,1,1,0,0,0,0,0,0,0,0.49455035168025013,0.5054496483197499
91482,0.4347826086956522,0.607843137254902,130,-155,0.41624967567367205,0.583750324326328,home,KC,under,8.5,0.5283018867924528,-112,0.5054496483197499,KC,DET,2023 REG,5,2,8,3,5,13,0,1,-1,1,1,1,0,0,0,0,0,0,0,0.49455035168025013,0.5054496483197499
91483,0.4464285714285714,0.5934959349593496,124,-146,0.42860513107682097,0.571394868923179,away,STL,over,9.5,0.5,100,0.4772727272727273,KC,STL,2023 REG,11,4,8,5,9,19,0,1,-1,1,1,1,1,1,0,0,0,0,0,0.4772727272727273,0.5227272727272727
91483,0.4464285714285714,0.5934959349593496,124,-146,0.42860513107682097,0.571394868923179,home,KC,under,9.5,0.5454545454545454,-120,0.5227272727272727,KC,STL,2023 REG,11,4,8,5,9,19,0,1,-1,1,1,1,1,1,0,0,0,0,0,0.4772727272727273,0.5227272727272727
91484,0.45454545454545453,0.5833333333333333,120,-140,0.43732782369146006,0.5626721763085399,away,CLE,over,8.5,0.5121951219512195,-105,0.48808156828023186,PIT,CLE,2023 REG,9,7,10,5,12,19,1,0,2,-2,1,1,1,1,1,0,0,0,0,0.48808156828023186,0.5119184317197681
91484,0.45454545454545453,0.5833333333333333,120,-140,0.43732782369146006,0.5626721763085399,home,PIT,under,8.5,0.5348837209302326,-115,0.5119184317197681,PIT,CLE,2023 REG,9,7,10,5,12,19,1,0,2,-2,1,1,1,1,1,0,0,0,0,0.48808156828023186,0.5119184317197681
91485,0.5475113122171946,0.49504950495049505,-121,102,0.5242087833606768,0.4757912166393232,away,CIN,over,7.5,0.5348837209302326,-115,0.5097020142727117,CLE,CIN,2023 REG,9,7,10,11,18,19,0,1,-4,4,1,1,1,1,1,1,1,0,0,0.5097020142727117,0.49029798572728833
91485,0.5475113122171946,0.49504950495049505,-121,102,0.5242087833606768,0.4757912166393232,home,CLE,under,7.5,0.5121951219512195,-105,0.49029798572728833,CLE,CIN,2023 REG,9,7,10,11,18,19,0,1,-4,4,1,1,1,1,1,1,1,0,0,0.5097020142727117,0.49029798572728833
91486,0.48780487804878053,0.5555555555555556,105,-125,0.4666534470222751,0.5333465529777248,away,BAL,over,8.5,0.5238095238095238,-110,0.4988662131519274,NYY,BAL,2023 REG,7,1,20,14,15,27,0,1,-13,13,1,0,0,0,0,0,0,0,0,0.4988662131519274,0.5011337868480725
91486,0.48780487804878053,0.5555555555555556,105,-125,0.4666534470222751,0.5333465529777248,home,NYY,under,8.5,0.5238095238095238,-110,0.5011337868480725,NYY,BAL,2023 REG,7,1,20,14,15,27,0,1,-13,13,1,0,0,0,0,0,0,0,0,0.4988662131519274,0.5011337868480725
91487,0.5867768595041323,0.45454545454545453,-142,120,0.5625298818386723,0.43747011816132775,away,OAK,over,9.5,0.5215311004784688,-109,0.4978845547971712,WSH,OAK,2023 REG,9,3,7,2,5,16,1,0,1,-1,1,1,0,0,0,0,0,0,0,0.4978845547971712,0.5021154452028288
91487,0.5867768595041323,0.45454545454545453,-142,120,0.5625298818386723,0.43747011816132775,home,WSH,under,9.5,0.5238095238095238,-110,0.5021154452028288,WSH,OAK,2023 REG,9,3,7,2,5,16,1,0,1,-1,1,1,0,0,0,0,0,0,0,0.4978845547971712,0.5021154452028288
91488,0.6376811594202898,0.40322580645161293,-176,148,0.6115955579947286,0.38840444200527136,away,BOS,over,9.5,0.5238095238095238,-110,0.5000596729920038,ATL,BOS,2023 REG,8,2,7,5,7,15,0,1,-3,3,1,1,0,0,0,0,0,0,0,0.5000596729920038,0.4999403270079962
91488,0.6376811594202898,0.40322580645161293,-176,148,0.6115955579947286,0.38840444200527136,home,ATL,under,9.5,0.5215311004784688,-109,0.4999403270079962,ATL,BOS,2023 REG,8,2,7,5,7,15,0,1,-3,3,1,1,0,0,0,0,0,0,0,0.5000596729920038,0.4999403270079962
91489,0.6875,0.35714285714285715,-220,180,0.6568080357142857,0.3431919642857143,away,COL,over,9,0.5238095238095238,-110,0.4988662131519274,ARI,COL,2023 REG,6,2,7,3,5,13,0,1,-1,1,1,1,0,0,0,0,0,0,0,0.4988662131519274,0.5011337868480725
91489,0.6875,0.35714285714285715,-220,180,0.6568080357142857,0.3431919642857143,home,ARI,under,9,0.5238095238095238,-110,0.5011337868480725,ARI,COL,2023 REG,6,2,7,3,5,13,0,1,-1,1,1,1,0,0,0,0,0,0,0,0.4988662131519274,0.5011337868480725
91490,0.47619047619047616,0.5652173913043479,110,-130,0.4564724440500838,0.5435275559499162,away,LAD,over,10,0.5238095238095238,-110,0.4988662131519274,BOS,LAD,2023 REG,10,8,10,5,13,20,1,0,3,-3,1,1,1,1,1,0,0,0,0,0.4988662131519274,0.5011337868480725
91490,0.47619047619047616,0.5652173913043479,110,-130,0.4564724440500838,0.5435275559499162,home,BOS,under,10,0.5238095238095238,-110,0.5011337868480725,BOS,LAD,2023 REG,10,8,10,5,13,20,1,0,3,-3,1,1,1,1,1,0,0,0,0,0.4988662131519274,0.5011337868480725
91491,0.47619047619047616,0.5652173913043479,110,-130,0.4564724440500838,0.5435275559499162,away,CIN,over,9,0.5348837209302326,-115,0.5097020142727117,STL,CIN,2023 REG,13,15,14,6,21,27,1,0,9,-9,1,1,1,1,1,1,0,0,0,0.5097020142727117,0.49029798572728833
91491,0.47619047619047616,0.5652173913043479,110,-130,0.4564724440500838,0.5435275559499162,home,STL,under,9,0.5121951219512195,-105,0.49029798572728833,STL,CIN,2023 REG,13,15,14,6,21,27,1,0,9,-9,1,1,1,1,1,1,0,0,0,0.5097020142727117,0.49029798572728833
91492,0.425531914893617,0.607843137254902,135,-155,0.4113297650431834,0.5886702349568166,away,LAA,over,12,0.5305164319248826,-113,0.5066009958897986,COL,LAA,2023 REG,15,7,11,4,11,26,1,0,3,-3,1,1,1,1,0,0,0,0,0,0.5066009958897986,0.49339900411020143
91492,0.425531914893617,0.607843137254902,135,-155,0.4113297650431834,0.5886702349568166,home,COL,under,12,0.5145631067961165,-106,0.49339900411020143,COL,LAA,2023 REG,15,7,11,4,11,26,1,0,3,-3,1,1,1,1,0,0,0,0,0,0.5066009958897986,0.49339900411020143
91493,0.6183206106870228,0.42372881355932196,-162,136,0.5923205850079852,0.40767941499201477,away,CWS,over,8.5,0.5348837209302326,-115,0.5097020142727117,BOS,CWS,2023 REG,5,2,4,3,5,9,0,1,-1,1,1,1,0,0,0,0,0,0,0,0.5097020142727117,0.49029798572728833
91493,0.6183206106870228,0.42372881355932196,-162,136,0.5923205850079852,0.40767941499201477,home,BOS,under,8.5,0.5121951219512195,-105,0.49029798572728833,BOS,CWS,2023 REG,5,2,4,3,5,9,0,1,-1,1,1,1,0,0,0,0,0,0,0,0.5097020142727117,0.49029798572728833
91494,0.4444444444444444,0.5967741935483871,125,-148,0.42612504978096366,0.5738749502190363,away,LAD,over,9,0.5,100,0.4772727272727273,MIA,LAD,2023 REG,13,11,6,4,15,19,1,0,7,-7,1,1,1,1,0,0,0,0,0,0.4772727272727273,0.5227272727272727
91494,0.4444444444444444,0.5967741935483871,125,-148,0.42612504978096366,0.5738749502190363,home,MIA,under,9,0.5454545454545454,-120,0.5227272727272727,MIA,LAD,2023 REG,13,11,6,4,15,19,1,0,7,-7,1,1,1,1,0,0,0,0,0,0.4772727272727273,0.5227272727272727
91495,0.3846153846153846,0.6491228070175439,160,-185,0.37163915706425826,0.6283608429357417,away,SEA,over,8.5,0.5121951219512195,-105,0.48808156828023186,DET,SEA,2023 REG,9,5,10,3,8,19,1,0,2,-2,1,1,1,0,0,0,0,0,0,0.48808156828023186,0.5119184317197681
91495,0.3846153846153846,0.6491228070175439,160,-185,0.37163915706425826,0.6283608429357417,home,DET,under,8.5,0.5348837209302326,-115,0.5119184317197681,DET,SEA,2023 REG,9,5,10,3,8,19,1,0,2,-2,1,1,1,0,0,0,0,0,0,0.48808156828023186,0.5119184317197681
91496,0.5121951219512195,0.5348837209302326,-105,-115,0.48808156828023186,0.5119184317197681,away,CIN,over,10,0.5348837209302326,-115,0.5097020142727117,WSH,CIN,2023 REG,7,4,16,8,12,23,0,1,-4,4,1,1,1,1,0,0,0,0,0,0.5097020142727117,0.49029798572728833
91496,0.5121951219512195,0.5348837209302326,-105,-115,0.48808156828023186,0.5119184317197681,home,WSH,under,10,0.5121951219512195,-105,0.49029798572728833,WSH,CIN,2023 REG,7,4,16,8,12,23,0,1,-4,4,1,1,1,1,0,0,0,0,0,0.5097020142727117,0.49029798572728833
91497,0.574468085106383,0.46511627906976744,-135,115,0.5517281312179562,0.44827186878204384,away,CHC,over,8.5,0.5454545454545454,-120,0.5206611570247933,STL,CHC,2023 REG,8,3,5,0,3,13,1,0,3,-3,0,0,0,0,0,0,0,0,0,0.5206611570247933,0.4793388429752067
91497,0.574468085106383,0.46511627906976744,-135,115,0.5517281312179562,0.44827186878204384,home,STL,under,8.5,0.5,100,0.4793388429752067,STL,CHC,2023 REG,8,3,5,0,3,13,1,0,3,-3,0,0,0,0,0,0,0,0,0,0.5206611570247933,0.4793388429752067
91990,0.5689655172413793,0.4716981132075471,-132,112,0.5458293137100936,0.4541706862899064,away,PHI,over,8.5,0.5121951219512195,-105,0.48808156828023186,CWS,PHI,2023 REG,3,3,1,0,3,4,1,0,3,-3,0,0,0,0,0,0,0,0,0,0.48808156828023186,0.5119184317197681
91990,0.5689655172413793,0.4716981132075471,-132,112,0.5458293137100936,0.4541706862899064,home,CWS,under,8.5,0.5348837209302326,-115,0.5119184317197681,CWS,PHI,2023 REG,3,3,1,0,3,4,1,0,3,-3,0,0,0,0,0,0,0,0,0,0.48808156828023186,0.5119184317197681
91991,0.46511627906976744,0.5689655172413793,115,-132,0.4492642807855131,0.5507357192144868,away,PHI,over,8,0.5169082125603864,-107,0.49353874091423283,CWS,PHI,2023 REG,8,4,14,7,11,22,0,1,-3,3,1,1,1,1,0,0,0,0,0,0.49353874091423283,0.5064612590857671
91991,0.46511627906976744,0.5689655172413793,115,-132,0.4492642807855131,0.5507357192144868,home,CWS,under,8,0.5283018867924528,-112,0.5064612590857671,CWS,PHI,2023 REG,8,4,14,7,11,22,0,1,-3,3,1,1,1,1,0,0,0,0,0,0.49353874091423283,0.5064612590857671
91992,0.08,0.9803921568627451,1150,-5000,0.07516862745098041,0.9248313725490196,away,TOR,over,NA,NA,NA,NA,CWS,TOR,2023 REG,4,2,8,6,8,12,0,1,-4,4,1,1,0,0,0,0,0,0,0,NA,NA
91992,0.08,0.9803921568627451,1150,-5000,0.07516862745098041,0.9248313725490196,home,CWS,under,NA,NA,NA,NA,CWS,TOR,2023 REG,4,2,8,6,8,12,0,1,-4,4,1,1,0,0,0,0,0,0,0,NA,NA
92490,0.46511627906976744,0.574468085106383,115,-135,0.44670494689481377,0.5532950531051862,away,STL,over,7.5,0.5238095238095238,-110,0.4988662131519274,NYM,STL,2024 REG,7,4,10,7,11,17,0,1,-3,3,1,1,1,1,0,0,0,0,0,0.4988662131519274,0.5011337868480725
92490,0.46511627906976744,0.574468085106383,115,-135,0.44670494689481377,0.5532950531051862,home,NYM,under,7.5,0.5238095238095238,-110,0.5011337868480725,NYM,STL,2024 REG,7,4,10,7,11,17,0,1,-3,3,1,1,1,1,0,0,0,0,0,0.4988662131519274,0.5011337868480725
92515,0.5121951219512195,0.5283018867924528,-105,-112,0.49145275161909474,0.5085472483809053,away,KC,over,8.5,0.5073891625615764,-103,0.4837652908580103,NYM,KC,2024 REG,8,2,3,1,3,11,1,0,1,-1,1,0,0,0,0,0,0,0,0,0.4837652908580103,0.5162347091419897
92515,0.5121951219512195,0.5283018867924528,-105,-112,0.49145275161909474,0.5085472483809053,home,NYM,under,8.5,0.5391705069124424,-117,0.5162347091419897,NYM,KC,2024 REG,8,2,3,1,3,11,1,0,1,-1,1,0,0,0,0,0,0,0,0,0.4837652908580103,0.5162347091419897
92519,0.6721311475409836,0.3663003663003663,-205,173,0.6463001300410599,0.3536998699589401,away,COL,over,8.5,0.5215311004784688,-109,0.49670754937970685,MIN,COL,2024 REG,8,4,7,5,9,15,0,1,-1,1,1,1,1,1,0,0,0,0,0,0.49670754937970685,0.5032924506202932
92519,0.6721311475409836,0.3663003663003663,-205,173,0.6463001300410599,0.3536998699589401,home,MIN,under,8.5,0.5260663507109005,-111,0.5032924506202932,MIN,COL,2024 REG,8,4,7,5,9,15,0,1,-1,1,1,1,1,1,0,0,0,0,0,0.49670754937970685,0.5032924506202932
92533,0.5901639344262295,0.4484304932735426,-144,123,0.5673868951280033,0.43261310487199667,away,WSH,over,8,0.5121951219512195,-105,0.48808156828023186,OAK,WSH,2024 REG,11,7,12,6,13,23,1,0,1,-1,1,1,1,1,1,1,0,0,0,0.48808156828023186,0.5119184317197681
92533,0.5901639344262295,0.4484304932735426,-144,123,0.5673868951280033,0.43261310487199667,home,OAK,under,8,0.5348837209302326,-115,0.5119184317197681,OAK,WSH,2024 REG,11,7,12,6,13,23,1,0,1,-1,1,1,1,1,1,1,0,0,0,0.48808156828023186,0.5119184317197681
92535,0.3846153846153846,0.6551724137931035,160,-190,0.3693123852275045,0.6306876147724956,away,TEX,over,9.5,0.5348837209302326,-115,0.5097020142727117,COL,TEX,2024 REG,10,4,5,2,6,15,1,0,2,-2,1,1,0,0,0,0,0,0,0,0.5097020142727117,0.49029798572728833
92535,0.3846153846153846,0.6551724137931035,160,-190,0.3693123852275045,0.6306876147724956,home,COL,under,9.5,0.5121951219512195,-105,0.49029798572728833,COL,TEX,2024 REG,10,4,5,2,6,15,1,0,2,-2,1,1,0,0,0,0,0,0,0,0.5097020142727117,0.49029798572728833
92538,0.5238095238095238,0.5169082125603864,-110,-107,0.5024811857109994,0.4975188142890006,away,CLE,over,9.5,0.5260663507109005,-111,0.5010269332605688,KC,CLE,2024 REG,13,10,8,3,13,21,1,0,7,-7,1,1,1,0,0,0,0,0,0,0.5010269332605688,0.4989730667394312
92538,0.5238095238095238,0.5169082125603864,-110,-107,0.5024811857109994,0.4975188142890006,home,KC,under,9.5,0.5215311004784688,-109,0.4989730667394312,KC,CLE,2024 REG,13,10,8,3,13,21,1,0,7,-7,1,1,1,0,0,0,0,0,0,0.5010269332605688,0.4989730667394312
92539,0.425531914893617,0.6108949416342413,135,-157,0.41003112488176247,0.5899688751182375,away,ATL,over,7,0.5238095238095238,-110,0.4988662131519274,NYM,ATL,2024 REG,2,1,7,4,5,9,0,1,-3,3,1,0,0,0,0,0,0,0,0,0.4988662131519274,0.5011337868480725
92539,0.425531914893617,0.6108949416342413,135,-157,0.41003112488176247,0.5899688751182375,home,NYM,under,7,0.5238095238095238,-110,0.5011337868480725,NYM,ATL,2024 REG,2,1,7,4,5,9,0,1,-3,3,1,0,0,0,0,0,0,0,0,0.4988662131519274,0.5011337868480725
92542,0.6865203761755486,0.35714285714285715,-219,180,0.656544676812756,0.34345532318724403,away,MIA,over,9.5,0.5121951219512195,-105,0.48808156828023186,ATL,MIA,2024 REG,8,3,8,0,3,16,1,0,3,-3,0,0,0,0,0,0,0,0,0,0.48808156828023186,0.5119184317197681
92542,0.6865203761755486,0.35714285714285715,-219,180,0.656544676812756,0.34345532318724403,home,ATL,under,9.5,0.5348837209302326,-115,0.5119184317197681,ATL,MIA,2024 REG,8,3,8,0,3,16,1,0,3,-3,0,0,0,0,0,0,0,0,0,0.48808156828023186,0.5119184317197681
92544,0.5283018867924528,0.5121951219512195,-112,-105,0.5069072406637203,0.4930927593362797,away,CIN,over,8,0.5073891625615764,-103,0.4826927225525911,SD,CIN,2024 REG,4,2,8,5,7,12,0,1,-3,3,1,1,0,0,0,0,0,0,0,0.4826927225525911,0.5173072774474089
92544,0.5283018867924528,0.5121951219512195,-112,-105,0.5069072406637203,0.4930927593362797,home,SD,under,8,0.5412844036697247,-118,0.5173072774474089,SD,CIN,2024 REG,4,2,8,5,7,12,0,1,-3,3,1,1,0,0,0,0,0,0,0,0.4826927225525911,0.5173072774474089
92550,0.5689655172413793,0.4716981132075471,-132,112,0.5458293137100936,0.4541706862899064,away,KC,over,8,0.5454545454545454,-120,0.5179608869977906,CLE,KC,2024 REG,7,8,10,5,13,17,1,0,3,-3,1,1,1,1,1,0,0,0,0,0.5179608869977906,0.48203911300220936
92550,0.5689655172413793,0.4716981132075471,-132,112,0.5458293137100936,0.4541706862899064,home,CLE,under,8,0.504950495049505,-102,0.48203911300220936,CLE,KC,2024 REG,7,8,10,5,13,17,1,0,3,-3,1,1,1,1,1,0,0,0,0,0.5179608869977906,0.48203911300220936
92557,0.6835443037974683,0.36101083032490977,-216,177,0.6530888956631846,0.3469111043368154,away,PIT,over,9,0.5238095238095238,-110,0.5000596729920038,ATL,PIT,2024 REG,10,6,6,1,7,16,1,0,5,-5,1,0,0,0,0,0,0,0,0,0.5000596729920038,0.4999403270079962
92557,0.6835443037974683,0.36101083032490977,-216,177,0.6530888956631846,0.3469111043368154,home,ATL,under,9,0.5215311004784688,-109,0.4999403270079962,ATL,PIT,2024 REG,10,6,6,1,7,16,1,0,5,-5,1,0,0,0,0,0,0,0,0,0.5000596729920038,0.4999403270079962
92565,0.6453900709219857,0.3968253968253968,-182,152,0.6181446271984977,0.3818553728015023,away,MIN,over,7.5,0.5348837209302326,-115,0.5097020142727117,NYY,MIN,2024 REG,6,5,2,1,6,8,1,0,4,-4,1,0,0,0,0,0,0,0,0,0.5097020142727117,0.49029798572728833
92565,0.6453900709219857,0.3968253968253968,-182,152,0.6181446271984977,0.3818553728015023,home,NYY,under,7.5,0.5121951219512195,-105,0.49029798572728833,NYY,MIN,2024 REG,6,5,2,1,6,8,1,0,4,-4,1,0,0,0,0,0,0,0,0,0.5097020142727117,0.49029798572728833
92566,0.5,0.5454545454545454,100,-120,0.4772727272727273,0.5227272727272727,away,NYM,over,8.5,0.5238095238095238,-110,0.4988662131519274,CIN,NYM,2024 REG,3,1,9,3,4,12,0,1,-2,2,1,0,0,0,0,0,0,0,0,0.4988662131519274,0.5011337868480725
92566,0.5,0.5454545454545454,100,-120,0.4772727272727273,0.5227272727272727,home,CIN,under,8.5,0.5238095238095238,-110,0.5011337868480725,CIN,NYM,2024 REG,3,1,9,3,4,12,0,1,-2,2,1,0,0,0,0,0,0,0,0,0.4988662131519274,0.5011337868480725
92568,0.5652173913043479,0.47619047619047616,-130,110,0.5418129444594474,0.4581870555405526,away,BAL,over,8.5,0.5192307692307692,-108,0.49455035168025013,TOR,BAL,2024 REG,7,6,6,5,11,13,1,0,1,-1,1,1,1,1,1,0,0,0,0,0.49455035168025013,0.5054496483197499
92568,0.5652173913043479,0.47619047619047616,-130,110,0.5418129444594474,0.4581870555405526,home,TOR,under,8.5,0.5283018867924528,-112,0.5054496483197499,TOR,BAL,2024 REG,7,6,6,5,11,13,1,0,1,-1,1,1,1,1,1,0,0,0,0,0.49455035168025013,0.5054496483197499
92569,0.7590361445783133,0.28169014084507044,-315,255,0.7281234219075522,0.2718765780924478,away,ARI,over,8,0.5121951219512195,-105,0.48808156828023186,LAD,ARI,2024 REG,6,0,9,6,6,15,0,1,-6,6,0,0,0,0,0,0,0,0,0,0.48808156828023186,0.5119184317197681
92569,0.7590361445783133,0.28169014084507044,-315,255,0.7281234219075522,0.2718765780924478,home,LAD,under,8,0.5348837209302326,-115,0.5119184317197681,LAD,ARI,2024 REG,6,0,9,6,6,15,0,1,-6,6,0,0,0,0,0,0,0,0,0,0.48808156828023186,0.5119184317197681
92571,0.5652173913043479,0.47619047619047616,-130,110,0.5418129444594474,0.4581870555405526,away,SF,over,7.5,0.5391705069124424,-117,0.5153817639191344,ATL,SF,2024 REG,8,2,6,4,6,14,0,1,-2,2,1,1,0,0,0,0,0,0,0,0.5153817639191344,0.4846182360808656
92571,0.5652173913043479,0.47619047619047616,-130,110,0.5418129444594474,0.4581870555405526,home,ATL,under,7.5,0.504950495049505,-102,0.4846182360808656,ATL,SF,2024 REG,8,2,6,4,6,14,0,1,-2,2,1,1,0,0,0,0,0,0,0,0.5153817639191344,0.4846182360808656
92575,0.4166666666666667,0.6226415094339623,140,-165,0.4002882599580712,0.5997117400419287,away,ATL,over,8,0.5391705069124424,-117,0.5114756747601454,BOS,ATL,2024 REG,5,3,8,8,11,13,0,1,-5,5,1,1,1,0,0,0,0,0,0,0.5114756747601454,0.48852432523985456
92575,0.4166666666666667,0.6226415094339623,140,-165,0.4002882599580712,0.5997117400419287,home,BOS,under,8,0.5121951219512195,-105,0.48852432523985456,BOS,ATL,2024 REG,5,3,8,8,11,13,0,1,-5,5,1,1,1,0,0,0,0,0,0,0.5114756747601454,0.48852432523985456
92583,0.49504950495049505,0.5475113122171946,102,-121,0.4739797934813417,0.5260202065186583,away,LAD,over,9,0.5098039215686274,-104,0.48592421718142587,DET,LAD,2024 REG,16,11,12,9,20,28,1,0,2,-2,1,1,1,1,1,1,1,1,1,0.48592421718142587,0.5140757828185741
92583,0.49504950495049505,0.5475113122171946,102,-121,0.4739797934813417,0.5260202065186583,home,DET,under,9,0.5370370370370371,-116,0.5140757828185741,DET,LAD,2024 REG,16,11,12,9,20,28,1,0,2,-2,1,1,1,1,1,1,1,1,1,0.48592421718142587,0.5140757828185741
92590,0.6875,0.35460992907801414,-220,182,0.6585494237588654,0.3414505762411346,away,OAK,over,7.5,0.5,100,0.4772727272727273,SEA,OAK,2024 REG,8,8,8,4,12,16,1,0,4,-4,1,1,1,1,0,0,0,0,0,0.4772727272727273,0.5227272727272727
92590,0.6875,0.35460992907801414,-220,182,0.6585494237588654,0.3414505762411346,home,SEA,under,7.5,0.5454545454545454,-120,0.5227272727272727,SEA,OAK,2024 REG,8,8,8,4,12,16,1,0,4,-4,1,1,1,1,0,0,0,0,0,0.4772727272727273,0.5227272727272727
92591,0.5348837209302326,0.5098039215686274,-115,-104,0.5109810284308424,0.48901897156915763,away,SD,over,8.5,0.5121951219512195,-105,0.48808156828023186,MIL,SD,2024 REG,10,3,12,7,10,22,0,1,-4,4,1,1,1,0,0,0,0,0,0,0.48808156828023186,0.5119184317197681
92591,0.5348837209302326,0.5098039215686274,-115,-104,0.5109810284308424,0.48901897156915763,home,MIL,under,8.5,0.5348837209302326,-115,0.5119184317197681,MIL,SD,2024 REG,10,3,12,7,10,22,0,1,-4,4,1,1,1,0,0,0,0,0,0,0.48808156828023186,0.5119184317197681
92599,0.5515695067264574,0.49019607843137253,-123,104,0.5285328835228112,0.47146711647718875,away,CIN,over,7,0.5238095238095238,-110,0.4988662131519274,CHC,CIN,2024 REG,8,2,10,5,7,18,0,1,-3,3,1,1,0,0,0,0,0,0,0,0.4988662131519274,0.5011337868480725
92599,0.5515695067264574,0.49019607843137253,-123,104,0.5285328835228112,0.47146711647718875,home,CHC,under,7,0.5238095238095238,-110,0.5011337868480725,CHC,CIN,2024 REG,8,2,10,5,7,18,0,1,-3,3,1,1,0,0,0,0,0,0,0,0.4988662131519274,0.5011337868480725
92600,0.5726495726495727,0.4672897196261683,-134,114,0.5497783539959433,0.4502216460040567,away,COL,over,8.5,0.5391705069124424,-117,0.5153817639191344,CWS,COL,2024 REG,8,5,3,3,8,11,1,0,2,-2,1,1,1,0,0,0,0,0,0,0.5153817639191344,0.4846182360808656
92600,0.5726495726495727,0.4672897196261683,-134,114,0.5497783539959433,0.4502216460040567,home,CWS,under,8.5,0.504950495049505,-102,0.4846182360808656,CWS,COL,2024 REG,8,5,3,3,8,11,1,0,2,-2,1,1,1,0,0,0,0,0,0,0.5153817639191344,0.4846182360808656
92601,0.4347826086956522,0.601593625498008,130,-151,0.41896685469840866,0.5810331453015913,away,BOS,over,8.5,0.5121951219512195,-105,0.48697865027430753,OAK,BOS,2024 REG,7,4,12,5,9,19,0,1,-1,1,1,1,1,1,0,0,0,0,0,0.48697865027430753,0.5130213497256925
92601,0.4347826086956522,0.601593625498008,130,-151,0.41896685469840866,0.5810331453015913,home,OAK,under,8.5,0.5370370370370371,-116,0.5130213497256925,OAK,BOS,2024 REG,7,4,12,5,9,19,0,1,-1,1,1,1,1,1,0,0,0,0,0,0.48697865027430753,0.5130213497256925
92604,0.635036496350365,0.4081632653061224,-174,145,0.6076030710648583,0.39239692893514166,away,SF,over,7,0.5412844036697247,-118,0.5175913212324037,PHI,SF,2024 REG,6,4,8,3,7,14,1,0,1,-1,1,1,1,0,0,0,0,0,0,0.5175913212324037,0.4824086787675963
92604,0.635036496350365,0.4081632653061224,-174,145,0.6076030710648583,0.39239692893514166,home,PHI,under,7,0.5024875621890548,-101,0.4824086787675963,PHI,SF,2024 REG,6,4,8,3,7,14,1,0,1,-1,1,1,1,0,0,0,0,0,0,0.5175913212324037,0.4824086787675963
92606,0.613899613899614,0.425531914893617,-159,135,0.589692613597978,0.410307386402022,away,STL,over,9.5,0.5,100,0.47522522522522526,CIN,STL,2024 REG,5,3,5,1,4,10,1,0,2,-2,1,0,0,0,0,0,0,0,0,0.47522522522522526,0.5247747747747747
92606,0.613899613899614,0.425531914893617,-159,135,0.589692613597978,0.410307386402022,home,CIN,under,9.5,0.5495495495495495,-122,0.5247747747747747,CIN,STL,2024 REG,5,3,5,1,4,10,1,0,2,-2,1,0,0,0,0,0,0,0,0,0.47522522522522526,0.5247747747747747
92607,0.5934959349593496,0.4484304932735426,-146,123,0.5686127702357632,0.4313872297642368,away,SEA,over,7,0.5,100,0.4772727272727273,BAL,SEA,2024 REG,12,6,9,3,9,21,1,0,3,-3,1,1,1,0,0,0,0,0,0,0.4772727272727273,0.5227272727272727
92607,0.5934959349593496,0.4484304932735426,-146,123,0.5686127702357632,0.4313872297642368,home,BAL,under,7,0.5454545454545454,-120,0.5227272727272727,BAL,SEA,2024 REG,12,6,9,3,9,21,1,0,3,-3,1,1,1,0,0,0,0,0,0,0.4772727272727273,0.5227272727272727
92609,0.6197718631178707,0.42016806722689076,-163,138,0.5950182180753,0.4049817819247,away,KC,over,8,0.5412844036697247,-118,0.5162581740877563,BAL,KC,2024 REG,9,6,7,4,10,16,1,0,2,-2,1,1,1,1,0,0,0,0,0,0.5162581740877563,0.4837418259122437
92609,0.6197718631178707,0.42016806722689076,-163,138,0.5950182180753,0.4049817819247,home,BAL,under,8,0.504950495049505,-102,0.4837418259122437,BAL,KC,2024 REG,9,6,7,4,10,16,1,0,2,-2,1,1,1,1,0,0,0,0,0,0.5162581740877563,0.4837418259122437
92616,0.5689655172413793,0.4716981132075471,-132,112,0.5458293137100936,0.4541706862899064,away,MIN,over,9,0.5238095238095238,-110,0.4988662131519274,BAL,MIN,2024 REG,12,7,11,4,11,23,1,0,3,-3,1,1,1,1,0,0,0,0,0,0.4988662131519274,0.5011337868480725
92616,0.5689655172413793,0.4716981132075471,-132,112,0.5458293137100936,0.4541706862899064,home,BAL,under,9,0.5238095238095238,-110,0.5011337868480725,BAL,MIN,2024 REG,12,7,11,4,11,23,1,0,3,-3,1,1,1,1,0,0,0,0,0,0.4988662131519274,0.5011337868480725
92618,0.6000000000000001,0.4366812227074236,-150,129,0.5779912663755458,0.42200873362445424,away,MIL,over,9.5,0.5,100,0.4772727272727273,BOS,MIL,2024 REG,5,3,11,6,9,16,0,1,-3,3,1,1,1,0,0,0,0,0,0,0.4772727272727273,0.5227272727272727
92618,0.6000000000000001,0.4366812227074236,-150,129,0.5779912663755458,0.42200873362445424,home,BOS,under,9.5,0.5454545454545454,-120,0.5227272727272727,BOS,MIL,2024 REG,5,3,11,6,9,16,0,1,-3,3,1,1,1,0,0,0,0,0,0,0.4772727272727273,0.5227272727272727
92626,0.6987951807228916,0.3436426116838488,-232,191,0.669139855908543,0.33086014409145703,away,OAK,over,8.5,0.5121951219512195,-105,0.48808156828023186,ATL,OAK,2024 REG,6,4,6,2,6,12,1,0,2,-2,1,1,0,0,0,0,0,0,0,0.48808156828023186,0.5119184317197681
92626,0.6987951807228916,0.3436426116838488,-232,191,0.669139855908543,0.33086014409145703,home,ATL,under,8.5,0.5348837209302326,-115,0.5119184317197681,ATL,OAK,2024 REG,6,4,6,2,6,12,1,0,2,-2,1,1,0,0,0,0,0,0,0,0.48808156828023186,0.5119184317197681
92627,0.45454545454545453,0.5850622406639003,120,-141,0.4365419567230205,0.5634580432769796,away,CIN,over,11.5,0.5260663507109005,-111,0.49982833141342614,COL,CIN,2024 REG,13,7,12,12,19,25,0,1,-5,5,1,1,1,1,1,1,1,0,0,0.49982833141342614,0.5001716685865738
92627,0.45454545454545453,0.5850622406639003,120,-141,0.4365419567230205,0.5634580432769796,home,COL,under,11.5,0.5238095238095238,-110,0.5001716685865738,COL,CIN,2024 REG,13,7,12,12,19,25,0,1,-5,5,1,1,1,1,1,1,1,0,0,0.49982833141342614,0.5001716685865738
92632,0.6062992125984252,0.4347826086956522,-154,130,0.581391336695717,0.41860866330428304,away,CLE,over,7.5,0.5,100,0.4772727272727273,SEA,CLE,2024 REG,5,0,10,8,8,15,0,1,-8,8,0,0,0,0,0,0,0,0,0,0.4772727272727273,0.5227272727272727
92632,0.6062992125984252,0.4347826086956522,-154,130,0.581391336695717,0.41860866330428304,home,SEA,under,7.5,0.5454545454545454,-120,0.5227272727272727,SEA,CLE,2024 REG,5,0,10,8,8,15,0,1,-8,8,0,0,0,0,0,0,0,0,0,0.4772727272727273,0.5227272727272727
92636,0.6774193548387096,0.36363636363636365,-210,175,0.6496074165168858,0.3503925834831142,away,TEX,over,9.5,0.5,100,0.4772727272727273,ATL,TEX,2024 REG,6,8,6,3,11,12,1,0,5,-5,1,1,1,0,0,0,0,0,0,0.4772727272727273,0.5227272727272727
92636,0.6774193548387096,0.36363636363636365,-210,175,0.6496074165168858,0.3503925834831142,home,ATL,under,9.5,0.5454545454545454,-120,0.5227272727272727,ATL,TEX,2024 REG,6,8,6,3,11,12,1,0,5,-5,1,1,1,0,0,0,0,0,0,0.4772727272727273,0.5227272727272727
92643,0.6794871794871794,0.3597122302158273,-212,178,0.6528516831505211,0.3471483168494789,away,SD,over,8.5,0.5495495495495495,-122,0.5223196169142115,LAD,SD,2024 REG,8,5,7,2,7,15,1,0,3,-3,1,1,0,0,0,0,0,0,0,0.5223196169142115,0.47768038308578853
92643,0.6794871794871794,0.3597122302158273,-212,178,0.6528516831505211,0.3471483168494789,home,LAD,under,8.5,0.5,100,0.47768038308578853,LAD,SD,2024 REG,8,5,7,2,7,15,1,0,3,-3,1,1,0,0,0,0,0,0,0,0.5223196169142115,0.47768038308578853
92645,0.4672897196261683,0.574468085106383,114,-135,0.4477767267604901,0.5522232732395099,away,NYY,over,7.5,0.5327102803738317,-114,0.5075272610403079,SF,NYY,2024 REG,7,2,8,6,8,15,0,1,-4,4,1,1,0,0,0,0,0,0,0,0.5075272610403079,0.4924727389596921
92645,0.4672897196261683,0.574468085106383,114,-135,0.4477767267604901,0.5522232732395099,home,SF,under,7.5,0.5145631067961165,-106,0.4924727389596921,SF,NYY,2024 REG,7,2,8,6,8,15,0,1,-4,4,1,1,0,0,0,0,0,0,0,0.5075272610403079,0.4924727389596921
92649,0.5833333333333333,0.4608294930875576,-140,117,0.5575716845878136,0.4424283154121864,away,MIA,over,7,0.5454545454545454,-120,0.5206611570247933,SD,MIA,2024 REG,9,4,6,0,4,15,1,0,4,-4,0,0,0,0,0,0,0,0,0,0.5206611570247933,0.4793388429752067
92649,0.5833333333333333,0.4608294930875576,-140,117,0.5575716845878136,0.4424283154121864,home,SD,under,7,0.5,100,0.4793388429752067,SD,MIA,2024 REG,9,4,6,0,4,15,1,0,4,-4,0,0,0,0,0,0,0,0,0,0.5206611570247933,0.4793388429752067
92650,0.626865671641791,0.4132231404958678,-168,142,0.6017353714957959,0.3982646285042041,away,BAL,over,8.5,0.5370370370370371,-116,0.5131785224377817,NYY,BAL,2024 REG,6,5,19,17,22,25,0,1,-12,12,1,1,1,1,1,0,0,0,0,0.5131785224377817,0.4868214775622183
92650,0.626865671641791,0.4132231404958678,-168,142,0.6017353714957959,0.3982646285042041,home,NYY,under,8.5,0.5073891625615764,-103,0.4868214775622183,NYY,BAL,2024 REG,6,5,19,17,22,25,0,1,-12,12,1,1,1,1,1,0,0,0,0,0.5131785224377817,0.4868214775622183
92656,0.7455470737913487,0.29673590504451036,-293,237,0.7140231226490925,0.2859768773509075,away,CWS,over,7.5,0.5348837209302326,-115,0.5097020142727117,PHI,CWS,2024 REG,11,8,4,2,10,15,1,0,6,-6,1,1,0,0,0,0,0,0,0,0.5097020142727117,0.49029798572728833
92656,0.7455470737913487,0.29673590504451036,-293,237,0.7140231226490925,0.2859768773509075,home,PHI,under,7.5,0.5121951219512195,-105,0.49029798572728833,PHI,CWS,2024 REG,11,8,4,2,10,15,1,0,6,-6,1,1,0,0,0,0,0,0,0,0.5097020142727117,0.49029798572728833
92658,0.3333333333333333,0.7076023391812866,200,-242,0.31968810916179335,0.6803118908382066,away,ATL,over,8,0.5238095238095238,-110,0.4988662131519274,PIT,ATL,2024 REG,5,1,14,8,9,19,0,1,-7,7,1,0,0,0,0,0,0,0,0,0.4988662131519274,0.5011337868480725
92658,0.3333333333333333,0.7076023391812866,200,-242,0.31968810916179335,0.6803118908382066,home,PIT,under,8,0.5238095238095238,-110,0.5011337868480725,PIT,ATL,2024 REG,5,1,14,8,9,19,0,1,-7,7,1,0,0,0,0,0,0,0,0,0.4988662131519274,0.5011337868480725
92659,0.5327102803738317,0.5098039215686274,-114,-104,0.5100625279371946,0.48993747206280536,away,ARI,over,8.5,0.49019607843137253,104,0.46776880686915284,SD,ARI,2024 REG,10,3,9,4,7,19,0,1,-1,1,1,1,1,0,0,0,0,0,0,0.46776880686915284,0.5322311931308472
92659,0.5327102803738317,0.5098039215686274,-114,-104,0.5100625279371946,0.48993747206280536,home,SD,under,8.5,0.5555555555555556,-125,0.5322311931308472,SD,ARI,2024 REG,10,3,9,4,7,19,0,1,-1,1,1,1,1,0,0,0,0,0,0,0.46776880686915284,0.5322311931308472
92669,0.5370370370370371,0.5073891625615764,-116,-103,0.5131785224377817,0.4868214775622183,away,NYY,over,8.5,0.5121951219512195,-105,0.48808156828023186,TOR,NYY,2024 REG,9,4,11,6,10,20,0,1,-2,2,1,1,1,1,0,0,0,0,0,0.48808156828023186,0.5119184317197681
92669,0.5370370370370371,0.5073891625615764,-116,-103,0.5131785224377817,0.4868214775622183,home,TOR,under,8.5,0.5348837209302326,-115,0.5119184317197681,TOR,NYY,2024 REG,9,4,11,6,10,20,0,1,-2,2,1,1,1,1,0,0,0,0,0,0.48808156828023186,0.5119184317197681
92671,0.5,0.5454545454545454,100,-120,0.4772727272727273,0.5227272727272727,away,TEX,over,8,0.5391705069124424,-117,0.5127649394825569,OAK,TEX,2024 REG,10,9,8,4,13,18,1,0,5,-5,1,1,1,1,0,0,0,0,0,0.5127649394825569,0.48723506051744314
92671,0.5,0.5454545454545454,100,-120,0.4772727272727273,0.5227272727272727,home,OAK,under,8,0.5098039215686274,-104,0.48723506051744314,OAK,TEX,2024 REG,10,9,8,4,13,18,1,0,5,-5,1,1,1,1,0,0,0,0,0,0.5127649394825569,0.48723506051744314
92680,0.46511627906976744,0.574468085106383,115,-135,0.44670494689481377,0.5532950531051862,away,SD,over,7.5,0.5121951219512195,-105,0.48808156828023186,CHC,SD,2024 REG,1,0,8,3,3,9,0,1,-3,3,0,0,0,0,0,0,0,0,0,0.48808156828023186,0.5119184317197681
92680,0.46511627906976744,0.574468085106383,115,-135,0.44670494689481377,0.5532950531051862,home,CHC,under,7.5,0.5348837209302326,-115,0.5119184317197681,CHC,SD,2024 REG,1,0,8,3,3,9,0,1,-3,3,0,0,0,0,0,0,0,0,0,0.48808156828023186,0.5119184317197681
92681,0.4347826086956522,0.6031746031746031,130,-152,0.418279473099889,0.581720526900111,away,TEX,over,10,0.5238095238095238,-110,0.4988662131519274,COL,TEX,2024 REG,14,8,8,3,11,22,1,0,5,-5,1,1,1,0,0,0,0,0,0,0.4988662131519274,0.5011337868480725
92681,0.4347826086956522,0.6031746031746031,130,-152,0.418279473099889,0.581720526900111,home,COL,under,10,0.5238095238095238,-110,0.5011337868480725,COL,TEX,2024 REG,14,8,8,3,11,22,1,0,5,-5,1,1,1,0,0,0,0,0,0,0.4988662131519274,0.5011337868480725
92683,0.6376811594202898,0.4,-176,150,0.6136525939928585,0.38634740600714146,away,PIT,over,8.5,0.5098039215686274,-104,0.48483656587239576,STL,PIT,2024 REG,11,4,6,2,6,17,1,0,2,-2,1,1,0,0,0,0,0,0,0,0.48483656587239576,0.5151634341276042
92683,0.6376811594202898,0.4,-176,150,0.6136525939928585,0.38634740600714146,home,STL,under,8.5,0.5391705069124424,-117,0.5151634341276042,STL,PIT,2024 REG,11,4,6,2,6,17,1,0,2,-2,1,1,0,0,0,0,0,0,0,0.48483656587239576,0.5151634341276042
92684,0.574468085106383,0.46511627906976744,-135,115,0.5517281312179562,0.44827186878204384,away,ATL,over,7,0.5454545454545454,-120,0.5206611570247933,SD,ATL,2024 REG,13,4,5,0,4,18,1,0,4,-4,0,0,0,0,0,0,0,0,0,0.5206611570247933,0.4793388429752067
92684,0.574468085106383,0.46511627906976744,-135,115,0.5517281312179562,0.44827186878204384,home,SD,under,7,0.5,100,0.4793388429752067,SD,ATL,2024 REG,13,4,5,0,4,18,1,0,4,-4,0,0,0,0,0,0,0,0,0,0.5206611570247933,0.4793388429752067
92689,0.5780590717299579,0.4608294930875576,-137,117,0.5555791840506346,0.44442081594936544,away,LAA,over,8.5,0.5515695067264574,-123,0.5258558814517258,PIT,LAA,2024 REG,6,4,10,5,9,16,0,1,-1,1,1,1,1,1,0,0,0,0,0,0.5258558814517258,0.4741441185482742
92689,0.5780590717299579,0.4608294930875576,-137,117,0.5555791840506346,0.44442081594936544,home,PIT,under,8.5,0.49504950495049505,102,0.4741441185482742,PIT,LAA,2024 REG,6,4,10,5,9,16,0,1,-1,1,1,1,1,1,0,0,0,0,0,0.5258558814517258,0.4741441185482742
92691,0.4464285714285714,0.5983935742971888,124,-149,0.426418684943857,0.5735813150561431,away,ATL,over,7.5,0.5238095238095238,-110,0.4988662131519274,NYM,ATL,2024 REG,4,2,7,4,6,11,0,1,-2,2,1,1,0,0,0,0,0,0,0,0.4988662131519274,0.5011337868480725
92691,0.4464285714285714,0.5983935742971888,124,-149,0.426418684943857,0.5735813150561431,home,NYM,under,7.5,0.5238095238095238,-110,0.5011337868480725,NYM,ATL,2024 REG,4,2,7,4,6,11,0,1,-2,2,1,1,0,0,0,0,0,0,0,0.4988662131519274,0.5011337868480725
92694,0.425531914893617,0.6168582375478928,135,-161,0.407493552152549,0.592506447847451,away,SEA,over,9,0.5238095238095238,-110,0.4988662131519274,WSH,SEA,2024 REG,6,3,5,1,4,11,1,0,2,-2,1,0,0,0,0,0,0,0,0,0.4988662131519274,0.5011337868480725
92694,0.425531914893617,0.6168582375478928,135,-161,0.407493552152549,0.592506447847451,home,WSH,under,9,0.5238095238095238,-110,0.5011337868480725,WSH,SEA,2024 REG,6,3,5,1,4,11,1,0,2,-2,1,0,0,0,0,0,0,0,0,0.4988662131519274,0.5011337868480725
92695,0.46511627906976744,0.574468085106383,115,-135,0.44670494689481377,0.5532950531051862,away,ATL,over,8,0.5348837209302326,-115,0.5097020142727117,PHI,ATL,2024 REG,8,4,19,12,16,27,0,1,-8,8,1,1,1,1,0,0,0,0,0,0.5097020142727117,0.49029798572728833
92695,0.46511627906976744,0.574468085106383,115,-135,0.44670494689481377,0.5532950531051862,home,PHI,under,8,0.5121951219512195,-105,0.49029798572728833,PHI,ATL,2024 REG,8,4,19,12,16,27,0,1,-8,8,1,1,1,1,0,0,0,0,0,0.5097020142727117,0.49029798572728833
92696,0.5283018867924528,0.5121951219512195,-112,-105,0.5069072406637203,0.4930927593362797,away,MIL,over,8.5,0.5495495495495495,-122,0.5250401592387142,SD,MIL,2024 REG,10,7,9,6,13,19,1,0,1,-1,1,1,1,1,1,1,0,0,0,0.5250401592387142,0.47495984076128583
92696,0.5283018867924528,0.5121951219512195,-112,-105,0.5069072406637203,0.4930927593362797,home,SD,under,8.5,0.49504950495049505,102,0.47495984076128583,SD,MIL,2024 REG,10,7,9,6,13,19,1,0,1,-1,1,1,1,1,1,1,0,0,0,0.5250401592387142,0.47495984076128583
92697,0.5121951219512195,0.5348837209302326,-105,-115,0.48808156828023186,0.5119184317197681,away,CLE,over,8,0.5121951219512195,-105,0.48808156828023186,SEA,CLE,2024 REG,7,5,6,4,9,13,1,0,1,-1,1,1,1,1,0,0,0,0,0,0.48808156828023186,0.5119184317197681
92697,0.5121951219512195,0.5348837209302326,-105,-115,0.48808156828023186,0.5119184317197681,home,SEA,under,8,0.5348837209302326,-115,0.5119184317197681,SEA,CLE,2024 REG,7,5,6,4,9,13,1,0,1,-1,1,1,1,1,0,0,0,0,0,0.48808156828023186,0.5119184317197681
92702,0.607843137254902,0.4347826086956522,-155,130,0.5819333701084867,0.41806662989151333,away,MIA,over,7.5,0.5121951219512195,-105,0.48808156828023186,NYM,MIA,2024 REG,4,2,5,4,6,9,0,1,-2,2,1,1,0,0,0,0,0,0,0,0.48808156828023186,0.5119184317197681
92702,0.607843137254902,0.4347826086956522,-155,130,0.5819333701084867,0.41806662989151333,home,NYM,under,7.5,0.5348837209302326,-115,0.5119184317197681,NYM,MIA,2024 REG,4,2,5,4,6,9,0,1,-2,2,1,1,0,0,0,0,0,0,0,0.48808156828023186,0.5119184317197681
92703,0.4672897196261683,0.574468085106383,114,-135,0.4477767267604901,0.5522232732395099,away,STL,over,8,0.5283018867924528,-112,0.5031902949311281,MIA,STL,2024 REG,15,9,10,8,17,25,1,0,1,-1,1,1,1,1,1,1,1,1,0,0.5031902949311281,0.4968097050688719
92703,0.4672897196261683,0.574468085106383,114,-135,0.4477767267604901,0.5522232732395099,home,MIA,under,8,0.5192307692307692,-108,0.4968097050688719,MIA,STL,2024 REG,15,9,10,8,17,25,1,0,1,-1,1,1,1,1,1,1,1,1,0,0.5031902949311281,0.4968097050688719
92707,0.4166666666666667,0.6226415094339623,140,-165,0.4002882599580712,0.5997117400419287,away,BAL,over,7,0.5121951219512195,-105,0.48808156828023186,CWS,BAL,2024 REG,1,1,6,4,5,7,0,1,-3,3,1,0,0,0,0,0,0,0,0,0.48808156828023186,0.5119184317197681
92707,0.4166666666666667,0.6226415094339623,140,-165,0.4002882599580712,0.5997117400419287,home,CWS,under,7,0.5348837209302326,-115,0.5119184317197681,CWS,BAL,2024 REG,1,1,6,4,5,7,0,1,-3,3,1,0,0,0,0,0,0,0,0,0.48808156828023186,0.5119184317197681
92708,0.41493775933609955,0.6254681647940076,141,-167,0.39817181571364846,0.6018281842863515,away,TB,over,12.5,0.5238095238095238,-110,0.4988662131519274,COL,TB,2024 REG,12,10,13,7,17,25,1,0,3,-3,1,1,1,1,1,1,1,0,0,0.4988662131519274,0.5011337868480725
92708,0.41493775933609955,0.6254681647940076,141,-167,0.39817181571364846,0.6018281842863515,home,COL,under,12.5,0.5238095238095238,-110,0.5011337868480725,COL,TB,2024 REG,12,10,13,7,17,25,1,0,3,-3,1,1,1,1,1,1,1,0,0,0.4988662131519274,0.5011337868480725
92710,0.4854368932038835,0.5575221238938054,106,-126,0.4645830014088889,0.535416998591111,away,MIN,over,8,0.5238095238095238,-110,0.4988662131519274,PIT,MIN,2024 REG,4,3,8,0,3,12,1,0,3,-3,0,0,0,0,0,0,0,0,0,0.4988662131519274,0.5011337868480725
92710,0.4854368932038835,0.5575221238938054,106,-126,0.4645830014088889,0.535416998591111,home,PIT,under,8,0.5238095238095238,-110,0.5011337868480725,PIT,MIN,2024 REG,4,3,8,0,3,12,1,0,3,-3,0,0,0,0,0,0,0,0,0,0.4988662131519274,0.5011337868480725
92712,0.6503496503496503,0.390625,-186,156,0.623701800821556,0.376298199178444,away,TB,over,8.5,0.5192307692307692,-108,0.49455035168025013,MIN,TB,2024 REG,13,7,8,6,13,21,1,0,1,-1,1,1,1,1,1,1,0,0,0,0.49455035168025013,0.5054496483197499
92712,0.6503496503496503,0.390625,-186,156,0.623701800821556,0.376298199178444,home,MIN,under,8.5,0.5283018867924528,-112,0.5054496483197499,MIN,TB,2024 REG,13,7,8,6,13,21,1,0,1,-1,1,1,1,1,1,1,0,0,0,0.49455035168025013,0.5054496483197499
92719,0.5918367346938775,0.45248868778280543,-145,121,0.5656033213913509,0.43439667860864906,away,CIN,over,7,0.5121951219512195,-105,0.48808156828023186,SF,CIN,2024 REG,7,2,9,4,6,16,0,1,-2,2,1,1,0,0,0,0,0,0,0,0.48808156828023186,0.5119184317197681
92719,0.5918367346938775,0.45248868778280543,-145,121,0.5656033213913509,0.43439667860864906,home,SF,under,7,0.5348837209302326,-115,0.5119184317197681,SF,CIN,2024 REG,7,2,9,4,6,16,0,1,-2,2,1,1,0,0,0,0,0,0,0,0.48808156828023186,0.5119184317197681
92723,0.5327102803738317,0.5121951219512195,-114,-105,0.508788710910954,0.491211289089046,away,SF,over,7.5,0.5215311004784688,-109,0.49670754937970685,TB,SF,2024 REG,8,2,13,11,13,21,0,1,-9,9,1,1,0,0,0,0,0,0,0,0.49670754937970685,0.5032924506202932
92723,0.5327102803738317,0.5121951219512195,-114,-105,0.508788710910954,0.491211289089046,home,TB,under,7.5,0.5260663507109005,-111,0.5032924506202932,TB,SF,2024 REG,8,2,13,11,13,21,0,1,-9,9,1,1,0,0,0,0,0,0,0,0.49670754937970685,0.5032924506202932
92725,0.5850622406639003,0.45454545454545453,-141,120,0.5618892737571823,0.43811072624281766,away,SEA,over,8,0.5215311004784688,-109,0.49670754937970685,NYY,SEA,2024 REG,12,4,7,5,9,19,0,1,-1,1,1,1,1,1,0,0,0,0,0,0.49670754937970685,0.5032924506202932
92725,0.5850622406639003,0.45454545454545453,-141,120,0.5618892737571823,0.43811072624281766,home,NYY,under,8,0.5260663507109005,-111,0.5032924506202932,NYY,SEA,2024 REG,12,4,7,5,9,19,0,1,-1,1,1,1,1,1,0,0,0,0,0,0.49670754937970685,0.5032924506202932
92729,0.47619047619047616,0.5652173913043479,110,-130,0.4564724440500838,0.5435275559499162,away,NYY,over,8,0.5073891625615764,-103,0.4826927225525911,SD,NYY,2024 REG,9,5,8,2,7,17,1,0,3,-3,1,1,0,0,0,0,0,0,0,0.4826927225525911,0.5173072774474089
92729,0.47619047619047616,0.5652173913043479,110,-130,0.4564724440500838,0.5435275559499162,home,SD,under,8,0.5412844036697247,-118,0.5173072774474089,SD,NYY,2024 REG,9,5,8,2,7,17,1,0,3,-3,1,1,0,0,0,0,0,0,0,0.4826927225525911,0.5173072774474089
92732,0.46511627906976744,0.574468085106383,115,-135,0.44670494689481377,0.5532950531051862,away,SF,over,8.5,0.5454545454545454,-120,0.5206611570247933,PIT,SF,2024 REG,11,7,9,6,13,20,1,0,1,-1,1,1,1,1,1,1,0,0,0,0.5206611570247933,0.4793388429752067
92732,0.46511627906976744,0.574468085106383,115,-135,0.44670494689481377,0.5532950531051862,home,PIT,under,8.5,0.5,100,0.4793388429752067,PIT,SF,2024 REG,11,7,9,6,13,20,1,0,1,-1,1,1,1,1,1,1,0,0,0,0.5206611570247933,0.4793388429752067
92738,0.6875,0.35714285714285715,-220,180,0.6568080357142857,0.3431919642857143,away,MIA,over,8.5,0.5283018867924528,-112,0.5044173060022736,NYY,MIA,2024 REG,6,2,6,5,7,12,0,1,-3,3,1,1,0,0,0,0,0,0,0,0.5044173060022736,0.49558269399772636
92738,0.6875,0.35714285714285715,-220,180,0.6568080357142857,0.3431919642857143,home,NYY,under,8.5,0.5169082125603864,-107,0.49558269399772636,NYY,MIA,2024 REG,6,2,6,5,7,12,0,1,-3,3,1,1,0,0,0,0,0,0,0,0.5044173060022736,0.49558269399772636
92739,0.5454545454545454,0.5,-120,100,0.5206611570247933,0.4793388429752067,away,MIL,over,7.5,0.5145631067961165,-106,0.49023796582517226,CHC,MIL,2024 REG,8,1,8,3,4,16,0,1,-2,2,1,0,0,0,0,0,0,0,0,0.49023796582517226,0.5097620341748277
92739,0.5454545454545454,0.5,-120,100,0.5206611570247933,0.4793388429752067,home,CHC,under,7.5,0.5327102803738317,-114,0.5097620341748277,CHC,MIL,2024 REG,8,1,8,3,4,16,0,1,-2,2,1,0,0,0,0,0,0,0,0,0.49023796582517226,0.5097620341748277
92740,0.43103448275862066,0.607843137254902,132,-155,0.4142768879252058,0.5857231120747942,away,ATL,over,8.5,0.5238095238095238,-110,0.4988662131519274,PIT,ATL,2024 REG,7,4,9,1,5,16,1,0,3,-3,1,0,0,0,0,0,0,0,0,0.4988662131519274,0.5011337868480725
92740,0.43103448275862066,0.607843137254902,132,-155,0.4142768879252058,0.5857231120747942,home,PIT,under,8.5,0.5238095238095238,-110,0.5011337868480725,PIT,ATL,2024 REG,7,4,9,1,5,16,1,0,3,-3,1,0,0,0,0,0,0,0,0,0.4988662131519274,0.5011337868480725
92741,0.425531914893617,0.6197718631178707,135,-163,0.4062537114844733,0.5937462885155267,away,BOS,over,8,0.5348837209302326,-115,0.5097020142727117,MIA,BOS,2024 REG,7,3,13,8,11,20,0,1,-5,5,1,1,1,0,0,0,0,0,0,0.5097020142727117,0.49029798572728833
92741,0.425531914893617,0.6197718631178707,135,-163,0.4062537114844733,0.5937462885155267,home,MIA,under,8,0.5121951219512195,-105,0.49029798572728833,MIA,BOS,2024 REG,7,3,13,8,11,20,0,1,-5,5,1,1,1,0,0,0,0,0,0,0.5097020142727117,0.49029798572728833
92743,0.35714285714285715,0.6835443037974683,180,-216,0.34261172823559805,0.657388271764402,away,HOU,over,16.5,0.5238095238095238,-110,0.5000596729920038,COL,HOU,2024 REG,8,4,15,12,16,23,0,1,-8,8,1,1,1,1,0,0,0,0,0,0.5000596729920038,0.4999403270079962
92743,0.35714285714285715,0.6835443037974683,180,-216,0.34261172823559805,0.657388271764402,home,COL,under,16.5,0.5215311004784688,-109,0.4999403270079962,COL,HOU,2024 REG,8,4,15,12,16,23,0,1,-8,8,1,1,1,1,0,0,0,0,0,0.5000596729920038,0.4999403270079962
92744,0.5215311004784688,0.5238095238095238,-109,-110,0.4978845547971712,0.5021154452028288,away,KC,over,7.5,0.5121951219512195,-105,0.48808156828023186,TB,KC,2024 REG,7,4,11,7,11,18,0,1,-3,3,1,1,1,1,0,0,0,0,0,0.48808156828023186,0.5119184317197681
92744,0.5215311004784688,0.5238095238095238,-109,-110,0.4978845547971712,0.5021154452028288,home,TB,under,7.5,0.5348837209302326,-115,0.5119184317197681,TB,KC,2024 REG,7,4,11,7,11,18,0,1,-3,3,1,1,1,1,0,0,0,0,0,0.48808156828023186,0.5119184317197681
92745,0.4587155963302753,0.5815899581589958,118,-139,0.4402268098673069,0.5597731901326931,away,ATL,over,7.5,0.5121951219512195,-105,0.48808156828023186,BAL,ATL,2024 REG,6,4,5,0,4,11,1,0,4,-4,0,0,0,0,0,0,0,0,0,0.48808156828023186,0.5119184317197681
92745,0.4587155963302753,0.5815899581589958,118,-139,0.4402268098673069,0.5597731901326931,home,BAL,under,7.5,0.5348837209302326,-115,0.5119184317197681,BAL,ATL,2024 REG,6,4,5,0,4,11,1,0,4,-4,0,0,0,0,0,0,0,0,0,0.48808156828023186,0.5119184317197681
92746,0.7101449275362319,0.3333333333333333,-245,200,0.6792690611216132,0.3207309388783868,away,KC,over,8,0.5,100,0.4772727272727273,LAD,KC,2024 REG,6,2,7,7,9,13,0,1,-5,5,1,1,0,0,0,0,0,0,0,0.4772727272727273,0.5227272727272727
92746,0.7101449275362319,0.3333333333333333,-245,200,0.6792690611216132,0.3207309388783868,home,LAD,under,8,0.5454545454545454,-120,0.5227272727272727,LAD,KC,2024 REG,6,2,7,7,9,13,0,1,-5,5,1,1,0,0,0,0,0,0,0,0.4772727272727273,0.5227272727272727
92747,0.726027397260274,0.31746031746031744,-265,215,0.6944541249288857,0.3055458750711143,away,MIA,over,8,0.5348837209302326,-115,0.5097020142727117,PHI,MIA,2024 REG,14,7,11,6,13,25,1,0,1,-1,1,1,1,1,1,1,0,0,0,0.5097020142727117,0.49029798572728833
92747,0.726027397260274,0.31746031746031744,-265,215,0.6944541249288857,0.3055458750711143,home,PHI,under,8,0.5121951219512195,-105,0.49029798572728833,PHI,MIA,2024 REG,14,7,11,6,13,25,1,0,1,-1,1,1,1,1,1,1,0,0,0,0.5097020142727117,0.49029798572728833
92748,0.5348837209302326,0.5073891625615764,-115,-103,0.5122726437136835,0.48772735628631647,away,SF,over,10.5,0.5073891625615764,-103,0.4826927225525911,CHC,SF,2024 REG,10,6,9,7,13,19,0,1,-1,1,1,1,1,1,1,1,0,0,0,0.4826927225525911,0.5173072774474089
92748,0.5348837209302326,0.5073891625615764,-115,-103,0.5122726437136835,0.48772735628631647,home,CHC,under,10.5,0.5412844036697247,-118,0.5173072774474089,CHC,SF,2024 REG,10,6,9,7,13,19,0,1,-1,1,1,1,1,1,1,1,0,0,0,0.4826927225525911,0.5173072774474089
92749,0.5495495495495495,0.4926108374384236,-122,103,0.5263803278714742,0.47361967212852585,away,TB,over,9,0.5391705069124424,-117,0.5114756747601454,BOS,TB,2024 REG,7,5,8,4,9,15,1,0,1,-1,1,1,1,1,0,0,0,0,0,0.5114756747601454,0.48852432523985456
92749,0.5495495495495495,0.4926108374384236,-122,103,0.5263803278714742,0.47361967212852585,home,BOS,under,9,0.5121951219512195,-105,0.48852432523985456,BOS,TB,2024 REG,7,5,8,4,9,15,1,0,1,-1,1,1,1,1,0,0,0,0,0,0.5114756747601454,0.48852432523985456
92750,0.5305164319248826,0.5121951219512195,-113,-105,0.5078572507605655,0.49214274923943446,away,ARI,over,8.5,0.5454545454545454,-120,0.5206611570247933,STL,ARI,2024 REG,7,5,9,3,8,16,1,0,2,-2,1,1,1,0,0,0,0,0,0,0.5206611570247933,0.4793388429752067
92750,0.5305164319248826,0.5121951219512195,-113,-105,0.5078572507605655,0.49214274923943446,home,STL,under,8.5,0.5,100,0.4793388429752067,STL,ARI,2024 REG,7,5,9,3,8,16,1,0,2,-2,1,1,1,0,0,0,0,0,0,0.5206611570247933,0.4793388429752067
92751,0.5555555555555556,0.48780487804878053,-125,105,0.5314664257753688,0.46853357422463116,away,WSH,over,8.5,0.5121951219512195,-105,0.48919479393107135,MIA,WSH,2024 REG,6,1,8,3,4,14,0,1,-2,2,1,0,0,0,0,0,0,0,0,0.48919479393107135,0.5108052060689287
92751,0.5555555555555556,0.48780487804878053,-125,105,0.5314664257753688,0.46853357422463116,home,MIA,under,8.5,0.5327102803738317,-114,0.5108052060689287,MIA,WSH,2024 REG,6,1,8,3,4,14,0,1,-2,2,1,0,0,0,0,0,0,0,0,0.48919479393107135,0.5108052060689287
92752,0.5,0.5454545454545454,100,-120,0.4772727272727273,0.5227272727272727,away,PIT,over,7.5,0.5121951219512195,-105,0.48808156828023186,MIL,PIT,2024 REG,2,0,6,1,1,8,0,1,-1,1,0,0,0,0,0,0,0,0,0,0.48808156828023186,0.5119184317197681
92752,0.5,0.5454545454545454,100,-120,0.4772727272727273,0.5227272727272727,home,MIL,under,7.5,0.5348837209302326,-115,0.5119184317197681,MIL,PIT,2024 REG,2,0,6,1,1,8,0,1,-1,1,0,0,0,0,0,0,0,0,0,0.48808156828023186,0.5119184317197681
92754,0.5121951219512195,0.5305164319248826,-105,-113,0.4903184724049234,0.5096815275950766,away,NYM,over,9,0.5454545454545454,-120,0.5206611570247933,WSH,NYM,2024 REG,5,1,1,0,1,6,1,0,1,-1,0,0,0,0,0,0,0,0,0,0.5206611570247933,0.4793388429752067
92754,0.5121951219512195,0.5305164319248826,-105,-113,0.4903184724049234,0.5096815275950766,home,WSH,under,9,0.5,100,0.4793388429752067,WSH,NYM,2024 REG,5,1,1,0,1,6,1,0,1,-1,0,0,0,0,0,0,0,0,0,0.5206611570247933,0.4793388429752067
92762,0.5614035087719298,0.47846889952153115,-128,109,0.5390189988527938,0.4609810011472062,away,CHC,over,9.5,0.5121951219512195,-105,0.48808156828023186,CIN,CHC,2024 REG,9,8,5,4,12,14,1,0,4,-4,1,1,1,1,0,0,0,0,0,0.48808156828023186,0.5119184317197681
92762,0.5614035087719298,0.47846889952153115,-128,109,0.5390189988527938,0.4609810011472062,home,CIN,under,9.5,0.5348837209302326,-115,0.5119184317197681,CIN,CHC,2024 REG,9,8,5,4,12,14,1,0,4,-4,1,1,1,1,0,0,0,0,0,0.48808156828023186,0.5119184317197681
92764,0.574468085106383,0.46511627906976744,-135,115,0.5517281312179562,0.44827186878204384,away,PIT,over,9.5,0.5238095238095238,-110,0.4988662131519274,CIN,PIT,2024 REG,4,1,10,6,7,14,0,1,-5,5,1,0,0,0,0,0,0,0,0,0.4988662131519274,0.5011337868480725
92764,0.574468085106383,0.46511627906976744,-135,115,0.5517281312179562,0.44827186878204384,home,CIN,under,9.5,0.5238095238095238,-110,0.5011337868480725,CIN,PIT,2024 REG,4,1,10,6,7,14,0,1,-5,5,1,0,0,0,0,0,0,0,0,0.4988662131519274,0.5011337868480725
92766,0.5884773662551441,0.45454545454545453,-143,120,0.5631594099815408,0.4368405900184592,away,LAA,over,8.5,0.5348837209302326,-115,0.5097020142727117,BAL,LAA,2024 REG,3,1,6,4,5,9,0,1,-3,3,1,0,0,0,0,0,0,0,0,0.5097020142727117,0.49029798572728833
92766,0.5884773662551441,0.45454545454545453,-143,120,0.5631594099815408,0.4368405900184592,home,BAL,under,8.5,0.5121951219512195,-105,0.49029798572728833,BAL,LAA,2024 REG,3,1,6,4,5,9,0,1,-3,3,1,0,0,0,0,0,0,0,0,0.5097020142727117,0.49029798572728833
92769,0.5238095238095238,0.5238095238095238,-110,-110,0.4988662131519274,0.5011337868480725,away,CLE,over,8.5,0.5,100,0.4772727272727273,LAA,CLE,2024 REG,9,4,6,5,9,15,0,1,-1,1,1,1,1,1,0,0,0,0,0,0.4772727272727273,0.5227272727272727
92769,0.5238095238095238,0.5238095238095238,-110,-110,0.4988662131519274,0.5011337868480725,home,LAA,under,8.5,0.5454545454545454,-120,0.5227272727272727,LAA,CLE,2024 REG,9,4,6,5,9,15,0,1,-1,1,1,1,1,1,0,0,0,0,0,0.4772727272727273,0.5227272727272727
92770,0.5348837209302326,0.5121951219512195,-115,-105,0.5097020142727117,0.49029798572728833,away,TEX,over,8.5,0.5305164319248826,-113,0.5066009958897986,HOU,TEX,2024 REG,10,8,10,5,13,20,1,0,3,-3,1,1,1,1,1,0,0,0,0,0.5066009958897986,0.49339900411020143
92770,0.5348837209302326,0.5121951219512195,-115,-105,0.5097020142727117,0.49029798572728833,home,HOU,under,8.5,0.5145631067961165,-106,0.49339900411020143,HOU,TEX,2024 REG,10,8,10,5,13,20,1,0,3,-3,1,1,1,1,1,0,0,0,0,0.5066009958897986,0.49339900411020143
92771,0.6563573883161512,0.3861003861003861,-191,159,0.6284899143863965,0.37151008561360355,away,TEX,over,8.5,0.5348837209302326,-115,0.5097020142727117,LAD,TEX,2024 REG,5,1,7,3,4,12,0,1,-2,2,1,0,0,0,0,0,0,0,0,0.5097020142727117,0.49029798572728833
92771,0.6563573883161512,0.3861003861003861,-191,159,0.6284899143863965,0.37151008561360355,home,LAD,under,8.5,0.5121951219512195,-105,0.49029798572728833,LAD,TEX,2024 REG,5,1,7,3,4,12,0,1,-2,2,1,0,0,0,0,0,0,0,0,0.5097020142727117,0.49029798572728833
92777,0.5515695067264574,0.4926108374384236,-123,103,0.527200976088429,0.472799023911571,away,BOS,over,7.5,0.5348837209302326,-115,0.5097020142727117,MIN,BOS,2024 REG,8,5,4,2,7,12,1,0,3,-3,1,1,0,0,0,0,0,0,0,0.5097020142727117,0.49029798572728833
92777,0.5515695067264574,0.4926108374384236,-123,103,0.527200976088429,0.472799023911571,home,MIN,under,7.5,0.5121951219512195,-105,0.49029798572728833,MIN,BOS,2024 REG,8,5,4,2,7,12,1,0,3,-3,1,1,0,0,0,0,0,0,0,0.5097020142727117,0.49029798572728833
92778,0.5454545454545454,0.49504950495049505,-120,102,0.5233614270517961,0.4766385729482039,away,PHI,over,9.5,0.5,100,0.4772727272727273,CHC,PHI,2024 REG,5,4,9,6,10,14,0,1,-2,2,1,1,1,1,0,0,0,0,0,0.4772727272727273,0.5227272727272727
92778,0.5454545454545454,0.49504950495049505,-120,102,0.5233614270517961,0.4766385729482039,home,CHC,under,9.5,0.5454545454545454,-120,0.5227272727272727,CHC,PHI,2024 REG,5,4,9,6,10,14,0,1,-2,2,1,1,1,1,0,0,0,0,0,0.4772727272727273,0.5227272727272727
92779,0.7333333333333333,0.3105590062111801,-275,222,0.7011456176673567,0.2988543823326433,away,WSH,over,8.5,0.5073891625615764,-103,0.48484779035144243,MIL,WSH,2024 REG,4,2,12,5,7,16,0,1,-3,3,1,1,0,0,0,0,0,0,0,0.48484779035144243,0.5151522096485576
92779,0.7333333333333333,0.3105590062111801,-275,222,0.7011456176673567,0.2988543823326433,home,MIL,under,8.5,0.5370370370370371,-116,0.5151522096485576,MIL,WSH,2024 REG,4,2,12,5,7,16,0,1,-3,3,1,1,0,0,0,0,0,0,0,0.48484779035144243,0.5151522096485576
92780,0.5348837209302326,0.5098039215686274,-115,-104,0.5109810284308424,0.48901897156915763,away,BOS,over,8.5,0.5073891625615764,-103,0.4837652908580103,PIT,BOS,2024 REG,4,1,12,8,9,16,0,1,-7,7,1,0,0,0,0,0,0,0,0,0.4837652908580103,0.5162347091419897
92780,0.5348837209302326,0.5098039215686274,-115,-104,0.5109810284308424,0.48901897156915763,home,PIT,under,8.5,0.5391705069124424,-117,0.5162347091419897,PIT,BOS,2024 REG,4,1,12,8,9,16,0,1,-7,7,1,0,0,0,0,0,0,0,0,0.4837652908580103,0.5162347091419897
92782,0.504950495049505,0.5348837209302326,-102,-115,0.48483618797062755,0.5151638120293724,away,PIT,over,8.5,0.5305164319248826,-113,0.5066009958897986,STL,PIT,2024 REG,8,4,7,3,7,15,1,0,1,-1,1,1,1,0,0,0,0,0,0,0.5066009958897986,0.49339900411020143
92782,0.504950495049505,0.5348837209302326,-102,-115,0.48483618797062755,0.5151638120293724,home,STL,under,8.5,0.5145631067961165,-106,0.49339900411020143,STL,PIT,2024 REG,8,4,7,3,7,15,1,0,1,-1,1,1,1,0,0,0,0,0,0,0.5066009958897986,0.49339900411020143
92783,0.5633187772925764,0.47619047619047616,-129,110,0.5410624729287608,0.45893752707123925,away,SF,over,7.5,0.5,100,0.4772727272727273,SD,SF,2024 REG,7,6,9,9,15,16,0,1,-3,3,1,1,1,1,1,1,0,0,0,0.4772727272727273,0.5227272727272727
92783,0.5633187772925764,0.47619047619047616,-129,110,0.5410624729287608,0.45893752707123925,home,SD,under,7.5,0.5454545454545454,-120,0.5227272727272727,SD,SF,2024 REG,7,6,9,9,15,16,0,1,-3,3,1,1,1,1,1,1,0,0,0,0.4772727272727273,0.5227272727272727
92784,0.5454545454545454,0.5,-120,100,0.5206611570247933,0.4793388429752067,away,SD,over,9.5,0.504950495049505,-102,0.4826715732667395,KC,SD,2024 REG,8,3,11,7,10,19,0,1,-4,4,1,1,1,0,0,0,0,0,0,0.4826715732667395,0.5173284267332605
92784,0.5454545454545454,0.5,-120,100,0.5206611570247933,0.4793388429752067,home,KC,under,9.5,0.5391705069124424,-117,0.5173284267332605,KC,SD,2024 REG,8,3,11,7,10,19,0,1,-4,4,1,1,1,0,0,0,0,0,0,0.4826715732667395,0.5173284267332605
92785,0.5594713656387665,0.4807692307692307,-127,108,0.5369579042122659,0.46304209578773414,away,DET,over,7.5,0.5024875621890548,-101,0.47839724939301687,CLE,DET,2024 REG,5,5,7,4,9,12,1,0,1,-1,1,1,1,1,0,0,0,0,0,0.47839724939301687,0.5216027506069831
92785,0.5594713656387665,0.4807692307692307,-127,108,0.5369579042122659,0.46304209578773414,home,CLE,under,7.5,0.5454545454545454,-120,0.5216027506069831,CLE,DET,2024 REG,5,5,7,4,9,12,1,0,1,-1,1,1,1,1,0,0,0,0,0,0.47839724939301687,0.5216027506069831
92788,0.6254681647940076,0.41493775933609955,-167,141,0.6001955455815435,0.39980445441845647,away,KC,over,7.5,0.5348837209302326,-115,0.5097020142727117,CLE,KC,2024 REG,9,3,10,4,7,19,0,1,-1,1,1,1,1,0,0,0,0,0,0,0.5097020142727117,0.49029798572728833
92788,0.6254681647940076,0.41493775933609955,-167,141,0.6001955455815435,0.39980445441845647,home,CLE,under,7.5,0.5121951219512195,-105,0.49029798572728833,CLE,KC,2024 REG,9,3,10,4,7,19,0,1,-1,1,1,1,1,0,0,0,0,0,0,0.5097020142727117,0.49029798572728833
92789,0.39370078740157477,0.6491228070175439,154,-185,0.37684110455940206,0.623158895440598,away,LAD,over,8,0.5348837209302326,-115,0.5097020142727117,MIN,LAD,2024 REG,6,3,9,6,9,15,0,1,-3,3,1,1,1,0,0,0,0,0,0,0.5097020142727117,0.49029798572728833
92789,0.39370078740157477,0.6491228070175439,154,-185,0.37684110455940206,0.623158895440598,home,MIN,under,8,0.5121951219512195,-105,0.49029798572728833,MIN,LAD,2024 REG,6,3,9,6,9,15,0,1,-3,3,1,1,1,0,0,0,0,0,0,0.5097020142727117,0.49029798572728833
92790,0.574468085106383,0.4672897196261683,-135,114,0.550479558983428,0.44952044101657196,away,ARI,over,7.5,0.5348837209302326,-115,0.5097020142727117,BAL,ARI,2024 REG,7,4,7,2,6,14,1,0,2,-2,1,1,0,0,0,0,0,0,0,0.5097020142727117,0.49029798572728833
92790,0.574468085106383,0.4672897196261683,-135,114,0.550479558983428,0.44952044101657196,home,BAL,under,7.5,0.5121951219512195,-105,0.49029798572728833,BAL,ARI,2024 REG,7,4,7,2,6,14,1,0,2,-2,1,1,0,0,0,0,0,0,0,0.5097020142727117,0.49029798572728833
92791,0.48780487804878053,0.5555555555555556,105,-125,0.4666534470222751,0.5333465529777248,away,NYM,over,8.5,0.5412844036697247,-118,0.5162581740877563,TEX,NYM,2024 REG,9,6,10,7,13,19,0,1,-1,1,1,1,1,1,1,1,0,0,0,0.5162581740877563,0.4837418259122437
92791,0.48780487804878053,0.5555555555555556,105,-125,0.4666534470222751,0.5333465529777248,home,TEX,under,8.5,0.504950495049505,-102,0.4837418259122437,TEX,NYM,2024 REG,9,6,10,7,13,19,0,1,-1,1,1,1,1,1,1,1,0,0,0,0.5162581740877563,0.4837418259122437
92793,0.6183206106870228,0.42372881355932196,-162,136,0.5923205850079852,0.40767941499201477,away,PIT,over,8.5,0.5121951219512195,-105,0.48808156828023186,MIL,PIT,2024 REG,6,2,11,12,14,17,0,1,-10,10,1,1,0,0,0,0,0,0,0,0.48808156828023186,0.5119184317197681
92793,0.6183206106870228,0.42372881355932196,-162,136,0.5923205850079852,0.40767941499201477,home,MIL,under,8.5,0.5348837209302326,-115,0.5119184317197681,MIL,PIT,2024 REG,6,2,11,12,14,17,0,1,-10,10,1,1,0,0,0,0,0,0,0,0.48808156828023186,0.5119184317197681
92794,0.6323529411764706,0.4132231404958678,-172,142,0.6035327718836684,0.3964672281163316,away,SD,over,9,0.5348837209302326,-115,0.5097020142727117,CHC,SD,2024 REG,10,3,9,2,5,19,1,0,1,-1,1,1,0,0,0,0,0,0,0,0.5097020142727117,0.49029798572728833
92794,0.6323529411764706,0.4132231404958678,-172,142,0.6035327718836684,0.3964672281163316,home,CHC,under,9,0.5121951219512195,-105,0.49029798572728833,CHC,SD,2024 REG,10,3,9,2,5,19,1,0,1,-1,1,1,0,0,0,0,0,0,0,0.5097020142727117,0.49029798572728833
92795,0.5594713656387665,0.4807692307692307,-127,108,0.5369579042122659,0.46304209578773414,away,DET,over,7.5,0.504950495049505,-102,0.48160416005266615,MIN,DET,2024 REG,7,5,5,3,8,12,1,0,2,-2,1,1,1,0,0,0,0,0,0,0.48160416005266615,0.5183958399473338
92795,0.5594713656387665,0.4807692307692307,-127,108,0.5369579042122659,0.46304209578773414,home,MIN,under,7.5,0.5412844036697247,-118,0.5183958399473338,MIN,DET,2024 REG,7,5,5,3,8,12,1,0,2,-2,1,1,1,0,0,0,0,0,0,0.48160416005266615,0.5183958399473338
92796,0.5901639344262295,0.45454545454545453,-144,120,0.5637780655249077,0.4362219344750923,away,DET,over,9,0.5121951219512195,-105,0.48808156828023186,ARI,DET,2024 REG,12,6,8,4,10,20,1,0,2,-2,1,1,1,1,0,0,0,0,0,0.48808156828023186,0.5119184317197681
92796,0.5901639344262295,0.45454545454545453,-144,120,0.5637780655249077,0.4362219344750923,home,ARI,under,9,0.5348837209302326,-115,0.5119184317197681,ARI,DET,2024 REG,12,6,8,4,10,20,1,0,2,-2,1,1,1,1,0,0,0,0,0,0.48808156828023186,0.5119184317197681
92797,0.6515679442508712,0.3921568627450981,-187,155,0.6230782616437414,0.37692173835625864,away,STL,over,7.5,0.5348837209302326,-115,0.5097020142727117,MIL,STL,2024 REG,6,5,12,3,8,18,1,0,2,-2,1,1,1,0,0,0,0,0,0,0.5097020142727117,0.49029798572728833
92797,0.6515679442508712,0.3921568627450981,-187,155,0.6230782616437414,0.37692173835625864,home,MIL,under,7.5,0.5121951219512195,-105,0.49029798572728833,MIL,STL,2024 REG,6,5,12,3,8,18,1,0,2,-2,1,1,1,0,0,0,0,0,0,0.5097020142727117,0.49029798572728833
92799,0.576271186440678,0.46511627906976744,-136,115,0.552420782587201,0.44757921741279905,away,COL,over,7.5,0.5,100,0.4772727272727273,SF,COL,2024 REG,14,10,11,5,15,25,1,0,5,-5,1,1,1,1,1,0,0,0,0,0.4772727272727273,0.5227272727272727
92799,0.576271186440678,0.46511627906976744,-136,115,0.552420782587201,0.44757921741279905,home,SF,under,7.5,0.5454545454545454,-120,0.5227272727272727,SF,COL,2024 REG,14,10,11,5,15,25,1,0,5,-5,1,1,1,1,1,0,0,0,0,0.4772727272727273,0.5227272727272727
92802,0.48780487804878053,0.5555555555555556,105,-125,0.4666534470222751,0.5333465529777248,away,LAD,over,9,0.5238095238095238,-110,0.4988662131519274,TOR,LAD,2024 REG,5,2,19,12,14,24,0,1,-10,10,1,1,0,0,0,0,0,0,0,0.4988662131519274,0.5011337868480725
92802,0.48780487804878053,0.5555555555555556,105,-125,0.4666534470222751,0.5333465529777248,home,TOR,under,9,0.5238095238095238,-110,0.5011337868480725,TOR,LAD,2024 REG,5,2,19,12,14,24,0,1,-10,10,1,1,0,0,0,0,0,0,0,0.4988662131519274,0.5011337868480725
92804,0.7340425531914894,0.3058103975535168,-276,227,0.7047887914744104,0.2952112085255896,away,OAK,over,8.5,0.5121951219512195,-105,0.48808156828023186,MIN,OAK,2024 REG,13,6,4,2,8,17,1,0,4,-4,1,1,0,0,0,0,0,0,0,0.48808156828023186,0.5119184317197681
92804,0.7340425531914894,0.3058103975535168,-276,227,0.7047887914744104,0.2952112085255896,home,MIN,under,8.5,0.5348837209302326,-115,0.5119184317197681,MIN,OAK,2024 REG,13,6,4,2,8,17,1,0,4,-4,1,1,0,0,0,0,0,0,0,0.48808156828023186,0.5119184317197681
92805,0.5652173913043479,0.47619047619047616,-130,110,0.5418129444594474,0.4581870555405526,away,CHC,over,9,0.5238095238095238,-110,0.4988662131519274,ARI,CHC,2024 REG,7,3,9,5,8,16,0,1,-2,2,1,1,1,0,0,0,0,0,0,0.4988662131519274,0.5011337868480725
92805,0.5652173913043479,0.47619047619047616,-130,110,0.5418129444594474,0.4581870555405526,home,ARI,under,9,0.5238095238095238,-110,0.5011337868480725,ARI,CHC,2024 REG,7,3,9,5,8,16,0,1,-2,2,1,1,1,0,0,0,0,0,0,0.4988662131519274,0.5011337868480725
92808,0.7311827956989247,0.3125,-272,220,0.69924268701584,0.30075731298416,away,CWS,over,7.5,0.5348837209302326,-115,0.5097020142727117,TB,CWS,2024 REG,8,5,6,1,6,14,1,0,4,-4,1,0,0,0,0,0,0,0,0,0.5097020142727117,0.49029798572728833
92808,0.7311827956989247,0.3125,-272,220,0.69924268701584,0.30075731298416,home,TB,under,7.5,0.5121951219512195,-105,0.49029798572728833,TB,CWS,2024 REG,8,5,6,1,6,14,1,0,4,-4,1,0,0,0,0,0,0,0,0,0.5097020142727117,0.49029798572728833
92809,0.4484304932735426,0.5934959349593496,123,-146,0.429629404379869,0.570370595620131,away,PHI,over,9,0.5121951219512195,-105,0.48808156828023186,LAA,PHI,2024 REG,11,6,6,5,11,17,1,0,1,-1,1,1,1,1,1,0,0,0,0,0.48808156828023186,0.5119184317197681
92809,0.4484304932735426,0.5934959349593496,123,-146,0.429629404379869,0.570370595620131,home,LAA,under,9,0.5348837209302326,-115,0.5119184317197681,LAA,PHI,2024 REG,11,6,6,5,11,17,1,0,1,-1,1,1,1,1,1,0,0,0,0,0.48808156828023186,0.5119184317197681
92810,0.7619047619047619,0.28169014084507044,-320,255,0.7286895979048896,0.27131040209511037,away,COL,over,7.5,0.504950495049505,-102,0.47949844489399435,LAD,COL,2024 REG,11,4,9,1,5,20,1,0,3,-3,1,0,0,0,0,0,0,0,0,0.47949844489399435,0.5205015551060057
92810,0.7619047619047619,0.28169014084507044,-320,255,0.7286895979048896,0.27131040209511037,home,LAD,under,7.5,0.5454545454545454,-120,0.5205015551060057,LAD,COL,2024 REG,11,4,9,1,5,20,1,0,3,-3,1,0,0,0,0,0,0,0,0,0.47949844489399435,0.5205015551060057
92812,0.7118155619596541,0.3333333333333333,-247,200,0.6796778756848186,0.32032212431518137,away,OAK,over,7.5,0.5024875621890548,-101,0.4794401874631478,DET,OAK,2024 REG,8,5,5,4,9,13,1,0,1,-1,1,1,1,1,0,0,0,0,0,0.4794401874631478,0.5205598125368522
92812,0.7118155619596541,0.3333333333333333,-247,200,0.6796778756848186,0.32032212431518137,home,DET,under,7.5,0.5433789954337899,-119,0.5205598125368522,DET,OAK,2024 REG,8,5,5,4,9,13,1,0,1,-1,1,1,1,1,0,0,0,0,0,0.4794401874631478,0.5205598125368522
92813,0.5215311004784688,0.5238095238095238,-109,-110,0.4978845547971712,0.5021154452028288,away,HOU,over,10,0.5238095238095238,-110,0.4988662131519274,TEX,HOU,2024 REG,15,7,8,2,9,23,1,0,5,-5,1,1,0,0,0,0,0,0,0,0.4988662131519274,0.5011337868480725
92813,0.5215311004784688,0.5238095238095238,-109,-110,0.4978845547971712,0.5021154452028288,home,TEX,under,10,0.5238095238095238,-110,0.5011337868480725,TEX,HOU,2024 REG,15,7,8,2,9,23,1,0,5,-5,1,1,0,0,0,0,0,0,0,0.4988662131519274,0.5011337868480725
92820,0.6000000000000001,0.4444444444444444,-150,125,0.5733333333333334,0.42666666666666664,away,CWS,over,7.5,0.5192307692307692,-108,0.49455035168025013,MIA,CWS,2024 REG,7,7,9,4,11,16,1,0,3,-3,1,1,1,1,0,0,0,0,0,0.49455035168025013,0.5054496483197499
92820,0.6000000000000001,0.4444444444444444,-150,125,0.5733333333333334,0.42666666666666664,home,MIA,under,7.5,0.5283018867924528,-112,0.5054496483197499,MIA,CWS,2024 REG,7,7,9,4,11,16,1,0,3,-3,1,1,1,1,0,0,0,0,0,0.49455035168025013,0.5054496483197499
92821,0.5515695067264574,0.49019607843137253,-123,104,0.5285328835228112,0.47146711647718875,away,TOR,over,8.5,0.5348837209302326,-115,0.5097020142727117,ARI,TOR,2024 REG,6,5,8,4,9,14,1,0,1,-1,1,1,1,1,0,0,0,0,0,0.5097020142727117,0.49029798572728833
92821,0.5515695067264574,0.49019607843137253,-123,104,0.5285328835228112,0.47146711647718875,home,ARI,under,8.5,0.5121951219512195,-105,0.49029798572728833,ARI,TOR,2024 REG,6,5,8,4,9,14,1,0,1,-1,1,1,1,1,0,0,0,0,0,0.5097020142727117,0.49029798572728833
92824,0.5652173913043479,0.47619047619047616,-130,110,0.5418129444594474,0.4581870555405526,away,MIN,over,7,0.5327102803738317,-114,0.5062779990911175,SEA,MIN,2024 REG,5,3,6,2,5,11,1,0,1,-1,1,1,0,0,0,0,0,0,0,0.5062779990911175,0.4937220009088825
92824,0.5652173913043479,0.47619047619047616,-130,110,0.5418129444594474,0.4581870555405526,home,SEA,under,7,0.5169082125603864,-107,0.4937220009088825,SEA,MIN,2024 REG,5,3,6,2,5,11,1,0,1,-1,1,1,0,0,0,0,0,0,0,0.5062779990911175,0.4937220009088825
92825,0.6197718631178707,0.42016806722689076,-163,138,0.5950182180753,0.4049817819247,away,DET,over,9,0.5348837209302326,-115,0.5097020142727117,ATL,DET,2024 REG,5,2,5,1,3,10,1,0,1,-1,1,0,0,0,0,0,0,0,0,0.5097020142727117,0.49029798572728833
92825,0.6197718631178707,0.42016806722689076,-163,138,0.5950182180753,0.4049817819247,home,ATL,under,9,0.5121951219512195,-105,0.49029798572728833,ATL,DET,2024 REG,5,2,5,1,3,10,1,0,1,-1,1,0,0,0,0,0,0,0,0,0.5097020142727117,0.49029798572728833
92826,0.6666666666666666,0.37735849056603776,-200,165,0.6373165618448637,0.36268343815513626,away,LAA,over,8.5,0.5391705069124424,-117,0.5114756747601454,ARI,LAA,2024 REG,9,11,6,1,12,15,1,0,10,-10,1,0,0,0,0,0,0,0,0,0.5114756747601454,0.48852432523985456
92826,0.6666666666666666,0.37735849056603776,-200,165,0.6373165618448637,0.36268343815513626,home,ARI,under,8.5,0.5121951219512195,-105,0.48852432523985456,ARI,LAA,2024 REG,9,11,6,1,12,15,1,0,10,-10,1,0,0,0,0,0,0,0,0,0.5114756747601454,0.48852432523985456
92829,0.5391705069124424,0.504950495049505,-117,-102,0.5153817639191344,0.4846182360808656,away,MIN,over,8,0.5412844036697247,-118,0.5149381613977361,LAA,MIN,2024 REG,5,3,11,5,8,16,0,1,-2,2,1,1,1,0,0,0,0,0,0,0.5149381613977361,0.48506183860226393
92829,0.5391705069124424,0.504950495049505,-117,-102,0.5153817639191344,0.4846182360808656,home,LAA,under,8,0.5073891625615764,-103,0.48506183860226393,LAA,MIN,2024 REG,5,3,11,5,8,16,0,1,-2,2,1,1,1,0,0,0,0,0,0,0.5149381613977361,0.48506183860226393
92830,0.6153846153846154,0.425531914893617,-160,135,0.5902052121364724,0.40979478786352763,away,TOR,over,9,0.5,100,0.4772727272727273,HOU,TOR,2024 REG,15,8,1,0,8,16,1,0,8,-8,0,0,0,0,0,0,0,0,0,0.4772727272727273,0.5227272727272727
92830,0.6153846153846154,0.425531914893617,-160,135,0.5902052121364724,0.40979478786352763,home,HOU,under,9,0.5454545454545454,-120,0.5227272727272727,HOU,TOR,2024 REG,15,8,1,0,8,16,1,0,8,-8,0,0,0,0,0,0,0,0,0,0.4772727272727273,0.5227272727272727
92832,0.8076923076923077,0.23696682464454974,-420,322,0.7716214700356151,0.2283785299643849,away,WSH,over,8.5,0.5348837209302326,-115,0.5097020142727117,LAD,WSH,2024 REG,9,4,8,6,10,17,0,1,-2,2,1,1,1,1,0,0,0,0,0,0.5097020142727117,0.49029798572728833
92832,0.8076923076923077,0.23696682464454974,-420,322,0.7716214700356151,0.2283785299643849,home,LAD,under,8.5,0.5121951219512195,-105,0.49029798572728833,LAD,WSH,2024 REG,9,4,8,6,10,17,0,1,-2,2,1,1,1,1,0,0,0,0,0,0.5097020142727117,0.49029798572728833
92833,0.5348837209302326,0.5098039215686274,-115,-104,0.5109810284308424,0.48901897156915763,away,CLE,over,8,0.5121951219512195,-105,0.48808156828023186,BAL,CLE,2024 REG,5,2,8,3,5,13,0,1,-1,1,1,1,0,0,0,0,0,0,0,0.48808156828023186,0.5119184317197681
92833,0.5348837209302326,0.5098039215686274,-115,-104,0.5109810284308424,0.48901897156915763,home,BAL,under,8,0.5348837209302326,-115,0.5119184317197681,BAL,CLE,2024 REG,5,2,8,3,5,13,0,1,-1,1,1,1,0,0,0,0,0,0,0,0.48808156828023186,0.5119184317197681
92834,0.6587030716723549,0.38314176245210724,-193,161,0.6311397509009514,0.3688602490990486,away,WSH,over,8,0.5238095238095238,-110,0.4988662131519274,TB,WSH,2024 REG,9,5,3,0,5,12,1,0,5,-5,0,0,0,0,0,0,0,0,0,0.4988662131519274,0.5011337868480725
92834,0.6587030716723549,0.38314176245210724,-193,161,0.6311397509009514,0.3688602490990486,home,TB,under,8,0.5238095238095238,-110,0.5011337868480725,TB,WSH,2024 REG,9,5,3,0,5,12,1,0,5,-5,0,0,0,0,0,0,0,0,0,0.4988662131519274,0.5011337868480725
92837,0.6000000000000001,0.44052863436123346,-150,127,0.57568281938326,0.42431718061673995,away,BOS,over,7.5,0.5169082125603864,-107,0.49353874091423283,SEA,BOS,2024 REG,8,4,11,6,10,19,0,1,-2,2,1,1,1,1,0,0,0,0,0,0.49353874091423283,0.5064612590857671
92837,0.6000000000000001,0.44052863436123346,-150,127,0.57568281938326,0.42431718061673995,home,SEA,under,7.5,0.5283018867924528,-112,0.5064612590857671,SEA,BOS,2024 REG,8,4,11,6,10,19,0,1,-2,2,1,1,1,1,0,0,0,0,0,0.49353874091423283,0.5064612590857671
92838,0.5348837209302326,0.5073891625615764,-115,-103,0.5122726437136835,0.48772735628631647,away,PHI,over,7.5,0.5,100,0.4772727272727273,SD,PHI,2024 REG,3,1,8,5,6,11,0,1,-4,4,1,0,0,0,0,0,0,0,0,0.4772727272727273,0.5227272727272727
92838,0.5348837209302326,0.5073891625615764,-115,-103,0.5122726437136835,0.48772735628631647,home,SD,under,7.5,0.5454545454545454,-120,0.5227272727272727,SD,PHI,2024 REG,3,1,8,5,6,11,0,1,-4,4,1,0,0,0,0,0,0,0,0,0.4772727272727273,0.5227272727272727
92839,0.6153846153846154,0.425531914893617,-160,135,0.5902052121364724,0.40979478786352763,away,OAK,over,8,0.5238095238095238,-110,0.4988662131519274,SD,OAK,2024 REG,10,4,9,3,7,19,1,0,1,-1,1,1,1,0,0,0,0,0,0,0.4988662131519274,0.5011337868480725
92839,0.6153846153846154,0.425531914893617,-160,135,0.5902052121364724,0.40979478786352763,home,SD,under,8,0.5238095238095238,-110,0.5011337868480725,SD,OAK,2024 REG,10,4,9,3,7,19,1,0,1,-1,1,1,1,0,0,0,0,0,0,0.4988662131519274,0.5011337868480725
92840,0.5708154506437768,0.4694835680751174,-133,113,0.5478121481132493,0.4521878518867507,away,SEA,over,8.5,0.5,100,0.4772727272727273,BAL,SEA,2024 REG,10,9,9,2,11,19,1,0,7,-7,1,1,0,0,0,0,0,0,0,0.4772727272727273,0.5227272727272727
92840,0.5708154506437768,0.4694835680751174,-133,113,0.5478121481132493,0.4521878518867507,home,BAL,under,8.5,0.5454545454545454,-120,0.5227272727272727,BAL,SEA,2024 REG,10,9,9,2,11,19,1,0,7,-7,1,1,0,0,0,0,0,0,0,0.4772727272727273,0.5227272727272727
92841,0.6309963099630996,0.41152263374485604,-171,143,0.6041670133798509,0.3958329866201491,away,CLE,over,9,0.5192307692307692,-108,0.49455035168025013,HOU,CLE,2024 REG,12,10,7,9,19,19,1,0,1,-1,1,1,1,1,1,1,1,1,1,0.49455035168025013,0.5054496483197499
92841,0.6309963099630996,0.41152263374485604,-171,143,0.6041670133798509,0.3958329866201491,home,HOU,under,9,0.5283018867924528,-112,0.5054496483197499,HOU,CLE,2024 REG,12,10,7,9,19,19,1,0,1,-1,1,1,1,1,1,1,1,1,1,0.49455035168025013,0.5054496483197499
92846,0.6254681647940076,0.41493775933609955,-167,141,0.6001955455815435,0.39980445441845647,away,KC,over,8.5,0.5238095238095238,-110,0.4988662131519274,TOR,KC,2024 REG,12,6,11,5,11,23,1,0,1,-1,1,1,1,1,1,0,0,0,0,0.4988662131519274,0.5011337868480725
92846,0.6254681647940076,0.41493775933609955,-167,141,0.6001955455815435,0.39980445441845647,home,TOR,under,8.5,0.5238095238095238,-110,0.5011337868480725,TOR,KC,2024 REG,12,6,11,5,11,23,1,0,1,-1,1,1,1,1,1,0,0,0,0,0.4988662131519274,0.5011337868480725
92848,0.4016064257028112,0.6363636363636364,149,-175,0.3863574047925913,0.6136425952074087,away,SEA,over,9,0.5348837209302326,-115,0.5097020142727117,WSH,SEA,2024 REG,8,5,10,9,14,18,0,1,-4,4,1,1,1,1,1,0,0,0,0,0.5097020142727117,0.49029798572728833
92848,0.4016064257028112,0.6363636363636364,149,-175,0.3863574047925913,0.6136425952074087,home,WSH,under,9,0.5121951219512195,-105,0.49029798572728833,WSH,SEA,2024 REG,8,5,10,9,14,18,0,1,-4,4,1,1,1,1,1,0,0,0,0,0.5097020142727117,0.49029798572728833
92849,0.5555555555555556,0.48780487804878053,-125,105,0.5314664257753688,0.46853357422463116,away,MIA,over,9,0.5,100,0.4772727272727273,WSH,MIA,2024 REG,9,4,4,0,4,13,1,0,4,-4,0,0,0,0,0,0,0,0,0,0.4772727272727273,0.5227272727272727
92849,0.5555555555555556,0.48780487804878053,-125,105,0.5314664257753688,0.46853357422463116,home,WSH,under,9,0.5454545454545454,-120,0.5227272727272727,WSH,MIA,2024 REG,9,4,4,0,4,13,1,0,4,-4,0,0,0,0,0,0,0,0,0,0.4772727272727273,0.5227272727272727
92850,0.5348837209302326,0.5121951219512195,-115,-105,0.5097020142727117,0.49029798572728833,away,SD,over,7.5,0.5,100,0.4772727272727273,CHC,SD,2024 REG,7,3,11,6,9,18,0,1,-3,3,1,1,1,0,0,0,0,0,0,0.4772727272727273,0.5227272727272727
92850,0.5348837209302326,0.5121951219512195,-115,-105,0.5097020142727117,0.49029798572728833,home,CHC,under,7.5,0.5454545454545454,-120,0.5227272727272727,CHC,SD,2024 REG,7,3,11,6,9,18,0,1,-3,3,1,1,1,0,0,0,0,0,0,0.4772727272727273,0.5227272727272727
92851,0.5934959349593496,0.4484304932735426,-146,123,0.5686127702357632,0.4313872297642368,away,CHC,over,7.5,0.49504950495049505,102,0.47297076509898783,NYM,CHC,2024 REG,4,1,3,3,4,7,0,1,-2,2,1,0,0,0,0,0,0,0,0,0.47297076509898783,0.5270292349010122
92851,0.5934959349593496,0.4484304932735426,-146,123,0.5686127702357632,0.4313872297642368,home,NYM,under,7.5,0.5495495495495495,-122,0.5270292349010122,NYM,CHC,2024 REG,4,1,3,3,4,7,0,1,-2,2,1,0,0,0,0,0,0,0,0,0.47297076509898783,0.5270292349010122
92852,0.5348837209302326,0.5098039215686274,-115,-104,0.5109810284308424,0.48901897156915763,away,STL,over,8.5,0.5348837209302326,-115,0.5097020142727117,DET,STL,2024 REG,14,11,11,6,17,25,1,0,5,-5,1,1,1,1,1,1,0,0,0,0.5097020142727117,0.49029798572728833
92852,0.5348837209302326,0.5098039215686274,-115,-104,0.5109810284308424,0.48901897156915763,home,DET,under,8.5,0.5121951219512195,-105,0.49029798572728833,DET,STL,2024 REG,14,11,11,6,17,25,1,0,5,-5,1,1,1,1,1,1,0,0,0,0.5097020142727117,0.49029798572728833
92853,0.5283018867924528,0.5121951219512195,-112,-105,0.5069072406637203,0.4930927593362797,away,SF,over,10.5,0.5412844036697247,-118,0.5162581740877563,CHC,SF,2024 REG,11,6,6,5,11,17,1,0,1,-1,1,1,1,1,1,0,0,0,0,0.5162581740877563,0.4837418259122437
92853,0.5283018867924528,0.5121951219512195,-112,-105,0.5069072406637203,0.4930927593362797,home,CHC,under,10.5,0.504950495049505,-102,0.4837418259122437,CHC,SF,2024 REG,11,6,6,5,11,17,1,0,1,-1,1,1,1,1,1,0,0,0,0,0.5162581740877563,0.4837418259122437
92854,0.4444444444444444,0.5967741935483871,125,-148,0.42612504978096366,0.5738749502190363,away,HOU,over,8,0.5348837209302326,-115,0.5097020142727117,DET,HOU,2024 REG,7,2,8,5,7,15,0,1,-3,3,1,1,0,0,0,0,0,0,0,0.5097020142727117,0.49029798572728833
92854,0.4444444444444444,0.5967741935483871,125,-148,0.42612504978096366,0.5738749502190363,home,DET,under,8,0.5121951219512195,-105,0.49029798572728833,DET,HOU,2024 REG,7,2,8,5,7,15,0,1,-3,3,1,1,0,0,0,0,0,0,0,0.5097020142727117,0.49029798572728833
92858,0.6296296296296295,0.4132231404958678,-170,142,0.6026482558469091,0.39735174415309094,away,TEX,over,8,0.5348837209302326,-115,0.5097020142727117,PHI,TEX,2024 REG,8,5,9,2,7,17,1,0,3,-3,1,1,0,0,0,0,0,0,0,0.5097020142727117,0.49029798572728833
92858,0.6296296296296295,0.4132231404958678,-170,142,0.6026482558469091,0.39735174415309094,home,PHI,under,8,0.5121951219512195,-105,0.49029798572728833,PHI,TEX,2024 REG,8,5,9,2,7,17,1,0,3,-3,1,1,0,0,0,0,0,0,0,0.5097020142727117,0.49029798572728833
92859,0.5433789954337899,0.5024875621890548,-119,-101,0.5184560714286826,0.48154392857131745,away,TB,over,8.5,0.5412844036697247,-118,0.5149381613977361,BOS,TB,2024 REG,8,3,10,5,8,18,0,1,-2,2,1,1,1,0,0,0,0,0,0,0.5149381613977361,0.48506183860226393
92859,0.5433789954337899,0.5024875621890548,-119,-101,0.5184560714286826,0.48154392857131745,home,BOS,under,8.5,0.5073891625615764,-103,0.48506183860226393,BOS,TB,2024 REG,8,3,10,5,8,18,0,1,-2,2,1,1,1,0,0,0,0,0,0,0.5149381613977361,0.48506183860226393
92860,0.47619047619047616,0.5670995670995671,110,-131,0.4555761698618841,0.5444238301381159,away,BAL,over,9.5,0.5348837209302326,-115,0.5097020142727117,LAA,BAL,2024 REG,6,5,9,6,11,15,0,1,-1,1,1,1,1,1,1,0,0,0,0,0.5097020142727117,0.49029798572728833
92860,0.47619047619047616,0.5670995670995671,110,-131,0.4555761698618841,0.5444238301381159,home,LAA,under,9.5,0.5121951219512195,-105,0.49029798572728833,LAA,BAL,2024 REG,6,5,9,6,11,15,0,1,-1,1,1,1,1,1,1,0,0,0,0,0.5097020142727117,0.49029798572728833
92861,0.5983935742971888,0.4464285714285714,-149,124,0.5715722903086816,0.4284277096913184,away,NYM,over,8,0.5238095238095238,-110,0.4988662131519274,TB,NYM,2024 REG,13,10,10,8,18,23,1,0,2,-2,1,1,1,1,1,1,1,1,0,0.4988662131519274,0.5011337868480725
92861,0.5983935742971888,0.4464285714285714,-149,124,0.5715722903086816,0.4284277096913184,home,TB,under,8,0.5238095238095238,-110,0.5011337868480725,TB,NYM,2024 REG,13,10,10,8,18,23,1,0,2,-2,1,1,1,1,1,1,1,1,0,0.4988662131519274,0.5011337868480725
92863,0.5798319327731092,0.46511627906976744,-138,115,0.5537695242255589,0.4462304757744411,away,MIL,over,9,0.504950495049505,-102,0.4826715732667395,HOU,MIL,2024 REG,14,9,10,4,13,24,1,0,5,-5,1,1,1,1,0,0,0,0,0,0.4826715732667395,0.5173284267332605
92863,0.5798319327731092,0.46511627906976744,-138,115,0.5537695242255589,0.4462304757744411,home,HOU,under,9,0.5391705069124424,-117,0.5173284267332605,HOU,MIL,2024 REG,14,9,10,4,13,24,1,0,5,-5,1,1,1,1,0,0,0,0,0,0.4826715732667395,0.5173284267332605
92865,0.574468085106383,0.46511627906976744,-135,115,0.5517281312179562,0.44827186878204384,away,TOR,over,7,0.5121951219512195,-105,0.48808156828023186,BAL,TOR,2024 REG,11,3,5,2,5,16,1,0,1,-1,1,1,0,0,0,0,0,0,0,0.48808156828023186,0.5119184317197681
92865,0.574468085106383,0.46511627906976744,-135,115,0.5517281312179562,0.44827186878204384,home,BAL,under,7,0.5348837209302326,-115,0.5119184317197681,BAL,TOR,2024 REG,11,3,5,2,5,16,1,0,1,-1,1,1,0,0,0,0,0,0,0,0.48808156828023186,0.5119184317197681
92866,0.3424657534246575,0.696969696969697,192,-230,0.32896046219371416,0.6710395378062859,away,BOS,over,8.5,0.5024875621890548,-101,0.47839724939301687,CWS,BOS,2024 REG,10,6,5,1,7,15,1,0,5,-5,1,0,0,0,0,0,0,0,0,0.47839724939301687,0.5216027506069831
92866,0.3424657534246575,0.696969696969697,192,-230,0.32896046219371416,0.6710395378062859,home,CWS,under,8.5,0.5454545454545454,-120,0.5216027506069831,CWS,BOS,2024 REG,10,6,5,1,7,15,1,0,5,-5,1,0,0,0,0,0,0,0,0,0.47839724939301687,0.5216027506069831
92867,0.5348837209302326,0.5121951219512195,-115,-105,0.5097020142727117,0.49029798572728833,away,LAA,over,9,0.5121951219512195,-105,0.48808156828023186,OAK,LAA,2024 REG,4,5,4,0,5,8,1,0,5,-5,0,0,0,0,0,0,0,0,0,0.48808156828023186,0.5119184317197681
92867,0.5348837209302326,0.5121951219512195,-115,-105,0.5097020142727117,0.49029798572728833,home,OAK,under,9,0.5348837209302326,-115,0.5119184317197681,OAK,LAA,2024 REG,4,5,4,0,5,8,1,0,5,-5,0,0,0,0,0,0,0,0,0,0.48808156828023186,0.5119184317197681
92868,0.47619047619047616,0.5652173913043479,110,-130,0.4564724440500838,0.5435275559499162,away,CIN,over,7.5,0.5348837209302326,-115,0.5097020142727117,CWS,CIN,2024 REG,2,0,4,5,5,6,0,1,-5,5,0,0,0,0,0,0,0,0,0,0.5097020142727117,0.49029798572728833
92868,0.47619047619047616,0.5652173913043479,110,-130,0.4564724440500838,0.5435275559499162,home,CWS,under,7.5,0.5121951219512195,-105,0.49029798572728833,CWS,CIN,2024 REG,2,0,4,5,5,6,0,1,-5,5,0,0,0,0,0,0,0,0,0,0.5097020142727117,0.49029798572728833
92870,0.5283018867924528,0.5145631067961165,-112,-106,0.5056562298022652,0.4943437701977348,away,SF,over,8.5,0.5238095238095238,-110,0.4988662131519274,TB,SF,2024 REG,6,2,6,1,3,12,1,0,1,-1,1,0,0,0,0,0,0,0,0,0.4988662131519274,0.5011337868480725
92870,0.5283018867924528,0.5145631067961165,-112,-106,0.5056562298022652,0.4943437701977348,home,TB,under,8.5,0.5238095238095238,-110,0.5011337868480725,TB,SF,2024 REG,6,2,6,1,3,12,1,0,1,-1,1,0,0,0,0,0,0,0,0,0.4988662131519274,0.5011337868480725
92871,0.613899613899614,0.425531914893617,-159,135,0.589692613597978,0.410307386402022,away,CIN,over,8.5,0.5454545454545454,-120,0.5179608869977906,ARI,CIN,2024 REG,11,6,10,5,11,21,1,0,1,-1,1,1,1,1,1,0,0,0,0,0.5179608869977906,0.48203911300220936
92871,0.613899613899614,0.425531914893617,-159,135,0.589692613597978,0.410307386402022,home,ARI,under,8.5,0.504950495049505,-102,0.48203911300220936,ARI,CIN,2024 REG,11,6,10,5,11,21,1,0,1,-1,1,1,1,1,1,0,0,0,0,0.5179608869977906,0.48203911300220936
92875,0.504950495049505,0.5370370370370371,-102,-116,0.4837488699364985,0.5162511300635015,away,NYY,over,8,0.5412844036697247,-118,0.5162581740877563,TB,NYY,2024 REG,9,5,8,4,9,17,1,0,1,-1,1,1,1,1,0,0,0,0,0,0.5162581740877563,0.4837418259122437
92875,0.504950495049505,0.5370370370370371,-102,-116,0.4837488699364985,0.5162511300635015,home,TB,under,8,0.504950495049505,-102,0.4837418259122437,TB,NYY,2024 REG,9,5,8,4,9,17,1,0,1,-1,1,1,1,1,0,0,0,0,0,0.5162581740877563,0.4837418259122437
92876,0.39370078740157477,0.6491228070175439,154,-185,0.37684110455940206,0.623158895440598,away,NYY,over,8.5,0.5454545454545454,-120,0.5206611570247933,LAA,NYY,2024 REG,9,4,9,3,7,18,1,0,1,-1,1,1,1,0,0,0,0,0,0,0.5206611570247933,0.4793388429752067
92876,0.39370078740157477,0.6491228070175439,154,-185,0.37684110455940206,0.623158895440598,home,LAA,under,8.5,0.5,100,0.4793388429752067,LAA,NYY,2024 REG,9,4,9,3,7,18,1,0,1,-1,1,1,1,0,0,0,0,0,0,0.5206611570247933,0.4793388429752067
92879,0.4807692307692307,0.5555555555555556,108,-125,0.4633053911900066,0.5366946088099934,away,ATL,over,7.5,0.5305164319248826,-113,0.5053568787472517,STL,ATL,2024 REG,4,2,9,6,8,13,0,1,-4,4,1,1,0,0,0,0,0,0,0,0.5053568787472517,0.49464312125274834
92879,0.4807692307692307,0.5555555555555556,108,-125,0.4633053911900066,0.5366946088099934,home,STL,under,7.5,0.5169082125603864,-107,0.49464312125274834,STL,ATL,2024 REG,4,2,9,6,8,13,0,1,-4,4,1,1,0,0,0,0,0,0,0,0.5053568787472517,0.49464312125274834
92880,0.5815899581589958,0.4608294930875576,-139,117,0.5569192312833853,0.4430807687166147,away,STL,over,8,0.5391705069124424,-117,0.5127649394825569,NYM,STL,2024 REG,8,4,4,2,6,12,1,0,2,-2,1,1,0,0,0,0,0,0,0,0.5127649394825569,0.48723506051744314
92880,0.5815899581589958,0.4608294930875576,-139,117,0.5569192312833853,0.4430807687166147,home,NYM,under,8,0.5098039215686274,-104,0.48723506051744314,NYM,STL,2024 REG,8,4,4,2,6,12,1,0,2,-2,1,1,0,0,0,0,0,0,0,0.5127649394825569,0.48723506051744314
92881,0.6282527881040892,0.41152263374485604,-169,143,0.603263768429473,0.39673623157052695,away,WSH,over,7,0.5348837209302326,-115,0.5097020142727117,CWS,WSH,2024 REG,9,2,3,0,2,12,1,0,2,-2,0,0,0,0,0,0,0,0,0,0.5097020142727117,0.49029798572728833
92881,0.6282527881040892,0.41152263374485604,-169,143,0.603263768429473,0.39673623157052695,home,CWS,under,7,0.5121951219512195,-105,0.49029798572728833,CWS,WSH,2024 REG,9,2,3,0,2,12,1,0,2,-2,0,0,0,0,0,0,0,0,0,0.5097020142727117,0.49029798572728833
92882,0.6000000000000001,0.44052863436123346,-150,127,0.57568281938326,0.42431718061673995,away,NYY,over,8.5,0.5121951219512195,-105,0.48808156828023186,BAL,NYY,2024 REG,3,0,4,2,2,7,0,1,-2,2,0,0,0,0,0,0,0,0,0,0.48808156828023186,0.5119184317197681
92882,0.6000000000000001,0.44052863436123346,-150,127,0.57568281938326,0.42431718061673995,home,BAL,under,8.5,0.5348837209302326,-115,0.5119184317197681,BAL,NYY,2024 REG,3,0,4,2,2,7,0,1,-2,2,0,0,0,0,0,0,0,0,0,0.48808156828023186,0.5119184317197681
92884,0.43103448275862066,0.6108949416342413,132,-157,0.41296145500307674,0.5870385449969233,away,LAD,over,10.5,0.5121951219512195,-105,0.48808156828023186,CIN,LAD,2024 REG,6,9,11,6,15,17,1,0,3,-3,1,1,1,1,1,1,0,0,0,0.48808156828023186,0.5119184317197681
92884,0.43103448275862066,0.6108949416342413,132,-157,0.41296145500307674,0.5870385449969233,home,CIN,under,10.5,0.5348837209302326,-115,0.5119184317197681,CIN,LAD,2024 REG,6,9,11,6,15,17,1,0,3,-3,1,1,1,1,1,1,0,0,0,0.48808156828023186,0.5119184317197681
92885,0.607843137254902,0.4347826086956522,-155,130,0.5819333701084867,0.41806662989151333,away,LAD,over,9.5,0.5,100,0.4772727272727273,PHI,LAD,2024 REG,10,5,5,1,6,15,1,0,4,-4,1,0,0,0,0,0,0,0,0,0.4772727272727273,0.5227272727272727
92885,0.607843137254902,0.4347826086956522,-155,130,0.5819333701084867,0.41806662989151333,home,PHI,under,9.5,0.5454545454545454,-120,0.5227272727272727,PHI,LAD,2024 REG,10,5,5,1,6,15,1,0,4,-4,1,0,0,0,0,0,0,0,0,0.4772727272727273,0.5227272727272727
92886,0.5260663507109005,0.5145631067961165,-111,-106,0.5046925602688205,0.4953074397311795,away,NYM,over,7,0.5495495495495495,-122,0.5223196169142115,TB,NYM,2024 REG,9,7,8,6,13,17,1,0,1,-1,1,1,1,1,1,1,0,0,0,0.5223196169142115,0.47768038308578853
92886,0.5260663507109005,0.5145631067961165,-111,-106,0.5046925602688205,0.4953074397311795,home,TB,under,7,0.5,100,0.47768038308578853,TB,NYM,2024 REG,9,7,8,6,13,17,1,0,1,-1,1,1,1,1,1,1,0,0,0,0.5223196169142115,0.47768038308578853
92887,0.4444444444444444,0.5983935742971888,125,-149,0.4254053250037185,0.5745946749962815,away,MIL,over,11.5,0.5238095238095238,-110,0.4988662131519274,COL,MIL,2024 REG,13,8,14,7,15,27,1,0,1,-1,1,1,1,1,1,1,1,0,0,0.4988662131519274,0.5011337868480725
92887,0.4444444444444444,0.5983935742971888,125,-149,0.4254053250037185,0.5745946749962815,home,COL,under,11.5,0.5238095238095238,-110,0.5011337868480725,COL,MIL,2024 REG,13,8,14,7,15,27,1,0,1,-1,1,1,1,1,1,1,1,0,0,0.4988662131519274,0.5011337868480725
92888,0.7118155619596541,0.3333333333333333,-247,200,0.6796778756848186,0.32032212431518137,away,MIA,over,8.5,0.5121951219512195,-105,0.48808156828023186,HOU,MIA,2024 REG,7,4,6,3,7,13,1,0,1,-1,1,1,1,0,0,0,0,0,0,0.48808156828023186,0.5119184317197681
92888,0.7118155619596541,0.3333333333333333,-247,200,0.6796778756848186,0.32032212431518137,home,HOU,under,8.5,0.5348837209302326,-115,0.5119184317197681,HOU,MIA,2024 REG,7,4,6,3,7,13,1,0,1,-1,1,1,1,0,0,0,0,0,0,0.48808156828023186,0.5119184317197681
92889,0.3508771929824561,0.6923076923076923,185,-225,0.3357246016525795,0.6642753983474206,away,ATL,over,8.5,0.5348837209302326,-115,0.5097020142727117,MIA,ATL,2024 REG,8,5,6,1,6,14,1,0,4,-4,1,0,0,0,0,0,0,0,0,0.5097020142727117,0.49029798572728833
92889,0.3508771929824561,0.6923076923076923,185,-225,0.3357246016525795,0.6642753983474206,home,MIA,under,8.5,0.5121951219512195,-105,0.49029798572728833,MIA,ATL,2024 REG,8,5,6,1,6,14,1,0,4,-4,1,0,0,0,0,0,0,0,0,0.5097020142727117,0.49029798572728833
92891,0.5145631067961165,0.5305164319248826,-106,-113,0.4913668392989033,0.5086331607010968,away,TB,over,8.5,0.5073891625615764,-103,0.4826927225525911,MIL,TB,2024 REG,10,7,5,1,8,15,1,0,6,-6,1,0,0,0,0,0,0,0,0,0.4826927225525911,0.5173072774474089
92891,0.5145631067961165,0.5305164319248826,-106,-113,0.4913668392989033,0.5086331607010968,home,MIL,under,8.5,0.5412844036697247,-118,0.5173072774474089,MIL,TB,2024 REG,10,7,5,1,8,15,1,0,6,-6,1,0,0,0,0,0,0,0,0,0.4826927225525911,0.5173072774474089
92894,0.4444444444444444,0.6000000000000001,125,-150,0.4246913580246913,0.5753086419753086,away,KC,over,7.5,0.5121951219512195,-105,0.48808156828023186,OAK,KC,2024 REG,9,2,7,3,5,16,0,1,-1,1,1,1,0,0,0,0,0,0,0,0.48808156828023186,0.5119184317197681
92894,0.4444444444444444,0.6000000000000001,125,-150,0.4246913580246913,0.5753086419753086,home,OAK,under,7.5,0.5348837209302326,-115,0.5119184317197681,OAK,KC,2024 REG,9,2,7,3,5,16,0,1,-1,1,1,1,0,0,0,0,0,0,0,0.48808156828023186,0.5119184317197681
92895,0.6666666666666666,0.37735849056603776,-200,165,0.6373165618448637,0.36268343815513626,away,WSH,over,9,0.5348837209302326,-115,0.5097020142727117,TEX,WSH,2024 REG,6,0,5,1,1,11,0,1,-1,1,0,0,0,0,0,0,0,0,0,0.5097020142727117,0.49029798572728833
92895,0.6666666666666666,0.37735849056603776,-200,165,0.6373165618448637,0.36268343815513626,home,TEX,under,9,0.5121951219512195,-105,0.49029798572728833,TEX,WSH,2024 REG,6,0,5,1,1,11,0,1,-1,1,0,0,0,0,0,0,0,0,0,0.5097020142727117,0.49029798572728833
92896,0.6031746031746031,0.4347826086956522,-152,130,0.5802797769671475,0.4197202230328525,away,STL,over,8,0.5121951219512195,-105,0.48808156828023186,SD,STL,2024 REG,9,2,6,5,7,15,0,1,-3,3,1,1,0,0,0,0,0,0,0,0.48808156828023186,0.5119184317197681
92896,0.6031746031746031,0.4347826086956522,-152,130,0.5802797769671475,0.4197202230328525,home,SD,under,8,0.5348837209302326,-115,0.5119184317197681,SD,STL,2024 REG,9,2,6,5,7,15,0,1,-3,3,1,1,0,0,0,0,0,0,0,0.48808156828023186,0.5119184317197681
92897,0.5348837209302326,0.5098039215686274,-115,-104,0.5109810284308424,0.48901897156915763,away,HOU,over,7.5,0.5348837209302326,-115,0.5097020142727117,DET,HOU,2024 REG,6,3,18,9,12,24,0,1,-6,6,1,1,1,0,0,0,0,0,0,0.5097020142727117,0.49029798572728833
92897,0.5348837209302326,0.5098039215686274,-115,-104,0.5109810284308424,0.48901897156915763,home,DET,under,7.5,0.5121951219512195,-105,0.49029798572728833,DET,HOU,2024 REG,6,3,18,9,12,24,0,1,-6,6,1,1,1,0,0,0,0,0,0,0.5097020142727117,0.49029798572728833
92898,0.4566210045662101,0.5815899581589958,119,-139,0.4391730763811846,0.5608269236188155,away,LAD,over,10.5,0.5215311004784688,-109,0.4978845547971712,ARI,LAD,2024 REG,7,4,10,8,12,17,0,1,-4,4,1,1,1,1,0,0,0,0,0,0.4978845547971712,0.5021154452028288
92898,0.4566210045662101,0.5815899581589958,119,-139,0.4391730763811846,0.5608269236188155,home,ARI,under,10.5,0.5238095238095238,-110,0.5021154452028288,ARI,LAD,2024 REG,7,4,10,8,12,17,0,1,-4,4,1,1,1,1,0,0,0,0,0,0.4978845547971712,0.5021154452028288
92900,0.5726495726495727,0.46511627906976744,-134,115,0.5510229738017454,0.44897702619825464,away,BOS,over,8,0.5192307692307692,-108,0.49455035168025013,CLE,BOS,2024 REG,4,0,16,8,8,20,0,1,-8,8,0,0,0,0,0,0,0,0,0,0.49455035168025013,0.5054496483197499
92900,0.5726495726495727,0.46511627906976744,-134,115,0.5510229738017454,0.44897702619825464,home,CLE,under,8,0.5283018867924528,-112,0.5054496483197499,CLE,BOS,2024 REG,4,0,16,8,8,20,0,1,-8,8,0,0,0,0,0,0,0,0,0,0.49455035168025013,0.5054496483197499
92902,0.5689655172413793,0.4716981132075471,-132,112,0.5458293137100936,0.4541706862899064,away,SF,over,8.5,0.5370370370370371,-116,0.5131785224377817,CLE,SF,2024 REG,6,5,6,4,9,12,1,0,1,-1,1,1,1,1,0,0,0,0,0,0.5131785224377817,0.4868214775622183
92902,0.5689655172413793,0.4716981132075471,-132,112,0.5458293137100936,0.4541706862899064,home,CLE,under,8.5,0.5073891625615764,-103,0.4868214775622183,CLE,SF,2024 REG,6,5,6,4,9,12,1,0,1,-1,1,1,1,1,0,0,0,0,0,0.5131785224377817,0.4868214775622183
92903,0.5884773662551441,0.45248868778280543,-143,121,0.5643697706690257,0.4356302293309743,away,DET,over,7.5,0.49019607843137253,104,0.46680480278177555,MIN,DET,2024 REG,7,4,5,3,7,12,1,0,1,-1,1,1,1,0,0,0,0,0,0,0.46680480278177555,0.5331951972182245
92903,0.5884773662551441,0.45248868778280543,-143,121,0.5643697706690257,0.4356302293309743,home,MIN,under,7.5,0.5575221238938054,-126,0.5331951972182245,MIN,DET,2024 REG,7,4,5,3,7,12,1,0,1,-1,1,1,1,0,0,0,0,0,0,0.46680480278177555,0.5331951972182245
92904,0.5555555555555556,0.48780487804878053,-125,105,0.5314664257753688,0.46853357422463116,away,CIN,over,7.5,0.49504950495049505,102,0.47297076509898783,SF,CIN,2024 REG,9,6,10,5,11,19,1,0,1,-1,1,1,1,1,1,0,0,0,0,0.47297076509898783,0.5270292349010122
92904,0.5555555555555556,0.48780487804878053,-125,105,0.5314664257753688,0.46853357422463116,home,SF,under,7.5,0.5495495495495495,-122,0.5270292349010122,SF,CIN,2024 REG,9,6,10,5,11,19,1,0,1,-1,1,1,1,1,1,0,0,0,0,0.47297076509898783,0.5270292349010122
92905,0.5121951219512195,0.5348837209302326,-105,-115,0.48808156828023186,0.5119184317197681,away,ARI,over,11,0.5283018867924528,-112,0.5031902949311281,COL,ARI,2024 REG,6,3,10,5,8,16,0,1,-2,2,1,1,1,0,0,0,0,0,0,0.5031902949311281,0.4968097050688719
92905,0.5121951219512195,0.5348837209302326,-105,-115,0.48808156828023186,0.5119184317197681,home,COL,under,11,0.5192307692307692,-108,0.4968097050688719,COL,ARI,2024 REG,6,3,10,5,8,16,0,1,-2,2,1,1,1,0,0,0,0,0,0,0.5031902949311281,0.4968097050688719
92906,0.626865671641791,0.41152263374485604,-168,143,0.6028013608024003,0.3971986391975997,away,CIN,over,7.5,0.49751243781094534,101,0.4740985137509976,SD,CIN,2024 REG,10,6,8,4,10,18,1,0,2,-2,1,1,1,1,0,0,0,0,0,0.4740985137509976,0.5259014862490023
92906,0.626865671641791,0.41152263374485604,-168,143,0.6028013608024003,0.3971986391975997,home,SD,under,7.5,0.5495495495495495,-122,0.5259014862490023,SD,CIN,2024 REG,10,6,8,4,10,18,1,0,2,-2,1,1,1,1,0,0,0,0,0,0.4740985137509976,0.5259014862490023
92909,0.45454545454545453,0.5850622406639003,120,-141,0.4365419567230205,0.5634580432769796,away,LAD,over,8,0.5121951219512195,-105,0.48808156828023186,SF,LAD,2024 REG,7,4,7,1,5,14,1,0,3,-3,1,0,0,0,0,0,0,0,0,0.48808156828023186,0.5119184317197681
92909,0.45454545454545453,0.5850622406639003,120,-141,0.4365419567230205,0.5634580432769796,home,SF,under,8,0.5348837209302326,-115,0.5119184317197681,SF,LAD,2024 REG,7,4,7,1,5,14,1,0,3,-3,1,0,0,0,0,0,0,0,0,0.48808156828023186,0.5119184317197681
92912,0.6491228070175439,0.3921568627450981,-185,155,0.6223272319084604,0.3776727680915396,away,COL,over,7.5,0.5454545454545454,-120,0.5166307047184789,STL,COL,2024 REG,12,8,10,5,13,22,1,0,3,-3,1,1,1,1,1,0,0,0,0,0.5166307047184789,0.48336929528152106
92912,0.6491228070175439,0.3921568627450981,-185,155,0.6223272319084604,0.3776727680915396,home,STL,under,7.5,0.5073891625615764,-103,0.48336929528152106,STL,COL,2024 REG,12,8,10,5,13,22,1,0,3,-3,1,1,1,1,1,0,0,0,0,0.5166307047184789,0.48336929528152106
92913,0.5967741935483871,0.4464285714285714,-148,124,0.5709918983202021,0.42900810167979786,away,MIA,over,7.5,0.5433789954337899,-119,0.5171177654451503,STL,MIA,2024 REG,8,3,8,1,4,16,1,0,2,-2,1,0,0,0,0,0,0,0,0,0.5171177654451503,0.4828822345548497
92913,0.5967741935483871,0.4464285714285714,-148,124,0.5709918983202021,0.42900810167979786,home,STL,under,7.5,0.504950495049505,-102,0.4828822345548497,STL,MIA,2024 REG,8,3,8,1,4,16,1,0,2,-2,1,0,0,0,0,0,0,0,0,0.5171177654451503,0.4828822345548497
92914,0.5238095238095238,0.5238095238095238,-110,-110,0.4988662131519274,0.5011337868480725,away,PIT,over,7.5,0.5348837209302326,-115,0.5097020142727117,OAK,PIT,2024 REG,6,4,4,0,4,10,1,0,4,-4,0,0,0,0,0,0,0,0,0,0.5097020142727117,0.49029798572728833
92914,0.5238095238095238,0.5238095238095238,-110,-110,0.4988662131519274,0.5011337868480725,home,OAK,under,7.5,0.5121951219512195,-105,0.49029798572728833,OAK,PIT,2024 REG,6,4,4,0,4,10,1,0,4,-4,0,0,0,0,0,0,0,0,0,0.5097020142727117,0.49029798572728833
92915,0.7058823529411764,0.3333333333333333,-240,200,0.6782006920415226,0.32179930795847744,away,SD,over,8.5,0.5192307692307692,-108,0.49571111079951763,ATL,SD,2024 REG,11,3,7,0,3,18,1,0,3,-3,0,0,0,0,0,0,0,0,0,0.49571111079951763,0.5042888892004824
92915,0.7058823529411764,0.3333333333333333,-240,200,0.6782006920415226,0.32179930795847744,home,ATL,under,8.5,0.5260663507109005,-111,0.5042888892004824,ATL,SD,2024 REG,11,3,7,0,3,18,1,0,3,-3,0,0,0,0,0,0,0,0,0,0.49571111079951763,0.5042888892004824
92916,0.48780487804878053,0.5555555555555556,105,-125,0.4666534470222751,0.5333465529777248,away,ATL,over,7,0.49504950495049505,102,0.47297076509898783,SEA,ATL,2024 REG,7,3,7,2,5,14,1,0,1,-1,1,1,0,0,0,0,0,0,0,0.47297076509898783,0.5270292349010122
92916,0.48780487804878053,0.5555555555555556,105,-125,0.4666534470222751,0.5333465529777248,home,SEA,under,7,0.5495495495495495,-122,0.5270292349010122,SEA,ATL,2024 REG,7,3,7,2,5,14,1,0,1,-1,1,1,0,0,0,0,0,0,0,0.47297076509898783,0.5270292349010122
92918,0.5024875621890548,0.5412844036697247,-101,-118,0.48049269377245407,0.5195073062275459,away,ATL,over,10.5,0.5121951219512195,-105,0.4858858974112951,HOU,ATL,2024 REG,7,1,11,6,7,18,0,1,-5,5,1,0,0,0,0,0,0,0,0,0.4858858974112951,0.5141141025887048
92918,0.5024875621890548,0.5412844036697247,-101,-118,0.48049269377245407,0.5195073062275459,home,HOU,under,10.5,0.5391705069124424,-117,0.5141141025887048,HOU,ATL,2024 REG,7,1,11,6,7,18,0,1,-5,5,1,0,0,0,0,0,0,0,0,0.4858858974112951,0.5141141025887048
92920,0.39840637450199207,0.6428571428571428,151,-180,0.3819667261517391,0.6180332738482609,away,LAD,over,9,0.5454545454545454,-120,0.5206611570247933,PIT,LAD,2024 REG,14,7,14,11,18,28,0,1,-4,4,1,1,1,1,1,1,1,0,0,0.5206611570247933,0.4793388429752067
92920,0.39840637450199207,0.6428571428571428,151,-180,0.3819667261517391,0.6180332738482609,home,PIT,under,9,0.5,100,0.4793388429752067,PIT,LAD,2024 REG,14,7,14,11,18,28,0,1,-4,4,1,1,1,1,1,1,1,0,0,0.5206611570247933,0.4793388429752067
92922,0.6551724137931035,0.3846153846153846,-190,160,0.6291045458703008,0.37089545412969915,away,MIA,over,8,0.5121951219512195,-105,0.48808156828023186,ARI,MIA,2024 REG,4,0,9,3,3,13,0,1,-3,3,0,0,0,0,0,0,0,0,0,0.48808156828023186,0.5119184317197681
92922,0.6551724137931035,0.3846153846153846,-190,160,0.6291045458703008,0.37089545412969915,home,ARI,under,8,0.5348837209302326,-115,0.5119184317197681,ARI,MIA,2024 REG,4,0,9,3,3,13,0,1,-3,3,0,0,0,0,0,0,0,0,0,0.48808156828023186,0.5119184317197681
92923,0.45454545454545453,0.5850622406639003,120,-141,0.4365419567230205,0.5634580432769796,away,TEX,over,7.5,0.5121951219512195,-105,0.48808156828023186,OAK,TEX,2024 REG,7,2,5,4,6,12,0,1,-2,2,1,1,0,0,0,0,0,0,0,0.48808156828023186,0.5119184317197681
92923,0.45454545454545453,0.5850622406639003,120,-141,0.4365419567230205,0.5634580432769796,home,OAK,under,7.5,0.5348837209302326,-115,0.5119184317197681,OAK,TEX,2024 REG,7,2,5,4,6,12,0,1,-2,2,1,1,0,0,0,0,0,0,0,0.48808156828023186,0.5119184317197681
92924,0.6794871794871794,0.36101083032490977,-212,177,0.6519693010251187,0.34803069897488126,away,BOS,over,8.5,0.5121951219512195,-105,0.48808156828023186,ATL,BOS,2024 REG,9,5,7,0,5,16,1,0,5,-5,0,0,0,0,0,0,0,0,0,0.48808156828023186,0.5119184317197681
92924,0.6794871794871794,0.36101083032490977,-212,177,0.6519693010251187,0.34803069897488126,home,ATL,under,8.5,0.5348837209302326,-115,0.5119184317197681,ATL,BOS,2024 REG,9,5,7,0,5,16,1,0,5,-5,0,0,0,0,0,0,0,0,0,0.48808156828023186,0.5119184317197681
92925,0.6226415094339623,0.4166666666666667,-165,140,0.5981666073335706,0.40183339266642937,away,CHC,over,7.5,0.5433789954337899,-119,0.5184560714286826,MIL,CHC,2024 REG,3,3,9,6,9,12,0,1,-3,3,1,1,1,0,0,0,0,0,0,0.5184560714286826,0.48154392857131745
92925,0.6226415094339623,0.4166666666666667,-165,140,0.5981666073335706,0.40183339266642937,home,MIL,under,7.5,0.5024875621890548,-101,0.48154392857131745,MIL,CHC,2024 REG,3,3,9,6,9,12,0,1,-3,3,1,1,1,0,0,0,0,0,0,0.5184560714286826,0.48154392857131745
92926,0.5121951219512195,0.5283018867924528,-105,-112,0.49145275161909474,0.5085472483809053,away,PHI,over,8,0.5121951219512195,-105,0.4858858974112951,CIN,PHI,2024 REG,2,0,9,7,7,11,0,1,-7,7,0,0,0,0,0,0,0,0,0,0.4858858974112951,0.5141141025887048
92926,0.5121951219512195,0.5283018867924528,-105,-112,0.49145275161909474,0.5085472483809053,home,CIN,under,8,0.5391705069124424,-117,0.5141141025887048,CIN,PHI,2024 REG,2,0,9,7,7,11,0,1,-7,7,0,0,0,0,0,0,0,0,0,0.4858858974112951,0.5141141025887048
92927,0.6031746031746031,0.4347826086956522,-152,130,0.5802797769671475,0.4197202230328525,away,KC,over,7,0.5238095238095238,-110,0.4988662131519274,SEA,KC,2024 REG,11,6,6,2,8,17,1,0,4,-4,1,1,0,0,0,0,0,0,0,0.4988662131519274,0.5011337868480725
92927,0.6031746031746031,0.4347826086956522,-152,130,0.5802797769671475,0.4197202230328525,home,SEA,under,7,0.5238095238095238,-110,0.5011337868480725,SEA,KC,2024 REG,11,6,6,2,8,17,1,0,4,-4,1,1,0,0,0,0,0,0,0,0.4988662131519274,0.5011337868480725
92929,0.45454545454545453,0.5833333333333333,120,-140,0.43732782369146006,0.5626721763085399,away,NYM,over,8.5,0.5454545454545454,-120,0.5206611570247933,MIA,NYM,2024 REG,8,3,12,7,10,20,0,1,-4,4,1,1,1,0,0,0,0,0,0,0.5206611570247933,0.4793388429752067
92929,0.45454545454545453,0.5833333333333333,120,-140,0.43732782369146006,0.5626721763085399,home,MIA,under,8.5,0.5,100,0.4793388429752067,MIA,NYM,2024 REG,8,3,12,7,10,20,0,1,-4,4,1,1,1,0,0,0,0,0,0,0.5206611570247933,0.4793388429752067
92930,0.49019607843137253,0.5515695067264574,104,-123,0.4697227523736127,0.5302772476263873,away,HOU,over,8.5,0.5145631067961165,-106,0.49023796582517226,KC,HOU,2024 REG,7,4,14,3,7,21,1,0,1,-1,1,1,1,0,0,0,0,0,0,0.49023796582517226,0.5097620341748277
92930,0.49019607843137253,0.5515695067264574,104,-123,0.4697227523736127,0.5302772476263873,home,KC,under,8.5,0.5327102803738317,-114,0.5097620341748277,KC,HOU,2024 REG,7,4,14,3,7,21,1,0,1,-1,1,1,1,0,0,0,0,0,0,0.49023796582517226,0.5097620341748277
92931,0.5370370370370371,0.504950495049505,-116,-102,0.514488177212783,0.48551182278721705,away,ARI,over,8.5,0.5073891625615764,-103,0.4826927225525911,LAD,ARI,2024 REG,6,3,12,9,12,18,0,1,-6,6,1,1,1,0,0,0,0,0,0,0.4826927225525911,0.5173072774474089
92931,0.5370370370370371,0.504950495049505,-116,-102,0.514488177212783,0.48551182278721705,home,LAD,under,8.5,0.5412844036697247,-118,0.5173072774474089,LAD,ARI,2024 REG,6,3,12,9,12,18,0,1,-6,6,1,1,1,0,0,0,0,0,0,0.4826927225525911,0.5173072774474089
92933,0.6875,0.35714285714285715,-220,180,0.6568080357142857,0.3431919642857143,away,WSH,over,8.5,0.5,100,0.4772727272727273,BOS,WSH,2024 REG,9,1,8,5,6,17,0,1,-4,4,1,0,0,0,0,0,0,0,0,0.4772727272727273,0.5227272727272727
92933,0.6875,0.35714285714285715,-220,180,0.6568080357142857,0.3431919642857143,home,BOS,under,8.5,0.5454545454545454,-120,0.5227272727272727,BOS,WSH,2024 REG,9,1,8,5,6,17,0,1,-4,4,1,0,0,0,0,0,0,0,0,0.4772727272727273,0.5227272727272727
92936,0.4926108374384236,0.5495495495495495,103,-122,0.4718421738975501,0.5281578261024499,away,MIN,over,9,0.5348837209302326,-115,0.5097020142727117,KC,MIN,2024 REG,14,11,4,0,11,18,1,0,11,-11,0,0,0,0,0,0,0,0,0,0.5097020142727117,0.49029798572728833
92936,0.4926108374384236,0.5495495495495495,103,-122,0.4718421738975501,0.5281578261024499,home,KC,under,9,0.5121951219512195,-105,0.49029798572728833,KC,MIN,2024 REG,14,11,4,0,11,18,1,0,11,-11,0,0,0,0,0,0,0,0,0,0.5097020142727117,0.49029798572728833
92937,0.5555555555555556,0.48780487804878053,-125,105,0.5314664257753688,0.46853357422463116,away,CHC,over,7,0.5475113122171946,-121,0.5228602997583487,NYM,CHC,2024 REG,7,4,4,2,6,11,1,0,2,-2,1,1,0,0,0,0,0,0,0,0.5228602997583487,0.4771397002416513
92937,0.5555555555555556,0.48780487804878053,-125,105,0.5314664257753688,0.46853357422463116,home,NYM,under,7,0.49751243781094534,101,0.4771397002416513,NYM,CHC,2024 REG,7,4,4,2,6,11,1,0,2,-2,1,1,0,0,0,0,0,0,0,0.5228602997583487,0.4771397002416513
92939,0.5555555555555556,0.48780487804878053,-125,105,0.5314664257753688,0.46853357422463116,away,CLE,over,8,0.5238095238095238,-110,0.4988662131519274,TOR,CLE,2024 REG,7,5,8,0,5,15,1,0,5,-5,0,0,0,0,0,0,0,0,0,0.4988662131519274,0.5011337868480725
92939,0.5555555555555556,0.48780487804878053,-125,105,0.5314664257753688,0.46853357422463116,home,TOR,under,8,0.5238095238095238,-110,0.5011337868480725,TOR,CLE,2024 REG,7,5,8,0,5,15,1,0,5,-5,0,0,0,0,0,0,0,0,0,0.4988662131519274,0.5011337868480725
92940,0.5535714285714286,0.48780487804878053,-124,105,0.53066668740667,0.46933331259333,away,CLE,over,8,0.5098039215686274,-104,0.48592421718142587,DET,CLE,2024 REG,11,10,3,1,11,14,1,0,9,-9,1,0,0,0,0,0,0,0,0,0.48592421718142587,0.5140757828185741
92940,0.5535714285714286,0.48780487804878053,-124,105,0.53066668740667,0.46933331259333,home,DET,under,8,0.5370370370370371,-116,0.5140757828185741,DET,CLE,2024 REG,11,10,3,1,11,14,1,0,9,-9,1,0,0,0,0,0,0,0,0,0.48592421718142587,0.5140757828185741
92941,0.5850622406639003,0.45454545454545453,-141,120,0.5618892737571823,0.43811072624281766,away,KC,over,8.5,0.5260663507109005,-111,0.5010269332605688,NYM,KC,2024 REG,14,6,3,1,7,17,1,0,5,-5,1,0,0,0,0,0,0,0,0,0.5010269332605688,0.4989730667394312
92941,0.5850622406639003,0.45454545454545453,-141,120,0.5618892737571823,0.43811072624281766,home,NYM,under,8.5,0.5215311004784688,-109,0.4989730667394312,NYM,KC,2024 REG,14,6,3,1,7,17,1,0,5,-5,1,0,0,0,0,0,0,0,0,0.5010269332605688,0.4989730667394312
92942,0.5850622406639003,0.4566210045662101,-141,119,0.5606749478114291,0.4393250521885709,away,LAA,over,7.5,0.5305164319248826,-113,0.5066009958897986,SF,LAA,2024 REG,10,3,6,4,7,16,0,1,-1,1,1,1,1,0,0,0,0,0,0,0.5066009958897986,0.49339900411020143
92942,0.5850622406639003,0.4566210045662101,-141,119,0.5606749478114291,0.4393250521885709,home,SF,under,7.5,0.5145631067961165,-106,0.49339900411020143,SF,LAA,2024 REG,10,3,6,4,7,16,0,1,-1,1,1,1,1,0,0,0,0,0,0,0.5066009958897986,0.49339900411020143
92944,0.6666666666666666,0.37037037037037035,-200,170,0.6419753086419753,0.3580246913580247,away,CHC,over,8,0.5327102803738317,-114,0.5075272610403079,STL,CHC,2024 REG,6,1,13,5,6,19,0,1,-4,4,1,0,0,0,0,0,0,0,0,0.5075272610403079,0.4924727389596921
92944,0.6666666666666666,0.37037037037037035,-200,170,0.6419753086419753,0.3580246913580247,home,STL,under,8,0.5145631067961165,-106,0.4924727389596921,STL,CHC,2024 REG,6,1,13,5,6,19,0,1,-4,4,1,0,0,0,0,0,0,0,0,0.5075272610403079,0.4924727389596921
92948,0.4424778761061947,0.6000000000000001,126,-150,0.42368235570522356,0.5763176442947764,away,HOU,over,8.5,0.5098039215686274,-104,0.48483656587239576,LAA,HOU,2024 REG,12,9,14,7,16,26,1,0,2,-2,1,1,1,1,1,1,1,0,0,0.48483656587239576,0.5151634341276042
92948,0.4424778761061947,0.6000000000000001,126,-150,0.42368235570522356,0.5763176442947764,home,LAA,under,8.5,0.5391705069124424,-117,0.5151634341276042,LAA,HOU,2024 REG,12,9,14,7,16,26,1,0,2,-2,1,1,1,1,1,1,1,0,0,0.48483656587239576,0.5151634341276042
92949,0.5475113122171946,0.49751243781094534,-121,101,0.5228602997583487,0.4771397002416513,away,BOS,over,7.5,0.5260663507109005,-111,0.5022370601254724,TOR,BOS,2024 REG,10,3,11,7,10,21,0,1,-4,4,1,1,1,0,0,0,0,0,0,0.5022370601254724,0.4977629398745276
92949,0.5475113122171946,0.49751243781094534,-121,101,0.5228602997583487,0.4771397002416513,home,TOR,under,7.5,0.5192307692307692,-108,0.4977629398745276,TOR,BOS,2024 REG,10,3,11,7,10,21,0,1,-4,4,1,1,1,0,0,0,0,0,0,0.5022370601254724,0.4977629398745276
92950,0.7701149425287357,0.27027027027027023,-335,270,0.7390136866950185,0.26098631330498145,away,MIA,over,7.5,0.5391705069124424,-117,0.5127649394825569,LAD,MIA,2024 REG,5,8,6,2,10,11,1,0,6,-6,1,1,0,0,0,0,0,0,0,0.5127649394825569,0.48723506051744314
92950,0.7701149425287357,0.27027027027027023,-335,270,0.7390136866950185,0.26098631330498145,home,LAD,under,7.5,0.5098039215686274,-104,0.48723506051744314,LAD,MIA,2024 REG,5,8,6,2,10,11,1,0,6,-6,1,1,0,0,0,0,0,0,0,0.5127649394825569,0.48723506051744314
92954,0.7142857142857143,0.33112582781456956,-250,202,0.6818488984997972,0.31815110150020276,away,WSH,over,7.5,0.5348837209302326,-115,0.5097020142727117,CLE,WSH,2024 REG,9,7,4,1,8,13,1,0,6,-6,1,0,0,0,0,0,0,0,0,0.5097020142727117,0.49029798572728833
92954,0.7142857142857143,0.33112582781456956,-250,202,0.6818488984997972,0.31815110150020276,home,CLE,under,7.5,0.5121951219512195,-105,0.49029798572728833,CLE,WSH,2024 REG,9,7,4,1,8,13,1,0,6,-6,1,0,0,0,0,0,0,0,0,0.5097020142727117,0.49029798572728833
92955,0.6153846153846154,0.425531914893617,-160,135,0.5902052121364724,0.40979478786352763,away,BOS,over,9,0.5348837209302326,-115,0.5097020142727117,BAL,BOS,2024 REG,13,11,8,3,14,21,1,0,8,-8,1,1,1,0,0,0,0,0,0,0.5097020142727117,0.49029798572728833
92955,0.6153846153846154,0.425531914893617,-160,135,0.5902052121364724,0.40979478786352763,home,BAL,under,9,0.5121951219512195,-105,0.49029798572728833,BAL,BOS,2024 REG,13,11,8,3,14,21,1,0,8,-8,1,1,1,0,0,0,0,0,0,0.5097020142727117,0.49029798572728833
92956,0.607843137254902,0.4347826086956522,-155,130,0.5819333701084867,0.41806662989151333,away,NYM,over,8,0.5098039215686274,-104,0.4816329383803432,CHC,NYM,2024 REG,6,1,14,11,12,20,0,1,-10,10,1,0,0,0,0,0,0,0,0,0.4816329383803432,0.5183670616196567
92956,0.607843137254902,0.4347826086956522,-155,130,0.5819333701084867,0.41806662989151333,home,CHC,under,8,0.5454545454545454,-120,0.5183670616196567,CHC,NYM,2024 REG,6,1,14,11,12,20,0,1,-10,10,1,0,0,0,0,0,0,0,0,0.4816329383803432,0.5183670616196567
92958,0.6666666666666666,0.37037037037037035,-200,170,0.6419753086419753,0.3580246913580247,away,ARI,over,9,0.5238095238095238,-110,0.4988662131519274,ATL,ARI,2024 REG,15,9,12,8,17,27,1,0,1,-1,1,1,1,1,1,1,1,1,0,0.4988662131519274,0.5011337868480725
92958,0.6666666666666666,0.37037037037037035,-200,170,0.6419753086419753,0.3580246913580247,home,ATL,under,9,0.5238095238095238,-110,0.5011337868480725,ATL,ARI,2024 REG,15,9,12,8,17,27,1,0,1,-1,1,1,1,1,1,1,1,1,0,0.4988662131519274,0.5011337868480725
92959,0.6153846153846154,0.425531914893617,-160,135,0.5902052121364724,0.40979478786352763,away,LAA,over,8.5,0.5348837209302326,-115,0.5097020142727117,TEX,LAA,2024 REG,7,1,6,4,5,13,0,1,-3,3,1,0,0,0,0,0,0,0,0,0.5097020142727117,0.49029798572728833
92959,0.6153846153846154,0.425531914893617,-160,135,0.5902052121364724,0.40979478786352763,home,TEX,under,8.5,0.5121951219512195,-105,0.49029798572728833,TEX,LAA,2024 REG,7,1,6,4,5,13,0,1,-3,3,1,0,0,0,0,0,0,0,0,0.5097020142727117,0.49029798572728833
92965,0.45454545454545453,0.5918367346938775,120,-145,0.433462641254849,0.566537358745151,away,CLE,over,8.5,0.5260663507109005,-111,0.5022370601254724,DET,CLE,2024 REG,7,1,3,0,1,10,1,0,1,-1,0,0,0,0,0,0,0,0,0,0.5022370601254724,0.4977629398745276
92965,0.45454545454545453,0.5918367346938775,120,-145,0.433462641254849,0.566537358745151,home,DET,under,8.5,0.5192307692307692,-108,0.4977629398745276,DET,CLE,2024 REG,7,1,3,0,1,10,1,0,1,-1,0,0,0,0,0,0,0,0,0,0.5022370601254724,0.4977629398745276
92966,0.6666666666666666,0.37735849056603776,-200,165,0.6373165618448637,0.36268343815513626,away,CWS,over,9,0.5283018867924528,-112,0.5031902949311281,ARI,CWS,2024 REG,10,7,8,1,8,18,1,0,6,-6,1,0,0,0,0,0,0,0,0,0.5031902949311281,0.4968097050688719
92966,0.6666666666666666,0.37735849056603776,-200,165,0.6373165618448637,0.36268343815513626,home,ARI,under,9,0.5192307692307692,-108,0.4968097050688719,ARI,CWS,2024 REG,10,7,8,1,8,18,1,0,6,-6,1,0,0,0,0,0,0,0,0,0.5031902949311281,0.4968097050688719
92971,0.27624309392265195,0.7737556561085973,262,-342,0.26243128452175435,0.7375687154782457,away,ATL,over,9,0.5238095238095238,-110,0.4930654432315562,CWS,ATL,2024 REG,3,0,11,9,9,14,0,1,-9,9,0,0,0,0,0,0,0,0,0,0.4930654432315562,0.5069345567684438
92971,0.27624309392265195,0.7737556561085973,262,-342,0.26243128452175435,0.7375687154782457,home,CWS,under,9,0.5348837209302326,-115,0.5069345567684438,CWS,ATL,2024 REG,3,0,11,9,9,14,0,1,-9,9,0,0,0,0,0,0,0,0,0,0.4930654432315562,0.5069345567684438
92972,0.49504950495049505,0.5454545454545454,102,-120,0.47499799484898986,0.5250020051510101,away,BAL,over,7.5,0.5,100,0.4772727272727273,KC,BAL,2024 REG,8,7,15,9,16,23,0,1,-2,2,1,1,1,1,1,1,1,0,0,0.4772727272727273,0.5227272727272727
92972,0.49504950495049505,0.5454545454545454,102,-120,0.47499799484898986,0.5250020051510101,home,KC,under,7.5,0.5454545454545454,-120,0.5227272727272727,KC,BAL,2024 REG,8,7,15,9,16,23,0,1,-2,2,1,1,1,1,1,1,1,0,0,0.4772727272727273,0.5227272727272727
92973,0.6551724137931035,0.3861003861003861,-190,159,0.6281316138628862,0.3718683861371138,away,SD,over,8.5,0.5215311004784688,-109,0.49670754937970685,PHI,SD,2024 REG,6,2,12,5,7,18,0,1,-3,3,1,1,0,0,0,0,0,0,0,0.49670754937970685,0.5032924506202932
92973,0.6551724137931035,0.3861003861003861,-190,159,0.6281316138628862,0.3718683861371138,home,PHI,under,8.5,0.5260663507109005,-111,0.5032924506202932,PHI,SD,2024 REG,6,2,12,5,7,18,0,1,-3,3,1,1,0,0,0,0,0,0,0,0.49670754937970685,0.5032924506202932
92976,0.4444444444444444,0.5934959349593496,125,-146,0.42758205359831375,0.5724179464016863,away,NYY,over,9,0.5495495495495495,-122,0.5223196169142115,BOS,NYY,2024 REG,14,9,6,3,12,20,1,0,6,-6,1,1,1,0,0,0,0,0,0,0.5223196169142115,0.47768038308578853
92976,0.4444444444444444,0.5934959349593496,125,-146,0.42758205359831375,0.5724179464016863,home,BOS,under,9,0.5,100,0.47768038308578853,BOS,NYY,2024 REG,14,9,6,3,12,20,1,0,6,-6,1,1,1,0,0,0,0,0,0,0.5223196169142115,0.47768038308578853
92977,0.6527777777777778,0.3861003861003861,-188,159,0.6273989763573097,0.3726010236426903,away,CWS,over,8,0.5348837209302326,-115,0.5097020142727117,KC,CWS,2024 REG,10,10,8,1,11,18,1,0,9,-9,1,0,0,0,0,0,0,0,0,0.5097020142727117,0.49029798572728833
92977,0.6527777777777778,0.3861003861003861,-188,159,0.6273989763573097,0.3726010236426903,home,KC,under,8,0.5121951219512195,-105,0.49029798572728833,KC,CWS,2024 REG,10,10,8,1,11,18,1,0,9,-9,1,0,0,0,0,0,0,0,0,0.5097020142727117,0.49029798572728833
92979,0.5238095238095238,0.5238095238095238,-110,-110,0.4988662131519274,0.5011337868480725,away,CLE,over,7.5,0.5121951219512195,-105,0.48808156828023186,MIA,CLE,2024 REG,7,3,6,2,5,13,1,0,1,-1,1,1,0,0,0,0,0,0,0,0.48808156828023186,0.5119184317197681
92979,0.5238095238095238,0.5238095238095238,-110,-110,0.4988662131519274,0.5011337868480725,home,MIA,under,7.5,0.5348837209302326,-115,0.5119184317197681,MIA,CLE,2024 REG,7,3,6,2,5,13,1,0,1,-1,1,1,0,0,0,0,0,0,0,0.48808156828023186,0.5119184317197681
92980,0.574468085106383,0.46511627906976744,-135,115,0.5517281312179562,0.44827186878204384,away,DET,over,7.5,0.5121951219512195,-105,0.48808156828023186,ATL,DET,2024 REG,12,7,8,0,7,20,1,0,7,-7,0,0,0,0,0,0,0,0,0,0.48808156828023186,0.5119184317197681
92980,0.574468085106383,0.46511627906976744,-135,115,0.5517281312179562,0.44827186878204384,home,ATL,under,7.5,0.5348837209302326,-115,0.5119184317197681,ATL,DET,2024 REG,12,7,8,0,7,20,1,0,7,-7,0,0,0,0,0,0,0,0,0,0.48808156828023186,0.5119184317197681
92982,0.5238095238095238,0.5238095238095238,-110,-110,0.4988662131519274,0.5011337868480725,away,SEA,over,7.5,0.5454545454545454,-120,0.5179608869977906,MIN,SEA,2024 REG,7,6,10,3,9,17,1,0,3,-3,1,1,1,0,0,0,0,0,0,0.5179608869977906,0.48203911300220936
92982,0.5238095238095238,0.5238095238095238,-110,-110,0.4988662131519274,0.5011337868480725,home,MIN,under,7.5,0.504950495049505,-102,0.48203911300220936,MIN,SEA,2024 REG,7,6,10,3,9,17,1,0,3,-3,1,1,1,0,0,0,0,0,0,0.5179608869977906,0.48203911300220936
92983,0.47619047619047616,0.5652173913043479,110,-130,0.4564724440500838,0.5435275559499162,away,TEX,over,9.5,0.5,100,0.4762443438914027,LAA,TEX,2024 REG,8,7,8,2,9,16,1,0,5,-5,1,1,0,0,0,0,0,0,0,0.4762443438914027,0.5237556561085973
92983,0.47619047619047616,0.5652173913043479,110,-130,0.4564724440500838,0.5435275559499162,home,LAA,under,9.5,0.5475113122171946,-121,0.5237556561085973,LAA,TEX,2024 REG,8,7,8,2,9,16,1,0,5,-5,1,1,0,0,0,0,0,0,0,0.4762443438914027,0.5237556561085973
92984,0.5024875621890548,0.5412844036697247,-101,-118,0.48049269377245407,0.5195073062275459,away,HOU,over,8.5,0.5192307692307692,-108,0.49455035168025013,TOR,HOU,2024 REG,5,2,11,9,11,16,0,1,-7,7,1,1,0,0,0,0,0,0,0,0.49455035168025013,0.5054496483197499
92984,0.5024875621890548,0.5412844036697247,-101,-118,0.48049269377245407,0.5195073062275459,home,TOR,under,8.5,0.5283018867924528,-112,0.5054496483197499,TOR,HOU,2024 REG,5,2,11,9,11,16,0,1,-7,7,1,1,0,0,0,0,0,0,0,0.49455035168025013,0.5054496483197499
92986,0.5867768595041323,0.45454545454545453,-142,120,0.5625298818386723,0.43747011816132775,away,TB,over,7.5,0.5433789954337899,-119,0.5184560714286826,MIN,TB,2024 REG,10,6,11,7,13,21,0,1,-1,1,1,1,1,1,1,1,0,0,0,0.5184560714286826,0.48154392857131745
92986,0.5867768595041323,0.45454545454545453,-142,120,0.5625298818386723,0.43747011816132775,home,MIN,under,7.5,0.5024875621890548,-101,0.48154392857131745,MIN,TB,2024 REG,10,6,11,7,13,21,0,1,-1,1,1,1,1,1,1,1,0,0,0,0.5184560714286826,0.48154392857131745
92989,0.5652173913043479,0.47619047619047616,-130,110,0.5418129444594474,0.4581870555405526,away,ARI,over,7.5,0.5215311004784688,-109,0.49670754937970685,SD,ARI,2024 REG,14,5,9,7,12,23,0,1,-2,2,1,1,1,1,1,0,0,0,0,0.49670754937970685,0.5032924506202932
92989,0.5652173913043479,0.47619047619047616,-130,110,0.5418129444594474,0.4581870555405526,home,SD,under,7.5,0.5260663507109005,-111,0.5032924506202932,SD,ARI,2024 REG,14,5,9,7,12,23,0,1,-2,2,1,1,1,1,1,0,0,0,0,0.49670754937970685,0.5032924506202932
92991,0.647887323943662,0.39370078740157477,-184,154,0.6209429137763255,0.3790570862236745,away,STL,over,8.5,0.5192307692307692,-108,0.49455035168025013,CHC,STL,2024 REG,9,5,4,1,6,13,1,0,4,-4,1,0,0,0,0,0,0,0,0,0.49455035168025013,0.5054496483197499
92991,0.647887323943662,0.39370078740157477,-184,154,0.6209429137763255,0.3790570862236745,home,CHC,under,8.5,0.5283018867924528,-112,0.5054496483197499,CHC,STL,2024 REG,9,5,4,1,6,13,1,0,4,-4,1,0,0,0,0,0,0,0,0,0.49455035168025013,0.5054496483197499
92992,0.6108949416342413,0.4273504273504274,-157,134,0.5875310391805721,0.41246896081942785,away,SD,over,9.5,0.5121951219512195,-105,0.48808156828023186,BOS,SD,2024 REG,8,2,12,9,11,20,0,1,-7,7,1,1,0,0,0,0,0,0,0,0.48808156828023186,0.5119184317197681
92992,0.6108949416342413,0.4273504273504274,-157,134,0.5875310391805721,0.41246896081942785,home,BOS,under,9.5,0.5348837209302326,-115,0.5119184317197681,BOS,SD,2024 REG,8,2,12,9,11,20,0,1,-7,7,1,1,0,0,0,0,0,0,0,0.48808156828023186,0.5119184317197681
92993,0.5391705069124424,0.504950495049505,-117,-102,0.5153817639191344,0.4846182360808656,away,TB,over,9.5,0.5,100,0.4772727272727273,KC,TB,2024 REG,6,1,9,5,6,15,0,1,-4,4,1,0,0,0,0,0,0,0,0,0.4772727272727273,0.5227272727272727
92993,0.5391705069124424,0.504950495049505,-117,-102,0.5153817639191344,0.4846182360808656,home,KC,under,9.5,0.5454545454545454,-120,0.5227272727272727,KC,TB,2024 REG,6,1,9,5,6,15,0,1,-4,4,1,0,0,0,0,0,0,0,0,0.4772727272727273,0.5227272727272727
92996,0.5260663507109005,0.5169082125603864,-111,-107,0.5034588790373798,0.49654112096262015,away,HOU,over,8,0.5370370370370371,-116,0.5118817074154765,NYM,HOU,2024 REG,9,7,12,2,9,21,1,0,5,-5,1,1,0,0,0,0,0,0,0,0.5118817074154765,0.48811829258452355
92996,0.5260663507109005,0.5169082125603864,-111,-107,0.5034588790373798,0.49654112096262015,home,NYM,under,8,0.5098039215686274,-104,0.48811829258452355,NYM,HOU,2024 REG,9,7,12,2,9,21,1,0,5,-5,1,1,0,0,0,0,0,0,0,0.5118817074154765,0.48811829258452355
92998,0.5652173913043479,0.47619047619047616,-130,110,0.5418129444594474,0.4581870555405526,away,CHC,over,8,0.5121951219512195,-105,0.48808156828023186,SEA,CHC,2024 REG,6,4,4,2,6,10,1,0,2,-2,1,1,0,0,0,0,0,0,0,0.48808156828023186,0.5119184317197681
92998,0.5652173913043479,0.47619047619047616,-130,110,0.5418129444594474,0.4581870555405526,home,SEA,under,8,0.5348837209302326,-115,0.5119184317197681,SEA,CHC,2024 REG,6,4,4,2,6,10,1,0,2,-2,1,1,0,0,0,0,0,0,0,0.48808156828023186,0.5119184317197681
93000,0.6825396825396826,0.35714285714285715,-215,180,0.6554547745023935,0.34454522549760647,away,DET,over,8,0.5121951219512195,-105,0.48808156828023186,ATL,DET,2024 REG,7,2,5,1,3,12,1,0,1,-1,1,0,0,0,0,0,0,0,0,0.48808156828023186,0.5119184317197681
93000,0.6825396825396826,0.35714285714285715,-215,180,0.6554547745023935,0.34454522549760647,home,ATL,under,8,0.5348837209302326,-115,0.5119184317197681,ATL,DET,2024 REG,7,2,5,1,3,12,1,0,1,-1,1,0,0,0,0,0,0,0,0,0.48808156828023186,0.5119184317197681
93001,0.5391705069124424,0.504950495049505,-117,-102,0.5153817639191344,0.4846182360808656,away,ATL,over,8,0.5121951219512195,-105,0.48808156828023186,SD,ATL,2024 REG,5,1,9,6,7,14,0,1,-5,5,1,0,0,0,0,0,0,0,0,0.48808156828023186,0.5119184317197681
93001,0.5391705069124424,0.504950495049505,-117,-102,0.5153817639191344,0.4846182360808656,home,SD,under,8,0.5348837209302326,-115,0.5119184317197681,SD,ATL,2024 REG,5,1,9,6,7,14,0,1,-5,5,1,0,0,0,0,0,0,0,0,0.48808156828023186,0.5119184317197681
93002,0.5169082125603864,0.5260663507109005,-107,-111,0.4946943078742622,0.5053056921257377,away,SF,over,8,0.5348837209302326,-115,0.5097020142727117,ARI,SF,2024 REG,9,3,14,9,12,23,0,1,-6,6,1,1,1,0,0,0,0,0,0,0.5097020142727117,0.49029798572728833
93002,0.5169082125603864,0.5260663507109005,-107,-111,0.4946943078742622,0.5053056921257377,home,ARI,under,8,0.5121951219512195,-105,0.49029798572728833,ARI,SF,2024 REG,9,3,14,9,12,23,0,1,-6,6,1,1,1,0,0,0,0,0,0,0.5097020142727117,0.49029798572728833
93003,0.7142857142857143,0.3278688524590164,-250,205,0.6841753094680495,0.3158246905319505,away,STL,over,8.5,0.5495495495495495,-122,0.5250401592387142,LAD,STL,2024 REG,10,7,3,1,8,13,1,0,6,-6,1,0,0,0,0,0,0,0,0,0.5250401592387142,0.47495984076128583
93003,0.7142857142857143,0.3278688524590164,-250,205,0.6841753094680495,0.3158246905319505,home,LAD,under,8.5,0.49504950495049505,102,0.47495984076128583,LAD,STL,2024 REG,10,7,3,1,8,13,1,0,6,-6,1,0,0,0,0,0,0,0,0,0.5250401592387142,0.47495984076128583
93004,0.6153846153846154,0.425531914893617,-160,135,0.5902052121364724,0.40979478786352763,away,KC,over,8.5,0.504950495049505,-102,0.48054649490447493,MIN,KC,2024 REG,9,7,7,6,13,16,1,0,1,-1,1,1,1,1,1,1,0,0,0,0.48054649490447493,0.5194535050955251
93004,0.6153846153846154,0.425531914893617,-160,135,0.5902052121364724,0.40979478786352763,home,MIN,under,8.5,0.5433789954337899,-119,0.5194535050955251,MIN,KC,2024 REG,9,7,7,6,13,16,1,0,1,-1,1,1,1,1,1,1,0,0,0,0.48054649490447493,0.5194535050955251
93008,0.425531914893617,0.613899613899614,135,-159,0.40875254093905067,0.5912474590609493,away,MIN,over,8,0.5238095238095238,-110,0.4988662131519274,OAK,MIN,2024 REG,9,6,10,5,11,19,1,0,1,-1,1,1,1,1,1,0,0,0,0,0.4988662131519274,0.5011337868480725
93008,0.425531914893617,0.613899613899614,135,-159,0.40875254093905067,0.5912474590609493,home,OAK,under,8,0.5238095238095238,-110,0.5011337868480725,OAK,MIN,2024 REG,9,6,10,5,11,19,1,0,1,-1,1,1,1,1,1,0,0,0,0,0.4988662131519274,0.5011337868480725
93011,0.6610169491525424,0.37878787878787884,-195,164,0.6347052832258232,0.3652947167741768,away,OAK,over,8,0.5348837209302326,-115,0.5097020142727117,BAL,OAK,2024 REG,9,7,5,0,7,14,1,0,7,-7,0,0,0,0,0,0,0,0,0,0.5097020142727117,0.49029798572728833
93011,0.6610169491525424,0.37878787878787884,-195,164,0.6347052832258232,0.3652947167741768,home,BAL,under,8,0.5121951219512195,-105,0.49029798572728833,BAL,OAK,2024 REG,9,7,5,0,7,14,1,0,7,-7,0,0,0,0,0,0,0,0,0,0.5097020142727117,0.49029798572728833
93013,0.4166666666666667,0.6226415094339623,140,-165,0.4002882599580712,0.5997117400419287,away,BAL,over,8.5,0.5348837209302326,-115,0.5097020142727117,OAK,BAL,2024 REG,5,2,8,3,5,13,0,1,-1,1,1,1,0,0,0,0,0,0,0,0.5097020142727117,0.49029798572728833
93013,0.4166666666666667,0.6226415094339623,140,-165,0.4002882599580712,0.5997117400419287,home,OAK,under,8.5,0.5121951219512195,-105,0.49029798572728833,OAK,BAL,2024 REG,5,2,8,3,5,13,0,1,-1,1,1,1,0,0,0,0,0,0,0,0.5097020142727117,0.49029798572728833
93014,0.5901639344262295,0.4504504504504505,-144,122,0.5661947892531068,0.43380521074689316,away,CHC,over,8,0.5412844036697247,-118,0.5149381613977361,STL,CHC,2024 REG,6,4,8,3,7,14,1,0,1,-1,1,1,1,0,0,0,0,0,0,0.5149381613977361,0.48506183860226393
93014,0.5901639344262295,0.4504504504504505,-144,122,0.5661947892531068,0.43380521074689316,home,STL,under,8,0.5073891625615764,-103,0.48506183860226393,STL,CHC,2024 REG,6,4,8,3,7,14,1,0,1,-1,1,1,1,0,0,0,0,0,0,0.5149381613977361,0.48506183860226393
93015,0.46511627906976744,0.574468085106383,115,-135,0.44670494689481377,0.5532950531051862,away,TOR,over,8.5,0.5121951219512195,-105,0.48808156828023186,KC,TOR,2024 REG,9,3,6,2,5,15,1,0,1,-1,1,1,0,0,0,0,0,0,0,0.48808156828023186,0.5119184317197681
93015,0.46511627906976744,0.574468085106383,115,-135,0.44670494689481377,0.5532950531051862,home,KC,under,8.5,0.5348837209302326,-115,0.5119184317197681,KC,TOR,2024 REG,9,3,6,2,5,15,1,0,1,-1,1,1,0,0,0,0,0,0,0,0.48808156828023186,0.5119184317197681
93016,0.4273504273504274,0.609375,134,-156,0.4116558002775952,0.5883441997224048,away,DET,over,8.5,0.5098039215686274,-104,0.48592421718142587,LAA,DET,2024 REG,8,5,4,0,5,12,1,0,5,-5,0,0,0,0,0,0,0,0,0,0.48592421718142587,0.5140757828185741
93016,0.4273504273504274,0.609375,134,-156,0.4116558002775952,0.5883441997224048,home,LAA,under,8.5,0.5370370370370371,-116,0.5140757828185741,LAA,DET,2024 REG,8,5,4,0,5,12,1,0,5,-5,0,0,0,0,0,0,0,0,0,0.48592421718142587,0.5140757828185741
93019,0.5867768595041323,0.45454545454545453,-142,120,0.5625298818386723,0.43747011816132775,away,CHC,over,7.5,0.5,100,0.4772727272727273,SEA,CHC,2024 REG,5,2,8,3,5,13,0,1,-1,1,1,1,0,0,0,0,0,0,0,0.4772727272727273,0.5227272727272727
93019,0.5867768595041323,0.45454545454545453,-142,120,0.5625298818386723,0.43747011816132775,home,SEA,under,7.5,0.5454545454545454,-120,0.5227272727272727,SEA,CHC,2024 REG,5,2,8,3,5,13,0,1,-1,1,1,1,0,0,0,0,0,0,0,0.4772727272727273,0.5227272727272727
93021,0.5283018867924528,0.5145631067961165,-112,-106,0.5056562298022652,0.4943437701977348,away,NYY,over,7.5,0.49751243781094534,101,0.47511256217505476,SF,NYY,2024 REG,5,3,11,7,10,16,0,1,-4,4,1,1,1,0,0,0,0,0,0,0.47511256217505476,0.5248874378249453
93021,0.5283018867924528,0.5145631067961165,-112,-106,0.5056562298022652,0.4943437701977348,home,SF,under,7.5,0.5475113122171946,-121,0.5248874378249453,SF,NYY,2024 REG,5,3,11,7,10,16,0,1,-4,4,1,1,1,0,0,0,0,0,0,0.47511256217505476,0.5248874378249453
93024,0.6923076923076923,0.35460992907801414,-225,182,0.6598262621175878,0.34017373788241223,away,OAK,over,7.5,0.5348837209302326,-115,0.5097020142727117,SD,OAK,2024 REG,6,5,10,4,9,16,1,0,1,-1,1,1,1,1,0,0,0,0,0,0.5097020142727117,0.49029798572728833
93024,0.6923076923076923,0.35460992907801414,-225,182,0.6598262621175878,0.34017373788241223,home,SD,under,7.5,0.5121951219512195,-105,0.49029798572728833,SD,OAK,2024 REG,6,5,10,4,9,16,1,0,1,-1,1,1,1,1,0,0,0,0,0,0.5097020142727117,0.49029798572728833
93025,0.6415770609318996,0.4,-179,150,0.6149021723770248,0.3850978276229752,away,MIL,over,8.5,0.5121951219512195,-105,0.48919479393107135,HOU,MIL,2024 REG,8,2,6,4,6,14,0,1,-2,2,1,1,0,0,0,0,0,0,0,0.48919479393107135,0.5108052060689287
93025,0.6415770609318996,0.4,-179,150,0.6149021723770248,0.3850978276229752,home,HOU,under,8.5,0.5327102803738317,-114,0.5108052060689287,HOU,MIL,2024 REG,8,2,6,4,6,14,0,1,-2,2,1,1,0,0,0,0,0,0,0,0.48919479393107135,0.5108052060689287
93026,0.6226415094339623,0.4166666666666667,-165,140,0.5981666073335706,0.40183339266642937,away,TEX,over,10,0.5121951219512195,-105,0.48808156828023186,ATL,TEX,2024 REG,5,4,11,6,10,16,0,1,-2,2,1,1,1,1,0,0,0,0,0,0.48808156828023186,0.5119184317197681
93026,0.6226415094339623,0.4166666666666667,-165,140,0.5981666073335706,0.40183339266642937,home,ATL,under,10,0.5348837209302326,-115,0.5119184317197681,ATL,TEX,2024 REG,5,4,11,6,10,16,0,1,-2,2,1,1,1,1,0,0,0,0,0,0.48808156828023186,0.5119184317197681
93029,0.47619047619047616,0.5652173913043479,110,-130,0.4564724440500838,0.5435275559499162,away,PHI,over,7.5,0.5238095238095238,-110,0.4988662131519274,SF,PHI,2024 REG,6,1,14,6,7,20,0,1,-5,5,1,0,0,0,0,0,0,0,0,0.4988662131519274,0.5011337868480725
93029,0.47619047619047616,0.5652173913043479,110,-130,0.4564724440500838,0.5435275559499162,home,SF,under,7.5,0.5238095238095238,-110,0.5011337868480725,SF,PHI,2024 REG,6,1,14,6,7,20,0,1,-5,5,1,0,0,0,0,0,0,0,0,0.4988662131519274,0.5011337868480725
93030,0.5454545454545454,0.49751243781094534,-120,101,0.5220180091279142,0.4779819908720858,away,SEA,over,8,0.5454545454545454,-120,0.5206611570247933,TOR,SEA,2024 REG,6,1,6,6,7,12,0,1,-5,5,1,0,0,0,0,0,0,0,0,0.5206611570247933,0.4793388429752067
93030,0.5454545454545454,0.49751243781094534,-120,101,0.5220180091279142,0.4779819908720858,home,TOR,under,8,0.5,100,0.4793388429752067,TOR,SEA,2024 REG,6,1,6,6,7,12,0,1,-5,5,1,0,0,0,0,0,0,0,0,0.5206611570247933,0.4793388429752067
93032,0.47846889952153115,0.5614035087719298,109,-128,0.45939119220408575,0.5406088077959142,away,BAL,over,9,0.5121951219512195,-105,0.48808156828023186,STL,BAL,2024 REG,8,5,8,4,9,16,1,0,1,-1,1,1,1,1,0,0,0,0,0,0.48808156828023186,0.5119184317197681
93032,0.47846889952153115,0.5614035087719298,109,-128,0.45939119220408575,0.5406088077959142,home,STL,under,9,0.5348837209302326,-115,0.5119184317197681,STL,BAL,2024 REG,8,5,8,4,9,16,1,0,1,-1,1,1,1,1,0,0,0,0,0,0.48808156828023186,0.5119184317197681
93034,0.5726495726495727,0.4672897196261683,-134,114,0.5497783539959433,0.4502216460040567,away,KC,over,9,0.504950495049505,-102,0.48160416005266615,BOS,KC,2024 REG,12,5,4,0,5,16,1,0,5,-5,0,0,0,0,0,0,0,0,0,0.48160416005266615,0.5183958399473338
93034,0.5726495726495727,0.4672897196261683,-134,114,0.5497783539959433,0.4502216460040567,home,BOS,under,9,0.5412844036697247,-118,0.5183958399473338,BOS,KC,2024 REG,12,5,4,0,5,16,1,0,5,-5,0,0,0,0,0,0,0,0,0,0.48160416005266615,0.5183958399473338
93036,0.5433789954337899,0.5,-119,100,0.5198077604720502,0.48019223952794976,away,MIN,over,8.5,0.5305164319248826,-113,0.5066009958897986,MIL,MIN,2024 REG,7,3,3,2,5,10,1,0,1,-1,1,1,0,0,0,0,0,0,0,0.5066009958897986,0.49339900411020143
93036,0.5433789954337899,0.5,-119,100,0.5198077604720502,0.48019223952794976,home,MIL,under,8.5,0.5145631067961165,-106,0.49339900411020143,MIL,MIN,2024 REG,7,3,3,2,5,10,1,0,1,-1,1,1,0,0,0,0,0,0,0,0.5066009958897986,0.49339900411020143
93038,0.5726495726495727,0.4672897196261683,-134,114,0.5497783539959433,0.4502216460040567,away,ATL,over,9,0.5238095238095238,-110,0.4988662131519274,NYY,ATL,2024 REG,9,8,4,3,11,13,1,0,5,-5,1,1,1,0,0,0,0,0,0,0.4988662131519274,0.5011337868480725
93038,0.5726495726495727,0.4672897196261683,-134,114,0.5497783539959433,0.4502216460040567,home,NYY,under,9,0.5238095238095238,-110,0.5011337868480725,NYY,ATL,2024 REG,9,8,4,3,11,13,1,0,5,-5,1,1,1,0,0,0,0,0,0,0.4988662131519274,0.5011337868480725
93039,0.5454545454545454,0.5,-120,100,0.5206611570247933,0.4793388429752067,away,SEA,over,8.5,0.5454545454545454,-120,0.5206611570247933,MIL,SEA,2024 REG,5,3,10,5,8,15,0,1,-2,2,1,1,1,0,0,0,0,0,0,0.5206611570247933,0.4793388429752067
93039,0.5454545454545454,0.5,-120,100,0.5206611570247933,0.4793388429752067,home,MIL,under,8.5,0.5,100,0.4793388429752067,MIL,SEA,2024 REG,5,3,10,5,8,15,0,1,-2,2,1,1,1,0,0,0,0,0,0,0.5206611570247933,0.4793388429752067
93041,0.48780487804878053,0.5555555555555556,105,-125,0.4666534470222751,0.5333465529777248,away,HOU,over,9.5,0.5238095238095238,-110,0.4988662131519274,KC,HOU,2024 REG,11,11,9,2,13,20,1,0,9,-9,1,1,0,0,0,0,0,0,0,0.4988662131519274,0.5011337868480725
93041,0.48780487804878053,0.5555555555555556,105,-125,0.4666534470222751,0.5333465529777248,home,KC,under,9.5,0.5238095238095238,-110,0.5011337868480725,KC,HOU,2024 REG,11,11,9,2,13,20,1,0,9,-9,1,1,0,0,0,0,0,0,0,0.4988662131519274,0.5011337868480725
93042,0.75,0.29411764705882354,-300,240,0.7169117647058822,0.28308823529411775,away,CWS,over,9,0.5454545454545454,-120,0.5206611570247933,CHC,CWS,2024 REG,8,7,9,6,13,17,1,0,1,-1,1,1,1,1,1,1,0,0,0,0.5206611570247933,0.4793388429752067
93042,0.75,0.29411764705882354,-300,240,0.7169117647058822,0.28308823529411775,home,CHC,under,9,0.5,100,0.4793388429752067,CHC,CWS,2024 REG,8,7,9,6,13,17,1,0,1,-1,1,1,1,1,1,1,0,0,0,0.5206611570247933,0.4793388429752067
93046,0.5555555555555556,0.48780487804878053,-125,105,0.5314664257753688,0.46853357422463116,away,STL,over,8.5,0.5238095238095238,-110,0.4988662131519274,MIL,STL,2024 REG,12,11,5,2,13,17,1,0,9,-9,1,1,0,0,0,0,0,0,0,0.4988662131519274,0.5011337868480725
93046,0.5555555555555556,0.48780487804878053,-125,105,0.5314664257753688,0.46853357422463116,home,MIL,under,8.5,0.5238095238095238,-110,0.5011337868480725,MIL,STL,2024 REG,12,11,5,2,13,17,1,0,9,-9,1,1,0,0,0,0,0,0,0,0.4988662131519274,0.5011337868480725
93047,0.5,0.5454545454545454,100,-120,0.4772727272727273,0.5227272727272727,away,TOR,over,8.5,0.5348837209302326,-115,0.5097020142727117,DET,TOR,2024 REG,7,6,10,2,8,17,1,0,4,-4,1,1,0,0,0,0,0,0,0,0.5097020142727117,0.49029798572728833
93047,0.5,0.5454545454545454,100,-120,0.4772727272727273,0.5227272727272727,home,DET,under,8.5,0.5121951219512195,-105,0.49029798572728833,DET,TOR,2024 REG,7,6,10,2,8,17,1,0,4,-4,1,1,0,0,0,0,0,0,0,0.5097020142727117,0.49029798572728833
93048,0.5327102803738317,0.5121951219512195,-114,-105,0.508788710910954,0.491211289089046,away,SEA,over,7,0.5454545454545454,-120,0.5206611570247933,TB,SEA,2024 REG,11,4,3,3,7,14,1,0,1,-1,1,1,1,0,0,0,0,0,0,0.5206611570247933,0.4793388429752067
93048,0.5327102803738317,0.5121951219512195,-114,-105,0.508788710910954,0.491211289089046,home,TB,under,7,0.5,100,0.4793388429752067,TB,SEA,2024 REG,11,4,3,3,7,14,1,0,1,-1,1,1,1,0,0,0,0,0,0,0.5206611570247933,0.4793388429752067
93051,0.646643109540636,0.4,-183,150,0.6164816641486346,0.3835183358513654,away,CHC,over,9,0.5121951219512195,-105,0.48808156828023186,BAL,CHC,2024 REG,5,2,14,9,11,19,0,1,-7,7,1,1,0,0,0,0,0,0,0,0.48808156828023186,0.5119184317197681
93051,0.646643109540636,0.4,-183,150,0.6164816641486346,0.3835183358513654,home,BAL,under,9,0.5348837209302326,-115,0.5119184317197681,BAL,CHC,2024 REG,5,2,14,9,11,19,0,1,-7,7,1,1,0,0,0,0,0,0,0,0.48808156828023186,0.5119184317197681
93053,0.4329004329004329,0.607843137254902,131,-155,0.41526252374227923,0.5847374762577208,away,TEX,over,8.5,0.5454545454545454,-120,0.5206611570247933,LAA,TEX,2024 REG,8,4,12,9,13,20,0,1,-5,5,1,1,1,1,0,0,0,0,0,0.5206611570247933,0.4793388429752067
93053,0.4329004329004329,0.607843137254902,131,-155,0.41526252374227923,0.5847374762577208,home,LAA,under,8.5,0.5,100,0.4793388429752067,LAA,TEX,2024 REG,8,4,12,9,13,20,0,1,-5,5,1,1,1,1,0,0,0,0,0,0.5206611570247933,0.4793388429752067
93054,0.6363636363636364,0.4081632653061224,-175,145,0.6080283353010626,0.3919716646989374,away,ARI,over,8.5,0.5,100,0.4772727272727273,SD,ARI,2024 REG,4,1,12,9,10,16,0,1,-8,8,1,0,0,0,0,0,0,0,0,0.4772727272727273,0.5227272727272727
93054,0.6363636363636364,0.4081632653061224,-175,145,0.6080283353010626,0.3919716646989374,home,SD,under,8.5,0.5454545454545454,-120,0.5227272727272727,SD,ARI,2024 REG,4,1,12,9,10,16,0,1,-8,8,1,0,0,0,0,0,0,0,0,0.4772727272727273,0.5227272727272727
93057,0.6226415094339623,0.4166666666666667,-165,140,0.5981666073335706,0.40183339266642937,away,TOR,over,8,0.5348837209302326,-115,0.5097020142727117,NYY,TOR,2024 REG,8,8,5,3,11,13,1,0,5,-5,1,1,1,0,0,0,0,0,0,0.5097020142727117,0.49029798572728833
93057,0.6226415094339623,0.4166666666666667,-165,140,0.5981666073335706,0.40183339266642937,home,NYY,under,8,0.5121951219512195,-105,0.49029798572728833,NYY,TOR,2024 REG,8,8,5,3,11,13,1,0,5,-5,1,1,1,0,0,0,0,0,0,0.5097020142727117,0.49029798572728833
93060,0.5454545454545454,0.5,-120,100,0.5206611570247933,0.4793388429752067,away,BOS,over,7.5,0.5412844036697247,-118,0.5136310900085983,PIT,BOS,2024 REG,9,2,7,4,6,16,0,1,-2,2,1,1,0,0,0,0,0,0,0,0.5136310900085983,0.4863689099914017
93060,0.5454545454545454,0.5,-120,100,0.5206611570247933,0.4793388429752067,home,PIT,under,7.5,0.5098039215686274,-104,0.4863689099914017,PIT,BOS,2024 REG,9,2,7,4,6,16,0,1,-2,2,1,1,0,0,0,0,0,0,0,0.5136310900085983,0.4863689099914017
93067,0.5884773662551441,0.45454545454545453,-143,120,0.5631594099815408,0.4368405900184592,away,WSH,over,8.5,0.5121951219512195,-105,0.48808156828023186,MIA,WSH,2024 REG,4,2,7,7,9,11,0,1,-5,5,1,1,0,0,0,0,0,0,0,0.48808156828023186,0.5119184317197681
93067,0.5884773662551441,0.45454545454545453,-143,120,0.5631594099815408,0.4368405900184592,home,MIA,under,8.5,0.5348837209302326,-115,0.5119184317197681,MIA,WSH,2024 REG,4,2,7,7,9,11,0,1,-5,5,1,1,0,0,0,0,0,0,0,0.48808156828023186,0.5119184317197681
93069,0.4098360655737705,0.6296296296296295,144,-170,0.3936616003264754,0.6063383996735245,away,SEA,over,7.5,0.5098039215686274,-104,0.48592421718142587,MIA,SEA,2024 REG,4,0,15,9,9,19,0,1,-9,9,0,0,0,0,0,0,0,0,0,0.48592421718142587,0.5140757828185741
93069,0.4098360655737705,0.6296296296296295,144,-170,0.3936616003264754,0.6063383996735245,home,MIA,under,7.5,0.5370370370370371,-116,0.5140757828185741,MIA,SEA,2024 REG,4,0,15,9,9,19,0,1,-9,9,0,0,0,0,0,0,0,0,0,0.48592421718142587,0.5140757828185741
93070,0.6721311475409836,0.37037037037037035,-205,170,0.6435645535349916,0.35643544646500835,away,MIA,over,7.5,0.5121951219512195,-105,0.48808156828023186,SD,MIA,2024 REG,8,2,4,1,3,12,1,0,1,-1,1,0,0,0,0,0,0,0,0,0.48808156828023186,0.5119184317197681
93070,0.6721311475409836,0.37037037037037035,-205,170,0.6435645535349916,0.35643544646500835,home,SD,under,7.5,0.5348837209302326,-115,0.5119184317197681,SD,MIA,2024 REG,8,2,4,1,3,12,1,0,1,-1,1,0,0,0,0,0,0,0,0,0.48808156828023186,0.5119184317197681
93071,0.49504950495049505,0.5454545454545454,102,-120,0.47499799484898986,0.5250020051510101,away,ATL,over,8.5,0.5412844036697247,-118,0.5136310900085983,STL,ATL,2024 REG,8,4,6,1,5,14,1,0,3,-3,1,0,0,0,0,0,0,0,0,0.5136310900085983,0.4863689099914017
93071,0.49504950495049505,0.5454545454545454,102,-120,0.47499799484898986,0.5250020051510101,home,STL,under,8.5,0.5098039215686274,-104,0.4863689099914017,STL,ATL,2024 REG,8,4,6,1,5,14,1,0,3,-3,1,0,0,0,0,0,0,0,0,0.5136310900085983,0.4863689099914017
93074,0.5098039215686274,0.5348837209302326,-104,-115,0.4870219861770517,0.5129780138229483,away,DET,over,7,0.5238095238095238,-110,0.4988662131519274,KC,DET,2024 REG,9,8,6,3,11,15,1,0,5,-5,1,1,1,0,0,0,0,0,0,0.4988662131519274,0.5011337868480725
93074,0.5098039215686274,0.5348837209302326,-104,-115,0.4870219861770517,0.5129780138229483,home,KC,under,7,0.5238095238095238,-110,0.5011337868480725,KC,DET,2024 REG,9,8,6,3,11,15,1,0,5,-5,1,1,1,0,0,0,0,0,0,0.4988662131519274,0.5011337868480725
93079,0.5652173913043479,0.47619047619047616,-130,110,0.5418129444594474,0.4581870555405526,away,CIN,over,7.5,0.5145631067961165,-106,0.49023796582517226,SEA,CIN,2024 REG,7,5,1,1,6,8,1,0,4,-4,1,0,0,0,0,0,0,0,0,0.49023796582517226,0.5097620341748277
93079,0.5652173913043479,0.47619047619047616,-130,110,0.5418129444594474,0.4581870555405526,home,SEA,under,7.5,0.5327102803738317,-114,0.5097620341748277,SEA,CIN,2024 REG,7,5,1,1,6,8,1,0,4,-4,1,0,0,0,0,0,0,0,0,0.49023796582517226,0.5097620341748277
93082,0.5348837209302326,0.5073891625615764,-115,-103,0.5122726437136835,0.48772735628631647,away,DET,over,7.5,0.5495495495495495,-122,0.5223196169142115,HOU,DET,2024 REG,10,5,19,13,18,29,0,1,-8,8,1,1,1,1,1,0,0,0,0,0.5223196169142115,0.47768038308578853
93082,0.5348837209302326,0.5073891625615764,-115,-103,0.5122726437136835,0.48772735628631647,home,HOU,under,7.5,0.5,100,0.47768038308578853,HOU,DET,2024 REG,10,5,19,13,18,29,0,1,-8,8,1,1,1,1,1,0,0,0,0,0.5223196169142115,0.47768038308578853
93083,0.6875,0.35460992907801414,-220,182,0.6585494237588654,0.3414505762411346,away,CIN,over,8.5,0.5283018867924528,-112,0.5031902949311281,NYY,CIN,2024 REG,6,4,5,5,9,11,0,1,-1,1,1,1,1,1,0,0,0,0,0,0.5031902949311281,0.4968097050688719
93083,0.6875,0.35460992907801414,-220,182,0.6585494237588654,0.3414505762411346,home,NYY,under,8.5,0.5192307692307692,-108,0.4968097050688719,NYY,CIN,2024 REG,6,4,5,5,9,11,0,1,-1,1,1,1,1,1,0,0,0,0,0,0.5031902949311281,0.4968097050688719
93085,0.5535714285714286,0.48780487804878053,-124,105,0.53066668740667,0.46933331259333,away,STL,over,8,0.5238095238095238,-110,0.4988662131519274,PIT,STL,2024 REG,7,4,13,7,11,20,0,1,-3,3,1,1,1,1,0,0,0,0,0,0.4988662131519274,0.5011337868480725
93085,0.5535714285714286,0.48780487804878053,-124,105,0.53066668740667,0.46933331259333,home,PIT,under,8,0.5238095238095238,-110,0.5011337868480725,PIT,STL,2024 REG,7,4,13,7,11,20,0,1,-3,3,1,1,1,1,0,0,0,0,0,0.4988662131519274,0.5011337868480725
93086,0.37735849056603776,0.6666666666666666,165,-200,0.36074522368577194,0.639254776314228,away,PHI,over,8,0.5348837209302326,-115,0.5097020142727117,WSH,PHI,2024 REG,2,0,9,4,4,11,0,1,-4,4,0,0,0,0,0,0,0,0,0,0.5097020142727117,0.49029798572728833
93086,0.37735849056603776,0.6666666666666666,165,-200,0.36074522368577194,0.639254776314228,home,WSH,under,8,0.5121951219512195,-105,0.49029798572728833,WSH,PHI,2024 REG,2,0,9,4,4,11,0,1,-4,4,0,0,0,0,0,0,0,0,0,0.5097020142727117,0.49029798572728833
93089,0.5884773662551441,0.4504504504504505,-143,122,0.5655692272061728,0.43443077279382725,away,NYM,over,11.5,0.5348837209302326,-115,0.5097020142727117,PHI,NYM,2024 REG,10,5,7,6,11,17,0,1,-1,1,1,1,1,1,1,0,0,0,0,0.5097020142727117,0.49029798572728833
93089,0.5884773662551441,0.4504504504504505,-143,122,0.5655692272061728,0.43443077279382725,home,PHI,under,11.5,0.5121951219512195,-105,0.49029798572728833,PHI,NYM,2024 REG,10,5,7,6,11,17,0,1,-1,1,1,1,1,1,1,0,0,0,0,0.5097020142727117,0.49029798572728833
93090,0.4444444444444444,0.5967741935483871,125,-148,0.42612504978096366,0.5738749502190363,away,MIN,over,7.5,0.5238095238095238,-110,0.5000596729920038,SF,MIN,2024 REG,9,7,10,1,8,19,1,0,6,-6,1,0,0,0,0,0,0,0,0,0.5000596729920038,0.4999403270079962
93090,0.4444444444444444,0.5967741935483871,125,-148,0.42612504978096366,0.5738749502190363,home,SF,under,7.5,0.5215311004784688,-109,0.4999403270079962,SF,MIN,2024 REG,9,7,10,1,8,19,1,0,6,-6,1,0,0,0,0,0,0,0,0,0.5000596729920038,0.4999403270079962
93093,0.4366812227074236,0.601593625498008,129,-151,0.4199673151941347,0.5800326848058652,away,CLE,over,11,0.5121951219512195,-105,0.48808156828023186,COL,CLE,2024 REG,9,7,8,4,11,17,1,0,3,-3,1,1,1,1,0,0,0,0,0,0.48808156828023186,0.5119184317197681
93093,0.4366812227074236,0.601593625498008,129,-151,0.4199673151941347,0.5800326848058652,home,COL,under,11,0.5348837209302326,-115,0.5119184317197681,COL,CLE,2024 REG,9,7,8,4,11,17,1,0,3,-3,1,1,1,1,0,0,0,0,0,0.48808156828023186,0.5119184317197681
93094,0.46511627906976744,0.574468085106383,115,-135,0.44670494689481377,0.5532950531051862,away,LAD,over,8.5,0.5391705069124424,-117,0.5140669063204599,MIN,LAD,2024 REG,3,2,10,4,6,13,0,1,-2,2,1,1,0,0,0,0,0,0,0,0.5140669063204599,0.4859330936795401
93094,0.46511627906976744,0.574468085106383,115,-135,0.44670494689481377,0.5532950531051862,home,MIN,under,8.5,0.5073891625615764,-103,0.4859330936795401,MIN,LAD,2024 REG,3,2,10,4,6,13,0,1,-2,2,1,1,0,0,0,0,0,0,0,0.5140669063204599,0.4859330936795401
93096,0.5348837209302326,0.5121951219512195,-115,-105,0.5097020142727117,0.49029798572728833,away,MIN,over,8,0.5238095238095238,-110,0.4988662131519274,HOU,MIN,2024 REG,6,1,6,6,7,12,0,1,-5,5,1,0,0,0,0,0,0,0,0,0.4988662131519274,0.5011337868480725
93096,0.5348837209302326,0.5121951219512195,-115,-105,0.5097020142727117,0.49029798572728833,home,HOU,under,8,0.5238095238095238,-110,0.5011337868480725,HOU,MIN,2024 REG,6,1,6,6,7,12,0,1,-5,5,1,0,0,0,0,0,0,0,0,0.4988662131519274,0.5011337868480725
93097,0.6402877697841727,0.4,-178,150,0.6144920035194866,0.38550799648051337,away,CIN,over,8,0.5305164319248826,-113,0.5053568787472517,LAD,CIN,2024 REG,7,3,6,2,5,13,1,0,1,-1,1,1,0,0,0,0,0,0,0,0.5053568787472517,0.49464312125274834
93097,0.6402877697841727,0.4,-178,150,0.6144920035194866,0.38550799648051337,home,LAD,under,8,0.5169082125603864,-107,0.49464312125274834,LAD,CIN,2024 REG,7,3,6,2,5,13,1,0,1,-1,1,1,0,0,0,0,0,0,0,0.5053568787472517,0.49464312125274834
93098,0.4347826086956522,0.607843137254902,130,-155,0.41624967567367205,0.583750324326328,away,SEA,over,7.5,0.5495495495495495,-122,0.5223196169142115,MIA,SEA,2024 REG,7,6,7,4,10,14,1,0,2,-2,1,1,1,1,0,0,0,0,0,0.5223196169142115,0.47768038308578853
93098,0.4347826086956522,0.607843137254902,130,-155,0.41624967567367205,0.583750324326328,home,MIA,under,7.5,0.5,100,0.47768038308578853,MIA,SEA,2024 REG,7,6,7,4,10,14,1,0,2,-2,1,1,1,1,0,0,0,0,0,0.5223196169142115,0.47768038308578853
93100,0.5192307692307692,0.5260663507109005,-108,-111,0.49571111079951763,0.5042888892004824,away,LAA,over,8,0.5121951219512195,-105,0.48808156828023186,OAK,LAA,2024 REG,7,7,11,5,12,18,1,0,2,-2,1,1,1,1,1,0,0,0,0,0.48808156828023186,0.5119184317197681
93100,0.5192307692307692,0.5260663507109005,-108,-111,0.49571111079951763,0.5042888892004824,home,OAK,under,8,0.5348837209302326,-115,0.5119184317197681,OAK,LAA,2024 REG,7,7,11,5,12,18,1,0,2,-2,1,1,1,1,1,0,0,0,0,0.48808156828023186,0.5119184317197681
93102,0.6655518394648829,0.37735849056603776,-199,165,0.6369927903807584,0.3630072096192416,away,OAK,over,9.5,0.504950495049505,-102,0.48160416005266615,KC,OAK,2024 REG,11,5,11,3,8,22,1,0,2,-2,1,1,1,0,0,0,0,0,0,0.48160416005266615,0.5183958399473338
93102,0.6655518394648829,0.37735849056603776,-199,165,0.6369927903807584,0.3630072096192416,home,KC,under,9.5,0.5412844036697247,-118,0.5183958399473338,KC,OAK,2024 REG,11,5,11,3,8,22,1,0,2,-2,1,1,1,0,0,0,0,0,0,0.48160416005266615,0.5183958399473338
93106,0.5121951219512195,0.5305164319248826,-105,-113,0.4903184724049234,0.5096815275950766,away,DET,over,8,0.5169082125603864,-107,0.49353874091423283,TB,DET,2024 REG,11,7,7,5,12,18,1,0,2,-2,1,1,1,1,1,0,0,0,0,0.49353874091423283,0.5064612590857671
93106,0.5121951219512195,0.5305164319248826,-105,-113,0.4903184724049234,0.5096815275950766,home,TB,under,8,0.5283018867924528,-112,0.5064612590857671,TB,DET,2024 REG,11,7,7,5,12,18,1,0,2,-2,1,1,1,1,1,0,0,0,0,0.49353874091423283,0.5064612590857671
93109,0.3333333333333333,0.7058823529411764,200,-240,0.32026143790849676,0.6797385620915033,away,BOS,over,8.5,0.5475113122171946,-121,0.5214983313199976,CWS,BOS,2024 REG,4,2,24,14,16,28,0,1,-12,12,1,1,0,0,0,0,0,0,0,0.5214983313199976,0.47850166868000243
93109,0.3333333333333333,0.7058823529411764,200,-240,0.32026143790849676,0.6797385620915033,home,CWS,under,8.5,0.5,100,0.47850166868000243,CWS,BOS,2024 REG,4,2,24,14,16,28,0,1,-12,12,1,1,0,0,0,0,0,0,0,0.5214983313199976,0.47850166868000243
93111,0.3861003861003861,0.6551724137931035,159,-190,0.37016494212606577,0.6298350578739342,away,KC,over,9,0.5121951219512195,-105,0.48808156828023186,CWS,KC,2024 REG,5,2,7,4,6,12,0,1,-2,2,1,1,0,0,0,0,0,0,0,0.48808156828023186,0.5119184317197681
93111,0.3861003861003861,0.6551724137931035,159,-190,0.37016494212606577,0.6298350578739342,home,CWS,under,9,0.5348837209302326,-115,0.5119184317197681,CWS,KC,2024 REG,5,2,7,4,6,12,0,1,-2,2,1,1,0,0,0,0,0,0,0,0.48808156828023186,0.5119184317197681
93112,0.5652173913043479,0.47619047619047616,-130,110,0.5418129444594474,0.4581870555405526,away,TB,over,9,0.5121951219512195,-105,0.48808156828023186,BAL,TB,2024 REG,15,3,13,4,7,28,0,1,-1,1,1,1,1,0,0,0,0,0,0,0.48808156828023186,0.5119184317197681
93112,0.5652173913043479,0.47619047619047616,-130,110,0.5418129444594474,0.4581870555405526,home,BAL,under,9,0.5348837209302326,-115,0.5119184317197681,BAL,TB,2024 REG,15,3,13,4,7,28,0,1,-1,1,1,1,1,0,0,0,0,0,0,0.48808156828023186,0.5119184317197681
93113,0.6254681647940076,0.41152263374485604,-167,143,0.6023315979176397,0.3976684020823603,away,TEX,over,9.5,0.49504950495049505,102,0.47297076509898783,BAL,TEX,2024 REG,7,6,9,5,11,16,1,0,1,-1,1,1,1,1,1,0,0,0,0,0.47297076509898783,0.5270292349010122
93113,0.6254681647940076,0.41152263374485604,-167,143,0.6023315979176397,0.3976684020823603,home,BAL,under,9.5,0.5495495495495495,-122,0.5270292349010122,BAL,TEX,2024 REG,7,6,9,5,11,16,1,0,1,-1,1,1,1,1,1,0,0,0,0,0.47297076509898783,0.5270292349010122
93114,0.5348837209302326,0.504950495049505,-115,-102,0.5135770472666521,0.4864229527333479,away,NYY,over,8.5,0.5,100,0.4772727272727273,TOR,NYY,2024 REG,8,5,6,4,9,14,1,0,1,-1,1,1,1,1,0,0,0,0,0,0.4772727272727273,0.5227272727272727
93114,0.5348837209302326,0.504950495049505,-115,-102,0.5135770472666521,0.4864229527333479,home,TOR,under,8.5,0.5454545454545454,-120,0.5227272727272727,TOR,NYY,2024 REG,8,5,6,4,9,14,1,0,1,-1,1,1,1,1,0,0,0,0,0,0.4772727272727273,0.5227272727272727
93117,0.504950495049505,0.5391705069124424,-102,-117,0.4826715732667395,0.5173284267332605,away,WSH,over,7.5,0.5169082125603864,-107,0.49353874091423283,CWS,WSH,2024 REG,8,3,10,6,9,18,0,1,-3,3,1,1,1,0,0,0,0,0,0,0.49353874091423283,0.5064612590857671
93117,0.504950495049505,0.5391705069124424,-102,-117,0.4826715732667395,0.5173284267332605,home,CWS,under,7.5,0.5283018867924528,-112,0.5064612590857671,CWS,WSH,2024 REG,8,3,10,6,9,18,0,1,-3,3,1,1,1,0,0,0,0,0,0,0.49353874091423283,0.5064612590857671
93118,0.7777777777777779,0.26525198938992045,-350,277,0.7443101810917903,0.25568981890820974,away,COL,over,8.5,0.5238095238095238,-110,0.4988662131519274,LAD,COL,2024 REG,5,1,7,4,5,12,0,1,-3,3,1,0,0,0,0,0,0,0,0,0.4988662131519274,0.5011337868480725
93118,0.7777777777777779,0.26525198938992045,-350,277,0.7443101810917903,0.25568981890820974,home,LAD,under,8.5,0.5238095238095238,-110,0.5011337868480725,LAD,COL,2024 REG,5,1,7,4,5,12,0,1,-3,3,1,0,0,0,0,0,0,0,0,0.4988662131519274,0.5011337868480725
93119,0.5918367346938775,0.45454545454545453,-145,120,0.5643860512665178,0.43561394873348225,away,WSH,over,7.5,0.5238095238095238,-110,0.4988662131519274,CLE,WSH,2024 REG,5,3,6,2,5,11,1,0,1,-1,1,1,0,0,0,0,0,0,0,0.4988662131519274,0.5011337868480725
93119,0.5918367346938775,0.45454545454545453,-145,120,0.5643860512665178,0.43561394873348225,home,CLE,under,7.5,0.5238095238095238,-110,0.5011337868480725,CLE,WSH,2024 REG,5,3,6,2,5,11,1,0,1,-1,1,1,0,0,0,0,0,0,0,0.4988662131519274,0.5011337868480725
93121,0.4166666666666667,0.6226415094339623,140,-165,0.4002882599580712,0.5997117400419287,away,CLE,over,8,0.5454545454545454,-120,0.5206611570247933,MIA,CLE,2024 REG,4,0,11,8,8,15,0,1,-8,8,0,0,0,0,0,0,0,0,0,0.5206611570247933,0.4793388429752067
93121,0.4166666666666667,0.6226415094339623,140,-165,0.4002882599580712,0.5997117400419287,home,MIA,under,8,0.5,100,0.4793388429752067,MIA,CLE,2024 REG,4,0,11,8,8,15,0,1,-8,8,0,0,0,0,0,0,0,0,0,0.5206611570247933,0.4793388429752067
93122,0.5348837209302326,0.5121951219512195,-115,-105,0.5097020142727117,0.49029798572728833,away,DET,over,7.5,0.5454545454545454,-120,0.5206611570247933,TEX,DET,2024 REG,5,1,6,3,4,11,0,1,-2,2,1,0,0,0,0,0,0,0,0,0.5206611570247933,0.4793388429752067
93122,0.5348837209302326,0.5121951219512195,-115,-105,0.5097020142727117,0.49029798572728833,home,TEX,under,7.5,0.5,100,0.4793388429752067,TEX,DET,2024 REG,5,1,6,3,4,11,0,1,-2,2,1,0,0,0,0,0,0,0,0,0.5206611570247933,0.4793388429752067
93123,0.6441281138790036,0.4,-181,150,0.6157039551170831,0.3842960448829169,away,OAK,over,8.5,0.5238095238095238,-110,0.4988662131519274,MIN,OAK,2024 REG,10,6,5,5,11,15,1,0,1,-1,1,1,1,1,1,0,0,0,0,0.4988662131519274,0.5011337868480725
93123,0.6441281138790036,0.4,-181,150,0.6157039551170831,0.3842960448829169,home,MIN,under,8.5,0.5238095238095238,-110,0.5011337868480725,MIN,OAK,2024 REG,10,6,5,5,11,15,1,0,1,-1,1,1,1,1,1,0,0,0,0,0.4988662131519274,0.5011337868480725
93124,0.5121951219512195,0.5348837209302326,-105,-115,0.48808156828023186,0.5119184317197681,away,MIN,over,8.5,0.5454545454545454,-120,0.5206611570247933,ARI,MIN,2024 REG,9,6,13,13,19,22,0,1,-7,7,1,1,1,1,1,1,0,0,0,0.5206611570247933,0.4793388429752067
93124,0.5121951219512195,0.5348837209302326,-105,-115,0.48808156828023186,0.5119184317197681,home,ARI,under,8.5,0.5,100,0.4793388429752067,ARI,MIN,2024 REG,9,6,13,13,19,22,0,1,-7,7,1,1,1,1,1,1,0,0,0,0.5206611570247933,0.4793388429752067
93125,0.5121951219512195,0.5348837209302326,-105,-115,0.48808156828023186,0.5119184317197681,away,HOU,over,10.5,0.5121951219512195,-105,0.48808156828023186,CHC,HOU,2024 REG,6,7,6,2,9,12,1,0,5,-5,1,1,0,0,0,0,0,0,0,0.48808156828023186,0.5119184317197681
93125,0.5121951219512195,0.5348837209302326,-105,-115,0.48808156828023186,0.5119184317197681,home,CHC,under,10.5,0.5348837209302326,-115,0.5119184317197681,CHC,HOU,2024 REG,6,7,6,2,9,12,1,0,5,-5,1,1,0,0,0,0,0,0,0,0.48808156828023186,0.5119184317197681
93126,0.5433789954337899,0.5,-119,100,0.5198077604720502,0.48019223952794976,away,NYY,over,9.5,0.5283018867924528,-112,0.5044173060022736,HOU,NYY,2024 REG,12,3,10,4,7,22,0,1,-1,1,1,1,1,0,0,0,0,0,0,0.5044173060022736,0.49558269399772636
93126,0.5433789954337899,0.5,-119,100,0.5198077604720502,0.48019223952794976,home,HOU,under,9.5,0.5169082125603864,-107,0.49558269399772636,HOU,NYY,2024 REG,12,3,10,4,7,22,0,1,-1,1,1,1,1,0,0,0,0,0,0,0.5044173060022736,0.49558269399772636
93128,0.5726495726495727,0.46511627906976744,-134,115,0.5510229738017454,0.44897702619825464,away,SEA,over,9,0.5121951219512195,-105,0.48808156828023186,MIL,SEA,2024 REG,14,12,8,4,16,22,1,0,8,-8,1,1,1,1,0,0,0,0,0,0.48808156828023186,0.5119184317197681
93128,0.5726495726495727,0.46511627906976744,-134,115,0.5510229738017454,0.44897702619825464,home,MIL,under,9,0.5348837209302326,-115,0.5119184317197681,MIL,SEA,2024 REG,14,12,8,4,16,22,1,0,8,-8,1,1,1,1,0,0,0,0,0,0.48808156828023186,0.5119184317197681
93130,0.6183206106870228,0.42194092827004215,-162,137,0.5934260713318911,0.40657392866810893,away,TB,over,8,0.5192307692307692,-108,0.49455035168025013,BAL,TB,2024 REG,10,9,10,5,14,20,1,0,4,-4,1,1,1,1,1,0,0,0,0,0.49455035168025013,0.5054496483197499
93130,0.6183206106870228,0.42194092827004215,-162,137,0.5934260713318911,0.40657392866810893,home,BAL,under,8,0.5283018867924528,-112,0.5054496483197499,BAL,TB,2024 REG,10,9,10,5,14,20,1,0,4,-4,1,1,1,1,1,0,0,0,0,0.49455035168025013,0.5054496483197499
93131,0.5121951219512195,0.5283018867924528,-105,-112,0.49145275161909474,0.5085472483809053,away,CHC,over,8,0.5348837209302326,-115,0.5097020142727117,MIL,CHC,2024 REG,6,5,5,1,6,11,1,0,4,-4,1,0,0,0,0,0,0,0,0,0.5097020142727117,0.49029798572728833
93131,0.5121951219512195,0.5283018867924528,-105,-112,0.49145275161909474,0.5085472483809053,home,MIL,under,8,0.5121951219512195,-105,0.49029798572728833,MIL,CHC,2024 REG,6,5,5,1,6,11,1,0,4,-4,1,0,0,0,0,0,0,0,0,0.5097020142727117,0.49029798572728833
93132,0.6666666666666666,0.3717472118959108,-200,169,0.641057414291615,0.358942585708385,away,MIL,over,8,0.5215311004784688,-109,0.4978845547971712,PHI,MIL,2024 REG,7,3,5,1,4,12,1,0,2,-2,1,0,0,0,0,0,0,0,0,0.4978845547971712,0.5021154452028288
93132,0.6666666666666666,0.3717472118959108,-200,169,0.641057414291615,0.358942585708385,home,PHI,under,8,0.5238095238095238,-110,0.5021154452028288,PHI,MIL,2024 REG,7,3,5,1,4,12,1,0,2,-2,1,0,0,0,0,0,0,0,0,0.4978845547971712,0.5021154452028288
93133,0.6825396825396826,0.35714285714285715,-215,180,0.6554547745023935,0.34454522549760647,away,WSH,over,7.5,0.5121951219512195,-105,0.48808156828023186,SF,WSH,2024 REG,6,1,10,8,9,16,0,1,-7,7,1,0,0,0,0,0,0,0,0,0.48808156828023186,0.5119184317197681
93133,0.6825396825396826,0.35714285714285715,-215,180,0.6554547745023935,0.34454522549760647,home,SF,under,7.5,0.5348837209302326,-115,0.5119184317197681,SF,WSH,2024 REG,6,1,10,8,9,16,0,1,-7,7,1,0,0,0,0,0,0,0,0,0.48808156828023186,0.5119184317197681
93139,0.6721311475409836,0.36363636363636365,-205,175,0.6480906892086682,0.3519093107913318,away,MIA,over,8.5,0.5412844036697247,-118,0.5162581740877563,KC,MIA,2024 REG,10,5,5,1,6,15,1,0,4,-4,1,0,0,0,0,0,0,0,0,0.5162581740877563,0.4837418259122437
93139,0.6721311475409836,0.36363636363636365,-205,175,0.6480906892086682,0.3519093107913318,home,KC,under,8.5,0.504950495049505,-102,0.4837418259122437,KC,MIA,2024 REG,10,5,5,1,6,15,1,0,4,-4,1,0,0,0,0,0,0,0,0,0.5162581740877563,0.4837418259122437
93140,0.5238095238095238,0.5215311004784688,-110,-109,0.5000596729920038,0.4999403270079962,away,PIT,over,8.5,0.5433789954337899,-119,0.5171177654451503,MIA,PIT,2024 REG,5,3,16,9,12,21,0,1,-6,6,1,1,1,0,0,0,0,0,0,0.5171177654451503,0.4828822345548497
93140,0.5238095238095238,0.5215311004784688,-110,-109,0.5000596729920038,0.4999403270079962,home,MIA,under,8.5,0.504950495049505,-102,0.4828822345548497,MIA,PIT,2024 REG,5,3,16,9,12,21,0,1,-6,6,1,1,1,0,0,0,0,0,0,0.5171177654451503,0.4828822345548497
93142,0.5726495726495727,0.4672897196261683,-134,114,0.5497783539959433,0.4502216460040567,away,NYM,over,7,0.5,100,0.4772727272727273,SF,NYM,2024 REG,8,5,9,1,6,17,1,0,4,-4,1,0,0,0,0,0,0,0,0,0.4772727272727273,0.5227272727272727
93142,0.5726495726495727,0.4672897196261683,-134,114,0.5497783539959433,0.4502216460040567,home,SF,under,7,0.5454545454545454,-120,0.5227272727272727,SF,NYM,2024 REG,8,5,9,1,6,17,1,0,4,-4,1,0,0,0,0,0,0,0,0,0.4772727272727273,0.5227272727272727
93143,0.607843137254902,0.4347826086956522,-155,130,0.5819333701084867,0.41806662989151333,away,BOS,over,8,0.5073891625615764,-103,0.4837652908580103,PIT,BOS,2024 REG,7,1,8,6,7,15,0,1,-5,5,1,0,0,0,0,0,0,0,0,0.4837652908580103,0.5162347091419897
93143,0.607843137254902,0.4347826086956522,-155,130,0.5819333701084867,0.41806662989151333,home,PIT,under,8,0.5391705069124424,-117,0.5162347091419897,PIT,BOS,2024 REG,7,1,8,6,7,15,0,1,-5,5,1,0,0,0,0,0,0,0,0,0.4837652908580103,0.5162347091419897
93145,0.6721311475409836,0.3663003663003663,-205,173,0.6463001300410599,0.3536998699589401,away,NYM,over,7.5,0.5121951219512195,-105,0.48808156828023186,PHI,NYM,2024 REG,10,10,9,5,15,19,1,0,5,-5,1,1,1,1,1,0,0,0,0,0.48808156828023186,0.5119184317197681
93145,0.6721311475409836,0.3663003663003663,-205,173,0.6463001300410599,0.3536998699589401,home,PHI,under,7.5,0.5348837209302326,-115,0.5119184317197681,PHI,NYM,2024 REG,10,10,9,5,15,19,1,0,5,-5,1,1,1,1,1,0,0,0,0,0.48808156828023186,0.5119184317197681
93146,0.574468085106383,0.46511627906976744,-135,115,0.5517281312179562,0.44827186878204384,away,CHC,over,8.5,0.5305164319248826,-113,0.5053568787472517,BAL,CHC,2024 REG,5,0,13,8,8,18,0,1,-8,8,0,0,0,0,0,0,0,0,0,0.5053568787472517,0.49464312125274834
93146,0.574468085106383,0.46511627906976744,-135,115,0.5517281312179562,0.44827186878204384,home,BAL,under,8.5,0.5169082125603864,-107,0.49464312125274834,BAL,CHC,2024 REG,5,0,13,8,8,18,0,1,-8,8,0,0,0,0,0,0,0,0,0,0.5053568787472517,0.49464312125274834
93147,0.5594713656387665,0.4807692307692307,-127,108,0.5369579042122659,0.46304209578773414,away,PIT,over,7.5,0.5121951219512195,-105,0.48808156828023186,MIA,PIT,2024 REG,8,5,9,6,11,17,0,1,-1,1,1,1,1,1,1,0,0,0,0,0.48808156828023186,0.5119184317197681
93147,0.5594713656387665,0.4807692307692307,-127,108,0.5369579042122659,0.46304209578773414,home,MIA,under,7.5,0.5348837209302326,-115,0.5119184317197681,MIA,PIT,2024 REG,8,5,9,6,11,17,0,1,-1,1,1,1,1,1,1,0,0,0,0,0.48808156828023186,0.5119184317197681
93148,0.6721311475409836,0.37037037037037035,-205,170,0.6435645535349916,0.35643544646500835,away,CWS,over,7.5,0.5238095238095238,-110,0.4988662131519274,TOR,CWS,2024 REG,12,9,9,3,12,21,1,0,6,-6,1,1,1,0,0,0,0,0,0,0.4988662131519274,0.5011337868480725
93148,0.6721311475409836,0.37037037037037035,-205,170,0.6435645535349916,0.35643544646500835,home,TOR,under,7.5,0.5238095238095238,-110,0.5011337868480725,TOR,CWS,2024 REG,12,9,9,3,12,21,1,0,6,-6,1,1,1,0,0,0,0,0,0,0.4988662131519274,0.5011337868480725
93150,0.6108949416342413,0.4273504273504274,-157,134,0.5875310391805721,0.41246896081942785,away,LAD,over,9,0.5348837209302326,-115,0.5097020142727117,PHI,LAD,2024 REG,12,10,7,1,11,19,1,0,9,-9,1,0,0,0,0,0,0,0,0,0.5097020142727117,0.49029798572728833
93150,0.6108949416342413,0.4273504273504274,-157,134,0.5875310391805721,0.41246896081942785,home,PHI,under,9,0.5121951219512195,-105,0.49029798572728833,PHI,LAD,2024 REG,12,10,7,1,11,19,1,0,9,-9,1,0,0,0,0,0,0,0,0,0.5097020142727117,0.49029798572728833
93152,0.6551724137931035,0.390625,-190,156,0.6251672116527942,0.3748327883472058,away,OAK,over,8,0.5121951219512195,-105,0.48808156828023186,TB,OAK,2024 REG,9,4,6,3,7,15,1,0,1,-1,1,1,1,0,0,0,0,0,0,0.48808156828023186,0.5119184317197681
93152,0.6551724137931035,0.390625,-190,156,0.6251672116527942,0.3748327883472058,home,TB,under,8,0.5348837209302326,-115,0.5119184317197681,TB,OAK,2024 REG,9,4,6,3,7,15,1,0,1,-1,1,1,1,0,0,0,0,0,0,0.48808156828023186,0.5119184317197681
93155,0.45454545454545453,0.5833333333333333,120,-140,0.43732782369146006,0.5626721763085399,away,MIL,over,6.5,0.5454545454545454,-120,0.5206611570247933,PIT,MIL,2024 REG,8,5,12,7,12,20,0,1,-2,2,1,1,1,1,1,0,0,0,0,0.5206611570247933,0.4793388429752067
93155,0.45454545454545453,0.5833333333333333,120,-140,0.43732782369146006,0.5626721763085399,home,PIT,under,6.5,0.5,100,0.4793388429752067,PIT,MIL,2024 REG,8,5,12,7,12,20,0,1,-2,2,1,1,1,1,1,0,0,0,0,0.5206611570247933,0.4793388429752067
93156,0.48780487804878053,0.5495495495495495,105,-122,0.4695832060495952,0.5304167939504048,away,TOR,over,7.5,0.5433789954337899,-119,0.5157926447422438,SD,TOR,2024 REG,9,2,8,5,7,17,0,1,-3,3,1,1,0,0,0,0,0,0,0,0.5157926447422438,0.48420735525775616
93156,0.48780487804878053,0.5495495495495495,105,-122,0.4695832060495952,0.5304167939504048,home,SD,under,7.5,0.5073891625615764,-103,0.48420735525775616,SD,TOR,2024 REG,9,2,8,5,7,17,0,1,-3,3,1,1,0,0,0,0,0,0,0,0.5157926447422438,0.48420735525775616
93157,0.4132231404958678,0.6296296296296295,142,-170,0.3955153842456623,0.6044846157543378,away,BOS,over,7.5,0.5215311004784688,-109,0.49670754937970685,OAK,BOS,2024 REG,8,0,10,1,1,18,0,1,-1,1,0,0,0,0,0,0,0,0,0,0.49670754937970685,0.5032924506202932
93157,0.4132231404958678,0.6296296296296295,142,-170,0.3955153842456623,0.6044846157543378,home,OAK,under,7.5,0.5260663507109005,-111,0.5032924506202932,OAK,BOS,2024 REG,8,0,10,1,1,18,0,1,-1,1,0,0,0,0,0,0,0,0,0,0.49670754937970685,0.5032924506202932
93158,0.5121951219512195,0.5283018867924528,-105,-112,0.49145275161909474,0.5085472483809053,away,TOR,over,7.5,0.5121951219512195,-105,0.48808156828023186,KC,TOR,2024 REG,3,2,3,1,3,6,1,0,1,-1,1,0,0,0,0,0,0,0,0,0.48808156828023186,0.5119184317197681
93158,0.5121951219512195,0.5283018867924528,-105,-112,0.49145275161909474,0.5085472483809053,home,KC,under,7.5,0.5348837209302326,-115,0.5119184317197681,KC,TOR,2024 REG,3,2,3,1,3,6,1,0,1,-1,1,0,0,0,0,0,0,0,0,0.48808156828023186,0.5119184317197681
93159,0.5283018867924528,0.5121951219512195,-112,-105,0.5069072406637203,0.4930927593362797,away,SEA,over,7,0.5283018867924528,-112,0.5031902949311281,TB,SEA,2024 REG,5,2,5,5,7,10,0,1,-3,3,1,1,0,0,0,0,0,0,0,0.5031902949311281,0.4968097050688719
93159,0.5283018867924528,0.5121951219512195,-112,-105,0.5069072406637203,0.4930927593362797,home,TB,under,7,0.5192307692307692,-108,0.4968097050688719,TB,SEA,2024 REG,5,2,5,5,7,10,0,1,-3,3,1,1,0,0,0,0,0,0,0,0.5031902949311281,0.4968097050688719
93161,0.4132231404958678,0.6254681647940076,142,-167,0.3972349978141011,0.6027650021858989,away,HOU,over,8.5,0.5433789954337899,-119,0.5171177654451503,OAK,HOU,2024 REG,6,2,11,5,7,17,0,1,-3,3,1,1,0,0,0,0,0,0,0,0.5171177654451503,0.4828822345548497
93161,0.4132231404958678,0.6254681647940076,142,-167,0.3972349978141011,0.6027650021858989,home,OAK,under,8.5,0.504950495049505,-102,0.4828822345548497,OAK,HOU,2024 REG,6,2,11,5,7,17,0,1,-3,3,1,1,0,0,0,0,0,0,0,0.5171177654451503,0.4828822345548497
93162,0.6742671009771988,0.3663003663003663,-207,173,0.6469137924219676,0.35308620757803244,away,OAK,over,8.5,0.5121951219512195,-105,0.48808156828023186,BAL,OAK,2024 REG,9,6,10,7,13,19,0,1,-1,1,1,1,1,1,1,1,0,0,0,0.48808156828023186,0.5119184317197681
93162,0.6742671009771988,0.3663003663003663,-207,173,0.6469137924219676,0.35308620757803244,home,BAL,under,8.5,0.5348837209302326,-115,0.5119184317197681,BAL,OAK,2024 REG,9,6,10,7,13,19,0,1,-1,1,1,1,1,1,1,1,0,0,0,0.48808156828023186,0.5119184317197681
93163,0.49751243781094534,0.5454545454545454,101,-120,0.476135829221149,0.523864170778851,away,TOR,over,8,0.5348837209302326,-115,0.5097020142727117,TB,TOR,2024 REG,3,2,10,9,11,13,0,1,-7,7,1,1,0,0,0,0,0,0,0,0.5097020142727117,0.49029798572728833
93163,0.49751243781094534,0.5454545454545454,101,-120,0.476135829221149,0.523864170778851,home,TB,under,8,0.5121951219512195,-105,0.49029798572728833,TB,TOR,2024 REG,3,2,10,9,11,13,0,1,-7,7,1,1,0,0,0,0,0,0,0,0.5097020142727117,0.49029798572728833
93165,0.5967741935483871,0.4444444444444444,-148,125,0.5721759741010521,0.42782402589894786,away,MIN,over,7.5,0.5454545454545454,-120,0.5206611570247933,TOR,MIN,2024 REG,16,10,13,8,18,29,1,0,2,-2,1,1,1,1,1,1,1,1,0,0.5206611570247933,0.4793388429752067
93165,0.5967741935483871,0.4444444444444444,-148,125,0.5721759741010521,0.42782402589894786,home,TOR,under,7.5,0.5,100,0.4793388429752067,TOR,MIN,2024 REG,16,10,13,8,18,29,1,0,2,-2,1,1,1,1,1,1,1,1,0,0.5206611570247933,0.4793388429752067
93166,0.726027397260274,0.31746031746031744,-265,215,0.6944541249288857,0.3055458750711143,away,MIA,over,9,0.5073891625615764,-103,0.4826927225525911,PHI,MIA,2024 REG,5,2,8,3,5,13,0,1,-1,1,1,1,0,0,0,0,0,0,0,0.4826927225525911,0.5173072774474089
93166,0.726027397260274,0.31746031746031744,-265,215,0.6944541249288857,0.3055458750711143,home,PHI,under,9,0.5412844036697247,-118,0.5173072774474089,PHI,MIA,2024 REG,5,2,8,3,5,13,0,1,-1,1,1,1,0,0,0,0,0,0,0,0.4826927225525911,0.5173072774474089
93167,0.5454545454545454,0.5,-120,100,0.5206611570247933,0.4793388429752067,away,SF,over,9,0.5121951219512195,-105,0.48808156828023186,STL,SF,2024 REG,13,9,10,4,13,23,1,0,5,-5,1,1,1,1,0,0,0,0,0,0.48808156828023186,0.5119184317197681
93167,0.5454545454545454,0.5,-120,100,0.5206611570247933,0.4793388429752067,home,STL,under,9,0.5348837209302326,-115,0.5119184317197681,STL,SF,2024 REG,13,9,10,4,13,23,1,0,5,-5,1,1,1,1,0,0,0,0,0,0.48808156828023186,0.5119184317197681
93168,0.5121951219512195,0.5348837209302326,-105,-115,0.48808156828023186,0.5119184317197681,away,BOS,over,9,0.5454545454545454,-120,0.5166307047184789,CIN,BOS,2024 REG,6,5,6,2,7,12,1,0,3,-3,1,1,0,0,0,0,0,0,0,0.5166307047184789,0.48336929528152106
93168,0.5121951219512195,0.5348837209302326,-105,-115,0.48808156828023186,0.5119184317197681,home,CIN,under,9,0.5073891625615764,-103,0.48336929528152106,CIN,BOS,2024 REG,6,5,6,2,7,12,1,0,3,-3,1,1,0,0,0,0,0,0,0,0.5166307047184789,0.48336929528152106
93171,0.6666666666666666,0.37735849056603776,-200,165,0.6373165618448637,0.36268343815513626,away,OAK,over,8.5,0.5238095238095238,-110,0.4988662131519274,ARI,OAK,2024 REG,8,5,5,1,6,13,1,0,4,-4,1,0,0,0,0,0,0,0,0,0.4988662131519274,0.5011337868480725
93171,0.6666666666666666,0.37735849056603776,-200,165,0.6373165618448637,0.36268343815513626,home,ARI,under,8.5,0.5238095238095238,-110,0.5011337868480725,ARI,OAK,2024 REG,8,5,5,1,6,13,1,0,4,-4,1,0,0,0,0,0,0,0,0,0.4988662131519274,0.5011337868480725
93172,0.5145631067961165,0.5283018867924528,-106,-112,0.4925063625223866,0.5074936374776133,away,PHI,over,7.5,0.5,100,0.4762443438914027,SD,PHI,2024 REG,7,3,13,9,12,20,0,1,-6,6,1,1,1,0,0,0,0,0,0,0.4762443438914027,0.5237556561085973
93172,0.5145631067961165,0.5283018867924528,-106,-112,0.4925063625223866,0.5074936374776133,home,SD,under,7.5,0.5475113122171946,-121,0.5237556561085973,SD,PHI,2024 REG,7,3,13,9,12,20,0,1,-6,6,1,1,1,0,0,0,0,0,0,0.4762443438914027,0.5237556561085973
93173,0.48780487804878053,0.5555555555555556,105,-125,0.4666534470222751,0.5333465529777248,away,TEX,over,8,0.5348837209302326,-115,0.5097020142727117,OAK,TEX,2024 REG,7,8,19,15,23,26,0,1,-7,7,1,1,1,1,1,1,1,1,0,0.5097020142727117,0.49029798572728833
93173,0.48780487804878053,0.5555555555555556,105,-125,0.4666534470222751,0.5333465529777248,home,OAK,under,8,0.5121951219512195,-105,0.49029798572728833,OAK,TEX,2024 REG,7,8,19,15,23,26,0,1,-7,7,1,1,1,1,1,1,1,1,0,0.5097020142727117,0.49029798572728833
93174,0.5515695067264574,0.49019607843137253,-123,104,0.5285328835228112,0.47146711647718875,away,TEX,over,8.5,0.5215311004784688,-109,0.49670754937970685,DET,TEX,2024 REG,5,0,7,1,1,12,0,1,-1,1,0,0,0,0,0,0,0,0,0,0.49670754937970685,0.5032924506202932
93174,0.5515695067264574,0.49019607843137253,-123,104,0.5285328835228112,0.47146711647718875,home,DET,under,8.5,0.5260663507109005,-111,0.5032924506202932,DET,TEX,2024 REG,5,0,7,1,1,12,0,1,-1,1,0,0,0,0,0,0,0,0,0,0.49670754937970685,0.5032924506202932
93175,0.574468085106383,0.46511627906976744,-135,115,0.5517281312179562,0.44827186878204384,away,HOU,over,7,0.5495495495495495,-122,0.5223196169142115,SEA,HOU,2024 REG,4,0,9,4,4,13,0,1,-4,4,0,0,0,0,0,0,0,0,0,0.5223196169142115,0.47768038308578853
93175,0.574468085106383,0.46511627906976744,-135,115,0.5517281312179562,0.44827186878204384,home,SEA,under,7,0.5,100,0.47768038308578853,SEA,HOU,2024 REG,4,0,9,4,4,13,0,1,-4,4,0,0,0,0,0,0,0,0,0,0.5223196169142115,0.47768038308578853
93177,0.4,0.6491228070175439,150,-185,0.38035087719298244,0.6196491228070176,away,BAL,over,8,0.5169082125603864,-107,0.4912600060678196,OAK,BAL,2024 REG,7,3,8,6,9,15,0,1,-3,3,1,1,1,0,0,0,0,0,0,0.4912600060678196,0.5087399939321804
93177,0.4,0.6491228070175439,150,-185,0.38035087719298244,0.6196491228070176,home,OAK,under,8,0.5327102803738317,-114,0.5087399939321804,OAK,BAL,2024 REG,7,3,8,6,9,15,0,1,-3,3,1,1,1,0,0,0,0,0,0,0.4912600060678196,0.5087399939321804
93178,0.5024875621890548,0.5433789954337899,-101,-119,0.4794401874631478,0.5205598125368522,away,SD,over,7.5,0.5,100,0.4772727272727273,TEX,SD,2024 REG,10,7,2,0,7,12,1,0,7,-7,0,0,0,0,0,0,0,0,0,0.4772727272727273,0.5227272727272727
93178,0.5024875621890548,0.5433789954337899,-101,-119,0.4794401874631478,0.5205598125368522,home,TEX,under,7.5,0.5454545454545454,-120,0.5227272727272727,TEX,SD,2024 REG,10,7,2,0,7,12,1,0,7,-7,0,0,0,0,0,0,0,0,0,0.4772727272727273,0.5227272727272727
93179,0.5901639344262295,0.45248868778280543,-144,121,0.5649918950897499,0.4350081049102501,away,ARI,over,8.5,0.5454545454545454,-120,0.5206611570247933,WSH,ARI,2024 REG,4,2,13,5,7,17,0,1,-3,3,1,1,0,0,0,0,0,0,0,0.5206611570247933,0.4793388429752067
93179,0.5901639344262295,0.45248868778280543,-144,121,0.5649918950897499,0.4350081049102501,home,WSH,under,8.5,0.5,100,0.4793388429752067,WSH,ARI,2024 REG,4,2,13,5,7,17,0,1,-3,3,1,1,0,0,0,0,0,0,0,0.5206611570247933,0.4793388429752067
93180,0.576271186440678,0.4629629629629629,-136,116,0.553661676614851,0.446338323385149,away,CLE,over,7.5,0.5121951219512195,-105,0.48808156828023186,TB,CLE,2024 REG,9,2,5,0,2,14,1,0,2,-2,0,0,0,0,0,0,0,0,0,0.48808156828023186,0.5119184317197681
93180,0.576271186440678,0.4629629629629629,-136,116,0.553661676614851,0.446338323385149,home,TB,under,7.5,0.5348837209302326,-115,0.5119184317197681,TB,CLE,2024 REG,9,2,5,0,2,14,1,0,2,-2,0,0,0,0,0,0,0,0,0,0.48808156828023186,0.5119184317197681
93182,0.5652173913043479,0.47619047619047616,-130,110,0.5418129444594474,0.4581870555405526,away,KC,over,7.5,0.5283018867924528,-112,0.5031902949311281,TOR,KC,2024 REG,4,1,8,4,5,12,0,1,-3,3,1,0,0,0,0,0,0,0,0,0.5031902949311281,0.4968097050688719
93182,0.5652173913043479,0.47619047619047616,-130,110,0.5418129444594474,0.4581870555405526,home,TOR,under,7.5,0.5192307692307692,-108,0.4968097050688719,TOR,KC,2024 REG,4,1,8,4,5,12,0,1,-3,3,1,0,0,0,0,0,0,0,0,0.5031902949311281,0.4968097050688719
93184,0.4672897196261683,0.5726495726495727,114,-134,0.44862649893656975,0.5513735010634302,away,TOR,over,8,0.5412844036697247,-118,0.5149381613977361,OAK,TOR,2024 REG,7,4,7,6,10,14,0,1,-2,2,1,1,1,1,0,0,0,0,0,0.5149381613977361,0.48506183860226393
93184,0.4672897196261683,0.5726495726495727,114,-134,0.44862649893656975,0.5513735010634302,home,OAK,under,8,0.5073891625615764,-103,0.48506183860226393,OAK,TOR,2024 REG,7,4,7,6,10,14,0,1,-2,2,1,1,1,1,0,0,0,0,0,0.5149381613977361,0.48506183860226393
93185,0.6336996336996338,0.4081632653061224,-173,145,0.6071711299340814,0.3928288700659186,away,COL,over,8,0.5348837209302326,-115,0.5097020142727117,STL,COL,2024 REG,10,5,5,1,6,15,1,0,4,-4,1,0,0,0,0,0,0,0,0,0.5097020142727117,0.49029798572728833
93185,0.6336996336996338,0.4081632653061224,-173,145,0.6071711299340814,0.3928288700659186,home,STL,under,8,0.5121951219512195,-105,0.49029798572728833,STL,COL,2024 REG,10,5,5,1,6,15,1,0,4,-4,1,0,0,0,0,0,0,0,0,0.5097020142727117,0.49029798572728833
93186,0.574468085106383,0.46511627906976744,-135,115,0.5517281312179562,0.44827186878204384,away,HOU,over,7.5,0.5238095238095238,-110,0.4988662131519274,MIN,HOU,2024 REG,14,9,7,3,12,21,1,0,6,-6,1,1,1,0,0,0,0,0,0,0.4988662131519274,0.5011337868480725
93186,0.574468085106383,0.46511627906976744,-135,115,0.5517281312179562,0.44827186878204384,home,MIN,under,7.5,0.5238095238095238,-110,0.5011337868480725,MIN,HOU,2024 REG,14,9,7,3,12,21,1,0,6,-6,1,1,1,0,0,0,0,0,0,0.4988662131519274,0.5011337868480725
93187,0.46511627906976744,0.574468085106383,115,-135,0.44670494689481377,0.5532950531051862,away,NYY,over,8.5,0.5145631067961165,-106,0.4913668392989033,MIL,NYY,2024 REG,11,5,18,15,20,29,0,1,-10,10,1,1,1,1,1,0,0,0,0,0.4913668392989033,0.5086331607010968
93187,0.46511627906976744,0.574468085106383,115,-135,0.44670494689481377,0.5532950531051862,home,MIL,under,8.5,0.5305164319248826,-113,0.5086331607010968,MIL,NYY,2024 REG,11,5,18,15,20,29,0,1,-10,10,1,1,1,1,1,0,0,0,0,0.4913668392989033,0.5086331607010968
93188,0.6031746031746031,0.44052863436123346,-152,127,0.5768139202164795,0.4231860797835205,away,PIT,over,8.5,0.5215311004784688,-109,0.48552333500561085,DET,PIT,2024 REG,4,2,13,10,12,17,0,1,-8,8,1,1,0,0,0,0,0,0,0,0.48552333500561085,0.5144766649943892
93188,0.6031746031746031,0.44052863436123346,-152,127,0.5768139202164795,0.4231860797835205,home,DET,under,8.5,0.5475113122171946,-121,0.5144766649943892,DET,PIT,2024 REG,4,2,13,10,12,17,0,1,-8,8,1,1,0,0,0,0,0,0,0,0.48552333500561085,0.5144766649943892
93190,0.4347826086956522,0.607843137254902,130,-155,0.41624967567367205,0.583750324326328,away,LAD,over,8,0.5,100,0.4772727272727273,CHC,LAD,2024 REG,7,1,9,4,5,16,0,1,-3,3,1,0,0,0,0,0,0,0,0,0.4772727272727273,0.5227272727272727
93190,0.4347826086956522,0.607843137254902,130,-155,0.41624967567367205,0.583750324326328,home,CHC,under,8,0.5454545454545454,-120,0.5227272727272727,CHC,LAD,2024 REG,7,1,9,4,5,16,0,1,-3,3,1,0,0,0,0,0,0,0,0,0.4772727272727273,0.5227272727272727
93191,0.5652173913043479,0.47619047619047616,-130,110,0.5418129444594474,0.4581870555405526,away,STL,over,10.5,0.5121951219512195,-105,0.48808156828023186,CHC,STL,2024 REG,5,1,9,2,3,14,0,1,-1,1,1,0,0,0,0,0,0,0,0,0.48808156828023186,0.5119184317197681
93191,0.5652173913043479,0.47619047619047616,-130,110,0.5418129444594474,0.4581870555405526,home,CHC,under,10.5,0.5348837209302326,-115,0.5119184317197681,CHC,STL,2024 REG,5,1,9,2,3,14,0,1,-1,1,1,0,0,0,0,0,0,0,0,0.48808156828023186,0.5119184317197681
93193,0.5238095238095238,0.5238095238095238,-110,-110,0.4988662131519274,0.5011337868480725,away,NYY,over,9,0.504950495049505,-102,0.4826715732667395,ARI,NYY,2024 REG,12,7,3,0,7,15,1,0,7,-7,0,0,0,0,0,0,0,0,0,0.4826715732667395,0.5173284267332605
93193,0.5238095238095238,0.5238095238095238,-110,-110,0.4988662131519274,0.5011337868480725,home,ARI,under,9,0.5391705069124424,-117,0.5173284267332605,ARI,NYY,2024 REG,12,7,3,0,7,15,1,0,7,-7,0,0,0,0,0,0,0,0,0,0.4826715732667395,0.5173284267332605
93194,0.504950495049505,0.5370370370370371,-102,-116,0.4837488699364985,0.5162511300635015,away,HOU,over,7,0.5454545454545454,-120,0.5206611570247933,CWS,HOU,2024 REG,8,1,12,4,5,20,0,1,-3,3,1,0,0,0,0,0,0,0,0,0.5206611570247933,0.4793388429752067
93194,0.504950495049505,0.5370370370370371,-102,-116,0.4837488699364985,0.5162511300635015,home,CWS,under,7,0.5,100,0.4793388429752067,CWS,HOU,2024 REG,8,1,12,4,5,20,0,1,-3,3,1,0,0,0,0,0,0,0,0,0.5206611570247933,0.4793388429752067
93196,0.46511627906976744,0.574468085106383,115,-135,0.44670494689481377,0.5532950531051862,away,DET,over,8,0.5348837209302326,-115,0.5097020142727117,CIN,DET,2024 REG,4,1,12,5,6,16,0,1,-4,4,1,0,0,0,0,0,0,0,0,0.5097020142727117,0.49029798572728833
93196,0.46511627906976744,0.574468085106383,115,-135,0.44670494689481377,0.5532950531051862,home,CIN,under,8,0.5121951219512195,-105,0.49029798572728833,CIN,DET,2024 REG,4,1,12,5,6,16,0,1,-4,4,1,0,0,0,0,0,0,0,0,0.5097020142727117,0.49029798572728833
93198,0.4587155963302753,0.5780590717299579,118,-137,0.4418464825411775,0.5581535174588226,away,TB,over,11.5,0.5,100,0.4772727272727273,COL,TB,2024 REG,11,6,9,8,14,20,0,1,-2,2,1,1,1,1,1,1,0,0,0,0.4772727272727273,0.5227272727272727
93198,0.4587155963302753,0.5780590717299579,118,-137,0.4418464825411775,0.5581535174588226,home,COL,under,11.5,0.5454545454545454,-120,0.5227272727272727,COL,TB,2024 REG,11,6,9,8,14,20,0,1,-2,2,1,1,1,1,1,1,0,0,0,0.4772727272727273,0.5227272727272727
93205,0.6376811594202898,0.4,-176,150,0.6136525939928585,0.38634740600714146,away,OAK,over,7.5,0.5454545454545454,-120,0.5206611570247933,TB,OAK,2024 REG,3,0,5,3,3,8,0,1,-3,3,0,0,0,0,0,0,0,0,0,0.5206611570247933,0.4793388429752067
93205,0.6376811594202898,0.4,-176,150,0.6136525939928585,0.38634740600714146,home,TB,under,7.5,0.5,100,0.4793388429752067,TB,OAK,2024 REG,3,0,5,3,3,8,0,1,-3,3,0,0,0,0,0,0,0,0,0,0.5206611570247933,0.4793388429752067
93207,0.36764705882352944,0.6742671009771988,172,-207,0.3522374412497323,0.6477625587502678,away,TOR,over,9,0.5238095238095238,-110,0.4988662131519274,CWS,TOR,2024 REG,10,1,6,5,6,16,0,1,-4,4,1,0,0,0,0,0,0,0,0,0.4988662131519274,0.5011337868480725
93207,0.36764705882352944,0.6742671009771988,172,-207,0.3522374412497323,0.6477625587502678,home,CWS,under,9,0.5238095238095238,-110,0.5011337868480725,CWS,TOR,2024 REG,10,1,6,5,6,16,0,1,-4,4,1,0,0,0,0,0,0,0,0,0.4988662131519274,0.5011337868480725
93209,0.6031746031746031,0.44052863436123346,-152,127,0.5768139202164795,0.4231860797835205,away,MIA,over,9.5,0.5098039215686274,-104,0.48375889301574193,CIN,MIA,2024 REG,10,10,15,6,16,25,1,0,4,-4,1,1,1,1,1,1,0,0,0,0.48375889301574193,0.5162411069842581
93209,0.6031746031746031,0.44052863436123346,-152,127,0.5768139202164795,0.4231860797835205,home,CIN,under,9.5,0.5412844036697247,-118,0.5162411069842581,CIN,MIA,2024 REG,10,10,15,6,16,25,1,0,4,-4,1,1,1,1,1,1,0,0,0,0.48375889301574193,0.5162411069842581
93210,0.7422680412371133,0.30120481927710846,-288,232,0.7099995262162476,0.2900004737837524,away,COL,over,8.5,0.5121951219512195,-105,0.48808156828023186,NYM,COL,2024 REG,10,7,8,6,13,18,1,0,1,-1,1,1,1,1,1,1,0,0,0,0.48808156828023186,0.5119184317197681
93210,0.7422680412371133,0.30120481927710846,-288,232,0.7099995262162476,0.2900004737837524,home,NYM,under,8.5,0.5348837209302326,-115,0.5119184317197681,NYM,COL,2024 REG,10,7,8,6,13,18,1,0,1,-1,1,1,1,1,1,1,0,0,0,0.48808156828023186,0.5119184317197681
93211,0.5867768595041323,0.45248868778280543,-142,121,0.563736744980392,0.43626325501960805,away,KC,over,8.5,0.5475113122171946,-121,0.5228602997583487,STL,KC,2024 REG,6,4,9,6,10,15,0,1,-2,2,1,1,1,1,0,0,0,0,0,0.5228602997583487,0.4771397002416513
93211,0.5867768595041323,0.45248868778280543,-142,121,0.563736744980392,0.43626325501960805,home,STL,under,8.5,0.49751243781094534,101,0.4771397002416513,STL,KC,2024 REG,6,4,9,6,10,15,0,1,-2,2,1,1,1,1,0,0,0,0,0,0.5228602997583487,0.4771397002416513
93214,0.5121951219512195,0.5305164319248826,-105,-113,0.4903184724049234,0.5096815275950766,away,SF,over,8,0.5283018867924528,-112,0.5044173060022736,MIA,SF,2024 REG,6,1,9,3,4,15,0,1,-2,2,1,0,0,0,0,0,0,0,0,0.5044173060022736,0.49558269399772636
93214,0.5121951219512195,0.5305164319248826,-105,-113,0.4903184724049234,0.5096815275950766,home,MIA,under,8,0.5169082125603864,-107,0.49558269399772636,MIA,SF,2024 REG,6,1,9,3,4,15,0,1,-2,2,1,0,0,0,0,0,0,0,0,0.5044173060022736,0.49558269399772636
93215,0.6296296296296295,0.41152263374485604,-170,143,0.6037189452827312,0.3962810547172688,away,CWS,over,8.5,0.5495495495495495,-122,0.5223196169142115,DET,CWS,2024 REG,5,1,12,5,6,17,0,1,-4,4,1,0,0,0,0,0,0,0,0,0.5223196169142115,0.47768038308578853
93215,0.6296296296296295,0.41152263374485604,-170,143,0.6037189452827312,0.3962810547172688,home,DET,under,8.5,0.5,100,0.47768038308578853,DET,CWS,2024 REG,5,1,12,5,6,17,0,1,-4,4,1,0,0,0,0,0,0,0,0,0.5223196169142115,0.47768038308578853
93216,0.5305164319248826,0.5121951219512195,-113,-105,0.5078572507605655,0.49214274923943446,away,SD,over,10,0.5348837209302326,-115,0.5097020142727117,BOS,SD,2024 REG,8,4,8,1,5,16,1,0,3,-3,1,0,0,0,0,0,0,0,0,0.5097020142727117,0.49029798572728833
93216,0.5305164319248826,0.5121951219512195,-113,-105,0.5078572507605655,0.49214274923943446,home,BOS,under,10,0.5121951219512195,-105,0.49029798572728833,BOS,SD,2024 REG,8,4,8,1,5,16,1,0,3,-3,1,0,0,0,0,0,0,0,0,0.5097020142727117,0.49029798572728833
93217,0.5555555555555556,0.48780487804878053,-125,105,0.5314664257753688,0.46853357422463116,away,CHC,over,9.5,0.5260663507109005,-111,0.5010269332605688,TEX,CHC,2024 REG,16,11,5,2,13,21,1,0,9,-9,1,1,0,0,0,0,0,0,0,0.5010269332605688,0.4989730667394312
93217,0.5555555555555556,0.48780487804878053,-125,105,0.5314664257753688,0.46853357422463116,home,TEX,under,9.5,0.5215311004784688,-109,0.4989730667394312,TEX,CHC,2024 REG,16,11,5,2,13,21,1,0,9,-9,1,1,0,0,0,0,0,0,0,0.5010269332605688,0.4989730667394312
93219,0.607843137254902,0.43103448275862066,-155,132,0.5842116427368785,0.41578835726312147,away,MIA,over,7.5,0.5348837209302326,-115,0.5097020142727117,NYM,MIA,2024 REG,14,10,9,4,14,23,1,0,6,-6,1,1,1,1,0,0,0,0,0,0.5097020142727117,0.49029798572728833
93219,0.607843137254902,0.43103448275862066,-155,132,0.5842116427368785,0.41578835726312147,home,NYM,under,7.5,0.5121951219512195,-105,0.49029798572728833,NYM,MIA,2024 REG,14,10,9,4,14,23,1,0,6,-6,1,1,1,1,0,0,0,0,0,0.5097020142727117,0.49029798572728833
93221,0.5454545454545454,0.5,-120,100,0.5206611570247933,0.4793388429752067,away,ATL,over,9,0.504950495049505,-102,0.4826715732667395,CHC,ATL,2024 REG,4,0,6,3,3,10,0,1,-3,3,0,0,0,0,0,0,0,0,0,0.4826715732667395,0.5173284267332605
93221,0.5454545454545454,0.5,-120,100,0.5206611570247933,0.4793388429752067,home,CHC,under,9,0.5391705069124424,-117,0.5173284267332605,CHC,ATL,2024 REG,4,0,6,3,3,10,0,1,-3,3,0,0,0,0,0,0,0,0,0,0.4826715732667395,0.5173284267332605
93223,0.41493775933609955,0.6254681647940076,141,-167,0.39817181571364846,0.6018281842863515,away,CLE,over,9,0.5348837209302326,-115,0.5097020142727117,CWS,CLE,2024 REG,6,0,5,7,7,11,0,1,-7,7,0,0,0,0,0,0,0,0,0,0.5097020142727117,0.49029798572728833
93223,0.41493775933609955,0.6254681647940076,141,-167,0.39817181571364846,0.6018281842863515,home,CWS,under,9,0.5121951219512195,-105,0.49029798572728833,CWS,CLE,2024 REG,6,0,5,7,7,11,0,1,-7,7,0,0,0,0,0,0,0,0,0,0.5097020142727117,0.49029798572728833
93224,0.4291845493562232,0.6108949416342413,133,-157,0.4119830510770539,0.5880169489229461,away,PHI,over,8,0.5121951219512195,-105,0.48808156828023186,BOS,PHI,2024 REG,4,1,7,4,5,11,0,1,-3,3,1,0,0,0,0,0,0,0,0,0.48808156828023186,0.5119184317197681
93224,0.4291845493562232,0.6108949416342413,133,-157,0.4119830510770539,0.5880169489229461,home,BOS,under,8,0.5348837209302326,-115,0.5119184317197681,BOS,PHI,2024 REG,4,1,7,4,5,11,0,1,-3,3,1,0,0,0,0,0,0,0,0,0.48808156828023186,0.5119184317197681
93225,0.6575342465753424,0.38167938931297707,-192,162,0.6317499380460364,0.3682500619539636,away,COL,over,9.5,0.5,100,0.4772727272727273,CIN,COL,2024 REG,12,5,12,6,11,24,0,1,-1,1,1,1,1,1,1,0,0,0,0,0.4772727272727273,0.5227272727272727
93225,0.6575342465753424,0.38167938931297707,-192,162,0.6317499380460364,0.3682500619539636,home,CIN,under,9.5,0.5454545454545454,-120,0.5227272727272727,CIN,COL,2024 REG,12,5,12,6,11,24,0,1,-1,1,1,1,1,1,1,0,0,0,0,0.4772727272727273,0.5227272727272727
93226,0.5121951219512195,0.5348837209302326,-105,-115,0.48808156828023186,0.5119184317197681,away,PHI,over,7.5,0.5238095238095238,-110,0.4988662131519274,CHC,PHI,2024 REG,9,3,9,5,8,18,0,1,-2,2,1,1,1,0,0,0,0,0,0,0.4988662131519274,0.5011337868480725
93226,0.5121951219512195,0.5348837209302326,-105,-115,0.48808156828023186,0.5119184317197681,home,CHC,under,7.5,0.5238095238095238,-110,0.5011337868480725,CHC,PHI,2024 REG,9,3,9,5,8,18,0,1,-2,2,1,1,1,0,0,0,0,0,0,0.4988662131519274,0.5011337868480725
93227,0.5433789954337899,0.5024875621890548,-119,-101,0.5184560714286826,0.48154392857131745,away,DET,over,7,0.5283018867924528,-112,0.5044173060022736,CLE,DET,2024 REG,7,2,6,1,3,13,1,0,1,-1,1,0,0,0,0,0,0,0,0,0.5044173060022736,0.49558269399772636
93227,0.5433789954337899,0.5024875621890548,-119,-101,0.5184560714286826,0.48154392857131745,home,CLE,under,7,0.5169082125603864,-107,0.49558269399772636,CLE,DET,2024 REG,7,2,6,1,3,13,1,0,1,-1,1,0,0,0,0,0,0,0,0,0.5044173060022736,0.49558269399772636
93228,0.5689655172413793,0.4716981132075471,-132,112,0.5458293137100936,0.4541706862899064,away,ARI,over,7,0.5238095238095238,-110,0.4988662131519274,SD,ARI,2024 REG,14,10,8,3,13,22,1,0,7,-7,1,1,1,0,0,0,0,0,0,0.4988662131519274,0.5011337868480725
93228,0.5689655172413793,0.4716981132075471,-132,112,0.5458293137100936,0.4541706862899064,home,SD,under,7,0.5238095238095238,-110,0.5011337868480725,SD,ARI,2024 REG,14,10,8,3,13,22,1,0,7,-7,1,1,1,0,0,0,0,0,0,0.4988662131519274,0.5011337868480725
93231,0.4587155963302753,0.5833333333333333,118,-140,0.4394270964845833,0.5605729035154168,away,SEA,over,8.5,0.5024875621890548,-101,0.4794401874631478,LAA,SEA,2024 REG,11,6,10,5,11,21,1,0,1,-1,1,1,1,1,1,0,0,0,0,0.4794401874631478,0.5205598125368522
93231,0.4587155963302753,0.5833333333333333,118,-140,0.4394270964845833,0.5605729035154168,home,LAA,under,8.5,0.5433789954337899,-119,0.5205598125368522,LAA,SEA,2024 REG,11,6,10,5,11,21,1,0,1,-1,1,1,1,1,1,0,0,0,0,0.4794401874631478,0.5205598125368522
93232,0.5348837209302326,0.5121951219512195,-115,-105,0.5097020142727117,0.49029798572728833,away,BAL,over,8,0.5348837209302326,-115,0.5097020142727117,TOR,BAL,2024 REG,9,3,6,2,5,15,1,0,1,-1,1,1,0,0,0,0,0,0,0,0.5097020142727117,0.49029798572728833
93232,0.5348837209302326,0.5121951219512195,-115,-105,0.5097020142727117,0.49029798572728833,home,TOR,under,8,0.5121951219512195,-105,0.49029798572728833,TOR,BAL,2024 REG,9,3,6,2,5,15,1,0,1,-1,1,1,0,0,0,0,0,0,0,0.5097020142727117,0.49029798572728833
93235,0.5555555555555556,0.48780487804878053,-125,105,0.5314664257753688,0.46853357422463116,away,TB,over,9,0.5073891625615764,-103,0.4826927225525911,NYY,TB,2024 REG,4,0,9,2,2,13,0,1,-2,2,0,0,0,0,0,0,0,0,0,0.4826927225525911,0.5173072774474089
93235,0.5555555555555556,0.48780487804878053,-125,105,0.5314664257753688,0.46853357422463116,home,NYY,under,9,0.5412844036697247,-118,0.5173072774474089,NYY,TB,2024 REG,4,0,9,2,2,13,0,1,-2,2,0,0,0,0,0,0,0,0,0,0.4826927225525911,0.5173072774474089
93238,0.5121951219512195,0.5348837209302326,-105,-115,0.48808156828023186,0.5119184317197681,away,ATL,over,9,0.5454545454545454,-120,0.5206611570247933,ARI,ATL,2024 REG,4,4,8,5,9,12,0,1,-1,1,1,1,1,1,0,0,0,0,0,0.5206611570247933,0.4793388429752067
93238,0.5121951219512195,0.5348837209302326,-105,-115,0.48808156828023186,0.5119184317197681,home,ARI,under,9,0.5,100,0.4793388429752067,ARI,ATL,2024 REG,4,4,8,5,9,12,0,1,-1,1,1,1,1,1,0,0,0,0,0,0.5206611570247933,0.4793388429752067
93240,0.48309178743961345,0.5555555555555556,107,-125,0.4644215734322854,0.5355784265677146,away,MIL,over,8.5,0.5238095238095238,-110,0.4988662131519274,BAL,MIL,2024 REG,6,1,15,11,12,21,0,1,-10,10,1,0,0,0,0,0,0,0,0,0.4988662131519274,0.5011337868480725
93240,0.48309178743961345,0.5555555555555556,107,-125,0.4644215734322854,0.5355784265677146,home,BAL,under,8.5,0.5238095238095238,-110,0.5011337868480725,BAL,MIL,2024 REG,6,1,15,11,12,21,0,1,-10,10,1,0,0,0,0,0,0,0,0,0.4988662131519274,0.5011337868480725
93244,0.7005988023952096,0.3424657534246575,-234,192,0.670427826162129,0.32957217383787096,away,CLE,over,9,0.5,100,0.4772727272727273,BAL,CLE,2024 REG,9,4,5,2,6,14,1,0,2,-2,1,1,0,0,0,0,0,0,0,0.4772727272727273,0.5227272727272727
93244,0.7005988023952096,0.3424657534246575,-234,192,0.670427826162129,0.32957217383787096,home,BAL,under,9,0.5454545454545454,-120,0.5227272727272727,BAL,CLE,2024 REG,9,4,5,2,6,14,1,0,2,-2,1,1,0,0,0,0,0,0,0,0.4772727272727273,0.5227272727272727
93247,0.5,0.5454545454545454,100,-120,0.4772727272727273,0.5227272727272727,away,CHC,over,9,0.5121951219512195,-105,0.48808156828023186,PIT,CHC,2024 REG,8,4,9,5,9,17,0,1,-1,1,1,1,1,1,0,0,0,0,0,0.48808156828023186,0.5119184317197681
93247,0.5,0.5454545454545454,100,-120,0.4772727272727273,0.5227272727272727,home,PIT,under,9,0.5348837209302326,-115,0.5119184317197681,PIT,CHC,2024 REG,8,4,9,5,9,17,0,1,-1,1,1,1,1,1,0,0,0,0,0,0.48808156828023186,0.5119184317197681
93249,0.5901639344262295,0.45248868778280543,-144,121,0.5649918950897499,0.4350081049102501,away,BAL,over,9,0.5,100,0.4762443438914027,NYY,BAL,2024 REG,6,4,8,2,6,14,1,0,2,-2,1,1,0,0,0,0,0,0,0,0.4762443438914027,0.5237556561085973
93249,0.5901639344262295,0.45248868778280543,-144,121,0.5649918950897499,0.4350081049102501,home,NYY,under,9,0.5475113122171946,-121,0.5237556561085973,NYY,BAL,2024 REG,6,4,8,2,6,14,1,0,2,-2,1,1,0,0,0,0,0,0,0,0.4762443438914027,0.5237556561085973
93250,0.574468085106383,0.46511627906976744,-135,115,0.5517281312179562,0.44827186878204384,away,CHC,over,8.5,0.5348837209302326,-115,0.5097020142727117,CIN,CHC,2024 REG,5,3,6,2,5,11,1,0,1,-1,1,1,0,0,0,0,0,0,0,0.5097020142727117,0.49029798572728833
93250,0.574468085106383,0.46511627906976744,-135,115,0.5517281312179562,0.44827186878204384,home,CIN,under,8.5,0.5121951219512195,-105,0.49029798572728833,CIN,CHC,2024 REG,5,3,6,2,5,11,1,0,1,-1,1,1,0,0,0,0,0,0,0,0.5097020142727117,0.49029798572728833
93254,0.607843137254902,0.4329004329004329,-155,131,0.583077437748718,0.416922562251282,away,CIN,over,8.5,0.5073891625615764,-103,0.48484779035144243,ARI,CIN,2024 REG,6,2,3,1,3,9,1,0,1,-1,1,0,0,0,0,0,0,0,0,0.48484779035144243,0.5151522096485576
93254,0.607843137254902,0.4329004329004329,-155,131,0.583077437748718,0.416922562251282,home,ARI,under,8.5,0.5370370370370371,-116,0.5151522096485576,ARI,CIN,2024 REG,6,2,3,1,3,9,1,0,1,-1,1,0,0,0,0,0,0,0,0,0.48484779035144243,0.5151522096485576
93255,0.5815899581589958,0.4608294930875576,-139,117,0.5569192312833853,0.4430807687166147,away,CWS,over,8,0.5121951219512195,-105,0.48919479393107135,MIA,CWS,2024 REG,7,2,10,3,5,17,0,1,-1,1,1,1,0,0,0,0,0,0,0,0.48919479393107135,0.5108052060689287
93255,0.5815899581589958,0.4608294930875576,-139,117,0.5569192312833853,0.4430807687166147,home,MIA,under,8,0.5327102803738317,-114,0.5108052060689287,MIA,CWS,2024 REG,7,2,10,3,5,17,0,1,-1,1,1,1,0,0,0,0,0,0,0,0.48919479393107135,0.5108052060689287
93257,0.5327102803738317,0.5098039215686274,-114,-104,0.5100625279371946,0.48993747206280536,away,SF,over,9.5,0.5,100,0.4772727272727273,CHC,SF,2024 REG,11,5,4,2,7,15,1,0,3,-3,1,1,0,0,0,0,0,0,0,0.4772727272727273,0.5227272727272727
93257,0.5327102803738317,0.5098039215686274,-114,-104,0.5100625279371946,0.48993747206280536,home,CHC,under,9.5,0.5454545454545454,-120,0.5227272727272727,CHC,SF,2024 REG,11,5,4,2,7,15,1,0,3,-3,1,1,0,0,0,0,0,0,0,0.4772727272727273,0.5227272727272727
93258,0.48780487804878053,0.5555555555555556,105,-125,0.4666534470222751,0.5333465529777248,away,WSH,over,7.5,0.5348837209302326,-115,0.5097020142727117,SD,WSH,2024 REG,9,9,9,7,16,18,1,0,2,-2,1,1,1,1,1,1,1,0,0,0.5097020142727117,0.49029798572728833
93258,0.48780487804878053,0.5555555555555556,105,-125,0.4666534470222751,0.5333465529777248,home,SD,under,7.5,0.5121951219512195,-105,0.49029798572728833,SD,WSH,2024 REG,9,9,9,7,16,18,1,0,2,-2,1,1,1,1,1,1,1,0,0,0.5097020142727117,0.49029798572728833
93259,0.47619047619047616,0.5652173913043479,110,-130,0.4564724440500838,0.5435275559499162,away,NYY,over,8,0.5370370370370371,-116,0.5118817074154765,TB,NYY,2024 REG,6,0,9,2,2,15,0,1,-2,2,0,0,0,0,0,0,0,0,0,0.5118817074154765,0.48811829258452355
93259,0.47619047619047616,0.5652173913043479,110,-130,0.4564724440500838,0.5435275559499162,home,TB,under,8,0.5098039215686274,-104,0.48811829258452355,TB,NYY,2024 REG,6,0,9,2,2,15,0,1,-2,2,0,0,0,0,0,0,0,0,0,0.5118817074154765,0.48811829258452355
93262,0.6183206106870228,0.42372881355932196,-162,136,0.5923205850079852,0.40767941499201477,away,COL,over,7,0.5412844036697247,-118,0.5162581740877563,PIT,COL,2024 REG,9,5,7,3,8,16,1,0,2,-2,1,1,1,0,0,0,0,0,0,0.5162581740877563,0.4837418259122437
93262,0.6183206106870228,0.42372881355932196,-162,136,0.5923205850079852,0.40767941499201477,home,PIT,under,7,0.504950495049505,-102,0.4837418259122437,PIT,COL,2024 REG,9,5,7,3,8,16,1,0,2,-2,1,1,1,0,0,0,0,0,0,0.5162581740877563,0.4837418259122437
93263,0.5967741935483871,0.4444444444444444,-148,125,0.5721759741010521,0.42782402589894786,away,TB,over,8,0.5283018867924528,-112,0.5031902949311281,BAL,TB,2024 REG,11,3,5,1,4,16,1,0,2,-2,1,0,0,0,0,0,0,0,0,0.5031902949311281,0.4968097050688719
93263,0.5967741935483871,0.4444444444444444,-148,125,0.5721759741010521,0.42782402589894786,home,BAL,under,8,0.5192307692307692,-108,0.4968097050688719,BAL,TB,2024 REG,11,3,5,1,4,16,1,0,2,-2,1,0,0,0,0,0,0,0,0,0.5031902949311281,0.4968097050688719
93264,0.6742671009771988,0.36764705882352944,-207,172,0.6460057619584667,0.3539942380415333,away,OAK,over,10.5,0.5238095238095238,-110,0.4988662131519274,BOS,OAK,2024 REG,13,12,13,9,21,26,1,0,3,-3,1,1,1,1,1,1,1,1,1,0.4988662131519274,0.5011337868480725
93264,0.6742671009771988,0.36764705882352944,-207,172,0.6460057619584667,0.3539942380415333,home,BOS,under,10.5,0.5238095238095238,-110,0.5011337868480725,BOS,OAK,2024 REG,13,12,13,9,21,26,1,0,3,-3,1,1,1,1,1,1,1,1,1,0.4988662131519274,0.5011337868480725
93265,0.5967741935483871,0.4444444444444444,-148,125,0.5721759741010521,0.42782402589894786,away,TOR,over,7.5,0.5238095238095238,-110,0.4988662131519274,TB,TOR,2024 REG,8,2,7,8,10,15,0,1,-6,6,1,1,0,0,0,0,0,0,0,0.4988662131519274,0.5011337868480725
93265,0.5967741935483871,0.4444444444444444,-148,125,0.5721759741010521,0.42782402589894786,home,TB,under,7.5,0.5238095238095238,-110,0.5011337868480725,TB,TOR,2024 REG,8,2,7,8,10,15,0,1,-6,6,1,1,0,0,0,0,0,0,0,0.4988662131519274,0.5011337868480725
93267,0.48780487804878053,0.5535714285714286,105,-124,0.4676213138438005,0.5323786861561994,away,MIN,over,9,0.5283018867924528,-112,0.5031902949311281,ARI,MIN,2024 REG,4,3,14,8,11,18,0,1,-5,5,1,1,1,0,0,0,0,0,0,0.5031902949311281,0.4968097050688719
93267,0.48780487804878053,0.5535714285714286,105,-124,0.4676213138438005,0.5323786861561994,home,ARI,under,9,0.5192307692307692,-108,0.4968097050688719,ARI,MIN,2024 REG,4,3,14,8,11,18,0,1,-5,5,1,1,1,0,0,0,0,0,0,0.5031902949311281,0.4968097050688719
93268,0.3846153846153846,0.6551724137931035,160,-190,0.3693123852275045,0.6306876147724956,away,PHI,over,8,0.5238095238095238,-110,0.4988662131519274,WSH,PHI,2024 REG,4,2,9,5,7,13,0,1,-3,3,1,1,0,0,0,0,0,0,0,0.4988662131519274,0.5011337868480725
93268,0.3846153846153846,0.6551724137931035,160,-190,0.3693123852275045,0.6306876147724956,home,WSH,under,8,0.5238095238095238,-110,0.5011337868480725,WSH,PHI,2024 REG,4,2,9,5,7,13,0,1,-3,3,1,1,0,0,0,0,0,0,0,0.4988662131519274,0.5011337868480725
93269,0.41152263374485604,0.6296296296296295,143,-170,0.39458754593642575,0.6054124540635742,away,HOU,over,9,0.504950495049505,-102,0.47949844489399435,WSH,HOU,2024 REG,11,6,4,0,6,15,1,0,6,-6,0,0,0,0,0,0,0,0,0,0.47949844489399435,0.5205015551060057
93269,0.41152263374485604,0.6296296296296295,143,-170,0.39458754593642575,0.6054124540635742,home,WSH,under,9,0.5454545454545454,-120,0.5205015551060057,WSH,HOU,2024 REG,11,6,4,0,6,15,1,0,6,-6,0,0,0,0,0,0,0,0,0,0.47949844489399435,0.5205015551060057
93271,0.5121951219512195,0.5305164319248826,-105,-113,0.4903184724049234,0.5096815275950766,away,BOS,over,8.5,0.5433789954337899,-119,0.5184560714286826,LAA,BOS,2024 REG,6,6,9,8,14,15,0,1,-2,2,1,1,1,1,1,1,0,0,0,0.5184560714286826,0.48154392857131745
93271,0.5121951219512195,0.5305164319248826,-105,-113,0.4903184724049234,0.5096815275950766,home,LAA,under,8.5,0.5024875621890548,-101,0.48154392857131745,LAA,BOS,2024 REG,6,6,9,8,14,15,0,1,-2,2,1,1,1,1,1,1,0,0,0,0.5184560714286826,0.48154392857131745
93272,0.5555555555555556,0.48780487804878053,-125,105,0.5314664257753688,0.46853357422463116,away,TOR,over,7.5,0.5283018867924528,-112,0.5044173060022736,SF,TOR,2024 REG,7,3,10,5,8,17,0,1,-2,2,1,1,1,0,0,0,0,0,0,0.5044173060022736,0.49558269399772636
93272,0.5555555555555556,0.48780487804878053,-125,105,0.5314664257753688,0.46853357422463116,home,SF,under,7.5,0.5169082125603864,-107,0.49558269399772636,SF,TOR,2024 REG,7,3,10,5,8,17,0,1,-2,2,1,1,1,0,0,0,0,0,0,0.5044173060022736,0.49558269399772636
93274,0.5652173913043479,0.47619047619047616,-130,110,0.5418129444594474,0.4581870555405526,away,ARI,over,8.5,0.5024875621890548,-101,0.47839724939301687,TEX,ARI,2024 REG,6,4,8,2,6,14,1,0,2,-2,1,1,0,0,0,0,0,0,0,0.47839724939301687,0.5216027506069831
93274,0.5652173913043479,0.47619047619047616,-130,110,0.5418129444594474,0.4581870555405526,home,TEX,under,8.5,0.5454545454545454,-120,0.5216027506069831,TEX,ARI,2024 REG,6,4,8,2,6,14,1,0,2,-2,1,1,0,0,0,0,0,0,0,0.47839724939301687,0.5216027506069831
93275,0.5798319327731092,0.4587155963302753,-138,118,0.557480844469466,0.442519155530534,away,PIT,over,8.5,0.5,100,0.4772727272727273,MIA,PIT,2024 REG,9,2,10,7,9,19,0,1,-5,5,1,1,0,0,0,0,0,0,0,0.4772727272727273,0.5227272727272727
93275,0.5798319327731092,0.4587155963302753,-138,118,0.557480844469466,0.442519155530534,home,MIA,under,8.5,0.5454545454545454,-120,0.5227272727272727,MIA,PIT,2024 REG,9,2,10,7,9,19,0,1,-5,5,1,1,0,0,0,0,0,0,0,0.4772727272727273,0.5227272727272727
93278,0.3921568627450981,0.6503496503496503,155,-186,0.3754876419236281,0.6245123580763718,away,LAD,over,8.5,0.5073891625615764,-103,0.4837652908580103,SF,LAD,2024 REG,9,2,13,10,12,22,0,1,-8,8,1,1,0,0,0,0,0,0,0,0.4837652908580103,0.5162347091419897
93278,0.3921568627450981,0.6503496503496503,155,-186,0.3754876419236281,0.6245123580763718,home,SF,under,8.5,0.5391705069124424,-117,0.5162347091419897,SF,LAD,2024 REG,9,2,13,10,12,22,0,1,-8,8,1,1,0,0,0,0,0,0,0,0.4837652908580103,0.5162347091419897
93282,0.6551724137931035,0.3846153846153846,-190,160,0.6291045458703008,0.37089545412969915,away,CLE,over,8.5,0.5370370370370371,-116,0.5131785224377817,TEX,CLE,2024 REG,7,4,6,0,4,13,1,0,4,-4,0,0,0,0,0,0,0,0,0,0.5131785224377817,0.4868214775622183
93282,0.6551724137931035,0.3846153846153846,-190,160,0.6291045458703008,0.37089545412969915,home,TEX,under,8.5,0.5073891625615764,-103,0.4868214775622183,TEX,CLE,2024 REG,7,4,6,0,4,13,1,0,4,-4,0,0,0,0,0,0,0,0,0,0.5131785224377817,0.4868214775622183
93283,0.5348837209302326,0.5121951219512195,-115,-105,0.5097020142727117,0.49029798572728833,away,TOR,over,8,0.5238095238095238,-110,0.4988662131519274,PHI,TOR,2024 REG,11,10,6,1,11,17,1,0,9,-9,1,0,0,0,0,0,0,0,0,0.4988662131519274,0.5011337868480725
93283,0.5348837209302326,0.5121951219512195,-115,-105,0.5097020142727117,0.49029798572728833,home,PHI,under,8,0.5238095238095238,-110,0.5011337868480725,PHI,TOR,2024 REG,11,10,6,1,11,17,1,0,9,-9,1,0,0,0,0,0,0,0,0,0.4988662131519274,0.5011337868480725
93285,0.41493775933609955,0.6254681647940076,141,-167,0.39817181571364846,0.6018281842863515,away,PHI,over,9,0.5121951219512195,-105,0.48808156828023186,DET,PHI,2024 REG,4,2,12,6,8,16,0,1,-4,4,1,1,0,0,0,0,0,0,0,0.48808156828023186,0.5119184317197681
93285,0.41493775933609955,0.6254681647940076,141,-167,0.39817181571364846,0.6018281842863515,home,DET,under,9,0.5348837209302326,-115,0.5119184317197681,DET,PHI,2024 REG,4,2,12,6,8,16,0,1,-4,4,1,1,0,0,0,0,0,0,0,0.48808156828023186,0.5119184317197681
93289,0.42016806722689076,0.6197718631178707,138,-163,0.4033865838887557,0.5966134161112443,away,PHI,over,9.5,0.5238095238095238,-110,0.5000596729920038,NYM,PHI,2024 REG,10,2,11,7,9,21,0,1,-5,5,1,1,0,0,0,0,0,0,0,0.5000596729920038,0.4999403270079962
93289,0.42016806722689076,0.6197718631178707,138,-163,0.4033865838887557,0.5966134161112443,home,NYM,under,9.5,0.5215311004784688,-109,0.4999403270079962,NYM,PHI,2024 REG,10,2,11,7,9,21,0,1,-5,5,1,1,0,0,0,0,0,0,0,0.5000596729920038,0.4999403270079962
93290,0.6677740863787376,0.37453183520599254,-201,167,0.6395232882440839,0.3604767117559161,away,CIN,over,8,0.5348837209302326,-115,0.5097020142727117,STL,CIN,2024 REG,8,4,13,9,13,21,0,1,-5,5,1,1,1,1,0,0,0,0,0,0.5097020142727117,0.49029798572728833
93290,0.6677740863787376,0.37453183520599254,-201,167,0.6395232882440839,0.3604767117559161,home,STL,under,8,0.5121951219512195,-105,0.49029798572728833,STL,CIN,2024 REG,8,4,13,9,13,21,0,1,-5,5,1,1,1,1,0,0,0,0,0,0.5097020142727117,0.49029798572728833
93292,0.36363636363636365,0.6774193548387096,175,-210,0.3487070114636097,0.6512929885363903,away,LAD,over,9,0.5238095238095238,-110,0.4988662131519274,CIN,LAD,2024 REG,8,4,5,1,5,13,1,0,3,-3,1,0,0,0,0,0,0,0,0,0.4988662131519274,0.5011337868480725
93292,0.36363636363636365,0.6774193548387096,175,-210,0.3487070114636097,0.6512929885363903,home,CIN,under,9,0.5238095238095238,-110,0.5011337868480725,CIN,LAD,2024 REG,8,4,5,1,5,13,1,0,3,-3,1,0,0,0,0,0,0,0,0,0.4988662131519274,0.5011337868480725
93293,0.42194092827004215,0.6183206106870228,137,-162,0.4049529371489177,0.5950470628510822,away,HOU,over,8.5,0.5145631067961165,-106,0.49023796582517226,LAA,HOU,2024 REG,4,1,11,7,8,15,0,1,-6,6,1,0,0,0,0,0,0,0,0,0.49023796582517226,0.5097620341748277
93293,0.42194092827004215,0.6183206106870228,137,-162,0.4049529371489177,0.5950470628510822,home,LAA,under,8.5,0.5327102803738317,-114,0.5097620341748277,LAA,HOU,2024 REG,4,1,11,7,8,15,0,1,-6,6,1,0,0,0,0,0,0,0,0,0.49023796582517226,0.5097620341748277
93294,0.4,0.6428571428571428,150,-180,0.38285714285714295,0.617142857142857,away,SD,over,10.5,0.5348837209302326,-115,0.5097020142727117,COL,SD,2024 REG,4,1,9,3,4,13,0,1,-2,2,1,0,0,0,0,0,0,0,0,0.5097020142727117,0.49029798572728833
93294,0.4,0.6428571428571428,150,-180,0.38285714285714295,0.617142857142857,home,COL,under,10.5,0.5121951219512195,-105,0.49029798572728833,COL,SD,2024 REG,4,1,9,3,4,13,0,1,-2,2,1,0,0,0,0,0,0,0,0,0.5097020142727117,0.49029798572728833
93298,0.5454545454545454,0.49751243781094534,-120,101,0.5220180091279142,0.4779819908720858,away,CLE,over,7.5,0.5121951219512195,-105,0.48808156828023186,TOR,CLE,2024 REG,11,7,13,6,13,24,1,0,1,-1,1,1,1,1,1,1,0,0,0,0.48808156828023186,0.5119184317197681
93298,0.5454545454545454,0.49751243781094534,-120,101,0.5220180091279142,0.4779819908720858,home,TOR,under,7.5,0.5348837209302326,-115,0.5119184317197681,TOR,CLE,2024 REG,11,7,13,6,13,24,1,0,1,-1,1,1,1,1,1,1,0,0,0,0.48808156828023186,0.5119184317197681
93299,0.6389891696750902,0.40485829959514175,-177,147,0.6109711116937506,0.3890288883062494,away,MIA,over,9,0.5348837209302326,-115,0.5097020142727117,CIN,MIA,2024 REG,11,7,11,4,11,22,1,0,3,-3,1,1,1,1,0,0,0,0,0,0.5097020142727117,0.49029798572728833
93299,0.6389891696750902,0.40485829959514175,-177,147,0.6109711116937506,0.3890288883062494,home,CIN,under,9,0.5121951219512195,-105,0.49029798572728833,CIN,MIA,2024 REG,11,7,11,4,11,22,1,0,3,-3,1,1,1,1,0,0,0,0,0,0.5097020142727117,0.49029798572728833
93300,0.44052863436123346,0.6000000000000001,127,-150,0.42267461041355353,0.5773253895864465,away,HOU,over,8,0.5348837209302326,-115,0.5097020142727117,WSH,HOU,2024 REG,8,3,13,5,8,21,0,1,-2,2,1,1,1,0,0,0,0,0,0,0.5097020142727117,0.49029798572728833
93300,0.44052863436123346,0.6000000000000001,127,-150,0.42267461041355353,0.5773253895864465,home,WSH,under,8,0.5121951219512195,-105,0.49029798572728833,WSH,HOU,2024 REG,8,3,13,5,8,21,0,1,-2,2,1,1,1,0,0,0,0,0,0,0.5097020142727117,0.49029798572728833
93301,0.5555555555555556,0.48780487804878053,-125,105,0.5314664257753688,0.46853357422463116,away,CHC,over,9,0.5121951219512195,-105,0.48808156828023186,CIN,CHC,2024 REG,6,4,10,3,7,16,1,0,1,-1,1,1,1,0,0,0,0,0,0,0.48808156828023186,0.5119184317197681
93301,0.5555555555555556,0.48780487804878053,-125,105,0.5314664257753688,0.46853357422463116,home,CIN,under,9,0.5348837209302326,-115,0.5119184317197681,CIN,CHC,2024 REG,6,4,10,3,7,16,1,0,1,-1,1,1,1,0,0,0,0,0,0,0.48808156828023186,0.5119184317197681
93302,0.5475113122171946,0.49504950495049505,-121,102,0.5242087833606768,0.4757912166393232,away,SD,over,9,0.5024875621890548,-101,0.47839724939301687,ATL,SD,2024 REG,4,1,14,9,10,18,0,1,-8,8,1,0,0,0,0,0,0,0,0,0.47839724939301687,0.5216027506069831
93302,0.5475113122171946,0.49504950495049505,-121,102,0.5242087833606768,0.4757912166393232,home,ATL,under,9,0.5454545454545454,-120,0.5216027506069831,ATL,SD,2024 REG,4,1,14,9,10,18,0,1,-8,8,1,0,0,0,0,0,0,0,0,0.47839724939301687,0.5216027506069831
93303,0.5652173913043479,0.47619047619047616,-130,110,0.5418129444594474,0.4581870555405526,away,BOS,over,8.5,0.5348837209302326,-115,0.5097020142727117,NYY,BOS,2024 REG,4,0,6,3,3,10,0,1,-3,3,0,0,0,0,0,0,0,0,0,0.5097020142727117,0.49029798572728833
93303,0.5652173913043479,0.47619047619047616,-130,110,0.5418129444594474,0.4581870555405526,home,NYY,under,8.5,0.5121951219512195,-105,0.49029798572728833,NYY,BOS,2024 REG,4,0,6,3,3,10,0,1,-3,3,0,0,0,0,0,0,0,0,0,0.5097020142727117,0.49029798572728833
93306,0.5238095238095238,0.5215311004784688,-110,-109,0.5000596729920038,0.4999403270079962,away,BAL,over,9,0.5073891625615764,-103,0.48484779035144243,KC,BAL,2024 REG,5,0,11,5,5,16,0,1,-5,5,0,0,0,0,0,0,0,0,0,0.48484779035144243,0.5151522096485576
93306,0.5238095238095238,0.5215311004784688,-110,-109,0.5000596729920038,0.4999403270079962,home,KC,under,9,0.5370370370370371,-116,0.5151522096485576,KC,BAL,2024 REG,5,0,11,5,5,16,0,1,-5,5,0,0,0,0,0,0,0,0,0,0.48484779035144243,0.5151522096485576
93311,0.5934959349593496,0.4464285714285714,-146,124,0.5698009027128599,0.4301990972871401,away,PIT,over,8.5,0.5192307692307692,-108,0.49571111079951763,MIA,PIT,2024 REG,7,7,11,9,16,18,0,1,-2,2,1,1,1,1,1,1,1,0,0,0.49571111079951763,0.5042888892004824
93311,0.5934959349593496,0.4464285714285714,-146,124,0.5698009027128599,0.4301990972871401,home,MIA,under,8.5,0.5260663507109005,-111,0.5042888892004824,MIA,PIT,2024 REG,7,7,11,9,16,18,0,1,-2,2,1,1,1,1,1,1,1,0,0,0.49571111079951763,0.5042888892004824
93312,0.390625,0.6515679442508712,156,-187,0.3741433811520034,0.6258566188479966,away,ATL,over,7.5,0.48780487804878053,105,0.4666534470222751,SEA,ATL,2024 REG,10,2,6,5,7,16,0,1,-3,3,1,1,0,0,0,0,0,0,0,0.4666534470222751,0.5333465529777248
93312,0.390625,0.6515679442508712,156,-187,0.3741433811520034,0.6258566188479966,home,SEA,under,7.5,0.5555555555555556,-125,0.5333465529777248,SEA,ATL,2024 REG,10,2,6,5,7,16,0,1,-3,3,1,1,0,0,0,0,0,0,0,0.4666534470222751,0.5333465529777248
93313,0.5833333333333333,0.45454545454545453,-140,120,0.5612373737373737,0.4387626262626263,away,ARI,over,8.5,0.5454545454545454,-120,0.5206611570247933,STL,ARI,2024 REG,6,1,15,14,15,21,0,1,-13,13,1,0,0,0,0,0,0,0,0,0.5206611570247933,0.4793388429752067
93313,0.5833333333333333,0.45454545454545453,-140,120,0.5612373737373737,0.4387626262626263,home,STL,under,8.5,0.5,100,0.4793388429752067,STL,ARI,2024 REG,6,1,15,14,15,21,0,1,-13,13,1,0,0,0,0,0,0,0,0,0.5206611570247933,0.4793388429752067
93314,0.47619047619047616,0.5652173913043479,110,-130,0.4564724440500838,0.5435275559499162,away,NYY,over,9,0.5121951219512195,-105,0.48808156828023186,BAL,NYY,2024 REG,6,1,7,4,5,13,0,1,-3,3,1,0,0,0,0,0,0,0,0,0.48808156828023186,0.5119184317197681
93314,0.47619047619047616,0.5652173913043479,110,-130,0.4564724440500838,0.5435275559499162,home,BAL,under,9,0.5348837209302326,-115,0.5119184317197681,BAL,NYY,2024 REG,6,1,7,4,5,13,0,1,-3,3,1,0,0,0,0,0,0,0,0,0.48808156828023186,0.5119184317197681
93316,0.6108949416342413,0.425531914893617,-157,135,0.5886419592417365,0.41135804075826354,away,PIT,over,8.5,0.5260663507109005,-111,0.5010269332605688,PHI,PIT,2024 REG,9,4,5,3,7,14,1,0,1,-1,1,1,1,0,0,0,0,0,0,0.5010269332605688,0.4989730667394312
93316,0.6108949416342413,0.425531914893617,-157,135,0.5886419592417365,0.41135804075826354,home,PHI,under,8.5,0.5215311004784688,-109,0.4989730667394312,PHI,PIT,2024 REG,9,4,5,3,7,14,1,0,1,-1,1,1,1,0,0,0,0,0,0,0.5010269332605688,0.4989730667394312
93317,0.3846153846153846,0.6563573883161512,160,-191,0.36885662579556316,0.6311433742044368,away,LAD,over,8,0.5121951219512195,-105,0.48808156828023186,PIT,LAD,2024 REG,4,1,5,0,1,9,1,0,1,-1,0,0,0,0,0,0,0,0,0,0.48808156828023186,0.5119184317197681
93317,0.3846153846153846,0.6563573883161512,160,-191,0.36885662579556316,0.6311433742044368,home,PIT,under,8,0.5348837209302326,-115,0.5119184317197681,PIT,LAD,2024 REG,4,1,5,0,1,9,1,0,1,-1,0,0,0,0,0,0,0,0,0,0.48808156828023186,0.5119184317197681
93320,0.5555555555555556,0.48780487804878053,-125,105,0.5314664257753688,0.46853357422463116,away,BOS,over,7,0.5391705069124424,-117,0.5127649394825569,TB,BOS,2024 REG,3,0,7,5,5,10,0,1,-5,5,0,0,0,0,0,0,0,0,0,0.5127649394825569,0.48723506051744314
93320,0.5555555555555556,0.48780487804878053,-125,105,0.5314664257753688,0.46853357422463116,home,TB,under,7,0.5098039215686274,-104,0.48723506051744314,TB,BOS,2024 REG,3,0,7,5,5,10,0,1,-5,5,0,0,0,0,0,0,0,0,0,0.5127649394825569,0.48723506051744314
93323,0.5215311004784688,0.5238095238095238,-109,-110,0.4978845547971712,0.5021154452028288,away,ATL,over,7.5,0.5283018867924528,-112,0.5031902949311281,NYY,ATL,2024 REG,3,1,14,8,9,17,0,1,-7,7,1,0,0,0,0,0,0,0,0,0.5031902949311281,0.4968097050688719
93323,0.5215311004784688,0.5238095238095238,-109,-110,0.4978845547971712,0.5021154452028288,home,NYY,under,7.5,0.5192307692307692,-108,0.4968097050688719,NYY,ATL,2024 REG,3,1,14,8,9,17,0,1,-7,7,1,0,0,0,0,0,0,0,0,0.5031902949311281,0.4968097050688719
93324,0.5121951219512195,0.5283018867924528,-105,-112,0.49145275161909474,0.5085472483809053,away,HOU,over,8.5,0.5024875621890548,-101,0.4794401874631478,TOR,HOU,2024 REG,10,3,9,5,8,19,0,1,-2,2,1,1,1,0,0,0,0,0,0,0.4794401874631478,0.5205598125368522
93324,0.5121951219512195,0.5283018867924528,-105,-112,0.49145275161909474,0.5085472483809053,home,TOR,under,8.5,0.5433789954337899,-119,0.5205598125368522,TOR,HOU,2024 REG,10,3,9,5,8,19,0,1,-2,2,1,1,1,0,0,0,0,0,0,0.4794401874631478,0.5205598125368522
93326,0.7777777777777779,0.26666666666666666,-350,275,0.7432098765432099,0.2567901234567901,away,CWS,over,7.5,0.5348837209302326,-115,0.5097020142727117,MIL,CWS,2024 REG,9,6,5,3,9,14,1,0,3,-3,1,1,1,0,0,0,0,0,0,0.5097020142727117,0.49029798572728833
93326,0.7777777777777779,0.26666666666666666,-350,275,0.7432098765432099,0.2567901234567901,home,MIL,under,7.5,0.5121951219512195,-105,0.49029798572728833,MIL,CWS,2024 REG,9,6,5,3,9,14,1,0,3,-3,1,1,1,0,0,0,0,0,0,0.5097020142727117,0.49029798572728833
93328,0.42372881355932196,0.6183206106870228,136,-162,0.40591126091256574,0.5940887390874343,away,MIN,over,8,0.5305164319248826,-113,0.5053568787472517,CWS,MIN,2024 REG,4,3,6,1,4,10,1,0,2,-2,1,0,0,0,0,0,0,0,0,0.5053568787472517,0.49464312125274834
93328,0.42372881355932196,0.6183206106870228,136,-162,0.40591126091256574,0.5940887390874343,home,CWS,under,8,0.5169082125603864,-107,0.49464312125274834,CWS,MIN,2024 REG,4,3,6,1,4,10,1,0,2,-2,1,0,0,0,0,0,0,0,0,0.5053568787472517,0.49464312125274834
93330,0.6296296296296295,0.4098360655737705,-170,144,0.6047808585756369,0.3952191414243631,away,KC,over,7.5,0.5370370370370371,-116,0.5118817074154765,MIN,KC,2024 REG,7,6,10,5,11,17,1,0,1,-1,1,1,1,1,1,0,0,0,0,0.5118817074154765,0.48811829258452355
93330,0.6296296296296295,0.4098360655737705,-170,144,0.6047808585756369,0.3952191414243631,home,MIN,under,7.5,0.5098039215686274,-104,0.48811829258452355,MIN,KC,2024 REG,7,6,10,5,11,17,1,0,1,-1,1,1,1,1,1,0,0,0,0,0.5118817074154765,0.48811829258452355
93332,0.5169082125603864,0.5260663507109005,-107,-111,0.4946943078742622,0.5053056921257377,away,MIN,over,8.5,0.5454545454545454,-120,0.5206611570247933,MIL,MIN,2024 REG,7,3,11,7,10,18,0,1,-4,4,1,1,1,0,0,0,0,0,0,0.5206611570247933,0.4793388429752067
93332,0.5169082125603864,0.5260663507109005,-107,-111,0.4946943078742622,0.5053056921257377,home,MIL,under,8.5,0.5,100,0.4793388429752067,MIL,MIN,2024 REG,7,3,11,7,10,18,0,1,-4,4,1,1,1,0,0,0,0,0,0,0.5206611570247933,0.4793388429752067
93333,0.607843137254902,0.4347826086956522,-155,130,0.5819333701084867,0.41806662989151333,away,STL,over,8.5,0.504950495049505,-102,0.47949844489399435,HOU,STL,2024 REG,5,2,5,4,6,10,0,1,-2,2,1,1,0,0,0,0,0,0,0,0.47949844489399435,0.5205015551060057
93333,0.607843137254902,0.4347826086956522,-155,130,0.5819333701084867,0.41806662989151333,home,HOU,under,8.5,0.5454545454545454,-120,0.5205015551060057,HOU,STL,2024 REG,5,2,5,4,6,10,0,1,-2,2,1,1,0,0,0,0,0,0,0,0.47949844489399435,0.5205015551060057
93335,0.6428571428571428,0.4,-180,150,0.6153061224489796,0.38469387755102036,away,CWS,over,8,0.5192307692307692,-108,0.49455035168025013,MIL,CWS,2024 REG,23,12,9,5,17,32,1,0,7,-7,1,1,1,1,1,0,0,0,0,0.49455035168025013,0.5054496483197499
93335,0.6428571428571428,0.4,-180,150,0.6153061224489796,0.38469387755102036,home,MIL,under,8,0.5283018867924528,-112,0.5054496483197499,MIL,CWS,2024 REG,23,12,9,5,17,32,1,0,7,-7,1,1,1,1,1,0,0,0,0,0.49455035168025013,0.5054496483197499
93336,0.6894409937888198,0.35460992907801414,-222,182,0.6590704817501952,0.3409295182498048,away,MIA,over,8.5,0.5073891625615764,-103,0.4826927225525911,CHC,MIA,2024 REG,7,5,8,3,8,15,1,0,2,-2,1,1,1,0,0,0,0,0,0,0.4826927225525911,0.5173072774474089
93336,0.6894409937888198,0.35460992907801414,-222,182,0.6590704817501952,0.3409295182498048,home,CHC,under,8.5,0.5412844036697247,-118,0.5173072774474089,CHC,MIA,2024 REG,7,5,8,3,8,15,1,0,2,-2,1,1,1,0,0,0,0,0,0,0.4826927225525911,0.5173072774474089
93337,0.574468085106383,0.4672897196261683,-135,114,0.550479558983428,0.44952044101657196,away,CHC,over,8.5,0.5348837209302326,-115,0.5097020142727117,STL,CHC,2024 REG,13,11,7,3,14,20,1,0,8,-8,1,1,1,0,0,0,0,0,0,0.5097020142727117,0.49029798572728833
93337,0.574468085106383,0.4672897196261683,-135,114,0.550479558983428,0.44952044101657196,home,STL,under,8.5,0.5121951219512195,-105,0.49029798572728833,STL,CHC,2024 REG,13,11,7,3,14,20,1,0,8,-8,1,1,1,0,0,0,0,0,0,0.5097020142727117,0.49029798572728833
93339,0.5884773662551441,0.4504504504504505,-143,122,0.5655692272061728,0.43443077279382725,away,COL,over,9,0.5,100,0.4772727272727273,MIA,COL,2024 REG,7,4,4,1,5,11,1,0,3,-3,1,0,0,0,0,0,0,0,0,0.4772727272727273,0.5227272727272727
93339,0.5884773662551441,0.4504504504504505,-143,122,0.5655692272061728,0.43443077279382725,home,MIA,under,9,0.5454545454545454,-120,0.5227272727272727,MIA,COL,2024 REG,7,4,4,1,5,11,1,0,3,-3,1,0,0,0,0,0,0,0,0,0.4772727272727273,0.5227272727272727
93340,0.5348837209302326,0.5073891625615764,-115,-103,0.5122726437136835,0.48772735628631647,away,LAD,over,8.5,0.5555555555555556,-125,0.5301379811183733,NYY,LAD,2024 REG,10,3,11,11,14,21,0,1,-8,8,1,1,1,0,0,0,0,0,0,0.5301379811183733,0.4698620188816267
93340,0.5348837209302326,0.5073891625615764,-115,-103,0.5122726437136835,0.48772735628631647,home,NYY,under,8.5,0.49019607843137253,104,0.4698620188816267,NYY,LAD,2024 REG,10,3,11,11,14,21,0,1,-8,8,1,1,1,0,0,0,0,0,0,0.5301379811183733,0.4698620188816267
93341,0.5867768595041323,0.45454545454545453,-142,120,0.5625298818386723,0.43747011816132775,away,CHC,over,8,0.5145631067961165,-106,0.49023796582517226,SD,CHC,2024 REG,4,1,9,5,6,13,0,1,-4,4,1,0,0,0,0,0,0,0,0,0.49023796582517226,0.5097620341748277
93341,0.5867768595041323,0.45454545454545453,-142,120,0.5625298818386723,0.43747011816132775,home,SD,under,8,0.5327102803738317,-114,0.5097620341748277,SD,CHC,2024 REG,4,1,9,5,6,13,0,1,-4,4,1,0,0,0,0,0,0,0,0,0.49023796582517226,0.5097620341748277
93342,0.726027397260274,0.31545741324921134,-265,217,0.6959082882602367,0.30409171173976335,away,KC,over,8,0.5238095238095238,-110,0.4988662131519274,LAD,KC,2024 REG,5,3,3,0,3,8,1,0,3,-3,0,0,0,0,0,0,0,0,0,0.4988662131519274,0.5011337868480725
93342,0.726027397260274,0.31545741324921134,-265,217,0.6959082882602367,0.30409171173976335,home,LAD,under,8,0.5238095238095238,-110,0.5011337868480725,LAD,KC,2024 REG,5,3,3,0,3,8,1,0,3,-3,0,0,0,0,0,0,0,0,0,0.4988662131519274,0.5011337868480725
93343,0.5726495726495727,0.4672897196261683,-134,114,0.5497783539959433,0.4502216460040567,away,MIA,over,9,0.5121951219512195,-105,0.48808156828023186,ARI,MIA,2024 REG,6,1,9,3,4,15,0,1,-2,2,1,0,0,0,0,0,0,0,0,0.48808156828023186,0.5119184317197681
93343,0.5726495726495727,0.4672897196261683,-134,114,0.5497783539959433,0.4502216460040567,home,ARI,under,9,0.5348837209302326,-115,0.5119184317197681,ARI,MIA,2024 REG,6,1,9,3,4,15,0,1,-2,2,1,0,0,0,0,0,0,0,0,0.48808156828023186,0.5119184317197681
93344,0.5833333333333333,0.45454545454545453,-140,120,0.5612373737373737,0.4387626262626263,away,OAK,over,9,0.5145631067961165,-106,0.49023796582517226,LAA,OAK,2024 REG,8,5,6,1,6,14,1,0,4,-4,1,0,0,0,0,0,0,0,0,0.49023796582517226,0.5097620341748277
93344,0.5833333333333333,0.45454545454545453,-140,120,0.5612373737373737,0.4387626262626263,home,LAA,under,9,0.5327102803738317,-114,0.5097620341748277,LAA,OAK,2024 REG,8,5,6,1,6,14,1,0,4,-4,1,0,0,0,0,0,0,0,0,0.49023796582517226,0.5097620341748277
93345,0.35714285714285715,0.6835443037974683,180,-216,0.34261172823559805,0.657388271764402,away,MIN,over,8,0.5283018867924528,-112,0.5031902949311281,CWS,MIN,2024 REG,4,2,5,3,5,9,0,1,-1,1,1,1,0,0,0,0,0,0,0,0.5031902949311281,0.4968097050688719
93345,0.35714285714285715,0.6835443037974683,180,-216,0.34261172823559805,0.657388271764402,home,CWS,under,8,0.5192307692307692,-108,0.4968097050688719,CWS,MIN,2024 REG,4,2,5,3,5,9,0,1,-1,1,1,1,0,0,0,0,0,0,0,0.5031902949311281,0.4968097050688719
93349,0.373134328358209,0.6677740863787376,168,-201,0.3578699945011394,0.6421300054988606,away,TOR,over,8.5,0.5,100,0.4772727272727273,CWS,TOR,2024 REG,4,1,7,3,4,11,0,1,-2,2,1,0,0,0,0,0,0,0,0,0.4772727272727273,0.5227272727272727
93349,0.373134328358209,0.6677740863787376,168,-201,0.3578699945011394,0.6421300054988606,home,CWS,under,8.5,0.5454545454545454,-120,0.5227272727272727,CWS,TOR,2024 REG,4,1,7,3,4,11,0,1,-2,2,1,0,0,0,0,0,0,0,0,0.4772727272727273,0.5227272727272727
93351,0.4347826086956522,0.607843137254902,130,-155,0.41624967567367205,0.583750324326328,away,STL,over,7,0.5412844036697247,-118,0.5162581740877563,MIA,STL,2024 REG,8,6,10,7,13,18,0,1,-1,1,1,1,1,1,1,1,0,0,0,0.5162581740877563,0.4837418259122437
93351,0.4347826086956522,0.607843137254902,130,-155,0.41624967567367205,0.583750324326328,home,MIA,under,7,0.504950495049505,-102,0.4837418259122437,MIA,STL,2024 REG,8,6,10,7,13,18,0,1,-1,1,1,1,1,1,1,1,0,0,0,0.5162581740877563,0.4837418259122437
93352,0.607843137254902,0.4347826086956522,-155,130,0.5819333701084867,0.41806662989151333,away,WSH,over,9.5,0.5238095238095238,-110,0.4988662131519274,CIN,WSH,2024 REG,10,8,6,2,10,16,1,0,6,-6,1,1,0,0,0,0,0,0,0,0.4988662131519274,0.5011337868480725
93352,0.607843137254902,0.4347826086956522,-155,130,0.5819333701084867,0.41806662989151333,home,CIN,under,9.5,0.5238095238095238,-110,0.5011337868480725,CIN,WSH,2024 REG,10,8,6,2,10,16,1,0,6,-6,1,1,0,0,0,0,0,0,0,0.4988662131519274,0.5011337868480725
93353,0.4016064257028112,0.6402877697841727,149,-178,0.3847814475955888,0.6152185524044111,away,PHI,over,8,0.5145631067961165,-106,0.49023796582517226,CIN,PHI,2024 REG,3,0,11,5,5,14,0,1,-5,5,0,0,0,0,0,0,0,0,0,0.49023796582517226,0.5097620341748277
93353,0.4016064257028112,0.6402877697841727,149,-178,0.3847814475955888,0.6152185524044111,home,CIN,under,8,0.5327102803738317,-114,0.5097620341748277,CIN,PHI,2024 REG,3,0,11,5,5,14,0,1,-5,5,0,0,0,0,0,0,0,0,0,0.49023796582517226,0.5097620341748277
93355,0.5327102803738317,0.5121951219512195,-114,-105,0.508788710910954,0.491211289089046,away,TOR,over,7.5,0.5260663507109005,-111,0.5010269332605688,DET,TOR,2024 REG,5,1,13,9,10,18,0,1,-8,8,1,0,0,0,0,0,0,0,0,0.5010269332605688,0.4989730667394312
93355,0.5327102803738317,0.5121951219512195,-114,-105,0.508788710910954,0.491211289089046,home,DET,under,7.5,0.5215311004784688,-109,0.4989730667394312,DET,TOR,2024 REG,5,1,13,9,10,18,0,1,-8,8,1,0,0,0,0,0,0,0,0,0.5010269332605688,0.4989730667394312
93357,0.574468085106383,0.46511627906976744,-135,115,0.5517281312179562,0.44827186878204384,away,WSH,over,8,0.5238095238095238,-110,0.4988662131519274,CLE,WSH,2024 REG,6,2,8,5,7,14,0,1,-3,3,1,1,0,0,0,0,0,0,0,0.4988662131519274,0.5011337868480725
93357,0.574468085106383,0.46511627906976744,-135,115,0.5517281312179562,0.44827186878204384,home,CLE,under,8,0.5238095238095238,-110,0.5011337868480725,CLE,WSH,2024 REG,6,2,8,5,7,14,0,1,-3,3,1,1,0,0,0,0,0,0,0,0.4988662131519274,0.5011337868480725
93359,0.5454545454545454,0.49504950495049505,-120,102,0.5233614270517961,0.4766385729482039,away,TOR,over,7.5,0.49504950495049505,102,0.47097973588023584,NYY,TOR,2024 REG,10,9,12,8,17,22,1,0,1,-1,1,1,1,1,1,1,1,1,0,0.47097973588023584,0.5290202641197641
93359,0.5454545454545454,0.49504950495049505,-120,102,0.5233614270517961,0.4766385729482039,home,NYY,under,7.5,0.5535714285714286,-124,0.5290202641197641,NYY,TOR,2024 REG,10,9,12,8,17,22,1,0,1,-1,1,1,1,1,1,1,1,1,0,0.47097973588023584,0.5290202641197641
93360,0.4464285714285714,0.5967741935483871,124,-148,0.42714162277814344,0.5728583772218565,away,LAD,over,9.5,0.5,100,0.4772727272727273,SD,LAD,2024 REG,6,0,5,5,5,11,0,1,-5,5,0,0,0,0,0,0,0,0,0,0.4772727272727273,0.5227272727272727
93360,0.4464285714285714,0.5967741935483871,124,-148,0.42714162277814344,0.5728583772218565,home,SD,under,9.5,0.5454545454545454,-120,0.5227272727272727,SD,LAD,2024 REG,6,0,5,5,5,11,0,1,-5,5,0,0,0,0,0,0,0,0,0,0.4772727272727273,0.5227272727272727
93361,0.5283018867924528,0.5145631067961165,-112,-106,0.5056562298022652,0.4943437701977348,away,KC,over,8,0.5348837209302326,-115,0.5097020142727117,DET,KC,2024 REG,8,6,9,5,11,17,1,0,1,-1,1,1,1,1,1,0,0,0,0,0.5097020142727117,0.49029798572728833
93361,0.5283018867924528,0.5145631067961165,-112,-106,0.5056562298022652,0.4943437701977348,home,DET,under,8,0.5121951219512195,-105,0.49029798572728833,DET,KC,2024 REG,8,6,9,5,11,17,1,0,1,-1,1,1,1,1,1,0,0,0,0,0.5097020142727117,0.49029798572728833
93363,0.613899613899614,0.425531914893617,-159,135,0.589692613597978,0.410307386402022,away,CHC,over,8,0.5454545454545454,-120,0.5206611570247933,SD,CHC,2024 REG,12,10,3,2,12,15,1,0,8,-8,1,1,0,0,0,0,0,0,0,0.5206611570247933,0.4793388429752067
93363,0.613899613899614,0.425531914893617,-159,135,0.589692613597978,0.410307386402022,home,SD,under,8,0.5,100,0.4793388429752067,SD,CHC,2024 REG,12,10,3,2,12,15,1,0,8,-8,1,1,0,0,0,0,0,0,0,0.5206611570247933,0.4793388429752067
93364,0.4,0.6428571428571428,150,-180,0.38285714285714295,0.617142857142857,away,PHI,over,8.5,0.5073891625615764,-103,0.4826927225525911,DET,PHI,2024 REG,7,1,15,8,9,22,0,1,-7,7,1,0,0,0,0,0,0,0,0,0.4826927225525911,0.5173072774474089
93364,0.4,0.6428571428571428,150,-180,0.38285714285714295,0.617142857142857,home,DET,under,8.5,0.5412844036697247,-118,0.5173072774474089,DET,PHI,2024 REG,7,1,15,8,9,22,0,1,-7,7,1,0,0,0,0,0,0,0,0,0.4826927225525911,0.5173072774474089
93368,0.646643109540636,0.39370078740157477,-183,154,0.6205550065709379,0.3794449934290621,away,DET,over,8,0.5145631067961165,-106,0.49023796582517226,MIN,DET,2024 REG,14,12,7,3,15,21,1,0,9,-9,1,1,1,0,0,0,0,0,0,0.49023796582517226,0.5097620341748277
93368,0.646643109540636,0.39370078740157477,-183,154,0.6205550065709379,0.3794449934290621,home,MIN,under,8,0.5327102803738317,-114,0.5097620341748277,MIN,DET,2024 REG,14,12,7,3,15,21,1,0,9,-9,1,1,1,0,0,0,0,0,0,0.49023796582517226,0.5097620341748277
93369,0.44052863436123346,0.6000000000000001,127,-150,0.42267461041355353,0.5773253895864465,away,CLE,over,8,0.5121951219512195,-105,0.48808156828023186,LAA,CLE,2024 REG,8,3,6,4,7,14,0,1,-1,1,1,1,1,0,0,0,0,0,0,0.48808156828023186,0.5119184317197681
93369,0.44052863436123346,0.6000000000000001,127,-150,0.42267461041355353,0.5773253895864465,home,LAA,under,8,0.5348837209302326,-115,0.5119184317197681,LAA,CLE,2024 REG,8,3,6,4,7,14,0,1,-1,1,1,1,1,0,0,0,0,0,0,0.48808156828023186,0.5119184317197681
93372,0.6226415094339623,0.4166666666666667,-165,140,0.5981666073335706,0.40183339266642937,away,LAA,over,7,0.5348837209302326,-115,0.5097020142727117,SEA,LAA,2024 REG,9,9,6,0,9,15,1,0,9,-9,0,0,0,0,0,0,0,0,0,0.5097020142727117,0.49029798572728833
93372,0.6226415094339623,0.4166666666666667,-165,140,0.5981666073335706,0.40183339266642937,home,SEA,under,7,0.5121951219512195,-105,0.49029798572728833,SEA,LAA,2024 REG,9,9,6,0,9,15,1,0,9,-9,0,0,0,0,0,0,0,0,0,0.5097020142727117,0.49029798572728833
93377,0.5145631067961165,0.5238095238095238,-106,-110,0.4948179667757384,0.5051820332242616,away,CLE,over,8.5,0.5238095238095238,-110,0.4988662131519274,BOS,CLE,2024 REG,6,4,8,5,9,14,0,1,-1,1,1,1,1,1,0,0,0,0,0,0.4988662131519274,0.5011337868480725
93377,0.5145631067961165,0.5238095238095238,-106,-110,0.4948179667757384,0.5051820332242616,home,BOS,under,8.5,0.5238095238095238,-110,0.5011337868480725,BOS,CLE,2024 REG,6,4,8,5,9,14,0,1,-1,1,1,1,1,1,0,0,0,0,0,0.4988662131519274,0.5011337868480725
93381,0.4,0.6428571428571428,150,-180,0.38285714285714295,0.617142857142857,away,KC,over,7.5,0.5412844036697247,-118,0.5149381613977361,CWS,KC,2024 REG,4,0,5,2,2,9,0,1,-2,2,0,0,0,0,0,0,0,0,0,0.5149381613977361,0.48506183860226393
93381,0.4,0.6428571428571428,150,-180,0.38285714285714295,0.617142857142857,home,CWS,under,7.5,0.5073891625615764,-103,0.48506183860226393,CWS,KC,2024 REG,4,0,5,2,2,9,0,1,-2,2,0,0,0,0,0,0,0,0,0,0.5149381613977361,0.48506183860226393
93382,0.6453900709219857,0.39840637450199207,-182,151,0.6171242799036738,0.3828757200963262,away,TOR,over,7.5,0.5348837209302326,-115,0.5097020142727117,BAL,TOR,2024 REG,3,2,8,3,5,11,0,1,-1,1,1,1,0,0,0,0,0,0,0,0.5097020142727117,0.49029798572728833
93382,0.6453900709219857,0.39840637450199207,-182,151,0.6171242799036738,0.3828757200963262,home,BAL,under,7.5,0.5121951219512195,-105,0.49029798572728833,BAL,TOR,2024 REG,3,2,8,3,5,11,0,1,-1,1,1,1,0,0,0,0,0,0,0,0.5097020142727117,0.49029798572728833
93383,0.5652173913043479,0.47619047619047616,-130,110,0.5418129444594474,0.4581870555405526,away,PIT,over,7.5,0.5454545454545454,-120,0.5206611570247933,CHC,PIT,2024 REG,2,2,10,3,5,12,0,1,-1,1,1,1,0,0,0,0,0,0,0,0.5206611570247933,0.4793388429752067
93383,0.5652173913043479,0.47619047619047616,-130,110,0.5418129444594474,0.4581870555405526,home,CHC,under,7.5,0.5,100,0.4793388429752067,CHC,PIT,2024 REG,2,2,10,3,5,12,0,1,-1,1,1,1,0,0,0,0,0,0,0,0.5206611570247933,0.4793388429752067
93384,0.6197718631178707,0.42016806722689076,-163,138,0.5950182180753,0.4049817819247,away,CWS,over,7.5,0.5238095238095238,-110,0.4988662131519274,STL,CWS,2024 REG,4,1,9,5,6,13,0,1,-4,4,1,0,0,0,0,0,0,0,0,0.4988662131519274,0.5011337868480725
93384,0.6197718631178707,0.42016806722689076,-163,138,0.5950182180753,0.4049817819247,home,STL,under,7.5,0.5238095238095238,-110,0.5011337868480725,STL,CWS,2024 REG,4,1,9,5,6,13,0,1,-4,4,1,0,0,0,0,0,0,0,0,0.4988662131519274,0.5011337868480725
93386,0.75,0.29411764705882354,-300,240,0.7169117647058822,0.28308823529411775,away,OAK,over,7.5,0.5121951219512195,-105,0.48808156828023186,BAL,OAK,2024 REG,6,2,7,3,5,13,0,1,-1,1,1,1,0,0,0,0,0,0,0,0.48808156828023186,0.5119184317197681
93386,0.75,0.29411764705882354,-300,240,0.7169117647058822,0.28308823529411775,home,BAL,under,7.5,0.5348837209302326,-115,0.5119184317197681,BAL,OAK,2024 REG,6,2,7,3,5,13,0,1,-1,1,1,1,0,0,0,0,0,0,0,0.48808156828023186,0.5119184317197681
93388,0.5555555555555556,0.4854368932038835,-125,106,0.5327819729114227,0.4672180270885773,away,SF,over,7.5,0.5,100,0.4772727272727273,STL,SF,2024 REG,11,5,2,3,8,13,1,0,2,-2,1,1,1,0,0,0,0,0,0,0.4772727272727273,0.5227272727272727
93388,0.5555555555555556,0.4854368932038835,-125,106,0.5327819729114227,0.4672180270885773,home,STL,under,7.5,0.5454545454545454,-120,0.5227272727272727,STL,SF,2024 REG,11,5,2,3,8,13,1,0,2,-2,1,1,1,0,0,0,0,0,0,0.4772727272727273,0.5227272727272727
93389,0.790356394129979,0.25,-377,300,0.7584604599853206,0.24153954001467937,away,CWS,over,7.5,0.5454545454545454,-120,0.5206611570247933,PHI,CWS,2024 REG,12,9,7,5,14,19,1,0,4,-4,1,1,1,1,1,0,0,0,0,0.5206611570247933,0.4793388429752067
93389,0.790356394129979,0.25,-377,300,0.7584604599853206,0.24153954001467937,home,PHI,under,7.5,0.5,100,0.4793388429752067,PHI,CWS,2024 REG,12,9,7,5,14,19,1,0,4,-4,1,1,1,1,1,0,0,0,0,0.5206611570247933,0.4793388429752067
93392,0.6742671009771988,0.37037037037037035,-207,170,0.6441695225767204,0.35583047742327956,away,ARI,over,9,0.5121951219512195,-105,0.48808156828023186,LAD,ARI,2024 REG,6,4,16,12,16,22,0,1,-8,8,1,1,1,1,0,0,0,0,0,0.48808156828023186,0.5119184317197681
93392,0.6742671009771988,0.37037037037037035,-207,170,0.6441695225767204,0.35583047742327956,home,LAD,under,9,0.5348837209302326,-115,0.5119184317197681,LAD,ARI,2024 REG,6,4,16,12,16,22,0,1,-8,8,1,1,1,1,0,0,0,0,0,0.48808156828023186,0.5119184317197681
93394,0.48780487804878053,0.5575221238938054,105,-126,0.46569414539386056,0.5343058546061394,away,LAD,over,8.5,0.5348837209302326,-115,0.5097020142727117,SF,LAD,2024 REG,16,10,8,4,14,24,1,0,6,-6,1,1,1,1,0,0,0,0,0,0.5097020142727117,0.49029798572728833
93394,0.48780487804878053,0.5575221238938054,105,-126,0.46569414539386056,0.5343058546061394,home,SF,under,8.5,0.5121951219512195,-105,0.49029798572728833,SF,LAD,2024 REG,16,10,8,4,14,24,1,0,6,-6,1,1,1,1,0,0,0,0,0,0.5097020142727117,0.49029798572728833
93396,0.5555555555555556,0.48780487804878053,-125,105,0.5314664257753688,0.46853357422463116,away,CHC,over,8.5,0.5098039215686274,-104,0.48483656587239576,TEX,CHC,2024 REG,8,4,6,3,7,14,1,0,1,-1,1,1,1,0,0,0,0,0,0,0.48483656587239576,0.5151634341276042
93396,0.5555555555555556,0.48780487804878053,-125,105,0.5314664257753688,0.46853357422463116,home,TEX,under,8.5,0.5391705069124424,-117,0.5151634341276042,TEX,CHC,2024 REG,8,4,6,3,7,14,1,0,1,-1,1,1,1,0,0,0,0,0,0,0.48483656587239576,0.5151634341276042
93398,0.4926108374384236,0.5475113122171946,103,-121,0.47284623169673967,0.5271537683032603,away,STL,over,8.5,0.5121951219512195,-105,0.48808156828023186,LAA,STL,2024 REG,14,7,9,2,9,23,1,0,5,-5,1,1,0,0,0,0,0,0,0,0.48808156828023186,0.5119184317197681
93398,0.4926108374384236,0.5475113122171946,103,-121,0.47284623169673967,0.5271537683032603,home,LAA,under,8.5,0.5348837209302326,-115,0.5119184317197681,LAA,STL,2024 REG,14,7,9,2,9,23,1,0,5,-5,1,1,0,0,0,0,0,0,0,0.48808156828023186,0.5119184317197681
93399,0.607843137254902,0.43103448275862066,-155,132,0.5842116427368785,0.41578835726312147,away,WSH,over,9.5,0.5121951219512195,-105,0.48808156828023186,DET,WSH,2024 REG,10,7,5,2,9,15,1,0,5,-5,1,1,0,0,0,0,0,0,0,0.48808156828023186,0.5119184317197681
93399,0.607843137254902,0.43103448275862066,-155,132,0.5842116427368785,0.41578835726312147,home,DET,under,9.5,0.5348837209302326,-115,0.5119184317197681,DET,WSH,2024 REG,10,7,5,2,9,15,1,0,5,-5,1,1,0,0,0,0,0,0,0,0.48808156828023186,0.5119184317197681
93401,0.5238095238095238,0.5238095238095238,-110,-110,0.4988662131519274,0.5011337868480725,away,SD,over,8.5,0.5370370370370371,-116,0.5131785224377817,ARI,SD,2024 REG,13,11,12,4,15,25,1,0,7,-7,1,1,1,1,0,0,0,0,0,0.5131785224377817,0.4868214775622183
93401,0.5238095238095238,0.5238095238095238,-110,-110,0.4988662131519274,0.5011337868480725,home,ARI,under,8.5,0.5073891625615764,-103,0.4868214775622183,ARI,SD,2024 REG,13,11,12,4,15,25,1,0,7,-7,1,1,1,1,0,0,0,0,0,0.5131785224377817,0.4868214775622183
93405,0.5951417004048584,0.4444444444444444,-147,125,0.5715823348467713,0.42841766515322866,away,TEX,over,8,0.5348837209302326,-115,0.5097020142727117,HOU,TEX,2024 REG,9,6,7,3,9,16,1,0,3,-3,1,1,1,0,0,0,0,0,0,0.5097020142727117,0.49029798572728833
93405,0.5951417004048584,0.4444444444444444,-147,125,0.5715823348467713,0.42841766515322866,home,HOU,under,8,0.5121951219512195,-105,0.49029798572728833,HOU,TEX,2024 REG,9,6,7,3,9,16,1,0,3,-3,1,1,1,0,0,0,0,0,0,0.5097020142727117,0.49029798572728833
93406,0.5454545454545454,0.49751243781094534,-120,101,0.5220180091279142,0.4779819908720858,away,CLE,over,8.5,0.504950495049505,-102,0.48160416005266615,BOS,CLE,2024 REG,11,7,14,10,17,25,0,1,-3,3,1,1,1,1,1,1,1,0,0,0.48160416005266615,0.5183958399473338
93406,0.5454545454545454,0.49751243781094534,-120,101,0.5220180091279142,0.4779819908720858,home,BOS,under,8.5,0.5412844036697247,-118,0.5183958399473338,BOS,CLE,2024 REG,11,7,14,10,17,25,0,1,-3,3,1,1,1,1,1,1,1,0,0,0.48160416005266615,0.5183958399473338
93407,0.49751243781094534,0.5454545454545454,101,-120,0.476135829221149,0.523864170778851,away,PHI,over,7,0.5433789954337899,-119,0.5184560714286826,DET,PHI,2024 REG,9,4,4,1,5,13,1,0,3,-3,1,0,0,0,0,0,0,0,0,0.5184560714286826,0.48154392857131745
93407,0.49751243781094534,0.5454545454545454,101,-120,0.476135829221149,0.523864170778851,home,DET,under,7,0.5024875621890548,-101,0.48154392857131745,DET,PHI,2024 REG,9,4,4,1,5,13,1,0,3,-3,1,0,0,0,0,0,0,0,0,0.5184560714286826,0.48154392857131745
93408,0.4566210045662101,0.5815899581589958,119,-139,0.4391730763811846,0.5608269236188155,away,SEA,over,8,0.5192307692307692,-108,0.49340049170764233,SD,SEA,2024 REG,4,3,13,8,11,17,0,1,-5,5,1,1,1,0,0,0,0,0,0,0.49340049170764233,0.5065995082923577
93408,0.4566210045662101,0.5815899581589958,119,-139,0.4391730763811846,0.5608269236188155,home,SD,under,8,0.5305164319248826,-113,0.5065995082923577,SD,SEA,2024 REG,4,3,13,8,11,17,0,1,-5,5,1,1,1,0,0,0,0,0,0,0.49340049170764233,0.5065995082923577
93410,0.6183206106870228,0.42372881355932196,-162,136,0.5923205850079852,0.40767941499201477,away,PIT,over,8.5,0.5348837209302326,-115,0.5097020142727117,MIL,PIT,2024 REG,14,9,4,0,9,18,1,0,9,-9,0,0,0,0,0,0,0,0,0,0.5097020142727117,0.49029798572728833
93410,0.6183206106870228,0.42372881355932196,-162,136,0.5923205850079852,0.40767941499201477,home,MIL,under,8.5,0.5121951219512195,-105,0.49029798572728833,MIL,PIT,2024 REG,14,9,4,0,9,18,1,0,9,-9,0,0,0,0,0,0,0,0,0,0.5097020142727117,0.49029798572728833
93411,0.5238095238095238,0.5192307692307692,-110,-108,0.5012646084074657,0.4987353915925343,away,DET,over,7.5,0.5121951219512195,-105,0.48808156828023186,TB,DET,2024 REG,6,1,11,7,8,17,0,1,-6,6,1,0,0,0,0,0,0,0,0,0.48808156828023186,0.5119184317197681
93411,0.5238095238095238,0.5192307692307692,-110,-108,0.5012646084074657,0.4987353915925343,home,TB,under,7.5,0.5348837209302326,-115,0.5119184317197681,TB,DET,2024 REG,6,1,11,7,8,17,0,1,-6,6,1,0,0,0,0,0,0,0,0,0.48808156828023186,0.5119184317197681
93413,0.5555555555555556,0.4854368932038835,-125,106,0.5327819729114227,0.4672180270885773,away,LAD,over,7.5,0.5098039215686274,-104,0.48592421718142587,SF,LAD,2024 REG,8,5,7,3,8,15,1,0,2,-2,1,1,1,0,0,0,0,0,0,0.48592421718142587,0.5140757828185741
93413,0.5555555555555556,0.4854368932038835,-125,106,0.5327819729114227,0.4672180270885773,home,SF,under,7.5,0.5370370370370371,-116,0.5140757828185741,SF,LAD,2024 REG,8,5,7,3,8,15,1,0,2,-2,1,1,1,0,0,0,0,0,0,0.48592421718142587,0.5140757828185741
93414,0.45454545454545453,0.5815899581589958,120,-139,0.43812026695252254,0.5618797330474774,away,BAL,over,7,0.5121951219512195,-105,0.48808156828023186,TB,BAL,2024 REG,5,2,11,5,7,16,0,1,-3,3,1,1,0,0,0,0,0,0,0,0.48808156828023186,0.5119184317197681
93414,0.45454545454545453,0.5815899581589958,120,-139,0.43812026695252254,0.5618797330474774,home,TB,under,7,0.5348837209302326,-115,0.5119184317197681,TB,BAL,2024 REG,5,2,11,5,7,16,0,1,-3,3,1,1,0,0,0,0,0,0,0,0.48808156828023186,0.5119184317197681
93415,0.6047430830039526,0.4347826086956522,-153,130,0.5808401943476698,0.41915980565233024,away,SEA,over,7.5,0.5024875621890548,-101,0.4794401874631478,CLE,SEA,2024 REG,9,8,3,0,8,12,1,0,8,-8,0,0,0,0,0,0,0,0,0,0.4794401874631478,0.5205598125368522
93415,0.6047430830039526,0.4347826086956522,-153,130,0.5808401943476698,0.41915980565233024,home,CLE,under,7.5,0.5433789954337899,-119,0.5205598125368522,CLE,SEA,2024 REG,9,8,3,0,8,12,1,0,8,-8,0,0,0,0,0,0,0,0,0,0.4794401874631478,0.5205598125368522
93416,0.5708154506437768,0.4694835680751174,-133,113,0.5478121481132493,0.4521878518867507,away,SF,over,8.5,0.5370370370370371,-116,0.5105975442470474,CLE,SF,2024 REG,10,5,7,4,9,17,1,0,1,-1,1,1,1,1,0,0,0,0,0,0.5105975442470474,0.4894024557529526
93416,0.5708154506437768,0.4694835680751174,-133,113,0.5478121481132493,0.4521878518867507,home,CLE,under,8.5,0.5121951219512195,-105,0.4894024557529526,CLE,SF,2024 REG,10,5,7,4,9,17,1,0,1,-1,1,1,1,1,0,0,0,0,0,0.5105975442470474,0.4894024557529526
93417,0.48780487804878053,0.5555555555555556,105,-125,0.4666534470222751,0.5333465529777248,away,NYM,over,11,0.5238095238095238,-110,0.4988662131519274,CHC,NYM,2024 REG,9,8,7,1,9,16,1,0,7,-7,1,0,0,0,0,0,0,0,0,0.4988662131519274,0.5011337868480725
93417,0.48780487804878053,0.5555555555555556,105,-125,0.4666534470222751,0.5333465529777248,home,CHC,under,11,0.5238095238095238,-110,0.5011337868480725,CHC,NYM,2024 REG,9,8,7,1,9,16,1,0,7,-7,1,0,0,0,0,0,0,0,0,0.4988662131519274,0.5011337868480725
93419,0.5121951219512195,0.5305164319248826,-105,-113,0.4903184724049234,0.5096815275950766,away,CLE,over,9,0.5121951219512195,-105,0.48808156828023186,TEX,CLE,2024 REG,4,0,8,7,7,12,0,1,-7,7,0,0,0,0,0,0,0,0,0,0.48808156828023186,0.5119184317197681
93419,0.5121951219512195,0.5305164319248826,-105,-113,0.4903184724049234,0.5096815275950766,home,TEX,under,9,0.5348837209302326,-115,0.5119184317197681,TEX,CLE,2024 REG,4,0,8,7,7,12,0,1,-7,7,0,0,0,0,0,0,0,0,0,0.48808156828023186,0.5119184317197681
93422,0.574468085106383,0.46511627906976744,-135,115,0.5517281312179562,0.44827186878204384,away,MIN,over,8.5,0.5391705069124424,-117,0.5140669063204599,DET,MIN,2024 REG,4,1,7,4,5,11,0,1,-3,3,1,0,0,0,0,0,0,0,0,0.5140669063204599,0.4859330936795401
93422,0.574468085106383,0.46511627906976744,-135,115,0.5517281312179562,0.44827186878204384,home,DET,under,8.5,0.5073891625615764,-103,0.4859330936795401,DET,MIN,2024 REG,4,1,7,4,5,11,0,1,-3,3,1,0,0,0,0,0,0,0,0,0.5140669063204599,0.4859330936795401
93424,0.5454545454545454,0.5,-120,100,0.5206611570247933,0.4793388429752067,away,SEA,over,8,0.5348837209302326,-115,0.5097020142727117,TOR,SEA,2024 REG,11,5,7,2,7,18,1,0,3,-3,1,1,0,0,0,0,0,0,0,0.5097020142727117,0.49029798572728833
93424,0.5454545454545454,0.5,-120,100,0.5206611570247933,0.4793388429752067,home,TOR,under,8,0.5121951219512195,-105,0.49029798572728833,TOR,SEA,2024 REG,11,5,7,2,7,18,1,0,3,-3,1,1,0,0,0,0,0,0,0,0.5097020142727117,0.49029798572728833
93425,0.6441281138790036,0.39840637450199207,-181,151,0.6167304541033445,0.3832695458966555,away,WSH,over,7.5,0.5215311004784688,-109,0.4978845547971712,TB,WSH,2024 REG,9,3,5,1,4,14,1,0,2,-2,1,0,0,0,0,0,0,0,0,0.4978845547971712,0.5021154452028288
93425,0.6441281138790036,0.39840637450199207,-181,151,0.6167304541033445,0.3832695458966555,home,TB,under,7.5,0.5238095238095238,-110,0.5021154452028288,TB,WSH,2024 REG,9,3,5,1,4,14,1,0,2,-2,1,0,0,0,0,0,0,0,0,0.4978845547971712,0.5021154452028288
93426,0.6183206106870228,0.42194092827004215,-162,137,0.5934260713318911,0.40657392866810893,away,SEA,over,8.5,0.5327102803738317,-114,0.5075272610403079,NYY,SEA,2024 REG,7,7,6,3,10,13,1,0,4,-4,1,1,1,0,0,0,0,0,0,0.5075272610403079,0.4924727389596921
93426,0.6183206106870228,0.42194092827004215,-162,137,0.5934260713318911,0.40657392866810893,home,NYY,under,8.5,0.5145631067961165,-106,0.4924727389596921,NYY,SEA,2024 REG,7,7,6,3,10,13,1,0,4,-4,1,1,1,0,0,0,0,0,0,0.5075272610403079,0.4924727389596921
93427,0.5555555555555556,0.48780487804878053,-125,105,0.5314664257753688,0.46853357422463116,away,HOU,over,8.5,0.5348837209302326,-115,0.5084354177277668,NYY,HOU,2024 REG,13,10,3,3,13,16,1,0,7,-7,1,1,1,0,0,0,0,0,0,0.5084354177277668,0.4915645822722332
93427,0.5555555555555556,0.48780487804878053,-125,105,0.5314664257753688,0.46853357422463116,home,NYY,under,8.5,0.5145631067961165,-106,0.4915645822722332,NYY,HOU,2024 REG,13,10,3,3,13,16,1,0,7,-7,1,1,1,0,0,0,0,0,0,0.5084354177277668,0.4915645822722332
93428,0.49504950495049505,0.5454545454545454,102,-120,0.47499799484898986,0.5250020051510101,away,TOR,over,9,0.5454545454545454,-120,0.5206611570247933,KC,TOR,2024 REG,8,3,6,5,8,14,0,1,-2,2,1,1,1,0,0,0,0,0,0,0.5206611570247933,0.4793388429752067
93428,0.49504950495049505,0.5454545454545454,102,-120,0.47499799484898986,0.5250020051510101,home,KC,under,9,0.5,100,0.4793388429752067,KC,TOR,2024 REG,8,3,6,5,8,14,0,1,-2,2,1,1,1,0,0,0,0,0,0,0.5206611570247933,0.4793388429752067
93434,0.7198879551820728,0.3225806451612903,-257,210,0.6893153213214445,0.31068467867855554,away,OAK,over,9,0.5098039215686274,-104,0.48375889301574193,PHI,OAK,2024 REG,6,2,8,6,8,14,0,1,-4,4,1,1,0,0,0,0,0,0,0,0.48375889301574193,0.5162411069842581
93434,0.7198879551820728,0.3225806451612903,-257,210,0.6893153213214445,0.31068467867855554,home,PHI,under,9,0.5412844036697247,-118,0.5162411069842581,PHI,OAK,2024 REG,6,2,8,6,8,14,0,1,-4,4,1,1,0,0,0,0,0,0,0,0.48375889301574193,0.5162411069842581
93435,0.7101449275362319,0.33112582781456956,-245,202,0.6808367099682715,0.3191632900317285,away,CWS,over,8,0.5327102803738317,-114,0.5075272610403079,TOR,CWS,2024 REG,10,9,6,2,11,16,1,0,7,-7,1,1,0,0,0,0,0,0,0,0.5075272610403079,0.4924727389596921
93435,0.7101449275362319,0.33112582781456956,-245,202,0.6808367099682715,0.3191632900317285,home,TOR,under,8,0.5145631067961165,-106,0.4924727389596921,TOR,CWS,2024 REG,10,9,6,2,11,16,1,0,7,-7,1,1,0,0,0,0,0,0,0,0.5075272610403079,0.4924727389596921
93438,0.6610169491525424,0.37735849056603776,-195,165,0.6356501330673793,0.3643498669326207,away,CWS,over,8,0.5348837209302326,-115,0.5097020142727117,KC,CWS,2024 REG,7,2,4,1,3,11,1,0,1,-1,1,0,0,0,0,0,0,0,0,0.5097020142727117,0.49029798572728833
93438,0.6610169491525424,0.37735849056603776,-195,165,0.6356501330673793,0.3643498669326207,home,KC,under,8,0.5121951219512195,-105,0.49029798572728833,KC,CWS,2024 REG,7,2,4,1,3,11,1,0,1,-1,1,0,0,0,0,0,0,0,0,0.5097020142727117,0.49029798572728833
93439,0.4672897196261683,0.5726495726495727,114,-134,0.44862649893656975,0.5513735010634302,away,WSH,over,7.5,0.5433789954337899,-119,0.5184560714286826,OAK,WSH,2024 REG,8,1,10,3,4,18,0,1,-2,2,1,0,0,0,0,0,0,0,0,0.5184560714286826,0.48154392857131745
93439,0.4672897196261683,0.5726495726495727,114,-134,0.44862649893656975,0.5513735010634302,home,OAK,under,7.5,0.5024875621890548,-101,0.48154392857131745,OAK,WSH,2024 REG,8,1,10,3,4,18,0,1,-2,2,1,0,0,0,0,0,0,0,0,0.5184560714286826,0.48154392857131745
93441,0.4504504504504505,0.5918367346938775,122,-145,0.43140216885390636,0.5685978311460936,away,SD,over,7,0.5454545454545454,-120,0.5206611570247933,NYM,SD,2024 REG,14,11,10,6,17,24,1,0,5,-5,1,1,1,1,1,1,0,0,0,0.5206611570247933,0.4793388429752067
93441,0.4504504504504505,0.5918367346938775,122,-145,0.43140216885390636,0.5685978311460936,home,NYM,under,7,0.5,100,0.4793388429752067,NYM,SD,2024 REG,14,11,10,6,17,24,1,0,5,-5,1,1,1,1,1,1,0,0,0,0.5206611570247933,0.4793388429752067
93443,0.5951417004048584,0.4444444444444444,-147,125,0.5715823348467713,0.42841766515322866,away,LAA,over,8.5,0.5238095238095238,-110,0.4988662131519274,TB,LAA,2024 REG,5,2,6,1,3,11,1,0,1,-1,1,0,0,0,0,0,0,0,0,0.4988662131519274,0.5011337868480725
93443,0.5951417004048584,0.4444444444444444,-147,125,0.5715823348467713,0.42841766515322866,home,TB,under,8.5,0.5238095238095238,-110,0.5011337868480725,TB,LAA,2024 REG,5,2,6,1,3,11,1,0,1,-1,1,0,0,0,0,0,0,0,0,0.4988662131519274,0.5011337868480725
93445,0.6721311475409836,0.37037037037037035,-205,170,0.6435645535349916,0.35643544646500835,away,PIT,over,8.5,0.5238095238095238,-110,0.4988662131519274,CHC,PIT,2024 REG,5,1,4,0,1,9,1,0,1,-1,0,0,0,0,0,0,0,0,0,0.4988662131519274,0.5011337868480725
93445,0.6721311475409836,0.37037037037037035,-205,170,0.6435645535349916,0.35643544646500835,home,CHC,under,8.5,0.5238095238095238,-110,0.5011337868480725,CHC,PIT,2024 REG,5,1,4,0,1,9,1,0,1,-1,0,0,0,0,0,0,0,0,0,0.4988662131519274,0.5011337868480725
93447,0.5535714285714286,0.48780487804878053,-124,105,0.53066668740667,0.46933331259333,away,DET,over,8,0.5098039215686274,-104,0.48592421718142587,MIN,DET,2024 REG,7,1,7,6,7,14,0,1,-5,5,1,0,0,0,0,0,0,0,0,0.48592421718142587,0.5140757828185741
93447,0.5535714285714286,0.48780487804878053,-124,105,0.53066668740667,0.46933331259333,home,MIN,under,8,0.5370370370370371,-116,0.5140757828185741,MIN,DET,2024 REG,7,1,7,6,7,14,0,1,-5,5,1,0,0,0,0,0,0,0,0,0.48592421718142587,0.5140757828185741
93449,0.6047430830039526,0.4366812227074236,-153,129,0.5796920206567566,0.4203079793432434,away,LAD,over,8,0.504950495049505,-102,0.4826715732667395,DET,LAD,2024 REG,8,3,9,4,7,17,0,1,-1,1,1,1,1,0,0,0,0,0,0,0.4826715732667395,0.5173284267332605
93449,0.6047430830039526,0.4366812227074236,-153,129,0.5796920206567566,0.4203079793432434,home,DET,under,8,0.5391705069124424,-117,0.5173284267332605,DET,LAD,2024 REG,8,3,9,4,7,17,0,1,-1,1,1,1,1,0,0,0,0,0,0,0.4826715732667395,0.5173284267332605
93450,0.41493775933609955,0.6254681647940076,141,-167,0.39817181571364846,0.6018281842863515,away,SF,over,9.5,0.504950495049505,-102,0.48160416005266615,COL,SF,2024 REG,12,6,13,8,14,25,0,1,-2,2,1,1,1,1,1,1,0,0,0,0.48160416005266615,0.5183958399473338
93450,0.41493775933609955,0.6254681647940076,141,-167,0.39817181571364846,0.6018281842863515,home,COL,under,9.5,0.5412844036697247,-118,0.5183958399473338,COL,SF,2024 REG,12,6,13,8,14,25,0,1,-2,2,1,1,1,1,1,1,0,0,0,0.48160416005266615,0.5183958399473338
93451,0.5833333333333333,0.4566210045662101,-140,119,0.5600266362252664,0.4399733637747336,away,MIA,over,7.5,0.5348837209302326,-115,0.5097020142727117,OAK,MIA,2024 REG,5,3,14,12,15,19,0,1,-9,9,1,1,1,0,0,0,0,0,0,0.5097020142727117,0.49029798572728833
93451,0.5833333333333333,0.4566210045662101,-140,119,0.5600266362252664,0.4399733637747336,home,OAK,under,7.5,0.5121951219512195,-105,0.49029798572728833,OAK,MIA,2024 REG,5,3,14,12,15,19,0,1,-9,9,1,1,1,0,0,0,0,0,0,0.5097020142727117,0.49029798572728833
93455,0.6309963099630996,0.4081632653061224,-171,145,0.6062867624684983,0.39371323753150167,away,MIA,over,9.5,0.5098039215686274,-104,0.48483656587239576,CHC,MIA,2024 REG,10,8,6,3,11,16,1,0,5,-5,1,1,1,0,0,0,0,0,0,0.48483656587239576,0.5151634341276042
93455,0.6309963099630996,0.4081632653061224,-171,145,0.6062867624684983,0.39371323753150167,home,CHC,under,9.5,0.5391705069124424,-117,0.5151634341276042,CHC,MIA,2024 REG,10,8,6,3,11,16,1,0,5,-5,1,1,1,0,0,0,0,0,0,0.48483656587239576,0.5151634341276042
93457,0.6415770609318996,0.4,-179,150,0.6149021723770248,0.3850978276229752,away,PIT,over,8,0.5327102803738317,-114,0.5062779990911175,TOR,PIT,2024 REG,11,5,11,4,9,22,1,0,1,-1,1,1,1,1,0,0,0,0,0,0.5062779990911175,0.4937220009088825
93457,0.6415770609318996,0.4,-179,150,0.6149021723770248,0.3850978276229752,home,TOR,under,8,0.5169082125603864,-107,0.4937220009088825,TOR,PIT,2024 REG,11,5,11,4,9,22,1,0,1,-1,1,1,1,1,0,0,0,0,0,0.5062779990911175,0.4937220009088825
93459,0.6655518394648829,0.37735849056603776,-199,165,0.6369927903807584,0.3630072096192416,away,CHC,over,7.5,0.5215311004784688,-109,0.49670754937970685,MIL,CHC,2024 REG,10,7,2,1,8,12,1,0,6,-6,1,0,0,0,0,0,0,0,0,0.49670754937970685,0.5032924506202932
93459,0.6655518394648829,0.37735849056603776,-199,165,0.6369927903807584,0.3630072096192416,home,MIL,under,7.5,0.5260663507109005,-111,0.5032924506202932,MIL,CHC,2024 REG,10,7,2,1,8,12,1,0,6,-6,1,0,0,0,0,0,0,0,0,0.49670754937970685,0.5032924506202932
93460,0.45248868778280543,0.5884773662551441,121,-143,0.43395201174753417,0.5660479882524658,away,CLE,over,7.5,0.5,100,0.4772727272727273,OAK,CLE,2024 REG,4,0,11,8,8,15,0,1,-8,8,0,0,0,0,0,0,0,0,0,0.4772727272727273,0.5227272727272727
93460,0.45248868778280543,0.5884773662551441,121,-143,0.43395201174753417,0.5660479882524658,home,OAK,under,7.5,0.5454545454545454,-120,0.5227272727272727,OAK,CLE,2024 REG,4,0,11,8,8,15,0,1,-8,8,0,0,0,0,0,0,0,0,0,0.4772727272727273,0.5227272727272727
93463,0.6000000000000001,0.4424778761061947,-150,126,0.5745132743362832,0.4254867256637168,away,CIN,over,9.5,0.504950495049505,-102,0.48160416005266615,MIL,CIN,2024 REG,8,5,8,4,9,16,1,0,1,-1,1,1,1,1,0,0,0,0,0,0.48160416005266615,0.5183958399473338
93463,0.6000000000000001,0.4424778761061947,-150,126,0.5745132743362832,0.4254867256637168,home,MIL,under,9.5,0.5412844036697247,-118,0.5183958399473338,MIL,CIN,2024 REG,8,5,8,4,9,16,1,0,1,-1,1,1,1,1,0,0,0,0,0,0.48160416005266615,0.5183958399473338
93464,0.6923076923076923,0.3472222222222222,-225,188,0.6649408284023669,0.3350591715976331,away,COL,over,7,0.5,100,0.47522522522522526,PIT,COL,2024 REG,6,1,1,0,1,7,1,0,1,-1,0,0,0,0,0,0,0,0,0,0.47522522522522526,0.5247747747747747
93464,0.6923076923076923,0.3472222222222222,-225,188,0.6649408284023669,0.3350591715976331,home,PIT,under,7,0.5495495495495495,-122,0.5247747747747747,PIT,COL,2024 REG,6,1,1,0,1,7,1,0,1,-1,0,0,0,0,0,0,0,0,0,0.47522522522522526,0.5247747747747747
93466,0.5348837209302326,0.5121951219512195,-115,-105,0.5097020142727117,0.49029798572728833,away,MIL,over,7.5,0.5,100,0.4772727272727273,NYM,MIL,2024 REG,1,1,8,3,4,9,0,1,-2,2,1,0,0,0,0,0,0,0,0,0.4772727272727273,0.5227272727272727
93466,0.5348837209302326,0.5121951219512195,-115,-105,0.5097020142727117,0.49029798572728833,home,NYM,under,7.5,0.5454545454545454,-120,0.5227272727272727,NYM,MIL,2024 REG,1,1,8,3,4,9,0,1,-2,2,1,0,0,0,0,0,0,0,0,0.4772727272727273,0.5227272727272727
93467,0.6987951807228916,0.3436426116838488,-232,191,0.669139855908543,0.33086014409145703,away,STL,over,8.5,0.5305164319248826,-113,0.5066009958897986,LAD,STL,2024 REG,7,6,6,3,9,13,1,0,3,-3,1,1,1,0,0,0,0,0,0,0.5066009958897986,0.49339900411020143
93467,0.6987951807228916,0.3436426116838488,-232,191,0.669139855908543,0.33086014409145703,home,LAD,under,8.5,0.5145631067961165,-106,0.49339900411020143,LAD,STL,2024 REG,7,6,6,3,9,13,1,0,3,-3,1,1,1,0,0,0,0,0,0,0.5066009958897986,0.49339900411020143
93468,0.6226415094339623,0.4166666666666667,-165,140,0.5981666073335706,0.40183339266642937,away,OAK,over,8,0.5121951219512195,-105,0.48808156828023186,CLE,OAK,2024 REG,9,10,6,2,12,15,1,0,8,-8,1,1,0,0,0,0,0,0,0,0.48808156828023186,0.5119184317197681
93468,0.6226415094339623,0.4166666666666667,-165,140,0.5981666073335706,0.40183339266642937,home,CLE,under,8,0.5348837209302326,-115,0.5119184317197681,CLE,OAK,2024 REG,9,10,6,2,12,15,1,0,8,-8,1,1,0,0,0,0,0,0,0,0.48808156828023186,0.5119184317197681
93473,0.6923076923076923,0.3484320557491289,-225,187,0.6641032513452776,0.3358967486547224,away,COL,over,8,0.5192307692307692,-108,0.49455035168025013,SD,COL,2024 REG,4,4,9,5,9,13,0,1,-1,1,1,1,1,1,0,0,0,0,0,0.49455035168025013,0.5054496483197499
93473,0.6923076923076923,0.3484320557491289,-225,187,0.6641032513452776,0.3358967486547224,home,SD,under,8,0.5283018867924528,-112,0.5054496483197499,SD,COL,2024 REG,4,4,9,5,9,13,0,1,-1,1,1,1,1,1,0,0,0,0,0,0.49455035168025013,0.5054496483197499
93474,0.6941896024464832,0.3484320557491289,-227,187,0.6646020904880614,0.3353979095119386,away,TB,over,8.5,0.5192307692307692,-108,0.49455035168025013,ATL,TB,2024 REG,12,7,8,3,10,20,1,0,4,-4,1,1,1,0,0,0,0,0,0,0.49455035168025013,0.5054496483197499
93474,0.6941896024464832,0.3484320557491289,-227,187,0.6646020904880614,0.3353979095119386,home,ATL,under,8.5,0.5283018867924528,-112,0.5054496483197499,ATL,TB,2024 REG,12,7,8,3,10,20,1,0,4,-4,1,1,1,0,0,0,0,0,0,0.49455035168025013,0.5054496483197499
93475,0.6987951807228916,0.3412969283276451,-232,193,0.67077900813336,0.32922099186664,away,OAK,over,8,0.5348837209302326,-115,0.5097020142727117,SEA,OAK,2024 REG,3,1,9,8,9,12,0,1,-7,7,1,0,0,0,0,0,0,0,0,0.5097020142727117,0.49029798572728833
93475,0.6987951807228916,0.3412969283276451,-232,193,0.67077900813336,0.32922099186664,home,SEA,under,8,0.5121951219512195,-105,0.49029798572728833,SEA,OAK,2024 REG,3,1,9,8,9,12,0,1,-7,7,1,0,0,0,0,0,0,0,0,0.5097020142727117,0.49029798572728833
93478,0.5884773662551441,0.45454545454545453,-143,120,0.5631594099815408,0.4368405900184592,away,MIA,over,9,0.5348837209302326,-115,0.5097020142727117,STL,MIA,2024 REG,5,3,13,10,13,18,0,1,-7,7,1,1,1,0,0,0,0,0,0,0.5097020142727117,0.49029798572728833
93478,0.5884773662551441,0.45454545454545453,-143,120,0.5631594099815408,0.4368405900184592,home,STL,under,9,0.5121951219512195,-105,0.49029798572728833,STL,MIA,2024 REG,5,3,13,10,13,18,0,1,-7,7,1,1,1,0,0,0,0,0,0,0.5097020142727117,0.49029798572728833
93479,0.5,0.5454545454545454,100,-120,0.4772727272727273,0.5227272727272727,away,NYM,over,8.5,0.5,100,0.4772727272727273,WSH,NYM,2024 REG,11,7,12,9,16,23,0,1,-2,2,1,1,1,1,1,1,1,0,0,0.4772727272727273,0.5227272727272727
93479,0.5,0.5454545454545454,100,-120,0.4772727272727273,0.5227272727272727,home,WSH,under,8.5,0.5454545454545454,-120,0.5227272727272727,WSH,NYM,2024 REG,11,7,12,9,16,23,0,1,-2,2,1,1,1,1,1,1,1,0,0,0.4772727272727273,0.5227272727272727
93480,0.5348837209302326,0.5073891625615764,-115,-103,0.5122726437136835,0.48772735628631647,away,TOR,over,8.5,0.504950495049505,-102,0.48160416005266615,WSH,TOR,2024 REG,11,11,10,8,19,21,1,0,3,-3,1,1,1,1,1,1,1,1,0,0.48160416005266615,0.5183958399473338
93480,0.5348837209302326,0.5073891625615764,-115,-103,0.5122726437136835,0.48772735628631647,home,WSH,under,8.5,0.5412844036697247,-118,0.5183958399473338,WSH,TOR,2024 REG,11,11,10,8,19,21,1,0,3,-3,1,1,1,1,1,1,1,1,0,0.48160416005266615,0.5183958399473338
93481,0.7737556561085973,0.27027027027027023,-342,270,0.7396903465575279,0.26030965344247214,away,MIA,over,8.5,0.5260663507109005,-111,0.5010269332605688,LAD,MIA,2024 REG,9,6,7,3,9,16,1,0,3,-3,1,1,1,0,0,0,0,0,0,0.5010269332605688,0.4989730667394312
93481,0.7737556561085973,0.27027027027027023,-342,270,0.7396903465575279,0.26030965344247214,home,LAD,under,8.5,0.5215311004784688,-109,0.4989730667394312,LAD,MIA,2024 REG,9,6,7,3,9,16,1,0,3,-3,1,1,1,0,0,0,0,0,0,0.5010269332605688,0.4989730667394312
93482,0.574468085106383,0.46511627906976744,-135,115,0.5517281312179562,0.44827186878204384,away,CHC,over,7.5,0.5433789954337899,-119,0.5184560714286826,ATL,CHC,2024 REG,10,2,5,0,2,15,1,0,2,-2,0,0,0,0,0,0,0,0,0,0.5184560714286826,0.48154392857131745
93482,0.574468085106383,0.46511627906976744,-135,115,0.5517281312179562,0.44827186878204384,home,ATL,under,7.5,0.5024875621890548,-101,0.48154392857131745,ATL,CHC,2024 REG,10,2,5,0,2,15,1,0,2,-2,0,0,0,0,0,0,0,0,0,0.5184560714286826,0.48154392857131745
93483,0.6296296296296295,0.4132231404958678,-170,142,0.6026482558469091,0.39735174415309094,away,LAA,over,8,0.5098039215686274,-104,0.48375889301574193,PIT,LAA,2024 REG,6,4,5,1,5,11,1,0,3,-3,1,0,0,0,0,0,0,0,0,0.48375889301574193,0.5162411069842581
93483,0.6296296296296295,0.4132231404958678,-170,142,0.6026482558469091,0.39735174415309094,home,PIT,under,8,0.5412844036697247,-118,0.5162411069842581,PIT,LAA,2024 REG,6,4,5,1,5,11,1,0,3,-3,1,0,0,0,0,0,0,0,0,0.48375889301574193,0.5162411069842581
93484,0.7050147492625369,0.3389830508474576,-239,195,0.6739956512498859,0.3260043487501141,away,OAK,over,10,0.5121951219512195,-105,0.48808156828023186,BOS,OAK,2024 REG,10,7,4,0,7,14,1,0,7,-7,0,0,0,0,0,0,0,0,0,0.48808156828023186,0.5119184317197681
93484,0.7050147492625369,0.3389830508474576,-239,195,0.6739956512498859,0.3260043487501141,home,BOS,under,10,0.5348837209302326,-115,0.5119184317197681,BOS,OAK,2024 REG,10,7,4,0,7,14,1,0,7,-7,0,0,0,0,0,0,0,0,0,0.48808156828023186,0.5119184317197681
93485,0.5798319327731092,0.4587155963302753,-138,118,0.557480844469466,0.442519155530534,away,NYY,over,8,0.5238095238095238,-110,0.4988662131519274,MIN,NYY,2024 REG,4,0,13,4,4,17,0,1,-4,4,0,0,0,0,0,0,0,0,0,0.4988662131519274,0.5011337868480725
93485,0.5798319327731092,0.4587155963302753,-138,118,0.557480844469466,0.442519155530534,home,MIN,under,8,0.5238095238095238,-110,0.5011337868480725,MIN,NYY,2024 REG,4,0,13,4,4,17,0,1,-4,4,0,0,0,0,0,0,0,0,0,0.4988662131519274,0.5011337868480725
93486,0.45454545454545453,0.5884773662551441,120,-143,0.43498962690881876,0.5650103730911813,away,TB,over,8.5,0.5,100,0.4772727272727273,CWS,TB,2024 REG,12,4,7,2,6,19,1,0,2,-2,1,1,0,0,0,0,0,0,0,0.4772727272727273,0.5227272727272727
93486,0.45454545454545453,0.5884773662551441,120,-143,0.43498962690881876,0.5650103730911813,home,CWS,under,8.5,0.5454545454545454,-120,0.5227272727272727,CWS,TB,2024 REG,12,4,7,2,6,19,1,0,2,-2,1,1,0,0,0,0,0,0,0,0.4772727272727273,0.5227272727272727
93488,0.49019607843137253,0.5495495495495495,104,-122,0.4707129274603323,0.5292870725396677,away,PHI,over,7.5,0.5412844036697247,-118,0.5149381613977361,NYM,PHI,2024 REG,4,0,7,4,4,11,0,1,-4,4,0,0,0,0,0,0,0,0,0,0.5149381613977361,0.48506183860226393
93488,0.49019607843137253,0.5495495495495495,104,-122,0.4707129274603323,0.5292870725396677,home,NYM,under,7.5,0.5073891625615764,-103,0.48506183860226393,NYM,PHI,2024 REG,4,0,7,4,4,11,0,1,-4,4,0,0,0,0,0,0,0,0,0,0.5149381613977361,0.48506183860226393
93490,0.5238095238095238,0.5238095238095238,-110,-110,0.4988662131519274,0.5011337868480725,away,MIN,over,7.5,0.5454545454545454,-120,0.5179608869977906,LAA,MIN,2024 REG,6,5,17,11,16,23,0,1,-6,6,1,1,1,1,1,0,0,0,0,0.5179608869977906,0.48203911300220936
93490,0.5238095238095238,0.5238095238095238,-110,-110,0.4988662131519274,0.5011337868480725,home,LAA,under,7.5,0.504950495049505,-102,0.48203911300220936,LAA,MIN,2024 REG,6,5,17,11,16,23,0,1,-6,6,1,1,1,1,1,0,0,0,0,0.5179608869977906,0.48203911300220936
93491,0.647887323943662,0.3968253968253968,-184,152,0.6189185189383564,0.38108148106164363,away,WSH,over,10.5,0.5238095238095238,-110,0.4988662131519274,CIN,WSH,2024 REG,10,6,11,7,13,21,0,1,-1,1,1,1,1,1,1,1,0,0,0,0.4988662131519274,0.5011337868480725
93491,0.647887323943662,0.3968253968253968,-184,152,0.6189185189383564,0.38108148106164363,home,CIN,under,10.5,0.5238095238095238,-110,0.5011337868480725,CIN,WSH,2024 REG,10,6,11,7,13,21,0,1,-1,1,1,1,1,1,1,1,0,0,0,0.4988662131519274,0.5011337868480725
93495,0.5454545454545454,0.5,-120,100,0.5206611570247933,0.4793388429752067,away,SF,over,8,0.5348837209302326,-115,0.5097020142727117,TEX,SF,2024 REG,5,1,6,3,4,11,0,1,-2,2,1,0,0,0,0,0,0,0,0,0.5097020142727117,0.49029798572728833
93495,0.5454545454545454,0.5,-120,100,0.5206611570247933,0.4793388429752067,home,TEX,under,8,0.5121951219512195,-105,0.49029798572728833,TEX,SF,2024 REG,5,1,6,3,4,11,0,1,-2,2,1,0,0,0,0,0,0,0,0,0.5097020142727117,0.49029798572728833
93496,0.6721311475409836,0.37037037037037035,-205,170,0.6435645535349916,0.35643544646500835,away,WSH,over,9.5,0.5305164319248826,-113,0.5066009958897986,NYM,WSH,2024 REG,12,6,5,2,8,17,1,0,4,-4,1,1,0,0,0,0,0,0,0,0.5066009958897986,0.49339900411020143
93496,0.6721311475409836,0.37037037037037035,-205,170,0.6435645535349916,0.35643544646500835,home,NYM,under,9.5,0.5145631067961165,-106,0.49339900411020143,NYM,WSH,2024 REG,12,6,5,2,8,17,1,0,4,-4,1,1,0,0,0,0,0,0,0,0.5066009958897986,0.49339900411020143
93497,0.49504950495049505,0.5475113122171946,102,-121,0.4739797934813417,0.5260202065186583,away,CLE,over,8,0.5348837209302326,-115,0.5097020142727117,MIA,CLE,2024 REG,5,3,10,6,9,15,0,1,-3,3,1,1,1,0,0,0,0,0,0,0.5097020142727117,0.49029798572728833
93497,0.49504950495049505,0.5475113122171946,102,-121,0.4739797934813417,0.5260202065186583,home,MIA,under,8,0.5121951219512195,-105,0.49029798572728833,MIA,CLE,2024 REG,5,3,10,6,9,15,0,1,-3,3,1,1,1,0,0,0,0,0,0,0.5097020142727117,0.49029798572728833
93498,0.4464285714285714,0.5934959349593496,124,-146,0.42860513107682097,0.571394868923179,away,PIT,over,7.5,0.4926108374384236,103,0.46888355024927125,STL,PIT,2024 REG,8,1,3,2,3,11,0,1,-1,1,1,0,0,0,0,0,0,0,0,0.46888355024927125,0.5311164497507288
93498,0.4464285714285714,0.5934959349593496,124,-146,0.42860513107682097,0.571394868923179,home,STL,under,7.5,0.5555555555555556,-125,0.5311164497507288,STL,PIT,2024 REG,8,1,3,2,3,11,0,1,-1,1,1,0,0,0,0,0,0,0,0,0.46888355024927125,0.5311164497507288
93502,0.6376811594202898,0.4,-176,150,0.6136525939928585,0.38634740600714146,away,OAK,over,9,0.5348837209302326,-115,0.5097020142727117,KC,OAK,2024 REG,9,8,11,4,12,20,1,0,4,-4,1,1,1,1,0,0,0,0,0,0.5097020142727117,0.49029798572728833
93502,0.6376811594202898,0.4,-176,150,0.6136525939928585,0.38634740600714146,home,KC,under,9,0.5121951219512195,-105,0.49029798572728833,KC,OAK,2024 REG,9,8,11,4,12,20,1,0,4,-4,1,1,1,1,0,0,0,0,0,0.5097020142727117,0.49029798572728833
93504,0.7142857142857143,0.3278688524590164,-250,205,0.6841753094680495,0.3158246905319505,away,CWS,over,8.5,0.5454545454545454,-120,0.5206611570247933,CLE,CWS,2024 REG,8,5,12,7,12,20,0,1,-2,2,1,1,1,1,1,0,0,0,0,0.5206611570247933,0.4793388429752067
93504,0.7142857142857143,0.3278688524590164,-250,205,0.6841753094680495,0.3158246905319505,home,CLE,under,8.5,0.5,100,0.4793388429752067,CLE,CWS,2024 REG,8,5,12,7,12,20,0,1,-2,2,1,1,1,1,1,0,0,0,0,0.5206611570247933,0.4793388429752067
93506,0.6323529411764706,0.4081632653061224,-172,145,0.6067323988418897,0.3932676011581103,away,CLE,over,8.5,0.5412844036697247,-118,0.5149381613977361,ATL,CLE,2024 REG,7,2,8,4,6,15,0,1,-2,2,1,1,0,0,0,0,0,0,0,0.5149381613977361,0.48506183860226393
93506,0.6323529411764706,0.4081632653061224,-172,145,0.6067323988418897,0.3932676011581103,home,ATL,under,8.5,0.5073891625615764,-103,0.48506183860226393,ATL,CLE,2024 REG,7,2,8,4,6,15,0,1,-2,2,1,1,0,0,0,0,0,0,0,0.5149381613977361,0.48506183860226393
93507,0.7101449275362319,0.3333333333333333,-245,200,0.6792690611216132,0.3207309388783868,away,SF,over,8.5,0.5121951219512195,-105,0.48808156828023186,LAD,SF,2024 REG,9,5,5,4,9,14,1,0,1,-1,1,1,1,1,0,0,0,0,0,0.48808156828023186,0.5119184317197681
93507,0.7101449275362319,0.3333333333333333,-245,200,0.6792690611216132,0.3207309388783868,home,LAD,under,8.5,0.5348837209302326,-115,0.5119184317197681,LAD,SF,2024 REG,9,5,5,4,9,14,1,0,1,-1,1,1,1,1,0,0,0,0,0,0.48808156828023186,0.5119184317197681
93509,0.6282527881040892,0.4132231404958678,-169,142,0.60219542032196,0.39780457967803995,away,DET,over,7.5,0.5145631067961165,-106,0.4913668392989033,NYY,DET,2024 REG,9,5,7,3,8,16,1,0,2,-2,1,1,1,0,0,0,0,0,0,0.4913668392989033,0.5086331607010968
93509,0.6282527881040892,0.4132231404958678,-169,142,0.60219542032196,0.39780457967803995,home,NYY,under,7.5,0.5305164319248826,-113,0.5086331607010968,NYY,DET,2024 REG,9,5,7,3,8,16,1,0,2,-2,1,1,1,0,0,0,0,0,0,0.4913668392989033,0.5086331607010968
93510,0.6875,0.35714285714285715,-220,180,0.6568080357142857,0.3431919642857143,away,COL,over,7,0.5454545454545454,-120,0.5206611570247933,CHC,COL,2024 REG,10,9,11,8,17,21,1,0,1,-1,1,1,1,1,1,1,1,1,0,0.5206611570247933,0.4793388429752067
93510,0.6875,0.35714285714285715,-220,180,0.6568080357142857,0.3431919642857143,home,CHC,under,7,0.5,100,0.4793388429752067,CHC,COL,2024 REG,10,9,11,8,17,21,1,0,1,-1,1,1,1,1,1,1,1,1,0,0.5206611570247933,0.4793388429752067
93512,0.5073891625615764,0.5348837209302326,-103,-115,0.4859403596076043,0.5140596403923957,away,SEA,over,9,0.5145631067961165,-106,0.49023796582517226,TEX,SEA,2024 REG,3,0,6,4,4,9,0,1,-4,4,0,0,0,0,0,0,0,0,0,0.49023796582517226,0.5097620341748277
93512,0.5073891625615764,0.5348837209302326,-103,-115,0.4859403596076043,0.5140596403923957,home,TEX,under,9,0.5327102803738317,-114,0.5097620341748277,TEX,SEA,2024 REG,3,0,6,4,4,9,0,1,-4,4,0,0,0,0,0,0,0,0,0,0.49023796582517226,0.5097620341748277
93515,0.3717472118959108,0.6688741721854304,169,-202,0.3566463256203193,0.6433536743796807,away,LAD,over,7,0.5454545454545454,-120,0.5206611570247933,SF,LAD,2024 REG,13,7,16,14,21,29,0,1,-7,7,1,1,1,1,1,1,1,0,0,0.5206611570247933,0.4793388429752067
93515,0.3717472118959108,0.6688741721854304,169,-202,0.3566463256203193,0.6433536743796807,home,SF,under,7,0.5,100,0.4793388429752067,SF,LAD,2024 REG,13,7,16,14,21,29,0,1,-7,7,1,1,1,1,1,1,1,0,0,0.5206611570247933,0.4793388429752067
93516,0.6539792387543253,0.390625,-189,156,0.6248089926485555,0.3751910073514445,away,PHI,over,8.5,0.504950495049505,-102,0.48160416005266615,BAL,PHI,2024 REG,11,6,7,2,8,18,1,0,4,-4,1,1,0,0,0,0,0,0,0,0.48160416005266615,0.5183958399473338
93516,0.6539792387543253,0.390625,-189,156,0.6248089926485555,0.3751910073514445,home,BAL,under,8.5,0.5412844036697247,-118,0.5183958399473338,BAL,PHI,2024 REG,11,6,7,2,8,18,1,0,4,-4,1,1,0,0,0,0,0,0,0,0.48160416005266615,0.5183958399473338
93517,0.7005988023952096,0.3424657534246575,-234,192,0.670427826162129,0.32957217383787096,away,SF,over,7.5,0.5024875621890548,-101,0.4794401874631478,PHI,SF,2024 REG,10,6,5,1,7,15,1,0,5,-5,1,0,0,0,0,0,0,0,0,0.4794401874631478,0.5205598125368522
93517,0.7005988023952096,0.3424657534246575,-234,192,0.670427826162129,0.32957217383787096,home,PHI,under,7.5,0.5433789954337899,-119,0.5205598125368522,PHI,SF,2024 REG,10,6,5,1,7,15,1,0,5,-5,1,0,0,0,0,0,0,0,0,0.4794401874631478,0.5205598125368522
93518,0.5652173913043479,0.47619047619047616,-130,110,0.5418129444594474,0.4581870555405526,away,TB,over,8,0.5348837209302326,-115,0.5097020142727117,NYY,TB,2024 REG,9,5,5,4,9,14,1,0,1,-1,1,1,1,1,0,0,0,0,0,0.5097020142727117,0.49029798572728833
93518,0.5652173913043479,0.47619047619047616,-130,110,0.5418129444594474,0.4581870555405526,home,NYY,under,8,0.5121951219512195,-105,0.49029798572728833,NYY,TB,2024 REG,9,5,5,4,9,14,1,0,1,-1,1,1,1,1,0,0,0,0,0,0.5097020142727117,0.49029798572728833
93520,0.504950495049505,0.5391705069124424,-102,-117,0.4826715732667395,0.5173284267332605,away,WSH,over,7.5,0.5121951219512195,-105,0.48808156828023186,CWS,WSH,2024 REG,7,4,4,0,4,11,1,0,4,-4,0,0,0,0,0,0,0,0,0,0.48808156828023186,0.5119184317197681
93520,0.504950495049505,0.5391705069124424,-102,-117,0.4826715732667395,0.5173284267332605,home,CWS,under,7.5,0.5348837209302326,-115,0.5119184317197681,CWS,WSH,2024 REG,7,4,4,0,4,11,1,0,4,-4,0,0,0,0,0,0,0,0,0,0.48808156828023186,0.5119184317197681
93521,0.6108949416342413,0.4273504273504274,-157,134,0.5875310391805721,0.41246896081942785,away,HOU,over,7.5,0.5348837209302326,-115,0.5097020142727117,DET,HOU,2024 REG,11,8,8,2,10,19,1,0,6,-6,1,1,0,0,0,0,0,0,0,0.5097020142727117,0.49029798572728833
93521,0.6108949416342413,0.4273504273504274,-157,134,0.5875310391805721,0.41246896081942785,home,DET,under,7.5,0.5121951219512195,-105,0.49029798572728833,DET,HOU,2024 REG,11,8,8,2,10,19,1,0,6,-6,1,1,0,0,0,0,0,0,0,0.5097020142727117,0.49029798572728833
93523,0.5260663507109005,0.5169082125603864,-111,-107,0.5034588790373798,0.49654112096262015,away,LAD,over,7.5,0.5348837209302326,-115,0.5097020142727117,SD,LAD,2024 REG,9,4,4,0,4,13,1,0,4,-4,0,0,0,0,0,0,0,0,0,0.5097020142727117,0.49029798572728833
93523,0.5260663507109005,0.5169082125603864,-111,-107,0.5034588790373798,0.49654112096262015,home,SD,under,7.5,0.5121951219512195,-105,0.49029798572728833,SD,LAD,2024 REG,9,4,4,0,4,13,1,0,4,-4,0,0,0,0,0,0,0,0,0,0.5097020142727117,0.49029798572728833
93524,0.5967741935483871,0.4464285714285714,-148,124,0.5709918983202021,0.42900810167979786,away,HOU,over,8.5,0.5475113122171946,-121,0.5214983313199976,MIN,HOU,2024 REG,11,3,5,2,5,16,1,0,1,-1,1,1,0,0,0,0,0,0,0,0.5214983313199976,0.47850166868000243
93524,0.5967741935483871,0.4464285714285714,-148,124,0.5709918983202021,0.42900810167979786,home,MIN,under,8.5,0.5,100,0.47850166868000243,MIN,HOU,2024 REG,11,3,5,2,5,16,1,0,1,-1,1,1,0,0,0,0,0,0,0,0.5214983313199976,0.47850166868000243
93525,0.46511627906976744,0.574468085106383,115,-135,0.44670494689481377,0.5532950531051862,away,DET,over,7.5,0.5391705069124424,-117,0.5140669063204599,ARI,DET,2024 REG,3,0,17,13,13,20,0,1,-13,13,0,0,0,0,0,0,0,0,0,0.5140669063204599,0.4859330936795401
93525,0.46511627906976744,0.574468085106383,115,-135,0.44670494689481377,0.5532950531051862,home,ARI,under,7.5,0.5073891625615764,-103,0.4859330936795401,ARI,DET,2024 REG,3,0,17,13,13,20,0,1,-13,13,0,0,0,0,0,0,0,0,0,0.5140669063204599,0.4859330936795401
93526,0.6363636363636364,0.4081632653061224,-175,145,0.6080283353010626,0.3919716646989374,away,SF,over,7,0.5348837209302326,-115,0.5097020142727117,PHI,SF,2024 REG,12,14,10,3,17,22,1,0,11,-11,1,1,1,0,0,0,0,0,0,0.5097020142727117,0.49029798572728833
93526,0.6363636363636364,0.4081632653061224,-175,145,0.6080283353010626,0.3919716646989374,home,PHI,under,7,0.5121951219512195,-105,0.49029798572728833,PHI,SF,2024 REG,12,14,10,3,17,22,1,0,11,-11,1,1,1,0,0,0,0,0,0,0.5097020142727117,0.49029798572728833
93529,0.6363636363636364,0.4081632653061224,-175,145,0.6080283353010626,0.3919716646989374,away,MIL,over,8.5,0.5454545454545454,-120,0.5193043049216726,PHI,MIL,2024 REG,3,2,3,0,2,6,1,0,2,-2,0,0,0,0,0,0,0,0,0,0.5193043049216726,0.48069569507832743
93529,0.6363636363636364,0.4081632653061224,-175,145,0.6080283353010626,0.3919716646989374,home,PHI,under,8.5,0.5024875621890548,-101,0.48069569507832743,PHI,MIL,2024 REG,3,2,3,0,2,6,1,0,2,-2,0,0,0,0,0,0,0,0,0,0.5193043049216726,0.48069569507832743
93531,0.7297297297297298,0.3125,-270,220,0.6989134404674946,0.3010865595325054,away,COL,over,8.5,0.5348837209302326,-115,0.5097020142727117,PHI,COL,2024 REG,6,2,5,1,3,11,1,0,1,-1,1,0,0,0,0,0,0,0,0,0.5097020142727117,0.49029798572728833
93531,0.7297297297297298,0.3125,-270,220,0.6989134404674946,0.3010865595325054,home,PHI,under,8.5,0.5121951219512195,-105,0.49029798572728833,PHI,COL,2024 REG,6,2,5,1,3,11,1,0,1,-1,1,0,0,0,0,0,0,0,0,0.5097020142727117,0.49029798572728833
93533,0.5555555555555556,0.48780487804878053,-125,105,0.5314664257753688,0.46853357422463116,away,CHC,over,8,0.5238095238095238,-110,0.4988662131519274,SF,CHC,2024 REG,8,5,4,1,6,12,1,0,4,-4,1,0,0,0,0,0,0,0,0,0.4988662131519274,0.5011337868480725
93533,0.5555555555555556,0.48780487804878053,-125,105,0.5314664257753688,0.46853357422463116,home,SF,under,8,0.5238095238095238,-110,0.5011337868480725,SF,CHC,2024 REG,8,5,4,1,6,12,1,0,4,-4,1,0,0,0,0,0,0,0,0,0.4988662131519274,0.5011337868480725
93534,0.6721311475409836,0.37037037037037035,-205,170,0.6435645535349916,0.35643544646500835,away,LAA,over,7,0.5,100,0.4772727272727273,SEA,LAA,2024 REG,5,5,4,1,6,9,1,0,4,-4,1,0,0,0,0,0,0,0,0,0.4772727272727273,0.5227272727272727
93534,0.6721311475409836,0.37037037037037035,-205,170,0.6435645535349916,0.35643544646500835,home,SEA,under,7,0.5454545454545454,-120,0.5227272727272727,SEA,LAA,2024 REG,5,5,4,1,6,9,1,0,4,-4,1,0,0,0,0,0,0,0,0,0.4772727272727273,0.5227272727272727
93535,0.4273504273504274,0.609375,134,-156,0.4116558002775952,0.5883441997224048,away,KC,over,10.5,0.5121951219512195,-105,0.48808156828023186,COL,KC,2024 REG,8,3,8,1,4,16,1,0,2,-2,1,0,0,0,0,0,0,0,0,0.48808156828023186,0.5119184317197681
93535,0.4273504273504274,0.609375,134,-156,0.4116558002775952,0.5883441997224048,home,COL,under,10.5,0.5348837209302326,-115,0.5119184317197681,COL,KC,2024 REG,8,3,8,1,4,16,1,0,2,-2,1,0,0,0,0,0,0,0,0,0.48808156828023186,0.5119184317197681
93536,0.5934959349593496,0.4484304932735426,-146,123,0.5686127702357632,0.4313872297642368,away,CHC,over,8.5,0.5327102803738317,-114,0.5062779990911175,STL,CHC,2024 REG,11,5,12,4,9,23,1,0,1,-1,1,1,1,1,0,0,0,0,0,0.5062779990911175,0.4937220009088825
93536,0.5934959349593496,0.4484304932735426,-146,123,0.5686127702357632,0.4313872297642368,home,STL,under,8.5,0.5169082125603864,-107,0.4937220009088825,STL,CHC,2024 REG,11,5,12,4,9,23,1,0,1,-1,1,1,1,1,0,0,0,0,0,0.5062779990911175,0.4937220009088825
93537,0.6226415094339623,0.4166666666666667,-165,140,0.5981666073335706,0.40183339266642937,away,SEA,over,8,0.5454545454545454,-120,0.5193043049216726,NYY,SEA,2024 REG,5,3,10,6,9,15,0,1,-3,3,1,1,1,0,0,0,0,0,0,0.5193043049216726,0.48069569507832743
93537,0.6226415094339623,0.4166666666666667,-165,140,0.5981666073335706,0.40183339266642937,home,NYY,under,8,0.5024875621890548,-101,0.48069569507832743,NYY,SEA,2024 REG,5,3,10,6,9,15,0,1,-3,3,1,1,1,0,0,0,0,0,0,0.5193043049216726,0.48069569507832743
93539,0.48780487804878053,0.5555555555555556,105,-125,0.4666534470222751,0.5333465529777248,away,ATL,over,11.5,0.5348837209302326,-115,0.5097020142727117,CHC,ATL,2024 REG,7,4,5,3,7,12,1,0,1,-1,1,1,1,0,0,0,0,0,0,0.5097020142727117,0.49029798572728833
93539,0.48780487804878053,0.5555555555555556,105,-125,0.4666534470222751,0.5333465529777248,home,CHC,under,11.5,0.5121951219512195,-105,0.49029798572728833,CHC,ATL,2024 REG,7,4,5,3,7,12,1,0,1,-1,1,1,1,0,0,0,0,0,0,0.5097020142727117,0.49029798572728833
93540,0.4,0.6428571428571428,150,-180,0.38285714285714295,0.617142857142857,away,MIN,over,8,0.5238095238095238,-110,0.4988662131519274,OAK,MIN,2024 REG,3,0,6,3,3,9,0,1,-3,3,0,0,0,0,0,0,0,0,0,0.4988662131519274,0.5011337868480725
93540,0.4,0.6428571428571428,150,-180,0.38285714285714295,0.617142857142857,home,OAK,under,8,0.5238095238095238,-110,0.5011337868480725,OAK,MIN,2024 REG,3,0,6,3,3,9,0,1,-3,3,0,0,0,0,0,0,0,0,0,0.4988662131519274,0.5011337868480725
93541,0.4444444444444444,0.6000000000000001,125,-150,0.4246913580246913,0.5753086419753086,away,SD,over,9.5,0.5238095238095238,-110,0.4988662131519274,COL,SD,2024 REG,13,7,12,4,11,25,1,0,3,-3,1,1,1,1,0,0,0,0,0,0.4988662131519274,0.5011337868480725
93541,0.4444444444444444,0.6000000000000001,125,-150,0.4246913580246913,0.5753086419753086,home,COL,under,9.5,0.5238095238095238,-110,0.5011337868480725,COL,SD,2024 REG,13,7,12,4,11,25,1,0,3,-3,1,1,1,1,0,0,0,0,0,0.4988662131519274,0.5011337868480725
93543,0.3278688524590164,0.7142857142857143,205,-250,0.3140476830345145,0.6859523169654855,away,BAL,over,7.5,0.5238095238095238,-110,0.4988662131519274,CWS,BAL,2024 REG,9,4,8,6,10,17,0,1,-2,2,1,1,1,1,0,0,0,0,0,0.4988662131519274,0.5011337868480725
93543,0.3278688524590164,0.7142857142857143,205,-250,0.3140476830345145,0.6859523169654855,home,CWS,under,7.5,0.5238095238095238,-110,0.5011337868480725,CWS,BAL,2024 REG,9,4,8,6,10,17,0,1,-2,2,1,1,1,1,0,0,0,0,0,0.4988662131519274,0.5011337868480725
93544,0.7058823529411764,0.33557046979865773,-240,198,0.6766215368895289,0.32337846311047114,away,WSH,over,7.5,0.5348837209302326,-115,0.5097020142727117,PHI,WSH,2024 REG,12,11,7,5,16,19,1,0,6,-6,1,1,1,1,1,0,0,0,0,0.5097020142727117,0.49029798572728833
93544,0.7058823529411764,0.33557046979865773,-240,198,0.6766215368895289,0.32337846311047114,home,PHI,under,7.5,0.5121951219512195,-105,0.49029798572728833,PHI,WSH,2024 REG,12,11,7,5,16,19,1,0,6,-6,1,1,1,1,1,0,0,0,0,0.5097020142727117,0.49029798572728833
93545,0.5348837209302326,0.5121951219512195,-115,-105,0.5097020142727117,0.49029798572728833,away,MIN,over,7,0.5454545454545454,-120,0.5206611570247933,TOR,MIN,2024 REG,8,2,7,3,5,15,0,1,-1,1,1,1,0,0,0,0,0,0,0,0.5206611570247933,0.4793388429752067
93545,0.5348837209302326,0.5121951219512195,-115,-105,0.5097020142727117,0.49029798572728833,home,TOR,under,7,0.5,100,0.4793388429752067,TOR,MIN,2024 REG,8,2,7,3,5,15,0,1,-1,1,1,1,0,0,0,0,0,0,0,0.5206611570247933,0.4793388429752067
93548,0.3367003367003367,0.7058823529411764,197,-240,0.3223627307604333,0.6776372692395667,away,BAL,over,8,0.5283018867924528,-112,0.5044173060022736,CWS,BAL,2024 REG,7,6,13,8,14,20,0,1,-2,2,1,1,1,1,1,1,0,0,0,0.5044173060022736,0.49558269399772636
93548,0.3367003367003367,0.7058823529411764,197,-240,0.3223627307604333,0.6776372692395667,home,CWS,under,8,0.5169082125603864,-107,0.49558269399772636,CWS,BAL,2024 REG,7,6,13,8,14,20,0,1,-2,2,1,1,1,1,1,1,0,0,0,0.5044173060022736,0.49558269399772636
93551,0.4132231404958678,0.6282527881040892,142,-169,0.3960843270248111,0.6039156729751889,away,TOR,over,7.5,0.5412844036697247,-118,0.5162581740877563,OAK,TOR,2024 REG,5,0,10,7,7,15,0,1,-7,7,0,0,0,0,0,0,0,0,0,0.5162581740877563,0.4837418259122437
93551,0.4132231404958678,0.6282527881040892,142,-169,0.3960843270248111,0.6039156729751889,home,OAK,under,7.5,0.504950495049505,-102,0.4837418259122437,OAK,TOR,2024 REG,5,0,10,7,7,15,0,1,-7,7,0,0,0,0,0,0,0,0,0,0.5162581740877563,0.4837418259122437
93554,0.5121951219512195,0.5348837209302326,-105,-115,0.48808156828023186,0.5119184317197681,away,LAA,over,10.5,0.5121951219512195,-105,0.48808156828023186,BOS,LAA,2024 REG,11,7,8,2,9,19,1,0,5,-5,1,1,0,0,0,0,0,0,0,0.48808156828023186,0.5119184317197681
93554,0.5121951219512195,0.5348837209302326,-105,-115,0.48808156828023186,0.5119184317197681,home,BOS,under,10.5,0.5348837209302326,-115,0.5119184317197681,BOS,LAA,2024 REG,11,7,8,2,9,19,1,0,5,-5,1,1,0,0,0,0,0,0,0,0.48808156828023186,0.5119184317197681
93555,0.574468085106383,0.4672897196261683,-135,114,0.550479558983428,0.44952044101657196,away,CHC,over,7.5,0.5121951219512195,-105,0.48808156828023186,TB,CHC,2024 REG,8,5,10,2,7,18,1,0,3,-3,1,1,0,0,0,0,0,0,0,0.48808156828023186,0.5119184317197681
93555,0.574468085106383,0.4672897196261683,-135,114,0.550479558983428,0.44952044101657196,home,TB,under,7.5,0.5348837209302326,-115,0.5119184317197681,TB,CHC,2024 REG,8,5,10,2,7,18,1,0,3,-3,1,1,0,0,0,0,0,0,0,0.48808156828023186,0.5119184317197681
93556,0.5833333333333333,0.4566210045662101,-140,119,0.5600266362252664,0.4399733637747336,away,MIL,over,8,0.5238095238095238,-110,0.4988662131519274,NYM,MIL,2024 REG,7,1,9,4,5,16,0,1,-3,3,1,0,0,0,0,0,0,0,0,0.4988662131519274,0.5011337868480725
93556,0.5833333333333333,0.4566210045662101,-140,119,0.5600266362252664,0.4399733637747336,home,NYM,under,8,0.5238095238095238,-110,0.5011337868480725,NYM,MIL,2024 REG,7,1,9,4,5,16,0,1,-3,3,1,0,0,0,0,0,0,0,0,0.4988662131519274,0.5011337868480725
93560,0.574468085106383,0.46511627906976744,-135,115,0.5517281312179562,0.44827186878204384,away,PHI,over,8,0.5238095238095238,-110,0.4988662131519274,SF,PHI,2024 REG,12,8,7,4,12,19,1,0,4,-4,1,1,1,1,0,0,0,0,0,0.4988662131519274,0.5011337868480725
93560,0.574468085106383,0.46511627906976744,-135,115,0.5517281312179562,0.44827186878204384,home,SF,under,8,0.5238095238095238,-110,0.5011337868480725,SF,PHI,2024 REG,12,8,7,4,12,19,1,0,4,-4,1,1,1,1,0,0,0,0,0,0.4988662131519274,0.5011337868480725
93564,0.6000000000000001,0.4444444444444444,-150,125,0.5733333333333334,0.42666666666666664,away,PIT,over,7.5,0.5238095238095238,-110,0.4988662131519274,SF,PIT,2024 REG,7,3,11,4,7,18,0,1,-1,1,1,1,1,0,0,0,0,0,0,0.4988662131519274,0.5011337868480725
93564,0.6000000000000001,0.4444444444444444,-150,125,0.5733333333333334,0.42666666666666664,home,SF,under,7.5,0.5238095238095238,-110,0.5011337868480725,SF,PIT,2024 REG,7,3,11,4,7,18,0,1,-1,1,1,1,1,0,0,0,0,0,0,0.4988662131519274,0.5011337868480725
93565,0.6774193548387096,0.36363636363636365,-210,175,0.6496074165168858,0.3503925834831142,away,SF,over,8.5,0.5238095238095238,-110,0.4988662131519274,LAD,SF,2024 REG,9,8,8,3,11,17,1,0,5,-5,1,1,1,0,0,0,0,0,0,0.4988662131519274,0.5011337868480725
93565,0.6774193548387096,0.36363636363636365,-210,175,0.6496074165168858,0.3503925834831142,home,LAD,under,8.5,0.5238095238095238,-110,0.5011337868480725,LAD,SF,2024 REG,9,8,8,3,11,17,1,0,5,-5,1,1,1,0,0,0,0,0,0,0.4988662131519274,0.5011337868480725
93566,0.5305164319248826,0.5121951219512195,-113,-105,0.5078572507605655,0.49214274923943446,away,NYY,over,8.5,0.5348837209302326,-115,0.5097020142727117,TOR,NYY,2024 REG,4,3,4,1,4,8,1,0,2,-2,1,0,0,0,0,0,0,0,0,0.5097020142727117,0.49029798572728833
93566,0.5305164319248826,0.5121951219512195,-113,-105,0.5078572507605655,0.49214274923943446,home,TOR,under,8.5,0.5121951219512195,-105,0.49029798572728833,TOR,NYY,2024 REG,4,3,4,1,4,8,1,0,2,-2,1,0,0,0,0,0,0,0,0,0.5097020142727117,0.49029798572728833
93568,0.6296296296296295,0.41152263374485604,-170,143,0.6037189452827312,0.3962810547172688,away,DET,over,8.5,0.5098039215686274,-104,0.48592421718142587,BOS,DET,2024 REG,12,7,7,3,10,19,1,0,4,-4,1,1,1,0,0,0,0,0,0,0.48592421718142587,0.5140757828185741
93568,0.6296296296296295,0.41152263374485604,-170,143,0.6037189452827312,0.3962810547172688,home,BOS,under,8.5,0.5370370370370371,-116,0.5140757828185741,BOS,DET,2024 REG,12,7,7,3,10,19,1,0,4,-4,1,1,1,0,0,0,0,0,0,0.48592421718142587,0.5140757828185741
93569,0.47619047619047616,0.5652173913043479,110,-130,0.4564724440500838,0.5435275559499162,away,SF,over,9.5,0.504950495049505,-102,0.47949844489399435,COL,SF,2024 REG,14,9,7,1,10,21,1,0,8,-8,1,0,0,0,0,0,0,0,0,0.47949844489399435,0.5205015551060057
93569,0.47619047619047616,0.5652173913043479,110,-130,0.4564724440500838,0.5435275559499162,home,COL,under,9.5,0.5454545454545454,-120,0.5205015551060057,COL,SF,2024 REG,14,9,7,1,10,21,1,0,8,-8,1,0,0,0,0,0,0,0,0,0.47949844489399435,0.5205015551060057
93571,0.5652173913043479,0.47619047619047616,-130,110,0.5418129444594474,0.4581870555405526,away,DET,over,8,0.5121951219512195,-105,0.48808156828023186,PIT,DET,2024 REG,12,7,9,4,11,21,1,0,3,-3,1,1,1,1,0,0,0,0,0,0.48808156828023186,0.5119184317197681
93571,0.5652173913043479,0.47619047619047616,-130,110,0.5418129444594474,0.4581870555405526,home,PIT,under,8,0.5348837209302326,-115,0.5119184317197681,PIT,DET,2024 REG,12,7,9,4,11,21,1,0,3,-3,1,1,1,1,0,0,0,0,0,0.48808156828023186,0.5119184317197681
93572,0.5305164319248826,0.5121951219512195,-113,-105,0.5078572507605655,0.49214274923943446,away,DET,over,8.5,0.5454545454545454,-120,0.5206611570247933,KC,DET,2024 REG,11,8,7,3,11,18,1,0,5,-5,1,1,1,0,0,0,0,0,0,0.5206611570247933,0.4793388429752067
93572,0.5305164319248826,0.5121951219512195,-113,-105,0.5078572507605655,0.49214274923943446,home,KC,under,8.5,0.5,100,0.4793388429752067,KC,DET,2024 REG,11,8,7,3,11,18,1,0,5,-5,1,1,1,0,0,0,0,0,0,0.5206611570247933,0.4793388429752067
93573,0.5348837209302326,0.5121951219512195,-115,-105,0.5097020142727117,0.49029798572728833,away,PHI,over,7,0.5305164319248826,-113,0.5041247242695369,NYM,PHI,2024 REG,8,4,8,5,9,16,0,1,-1,1,1,1,1,1,0,0,0,0,0,0.5041247242695369,0.4958752757304631
93573,0.5348837209302326,0.5121951219512195,-115,-105,0.5097020142727117,0.49029798572728833,home,NYM,under,7,0.5192307692307692,-108,0.4958752757304631,NYM,PHI,2024 REG,8,4,8,5,9,16,0,1,-1,1,1,1,1,1,0,0,0,0,0,0.5041247242695369,0.4958752757304631
93574,0.6168582375478928,0.425531914893617,-161,135,0.5907095228234366,0.4092904771765634,away,OAK,over,8.5,0.5,100,0.4772727272727273,TB,OAK,2024 REG,6,6,11,5,11,17,1,0,1,-1,1,1,1,1,1,0,0,0,0,0.4772727272727273,0.5227272727272727
93574,0.6168582375478928,0.425531914893617,-161,135,0.5907095228234366,0.4092904771765634,home,TB,under,8.5,0.5454545454545454,-120,0.5227272727272727,TB,OAK,2024 REG,6,6,11,5,11,17,1,0,1,-1,1,1,1,1,1,0,0,0,0,0.4772727272727273,0.5227272727272727
93575,0.5555555555555556,0.4854368932038835,-125,106,0.5327819729114227,0.4672180270885773,away,STL,over,8.5,0.5121951219512195,-105,0.48808156828023186,PIT,STL,2024 REG,11,5,8,4,9,19,1,0,1,-1,1,1,1,1,0,0,0,0,0,0.48808156828023186,0.5119184317197681
93575,0.5555555555555556,0.4854368932038835,-125,106,0.5327819729114227,0.4672180270885773,home,PIT,under,8.5,0.5348837209302326,-115,0.5119184317197681,PIT,STL,2024 REG,11,5,8,4,9,19,1,0,1,-1,1,1,1,1,0,0,0,0,0,0.48808156828023186,0.5119184317197681
93576,0.4444444444444444,0.6031746031746031,125,-152,0.4232804232804233,0.5767195767195767,away,SD,over,10.5,0.5348837209302326,-115,0.5097020142727117,COL,SD,2024 REG,5,2,8,5,7,13,0,1,-3,3,1,1,0,0,0,0,0,0,0,0.5097020142727117,0.49029798572728833
93576,0.4444444444444444,0.6031746031746031,125,-152,0.4232804232804233,0.5767195767195767,home,COL,under,10.5,0.5121951219512195,-105,0.49029798572728833,COL,SD,2024 REG,5,2,8,5,7,13,0,1,-3,3,1,1,0,0,0,0,0,0,0,0.5097020142727117,0.49029798572728833
93578,0.5967741935483871,0.4444444444444444,-148,125,0.5721759741010521,0.42782402589894786,away,TOR,over,7.5,0.5,100,0.4772727272727273,SEA,TOR,2024 REG,10,4,10,5,9,20,0,1,-1,1,1,1,1,1,0,0,0,0,0,0.4772727272727273,0.5227272727272727
93578,0.5967741935483871,0.4444444444444444,-148,125,0.5721759741010521,0.42782402589894786,home,SEA,under,7.5,0.5454545454545454,-120,0.5227272727272727,SEA,TOR,2024 REG,10,4,10,5,9,20,0,1,-1,1,1,1,1,1,0,0,0,0,0,0.4772727272727273,0.5227272727272727
93580,0.6825396825396826,0.35714285714285715,-215,180,0.6554547745023935,0.34454522549760647,away,MIL,over,7.5,0.5238095238095238,-110,0.5000596729920038,LAD,MIL,2024 REG,10,8,4,5,13,14,1,0,3,-3,1,1,1,1,1,0,0,0,0,0.5000596729920038,0.4999403270079962
93580,0.6825396825396826,0.35714285714285715,-215,180,0.6554547745023935,0.34454522549760647,home,LAD,under,7.5,0.5215311004784688,-109,0.4999403270079962,LAD,MIL,2024 REG,10,8,4,5,13,14,1,0,3,-3,1,1,1,1,1,0,0,0,0,0.5000596729920038,0.4999403270079962
93581,0.5073891625615764,0.5348837209302326,-103,-115,0.4859403596076043,0.5140596403923957,away,STL,over,8.5,0.5348837209302326,-115,0.5097020142727117,LAA,STL,2024 REG,7,5,10,10,15,17,0,1,-5,5,1,1,1,1,1,0,0,0,0,0.5097020142727117,0.49029798572728833
93581,0.5073891625615764,0.5348837209302326,-103,-115,0.4859403596076043,0.5140596403923957,home,LAA,under,8.5,0.5121951219512195,-105,0.49029798572728833,LAA,STL,2024 REG,7,5,10,10,15,17,0,1,-5,5,1,1,1,1,1,0,0,0,0,0.5097020142727117,0.49029798572728833
93582,0.6587030716723549,0.38167938931297707,-193,162,0.6321030205796278,0.36789697942037225,away,CIN,over,8.5,0.5121951219512195,-105,0.48808156828023186,LAD,CIN,2024 REG,9,7,8,3,10,17,1,0,4,-4,1,1,1,0,0,0,0,0,0,0.48808156828023186,0.5119184317197681
93582,0.6587030716723549,0.38167938931297707,-193,162,0.6321030205796278,0.36789697942037225,home,LAD,under,8.5,0.5348837209302326,-115,0.5119184317197681,LAD,CIN,2024 REG,9,7,8,3,10,17,1,0,4,-4,1,1,1,0,0,0,0,0,0,0.48808156828023186,0.5119184317197681
93583,0.5348837209302326,0.5121951219512195,-115,-105,0.5097020142727117,0.49029798572728833,away,DET,over,9,0.5121951219512195,-105,0.48808156828023186,KC,DET,2024 REG,15,10,6,3,13,21,1,0,7,-7,1,1,1,0,0,0,0,0,0,0.48808156828023186,0.5119184317197681
93583,0.5348837209302326,0.5121951219512195,-115,-105,0.5097020142727117,0.49029798572728833,home,KC,under,9,0.5348837209302326,-115,0.5119184317197681,KC,DET,2024 REG,15,10,6,3,13,21,1,0,7,-7,1,1,1,0,0,0,0,0,0,0.48808156828023186,0.5119184317197681
93584,0.5815899581589958,0.4587155963302753,-139,118,0.5581486524100054,0.44185134758999456,away,SD,over,8.5,0.5348837209302326,-115,0.5097020142727117,BOS,SD,2024 REG,6,1,16,11,12,22,0,1,-10,10,1,0,0,0,0,0,0,0,0,0.5097020142727117,0.49029798572728833
93584,0.5815899581589958,0.4587155963302753,-139,118,0.5581486524100054,0.44185134758999456,home,BOS,under,8.5,0.5121951219512195,-105,0.49029798572728833,BOS,SD,2024 REG,6,1,16,11,12,22,0,1,-10,10,1,0,0,0,0,0,0,0,0,0.5097020142727117,0.49029798572728833
93587,0.5454545454545454,0.5,-120,100,0.5206611570247933,0.4793388429752067,away,ATL,over,8.5,0.5495495495495495,-122,0.5250401592387142,BAL,ATL,2024 REG,9,4,7,2,6,16,1,0,2,-2,1,1,0,0,0,0,0,0,0,0.5250401592387142,0.47495984076128583
93587,0.5454545454545454,0.5,-120,100,0.5206611570247933,0.4793388429752067,home,BAL,under,8.5,0.49504950495049505,102,0.47495984076128583,BAL,ATL,2024 REG,9,4,7,2,6,16,1,0,2,-2,1,1,0,0,0,0,0,0,0,0.5250401592387142,0.47495984076128583
93588,0.3921568627450981,0.6515679442508712,155,-187,0.3750098796094239,0.6249901203905761,away,SEA,over,9.5,0.5348837209302326,-115,0.5097020142727117,COL,SEA,2024 REG,3,0,16,7,7,19,0,1,-7,7,0,0,0,0,0,0,0,0,0,0.5097020142727117,0.49029798572728833
93588,0.3921568627450981,0.6515679442508712,155,-187,0.3750098796094239,0.6249901203905761,home,COL,under,9.5,0.5121951219512195,-105,0.49029798572728833,COL,SEA,2024 REG,3,0,16,7,7,19,0,1,-7,7,0,0,0,0,0,0,0,0,0,0.5097020142727117,0.49029798572728833
93589,0.5370370370370371,0.5024875621890548,-116,-101,0.5158108633785803,0.4841891366214197,away,ATL,over,8.5,0.5454545454545454,-120,0.5179608869977906,NYY,ATL,2024 REG,7,1,6,3,4,13,0,1,-2,2,1,0,0,0,0,0,0,0,0,0.5179608869977906,0.48203911300220936
93589,0.5370370370370371,0.5024875621890548,-116,-101,0.5158108633785803,0.4841891366214197,home,NYY,under,8.5,0.504950495049505,-102,0.48203911300220936,NYY,ATL,2024 REG,7,1,6,3,4,13,0,1,-2,2,1,0,0,0,0,0,0,0,0,0.5179608869977906,0.48203911300220936
93590,0.6774193548387096,0.36363636363636365,-210,175,0.6496074165168858,0.3503925834831142,away,CWS,over,8,0.5348837209302326,-115,0.5097020142727117,MIN,CWS,2024 REG,10,6,9,3,9,19,1,0,3,-3,1,1,1,0,0,0,0,0,0,0.5097020142727117,0.49029798572728833
93590,0.6774193548387096,0.36363636363636365,-210,175,0.6496074165168858,0.3503925834831142,home,MIN,under,8,0.5121951219512195,-105,0.49029798572728833,MIN,CWS,2024 REG,10,6,9,3,9,19,1,0,3,-3,1,1,1,0,0,0,0,0,0,0.5097020142727117,0.49029798572728833
93593,0.6666666666666666,0.37453183520599254,-200,167,0.6392009987515606,0.36079900124843944,away,SD,over,8.5,0.5,100,0.47522522522522526,LAD,SD,2024 REG,7,7,10,8,15,17,0,1,-1,1,1,1,1,1,1,1,1,0,0,0.47522522522522526,0.5247747747747747
93593,0.6666666666666666,0.37453183520599254,-200,167,0.6392009987515606,0.36079900124843944,home,LAD,under,8.5,0.5495495495495495,-122,0.5247747747747747,LAD,SD,2024 REG,7,7,10,8,15,17,0,1,-1,1,1,1,1,1,1,1,1,0,0,0.47522522522522526,0.5247747747747747
93594,0.6323529411764706,0.4081632653061224,-172,145,0.6067323988418897,0.3932676011581103,away,CLE,over,8,0.5348837209302326,-115,0.5097020142727117,MIN,CLE,2024 REG,2,1,7,3,4,9,0,1,-2,2,1,0,0,0,0,0,0,0,0,0.5097020142727117,0.49029798572728833
93594,0.6323529411764706,0.4081632653061224,-172,145,0.6067323988418897,0.3932676011581103,home,MIN,under,8,0.5121951219512195,-105,0.49029798572728833,MIN,CLE,2024 REG,2,1,7,3,4,9,0,1,-2,2,1,0,0,0,0,0,0,0,0,0.5097020142727117,0.49029798572728833
93595,0.5,0.5454545454545454,100,-120,0.4772727272727273,0.5227272727272727,away,MIL,over,8.5,0.5121951219512195,-105,0.48808156828023186,SD,MIL,2024 REG,10,6,10,4,10,20,1,0,2,-2,1,1,1,1,0,0,0,0,0,0.48808156828023186,0.5119184317197681
93595,0.5,0.5454545454545454,100,-120,0.4772727272727273,0.5227272727272727,home,SD,under,8.5,0.5348837209302326,-115,0.5119184317197681,SD,MIL,2024 REG,10,6,10,4,10,20,1,0,2,-2,1,1,1,1,0,0,0,0,0,0.48808156828023186,0.5119184317197681
93598,0.5121951219512195,0.5348837209302326,-105,-115,0.48808156828023186,0.5119184317197681,away,LAD,over,9.5,0.5305164319248826,-113,0.5053568787472517,ARI,LAD,2024 REG,10,4,5,3,7,15,1,0,1,-1,1,1,1,0,0,0,0,0,0,0.5053568787472517,0.49464312125274834
93598,0.5121951219512195,0.5348837209302326,-105,-115,0.48808156828023186,0.5119184317197681,home,ARI,under,9.5,0.5169082125603864,-107,0.49464312125274834,ARI,LAD,2024 REG,10,4,5,3,7,15,1,0,1,-1,1,1,1,0,0,0,0,0,0,0.5053568787472517,0.49464312125274834
93600,0.48780487804878053,0.5555555555555556,105,-125,0.4666534470222751,0.5333465529777248,away,MIN,over,8.5,0.5215311004784688,-109,0.49670754937970685,KC,MIN,2024 REG,5,1,10,4,5,15,0,1,-3,3,1,0,0,0,0,0,0,0,0,0.49670754937970685,0.5032924506202932
93600,0.48780487804878053,0.5555555555555556,105,-125,0.4666534470222751,0.5333465529777248,home,KC,under,8.5,0.5260663507109005,-111,0.5032924506202932,KC,MIN,2024 REG,5,1,10,4,5,15,0,1,-3,3,1,0,0,0,0,0,0,0,0,0.49670754937970685,0.5032924506202932
93602,0.7333333333333333,0.3076923076923077,-275,225,0.7032478632478633,0.29675213675213674,away,COL,over,8,0.5348837209302326,-115,0.5097020142727117,HOU,COL,2024 REG,9,5,6,2,7,15,1,0,3,-3,1,1,0,0,0,0,0,0,0,0.5097020142727117,0.49029798572728833
93602,0.7333333333333333,0.3076923076923077,-275,225,0.7032478632478633,0.29675213675213674,home,HOU,under,8,0.5121951219512195,-105,0.49029798572728833,HOU,COL,2024 REG,9,5,6,2,7,15,1,0,3,-3,1,1,0,0,0,0,0,0,0,0.5097020142727117,0.49029798572728833
93605,0.6108949416342413,0.4291845493562232,-157,133,0.5864105833248914,0.4135894166751086,away,ARI,over,8.5,0.5454545454545454,-120,0.5206611570247933,BAL,ARI,2024 REG,13,5,7,4,9,20,1,0,1,-1,1,1,1,1,0,0,0,0,0,0.5206611570247933,0.4793388429752067
93605,0.6108949416342413,0.4291845493562232,-157,133,0.5864105833248914,0.4135894166751086,home,BAL,under,8.5,0.5,100,0.4793388429752067,BAL,ARI,2024 REG,13,5,7,4,9,20,1,0,1,-1,1,1,1,1,0,0,0,0,0,0.5206611570247933,0.4793388429752067
93606,0.6226415094339623,0.4166666666666667,-165,140,0.5981666073335706,0.40183339266642937,away,LAA,over,8.5,0.5192307692307692,-108,0.49571111079951763,TB,LAA,2024 REG,6,3,13,7,10,19,0,1,-4,4,1,1,1,0,0,0,0,0,0,0.49571111079951763,0.5042888892004824
93606,0.6226415094339623,0.4166666666666667,-165,140,0.5981666073335706,0.40183339266642937,home,TB,under,8.5,0.5260663507109005,-111,0.5042888892004824,TB,LAA,2024 REG,6,3,13,7,10,19,0,1,-4,4,1,1,1,0,0,0,0,0,0,0.49571111079951763,0.5042888892004824
93608,0.5983935742971888,0.44052863436123346,-149,127,0.5751027747385346,0.42489722526146545,away,LAA,over,8.5,0.5098039215686274,-104,0.48483656587239576,TB,LAA,2024 REG,7,7,6,6,13,13,1,0,1,-1,1,1,1,1,1,1,0,0,0,0.48483656587239576,0.5151634341276042
93608,0.5983935742971888,0.44052863436123346,-149,127,0.5751027747385346,0.42489722526146545,home,TB,under,8.5,0.5391705069124424,-117,0.5151634341276042,TB,LAA,2024 REG,7,7,6,6,13,13,1,0,1,-1,1,1,1,1,1,1,0,0,0,0.48483656587239576,0.5151634341276042
93610,0.34965034965034963,0.6923076923076923,186,-225,0.33497970560907625,0.6650202943909238,away,MIN,over,9,0.5192307692307692,-108,0.49455035168025013,CWS,MIN,2024 REG,7,5,12,10,15,19,0,1,-5,5,1,1,1,1,1,0,0,0,0,0.49455035168025013,0.5054496483197499
93610,0.34965034965034963,0.6923076923076923,186,-225,0.33497970560907625,0.6650202943909238,home,CWS,under,9,0.5283018867924528,-112,0.5054496483197499,CWS,MIN,2024 REG,7,5,12,10,15,19,0,1,-5,5,1,1,1,1,1,0,0,0,0,0.49455035168025013,0.5054496483197499
93611,0.5475113122171946,0.49504950495049505,-121,102,0.5242087833606768,0.4757912166393232,away,NYM,over,9,0.5454545454545454,-120,0.5206611570247933,CLE,NYM,2024 REG,7,7,11,6,13,18,1,0,1,-1,1,1,1,1,1,1,0,0,0,0.5206611570247933,0.4793388429752067
93611,0.5475113122171946,0.49504950495049505,-121,102,0.5242087833606768,0.4757912166393232,home,CLE,under,9,0.5,100,0.4793388429752067,CLE,NYM,2024 REG,7,7,11,6,13,18,1,0,1,-1,1,1,1,1,1,1,0,0,0,0.5206611570247933,0.4793388429752067
93612,0.4,0.6389891696750902,150,-177,0.3844043321299639,0.6155956678700361,away,HOU,over,9,0.5169082125603864,-107,0.49239402434819424,CWS,HOU,2024 REG,6,3,11,5,8,17,0,1,-2,2,1,1,1,0,0,0,0,0,0,0.49239402434819424,0.5076059756518058
93612,0.4,0.6389891696750902,150,-177,0.3844043321299639,0.6155956678700361,home,CWS,under,9,0.5305164319248826,-113,0.5076059756518058,CWS,HOU,2024 REG,6,3,11,5,8,17,0,1,-2,2,1,1,1,0,0,0,0,0,0,0.49239402434819424,0.5076059756518058
93613,0.6794871794871794,0.3623188405797102,-212,176,0.651080524826344,0.34891947517365596,away,SF,over,7.5,0.5283018867924528,-112,0.5044173060022736,ATL,SF,2024 REG,10,3,4,1,4,14,1,0,2,-2,1,0,0,0,0,0,0,0,0,0.5044173060022736,0.49558269399772636
93613,0.6794871794871794,0.3623188405797102,-212,176,0.651080524826344,0.34891947517365596,home,ATL,under,7.5,0.5169082125603864,-107,0.49558269399772636,ATL,SF,2024 REG,10,3,4,1,4,14,1,0,2,-2,1,0,0,0,0,0,0,0,0,0.5044173060022736,0.49558269399772636
93614,0.42016806722689076,0.6197718631178707,138,-163,0.4033865838887557,0.5966134161112443,away,STL,over,9,0.5,100,0.4772727272727273,WSH,STL,2024 REG,14,6,14,7,13,28,0,1,-1,1,1,1,1,1,1,1,0,0,0,0.4772727272727273,0.5227272727272727
93614,0.42016806722689076,0.6197718631178707,138,-163,0.4033865838887557,0.5966134161112443,home,WSH,under,9,0.5454545454545454,-120,0.5227272727272727,WSH,STL,2024 REG,14,6,14,7,13,28,0,1,-1,1,1,1,1,1,1,1,0,0,0,0.4772727272727273,0.5227272727272727
93615,0.43859649122807015,0.6031746031746031,128,-152,0.4202758357883012,0.5797241642116988,away,NYY,over,9.5,0.5,100,0.4772727272727273,BOS,NYY,2024 REG,5,1,10,8,9,15,0,1,-7,7,1,0,0,0,0,0,0,0,0,0.4772727272727273,0.5227272727272727
93615,0.43859649122807015,0.6031746031746031,128,-152,0.4202758357883012,0.5797241642116988,home,BOS,under,9.5,0.5454545454545454,-120,0.5227272727272727,BOS,NYY,2024 REG,5,1,10,8,9,15,0,1,-7,7,1,0,0,0,0,0,0,0,0,0.4772727272727273,0.5227272727272727
93616,0.626865671641791,0.41493775933609955,-168,141,0.6006605358049044,0.3993394641950956,away,CLE,over,7,0.5412844036697247,-118,0.5149381613977361,MIN,CLE,2024 REG,7,2,7,4,6,14,0,1,-2,2,1,1,0,0,0,0,0,0,0,0.5149381613977361,0.48506183860226393
93616,0.626865671641791,0.41493775933609955,-168,141,0.6006605358049044,0.3993394641950956,home,MIN,under,7,0.5073891625615764,-103,0.48506183860226393,MIN,CLE,2024 REG,7,2,7,4,6,14,0,1,-2,2,1,1,0,0,0,0,0,0,0,0.5149381613977361,0.48506183860226393
93618,0.5867768595041323,0.45248868778280543,-142,121,0.563736744980392,0.43626325501960805,away,BOS,over,8,0.5348837209302326,-115,0.5097020142727117,NYY,BOS,2024 REG,6,3,8,5,8,14,0,1,-2,2,1,1,1,0,0,0,0,0,0,0.5097020142727117,0.49029798572728833
93618,0.5867768595041323,0.45248868778280543,-142,121,0.563736744980392,0.43626325501960805,home,NYY,under,8,0.5121951219512195,-105,0.49029798572728833,NYY,BOS,2024 REG,6,3,8,5,8,14,0,1,-2,2,1,1,1,0,0,0,0,0,0,0.5097020142727117,0.49029798572728833
93621,0.7275204359673024,0.31545741324921134,-267,217,0.6962531723683673,0.30374682763163274,away,MIA,over,8.5,0.5098039215686274,-104,0.48592421718142587,ATL,MIA,2024 REG,10,5,3,0,5,13,1,0,5,-5,0,0,0,0,0,0,0,0,0,0.48592421718142587,0.5140757828185741
93621,0.7275204359673024,0.31545741324921134,-267,217,0.6962531723683673,0.30374682763163274,home,ATL,under,8.5,0.5370370370370371,-116,0.5140757828185741,ATL,MIA,2024 REG,10,5,3,0,5,13,1,0,5,-5,0,0,0,0,0,0,0,0,0,0.48592421718142587,0.5140757828185741
93622,0.574468085106383,0.46511627906976744,-135,115,0.5517281312179562,0.44827186878204384,away,CHC,over,7.5,0.5260663507109005,-111,0.5010269332605688,SD,CHC,2024 REG,8,9,8,8,17,16,1,0,1,-1,1,1,1,1,1,1,1,1,0,0.5010269332605688,0.4989730667394312
93622,0.574468085106383,0.46511627906976744,-135,115,0.5517281312179562,0.44827186878204384,home,SD,under,7.5,0.5215311004784688,-109,0.4989730667394312,SD,CHC,2024 REG,8,9,8,8,17,16,1,0,1,-1,1,1,1,1,1,1,1,1,0,0.5010269332605688,0.4989730667394312
93623,0.5192307692307692,0.5260663507109005,-108,-111,0.49571111079951763,0.5042888892004824,away,DET,over,8.5,0.5454545454545454,-120,0.5206611570247933,LAA,DET,2024 REG,9,6,8,7,13,17,0,1,-1,1,1,1,1,1,1,1,0,0,0,0.5206611570247933,0.4793388429752067
93623,0.5192307692307692,0.5260663507109005,-108,-111,0.49571111079951763,0.5042888892004824,home,LAA,under,8.5,0.5,100,0.4793388429752067,LAA,DET,2024 REG,9,6,8,7,13,17,0,1,-1,1,1,1,1,1,1,1,0,0,0,0.5206611570247933,0.4793388429752067
93624,0.5652173913043479,0.47619047619047616,-130,110,0.5418129444594474,0.4581870555405526,away,MIL,over,7.5,0.5238095238095238,-110,0.4988662131519274,NYM,MIL,2024 REG,12,6,16,7,13,28,0,1,-1,1,1,1,1,1,1,1,0,0,0,0.4988662131519274,0.5011337868480725
93624,0.5652173913043479,0.47619047619047616,-130,110,0.5418129444594474,0.4581870555405526,home,NYM,under,7.5,0.5238095238095238,-110,0.5011337868480725,NYM,MIL,2024 REG,12,6,16,7,13,28,0,1,-1,1,1,1,1,1,1,1,0,0,0,0.4988662131519274,0.5011337868480725
93627,0.5515695067264574,0.48780487804878053,-123,105,0.5298517967383217,0.4701482032616783,away,STL,over,9.5,0.5121951219512195,-105,0.48808156828023186,ARI,STL,2024 REG,9,6,14,9,15,23,0,1,-3,3,1,1,1,1,1,1,0,0,0,0.48808156828023186,0.5119184317197681
93627,0.5515695067264574,0.48780487804878053,-123,105,0.5298517967383217,0.4701482032616783,home,ARI,under,9.5,0.5348837209302326,-115,0.5119184317197681,ARI,STL,2024 REG,9,6,14,9,15,23,0,1,-3,3,1,1,1,1,1,1,0,0,0,0.48808156828023186,0.5119184317197681
93628,0.48780487804878053,0.5535714285714286,105,-124,0.4676213138438005,0.5323786861561994,away,LAD,over,8.5,0.5098039215686274,-104,0.48483656587239576,NYM,LAD,2024 REG,3,0,10,3,3,13,0,1,-3,3,0,0,0,0,0,0,0,0,0,0.48483656587239576,0.5151634341276042
93628,0.48780487804878053,0.5535714285714286,105,-124,0.4676213138438005,0.5323786861561994,home,NYM,under,8.5,0.5391705069124424,-117,0.5151634341276042,NYM,LAD,2024 REG,3,0,10,3,3,13,0,1,-3,3,0,0,0,0,0,0,0,0,0,0.48483656587239576,0.5151634341276042
93629,0.4566210045662101,0.5833333333333333,119,-140,0.4383770146577428,0.5616229853422572,away,BAL,over,8.5,0.5454545454545454,-120,0.5206611570247933,PIT,BAL,2024 REG,11,5,4,4,9,15,1,0,1,-1,1,1,1,1,0,0,0,0,0,0.5206611570247933,0.4793388429752067
93629,0.4566210045662101,0.5833333333333333,119,-140,0.4383770146577428,0.5616229853422572,home,PIT,under,8.5,0.5,100,0.4793388429752067,PIT,BAL,2024 REG,11,5,4,4,9,15,1,0,1,-1,1,1,1,1,0,0,0,0,0,0.5206611570247933,0.4793388429752067
93630,0.576271186440678,0.4629629629629629,-136,116,0.553661676614851,0.446338323385149,away,TOR,over,7,0.5454545454545454,-120,0.5206611570247933,SEA,TOR,2024 REG,8,2,2,1,3,10,1,0,1,-1,1,0,0,0,0,0,0,0,0,0.5206611570247933,0.4793388429752067
93630,0.576271186440678,0.4629629629629629,-136,116,0.553661676614851,0.446338323385149,home,SEA,under,7,0.5,100,0.4793388429752067,SEA,TOR,2024 REG,8,2,2,1,3,10,1,0,1,-1,1,0,0,0,0,0,0,0,0,0.5206611570247933,0.4793388429752067
93631,0.6168582375478928,0.425531914893617,-161,135,0.5907095228234366,0.4092904771765634,away,TOR,over,7,0.5454545454545454,-120,0.5206611570247933,SF,TOR,2024 REG,9,6,14,10,16,23,0,1,-4,4,1,1,1,1,1,1,0,0,0,0.5206611570247933,0.4793388429752067
93631,0.6168582375478928,0.425531914893617,-161,135,0.5907095228234366,0.4092904771765634,home,SF,under,7,0.5,100,0.4793388429752067,SF,TOR,2024 REG,9,6,14,10,16,23,0,1,-4,4,1,1,1,1,1,1,0,0,0,0.5206611570247933,0.4793388429752067
93633,0.4098360655737705,0.6296296296296295,144,-170,0.3936616003264754,0.6063383996735245,away,PIT,over,10.5,0.5391705069124424,-117,0.5127649394825569,COL,PIT,2024 REG,16,16,11,4,20,27,1,0,12,-12,1,1,1,1,0,0,0,0,0,0.5127649394825569,0.48723506051744314
93633,0.4098360655737705,0.6296296296296295,144,-170,0.3936616003264754,0.6063383996735245,home,COL,under,10.5,0.5098039215686274,-104,0.48723506051744314,COL,PIT,2024 REG,16,16,11,4,20,27,1,0,12,-12,1,1,1,1,0,0,0,0,0,0.5127649394825569,0.48723506051744314
93634,0.5495495495495495,0.4926108374384236,-122,103,0.5263803278714742,0.47361967212852585,away,CHC,over,10,0.5391705069124424,-117,0.5114756747601454,ARI,CHC,2024 REG,12,12,14,11,23,26,1,0,1,-1,1,1,1,1,1,1,1,1,1,0.5114756747601454,0.48852432523985456
93634,0.5495495495495495,0.4926108374384236,-122,103,0.5263803278714742,0.47361967212852585,home,ARI,under,10,0.5121951219512195,-105,0.48852432523985456,ARI,CHC,2024 REG,12,12,14,11,23,26,1,0,1,-1,1,1,1,1,1,1,1,1,1,0.5114756747601454,0.48852432523985456
93635,0.7118155619596541,0.3333333333333333,-247,200,0.6796778756848186,0.32032212431518137,away,COL,over,7.5,0.49504950495049505,102,0.4719707862985384,SD,COL,2024 REG,4,0,12,8,8,16,0,1,-8,8,0,0,0,0,0,0,0,0,0,0.4719707862985384,0.5280292137014616
93635,0.7118155619596541,0.3333333333333333,-247,200,0.6796778756848186,0.32032212431518137,home,SD,under,7.5,0.5515695067264574,-123,0.5280292137014616,SD,COL,2024 REG,4,0,12,8,8,16,0,1,-8,8,0,0,0,0,0,0,0,0,0,0.4719707862985384,0.5280292137014616
93636,0.5901639344262295,0.4504504504504505,-144,122,0.5661947892531068,0.43380521074689316,away,PIT,over,8,0.5098039215686274,-104,0.48592421718142587,SF,PIT,2024 REG,6,3,8,0,3,14,1,0,3,-3,0,0,0,0,0,0,0,0,0,0.48592421718142587,0.5140757828185741
93636,0.5901639344262295,0.4504504504504505,-144,122,0.5661947892531068,0.43380521074689316,home,SF,under,8,0.5370370370370371,-116,0.5140757828185741,SF,PIT,2024 REG,6,3,8,0,3,14,1,0,3,-3,0,0,0,0,0,0,0,0,0,0.48592421718142587,0.5140757828185741
93637,0.5145631067961165,0.5260663507109005,-106,-111,0.49365668691386505,0.506343313086135,away,ARI,over,8,0.5348837209302326,-115,0.5097020142727117,NYM,ARI,2024 REG,5,4,9,5,9,14,0,1,-1,1,1,1,1,1,0,0,0,0,0,0.5097020142727117,0.49029798572728833
93637,0.5145631067961165,0.5260663507109005,-106,-111,0.49365668691386505,0.506343313086135,home,NYM,under,8,0.5121951219512195,-105,0.49029798572728833,NYM,ARI,2024 REG,5,4,9,5,9,14,0,1,-1,1,1,1,1,1,0,0,0,0,0,0.5097020142727117,0.49029798572728833
93638,0.5121951219512195,0.5348837209302326,-105,-115,0.48808156828023186,0.5119184317197681,away,PIT,over,12,0.5305164319248826,-113,0.5041247242695369,COL,PIT,2024 REG,9,2,15,8,10,24,0,1,-6,6,1,1,0,0,0,0,0,0,0,0.5041247242695369,0.4958752757304631
93638,0.5121951219512195,0.5348837209302326,-105,-115,0.48808156828023186,0.5119184317197681,home,COL,under,12,0.5192307692307692,-108,0.4958752757304631,COL,PIT,2024 REG,9,2,15,8,10,24,0,1,-6,6,1,1,0,0,0,0,0,0,0,0.5041247242695369,0.4958752757304631
93639,0.5,0.5391705069124424,100,-117,0.4804147465437788,0.5195852534562212,away,TEX,over,8.5,0.5121951219512195,-105,0.48919479393107135,MIL,TEX,2024 REG,11,6,10,5,11,21,1,0,1,-1,1,1,1,1,1,0,0,0,0,0.48919479393107135,0.5108052060689287
93639,0.5,0.5391705069124424,100,-117,0.4804147465437788,0.5195852534562212,home,MIL,under,8.5,0.5327102803738317,-114,0.5108052060689287,MIL,TEX,2024 REG,11,6,10,5,11,21,1,0,1,-1,1,1,1,1,1,0,0,0,0,0.48919479393107135,0.5108052060689287
93643,0.5391705069124424,0.5,-117,100,0.5180509248444435,0.4819490751555565,away,TEX,over,8.5,0.5454545454545454,-120,0.5206611570247933,KC,TEX,2024 REG,11,7,7,1,8,18,1,0,6,-6,1,0,0,0,0,0,0,0,0,0.5206611570247933,0.4793388429752067
93643,0.5391705069124424,0.5,-117,100,0.5180509248444435,0.4819490751555565,home,KC,under,8.5,0.5,100,0.4793388429752067,KC,TEX,2024 REG,11,7,7,1,8,18,1,0,6,-6,1,0,0,0,0,0,0,0,0,0.5206611570247933,0.4793388429752067
93644,0.5,0.5454545454545454,100,-120,0.4772727272727273,0.5227272727272727,away,KC,over,8.5,0.5,100,0.4772727272727273,LAA,KC,2024 REG,5,4,12,10,14,17,0,1,-6,6,1,1,1,1,0,0,0,0,0,0.4772727272727273,0.5227272727272727
93644,0.5,0.5454545454545454,100,-120,0.4772727272727273,0.5227272727272727,home,LAA,under,8.5,0.5454545454545454,-120,0.5227272727272727,LAA,KC,2024 REG,5,4,12,10,14,17,0,1,-6,6,1,1,1,1,0,0,0,0,0,0.4772727272727273,0.5227272727272727
93645,0.7058823529411764,0.3367003367003367,-240,197,0.6758239837824612,0.3241760162175388,away,COL,over,8,0.504950495049505,-102,0.48160416005266615,PHI,COL,2024 REG,12,7,11,6,13,23,1,0,1,-1,1,1,1,1,1,1,0,0,0,0.48160416005266615,0.5183958399473338
93645,0.7058823529411764,0.3367003367003367,-240,197,0.6758239837824612,0.3241760162175388,home,PHI,under,8,0.5412844036697247,-118,0.5183958399473338,PHI,COL,2024 REG,12,7,11,6,13,23,1,0,1,-1,1,1,1,1,1,1,0,0,0,0.48160416005266615,0.5183958399473338
93646,0.5652173913043479,0.47619047619047616,-130,110,0.5418129444594474,0.4581870555405526,away,LAA,over,10,0.5348837209302326,-115,0.5097020142727117,BOS,LAA,2024 REG,7,5,9,4,9,16,1,0,1,-1,1,1,1,1,0,0,0,0,0,0.5097020142727117,0.49029798572728833
93646,0.5652173913043479,0.47619047619047616,-130,110,0.5418129444594474,0.4581870555405526,home,BOS,under,10,0.5121951219512195,-105,0.49029798572728833,BOS,LAA,2024 REG,7,5,9,4,9,16,1,0,1,-1,1,1,1,1,0,0,0,0,0,0.5097020142727117,0.49029798572728833
93648,0.5215311004784688,0.5238095238095238,-109,-110,0.4978845547971712,0.5021154452028288,away,PIT,over,8.5,0.5145631067961165,-106,0.4913668392989033,WSH,PIT,2024 REG,8,4,15,8,12,23,0,1,-4,4,1,1,1,1,0,0,0,0,0,0.4913668392989033,0.5086331607010968
93648,0.5215311004784688,0.5238095238095238,-109,-110,0.4978845547971712,0.5021154452028288,home,WSH,under,8.5,0.5305164319248826,-113,0.5086331607010968,WSH,PIT,2024 REG,8,4,15,8,12,23,0,1,-4,4,1,1,1,1,0,0,0,0,0,0.4913668392989033,0.5086331607010968
93652,0.5594713656387665,0.47846889952153115,-127,109,0.5382448736768379,0.46175512632316207,away,TOR,over,8,0.5121951219512195,-105,0.48808156828023186,TB,TOR,2024 REG,10,8,6,2,10,16,1,0,6,-6,1,1,0,0,0,0,0,0,0,0.48808156828023186,0.5119184317197681
93652,0.5594713656387665,0.47846889952153115,-127,109,0.5382448736768379,0.46175512632316207,home,TB,under,8,0.5348837209302326,-115,0.5119184317197681,TB,TOR,2024 REG,10,8,6,2,10,16,1,0,6,-6,1,1,0,0,0,0,0,0,0,0.48808156828023186,0.5119184317197681
93653,0.49751243781094534,0.5475113122171946,101,-121,0.47511256217505476,0.5248874378249453,away,MIN,over,8,0.5238095238095238,-110,0.4988662131519274,KC,MIN,2024 REG,5,1,7,5,6,12,0,1,-4,4,1,0,0,0,0,0,0,0,0,0.4988662131519274,0.5011337868480725
93653,0.49751243781094534,0.5475113122171946,101,-121,0.47511256217505476,0.5248874378249453,home,KC,under,8,0.5238095238095238,-110,0.5011337868480725,KC,MIN,2024 REG,5,1,7,5,6,12,0,1,-4,4,1,0,0,0,0,0,0,0,0,0.4988662131519274,0.5011337868480725
93655,0.4347826086956522,0.607843137254902,130,-155,0.41624967567367205,0.583750324326328,away,CIN,over,9,0.5348837209302326,-115,0.5097020142727117,CWS,CIN,2024 REG,8,4,11,11,15,19,0,1,-7,7,1,1,1,1,0,0,0,0,0,0.5097020142727117,0.49029798572728833
93655,0.4347826086956522,0.607843137254902,130,-155,0.41624967567367205,0.583750324326328,home,CWS,under,9,0.5121951219512195,-105,0.49029798572728833,CWS,CIN,2024 REG,8,4,11,11,15,19,0,1,-7,7,1,1,1,1,0,0,0,0,0,0.5097020142727117,0.49029798572728833
93656,0.47619047619047616,0.5652173913043479,110,-130,0.4564724440500838,0.5435275559499162,away,NYM,over,9,0.5327102803738317,-114,0.5075272610403079,PIT,NYM,2024 REG,6,2,9,3,5,15,0,1,-1,1,1,1,0,0,0,0,0,0,0,0.5075272610403079,0.4924727389596921
93656,0.47619047619047616,0.5652173913043479,110,-130,0.4564724440500838,0.5435275559499162,home,PIT,under,9,0.5145631067961165,-106,0.4924727389596921,PIT,NYM,2024 REG,6,2,9,3,5,15,0,1,-1,1,1,1,0,0,0,0,0,0,0,0.5075272610403079,0.4924727389596921
93657,0.5121951219512195,0.5348837209302326,-105,-115,0.48808156828023186,0.5119184317197681,away,NYY,over,8.5,0.5073891625615764,-103,0.48484779035144243,MIN,NYY,2024 REG,7,1,13,5,6,20,0,1,-4,4,1,0,0,0,0,0,0,0,0,0.48484779035144243,0.5151522096485576
93657,0.5121951219512195,0.5348837209302326,-105,-115,0.48808156828023186,0.5119184317197681,home,MIN,under,8.5,0.5370370370370371,-116,0.5151522096485576,MIN,NYY,2024 REG,7,1,13,5,6,20,0,1,-4,4,1,0,0,0,0,0,0,0,0,0.48484779035144243,0.5151522096485576
93658,0.4672897196261683,0.5726495726495727,114,-134,0.44862649893656975,0.5513735010634302,away,ATL,over,8.5,0.5215311004784688,-109,0.49670754937970685,WSH,ATL,2024 REG,12,7,7,3,10,19,1,0,4,-4,1,1,1,0,0,0,0,0,0,0.49670754937970685,0.5032924506202932
93658,0.4672897196261683,0.5726495726495727,114,-134,0.44862649893656975,0.5513735010634302,home,WSH,under,8.5,0.5260663507109005,-111,0.5032924506202932,WSH,ATL,2024 REG,12,7,7,3,10,19,1,0,4,-4,1,1,1,0,0,0,0,0,0,0.49670754937970685,0.5032924506202932
93660,0.7237569060773481,0.31746031746031744,-262,215,0.6939256558926289,0.3060743441073711,away,COL,over,8.5,0.5098039215686274,-104,0.48592421718142587,PHI,COL,2024 REG,7,5,7,0,5,14,1,0,5,-5,0,0,0,0,0,0,0,0,0,0.48592421718142587,0.5140757828185741
93660,0.7237569060773481,0.31746031746031744,-262,215,0.6939256558926289,0.3060743441073711,home,PHI,under,8.5,0.5370370370370371,-116,0.5140757828185741,PHI,COL,2024 REG,7,5,7,0,5,14,1,0,5,-5,0,0,0,0,0,0,0,0,0,0.48592421718142587,0.5140757828185741
93661,0.6503496503496503,0.390625,-186,156,0.623701800821556,0.376298199178444,away,MIA,over,9.5,0.5073891625615764,-103,0.48484779035144243,ARI,MIA,2024 REG,5,3,11,2,5,16,1,0,1,-1,1,1,0,0,0,0,0,0,0,0.48484779035144243,0.5151522096485576
93661,0.6503496503496503,0.390625,-186,156,0.623701800821556,0.376298199178444,home,ARI,under,9.5,0.5370370370370371,-116,0.5151522096485576,ARI,MIA,2024 REG,5,3,11,2,5,16,1,0,1,-1,1,1,0,0,0,0,0,0,0,0.48484779035144243,0.5151522096485576
93662,0.5192307692307692,0.5238095238095238,-108,-110,0.49688292476754015,0.5031170752324599,away,NYM,over,9,0.5348837209302326,-115,0.5097020142727117,CLE,NYM,2024 REG,8,6,8,3,9,16,1,0,3,-3,1,1,1,0,0,0,0,0,0,0.5097020142727117,0.49029798572728833
93662,0.5192307692307692,0.5238095238095238,-108,-110,0.49688292476754015,0.5031170752324599,home,CLE,under,9,0.5121951219512195,-105,0.49029798572728833,CLE,NYM,2024 REG,8,6,8,3,9,16,1,0,3,-3,1,1,1,0,0,0,0,0,0,0.5097020142727117,0.49029798572728833
93663,0.5283018867924528,0.5169082125603864,-112,-107,0.5044173060022736,0.49558269399772636,away,LAA,over,9,0.5,100,0.4772727272727273,MIA,LAA,2024 REG,9,4,7,7,11,16,0,1,-3,3,1,1,1,1,0,0,0,0,0,0.4772727272727273,0.5227272727272727
93663,0.5283018867924528,0.5169082125603864,-112,-107,0.5044173060022736,0.49558269399772636,home,MIA,under,9,0.5454545454545454,-120,0.5227272727272727,MIA,LAA,2024 REG,9,4,7,7,11,16,0,1,-3,3,1,1,1,1,0,0,0,0,0,0.4772727272727273,0.5227272727272727
93664,0.6226415094339623,0.4166666666666667,-165,140,0.5981666073335706,0.40183339266642937,away,KC,over,8.5,0.5121951219512195,-105,0.48808156828023186,NYM,KC,2024 REG,9,7,13,11,18,22,0,1,-4,4,1,1,1,1,1,1,1,0,0,0.48808156828023186,0.5119184317197681
93664,0.6226415094339623,0.4166666666666667,-165,140,0.5981666073335706,0.40183339266642937,home,NYM,under,8.5,0.5348837209302326,-115,0.5119184317197681,NYM,KC,2024 REG,9,7,13,11,18,22,0,1,-4,4,1,1,1,1,1,1,1,0,0,0.48808156828023186,0.5119184317197681
93665,0.6183206106870228,0.42194092827004215,-162,137,0.5934260713318911,0.40657392866810893,away,SD,over,8.5,0.5238095238095238,-110,0.4988662131519274,LAD,SD,2024 REG,6,3,8,6,9,14,0,1,-3,3,1,1,1,0,0,0,0,0,0,0.4988662131519274,0.5011337868480725
93665,0.6183206106870228,0.42194092827004215,-162,137,0.5934260713318911,0.40657392866810893,home,LAD,under,8.5,0.5238095238095238,-110,0.5011337868480725,LAD,SD,2024 REG,6,3,8,6,9,14,0,1,-3,3,1,1,1,0,0,0,0,0,0,0.4988662131519274,0.5011337868480725
93669,0.5918367346938775,0.4484304932735426,-145,123,0.5680051099784656,0.43199489002153435,away,KC,over,8,0.5121951219512195,-105,0.48919479393107135,SEA,KC,2024 REG,9,4,6,2,6,15,1,0,2,-2,1,1,0,0,0,0,0,0,0,0.48919479393107135,0.5108052060689287
93669,0.5918367346938775,0.4484304932735426,-145,123,0.5680051099784656,0.43199489002153435,home,SEA,under,8,0.5327102803738317,-114,0.5108052060689287,SEA,KC,2024 REG,9,4,6,2,6,15,1,0,2,-2,1,1,0,0,0,0,0,0,0,0.48919479393107135,0.5108052060689287
93672,0.626865671641791,0.4098360655737705,-168,144,0.6038586124917376,0.39614138750826244,away,OAK,over,7.5,0.5,100,0.4762443438914027,CLE,OAK,2024 REG,7,6,7,2,8,14,1,0,4,-4,1,1,0,0,0,0,0,0,0,0.4762443438914027,0.5237556561085973
93672,0.626865671641791,0.4098360655737705,-168,144,0.6038586124917376,0.39614138750826244,home,CLE,under,7.5,0.5475113122171946,-121,0.5237556561085973,CLE,OAK,2024 REG,7,6,7,2,8,14,1,0,4,-4,1,1,0,0,0,0,0,0,0,0.4762443438914027,0.5237556561085973
93673,0.5238095238095238,0.5215311004784688,-110,-109,0.5000596729920038,0.4999403270079962,away,CHC,over,8.5,0.5145631067961165,-106,0.49023796582517226,STL,CHC,2024 REG,15,7,12,6,13,27,1,0,1,-1,1,1,1,1,1,1,0,0,0,0.49023796582517226,0.5097620341748277
93673,0.5238095238095238,0.5215311004784688,-110,-109,0.5000596729920038,0.4999403270079962,home,STL,under,8.5,0.5327102803738317,-114,0.5097620341748277,STL,CHC,2024 REG,15,7,12,6,13,27,1,0,1,-1,1,1,1,1,1,1,0,0,0,0.49023796582517226,0.5097620341748277
93674,0.6551724137931035,0.3891050583657587,-190,157,0.6261630354821247,0.3738369645178753,away,WSH,over,8.5,0.5121951219512195,-105,0.48808156828023186,SF,WSH,2024 REG,10,3,8,5,8,18,0,1,-2,2,1,1,1,0,0,0,0,0,0,0.48808156828023186,0.5119184317197681
93674,0.6551724137931035,0.3891050583657587,-190,157,0.6261630354821247,0.3738369645178753,home,SF,under,8.5,0.5348837209302326,-115,0.5119184317197681,SF,WSH,2024 REG,10,3,8,5,8,18,0,1,-2,2,1,1,1,0,0,0,0,0,0,0.48808156828023186,0.5119184317197681
93675,0.5652173913043479,0.47619047619047616,-130,110,0.5418129444594474,0.4581870555405526,away,STL,over,8.5,0.5454545454545454,-120,0.5206611570247933,WSH,STL,2024 REG,15,14,11,6,20,26,1,0,8,-8,1,1,1,1,1,1,0,0,0,0.5206611570247933,0.4793388429752067
93675,0.5652173913043479,0.47619047619047616,-130,110,0.5418129444594474,0.4581870555405526,home,WSH,under,8.5,0.5,100,0.4793388429752067,WSH,STL,2024 REG,15,14,11,6,20,26,1,0,8,-8,1,1,1,1,1,1,0,0,0,0.5206611570247933,0.4793388429752067
93676,0.6688741721854304,0.37037037037037035,-202,170,0.6426245112706233,0.35737548872937674,away,TEX,over,8,0.5348837209302326,-115,0.5097020142727117,PHI,TEX,2024 REG,12,5,6,2,7,18,1,0,3,-3,1,1,0,0,0,0,0,0,0,0.5097020142727117,0.49029798572728833
93676,0.6688741721854304,0.37037037037037035,-202,170,0.6426245112706233,0.35737548872937674,home,PHI,under,8,0.5121951219512195,-105,0.49029798572728833,PHI,TEX,2024 REG,12,5,6,2,7,18,1,0,3,-3,1,1,0,0,0,0,0,0,0,0.5097020142727117,0.49029798572728833
93678,0.49751243781094534,0.5454545454545454,101,-120,0.476135829221149,0.523864170778851,away,CLE,over,8.5,0.5238095238095238,-110,0.4988662131519274,OAK,CLE,2024 REG,9,4,7,3,7,16,1,0,1,-1,1,1,1,0,0,0,0,0,0,0.4988662131519274,0.5011337868480725
93678,0.49751243781094534,0.5454545454545454,101,-120,0.476135829221149,0.523864170778851,home,OAK,under,8.5,0.5238095238095238,-110,0.5011337868480725,OAK,CLE,2024 REG,9,4,7,3,7,16,1,0,1,-1,1,1,1,0,0,0,0,0,0,0.4988662131519274,0.5011337868480725
93679,0.6153846153846154,0.425531914893617,-160,135,0.5902052121364724,0.40979478786352763,away,LAA,over,7,0.49504950495049505,102,0.47297076509898783,SEA,LAA,2024 REG,9,5,7,4,9,16,1,0,1,-1,1,1,1,1,0,0,0,0,0,0.47297076509898783,0.5270292349010122
93679,0.6153846153846154,0.425531914893617,-160,135,0.5902052121364724,0.40979478786352763,home,SEA,under,7,0.5495495495495495,-122,0.5270292349010122,SEA,LAA,2024 REG,9,5,7,4,9,16,1,0,1,-1,1,1,1,1,0,0,0,0,0,0.47297076509898783,0.5270292349010122
93680,0.5238095238095238,0.5238095238095238,-110,-110,0.4988662131519274,0.5011337868480725,away,MIL,over,9.5,0.5121951219512195,-105,0.48808156828023186,CIN,MIL,2024 REG,10,10,12,8,18,22,1,0,2,-2,1,1,1,1,1,1,1,1,0,0.48808156828023186,0.5119184317197681
93680,0.5238095238095238,0.5238095238095238,-110,-110,0.4988662131519274,0.5011337868480725,home,CIN,under,9.5,0.5348837209302326,-115,0.5119184317197681,CIN,MIL,2024 REG,10,10,12,8,18,22,1,0,2,-2,1,1,1,1,1,1,1,1,0,0.48808156828023186,0.5119184317197681
93681,0.613899613899614,0.4273504273504274,-159,134,0.5885762295028705,0.4114237704971295,away,PIT,over,8,0.5121951219512195,-105,0.4858858974112951,NYM,PIT,2024 REG,10,9,5,1,10,15,1,0,8,-8,1,0,0,0,0,0,0,0,0,0.4858858974112951,0.5141141025887048
93681,0.613899613899614,0.4273504273504274,-159,134,0.5885762295028705,0.4114237704971295,home,NYM,under,8,0.5391705069124424,-117,0.5141141025887048,NYM,PIT,2024 REG,10,9,5,1,10,15,1,0,8,-8,1,0,0,0,0,0,0,0,0,0.4858858974112951,0.5141141025887048
93682,0.6108949416342413,0.4291845493562232,-157,133,0.5864105833248914,0.4135894166751086,away,STL,over,9,0.5,100,0.4772727272727273,HOU,STL,2024 REG,10,8,11,5,13,21,1,0,3,-3,1,1,1,1,1,0,0,0,0,0.4772727272727273,0.5227272727272727
93682,0.6108949416342413,0.4291845493562232,-157,133,0.5864105833248914,0.4135894166751086,home,HOU,under,9,0.5454545454545454,-120,0.5227272727272727,HOU,STL,2024 REG,10,8,11,5,13,21,1,0,3,-3,1,1,1,1,1,0,0,0,0,0.4772727272727273,0.5227272727272727
93683,0.5454545454545454,0.5,-120,100,0.5206611570247933,0.4793388429752067,away,MIN,over,8.5,0.5145631067961165,-106,0.4891195935000339,PIT,MIN,2024 REG,10,5,13,11,16,23,0,1,-6,6,1,1,1,1,1,0,0,0,0,0.4891195935000339,0.5108804064999661
93683,0.5454545454545454,0.5,-120,100,0.5206611570247933,0.4793388429752067,home,PIT,under,8.5,0.5348837209302326,-115,0.5108804064999661,PIT,MIN,2024 REG,10,5,13,11,16,23,0,1,-6,6,1,1,1,1,1,0,0,0,0,0.4891195935000339,0.5108804064999661
93695,0.5867768595041323,0.45454545454545453,-142,120,0.5625298818386723,0.43747011816132775,away,TEX,over,9,0.5412844036697247,-118,0.5136310900085983,ATL,TEX,2024 REG,8,5,5,2,7,13,1,0,3,-3,1,1,0,0,0,0,0,0,0,0.5136310900085983,0.4863689099914017
93695,0.5867768595041323,0.45454545454545453,-142,120,0.5625298818386723,0.43747011816132775,home,ATL,under,9,0.5098039215686274,-104,0.4863689099914017,ATL,TEX,2024 REG,8,5,5,2,7,13,1,0,3,-3,1,1,0,0,0,0,0,0,0,0.5136310900085983,0.4863689099914017
93697,0.6987951807228916,0.3436426116838488,-232,191,0.669139855908543,0.33086014409145703,away,WSH,over,9.5,0.5555555555555556,-125,0.5314664257753688,LAD,WSH,2024 REG,5,0,4,2,2,9,0,1,-2,2,0,0,0,0,0,0,0,0,0,0.5314664257753688,0.46853357422463116
93697,0.6987951807228916,0.3436426116838488,-232,191,0.669139855908543,0.33086014409145703,home,LAD,under,9.5,0.48780487804878053,105,0.46853357422463116,LAD,WSH,2024 REG,5,0,4,2,2,9,0,1,-2,2,0,0,0,0,0,0,0,0,0,0.5314664257753688,0.46853357422463116
93699,0.5850622406639003,0.45454545454545453,-141,120,0.5618892737571823,0.43811072624281766,away,MIL,over,8.5,0.5121951219512195,-105,0.48808156828023186,CIN,MIL,2024 REG,4,2,6,7,9,10,0,1,-5,5,1,1,0,0,0,0,0,0,0,0.48808156828023186,0.5119184317197681
93699,0.5850622406639003,0.45454545454545453,-141,120,0.5618892737571823,0.43811072624281766,home,CIN,under,8.5,0.5348837209302326,-115,0.5119184317197681,CIN,MIL,2024 REG,4,2,6,7,9,10,0,1,-5,5,1,1,0,0,0,0,0,0,0,0.48808156828023186,0.5119184317197681
93700,0.45454545454545453,0.5884773662551441,120,-143,0.43498962690881876,0.5650103730911813,away,STL,over,8,0.5238095238095238,-110,0.4988662131519274,OAK,STL,2024 REG,5,2,4,3,5,9,0,1,-1,1,1,1,0,0,0,0,0,0,0,0.4988662131519274,0.5011337868480725
93700,0.45454545454545453,0.5884773662551441,120,-143,0.43498962690881876,0.5650103730911813,home,OAK,under,8,0.5238095238095238,-110,0.5011337868480725,OAK,STL,2024 REG,5,2,4,3,5,9,0,1,-1,1,1,1,0,0,0,0,0,0,0,0.4988662131519274,0.5011337868480725
93703,0.6563573883161512,0.3846153846153846,-191,160,0.6294646060827378,0.3705353939172622,away,MIA,over,9.5,0.5348837209302326,-115,0.5097020142727117,KC,MIA,2024 REG,4,1,7,2,3,11,0,1,-1,1,1,0,0,0,0,0,0,0,0,0.5097020142727117,0.49029798572728833
93703,0.6563573883161512,0.3846153846153846,-191,160,0.6294646060827378,0.3705353939172622,home,KC,under,9.5,0.5121951219512195,-105,0.49029798572728833,KC,MIA,2024 REG,4,1,7,2,3,11,0,1,-1,1,1,0,0,0,0,0,0,0,0,0.5097020142727117,0.49029798572728833
93704,0.49751243781094534,0.5454545454545454,101,-120,0.476135829221149,0.523864170778851,away,CHC,over,7.5,0.49504950495049505,102,0.47297076509898783,NYM,CHC,2024 REG,5,0,5,1,1,10,0,1,-1,1,0,0,0,0,0,0,0,0,0,0.47297076509898783,0.5270292349010122
93704,0.49751243781094534,0.5454545454545454,101,-120,0.476135829221149,0.523864170778851,home,NYM,under,7.5,0.5495495495495495,-122,0.5270292349010122,NYM,CHC,2024 REG,5,0,5,1,1,10,0,1,-1,1,0,0,0,0,0,0,0,0,0,0.47297076509898783,0.5270292349010122
93705,0.5,0.5454545454545454,100,-120,0.4772727272727273,0.5227272727272727,away,ATL,over,7.5,0.5,100,0.4772727272727273,ARI,ATL,2024 REG,6,2,11,6,8,17,0,1,-4,4,1,1,0,0,0,0,0,0,0,0.4772727272727273,0.5227272727272727
93705,0.5,0.5454545454545454,100,-120,0.4772727272727273,0.5227272727272727,home,ARI,under,7.5,0.5454545454545454,-120,0.5227272727272727,ARI,ATL,2024 REG,6,2,11,6,8,17,0,1,-4,4,1,1,0,0,0,0,0,0,0,0.4772727272727273,0.5227272727272727
93707,0.2898550724637681,0.7512437810945274,245,-302,0.2779423612874506,0.7220576387125495,away,ATL,over,8,0.504950495049505,-102,0.48160416005266615,CWS,ATL,2024 REG,4,1,3,0,1,7,1,0,1,-1,0,0,0,0,0,0,0,0,0,0.48160416005266615,0.5183958399473338
93707,0.2898550724637681,0.7512437810945274,245,-302,0.2779423612874506,0.7220576387125495,home,CWS,under,8,0.5412844036697247,-118,0.5183958399473338,CWS,ATL,2024 REG,4,1,3,0,1,7,1,0,1,-1,0,0,0,0,0,0,0,0,0,0.48160416005266615,0.5183958399473338
93708,0.5348837209302326,0.5121951219512195,-115,-105,0.5097020142727117,0.49029798572728833,away,HOU,over,8.5,0.5121951219512195,-105,0.48808156828023186,TOR,HOU,2024 REG,6,7,8,6,13,14,1,0,1,-1,1,1,1,1,1,1,0,0,0,0.48808156828023186,0.5119184317197681
93708,0.5348837209302326,0.5121951219512195,-115,-105,0.5097020142727117,0.49029798572728833,home,TOR,under,8.5,0.5348837209302326,-115,0.5119184317197681,TOR,HOU,2024 REG,6,7,8,6,13,14,1,0,1,-1,1,1,1,1,1,1,0,0,0,0.48808156828023186,0.5119184317197681
93709,0.4347826086956522,0.6031746031746031,130,-152,0.418279473099889,0.581720526900111,away,BAL,over,7,0.5121951219512195,-105,0.48808156828023186,SEA,BAL,2024 REG,7,7,10,3,10,17,1,0,4,-4,1,1,1,0,0,0,0,0,0,0.48808156828023186,0.5119184317197681
93709,0.4347826086956522,0.6031746031746031,130,-152,0.418279473099889,0.581720526900111,home,SEA,under,7,0.5348837209302326,-115,0.5119184317197681,SEA,BAL,2024 REG,7,7,10,3,10,17,1,0,4,-4,1,1,1,0,0,0,0,0,0,0.48808156828023186,0.5119184317197681
93710,0.5726495726495727,0.4672897196261683,-134,114,0.5497783539959433,0.4502216460040567,away,MIL,over,9.5,0.5121951219512195,-105,0.48808156828023186,CIN,MIL,2024 REG,10,5,13,9,14,23,0,1,-4,4,1,1,1,1,1,0,0,0,0,0.48808156828023186,0.5119184317197681
93710,0.5726495726495727,0.4672897196261683,-134,114,0.5497783539959433,0.4502216460040567,home,CIN,under,9.5,0.5348837209302326,-115,0.5119184317197681,CIN,MIL,2024 REG,10,5,13,9,14,23,0,1,-4,4,1,1,1,1,1,0,0,0,0,0.48808156828023186,0.5119184317197681
93711,0.646643109540636,0.3921568627450981,-183,155,0.6215533748116984,0.37844662518830163,away,PIT,over,8.5,0.5073891625615764,-103,0.48057683780462784,TOR,PIT,2024 REG,6,5,6,3,8,12,1,0,2,-2,1,1,1,0,0,0,0,0,0,0.48057683780462784,0.5194231621953722
93711,0.646643109540636,0.3921568627450981,-183,155,0.6215533748116984,0.37844662518830163,home,TOR,under,8.5,0.5454545454545454,-120,0.5194231621953722,TOR,PIT,2024 REG,6,5,6,3,8,12,1,0,2,-2,1,1,1,0,0,0,0,0,0,0.48057683780462784,0.5194231621953722
93714,0.4926108374384236,0.5495495495495495,103,-122,0.4718421738975501,0.5281578261024499,away,TB,over,8.5,0.5169082125603864,-107,0.49353874091423283,LAA,TB,2024 REG,7,4,12,6,10,19,0,1,-2,2,1,1,1,1,0,0,0,0,0,0.49353874091423283,0.5064612590857671
93714,0.4926108374384236,0.5495495495495495,103,-122,0.4718421738975501,0.5281578261024499,home,LAA,under,8.5,0.5283018867924528,-112,0.5064612590857671,LAA,TB,2024 REG,7,4,12,6,10,19,0,1,-2,2,1,1,1,1,0,0,0,0,0,0.49353874091423283,0.5064612590857671
93715,0.41493775933609955,0.6240601503759399,141,-166,0.3987560540613944,0.6012439459386056,away,ATL,over,9.5,0.5121951219512195,-105,0.48808156828023186,WSH,ATL,2024 REG,7,8,8,5,13,15,1,0,3,-3,1,1,1,1,1,0,0,0,0,0.48808156828023186,0.5119184317197681
93715,0.41493775933609955,0.6240601503759399,141,-166,0.3987560540613944,0.6012439459386056,home,WSH,under,9.5,0.5348837209302326,-115,0.5119184317197681,WSH,ATL,2024 REG,7,8,8,5,13,15,1,0,3,-3,1,1,1,1,1,0,0,0,0,0.48808156828023186,0.5119184317197681
93717,0.4347826086956522,0.607843137254902,130,-155,0.41624967567367205,0.583750324326328,away,BAL,over,8,0.5098039215686274,-104,0.48375889301574193,TOR,BAL,2024 REG,5,1,9,10,11,14,0,1,-9,9,1,0,0,0,0,0,0,0,0,0.48375889301574193,0.5162411069842581
93717,0.4347826086956522,0.607843137254902,130,-155,0.41624967567367205,0.583750324326328,home,TOR,under,8,0.5412844036697247,-118,0.5162411069842581,TOR,BAL,2024 REG,5,1,9,10,11,14,0,1,-9,9,1,0,0,0,0,0,0,0,0,0.48375889301574193,0.5162411069842581
93721,0.6551724137931035,0.3846153846153846,-190,160,0.6291045458703008,0.37089545412969915,away,OAK,over,9,0.5433789954337899,-119,0.5184560714286826,PHI,OAK,2024 REG,9,11,10,5,16,19,1,0,6,-6,1,1,1,1,1,0,0,0,0,0.5184560714286826,0.48154392857131745
93721,0.6551724137931035,0.3846153846153846,-190,160,0.6291045458703008,0.37089545412969915,home,PHI,under,9,0.5024875621890548,-101,0.48154392857131745,PHI,OAK,2024 REG,9,11,10,5,16,19,1,0,6,-6,1,1,1,1,1,0,0,0,0,0.5184560714286826,0.48154392857131745
93722,0.6923076923076923,0.3508771929824561,-225,185,0.6624104640298972,0.33758953597010277,away,MIL,over,8.5,0.5454545454545454,-120,0.5206611570247933,BAL,MIL,2024 REG,11,6,12,4,10,23,1,0,2,-2,1,1,1,1,0,0,0,0,0,0.5206611570247933,0.4793388429752067
93722,0.6923076923076923,0.3508771929824561,-225,185,0.6624104640298972,0.33758953597010277,home,BAL,under,8.5,0.5,100,0.4793388429752067,BAL,MIL,2024 REG,11,6,12,4,10,23,1,0,2,-2,1,1,1,1,0,0,0,0,0,0.5206611570247933,0.4793388429752067
93724,0.5,0.5454545454545454,100,-120,0.4772727272727273,0.5227272727272727,away,NYY,over,7.5,0.5433789954337899,-119,0.5184560714286826,TB,NYY,2024 REG,7,5,7,3,8,14,1,0,2,-2,1,1,1,0,0,0,0,0,0,0.5184560714286826,0.48154392857131745
93724,0.5,0.5454545454545454,100,-120,0.4772727272727273,0.5227272727272727,home,TB,under,7.5,0.5024875621890548,-101,0.48154392857131745,TB,NYY,2024 REG,7,5,7,3,8,14,1,0,2,-2,1,1,1,0,0,0,0,0,0,0.5184560714286826,0.48154392857131745
93725,0.46511627906976744,0.574468085106383,115,-135,0.44670494689481377,0.5532950531051862,away,NYY,over,7.5,0.5348837209302326,-115,0.5097020142727117,SF,NYY,2024 REG,11,5,11,7,12,22,0,1,-2,2,1,1,1,1,1,0,0,0,0,0.5097020142727117,0.49029798572728833
93725,0.46511627906976744,0.574468085106383,115,-135,0.44670494689481377,0.5532950531051862,home,SF,under,7.5,0.5121951219512195,-105,0.49029798572728833,SF,NYY,2024 REG,11,5,11,7,12,22,0,1,-2,2,1,1,1,1,1,0,0,0,0,0.5097020142727117,0.49029798572728833
93727,0.6108949416342413,0.425531914893617,-157,135,0.5886419592417365,0.41135804075826354,away,OAK,over,7.5,0.5024875621890548,-101,0.47839724939301687,SEA,OAK,2024 REG,11,8,7,1,9,18,1,0,7,-7,1,0,0,0,0,0,0,0,0,0.47839724939301687,0.5216027506069831
93727,0.6108949416342413,0.425531914893617,-157,135,0.5886419592417365,0.41135804075826354,home,SEA,under,7.5,0.5454545454545454,-120,0.5216027506069831,SEA,OAK,2024 REG,11,8,7,1,9,18,1,0,7,-7,1,0,0,0,0,0,0,0,0,0.47839724939301687,0.5216027506069831
93728,0.647887323943662,0.39370078740157477,-184,154,0.6209429137763255,0.3790570862236745,away,CWS,over,7.5,0.5283018867924528,-112,0.5031902949311281,PHI,CWS,2024 REG,7,7,2,0,7,9,1,0,7,-7,0,0,0,0,0,0,0,0,0,0.5031902949311281,0.4968097050688719
93728,0.647887323943662,0.39370078740157477,-184,154,0.6209429137763255,0.3790570862236745,home,PHI,under,7.5,0.5192307692307692,-108,0.4968097050688719,PHI,CWS,2024 REG,7,7,2,0,7,9,1,0,7,-7,0,0,0,0,0,0,0,0,0,0.5031902949311281,0.4968097050688719
93730,0.4504504504504505,0.5901639344262295,122,-144,0.43215568248798203,0.567844317512018,away,MIL,over,8.5,0.5348837209302326,-115,0.5097020142727117,MIA,MIL,2024 REG,7,3,4,2,5,11,1,0,1,-1,1,1,0,0,0,0,0,0,0,0.5097020142727117,0.49029798572728833
93730,0.4504504504504505,0.5901639344262295,122,-144,0.43215568248798203,0.567844317512018,home,MIA,under,8.5,0.5121951219512195,-105,0.49029798572728833,MIA,MIL,2024 REG,7,3,4,2,5,11,1,0,1,-1,1,1,0,0,0,0,0,0,0,0.5097020142727117,0.49029798572728833
93732,0.6539792387543253,0.390625,-189,156,0.6248089926485555,0.3751910073514445,away,WSH,over,7.5,0.5,100,0.4772727272727273,SD,WSH,2024 REG,9,8,5,5,13,14,1,0,3,-3,1,1,1,1,1,0,0,0,0,0.4772727272727273,0.5227272727272727
93732,0.6539792387543253,0.390625,-189,156,0.6248089926485555,0.3751910073514445,home,SD,under,7.5,0.5454545454545454,-120,0.5227272727272727,SD,WSH,2024 REG,9,8,5,5,13,14,1,0,3,-3,1,1,1,1,1,0,0,0,0,0.4772727272727273,0.5227272727272727
93735,0.5918367346938775,0.4484304932735426,-145,123,0.5680051099784656,0.43199489002153435,away,CIN,over,7.5,0.5238095238095238,-110,0.4988662131519274,SD,CIN,2024 REG,8,6,4,2,8,12,1,0,4,-4,1,1,0,0,0,0,0,0,0,0.4988662131519274,0.5011337868480725
93735,0.5918367346938775,0.4484304932735426,-145,123,0.5680051099784656,0.43199489002153435,home,SD,under,7.5,0.5238095238095238,-110,0.5011337868480725,SD,CIN,2024 REG,8,6,4,2,8,12,1,0,4,-4,1,1,0,0,0,0,0,0,0,0.4988662131519274,0.5011337868480725
93736,0.726027397260274,0.3125,-265,220,0.6980554513041847,0.30194454869581533,away,MIA,over,9,0.5073891625615764,-103,0.4826927225525911,LAD,MIA,2024 REG,6,3,6,1,4,12,1,0,2,-2,1,0,0,0,0,0,0,0,0,0.4826927225525911,0.5173072774474089
93736,0.726027397260274,0.3125,-265,220,0.6980554513041847,0.30194454869581533,home,LAD,under,9,0.5412844036697247,-118,0.5173072774474089,LAD,MIA,2024 REG,6,3,6,1,4,12,1,0,2,-2,1,0,0,0,0,0,0,0,0,0.4826927225525911,0.5173072774474089
93739,0.5934959349593496,0.4484304932735426,-146,123,0.5686127702357632,0.4313872297642368,away,BAL,over,7.5,0.5348837209302326,-115,0.5097020142727117,NYY,BAL,2024 REG,9,6,11,7,13,20,0,1,-1,1,1,1,1,1,1,1,0,0,0,0.5097020142727117,0.49029798572728833
93739,0.5934959349593496,0.4484304932735426,-146,123,0.5686127702357632,0.4313872297642368,home,NYY,under,7.5,0.5121951219512195,-105,0.49029798572728833,NYY,BAL,2024 REG,9,6,11,7,13,20,0,1,-1,1,1,1,1,1,1,1,0,0,0,0.5097020142727117,0.49029798572728833
93741,0.49751243781094534,0.5475113122171946,101,-121,0.47511256217505476,0.5248874378249453,away,LAD,over,8.5,0.5454545454545454,-120,0.5206611570247933,NYM,LAD,2024 REG,9,3,16,10,13,25,0,1,-7,7,1,1,1,0,0,0,0,0,0,0.5206611570247933,0.4793388429752067
93741,0.49751243781094534,0.5475113122171946,101,-121,0.47511256217505476,0.5248874378249453,home,NYM,under,8.5,0.5,100,0.4793388429752067,NYM,LAD,2024 REG,9,3,16,10,13,25,0,1,-7,7,1,1,1,0,0,0,0,0,0,0.5206611570247933,0.4793388429752067
93742,0.4166666666666667,0.6226415094339623,140,-165,0.4002882599580712,0.5997117400419287,away,NYY,over,10.5,0.5454545454545454,-120,0.5206611570247933,KC,NYY,2024 REG,9,4,5,3,7,14,1,0,1,-1,1,1,1,0,0,0,0,0,0,0.5206611570247933,0.4793388429752067
93742,0.4166666666666667,0.6226415094339623,140,-165,0.4002882599580712,0.5997117400419287,home,KC,under,10.5,0.5,100,0.4793388429752067,KC,NYY,2024 REG,9,4,5,3,7,14,1,0,1,-1,1,1,1,0,0,0,0,0,0,0.5206611570247933,0.4793388429752067
93744,0.6000000000000001,0.4444444444444444,-150,125,0.5733333333333334,0.42666666666666664,away,LAA,over,8.5,0.5,100,0.4772727272727273,ARI,LAA,2024 REG,6,3,14,8,11,20,0,1,-5,5,1,1,1,0,0,0,0,0,0,0.4772727272727273,0.5227272727272727
93744,0.6000000000000001,0.4444444444444444,-150,125,0.5733333333333334,0.42666666666666664,home,ARI,under,8.5,0.5454545454545454,-120,0.5227272727272727,ARI,LAA,2024 REG,6,3,14,8,11,20,0,1,-5,5,1,1,1,0,0,0,0,0,0,0.4772727272727273,0.5227272727272727
93746,0.6389891696750902,0.4,-177,150,0.614075512518083,0.385924487481917,away,LAA,over,8.5,0.5238095238095238,-110,0.4988662131519274,BAL,LAA,2024 REG,14,13,10,4,17,24,1,0,9,-9,1,1,1,1,0,0,0,0,0,0.4988662131519274,0.5011337868480725
93746,0.6389891696750902,0.4,-177,150,0.614075512518083,0.385924487481917,home,BAL,under,8.5,0.5238095238095238,-110,0.5011337868480725,BAL,LAA,2024 REG,14,13,10,4,17,24,1,0,9,-9,1,1,1,1,0,0,0,0,0,0.4988662131519274,0.5011337868480725
93748,0.5780590717299579,0.4608294930875576,-137,117,0.5555791840506346,0.44442081594936544,away,COL,over,8,0.5238095238095238,-110,0.5000596729920038,MIA,COL,2024 REG,9,7,9,6,13,18,1,0,1,-1,1,1,1,1,1,1,0,0,0,0.5000596729920038,0.4999403270079962
93748,0.5780590717299579,0.4608294930875576,-137,117,0.5555791840506346,0.44442081594936544,home,MIA,under,8,0.5215311004784688,-109,0.4999403270079962,MIA,COL,2024 REG,9,7,9,6,13,18,1,0,1,-1,1,1,1,1,1,1,0,0,0,0.5000596729920038,0.4999403270079962
93750,0.7142857142857143,0.33112582781456956,-250,202,0.6818488984997972,0.31815110150020276,away,COL,over,9,0.5391705069124424,-117,0.5127649394825569,ARI,COL,2024 REG,14,7,7,3,10,21,1,0,4,-4,1,1,1,0,0,0,0,0,0,0.5127649394825569,0.48723506051744314
93750,0.7142857142857143,0.33112582781456956,-250,202,0.6818488984997972,0.31815110150020276,home,ARI,under,9,0.5098039215686274,-104,0.48723506051744314,ARI,COL,2024 REG,14,7,7,3,10,21,1,0,4,-4,1,1,1,0,0,0,0,0,0,0.5127649394825569,0.48723506051744314
93752,0.6153846153846154,0.425531914893617,-160,135,0.5902052121364724,0.40979478786352763,away,WSH,over,8,0.5,100,0.4772727272727273,TEX,WSH,2024 REG,11,7,3,1,8,14,1,0,6,-6,1,0,0,0,0,0,0,0,0,0.4772727272727273,0.5227272727272727
93752,0.6153846153846154,0.425531914893617,-160,135,0.5902052121364724,0.40979478786352763,home,TEX,under,8,0.5454545454545454,-120,0.5227272727272727,TEX,WSH,2024 REG,11,7,3,1,8,14,1,0,6,-6,1,0,0,0,0,0,0,0,0,0.4772727272727273,0.5227272727272727
93754,0.4,0.6428571428571428,150,-180,0.38285714285714295,0.617142857142857,away,ARI,over,10.5,0.5238095238095238,-110,0.4988662131519274,COL,ARI,2024 REG,13,7,7,5,12,20,1,0,2,-2,1,1,1,1,1,0,0,0,0,0.4988662131519274,0.5011337868480725
93754,0.4,0.6428571428571428,150,-180,0.38285714285714295,0.617142857142857,home,COL,under,10.5,0.5238095238095238,-110,0.5011337868480725,COL,ARI,2024 REG,13,7,7,5,12,20,1,0,2,-2,1,1,1,1,1,0,0,0,0,0.4988662131519274,0.5011337868480725
93755,0.7142857142857143,0.3278688524590164,-250,205,0.6841753094680495,0.3158246905319505,away,OAK,over,8.5,0.5454545454545454,-120,0.5206611570247933,HOU,OAK,2024 REG,8,3,2,0,3,10,1,0,3,-3,0,0,0,0,0,0,0,0,0,0.5206611570247933,0.4793388429752067
93755,0.7142857142857143,0.3278688524590164,-250,205,0.6841753094680495,0.3158246905319505,home,HOU,under,8.5,0.5,100,0.4793388429752067,HOU,OAK,2024 REG,8,3,2,0,3,10,1,0,3,-3,0,0,0,0,0,0,0,0,0,0.5206611570247933,0.4793388429752067
93756,0.5951417004048584,0.4464285714285714,-147,124,0.5704014981396188,0.4295985018603812,away,LAA,over,9.5,0.5,100,0.4772727272727273,CHC,LAA,2024 REG,7,5,3,0,5,10,1,0,5,-5,0,0,0,0,0,0,0,0,0,0.4772727272727273,0.5227272727272727
93756,0.5951417004048584,0.4464285714285714,-147,124,0.5704014981396188,0.4295985018603812,home,CHC,under,9.5,0.5454545454545454,-120,0.5227272727272727,CHC,LAA,2024 REG,7,5,3,0,5,10,1,0,5,-5,0,0,0,0,0,0,0,0,0,0.4772727272727273,0.5227272727272727
93757,0.5867768595041323,0.45454545454545453,-142,120,0.5625298818386723,0.43747011816132775,away,TB,over,7.5,0.5,100,0.4772727272727273,TOR,TB,2024 REG,10,4,12,5,9,22,0,1,-1,1,1,1,1,1,0,0,0,0,0,0.4772727272727273,0.5227272727272727
93757,0.5867768595041323,0.45454545454545453,-142,120,0.5625298818386723,0.43747011816132775,home,TOR,under,7.5,0.5454545454545454,-120,0.5227272727272727,TOR,TB,2024 REG,10,4,12,5,9,22,0,1,-1,1,1,1,1,1,0,0,0,0,0,0.4772727272727273,0.5227272727272727
93758,0.5305164319248826,0.5121951219512195,-113,-105,0.5078572507605655,0.49214274923943446,away,DET,over,8.5,0.5238095238095238,-110,0.4988662131519274,BOS,DET,2024 REG,10,6,7,3,9,17,1,0,3,-3,1,1,1,0,0,0,0,0,0,0.4988662131519274,0.5011337868480725
93758,0.5305164319248826,0.5121951219512195,-113,-105,0.5078572507605655,0.49214274923943446,home,BOS,under,8.5,0.5238095238095238,-110,0.5011337868480725,BOS,DET,2024 REG,10,6,7,3,9,17,1,0,3,-3,1,1,1,0,0,0,0,0,0,0.4988662131519274,0.5011337868480725
93761,0.6721311475409836,0.37037037037037035,-205,170,0.6435645535349916,0.35643544646500835,away,WSH,over,8.5,0.5121951219512195,-105,0.48808156828023186,SF,WSH,2024 REG,12,7,4,1,8,16,1,0,6,-6,1,0,0,0,0,0,0,0,0,0.48808156828023186,0.5119184317197681
93761,0.6721311475409836,0.37037037037037035,-205,170,0.6435645535349916,0.35643544646500835,home,SF,under,8.5,0.5348837209302326,-115,0.5119184317197681,SF,WSH,2024 REG,12,7,4,1,8,16,1,0,6,-6,1,0,0,0,0,0,0,0,0,0.48808156828023186,0.5119184317197681
93763,0.5652173913043479,0.47619047619047616,-130,110,0.5418129444594474,0.4581870555405526,away,MIN,over,8,0.504950495049505,-102,0.4826715732667395,SF,MIN,2024 REG,8,2,10,4,6,18,0,1,-2,2,1,1,0,0,0,0,0,0,0,0.4826715732667395,0.5173284267332605
93763,0.5652173913043479,0.47619047619047616,-130,110,0.5418129444594474,0.4581870555405526,home,SF,under,8,0.5391705069124424,-117,0.5173284267332605,SF,MIN,2024 REG,8,2,10,4,6,18,0,1,-2,2,1,1,0,0,0,0,0,0,0,0.4826715732667395,0.5173284267332605
93764,0.7560975609756098,0.2857142857142857,-310,250,0.7244837256734936,0.2755162743265064,away,CIN,over,7.5,0.5,100,0.4772727272727273,LAD,CIN,2024 REG,4,2,11,7,9,15,0,1,-5,5,1,1,0,0,0,0,0,0,0,0.4772727272727273,0.5227272727272727
93764,0.7560975609756098,0.2857142857142857,-310,250,0.7244837256734936,0.2755162743265064,home,LAD,under,7.5,0.5454545454545454,-120,0.5227272727272727,LAD,CIN,2024 REG,4,2,11,7,9,15,0,1,-5,5,1,1,0,0,0,0,0,0,0,0.4772727272727273,0.5227272727272727
93765,0.6153846153846154,0.425531914893617,-160,135,0.5902052121364724,0.40979478786352763,away,SF,over,7.5,0.5215311004784688,-109,0.49670754937970685,TEX,SF,2024 REG,9,7,5,2,9,14,1,0,5,-5,1,1,0,0,0,0,0,0,0,0.49670754937970685,0.5032924506202932
93765,0.6153846153846154,0.425531914893617,-160,135,0.5902052121364724,0.40979478786352763,home,TEX,under,7.5,0.5260663507109005,-111,0.5032924506202932,TEX,SF,2024 REG,9,7,5,2,9,14,1,0,5,-5,1,1,0,0,0,0,0,0,0,0.49670754937970685,0.5032924506202932
93767,0.4926108374384236,0.5475113122171946,103,-121,0.47284623169673967,0.5271537683032603,away,TOR,over,8.5,0.5121951219512195,-105,0.48697865027430753,KC,TOR,2024 REG,8,3,9,2,5,17,1,0,1,-1,1,1,0,0,0,0,0,0,0,0.48697865027430753,0.5130213497256925
93767,0.4926108374384236,0.5475113122171946,103,-121,0.47284623169673967,0.5271537683032603,home,KC,under,8.5,0.5370370370370371,-116,0.5130213497256925,KC,TOR,2024 REG,8,3,9,2,5,17,1,0,1,-1,1,1,0,0,0,0,0,0,0,0.48697865027430753,0.5130213497256925
93768,0.6197718631178707,0.425531914893617,-163,135,0.5916938562134125,0.40830614378658747,away,ARI,over,8.5,0.5121951219512195,-105,0.48808156828023186,LAD,ARI,2024 REG,6,3,12,7,10,18,0,1,-4,4,1,1,1,0,0,0,0,0,0,0.48808156828023186,0.5119184317197681
93768,0.6197718631178707,0.425531914893617,-163,135,0.5916938562134125,0.40830614378658747,home,LAD,under,8.5,0.5348837209302326,-115,0.5119184317197681,LAD,ARI,2024 REG,6,3,12,7,10,18,0,1,-4,4,1,1,1,0,0,0,0,0,0,0.48808156828023186,0.5119184317197681
93769,0.5348837209302326,0.5073891625615764,-115,-103,0.5122726437136835,0.48772735628631647,away,CHC,over,8,0.5283018867924528,-112,0.5031902949311281,NYM,CHC,2024 REG,8,7,9,6,13,17,1,0,1,-1,1,1,1,1,1,1,0,0,0,0.5031902949311281,0.4968097050688719
93769,0.5348837209302326,0.5073891625615764,-115,-103,0.5122726437136835,0.48772735628631647,home,NYM,under,8,0.5192307692307692,-108,0.4968097050688719,NYM,CHC,2024 REG,8,7,9,6,13,17,1,0,1,-1,1,1,1,1,1,1,0,0,0,0.5031902949311281,0.4968097050688719
93770,0.47619047619047616,0.5652173913043479,110,-130,0.4564724440500838,0.5435275559499162,away,SF,over,8.5,0.5283018867924528,-112,0.5031902949311281,MIA,SF,2024 REG,8,6,9,3,9,17,1,0,3,-3,1,1,1,0,0,0,0,0,0,0.5031902949311281,0.4968097050688719
93770,0.47619047619047616,0.5652173913043479,110,-130,0.4564724440500838,0.5435275559499162,home,MIA,under,8.5,0.5192307692307692,-108,0.4968097050688719,MIA,SF,2024 REG,8,6,9,3,9,17,1,0,3,-3,1,1,1,0,0,0,0,0,0,0.5031902949311281,0.4968097050688719
93771,0.5967741935483871,0.4444444444444444,-148,125,0.5721759741010521,0.42782402589894786,away,SF,over,8.5,0.5098039215686274,-104,0.48592421718142587,LAD,SF,2024 REG,9,5,9,4,9,18,1,0,1,-1,1,1,1,1,0,0,0,0,0,0.48592421718142587,0.5140757828185741
93771,0.5967741935483871,0.4444444444444444,-148,125,0.5721759741010521,0.42782402589894786,home,LAD,under,8.5,0.5370370370370371,-116,0.5140757828185741,LAD,SF,2024 REG,9,5,9,4,9,18,1,0,1,-1,1,1,1,1,0,0,0,0,0,0.48592421718142587,0.5140757828185741
93773,0.5726495726495727,0.4694835680751174,-134,113,0.5485220476191947,0.45147795238080535,away,CLE,over,8.5,0.5121951219512195,-105,0.48808156828023186,BOS,CLE,2024 REG,5,2,3,0,2,8,1,0,2,-2,0,0,0,0,0,0,0,0,0,0.48808156828023186,0.5119184317197681
93773,0.5726495726495727,0.4694835680751174,-134,113,0.5485220476191947,0.45147795238080535,home,BOS,under,8.5,0.5348837209302326,-115,0.5119184317197681,BOS,CLE,2024 REG,5,2,3,0,2,8,1,0,2,-2,0,0,0,0,0,0,0,0,0,0.48808156828023186,0.5119184317197681
93774,0.4444444444444444,0.5983935742971888,125,-149,0.4254053250037185,0.5745946749962815,away,DET,over,7.5,0.5454545454545454,-120,0.5179608869977906,CWS,DET,2024 REG,5,2,8,3,5,13,0,1,-1,1,1,1,0,0,0,0,0,0,0,0.5179608869977906,0.48203911300220936
93774,0.4444444444444444,0.5983935742971888,125,-149,0.4254053250037185,0.5745946749962815,home,CWS,under,7.5,0.504950495049505,-102,0.48203911300220936,CWS,DET,2024 REG,5,2,8,3,5,13,0,1,-1,1,1,1,0,0,0,0,0,0,0,0.5179608869977906,0.48203911300220936
93775,0.6491228070175439,0.39370078740157477,-185,154,0.6213250352016247,0.37867496479837526,away,CWS,over,8.5,0.5121951219512195,-105,0.48808156828023186,STL,CWS,2024 REG,5,5,8,6,11,13,0,1,-1,1,1,1,1,1,1,0,0,0,0,0.48808156828023186,0.5119184317197681
93775,0.6491228070175439,0.39370078740157477,-185,154,0.6213250352016247,0.37867496479837526,home,STL,under,8.5,0.5348837209302326,-115,0.5119184317197681,STL,CWS,2024 REG,5,5,8,6,11,13,0,1,-1,1,1,1,1,1,1,0,0,0,0,0.48808156828023186,0.5119184317197681
93776,0.574468085106383,0.46511627906976744,-135,115,0.5517281312179562,0.44827186878204384,away,WSH,over,8.5,0.5121951219512195,-105,0.48808156828023186,MIA,WSH,2024 REG,12,9,14,12,21,26,0,1,-3,3,1,1,1,1,1,1,1,1,1,0.48808156828023186,0.5119184317197681
93776,0.574468085106383,0.46511627906976744,-135,115,0.5517281312179562,0.44827186878204384,home,MIA,under,8.5,0.5348837209302326,-115,0.5119184317197681,MIA,WSH,2024 REG,12,9,14,12,21,26,0,1,-3,3,1,1,1,1,1,1,1,1,1,0.48808156828023186,0.5119184317197681
93779,0.574468085106383,0.46511627906976744,-135,115,0.5517281312179562,0.44827186878204384,away,MIA,over,7,0.5,100,0.4772727272727273,OAK,MIA,2024 REG,21,20,7,4,24,28,1,0,16,-16,1,1,1,1,0,0,0,0,0,0.4772727272727273,0.5227272727272727
93779,0.574468085106383,0.46511627906976744,-135,115,0.5517281312179562,0.44827186878204384,home,OAK,under,7,0.5454545454545454,-120,0.5227272727272727,OAK,MIA,2024 REG,21,20,7,4,24,28,1,0,16,-16,1,1,1,1,0,0,0,0,0,0.4772727272727273,0.5227272727272727
93781,0.40322580645161293,0.6363636363636364,148,-175,0.387262321445464,0.612737678554536,away,MIL,over,11.5,0.5327102803738317,-114,0.5075272610403079,COL,MIL,2024 REG,8,0,9,3,3,17,0,1,-3,3,0,0,0,0,0,0,0,0,0,0.5075272610403079,0.4924727389596921
93781,0.40322580645161293,0.6363636363636364,148,-175,0.387262321445464,0.612737678554536,home,COL,under,11.5,0.5145631067961165,-106,0.4924727389596921,COL,MIL,2024 REG,8,0,9,3,3,17,0,1,-3,3,0,0,0,0,0,0,0,0,0,0.5075272610403079,0.4924727389596921
93783,0.574468085106383,0.46511627906976744,-135,115,0.5517281312179562,0.44827186878204384,away,TEX,over,9,0.5238095238095238,-110,0.4988662131519274,HOU,TEX,2024 REG,14,9,8,2,11,22,1,0,7,-7,1,1,0,0,0,0,0,0,0,0.4988662131519274,0.5011337868480725
93783,0.574468085106383,0.46511627906976744,-135,115,0.5517281312179562,0.44827186878204384,home,HOU,under,9,0.5238095238095238,-110,0.5011337868480725,HOU,TEX,2024 REG,14,9,8,2,11,22,1,0,7,-7,1,1,0,0,0,0,0,0,0,0.4988662131519274,0.5011337868480725
93786,0.4366812227074236,0.601593625498008,129,-151,0.4199673151941347,0.5800326848058652,away,SD,over,8.5,0.5121951219512195,-105,0.4858858974112951,LAA,SD,2024 REG,4,2,6,1,3,10,1,0,1,-1,1,0,0,0,0,0,0,0,0,0.4858858974112951,0.5141141025887048
93786,0.4366812227074236,0.601593625498008,129,-151,0.4199673151941347,0.5800326848058652,home,LAA,under,8.5,0.5391705069124424,-117,0.5141141025887048,LAA,SD,2024 REG,4,2,6,1,3,10,1,0,1,-1,1,0,0,0,0,0,0,0,0,0.4858858974112951,0.5141141025887048
93787,0.6376811594202898,0.4,-176,150,0.6136525939928585,0.38634740600714146,away,TEX,over,8,0.5348837209302326,-115,0.5097020142727117,MIL,TEX,2024 REG,8,6,7,3,9,15,1,0,3,-3,1,1,1,0,0,0,0,0,0,0.5097020142727117,0.49029798572728833
93787,0.6376811594202898,0.4,-176,150,0.6136525939928585,0.38634740600714146,home,MIL,under,8,0.5121951219512195,-105,0.49029798572728833,MIL,TEX,2024 REG,8,6,7,3,9,15,1,0,3,-3,1,1,1,0,0,0,0,0,0,0.5097020142727117,0.49029798572728833
93789,0.6666666666666666,0.3717472118959108,-200,169,0.641057414291615,0.358942585708385,away,OAK,over,9.5,0.5121951219512195,-105,0.48808156828023186,TEX,OAK,2024 REG,1,0,4,1,1,5,0,1,-1,1,0,0,0,0,0,0,0,0,0,0.48808156828023186,0.5119184317197681
93789,0.6666666666666666,0.3717472118959108,-200,169,0.641057414291615,0.358942585708385,home,TEX,under,9.5,0.5348837209302326,-115,0.5119184317197681,TEX,OAK,2024 REG,1,0,4,1,1,5,0,1,-1,1,0,0,0,0,0,0,0,0,0,0.48808156828023186,0.5119184317197681
93792,0.5918367346938775,0.4484304932735426,-145,123,0.5680051099784656,0.43199489002153435,away,DET,over,7.5,0.5238095238095238,-110,0.4988662131519274,ARI,DET,2024 REG,8,3,15,8,11,23,0,1,-5,5,1,1,1,0,0,0,0,0,0,0.4988662131519274,0.5011337868480725
93792,0.5918367346938775,0.4484304932735426,-145,123,0.5680051099784656,0.43199489002153435,home,ARI,under,7.5,0.5238095238095238,-110,0.5011337868480725,ARI,DET,2024 REG,8,3,15,8,11,23,0,1,-5,5,1,1,1,0,0,0,0,0,0,0.4988662131519274,0.5011337868480725
93795,0.574468085106383,0.46511627906976744,-135,115,0.5517281312179562,0.44827186878204384,away,CIN,over,8.5,0.5348837209302326,-115,0.5097020142727117,CHC,CIN,2024 REG,8,4,8,5,9,16,0,1,-1,1,1,1,1,1,0,0,0,0,0,0.5097020142727117,0.49029798572728833
93795,0.574468085106383,0.46511627906976744,-135,115,0.5517281312179562,0.44827186878204384,home,CHC,under,8.5,0.5121951219512195,-105,0.49029798572728833,CHC,CIN,2024 REG,8,4,8,5,9,16,0,1,-1,1,1,1,1,1,0,0,0,0,0,0.5097020142727117,0.49029798572728833
93796,0.6212121212121212,0.4184100418410042,-164,139,0.5965983532548766,0.40340164674512335,away,KC,over,8.5,0.5192307692307692,-108,0.49455035168025013,BAL,KC,2024 REG,3,1,8,4,5,11,0,1,-3,3,1,0,0,0,0,0,0,0,0,0.49455035168025013,0.5054496483197499
93796,0.6212121212121212,0.4184100418410042,-164,139,0.5965983532548766,0.40340164674512335,home,BAL,under,8.5,0.5283018867924528,-112,0.5054496483197499,BAL,KC,2024 REG,3,1,8,4,5,11,0,1,-3,3,1,0,0,0,0,0,0,0,0,0.49455035168025013,0.5054496483197499
93798,0.5348837209302326,0.5098039215686274,-115,-104,0.5109810284308424,0.48901897156915763,away,WSH,over,8,0.5283018867924528,-112,0.5031902949311281,DET,WSH,2024 REG,6,4,5,5,9,11,0,1,-1,1,1,1,1,1,0,0,0,0,0,0.5031902949311281,0.4968097050688719
93798,0.5348837209302326,0.5098039215686274,-115,-104,0.5109810284308424,0.48901897156915763,home,DET,under,8,0.5192307692307692,-108,0.4968097050688719,DET,WSH,2024 REG,6,4,5,5,9,11,0,1,-1,1,1,1,1,1,0,0,0,0,0,0.5031902949311281,0.4968097050688719
93800,0.7455470737913487,0.29411764705882354,-293,240,0.7159751572287522,0.28402484277124784,away,COL,over,7,0.5238095238095238,-110,0.4988662131519274,SD,COL,2024 REG,11,3,10,6,9,21,0,1,-3,3,1,1,1,0,0,0,0,0,0,0.4988662131519274,0.5011337868480725
93800,0.7455470737913487,0.29411764705882354,-293,240,0.7159751572287522,0.28402484277124784,home,SD,under,7,0.5238095238095238,-110,0.5011337868480725,SD,COL,2024 REG,11,3,10,6,9,21,0,1,-3,3,1,1,1,0,0,0,0,0,0,0.4988662131519274,0.5011337868480725
93801,0.5475113122171946,0.49504950495049505,-121,102,0.5242087833606768,0.4757912166393232,away,LAA,over,9.5,0.5,100,0.4772727272727273,CIN,LAA,2024 REG,8,7,7,5,12,15,1,0,2,-2,1,1,1,1,1,0,0,0,0,0.4772727272727273,0.5227272727272727
93801,0.5475113122171946,0.49504950495049505,-121,102,0.5242087833606768,0.4757912166393232,home,CIN,under,9.5,0.5454545454545454,-120,0.5227272727272727,CIN,LAA,2024 REG,8,7,7,5,12,15,1,0,2,-2,1,1,1,1,1,0,0,0,0,0.4772727272727273,0.5227272727272727
93802,0.5555555555555556,0.48780487804878053,-125,105,0.5314664257753688,0.46853357422463116,away,BOS,over,8,0.5327102803738317,-114,0.5075272610403079,CLE,BOS,2024 REG,7,4,6,1,5,13,1,0,3,-3,1,0,0,0,0,0,0,0,0,0.5075272610403079,0.4924727389596921
93802,0.5555555555555556,0.48780487804878053,-125,105,0.5314664257753688,0.46853357422463116,home,CLE,under,8,0.5145631067961165,-106,0.4924727389596921,CLE,BOS,2024 REG,7,4,6,1,5,13,1,0,3,-3,1,0,0,0,0,0,0,0,0,0.5075272610403079,0.4924727389596921
93803,0.48780487804878053,0.5555555555555556,105,-125,0.4666534470222751,0.5333465529777248,away,ARI,over,7,0.5145631067961165,-106,0.49023796582517226,NYM,ARI,2024 REG,9,3,4,2,5,13,1,0,1,-1,1,1,0,0,0,0,0,0,0,0.49023796582517226,0.5097620341748277
93803,0.48780487804878053,0.5555555555555556,105,-125,0.4666534470222751,0.5333465529777248,home,NYM,under,7,0.5327102803738317,-114,0.5097620341748277,NYM,ARI,2024 REG,9,3,4,2,5,13,1,0,1,-1,1,1,0,0,0,0,0,0,0,0.49023796582517226,0.5097620341748277
93804,0.5918367346938775,0.4504504504504505,-145,122,0.566809625118663,0.43319037488133705,away,PIT,over,7.5,0.5,100,0.4772727272727273,ATL,PIT,2024 REG,7,2,7,1,3,14,1,0,1,-1,1,0,0,0,0,0,0,0,0,0.4772727272727273,0.5227272727272727
93804,0.5918367346938775,0.4504504504504505,-145,122,0.566809625118663,0.43319037488133705,home,ATL,under,7.5,0.5454545454545454,-120,0.5227272727272727,ATL,PIT,2024 REG,7,2,7,1,3,14,1,0,1,-1,1,0,0,0,0,0,0,0,0,0.4772727272727273,0.5227272727272727
93806,0.35714285714285715,0.6894409937888198,180,-222,0.3405057675244011,0.6594942324755989,away,LAD,over,12,0.5121951219512195,-105,0.48919479393107135,COL,LAD,2024 REG,6,3,12,5,8,18,0,1,-2,2,1,1,1,0,0,0,0,0,0,0.48919479393107135,0.5108052060689287
93806,0.35714285714285715,0.6894409937888198,180,-222,0.3405057675244011,0.6594942324755989,home,COL,under,12,0.5327102803738317,-114,0.5108052060689287,COL,LAD,2024 REG,6,3,12,5,8,18,0,1,-2,2,1,1,1,0,0,0,0,0,0,0.48919479393107135,0.5108052060689287
93807,0.6197718631178707,0.42016806722689076,-163,138,0.5950182180753,0.4049817819247,away,SEA,over,8,0.5348837209302326,-115,0.5097020142727117,MIN,SEA,2024 REG,9,6,10,10,16,19,0,1,-4,4,1,1,1,1,1,1,0,0,0,0.5097020142727117,0.49029798572728833
93807,0.6197718631178707,0.42016806722689076,-163,138,0.5950182180753,0.4049817819247,home,MIN,under,8,0.5121951219512195,-105,0.49029798572728833,MIN,SEA,2024 REG,9,6,10,10,16,19,0,1,-4,4,1,1,1,1,1,1,0,0,0,0.5097020142727117,0.49029798572728833
93809,0.47846889952153115,0.5594713656387665,109,-127,0.4603156626027285,0.5396843373972715,away,SD,over,9.5,0.5024875621890548,-101,0.47839724939301687,CIN,SD,2024 REG,6,3,14,7,10,20,0,1,-4,4,1,1,1,0,0,0,0,0,0,0.47839724939301687,0.5216027506069831
93809,0.47846889952153115,0.5594713656387665,109,-127,0.4603156626027285,0.5396843373972715,home,CIN,under,9.5,0.5454545454545454,-120,0.5216027506069831,CIN,SD,2024 REG,6,3,14,7,10,20,0,1,-4,4,1,1,1,0,0,0,0,0,0,0.47839724939301687,0.5216027506069831
93816,0.574468085106383,0.46511627906976744,-135,115,0.5517281312179562,0.44827186878204384,away,SD,over,8.5,0.5238095238095238,-110,0.4988662131519274,NYM,SD,2024 REG,10,5,2,1,6,12,1,0,4,-4,1,0,0,0,0,0,0,0,0,0.4988662131519274,0.5011337868480725
93816,0.574468085106383,0.46511627906976744,-135,115,0.5517281312179562,0.44827186878204384,home,NYM,under,8.5,0.5238095238095238,-110,0.5011337868480725,NYM,SD,2024 REG,10,5,2,1,6,12,1,0,4,-4,1,0,0,0,0,0,0,0,0,0.4988662131519274,0.5011337868480725
93817,0.5454545454545454,0.49504950495049505,-120,102,0.5233614270517961,0.4766385729482039,away,MIL,over,8.5,0.5370370370370371,-116,0.5131785224377817,KC,MIL,2024 REG,9,6,8,4,10,17,1,0,2,-2,1,1,1,1,0,0,0,0,0,0.5131785224377817,0.4868214775622183
93817,0.5454545454545454,0.49504950495049505,-120,102,0.5233614270517961,0.4766385729482039,home,KC,under,8.5,0.5073891625615764,-103,0.4868214775622183,KC,MIL,2024 REG,9,6,8,4,10,17,1,0,2,-2,1,1,1,1,0,0,0,0,0,0.5131785224377817,0.4868214775622183
93818,0.6363636363636364,0.40485829959514175,-175,147,0.6101314952989593,0.38986850470104073,away,COL,over,7.5,0.5145631067961165,-106,0.4913668392989033,MIA,COL,2024 REG,9,5,5,4,9,14,1,0,1,-1,1,1,1,1,0,0,0,0,0,0.4913668392989033,0.5086331607010968
93818,0.6363636363636364,0.40485829959514175,-175,147,0.6101314952989593,0.38986850470104073,home,MIA,under,7.5,0.5305164319248826,-113,0.5086331607010968,MIA,COL,2024 REG,9,5,5,4,9,14,1,0,1,-1,1,1,1,1,0,0,0,0,0,0.4913668392989033,0.5086331607010968
93821,0.4739336492890995,0.5652173913043479,111,-130,0.4553786537471813,0.5446213462528187,away,CLE,over,11,0.5348837209302326,-115,0.5097020142727117,COL,CLE,2024 REG,8,8,10,6,14,18,1,0,2,-2,1,1,1,1,1,1,0,0,0,0.5097020142727117,0.49029798572728833
93821,0.4739336492890995,0.5652173913043479,111,-130,0.4553786537471813,0.5446213462528187,home,COL,under,11,0.5121951219512195,-105,0.49029798572728833,COL,CLE,2024 REG,8,8,10,6,14,18,1,0,2,-2,1,1,1,1,1,1,0,0,0,0.5097020142727117,0.49029798572728833
93823,0.647887323943662,0.39370078740157477,-184,154,0.6209429137763255,0.3790570862236745,away,MIA,over,8,0.5348837209302326,-115,0.5097020142727117,DET,MIA,2024 REG,4,0,4,1,1,8,0,1,-1,1,0,0,0,0,0,0,0,0,0,0.5097020142727117,0.49029798572728833
93823,0.647887323943662,0.39370078740157477,-184,154,0.6209429137763255,0.3790570862236745,home,DET,under,8,0.5121951219512195,-105,0.49029798572728833,DET,MIA,2024 REG,4,0,4,1,1,8,0,1,-1,1,0,0,0,0,0,0,0,0,0,0.5097020142727117,0.49029798572728833
93824,0.4807692307692307,0.5614035087719298,108,-128,0.4604938752205958,0.5395061247794042,away,NYY,over,9,0.5,100,0.4772727272727273,BAL,NYY,2024 REG,9,4,5,2,6,14,1,0,2,-2,1,1,0,0,0,0,0,0,0,0.4772727272727273,0.5227272727272727
93824,0.4807692307692307,0.5614035087719298,108,-128,0.4604938752205958,0.5395061247794042,home,BAL,under,9,0.5454545454545454,-120,0.5227272727272727,BAL,NYY,2024 REG,9,4,5,2,6,14,1,0,2,-2,1,1,0,0,0,0,0,0,0,0.4772727272727273,0.5227272727272727
93825,0.7601918465227817,0.2840909090909091,-317,252,0.7265284567636929,0.27347154323630707,away,ARI,over,9,0.5238095238095238,-110,0.4988662131519274,ATL,ARI,2024 REG,12,6,9,5,11,21,1,0,1,-1,1,1,1,1,1,0,0,0,0,0.4988662131519274,0.5011337868480725
93825,0.7601918465227817,0.2840909090909091,-317,252,0.7265284567636929,0.27347154323630707,home,ATL,under,9,0.5238095238095238,-110,0.5011337868480725,ATL,ARI,2024 REG,12,6,9,5,11,21,1,0,1,-1,1,1,1,1,1,0,0,0,0,0.4988662131519274,0.5011337868480725
93826,0.5850622406639003,0.45454545454545453,-141,120,0.5618892737571823,0.43811072624281766,away,KC,over,8,0.5121951219512195,-105,0.48808156828023186,TOR,KC,2024 REG,4,1,7,6,7,11,0,1,-5,5,1,0,0,0,0,0,0,0,0,0.48808156828023186,0.5119184317197681
93826,0.5850622406639003,0.45454545454545453,-141,120,0.5618892737571823,0.43811072624281766,home,TOR,under,8,0.5348837209302326,-115,0.5119184317197681,TOR,KC,2024 REG,4,1,7,6,7,11,0,1,-5,5,1,0,0,0,0,0,0,0,0,0.48808156828023186,0.5119184317197681
93827,0.5192307692307692,0.5238095238095238,-108,-110,0.49688292476754015,0.5031170752324599,away,TB,over,8,0.5238095238095238,-110,0.4988662131519274,KC,TB,2024 REG,7,4,5,2,6,12,1,0,2,-2,1,1,0,0,0,0,0,0,0,0.4988662131519274,0.5011337868480725
93827,0.5192307692307692,0.5238095238095238,-108,-110,0.49688292476754015,0.5031170752324599,home,KC,under,8,0.5238095238095238,-110,0.5011337868480725,KC,TB,2024 REG,7,4,5,2,6,12,1,0,2,-2,1,1,0,0,0,0,0,0,0,0.4988662131519274,0.5011337868480725
93830,0.6031746031746031,0.4347826086956522,-152,130,0.5802797769671475,0.4197202230328525,away,ARI,over,7,0.5475113122171946,-121,0.5214983313199976,SEA,ARI,2024 REG,4,3,3,1,4,7,1,0,2,-2,1,0,0,0,0,0,0,0,0,0.5214983313199976,0.47850166868000243
93830,0.6031746031746031,0.4347826086956522,-152,130,0.5802797769671475,0.4197202230328525,home,SEA,under,7,0.5,100,0.47850166868000243,SEA,ARI,2024 REG,4,3,3,1,4,7,1,0,2,-2,1,0,0,0,0,0,0,0,0,0.5214983313199976,0.47850166868000243
93831,0.607843137254902,0.4347826086956522,-155,130,0.5819333701084867,0.41806662989151333,away,ARI,over,7.5,0.5412844036697247,-118,0.5136310900085983,SF,ARI,2024 REG,8,5,3,0,5,11,1,0,5,-5,0,0,0,0,0,0,0,0,0,0.5136310900085983,0.4863689099914017
93831,0.607843137254902,0.4347826086956522,-155,130,0.5819333701084867,0.41806662989151333,home,SF,under,7.5,0.5098039215686274,-104,0.4863689099914017,SF,ARI,2024 REG,8,5,3,0,5,11,1,0,5,-5,0,0,0,0,0,0,0,0,0,0.5136310900085983,0.4863689099914017
93832,0.5121951219512195,0.5348837209302326,-105,-115,0.48808156828023186,0.5119184317197681,away,LAD,over,8.5,0.5238095238095238,-110,0.4988662131519274,CHC,LAD,2024 REG,7,8,4,1,9,11,1,0,7,-7,1,0,0,0,0,0,0,0,0,0.4988662131519274,0.5011337868480725
93832,0.5121951219512195,0.5348837209302326,-105,-115,0.48808156828023186,0.5119184317197681,home,CHC,under,8.5,0.5238095238095238,-110,0.5011337868480725,CHC,LAD,2024 REG,7,8,4,1,9,11,1,0,7,-7,1,0,0,0,0,0,0,0,0,0.4988662131519274,0.5011337868480725
93833,0.4065040650406504,0.6363636363636364,146,-175,0.389078170160859,0.610921829839141,away,LAD,over,8.5,0.5024875621890548,-101,0.47839724939301687,CWS,LAD,2024 REG,4,0,6,4,4,10,0,1,-4,4,0,0,0,0,0,0,0,0,0,0.47839724939301687,0.5216027506069831
93833,0.4065040650406504,0.6363636363636364,146,-175,0.389078170160859,0.610921829839141,home,CWS,under,8.5,0.5454545454545454,-120,0.5216027506069831,CWS,LAD,2024 REG,4,0,6,4,4,10,0,1,-4,4,0,0,0,0,0,0,0,0,0,0.47839724939301687,0.5216027506069831
93835,0.5,0.5454545454545454,100,-120,0.4772727272727273,0.5227272727272727,away,TB,over,9,0.5454545454545454,-120,0.5179608869977906,LAA,TB,2024 REG,9,2,7,4,6,16,0,1,-2,2,1,1,0,0,0,0,0,0,0,0.5179608869977906,0.48203911300220936
93835,0.5,0.5454545454545454,100,-120,0.4772727272727273,0.5227272727272727,home,LAA,under,9,0.504950495049505,-102,0.48203911300220936,LAA,TB,2024 REG,9,2,7,4,6,16,0,1,-2,2,1,1,0,0,0,0,0,0,0,0.5179608869977906,0.48203911300220936
93836,0.5555555555555556,0.48780487804878053,-125,105,0.5314664257753688,0.46853357422463116,away,ARI,over,8.5,0.5098039215686274,-104,0.48375889301574193,NYM,ARI,2024 REG,12,5,11,10,15,23,0,1,-5,5,1,1,1,1,1,0,0,0,0,0.48375889301574193,0.5162411069842581
93836,0.5555555555555556,0.48780487804878053,-125,105,0.5314664257753688,0.46853357422463116,home,NYM,under,8.5,0.5412844036697247,-118,0.5162411069842581,NYM,ARI,2024 REG,12,5,11,10,15,23,0,1,-5,5,1,1,1,1,1,0,0,0,0,0.48375889301574193,0.5162411069842581
93837,0.696969696969697,0.3448275862068966,-230,190,0.6678382571799499,0.33216174282005007,away,MIA,over,8,0.5238095238095238,-110,0.4988662131519274,HOU,MIA,2024 REG,13,9,6,1,10,19,1,0,8,-8,1,0,0,0,0,0,0,0,0,0.4988662131519274,0.5011337868480725
93837,0.696969696969697,0.3448275862068966,-230,190,0.6678382571799499,0.33216174282005007,home,HOU,under,8,0.5238095238095238,-110,0.5011337868480725,HOU,MIA,2024 REG,13,9,6,1,10,19,1,0,8,-8,1,0,0,0,0,0,0,0,0,0.4988662131519274,0.5011337868480725
93838,0.5454545454545454,0.5,-120,100,0.5206611570247933,0.4793388429752067,away,CLE,over,7.5,0.49504950495049505,102,0.47297076509898783,CWS,CLE,2024 REG,8,6,8,3,9,16,1,0,3,-3,1,1,1,0,0,0,0,0,0,0.47297076509898783,0.5270292349010122
93838,0.5454545454545454,0.5,-120,100,0.5206611570247933,0.4793388429752067,home,CWS,under,7.5,0.5495495495495495,-122,0.5270292349010122,CWS,CLE,2024 REG,8,6,8,3,9,16,1,0,3,-3,1,1,1,0,0,0,0,0,0,0.47297076509898783,0.5270292349010122
93839,0.6282527881040892,0.4132231404958678,-169,142,0.60219542032196,0.39780457967803995,away,CIN,over,7.5,0.5,100,0.4772727272727273,MIL,CIN,2024 REG,8,5,10,6,11,18,0,1,-1,1,1,1,1,1,1,0,0,0,0,0.4772727272727273,0.5227272727272727
93839,0.6282527881040892,0.4132231404958678,-169,142,0.60219542032196,0.39780457967803995,home,MIL,under,7.5,0.5454545454545454,-120,0.5227272727272727,MIL,CIN,2024 REG,8,5,10,6,11,18,0,1,-1,1,1,1,1,1,1,0,0,0,0,0.4772727272727273,0.5227272727272727
93842,0.504950495049505,0.5391705069124424,-102,-117,0.4826715732667395,0.5173284267332605,away,HOU,over,8,0.5412844036697247,-118,0.5136310900085983,SF,HOU,2024 REG,9,4,9,3,7,18,1,0,1,-1,1,1,1,0,0,0,0,0,0,0.5136310900085983,0.4863689099914017
93842,0.504950495049505,0.5391705069124424,-102,-117,0.4826715732667395,0.5173284267332605,home,SF,under,8,0.5098039215686274,-104,0.4863689099914017,SF,HOU,2024 REG,9,4,9,3,7,18,1,0,1,-1,1,1,1,0,0,0,0,0,0,0.5136310900085983,0.4863689099914017
93843,0.574468085106383,0.46511627906976744,-135,115,0.5517281312179562,0.44827186878204384,away,PHI,over,7,0.5348837209302326,-115,0.5097020142727117,BAL,PHI,2024 REG,10,8,10,3,11,20,1,0,5,-5,1,1,1,0,0,0,0,0,0,0.5097020142727117,0.49029798572728833
93843,0.574468085106383,0.46511627906976744,-135,115,0.5517281312179562,0.44827186878204384,home,BAL,under,7,0.5121951219512195,-105,0.49029798572728833,BAL,PHI,2024 REG,10,8,10,3,11,20,1,0,5,-5,1,1,1,0,0,0,0,0,0,0.5097020142727117,0.49029798572728833
93844,0.6031746031746031,0.4366812227074236,-152,129,0.5791345812140156,0.4208654187859844,away,LAA,over,8.5,0.5121951219512195,-105,0.48808156828023186,CHC,LAA,2024 REG,4,0,12,7,7,16,0,1,-7,7,0,0,0,0,0,0,0,0,0,0.48808156828023186,0.5119184317197681
93844,0.6031746031746031,0.4366812227074236,-152,129,0.5791345812140156,0.4208654187859844,home,CHC,under,8.5,0.5348837209302326,-115,0.5119184317197681,CHC,LAA,2024 REG,4,0,12,7,7,16,0,1,-7,7,0,0,0,0,0,0,0,0,0,0.48808156828023186,0.5119184317197681
93847,0.47619047619047616,0.5652173913043479,110,-130,0.4564724440500838,0.5435275559499162,away,CIN,over,10.5,0.5454545454545454,-120,0.5206611570247933,COL,CIN,2024 REG,3,1,12,4,5,15,0,1,-3,3,1,0,0,0,0,0,0,0,0,0.5206611570247933,0.4793388429752067
93847,0.47619047619047616,0.5652173913043479,110,-130,0.4564724440500838,0.5435275559499162,home,COL,under,10.5,0.5,100,0.4793388429752067,COL,CIN,2024 REG,3,1,12,4,5,15,0,1,-3,3,1,0,0,0,0,0,0,0,0,0.5206611570247933,0.4793388429752067
93850,0.6632996632996633,0.37878787878787884,-197,164,0.6353830108038862,0.36461698919611385,away,OAK,over,10,0.5348837209302326,-115,0.5097020142727117,BOS,OAK,2024 REG,8,2,8,5,7,16,0,1,-3,3,1,1,0,0,0,0,0,0,0,0.5097020142727117,0.49029798572728833
93850,0.6632996632996633,0.37878787878787884,-197,164,0.6353830108038862,0.36461698919611385,home,BOS,under,10,0.5121951219512195,-105,0.49029798572728833,BOS,OAK,2024 REG,8,2,8,5,7,16,0,1,-3,3,1,1,0,0,0,0,0,0,0,0.5097020142727117,0.49029798572728833
93851,0.6226415094339623,0.4166666666666667,-165,140,0.5981666073335706,0.40183339266642937,away,TEX,over,8.5,0.5098039215686274,-104,0.48592421718142587,LAD,TEX,2024 REG,7,2,8,3,5,15,0,1,-1,1,1,1,0,0,0,0,0,0,0,0.48592421718142587,0.5140757828185741
93851,0.6226415094339623,0.4166666666666667,-165,140,0.5981666073335706,0.40183339266642937,home,LAD,under,8.5,0.5370370370370371,-116,0.5140757828185741,LAD,TEX,2024 REG,7,2,8,3,5,15,0,1,-1,1,1,1,0,0,0,0,0,0,0,0.48592421718142587,0.5140757828185741
93852,0.5121951219512195,0.5348837209302326,-105,-115,0.48808156828023186,0.5119184317197681,away,MIL,over,11.5,0.5145631067961165,-106,0.49023796582517226,COL,MIL,2024 REG,7,3,12,4,7,19,0,1,-1,1,1,1,1,0,0,0,0,0,0,0.49023796582517226,0.5097620341748277
93852,0.5121951219512195,0.5348837209302326,-105,-115,0.48808156828023186,0.5119184317197681,home,COL,under,11.5,0.5327102803738317,-114,0.5097620341748277,COL,MIL,2024 REG,7,3,12,4,7,19,0,1,-1,1,1,1,1,0,0,0,0,0,0,0.49023796582517226,0.5097620341748277
93853,0.4166666666666667,0.6226415094339623,140,-165,0.4002882599580712,0.5997117400419287,away,SEA,over,8.5,0.5433789954337899,-119,0.5184560714286826,LAA,SEA,2024 REG,5,0,15,11,11,20,0,1,-11,11,0,0,0,0,0,0,0,0,0,0.5184560714286826,0.48154392857131745
93853,0.4166666666666667,0.6226415094339623,140,-165,0.4002882599580712,0.5997117400419287,home,LAA,under,8.5,0.5024875621890548,-101,0.48154392857131745,LAA,SEA,2024 REG,5,0,15,11,11,20,0,1,-11,11,0,0,0,0,0,0,0,0,0,0.5184560714286826,0.48154392857131745
93854,0.6666666666666666,0.37735849056603776,-200,165,0.6373165618448637,0.36268343815513626,away,LAA,over,9,0.5145631067961165,-106,0.49023796582517226,HOU,LAA,2024 REG,10,6,11,5,11,21,1,0,1,-1,1,1,1,1,1,0,0,0,0,0.49023796582517226,0.5097620341748277
93854,0.6666666666666666,0.37735849056603776,-200,165,0.6373165618448637,0.36268343815513626,home,HOU,under,9,0.5327102803738317,-114,0.5097620341748277,HOU,LAA,2024 REG,10,6,11,5,11,21,1,0,1,-1,1,1,1,1,1,0,0,0,0,0.49023796582517226,0.5097620341748277
93855,0.626865671641791,0.4081632653061224,-168,145,0.6049072335550394,0.3950927664449606,away,KC,over,7.5,0.5024875621890548,-101,0.47839724939301687,DET,KC,2024 REG,10,4,5,1,5,15,1,0,3,-3,1,0,0,0,0,0,0,0,0,0.47839724939301687,0.5216027506069831
93855,0.626865671641791,0.4081632653061224,-168,145,0.6049072335550394,0.3950927664449606,home,DET,under,7.5,0.5454545454545454,-120,0.5216027506069831,DET,KC,2024 REG,10,4,5,1,5,15,1,0,3,-3,1,0,0,0,0,0,0,0,0,0.47839724939301687,0.5216027506069831
93857,0.5121951219512195,0.5327102803738317,-105,-114,0.48919479393107135,0.5108052060689287,away,KC,over,9,0.5454545454545454,-120,0.5179608869977906,BOS,KC,2024 REG,5,1,9,6,7,14,0,1,-5,5,1,0,0,0,0,0,0,0,0,0.5179608869977906,0.48203911300220936
93857,0.5121951219512195,0.5327102803738317,-105,-114,0.48919479393107135,0.5108052060689287,home,BOS,under,9,0.504950495049505,-102,0.48203911300220936,BOS,KC,2024 REG,5,1,9,6,7,14,0,1,-5,5,1,0,0,0,0,0,0,0,0,0.5179608869977906,0.48203911300220936
93858,0.5867768595041323,0.4504504504504505,-142,122,0.5649327354811953,0.43506726451880473,away,NYM,over,8.5,0.5348837209302326,-115,0.5097020142727117,PHI,NYM,2024 REG,8,5,8,6,11,16,0,1,-1,1,1,1,1,1,1,0,0,0,0,0.5097020142727117,0.49029798572728833
93858,0.5867768595041323,0.4504504504504505,-142,122,0.5649327354811953,0.43506726451880473,home,PHI,under,8.5,0.5121951219512195,-105,0.49029798572728833,PHI,NYM,2024 REG,8,5,8,6,11,16,0,1,-1,1,1,1,1,1,1,0,0,0,0,0.5097020142727117,0.49029798572728833
93859,0.5024875621890548,0.5412844036697247,-101,-118,0.48049269377245407,0.5195073062275459,away,CHC,over,9,0.5215311004784688,-109,0.4978845547971712,BOS,CHC,2024 REG,21,17,5,0,17,26,1,0,17,-17,0,0,0,0,0,0,0,0,0,0.4978845547971712,0.5021154452028288
93859,0.5024875621890548,0.5412844036697247,-101,-118,0.48049269377245407,0.5195073062275459,home,BOS,under,9,0.5238095238095238,-110,0.5021154452028288,BOS,CHC,2024 REG,21,17,5,0,17,26,1,0,17,-17,0,0,0,0,0,0,0,0,0,0.4978845547971712,0.5021154452028288
93860,0.7142857142857143,0.3278688524590164,-250,205,0.6841753094680495,0.3158246905319505,away,COL,over,8.5,0.5073891625615764,-103,0.4826927225525911,MIN,COL,2024 REG,7,5,6,0,5,13,1,0,5,-5,0,0,0,0,0,0,0,0,0,0.4826927225525911,0.5173072774474089
93860,0.7142857142857143,0.3278688524590164,-250,205,0.6841753094680495,0.3158246905319505,home,MIN,under,8.5,0.5412844036697247,-118,0.5173072774474089,MIN,COL,2024 REG,7,5,6,0,5,13,1,0,5,-5,0,0,0,0,0,0,0,0,0,0.4826927225525911,0.5173072774474089
93863,0.47619047619047616,0.5652173913043479,110,-130,0.4564724440500838,0.5435275559499162,away,PIT,over,7.5,0.5,100,0.4772727272727273,OAK,PIT,2024 REG,8,5,5,2,7,13,1,0,3,-3,1,1,0,0,0,0,0,0,0,0.4772727272727273,0.5227272727272727
93863,0.47619047619047616,0.5652173913043479,110,-130,0.4564724440500838,0.5435275559499162,home,OAK,under,7.5,0.5454545454545454,-120,0.5227272727272727,OAK,PIT,2024 REG,8,5,5,2,7,13,1,0,3,-3,1,1,0,0,0,0,0,0,0,0.4772727272727273,0.5227272727272727
93864,0.6240601503759399,0.41493775933609955,-166,141,0.5997231089766972,0.40027689102330277,away,TEX,over,8.5,0.5305164319248826,-113,0.5053568787472517,LAD,TEX,2024 REG,14,15,5,2,17,19,1,0,13,-13,1,1,0,0,0,0,0,0,0,0.5053568787472517,0.49464312125274834
93864,0.6240601503759399,0.41493775933609955,-166,141,0.5997231089766972,0.40027689102330277,home,LAD,under,8.5,0.5169082125603864,-107,0.49464312125274834,LAD,TEX,2024 REG,14,15,5,2,17,19,1,0,13,-13,1,1,0,0,0,0,0,0,0,0.5053568787472517,0.49464312125274834
93868,0.7142857142857143,0.3278688524590164,-250,205,0.6841753094680495,0.3158246905319505,away,COL,over,7.5,0.5454545454545454,-120,0.5193043049216726,MIN,COL,2024 REG,24,17,12,9,26,36,1,0,8,-8,1,1,1,1,1,1,1,1,1,0.5193043049216726,0.48069569507832743
93868,0.7142857142857143,0.3278688524590164,-250,205,0.6841753094680495,0.3158246905319505,home,MIN,under,7.5,0.5024875621890548,-101,0.48069569507832743,MIN,COL,2024 REG,24,17,12,9,26,36,1,0,8,-8,1,1,1,1,1,1,1,1,1,0.5193043049216726,0.48069569507832743
93869,0.5867768595041323,0.45454545454545453,-142,120,0.5625298818386723,0.43747011816132775,away,TOR,over,9,0.5098039215686274,-104,0.48592421718142587,CLE,TOR,2024 REG,8,6,4,3,9,12,1,0,3,-3,1,1,1,0,0,0,0,0,0,0.48592421718142587,0.5140757828185741
93869,0.5867768595041323,0.45454545454545453,-142,120,0.5625298818386723,0.43747011816132775,home,CLE,under,9,0.5370370370370371,-116,0.5140757828185741,CLE,TOR,2024 REG,8,6,4,3,9,12,1,0,3,-3,1,1,1,0,0,0,0,0,0,0.48592421718142587,0.5140757828185741
93870,0.4484304932735426,0.5934959349593496,123,-146,0.429629404379869,0.570370595620131,away,NYY,over,8.5,0.5370370370370371,-116,0.5118817074154765,TB,NYY,2024 REG,8,6,11,10,16,19,0,1,-4,4,1,1,1,1,1,1,0,0,0,0.5118817074154765,0.48811829258452355
93870,0.4484304932735426,0.5934959349593496,123,-146,0.429629404379869,0.570370595620131,home,TB,under,8.5,0.5098039215686274,-104,0.48811829258452355,TB,NYY,2024 REG,8,6,11,10,16,19,0,1,-4,4,1,1,1,1,1,1,0,0,0,0.5118817074154765,0.48811829258452355
93872,0.5535714285714286,0.48780487804878053,-124,105,0.53066668740667,0.46933331259333,away,SD,over,7.5,0.5238095238095238,-110,0.4988662131519274,ATL,SD,2024 REG,12,5,10,6,11,22,0,1,-1,1,1,1,1,1,1,0,0,0,0,0.4988662131519274,0.5011337868480725
93872,0.5535714285714286,0.48780487804878053,-124,105,0.53066668740667,0.46933331259333,home,ATL,under,7.5,0.5238095238095238,-110,0.5011337868480725,ATL,SD,2024 REG,12,5,10,6,11,22,0,1,-1,1,1,1,1,1,1,0,0,0,0,0.4988662131519274,0.5011337868480725
93873,0.7275204359673024,0.31545741324921134,-267,217,0.6962531723683673,0.30374682763163274,away,CWS,over,8.5,0.5121951219512195,-105,0.48808156828023186,TB,CWS,2024 REG,4,1,12,4,5,16,0,1,-3,3,1,0,0,0,0,0,0,0,0,0.48808156828023186,0.5119184317197681
93873,0.7275204359673024,0.31545741324921134,-267,217,0.6962531723683673,0.30374682763163274,home,TB,under,8.5,0.5348837209302326,-115,0.5119184317197681,TB,CWS,2024 REG,4,1,12,4,5,16,0,1,-3,3,1,0,0,0,0,0,0,0,0,0.48808156828023186,0.5119184317197681
93874,0.5412844036697247,0.5,-118,100,0.5189377998484975,0.4810622001515025,away,BOS,over,8,0.5238095238095238,-110,0.4988662131519274,LAA,BOS,2024 REG,6,2,3,1,3,9,1,0,1,-1,1,0,0,0,0,0,0,0,0,0.4988662131519274,0.5011337868480725
93874,0.5412844036697247,0.5,-118,100,0.5189377998484975,0.4810622001515025,home,LAA,under,8,0.5238095238095238,-110,0.5011337868480725,LAA,BOS,2024 REG,6,2,3,1,3,9,1,0,1,-1,1,0,0,0,0,0,0,0,0,0.4988662131519274,0.5011337868480725
93876,0.5798319327731092,0.4587155963302753,-138,118,0.557480844469466,0.442519155530534,away,WSH,over,7.5,0.5370370370370371,-116,0.5131785224377817,BOS,WSH,2024 REG,7,3,5,2,5,12,1,0,1,-1,1,1,0,0,0,0,0,0,0,0.5131785224377817,0.4868214775622183
93876,0.5798319327731092,0.4587155963302753,-138,118,0.557480844469466,0.442519155530534,home,BOS,under,7.5,0.5073891625615764,-103,0.4868214775622183,BOS,WSH,2024 REG,7,3,5,2,5,12,1,0,1,-1,1,1,0,0,0,0,0,0,0,0.5131785224377817,0.4868214775622183
93877,0.48780487804878053,0.5555555555555556,105,-125,0.4666534470222751,0.5333465529777248,away,WSH,over,11,0.5238095238095238,-110,0.4988662131519274,COL,WSH,2024 REG,11,5,19,11,16,30,0,1,-6,6,1,1,1,1,1,0,0,0,0,0.4988662131519274,0.5011337868480725
93877,0.48780487804878053,0.5555555555555556,105,-125,0.4666534470222751,0.5333465529777248,home,COL,under,11,0.5238095238095238,-110,0.5011337868480725,COL,WSH,2024 REG,11,5,19,11,16,30,0,1,-6,6,1,1,1,1,1,0,0,0,0,0.4988662131519274,0.5011337868480725
93883,0.45454545454545453,0.5833333333333333,120,-140,0.43732782369146006,0.5626721763085399,away,LAD,over,8.5,0.5454545454545454,-120,0.5206611570247933,ARI,LAD,2024 REG,7,0,10,8,8,17,0,1,-8,8,0,0,0,0,0,0,0,0,0,0.5206611570247933,0.4793388429752067
93883,0.45454545454545453,0.5833333333333333,120,-140,0.43732782369146006,0.5626721763085399,home,ARI,under,8.5,0.5,100,0.4793388429752067,ARI,LAD,2024 REG,7,0,10,8,8,17,0,1,-8,8,0,0,0,0,0,0,0,0,0,0.5206611570247933,0.4793388429752067
93884,0.5121951219512195,0.5283018867924528,-105,-112,0.49145275161909474,0.5085472483809053,away,ATL,over,9.5,0.5121951219512195,-105,0.48808156828023186,HOU,ATL,2024 REG,7,2,11,6,8,18,0,1,-4,4,1,1,0,0,0,0,0,0,0,0.48808156828023186,0.5119184317197681
93884,0.5121951219512195,0.5283018867924528,-105,-112,0.49145275161909474,0.5085472483809053,home,HOU,under,9.5,0.5348837209302326,-115,0.5119184317197681,HOU,ATL,2024 REG,7,2,11,6,8,18,0,1,-4,4,1,1,0,0,0,0,0,0,0,0.48808156828023186,0.5119184317197681
93891,0.7058823529411764,0.3367003367003367,-240,197,0.6758239837824612,0.3241760162175388,away,OAK,over,7.5,0.5215311004784688,-109,0.49670754937970685,SD,OAK,2024 REG,10,6,8,1,7,18,1,0,5,-5,1,0,0,0,0,0,0,0,0,0.49670754937970685,0.5032924506202932
93891,0.7058823529411764,0.3367003367003367,-240,197,0.6758239837824612,0.3241760162175388,home,SD,under,7.5,0.5260663507109005,-111,0.5032924506202932,SD,OAK,2024 REG,10,6,8,1,7,18,1,0,5,-5,1,0,0,0,0,0,0,0,0,0.49670754937970685,0.5032924506202932
93893,0.4672897196261683,0.5726495726495727,114,-134,0.44862649893656975,0.5513735010634302,away,NYM,over,9.5,0.5169082125603864,-107,0.4912600060678196,PIT,NYM,2024 REG,6,2,11,5,7,17,0,1,-3,3,1,1,0,0,0,0,0,0,0,0.4912600060678196,0.5087399939321804
93893,0.4672897196261683,0.5726495726495727,114,-134,0.44862649893656975,0.5513735010634302,home,PIT,under,9.5,0.5327102803738317,-114,0.5087399939321804,PIT,NYM,2024 REG,6,2,11,5,7,17,0,1,-3,3,1,1,0,0,0,0,0,0,0,0.4912600060678196,0.5087399939321804
93895,0.6226415094339623,0.4166666666666667,-165,140,0.5981666073335706,0.40183339266642937,away,NYM,over,9.5,0.5433789954337899,-119,0.5171177654451503,ATL,NYM,2024 REG,10,4,16,16,20,26,0,1,-12,12,1,1,1,1,0,0,0,0,0,0.5171177654451503,0.4828822345548497
93895,0.6226415094339623,0.4166666666666667,-165,140,0.5981666073335706,0.40183339266642937,home,ATL,under,9.5,0.504950495049505,-102,0.4828822345548497,ATL,NYM,2024 REG,10,4,16,16,20,26,0,1,-12,12,1,1,1,1,0,0,0,0,0,0.5171177654451503,0.4828822345548497
93897,0.4081632653061224,0.6363636363636364,145,-175,0.3899890197266291,0.6100109802733709,away,NYY,over,10.5,0.5454545454545454,-120,0.5206611570247933,KC,NYY,2024 REG,11,5,11,11,16,22,0,1,-6,6,1,1,1,1,1,0,0,0,0,0.5206611570247933,0.4793388429752067
93897,0.4081632653061224,0.6363636363636364,145,-175,0.3899890197266291,0.6100109802733709,home,KC,under,10.5,0.5,100,0.4793388429752067,KC,NYY,2024 REG,11,5,11,11,16,22,0,1,-6,6,1,1,1,1,1,0,0,0,0,0.5206611570247933,0.4793388429752067
93898,0.47846889952153115,0.5614035087719298,109,-128,0.45939119220408575,0.5406088077959142,away,ARI,over,8.5,0.5495495495495495,-122,0.5223196169142115,CIN,ARI,2024 REG,3,2,8,6,8,11,0,1,-4,4,1,1,0,0,0,0,0,0,0,0.5223196169142115,0.47768038308578853
93898,0.47846889952153115,0.5614035087719298,109,-128,0.45939119220408575,0.5406088077959142,home,CIN,under,8.5,0.5,100,0.47768038308578853,CIN,ARI,2024 REG,3,2,8,6,8,11,0,1,-4,4,1,1,0,0,0,0,0,0,0,0.5223196169142115,0.47768038308578853
93899,0.5652173913043479,0.47619047619047616,-130,110,0.5418129444594474,0.4581870555405526,away,CIN,over,7.5,0.5348837209302326,-115,0.5097020142727117,PIT,CIN,2024 REG,3,1,2,0,1,5,1,0,1,-1,0,0,0,0,0,0,0,0,0,0.5097020142727117,0.49029798572728833
93899,0.5652173913043479,0.47619047619047616,-130,110,0.5418129444594474,0.4581870555405526,home,PIT,under,7.5,0.5121951219512195,-105,0.49029798572728833,PIT,CIN,2024 REG,3,1,2,0,1,5,1,0,1,-1,0,0,0,0,0,0,0,0,0,0.5097020142727117,0.49029798572728833
93900,0.5652173913043479,0.47619047619047616,-130,110,0.5418129444594474,0.4581870555405526,away,MIL,over,9,0.5454545454545454,-120,0.5206611570247933,KC,MIL,2024 REG,12,5,13,6,11,25,0,1,-1,1,1,1,1,1,1,0,0,0,0,0.5206611570247933,0.4793388429752067
93900,0.5652173913043479,0.47619047619047616,-130,110,0.5418129444594474,0.4581870555405526,home,KC,under,9,0.5,100,0.4793388429752067,KC,MIL,2024 REG,12,5,13,6,11,25,0,1,-1,1,1,1,1,1,1,0,0,0,0,0.5206611570247933,0.4793388429752067
93902,0.5238095238095238,0.5169082125603864,-110,-107,0.5024811857109994,0.4975188142890006,away,TB,over,8,0.5121951219512195,-105,0.48808156828023186,TEX,TB,2024 REG,8,4,7,3,7,15,1,0,1,-1,1,1,1,0,0,0,0,0,0,0.48808156828023186,0.5119184317197681
93902,0.5238095238095238,0.5169082125603864,-110,-107,0.5024811857109994,0.4975188142890006,home,TEX,under,8,0.5348837209302326,-115,0.5119184317197681,TEX,TB,2024 REG,8,4,7,3,7,15,1,0,1,-1,1,1,1,0,0,0,0,0,0,0.48808156828023186,0.5119184317197681
93903,0.6376811594202898,0.4,-176,150,0.6136525939928585,0.38634740600714146,away,OAK,over,9,0.5283018867924528,-112,0.5031902949311281,ARI,OAK,2024 REG,7,4,14,9,13,21,0,1,-5,5,1,1,1,1,0,0,0,0,0,0.5031902949311281,0.4968097050688719
93903,0.6376811594202898,0.4,-176,150,0.6136525939928585,0.38634740600714146,home,ARI,under,9,0.5192307692307692,-108,0.4968097050688719,ARI,OAK,2024 REG,7,4,14,9,13,21,0,1,-5,5,1,1,1,1,0,0,0,0,0,0.5031902949311281,0.4968097050688719
93904,0.5348837209302326,0.5098039215686274,-115,-104,0.5109810284308424,0.48901897156915763,away,SD,over,8.5,0.5121951219512195,-105,0.48808156828023186,MIL,SD,2024 REG,3,1,5,0,1,8,1,0,1,-1,0,0,0,0,0,0,0,0,0,0.48808156828023186,0.5119184317197681
93904,0.5348837209302326,0.5098039215686274,-115,-104,0.5109810284308424,0.48901897156915763,home,MIL,under,8.5,0.5348837209302326,-115,0.5119184317197681,MIL,SD,2024 REG,3,1,5,0,1,8,1,0,1,-1,0,0,0,0,0,0,0,0,0,0.48808156828023186,0.5119184317197681
93910,0.6774193548387096,0.36363636363636365,-210,175,0.6496074165168858,0.3503925834831142,away,OAK,over,9,0.5238095238095238,-110,0.4988662131519274,HOU,OAK,2024 REG,8,8,4,1,9,12,1,0,7,-7,1,0,0,0,0,0,0,0,0,0.4988662131519274,0.5011337868480725
93910,0.6774193548387096,0.36363636363636365,-210,175,0.6496074165168858,0.3503925834831142,home,HOU,under,9,0.5238095238095238,-110,0.5011337868480725,HOU,OAK,2024 REG,8,8,4,1,9,12,1,0,7,-7,1,0,0,0,0,0,0,0,0,0.4988662131519274,0.5011337868480725
93911,0.5348837209302326,0.5121951219512195,-115,-105,0.5097020142727117,0.49029798572728833,away,SEA,over,6.5,0.5555555555555556,-125,0.5301379811183733,MIN,SEA,2024 REG,11,11,6,1,12,17,1,0,10,-10,1,0,0,0,0,0,0,0,0,0.5301379811183733,0.4698620188816267
93911,0.5348837209302326,0.5121951219512195,-115,-105,0.5097020142727117,0.49029798572728833,home,MIN,under,6.5,0.49019607843137253,104,0.4698620188816267,MIN,SEA,2024 REG,11,11,6,1,12,17,1,0,10,-10,1,0,0,0,0,0,0,0,0,0.5301379811183733,0.4698620188816267
93912,0.5073891625615764,0.5348837209302326,-103,-115,0.4859403596076043,0.5140596403923957,away,BAL,over,8.5,0.5348837209302326,-115,0.5097020142727117,PIT,BAL,2024 REG,7,3,6,2,5,13,1,0,1,-1,1,1,0,0,0,0,0,0,0,0.5097020142727117,0.49029798572728833
93912,0.5073891625615764,0.5348837209302326,-103,-115,0.4859403596076043,0.5140596403923957,home,PIT,under,8.5,0.5121951219512195,-105,0.49029798572728833,PIT,BAL,2024 REG,7,3,6,2,5,13,1,0,1,-1,1,1,0,0,0,0,0,0,0,0.5097020142727117,0.49029798572728833
93913,0.425531914893617,0.6153846153846154,135,-160,0.4081206254135181,0.5918793745864819,away,DET,over,7.5,0.5454545454545454,-120,0.5206611570247933,CWS,DET,2024 REG,3,0,6,1,1,9,0,1,-1,1,0,0,0,0,0,0,0,0,0,0.5206611570247933,0.4793388429752067
93913,0.425531914893617,0.6153846153846154,135,-160,0.4081206254135181,0.5918793745864819,home,CWS,under,7.5,0.5,100,0.4793388429752067,CWS,DET,2024 REG,3,0,6,1,1,9,0,1,-1,1,0,0,0,0,0,0,0,0,0,0.5206611570247933,0.4793388429752067
93914,0.5652173913043479,0.47619047619047616,-130,110,0.5418129444594474,0.4581870555405526,away,BAL,over,9,0.5412844036697247,-118,0.5136310900085983,CIN,BAL,2024 REG,3,1,11,11,12,14,0,1,-10,10,1,0,0,0,0,0,0,0,0,0.5136310900085983,0.4863689099914017
93914,0.5652173913043479,0.47619047619047616,-130,110,0.5418129444594474,0.4581870555405526,home,CIN,under,9,0.5098039215686274,-104,0.4863689099914017,CIN,BAL,2024 REG,3,1,11,11,12,14,0,1,-10,10,1,0,0,0,0,0,0,0,0,0.5136310900085983,0.4863689099914017
93916,0.6491228070175439,0.3921568627450981,-185,155,0.6223272319084604,0.3776727680915396,away,SF,over,7.5,0.5348837209302326,-115,0.5097020142727117,CLE,SF,2024 REG,11,2,6,4,6,17,0,1,-2,2,1,1,0,0,0,0,0,0,0,0.5097020142727117,0.49029798572728833
93916,0.6491228070175439,0.3921568627450981,-185,155,0.6223272319084604,0.3776727680915396,home,CLE,under,7.5,0.5121951219512195,-105,0.49029798572728833,CLE,SF,2024 REG,11,2,6,4,6,17,0,1,-2,2,1,1,0,0,0,0,0,0,0,0.5097020142727117,0.49029798572728833
93917,0.5348837209302326,0.5098039215686274,-115,-104,0.5109810284308424,0.48901897156915763,away,BAL,over,9,0.5283018867924528,-112,0.5031902949311281,BOS,BAL,2024 REG,8,5,9,7,12,17,0,1,-2,2,1,1,1,1,1,0,0,0,0,0.5031902949311281,0.4968097050688719
93917,0.5348837209302326,0.5098039215686274,-115,-104,0.5109810284308424,0.48901897156915763,home,BOS,under,9,0.5192307692307692,-108,0.4968097050688719,BOS,BAL,2024 REG,8,5,9,7,12,17,0,1,-2,2,1,1,1,1,1,0,0,0,0,0.5031902949311281,0.4968097050688719
93918,0.48780487804878053,0.5555555555555556,105,-125,0.4666534470222751,0.5333465529777248,away,MIN,over,7,0.5454545454545454,-120,0.5206611570247933,CLE,MIN,2024 REG,16,11,10,4,15,26,1,0,7,-7,1,1,1,1,0,0,0,0,0,0.5206611570247933,0.4793388429752067
93918,0.48780487804878053,0.5555555555555556,105,-125,0.4666534470222751,0.5333465529777248,home,CLE,under,7,0.5,100,0.4793388429752067,CLE,MIN,2024 REG,16,11,10,4,15,26,1,0,7,-7,1,1,1,1,0,0,0,0,0,0.5206611570247933,0.4793388429752067
93919,0.5652173913043479,0.47619047619047616,-130,110,0.5418129444594474,0.4581870555405526,away,CLE,over,8.5,0.5169082125603864,-107,0.49353874091423283,KC,CLE,2024 REG,11,6,8,2,8,19,1,0,4,-4,1,1,0,0,0,0,0,0,0,0.49353874091423283,0.5064612590857671
93919,0.5652173913043479,0.47619047619047616,-130,110,0.5418129444594474,0.4581870555405526,home,KC,under,8.5,0.5283018867924528,-112,0.5064612590857671,KC,CLE,2024 REG,11,6,8,2,8,19,1,0,4,-4,1,1,0,0,0,0,0,0,0,0.49353874091423283,0.5064612590857671
93922,0.4,0.6415770609318996,150,-179,0.38336917562724016,0.6166308243727598,away,MIN,over,8.5,0.5238095238095238,-110,0.4988662131519274,OAK,MIN,2024 REG,4,2,16,10,12,20,0,1,-8,8,1,1,0,0,0,0,0,0,0,0.4988662131519274,0.5011337868480725
93922,0.4,0.6415770609318996,150,-179,0.38336917562724016,0.6166308243727598,home,OAK,under,8.5,0.5238095238095238,-110,0.5011337868480725,OAK,MIN,2024 REG,4,2,16,10,12,20,0,1,-8,8,1,1,0,0,0,0,0,0,0,0.4988662131519274,0.5011337868480725
93923,0.44052863436123346,0.6000000000000001,127,-150,0.42267461041355353,0.5773253895864465,away,PIT,over,8.5,0.5192307692307692,-108,0.49571111079951763,WSH,PIT,2024 REG,10,5,4,3,8,14,1,0,2,-2,1,1,1,0,0,0,0,0,0,0.49571111079951763,0.5042888892004824
93923,0.44052863436123346,0.6000000000000001,127,-150,0.42267461041355353,0.5773253895864465,home,WSH,under,8.5,0.5260663507109005,-111,0.5042888892004824,WSH,PIT,2024 REG,10,5,4,3,8,14,1,0,2,-2,1,1,1,0,0,0,0,0,0,0.49571111079951763,0.5042888892004824
93925,0.5850622406639003,0.45454545454545453,-141,120,0.5618892737571823,0.43811072624281766,away,WSH,over,9,0.504950495049505,-102,0.47949844489399435,MIL,WSH,2024 REG,6,5,12,6,11,18,0,1,-1,1,1,1,1,1,1,0,0,0,0,0.47949844489399435,0.5205015551060057
93925,0.5850622406639003,0.45454545454545453,-141,120,0.5618892737571823,0.43811072624281766,home,MIL,under,9,0.5454545454545454,-120,0.5205015551060057,MIL,WSH,2024 REG,6,5,12,6,11,18,0,1,-1,1,1,1,1,1,1,0,0,0,0,0.47949844489399435,0.5205015551060057
93926,0.6197718631178707,0.42016806722689076,-163,138,0.5950182180753,0.4049817819247,away,TOR,over,8.5,0.5283018867924528,-112,0.5031902949311281,BOS,TOR,2024 REG,11,7,9,6,13,20,1,0,1,-1,1,1,1,1,1,1,0,0,0,0.5031902949311281,0.4968097050688719
93926,0.6197718631178707,0.42016806722689076,-163,138,0.5950182180753,0.4049817819247,home,BOS,under,8.5,0.5192307692307692,-108,0.4968097050688719,BOS,TOR,2024 REG,11,7,9,6,13,20,1,0,1,-1,1,1,1,1,1,1,0,0,0,0.5031902949311281,0.4968097050688719
93927,0.5495495495495495,0.4926108374384236,-122,103,0.5263803278714742,0.47361967212852585,away,SF,over,7.5,0.5073891625615764,-103,0.4826927225525911,PIT,SF,2024 REG,6,5,12,9,14,18,0,1,-4,4,1,1,1,1,1,0,0,0,0,0.4826927225525911,0.5173072774474089
93927,0.5495495495495495,0.4926108374384236,-122,103,0.5263803278714742,0.47361967212852585,home,PIT,under,7.5,0.5412844036697247,-118,0.5173072774474089,PIT,SF,2024 REG,6,5,12,9,14,18,0,1,-4,4,1,1,1,1,1,0,0,0,0,0.4826927225525911,0.5173072774474089
93928,0.5121951219512195,0.5348837209302326,-105,-115,0.48808156828023186,0.5119184317197681,away,LAD,over,8,0.5,100,0.4772727272727273,CWS,LAD,2024 REG,5,0,9,3,3,14,0,1,-3,3,0,0,0,0,0,0,0,0,0,0.4772727272727273,0.5227272727272727
93928,0.5121951219512195,0.5348837209302326,-105,-115,0.48808156828023186,0.5119184317197681,home,CWS,under,8,0.5454545454545454,-120,0.5227272727272727,CWS,LAD,2024 REG,5,0,9,3,3,14,0,1,-3,3,0,0,0,0,0,0,0,0,0,0.4772727272727273,0.5227272727272727
93929,0.574468085106383,0.46511627906976744,-135,115,0.5517281312179562,0.44827186878204384,away,PHI,over,7,0.5348837209302326,-115,0.5097020142727117,BAL,PHI,2024 REG,8,3,7,5,8,15,0,1,-2,2,1,1,1,0,0,0,0,0,0,0.5097020142727117,0.49029798572728833
93929,0.574468085106383,0.46511627906976744,-135,115,0.5517281312179562,0.44827186878204384,home,BAL,under,7,0.5121951219512195,-105,0.49029798572728833,BAL,PHI,2024 REG,8,3,7,5,8,15,0,1,-2,2,1,1,1,0,0,0,0,0,0,0.5097020142727117,0.49029798572728833
93931,0.5555555555555556,0.48780487804878053,-125,105,0.5314664257753688,0.46853357422463116,away,DET,over,8.5,0.5121951219512195,-105,0.48808156828023186,PIT,DET,2024 REG,8,3,9,5,8,17,0,1,-2,2,1,1,1,0,0,0,0,0,0,0.48808156828023186,0.5119184317197681
93931,0.5555555555555556,0.48780487804878053,-125,105,0.5314664257753688,0.46853357422463116,home,PIT,under,8.5,0.5348837209302326,-115,0.5119184317197681,PIT,DET,2024 REG,8,3,9,5,8,17,0,1,-2,2,1,1,1,0,0,0,0,0,0,0.48808156828023186,0.5119184317197681
93934,0.6575342465753424,0.38314176245210724,-192,161,0.6307883776257865,0.36921162237421346,away,ARI,over,9,0.5121951219512195,-105,0.48808156828023186,LAD,ARI,2024 REG,12,6,10,5,11,22,1,0,1,-1,1,1,1,1,1,0,0,0,0,0.48808156828023186,0.5119184317197681
93934,0.6575342465753424,0.38314176245210724,-192,161,0.6307883776257865,0.36921162237421346,home,LAD,under,9,0.5348837209302326,-115,0.5119184317197681,LAD,ARI,2024 REG,12,6,10,5,11,22,1,0,1,-1,1,1,1,1,1,0,0,0,0,0.48808156828023186,0.5119184317197681
93936,0.5983935742971888,0.4444444444444444,-149,125,0.5727595791465728,0.42724042085342717,away,MIN,over,8,0.5121951219512195,-105,0.48808156828023186,HOU,MIN,2024 REG,6,3,7,4,7,13,0,1,-1,1,1,1,1,0,0,0,0,0,0,0.48808156828023186,0.5119184317197681
93936,0.5983935742971888,0.4444444444444444,-149,125,0.5727595791465728,0.42724042085342717,home,HOU,under,8,0.5348837209302326,-115,0.5119184317197681,HOU,MIN,2024 REG,6,3,7,4,7,13,0,1,-1,1,1,1,1,0,0,0,0,0,0,0.48808156828023186,0.5119184317197681
93937,0.6000000000000001,0.4444444444444444,-150,125,0.5733333333333334,0.42666666666666664,away,WSH,over,8.5,0.5454545454545454,-120,0.5193043049216726,NYM,WSH,2024 REG,9,7,6,0,7,15,1,0,7,-7,0,0,0,0,0,0,0,0,0,0.5193043049216726,0.48069569507832743
93937,0.6000000000000001,0.4444444444444444,-150,125,0.5733333333333334,0.42666666666666664,home,NYM,under,8.5,0.5024875621890548,-101,0.48069569507832743,NYM,WSH,2024 REG,9,7,6,0,7,15,1,0,7,-7,0,0,0,0,0,0,0,0,0,0.5193043049216726,0.48069569507832743
93938,0.6296296296296295,0.4098360655737705,-170,144,0.6047808585756369,0.3952191414243631,away,MIA,over,8.5,0.5475113122171946,-121,0.5214983313199976,DET,MIA,2024 REG,8,6,12,5,11,20,1,0,1,-1,1,1,1,1,1,0,0,0,0,0.5214983313199976,0.47850166868000243
93938,0.6296296296296295,0.4098360655737705,-170,144,0.6047808585756369,0.3952191414243631,home,DET,under,8.5,0.5,-100,0.47850166868000243,DET,MIA,2024 REG,8,6,12,5,11,20,1,0,1,-1,1,1,1,1,1,0,0,0,0,0.5214983313199976,0.47850166868000243
93939,0.49019607843137253,0.5495495495495495,104,-122,0.4707129274603323,0.5292870725396677,away,NYM,over,7.5,0.5121951219512195,-105,0.48808156828023186,MIA,NYM,2024 REG,13,10,15,9,19,28,1,0,1,-1,1,1,1,1,1,1,1,1,1,0.48808156828023186,0.5119184317197681
93939,0.49019607843137253,0.5495495495495495,104,-122,0.4707129274603323,0.5292870725396677,home,MIA,under,7.5,0.5348837209302326,-115,0.5119184317197681,MIA,NYM,2024 REG,13,10,15,9,19,28,1,0,1,-1,1,1,1,1,1,1,1,1,1,0.48808156828023186,0.5119184317197681
93940,0.4098360655737705,0.6296296296296295,144,-170,0.3936616003264754,0.6063383996735245,away,BAL,over,8,0.5454545454545454,-120,0.5206611570247933,WSH,BAL,2024 REG,9,6,10,7,13,19,0,1,-1,1,1,1,1,1,1,1,0,0,0,0.5206611570247933,0.4793388429752067
93940,0.4098360655737705,0.6296296296296295,144,-170,0.3936616003264754,0.6063383996735245,home,WSH,under,8,0.5,100,0.4793388429752067,WSH,BAL,2024 REG,9,6,10,7,13,19,0,1,-1,1,1,1,1,1,1,1,0,0,0,0.5206611570247933,0.4793388429752067
93945,0.5283018867924528,0.5169082125603864,-112,-107,0.5044173060022736,0.49558269399772636,away,NYM,over,8.5,0.5024875621890548,-101,0.47839724939301687,SF,NYM,2024 REG,8,5,4,2,7,12,1,0,3,-3,1,1,0,0,0,0,0,0,0,0.47839724939301687,0.5216027506069831
93945,0.5283018867924528,0.5169082125603864,-112,-107,0.5044173060022736,0.49558269399772636,home,SF,under,8.5,0.5454545454545454,-120,0.5216027506069831,SF,NYM,2024 REG,8,5,4,2,7,12,1,0,3,-3,1,1,0,0,0,0,0,0,0,0.47839724939301687,0.5216027506069831
93946,0.5169082125603864,0.5260663507109005,-107,-111,0.4946943078742622,0.5053056921257377,away,CHC,over,7.5,0.5,100,0.47522522522522526,TB,CHC,2024 REG,7,3,3,2,5,10,1,0,1,-1,1,1,0,0,0,0,0,0,0,0.47522522522522526,0.5247747747747747
93946,0.5169082125603864,0.5260663507109005,-107,-111,0.4946943078742622,0.5053056921257377,home,TB,under,7.5,0.5495495495495495,-122,0.5247747747747747,TB,CHC,2024 REG,7,3,3,2,5,10,1,0,1,-1,1,1,0,0,0,0,0,0,0,0.47522522522522526,0.5247747747747747
93947,0.6363636363636364,0.40322580645161293,-175,148,0.6111703545721141,0.3888296454278859,away,NYM,over,9.5,0.5,100,0.47522522522522526,LAD,NYM,2024 REG,6,4,8,6,10,14,0,1,-2,2,1,1,1,1,0,0,0,0,0,0.47522522522522526,0.5247747747747747
93947,0.6363636363636364,0.40322580645161293,-175,148,0.6111703545721141,0.3888296454278859,home,LAD,under,9.5,0.5495495495495495,-122,0.5247747747747747,LAD,NYM,2024 REG,6,4,8,6,10,14,0,1,-2,2,1,1,1,1,0,0,0,0,0,0.47522522522522526,0.5247747747747747
93948,0.5652173913043479,0.47619047619047616,-130,110,0.5418129444594474,0.4581870555405526,away,HOU,over,10,0.5121951219512195,-105,0.48808156828023186,TEX,HOU,2024 REG,8,5,11,10,15,19,0,1,-5,5,1,1,1,1,1,0,0,0,0,0.48808156828023186,0.5119184317197681
93948,0.5652173913043479,0.47619047619047616,-130,110,0.5418129444594474,0.4581870555405526,home,TEX,under,10,0.5348837209302326,-115,0.5119184317197681,TEX,HOU,2024 REG,8,5,11,10,15,19,0,1,-5,5,1,1,1,1,1,0,0,0,0,0.48808156828023186,0.5119184317197681
93949,0.5515695067264574,0.49019607843137253,-123,104,0.5285328835228112,0.47146711647718875,away,STL,over,8,0.5238095238095238,-110,0.4988662131519274,SD,STL,2024 REG,5,2,14,6,8,19,0,1,-4,4,1,1,0,0,0,0,0,0,0,0.4988662131519274,0.5011337868480725
93949,0.5515695067264574,0.49019607843137253,-123,104,0.5285328835228112,0.47146711647718875,home,SD,under,8,0.5238095238095238,-110,0.5011337868480725,SD,STL,2024 REG,5,2,14,6,8,19,0,1,-4,4,1,1,0,0,0,0,0,0,0,0.4988662131519274,0.5011337868480725
93950,0.5260663507109005,0.5145631067961165,-111,-106,0.5046925602688205,0.4953074397311795,away,CLE,over,9,0.5283018867924528,-112,0.5031902949311281,CIN,CLE,2024 REG,6,3,9,5,8,15,0,1,-2,2,1,1,1,0,0,0,0,0,0,0.5031902949311281,0.4968097050688719
93950,0.5260663507109005,0.5145631067961165,-111,-106,0.5046925602688205,0.4953074397311795,home,CIN,under,9,0.5192307692307692,-108,0.4968097050688719,CIN,CLE,2024 REG,6,3,9,5,8,15,0,1,-2,2,1,1,1,0,0,0,0,0,0,0.5031902949311281,0.4968097050688719
93953,0.6491228070175439,0.39370078740157477,-185,154,0.6213250352016247,0.37867496479837526,away,BOS,over,7,0.5238095238095238,-110,0.4988662131519274,BAL,BOS,2024 REG,6,6,6,1,7,12,1,0,5,-5,1,0,0,0,0,0,0,0,0,0.4988662131519274,0.5011337868480725
93953,0.6491228070175439,0.39370078740157477,-185,154,0.6213250352016247,0.37867496479837526,home,BAL,under,7,0.5238095238095238,-110,0.5011337868480725,BAL,BOS,2024 REG,6,6,6,1,7,12,1,0,5,-5,1,0,0,0,0,0,0,0,0,0.4988662131519274,0.5011337868480725
93956,0.5,0.5454545454545454,100,-120,0.4772727272727273,0.5227272727272727,away,MIN,over,8,0.5121951219512195,-105,0.48808156828023186,TOR,MIN,2024 REG,2,1,6,5,6,8,0,1,-4,4,1,0,0,0,0,0,0,0,0,0.48808156828023186,0.5119184317197681
93956,0.5,0.5454545454545454,100,-120,0.4772727272727273,0.5227272727272727,home,TOR,under,8,0.5348837209302326,-115,0.5119184317197681,TOR,MIN,2024 REG,2,1,6,5,6,8,0,1,-4,4,1,0,0,0,0,0,0,0,0,0.48808156828023186,0.5119184317197681
93958,0.5348837209302326,0.5073891625615764,-115,-103,0.5122726437136835,0.48772735628631647,away,BAL,over,9,0.5283018867924528,-112,0.5031902949311281,CIN,BAL,2024 REG,2,0,9,3,3,11,0,1,-3,3,0,0,0,0,0,0,0,0,0,0.5031902949311281,0.4968097050688719
93958,0.5348837209302326,0.5073891625615764,-115,-103,0.5122726437136835,0.48772735628631647,home,CIN,under,9,0.5192307692307692,-108,0.4968097050688719,CIN,BAL,2024 REG,2,0,9,3,3,11,0,1,-3,3,0,0,0,0,0,0,0,0,0,0.5031902949311281,0.4968097050688719
93962,0.4,0.6376811594202898,150,-176,0.384927536231884,0.615072463768116,away,HOU,over,9.5,0.5121951219512195,-105,0.48808156828023186,WSH,HOU,2024 REG,9,5,9,4,9,18,1,0,1,-1,1,1,1,1,0,0,0,0,0,0.48808156828023186,0.5119184317197681
93962,0.4,0.6376811594202898,150,-176,0.384927536231884,0.615072463768116,home,WSH,under,9.5,0.5348837209302326,-115,0.5119184317197681,WSH,HOU,2024 REG,9,5,9,4,9,18,1,0,1,-1,1,1,1,1,0,0,0,0,0,0.48808156828023186,0.5119184317197681
93963,0.33783783783783783,0.7076023391812866,196,-242,0.32248642668272826,0.6775135733172717,away,HOU,over,16,0.5260663507109005,-111,0.5010269332605688,COL,HOU,2024 REG,7,2,8,8,10,15,0,1,-6,6,1,1,0,0,0,0,0,0,0,0.5010269332605688,0.4989730667394312
93963,0.33783783783783783,0.7076023391812866,196,-242,0.32248642668272826,0.6775135733172717,home,COL,under,16,0.5215311004784688,-109,0.4989730667394312,COL,HOU,2024 REG,7,2,8,8,10,15,0,1,-6,6,1,1,0,0,0,0,0,0,0,0.5010269332605688,0.4989730667394312
93966,0.37735849056603776,0.6621621621621622,165,-196,0.36244503670633965,0.6375549632936603,away,LAD,over,7.5,0.5348837209302326,-115,0.5097020142727117,NYM,LAD,2024 REG,4,2,11,5,7,15,0,1,-3,3,1,1,0,0,0,0,0,0,0,0.5097020142727117,0.49029798572728833
93966,0.37735849056603776,0.6621621621621622,165,-196,0.36244503670633965,0.6375549632936603,home,NYM,under,7.5,0.5121951219512195,-105,0.49029798572728833,NYM,LAD,2024 REG,4,2,11,5,7,15,0,1,-3,3,1,1,0,0,0,0,0,0,0,0.5097020142727117,0.49029798572728833
93967,0.5348837209302326,0.5121951219512195,-115,-105,0.5097020142727117,0.49029798572728833,away,SD,over,7.5,0.5121951219512195,-105,0.48808156828023186,NYM,SD,2024 REG,4,2,5,1,3,9,1,0,1,-1,1,0,0,0,0,0,0,0,0,0.48808156828023186,0.5119184317197681
93967,0.5348837209302326,0.5121951219512195,-115,-105,0.5097020142727117,0.49029798572728833,home,NYM,under,7.5,0.5348837209302326,-115,0.5119184317197681,NYM,SD,2024 REG,4,2,5,1,3,9,1,0,1,-1,1,0,0,0,0,0,0,0,0,0.48808156828023186,0.5119184317197681
93969,0.39370078740157477,0.6491228070175439,154,-185,0.37684110455940206,0.623158895440598,away,KC,over,10.5,0.5121951219512195,-105,0.48808156828023186,COL,KC,2024 REG,8,4,10,2,6,18,1,0,2,-2,1,1,0,0,0,0,0,0,0,0.48808156828023186,0.5119184317197681
93969,0.39370078740157477,0.6491228070175439,154,-185,0.37684110455940206,0.623158895440598,home,COL,under,10.5,0.5348837209302326,-115,0.5119184317197681,COL,KC,2024 REG,8,4,10,2,6,18,1,0,2,-2,1,1,0,0,0,0,0,0,0,0.48808156828023186,0.5119184317197681
93970,0.5652173913043479,0.47619047619047616,-130,110,0.5418129444594474,0.4581870555405526,away,SEA,over,7.5,0.5327102803738317,-114,0.5062779990911175,MIL,SEA,2024 REG,8,6,8,5,11,16,1,0,1,-1,1,1,1,1,1,0,0,0,0,0.5062779990911175,0.4937220009088825
93970,0.5652173913043479,0.47619047619047616,-130,110,0.5418129444594474,0.4581870555405526,home,MIL,under,7.5,0.5169082125603864,-107,0.4937220009088825,MIL,SEA,2024 REG,8,6,8,5,11,16,1,0,1,-1,1,1,1,1,1,0,0,0,0,0.5062779990911175,0.4937220009088825
93971,0.5614035087719298,0.47619047619047616,-128,110,0.5402981137053159,0.4597018862946841,away,ARI,over,7.5,0.5,100,0.4772727272727273,BAL,ARI,2024 REG,4,2,8,9,11,12,0,1,-7,7,1,1,0,0,0,0,0,0,0,0.4772727272727273,0.5227272727272727
93971,0.5614035087719298,0.47619047619047616,-128,110,0.5402981137053159,0.4597018862946841,home,BAL,under,7.5,0.5454545454545454,-120,0.5227272727272727,BAL,ARI,2024 REG,4,2,8,9,11,12,0,1,-7,7,1,1,0,0,0,0,0,0,0,0.4772727272727273,0.5227272727272727
93972,0.5348837209302326,0.504950495049505,-115,-102,0.5135770472666521,0.4864229527333479,away,ARI,over,7.5,0.5454545454545454,-120,0.5206611570247933,STL,ARI,2024 REG,9,5,7,1,6,16,1,0,4,-4,1,0,0,0,0,0,0,0,0,0.5206611570247933,0.4793388429752067
93972,0.5348837209302326,0.504950495049505,-115,-102,0.5135770472666521,0.4864229527333479,home,STL,under,7.5,0.5,100,0.4793388429752067,STL,ARI,2024 REG,9,5,7,1,6,16,1,0,4,-4,1,0,0,0,0,0,0,0,0,0.5206611570247933,0.4793388429752067
93973,0.4716981132075471,0.5689655172413793,112,-132,0.45251715544861953,0.5474828445513804,away,BAL,over,9,0.5348837209302326,-115,0.5097020142727117,KC,BAL,2024 REG,9,9,8,4,13,17,1,0,5,-5,1,1,1,1,0,0,0,0,0,0.5097020142727117,0.49029798572728833
93973,0.4716981132075471,0.5689655172413793,112,-132,0.45251715544861953,0.5474828445513804,home,KC,under,9,0.5121951219512195,-105,0.49029798572728833,KC,BAL,2024 REG,9,9,8,4,13,17,1,0,5,-5,1,1,1,1,0,0,0,0,0,0.5097020142727117,0.49029798572728833
93974,0.4672897196261683,0.5726495726495727,114,-134,0.44862649893656975,0.5513735010634302,away,NYY,over,8.5,0.5454545454545454,-120,0.5206611570247933,TOR,NYY,2024 REG,11,9,3,2,11,14,1,0,7,-7,1,1,0,0,0,0,0,0,0,0.5206611570247933,0.4793388429752067
93974,0.4672897196261683,0.5726495726495727,114,-134,0.44862649893656975,0.5513735010634302,home,TOR,under,8.5,0.5,100,0.4793388429752067,TOR,NYY,2024 REG,11,9,3,2,11,14,1,0,7,-7,1,1,0,0,0,0,0,0,0,0.5206611570247933,0.4793388429752067
93975,0.4016064257028112,0.6363636363636364,149,-175,0.3863574047925913,0.6136425952074087,away,HOU,over,8.5,0.5073891625615764,-103,0.48484779035144243,LAA,HOU,2024 REG,6,1,11,6,7,17,0,1,-5,5,1,0,0,0,0,0,0,0,0,0.48484779035144243,0.5151522096485576
93975,0.4016064257028112,0.6363636363636364,149,-175,0.3863574047925913,0.6136425952074087,home,LAA,under,8.5,0.5370370370370371,-116,0.5151522096485576,LAA,HOU,2024 REG,6,1,11,6,7,17,0,1,-5,5,1,0,0,0,0,0,0,0,0,0.48484779035144243,0.5151522096485576
93979,0.3448275862068966,0.6941896024464832,190,-227,0.3313733832229725,0.6686266167770275,away,LAD,over,10,0.5121951219512195,-105,0.4858858974112951,WSH,LAD,2024 REG,7,1,9,4,5,16,0,1,-3,3,1,0,0,0,0,0,0,0,0,0.4858858974112951,0.5141141025887048
93979,0.3448275862068966,0.6941896024464832,190,-227,0.3313733832229725,0.6686266167770275,home,WSH,under,10,0.5391705069124424,-117,0.5141141025887048,WSH,LAD,2024 REG,7,1,9,4,5,16,0,1,-3,3,1,0,0,0,0,0,0,0,0,0.4858858974112951,0.5141141025887048
93981,0.6923076923076923,0.3508771929824561,-225,185,0.6624104640298972,0.33758953597010277,away,COL,over,8.5,0.5192307692307692,-108,0.49340049170764233,ARI,COL,2024 REG,18,16,4,1,17,22,1,0,15,-15,1,0,0,0,0,0,0,0,0,0.49340049170764233,0.5065995082923577
93981,0.6923076923076923,0.3508771929824561,-225,185,0.6624104640298972,0.33758953597010277,home,ARI,under,8.5,0.5305164319248826,-113,0.5065995082923577,ARI,COL,2024 REG,18,16,4,1,17,22,1,0,15,-15,1,0,0,0,0,0,0,0,0,0.49340049170764233,0.5065995082923577
93983,0.4347826086956522,0.607843137254902,130,-155,0.41624967567367205,0.583750324326328,away,CLE,over,7.5,0.5370370370370371,-116,0.5105975442470474,CWS,CLE,2024 REG,8,3,9,2,5,17,1,0,1,-1,1,1,0,0,0,0,0,0,0,0.5105975442470474,0.4894024557529526
93983,0.4347826086956522,0.607843137254902,130,-155,0.41624967567367205,0.583750324326328,home,CWS,under,7.5,0.5121951219512195,-105,0.4894024557529526,CWS,CLE,2024 REG,8,3,9,2,5,17,1,0,1,-1,1,1,0,0,0,0,0,0,0,0.5105975442470474,0.4894024557529526
93985,0.5238095238095238,0.5192307692307692,-110,-108,0.5012646084074657,0.4987353915925343,away,ARI,over,9,0.5348837209302326,-115,0.5097020142727117,CIN,ARI,2024 REG,9,3,8,4,7,17,0,1,-1,1,1,1,1,0,0,0,0,0,0,0.5097020142727117,0.49029798572728833
93985,0.5238095238095238,0.5192307692307692,-110,-108,0.5012646084074657,0.4987353915925343,home,CIN,under,9,0.5121951219512195,-105,0.49029798572728833,CIN,ARI,2024 REG,9,3,8,4,7,17,0,1,-1,1,1,1,1,0,0,0,0,0,0,0.5097020142727117,0.49029798572728833
93991,0.5652173913043479,0.47619047619047616,-130,110,0.5418129444594474,0.4581870555405526,away,LAA,over,7.5,0.5327102803738317,-114,0.5075272610403079,CLE,LAA,2024 REG,6,7,4,1,8,10,1,0,6,-6,1,0,0,0,0,0,0,0,0,0.5075272610403079,0.4924727389596921
93991,0.5652173913043479,0.47619047619047616,-130,110,0.5418129444594474,0.4581870555405526,home,CLE,under,7.5,0.5145631067961165,-106,0.4924727389596921,CLE,LAA,2024 REG,6,7,4,1,8,10,1,0,6,-6,1,0,0,0,0,0,0,0,0,0.5075272610403079,0.4924727389596921
93994,0.40485829959514175,0.6336996336996338,147,-173,0.389247800285516,0.610752199714484,away,TOR,over,7.5,0.5454545454545454,-120,0.5179608869977906,OAK,TOR,2024 REG,5,2,5,1,3,10,1,0,1,-1,1,0,0,0,0,0,0,0,0,0.5179608869977906,0.48203911300220936
93994,0.40485829959514175,0.6336996336996338,147,-173,0.389247800285516,0.610752199714484,home,OAK,under,7.5,0.504950495049505,-102,0.48203911300220936,OAK,TOR,2024 REG,5,2,5,1,3,10,1,0,1,-1,1,0,0,0,0,0,0,0,0,0.5179608869977906,0.48203911300220936
93995,0.5348837209302326,0.5098039215686274,-115,-104,0.5109810284308424,0.48901897156915763,away,COL,over,9,0.5,100,0.47522522522522526,CWS,COL,2024 REG,12,11,4,3,14,16,1,0,8,-8,1,1,1,0,0,0,0,0,0,0.47522522522522526,0.5247747747747747
93995,0.5348837209302326,0.5098039215686274,-115,-104,0.5109810284308424,0.48901897156915763,home,CWS,under,9,0.5495495495495495,-122,0.5247747747747747,CWS,COL,2024 REG,12,11,4,3,14,16,1,0,8,-8,1,1,1,0,0,0,0,0,0,0.47522522522522526,0.5247747747747747
93997,0.5073891625615764,0.5327102803738317,-103,-114,0.487043139791394,0.512956860208606,away,CLE,over,7.5,0.5454545454545454,-120,0.5206611570247933,LAA,CLE,2024 REG,9,4,10,10,14,19,0,1,-6,6,1,1,1,1,0,0,0,0,0,0.5206611570247933,0.4793388429752067
93997,0.5073891625615764,0.5327102803738317,-103,-114,0.487043139791394,0.512956860208606,home,LAA,under,7.5,0.5,100,0.4793388429752067,LAA,CLE,2024 REG,9,4,10,10,14,19,0,1,-6,6,1,1,1,1,0,0,0,0,0,0.5206611570247933,0.4793388429752067
94002,0.6197718631178707,0.4184100418410042,-163,139,0.5961077927441193,0.4038922072558807,away,STL,over,7,0.5454545454545454,-120,0.5206611570247933,PHI,STL,2024 REG,7,6,5,1,7,12,1,0,5,-5,1,0,0,0,0,0,0,0,0,0.5206611570247933,0.4793388429752067
94002,0.6197718631178707,0.4184100418410042,-163,139,0.5961077927441193,0.4038922072558807,home,PHI,under,7,0.5,100,0.4793388429752067,PHI,STL,2024 REG,7,6,5,1,7,12,1,0,5,-5,1,0,0,0,0,0,0,0,0,0.5206611570247933,0.4793388429752067
94003,0.726027397260274,0.31746031746031744,-265,215,0.6944541249288857,0.3055458750711143,away,WSH,over,8.5,0.5,100,0.4772727272727273,ATL,WSH,2024 REG,5,2,7,0,2,12,1,0,2,-2,0,0,0,0,0,0,0,0,0,0.4772727272727273,0.5227272727272727
94003,0.726027397260274,0.31746031746031744,-265,215,0.6944541249288857,0.3055458750711143,home,ATL,under,8.5,0.5454545454545454,-120,0.5227272727272727,ATL,WSH,2024 REG,5,2,7,0,2,12,1,0,2,-2,0,0,0,0,0,0,0,0,0,0.4772727272727273,0.5227272727272727
94005,0.6323529411764706,0.4081632653061224,-172,145,0.6067323988418897,0.3932676011581103,away,COL,over,8,0.5348837209302326,-115,0.5097020142727117,SF,COL,2024 REG,18,14,10,4,18,28,1,0,10,-10,1,1,1,1,0,0,0,0,0,0.5097020142727117,0.49029798572728833
94005,0.6323529411764706,0.4081632653061224,-172,145,0.6067323988418897,0.3932676011581103,home,SF,under,8,0.5121951219512195,-105,0.49029798572728833,SF,COL,2024 REG,18,14,10,4,18,28,1,0,10,-10,1,1,1,1,0,0,0,0,0,0.5097020142727117,0.49029798572728833
94007,0.47619047619047616,0.5652173913043479,110,-130,0.4564724440500838,0.5435275559499162,away,TOR,over,8,0.5238095238095238,-110,0.4988662131519274,DET,TOR,2024 REG,17,14,14,11,25,31,1,0,3,-3,1,1,1,1,1,1,1,1,1,0.4988662131519274,0.5011337868480725
94007,0.47619047619047616,0.5652173913043479,110,-130,0.4564724440500838,0.5435275559499162,home,DET,under,8,0.5238095238095238,-110,0.5011337868480725,DET,TOR,2024 REG,17,14,14,11,25,31,1,0,3,-3,1,1,1,1,1,1,1,1,1,0.4988662131519274,0.5011337868480725
94008,0.5260663507109005,0.5169082125603864,-111,-107,0.5034588790373798,0.49654112096262015,away,ATL,over,10,0.5238095238095238,-110,0.4988662131519274,BOS,ATL,2024 REG,13,9,1,0,9,14,1,0,9,-9,0,0,0,0,0,0,0,0,0,0.4988662131519274,0.5011337868480725
94008,0.5260663507109005,0.5169082125603864,-111,-107,0.5034588790373798,0.49654112096262015,home,BOS,under,10,0.5238095238095238,-110,0.5011337868480725,BOS,ATL,2024 REG,13,9,1,0,9,14,1,0,9,-9,0,0,0,0,0,0,0,0,0,0.4988662131519274,0.5011337868480725
94011,0.6363636363636364,0.4081632653061224,-175,145,0.6080283353010626,0.3919716646989374,away,CIN,over,8.5,0.5327102803738317,-114,0.508788710910954,TEX,CIN,2024 REG,8,2,3,1,3,11,1,0,1,-1,1,0,0,0,0,0,0,0,0,0.508788710910954,0.491211289089046
94011,0.6363636363636364,0.4081632653061224,-175,145,0.6080283353010626,0.3919716646989374,home,TEX,under,8.5,0.5121951219512195,-105,0.491211289089046,TEX,CIN,2024 REG,8,2,3,1,3,11,1,0,1,-1,1,0,0,0,0,0,0,0,0,0.508788710910954,0.491211289089046
94013,0.6721311475409836,0.37037037037037035,-205,170,0.6435645535349916,0.35643544646500835,away,LAA,over,9,0.5121951219512195,-105,0.48808156828023186,HOU,LAA,2024 REG,6,1,3,2,3,9,0,1,-1,1,1,0,0,0,0,0,0,0,0,0.48808156828023186,0.5119184317197681
94013,0.6721311475409836,0.37037037037037035,-205,170,0.6435645535349916,0.35643544646500835,home,HOU,under,9,0.5348837209302326,-115,0.5119184317197681,HOU,LAA,2024 REG,6,1,3,2,3,9,0,1,-1,1,1,0,0,0,0,0,0,0,0,0.48808156828023186,0.5119184317197681
94014,0.4926108374384236,0.5495495495495495,103,-122,0.4718421738975501,0.5281578261024499,away,PIT,over,8.5,0.5215311004784688,-109,0.49670754937970685,WSH,PIT,2024 REG,8,4,11,7,11,19,0,1,-3,3,1,1,1,1,0,0,0,0,0,0.49670754937970685,0.5032924506202932
94014,0.4926108374384236,0.5495495495495495,103,-122,0.4718421738975501,0.5281578261024499,home,WSH,under,8.5,0.5260663507109005,-111,0.5032924506202932,WSH,PIT,2024 REG,8,4,11,7,11,19,0,1,-3,3,1,1,1,1,0,0,0,0,0,0.49670754937970685,0.5032924506202932
94015,0.46511627906976744,0.574468085106383,115,-135,0.44670494689481377,0.5532950531051862,away,NYY,over,8.5,0.5,100,0.4772727272727273,CLE,NYY,2024 REG,5,2,10,3,5,15,0,1,-1,1,1,1,0,0,0,0,0,0,0,0.4772727272727273,0.5227272727272727
94015,0.46511627906976744,0.574468085106383,115,-135,0.44670494689481377,0.5532950531051862,home,CLE,under,8.5,0.5454545454545454,-120,0.5227272727272727,CLE,NYY,2024 REG,5,2,10,3,5,15,0,1,-1,1,1,1,0,0,0,0,0,0,0,0.4772727272727273,0.5227272727272727
94017,0.37878787878787884,0.6655518394648829,164,-199,0.361992530964863,0.6380074690351369,away,PHI,over,7.5,0.5121951219512195,-105,0.48808156828023186,MIA,PHI,2024 REG,5,2,15,8,10,20,0,1,-6,6,1,1,0,0,0,0,0,0,0,0.48808156828023186,0.5119184317197681
94017,0.37878787878787884,0.6655518394648829,164,-199,0.361992530964863,0.6380074690351369,home,MIA,under,7.5,0.5348837209302326,-115,0.5119184317197681,MIA,PHI,2024 REG,5,2,15,8,10,20,0,1,-6,6,1,1,0,0,0,0,0,0,0,0.48808156828023186,0.5119184317197681
94018,0.5652173913043479,0.47619047619047616,-130,110,0.5418129444594474,0.4581870555405526,away,DET,over,9,0.5,100,0.4772727272727273,CIN,DET,2024 REG,7,4,11,5,9,18,0,1,-1,1,1,1,1,1,0,0,0,0,0,0.4772727272727273,0.5227272727272727
94018,0.5652173913043479,0.47619047619047616,-130,110,0.5418129444594474,0.4581870555405526,home,CIN,under,9,0.5454545454545454,-120,0.5227272727272727,CIN,DET,2024 REG,7,4,11,5,9,18,0,1,-1,1,1,1,1,1,0,0,0,0,0,0.4772727272727273,0.5227272727272727
94019,0.5305164319248826,0.5121951219512195,-113,-105,0.5078572507605655,0.49214274923943446,away,CHC,over,8,0.504950495049505,-102,0.48160416005266615,SF,CHC,2024 REG,6,4,9,3,7,15,1,0,1,-1,1,1,1,0,0,0,0,0,0,0.48160416005266615,0.5183958399473338
94019,0.5305164319248826,0.5121951219512195,-113,-105,0.5078572507605655,0.49214274923943446,home,SF,under,8,0.5412844036697247,-118,0.5183958399473338,SF,CHC,2024 REG,6,4,9,3,7,15,1,0,1,-1,1,1,1,0,0,0,0,0,0,0.48160416005266615,0.5183958399473338
94022,0.5555555555555556,0.48780487804878053,-125,105,0.5314664257753688,0.46853357422463116,away,MIN,over,7.5,0.5121951219512195,-105,0.48808156828023186,HOU,MIN,2024 REG,10,5,4,2,7,14,1,0,3,-3,1,1,0,0,0,0,0,0,0,0.48808156828023186,0.5119184317197681
94022,0.5555555555555556,0.48780487804878053,-125,105,0.5314664257753688,0.46853357422463116,home,HOU,under,7.5,0.5348837209302326,-115,0.5119184317197681,HOU,MIN,2024 REG,10,5,4,2,7,14,1,0,3,-3,1,1,0,0,0,0,0,0,0,0.48808156828023186,0.5119184317197681
94023,0.5555555555555556,0.48780487804878053,-125,105,0.5314664257753688,0.46853357422463116,away,MIA,over,8.5,0.5024875621890548,-101,0.47839724939301687,CHC,MIA,2024 REG,8,3,11,6,9,19,0,1,-3,3,1,1,1,0,0,0,0,0,0,0.47839724939301687,0.5216027506069831
94023,0.5555555555555556,0.48780487804878053,-125,105,0.5314664257753688,0.46853357422463116,home,CHC,under,8.5,0.5454545454545454,-120,0.5216027506069831,CHC,MIA,2024 REG,8,3,11,6,9,19,0,1,-3,3,1,1,1,0,0,0,0,0,0,0.47839724939301687,0.5216027506069831
94024,0.5951417004048584,0.4444444444444444,-147,125,0.5715823348467713,0.42841766515322866,away,CHC,over,9.5,0.5,100,0.4772727272727273,BOS,CHC,2024 REG,9,5,7,4,9,16,1,0,1,-1,1,1,1,1,0,0,0,0,0,0.4772727272727273,0.5227272727272727
94024,0.5951417004048584,0.4444444444444444,-147,125,0.5715823348467713,0.42841766515322866,home,BOS,under,9.5,0.5454545454545454,-120,0.5227272727272727,BOS,CHC,2024 REG,9,5,7,4,9,16,1,0,1,-1,1,1,1,1,0,0,0,0,0,0.4772727272727273,0.5227272727272727
94026,0.4464285714285714,0.5967741935483871,124,-148,0.42714162277814344,0.5728583772218565,away,SD,over,11,0.5121951219512195,-105,0.48808156828023186,COL,SD,2024 REG,14,10,11,9,19,25,1,0,1,-1,1,1,1,1,1,1,1,1,1,0.48808156828023186,0.5119184317197681
94026,0.4464285714285714,0.5967741935483871,124,-148,0.42714162277814344,0.5728583772218565,home,COL,under,11,0.5348837209302326,-115,0.5119184317197681,COL,SD,2024 REG,14,10,11,9,19,25,1,0,1,-1,1,1,1,1,1,1,1,1,1,0.48808156828023186,0.5119184317197681
94027,0.6655518394648829,0.37878787878787884,-199,164,0.6360414584204026,0.3639585415795974,away,PIT,over,9,0.5238095238095238,-110,0.4988662131519274,ATL,PIT,2024 REG,6,2,6,4,6,12,0,1,-2,2,1,1,0,0,0,0,0,0,0,0.4988662131519274,0.5011337868480725
94027,0.6655518394648829,0.37878787878787884,-199,164,0.6360414584204026,0.3639585415795974,home,ATL,under,9,0.5238095238095238,-110,0.5011337868480725,ATL,PIT,2024 REG,6,2,6,4,6,12,0,1,-2,2,1,1,0,0,0,0,0,0,0,0.4988662131519274,0.5011337868480725
94028,0.6108949416342413,0.4273504273504274,-157,134,0.5875310391805721,0.41246896081942785,away,SF,over,8.5,0.5454545454545454,-120,0.5206611570247933,SD,SF,2024 REG,16,13,5,4,17,21,1,0,9,-9,1,1,1,1,0,0,0,0,0,0.5206611570247933,0.4793388429752067
94028,0.6108949416342413,0.4273504273504274,-157,134,0.5875310391805721,0.41246896081942785,home,SD,under,8.5,0.5,100,0.4793388429752067,SD,SF,2024 REG,16,13,5,4,17,21,1,0,9,-9,1,1,1,1,0,0,0,0,0,0.5206611570247933,0.4793388429752067
94029,0.5934959349593496,0.4464285714285714,-146,124,0.5698009027128599,0.4301990972871401,away,MIL,over,7.5,0.49751243781094534,101,0.47511256217505476,PIT,MIL,2024 REG,9,4,5,2,6,14,1,0,2,-2,1,1,0,0,0,0,0,0,0,0.47511256217505476,0.5248874378249453
94029,0.5934959349593496,0.4464285714285714,-146,124,0.5698009027128599,0.4301990972871401,home,PIT,under,7.5,0.5475113122171946,-121,0.5248874378249453,PIT,MIL,2024 REG,9,4,5,2,6,14,1,0,2,-2,1,1,0,0,0,0,0,0,0,0.47511256217505476,0.5248874378249453
94030,0.5454545454545454,0.5,-120,100,0.5206611570247933,0.4793388429752067,away,LAD,over,8.5,0.5121951219512195,-105,0.48919479393107135,PIT,LAD,2024 REG,9,10,11,6,16,20,1,0,4,-4,1,1,1,1,1,1,0,0,0,0.48919479393107135,0.5108052060689287
94030,0.5454545454545454,0.5,-120,100,0.5206611570247933,0.4793388429752067,home,PIT,under,8.5,0.5327102803738317,-114,0.5108052060689287,PIT,LAD,2024 REG,9,10,11,6,16,20,1,0,4,-4,1,1,1,1,1,1,0,0,0,0.48919479393107135,0.5108052060689287
94031,0.5238095238095238,0.5192307692307692,-110,-108,0.5012646084074657,0.4987353915925343,away,BAL,over,8.5,0.5098039215686274,-104,0.48375889301574193,HOU,BAL,2024 REG,15,8,7,1,9,22,1,0,7,-7,1,0,0,0,0,0,0,0,0,0.48375889301574193,0.5162411069842581
94031,0.5238095238095238,0.5192307692307692,-110,-108,0.5012646084074657,0.4987353915925343,home,HOU,under,8.5,0.5412844036697247,-118,0.5162411069842581,HOU,BAL,2024 REG,15,8,7,1,9,22,1,0,7,-7,1,0,0,0,0,0,0,0,0,0.48375889301574193,0.5162411069842581
94034,0.3846153846153846,0.6575342465753424,160,-192,0.3684039880035665,0.6315960119964334,away,LAD,over,8.5,0.5412844036697247,-118,0.5149381613977361,SD,LAD,2024 REG,4,2,7,5,7,11,0,1,-3,3,1,1,0,0,0,0,0,0,0,0.5149381613977361,0.48506183860226393
94034,0.3846153846153846,0.6575342465753424,160,-192,0.3684039880035665,0.6315960119964334,home,SD,under,8.5,0.5073891625615764,-103,0.48506183860226393,SD,LAD,2024 REG,4,2,7,5,7,11,0,1,-3,3,1,1,0,0,0,0,0,0,0,0.5149381613977361,0.48506183860226393
94038,0.4098360655737705,0.6296296296296295,144,-170,0.3936616003264754,0.6063383996735245,away,SEA,over,7.5,0.49019607843137253,104,0.46776880686915284,MIA,SEA,2024 REG,7,3,6,2,5,13,1,0,1,-1,1,1,0,0,0,0,0,0,0,0.46776880686915284,0.5322311931308472
94038,0.4098360655737705,0.6296296296296295,144,-170,0.3936616003264754,0.6063383996735245,home,MIA,under,7.5,0.5555555555555556,-125,0.5322311931308472,MIA,SEA,2024 REG,7,3,6,2,5,13,1,0,1,-1,1,1,0,0,0,0,0,0,0,0.46776880686915284,0.5322311931308472
94039,0.5901639344262295,0.45248868778280543,-144,121,0.5649918950897499,0.4350081049102501,away,BOS,over,7.5,0.5348837209302326,-115,0.5097020142727117,TB,BOS,2024 REG,8,5,8,8,13,16,0,1,-3,3,1,1,1,1,1,0,0,0,0,0.5097020142727117,0.49029798572728833
94039,0.5901639344262295,0.45248868778280543,-144,121,0.5649918950897499,0.4350081049102501,home,TB,under,7.5,0.5121951219512195,-105,0.49029798572728833,TB,BOS,2024 REG,8,5,8,8,13,16,0,1,-3,3,1,1,1,1,1,0,0,0,0,0.5097020142727117,0.49029798572728833
94040,0.5,0.5454545454545454,100,-120,0.4772727272727273,0.5227272727272727,away,SEA,over,9,0.5238095238095238,-110,0.4988662131519274,TEX,SEA,2024 REG,7,3,5,4,7,12,0,1,-1,1,1,1,1,0,0,0,0,0,0,0.4988662131519274,0.5011337868480725
94040,0.5,0.5454545454545454,100,-120,0.4772727272727273,0.5227272727272727,home,TEX,under,9,0.5238095238095238,-110,0.5011337868480725,TEX,SEA,2024 REG,7,3,5,4,7,12,0,1,-1,1,1,1,1,0,0,0,0,0,0,0.4988662131519274,0.5011337868480725
94041,0.4347826086956522,0.6062992125984252,130,-154,0.4169209472634447,0.5830790527365552,away,SEA,over,8,0.5098039215686274,-104,0.48592421718142587,OAK,SEA,2024 REG,2,0,4,3,3,6,0,1,-3,3,0,0,0,0,0,0,0,0,0,0.48592421718142587,0.5140757828185741
94041,0.4347826086956522,0.6062992125984252,130,-154,0.4169209472634447,0.5830790527365552,home,OAK,under,8,0.5370370370370371,-116,0.5140757828185741,OAK,SEA,2024 REG,2,0,4,3,3,6,0,1,-3,3,0,0,0,0,0,0,0,0,0,0.48592421718142587,0.5140757828185741
94045,0.574468085106383,0.46511627906976744,-135,115,0.5517281312179562,0.44827186878204384,away,TOR,over,8.5,0.5475113122171946,-121,0.5214983313199976,ARI,TOR,2024 REG,15,12,5,1,13,20,1,0,11,-11,1,0,0,0,0,0,0,0,0,0.5214983313199976,0.47850166868000243
94045,0.574468085106383,0.46511627906976744,-135,115,0.5517281312179562,0.44827186878204384,home,ARI,under,8.5,0.5,100,0.47850166868000243,ARI,TOR,2024 REG,15,12,5,1,13,20,1,0,11,-11,1,0,0,0,0,0,0,0,0,0.5214983313199976,0.47850166868000243
94046,0.6491228070175439,0.39370078740157477,-185,154,0.6213250352016247,0.37867496479837526,away,TB,over,8.5,0.5215311004784688,-109,0.4978845547971712,NYY,TB,2024 REG,5,5,14,3,8,19,1,0,2,-2,1,1,1,0,0,0,0,0,0,0.4978845547971712,0.5021154452028288
94046,0.6491228070175439,0.39370078740157477,-185,154,0.6213250352016247,0.37867496479837526,home,NYY,under,8.5,0.5238095238095238,-110,0.5021154452028288,NYY,TB,2024 REG,5,5,14,3,8,19,1,0,2,-2,1,1,1,0,0,0,0,0,0,0.4978845547971712,0.5021154452028288
94047,0.5073891625615764,0.5348837209302326,-103,-115,0.4859403596076043,0.5140596403923957,away,PIT,over,10.5,0.5283018867924528,-112,0.5031902949311281,COL,PIT,2024 REG,9,2,9,5,7,18,0,1,-3,3,1,1,0,0,0,0,0,0,0,0.5031902949311281,0.4968097050688719
94047,0.5073891625615764,0.5348837209302326,-103,-115,0.4859403596076043,0.5140596403923957,home,COL,under,10.5,0.5192307692307692,-108,0.4968097050688719,COL,PIT,2024 REG,9,2,9,5,7,18,0,1,-3,3,1,1,0,0,0,0,0,0,0,0.5031902949311281,0.4968097050688719
94048,0.6153846153846154,0.425531914893617,-160,135,0.5902052121364724,0.40979478786352763,away,SF,over,8.5,0.5348837209302326,-115,0.5097020142727117,BOS,SF,2024 REG,10,6,5,2,8,15,1,0,4,-4,1,1,0,0,0,0,0,0,0,0.5097020142727117,0.49029798572728833
94048,0.6153846153846154,0.425531914893617,-160,135,0.5902052121364724,0.40979478786352763,home,BOS,under,8.5,0.5121951219512195,-105,0.49029798572728833,BOS,SF,2024 REG,10,6,5,2,8,15,1,0,4,-4,1,1,0,0,0,0,0,0,0,0.5097020142727117,0.49029798572728833
94053,0.6415770609318996,0.4,-179,150,0.6149021723770248,0.3850978276229752,away,CWS,over,8.5,0.5475113122171946,-121,0.5214983313199976,ARI,CWS,2024 REG,9,12,11,5,17,20,1,0,7,-7,1,1,1,1,1,0,0,0,0,0.5214983313199976,0.47850166868000243
94053,0.6415770609318996,0.4,-179,150,0.6149021723770248,0.3850978276229752,home,ARI,under,8.5,0.5,100,0.47850166868000243,ARI,CWS,2024 REG,9,12,11,5,17,20,1,0,7,-7,1,1,1,1,1,0,0,0,0,0.5214983313199976,0.47850166868000243
94056,0.4854368932038835,0.5555555555555556,106,-125,0.465537646233282,0.534462353766718,away,NYY,over,8.5,0.5433789954337899,-119,0.5184560714286826,CLE,NYY,2024 REG,9,8,12,7,15,21,1,0,1,-1,1,1,1,1,1,1,1,0,0,0.5184560714286826,0.48154392857131745
94056,0.4854368932038835,0.5555555555555556,106,-125,0.465537646233282,0.534462353766718,home,CLE,under,8.5,0.5024875621890548,-101,0.48154392857131745,CLE,NYY,2024 REG,9,8,12,7,15,21,1,0,1,-1,1,1,1,1,1,1,1,0,0,0.5184560714286826,0.48154392857131745
94058,0.6428571428571428,0.39370078740157477,-180,154,0.6193556162622529,0.3806443837377471,away,TB,over,7.5,0.5348837209302326,-115,0.5097020142727117,MIL,TB,2024 REG,10,8,5,2,10,15,1,0,6,-6,1,1,0,0,0,0,0,0,0,0.5097020142727117,0.49029798572728833
94058,0.6428571428571428,0.39370078740157477,-180,154,0.6193556162622529,0.3806443837377471,home,MIL,under,7.5,0.5121951219512195,-105,0.49029798572728833,MIL,TB,2024 REG,10,8,5,2,10,15,1,0,6,-6,1,1,0,0,0,0,0,0,0,0.5097020142727117,0.49029798572728833
94059,0.35211267605633806,0.6923076923076923,184,-225,0.33647170128027104,0.663528298719729,away,TOR,over,7.5,0.5348837209302326,-115,0.5097020142727117,CWS,TOR,2024 REG,8,2,13,7,9,21,0,1,-5,5,1,1,0,0,0,0,0,0,0,0.5097020142727117,0.49029798572728833
94059,0.35211267605633806,0.6923076923076923,184,-225,0.33647170128027104,0.663528298719729,home,CWS,under,7.5,0.5121951219512195,-105,0.49029798572728833,CWS,TOR,2024 REG,8,2,13,7,9,21,0,1,-5,5,1,1,0,0,0,0,0,0,0,0.5097020142727117,0.49029798572728833
94060,0.3921568627450981,0.6491228070175439,155,-185,0.37596875695582666,0.6240312430441733,away,ARI,over,11,0.5238095238095238,-110,0.4988662131519274,COL,ARI,2024 REG,8,2,9,3,5,17,0,1,-1,1,1,1,0,0,0,0,0,0,0,0.4988662131519274,0.5011337868480725
94060,0.3921568627450981,0.6491228070175439,155,-185,0.37596875695582666,0.6240312430441733,home,COL,under,11,0.5238095238095238,-110,0.5011337868480725,COL,ARI,2024 REG,8,2,9,3,5,17,0,1,-1,1,1,1,0,0,0,0,0,0,0,0.4988662131519274,0.5011337868480725
94061,0.5,0.5412844036697247,100,-118,0.47935779816513757,0.5206422018348624,away,ATL,over,8,0.5121951219512195,-105,0.48808156828023186,ARI,ATL,2024 REG,6,1,5,0,1,11,1,0,1,-1,0,0,0,0,0,0,0,0,0,0.48808156828023186,0.5119184317197681
94061,0.5,0.5412844036697247,100,-118,0.47935779816513757,0.5206422018348624,home,ARI,under,8,0.5348837209302326,-115,0.5119184317197681,ARI,ATL,2024 REG,6,1,5,0,1,11,1,0,1,-1,0,0,0,0,0,0,0,0,0,0.48808156828023186,0.5119184317197681
94063,0.6296296296296295,0.4098360655737705,-170,144,0.6047808585756369,0.3952191414243631,away,DET,over,9,0.5,100,0.4772727272727273,MIN,DET,2024 REG,8,2,11,9,11,19,0,1,-7,7,1,1,0,0,0,0,0,0,0,0.4772727272727273,0.5227272727272727
94063,0.6296296296296295,0.4098360655737705,-170,144,0.6047808585756369,0.3952191414243631,home,MIN,under,9,0.5454545454545454,-120,0.5227272727272727,MIN,DET,2024 REG,8,2,11,9,11,19,0,1,-7,7,1,1,0,0,0,0,0,0,0,0.4772727272727273,0.5227272727272727
94065,0.5555555555555556,0.48780487804878053,-125,105,0.5314664257753688,0.46853357422463116,away,COL,over,7.5,0.5348837209302326,-115,0.5097020142727117,OAK,COL,2024 REG,6,5,8,4,9,14,1,0,1,-1,1,1,1,1,0,0,0,0,0,0.5097020142727117,0.49029798572728833
94065,0.5555555555555556,0.48780487804878053,-125,105,0.5314664257753688,0.46853357422463116,home,OAK,under,7.5,0.5121951219512195,-105,0.49029798572728833,OAK,COL,2024 REG,6,5,8,4,9,14,1,0,1,-1,1,1,1,1,0,0,0,0,0,0.5097020142727117,0.49029798572728833
94067,0.6183206106870228,0.42194092827004215,-162,137,0.5934260713318911,0.40657392866810893,away,PIT,over,9,0.5348837209302326,-115,0.5097020142727117,PHI,PIT,2024 REG,7,2,9,5,7,16,0,1,-3,3,1,1,0,0,0,0,0,0,0,0.5097020142727117,0.49029798572728833
94067,0.6183206106870228,0.42194092827004215,-162,137,0.5934260713318911,0.40657392866810893,home,PHI,under,9,0.5121951219512195,-105,0.49029798572728833,PHI,PIT,2024 REG,7,2,9,5,7,16,0,1,-3,3,1,1,0,0,0,0,0,0,0,0.5097020142727117,0.49029798572728833
94068,0.5433789954337899,0.5,-119,100,0.5198077604720502,0.48019223952794976,away,HOU,over,7.5,0.49504950495049505,102,0.47297076509898783,SF,HOU,2024 REG,10,5,9,3,8,19,1,0,2,-2,1,1,1,0,0,0,0,0,0,0.47297076509898783,0.5270292349010122
94068,0.5433789954337899,0.5,-119,100,0.5198077604720502,0.48019223952794976,home,SF,under,7.5,0.5495495495495495,-122,0.5270292349010122,SF,HOU,2024 REG,10,5,9,3,8,19,1,0,2,-2,1,1,1,0,0,0,0,0,0,0.47297076509898783,0.5270292349010122
94069,0.6575342465753424,0.3846153846153846,-192,160,0.6298194205869192,0.3701805794130808,away,CWS,over,8.5,0.504950495049505,-102,0.48160416005266615,DET,CWS,2024 REG,16,11,5,2,13,21,1,0,9,-9,1,1,0,0,0,0,0,0,0,0.48160416005266615,0.5183958399473338
94069,0.6575342465753424,0.3846153846153846,-192,160,0.6298194205869192,0.3701805794130808,home,DET,under,8.5,0.5412844036697247,-118,0.5183958399473338,DET,CWS,2024 REG,16,11,5,2,13,21,1,0,9,-9,1,1,0,0,0,0,0,0,0,0.48160416005266615,0.5183958399473338
94070,0.5073891625615764,0.5370370370370371,-103,-116,0.48484779035144243,0.5151522096485576,away,SD,over,8.5,0.5238095238095238,-110,0.4988662131519274,MIL,SD,2024 REG,6,3,10,6,9,16,0,1,-3,3,1,1,1,0,0,0,0,0,0,0.4988662131519274,0.5011337868480725
94070,0.5073891625615764,0.5370370370370371,-103,-116,0.48484779035144243,0.5151522096485576,home,MIL,under,8.5,0.5238095238095238,-110,0.5011337868480725,MIL,SD,2024 REG,6,3,10,6,9,16,0,1,-3,3,1,1,1,0,0,0,0,0,0,0.4988662131519274,0.5011337868480725
94073,0.6721311475409836,0.36363636363636365,-205,175,0.6480906892086682,0.3519093107913318,away,OAK,over,7.5,0.5412844036697247,-118,0.5136310900085983,DET,OAK,2024 REG,7,1,14,7,8,21,0,1,-6,6,1,0,0,0,0,0,0,0,0,0.5136310900085983,0.4863689099914017
94073,0.6721311475409836,0.36363636363636365,-205,175,0.6480906892086682,0.3519093107913318,home,DET,under,7.5,0.5098039215686274,-104,0.4863689099914017,DET,OAK,2024 REG,7,1,14,7,8,21,0,1,-6,6,1,0,0,0,0,0,0,0,0,0.5136310900085983,0.4863689099914017
94074,0.4444444444444444,0.6000000000000001,125,-150,0.4246913580246913,0.5753086419753086,away,CIN,over,7.5,0.5145631067961165,-106,0.4913668392989033,SF,CIN,2024 REG,7,5,8,1,6,15,1,0,4,-4,1,0,0,0,0,0,0,0,0,0.4913668392989033,0.5086331607010968
94074,0.4444444444444444,0.6000000000000001,125,-150,0.4246913580246913,0.5753086419753086,home,SF,under,7.5,0.5305164319248826,-113,0.5086331607010968,SF,CIN,2024 REG,7,5,8,1,6,15,1,0,4,-4,1,0,0,0,0,0,0,0,0,0.4913668392989033,0.5086331607010968
94075,0.5951417004048584,0.4444444444444444,-147,125,0.5715823348467713,0.42841766515322866,away,CLE,over,7.5,0.5433789954337899,-119,0.5171177654451503,TOR,CLE,2024 REG,3,1,9,3,4,12,0,1,-2,2,1,0,0,0,0,0,0,0,0,0.5171177654451503,0.4828822345548497
94075,0.5951417004048584,0.4444444444444444,-147,125,0.5715823348467713,0.42841766515322866,home,TOR,under,7.5,0.504950495049505,-102,0.4828822345548497,TOR,CLE,2024 REG,3,1,9,3,4,12,0,1,-2,2,1,0,0,0,0,0,0,0,0,0.5171177654451503,0.4828822345548497
94077,0.45454545454545453,0.5867768595041323,120,-142,0.43576258452291505,0.564237415477085,away,NYM,over,9.5,0.5238095238095238,-110,0.4988662131519274,WSH,NYM,2024 REG,7,1,11,9,10,18,0,1,-8,8,1,0,0,0,0,0,0,0,0,0.4988662131519274,0.5011337868480725
94077,0.45454545454545453,0.5867768595041323,120,-142,0.43576258452291505,0.564237415477085,home,WSH,under,9.5,0.5238095238095238,-110,0.5011337868480725,WSH,NYM,2024 REG,7,1,11,9,10,18,0,1,-8,8,1,0,0,0,0,0,0,0,0,0.4988662131519274,0.5011337868480725
94079,0.5555555555555556,0.48780487804878053,-125,105,0.5314664257753688,0.46853357422463116,away,TOR,over,9,0.5121951219512195,-105,0.48808156828023186,MIL,TOR,2024 REG,11,5,7,4,9,18,1,0,1,-1,1,1,1,1,0,0,0,0,0,0.48808156828023186,0.5119184317197681
94079,0.5555555555555556,0.48780487804878053,-125,105,0.5314664257753688,0.46853357422463116,home,MIL,under,9,0.5348837209302326,-115,0.5119184317197681,MIL,TOR,2024 REG,11,5,7,4,9,18,1,0,1,-1,1,1,1,1,0,0,0,0,0,0.48808156828023186,0.5119184317197681
94080,0.4444444444444444,0.5983935742971888,125,-149,0.4254053250037185,0.5745946749962815,away,LAD,over,9.5,0.5121951219512195,-105,0.48808156828023186,CIN,LAD,2024 REG,9,3,5,1,4,14,1,0,2,-2,1,0,0,0,0,0,0,0,0,0.48808156828023186,0.5119184317197681
94080,0.4444444444444444,0.5983935742971888,125,-149,0.4254053250037185,0.5745946749962815,home,CIN,under,9.5,0.5348837209302326,-115,0.5119184317197681,CIN,LAD,2024 REG,9,3,5,1,4,14,1,0,2,-2,1,0,0,0,0,0,0,0,0,0.48808156828023186,0.5119184317197681
94082,0.7076023391812866,0.3367003367003367,-242,197,0.6762536620954597,0.3237463379045403,away,ARI,over,9.5,0.5454545454545454,-120,0.5206611570247933,PHI,ARI,2024 REG,11,4,6,1,5,17,1,0,3,-3,1,0,0,0,0,0,0,0,0,0.5206611570247933,0.4793388429752067
94082,0.7076023391812866,0.3367003367003367,-242,197,0.6762536620954597,0.3237463379045403,home,PHI,under,9.5,0.5,100,0.4793388429752067,PHI,ARI,2024 REG,11,4,6,1,5,17,1,0,3,-3,1,0,0,0,0,0,0,0,0,0.5206611570247933,0.4793388429752067
94083,0.6254681647940076,0.4132231404958678,-167,142,0.6012679850808645,0.39873201491913546,away,MIN,over,8.5,0.504950495049505,-102,0.48160416005266615,BAL,MIN,2024 REG,15,11,7,3,14,22,1,0,8,-8,1,1,1,0,0,0,0,0,0,0.48160416005266615,0.5183958399473338
94083,0.6254681647940076,0.4132231404958678,-167,142,0.6012679850808645,0.39873201491913546,home,BAL,under,8.5,0.5412844036697247,-118,0.5183958399473338,BAL,MIN,2024 REG,15,11,7,3,14,22,1,0,8,-8,1,1,1,0,0,0,0,0,0,0.48160416005266615,0.5183958399473338
94084,0.5305164319248826,0.5121951219512195,-113,-105,0.5078572507605655,0.49214274923943446,away,ATL,over,9,0.5348837209302326,-115,0.5097020142727117,BAL,ATL,2024 REG,6,3,12,6,9,18,0,1,-3,3,1,1,1,0,0,0,0,0,0,0.5097020142727117,0.49029798572728833
94084,0.5305164319248826,0.5121951219512195,-113,-105,0.5078572507605655,0.49214274923943446,home,BAL,under,9,0.5121951219512195,-105,0.49029798572728833,BAL,ATL,2024 REG,6,3,12,6,9,18,0,1,-3,3,1,1,1,0,0,0,0,0,0,0.5097020142727117,0.49029798572728833
94085,0.5,0.5454545454545454,100,-120,0.4772727272727273,0.5227272727272727,away,TOR,over,8.5,0.5073891625615764,-103,0.4837652908580103,MIL,TOR,2024 REG,5,0,9,3,3,14,0,1,-3,3,0,0,0,0,0,0,0,0,0,0.4837652908580103,0.5162347091419897
94085,0.5,0.5454545454545454,100,-120,0.4772727272727273,0.5227272727272727,home,MIL,under,8.5,0.5391705069124424,-117,0.5162347091419897,MIL,TOR,2024 REG,5,0,9,3,3,14,0,1,-3,3,0,0,0,0,0,0,0,0,0,0.4837652908580103,0.5162347091419897
94086,0.5260663507109005,0.5169082125603864,-111,-107,0.5034588790373798,0.49654112096262015,away,HOU,over,10.5,0.5121951219512195,-105,0.48808156828023186,TEX,HOU,2024 REG,2,1,4,3,4,6,0,1,-2,2,1,0,0,0,0,0,0,0,0,0.48808156828023186,0.5119184317197681
94086,0.5260663507109005,0.5169082125603864,-111,-107,0.5034588790373798,0.49654112096262015,home,TEX,under,10.5,0.5348837209302326,-115,0.5119184317197681,TEX,HOU,2024 REG,2,1,4,3,4,6,0,1,-2,2,1,0,0,0,0,0,0,0,0,0.48808156828023186,0.5119184317197681
94088,0.3968253968253968,0.6491228070175439,152,-185,0.37859198260200766,0.6214080173979923,away,SD,over,7.5,0.5348837209302326,-115,0.5097020142727117,LAA,SD,2024 REG,6,3,8,2,5,14,1,0,1,-1,1,1,0,0,0,0,0,0,0,0.5097020142727117,0.49029798572728833
94088,0.3968253968253968,0.6491228070175439,152,-185,0.37859198260200766,0.6214080173979923,home,LAA,under,7.5,0.5121951219512195,-105,0.49029798572728833,LAA,SD,2024 REG,6,3,8,2,5,14,1,0,1,-1,1,1,0,0,0,0,0,0,0,0.5097020142727117,0.49029798572728833
94089,0.607843137254902,0.43103448275862066,-155,132,0.5842116427368785,0.41578835726312147,away,TEX,over,8.5,0.5145631067961165,-106,0.4913668392989033,TB,TEX,2024 REG,7,5,7,2,7,14,1,0,3,-3,1,1,0,0,0,0,0,0,0,0.4913668392989033,0.5086331607010968
94089,0.607843137254902,0.43103448275862066,-155,132,0.5842116427368785,0.41578835726312147,home,TB,under,8.5,0.5305164319248826,-113,0.5086331607010968,TB,TEX,2024 REG,7,5,7,2,7,14,1,0,3,-3,1,1,0,0,0,0,0,0,0,0.4913668392989033,0.5086331607010968
94090,0.5169082125603864,0.5260663507109005,-107,-111,0.4946943078742622,0.5053056921257377,away,LAA,over,8.5,0.5215311004784688,-109,0.4978845547971712,OAK,LAA,2024 REG,10,5,5,0,5,15,1,0,5,-5,0,0,0,0,0,0,0,0,0,0.4978845547971712,0.5021154452028288
94090,0.5169082125603864,0.5260663507109005,-107,-111,0.4946943078742622,0.5053056921257377,home,OAK,under,8.5,0.5238095238095238,-110,0.5021154452028288,OAK,LAA,2024 REG,10,5,5,0,5,15,1,0,5,-5,0,0,0,0,0,0,0,0,0,0.4978845547971712,0.5021154452028288
94091,0.6415770609318996,0.4,-179,150,0.6149021723770248,0.3850978276229752,away,BOS,over,8.5,0.5348837209302326,-115,0.5097020142727117,NYY,BOS,2024 REG,14,14,8,4,18,22,1,0,10,-10,1,1,1,1,0,0,0,0,0,0.5097020142727117,0.49029798572728833
94091,0.6415770609318996,0.4,-179,150,0.6149021723770248,0.3850978276229752,home,NYY,under,8.5,0.5121951219512195,-105,0.49029798572728833,NYY,BOS,2024 REG,14,14,8,4,18,22,1,0,10,-10,1,1,1,1,0,0,0,0,0,0.5097020142727117,0.49029798572728833
94092,0.5305164319248826,0.5121951219512195,-113,-105,0.5078572507605655,0.49214274923943446,away,NYY,over,9,0.504950495049505,-102,0.48160416005266615,BAL,NYY,2024 REG,8,7,6,2,9,14,1,0,5,-5,1,1,0,0,0,0,0,0,0,0.48160416005266615,0.5183958399473338
94092,0.5305164319248826,0.5121951219512195,-113,-105,0.5078572507605655,0.49214274923943446,home,BAL,under,9,0.5412844036697247,-118,0.5183958399473338,BAL,NYY,2024 REG,8,7,6,2,9,14,1,0,5,-5,1,1,0,0,0,0,0,0,0,0.48160416005266615,0.5183958399473338
94093,0.5098039215686274,0.5305164319248826,-104,-113,0.4892484472386027,0.5107515527613973,away,TB,over,8.5,0.5454545454545454,-120,0.5206611570247933,KC,TB,2024 REG,10,8,16,10,18,26,0,1,-2,2,1,1,1,1,1,1,1,1,0,0.5206611570247933,0.4793388429752067
94093,0.5098039215686274,0.5305164319248826,-104,-113,0.4892484472386027,0.5107515527613973,home,KC,under,8.5,0.5,100,0.4793388429752067,KC,TB,2024 REG,10,8,16,10,18,26,0,1,-2,2,1,1,1,1,1,1,1,1,0,0.5206611570247933,0.4793388429752067
94095,0.5515695067264574,0.49019607843137253,-123,104,0.5285328835228112,0.47146711647718875,away,TOR,over,8.5,0.5327102803738317,-114,0.5075272610403079,MIL,TOR,2024 REG,6,3,4,1,4,10,1,0,2,-2,1,0,0,0,0,0,0,0,0,0.5075272610403079,0.4924727389596921
94095,0.5515695067264574,0.49019607843137253,-123,104,0.5285328835228112,0.47146711647718875,home,MIL,under,8.5,0.5145631067961165,-106,0.4924727389596921,MIL,TOR,2024 REG,6,3,4,1,4,10,1,0,2,-2,1,0,0,0,0,0,0,0,0,0.5075272610403079,0.4924727389596921
94096,0.37593984962406013,0.6666666666666666,166,-200,0.35992236229671926,0.6400776377032807,away,TB,over,8.5,0.5433789954337899,-119,0.5184560714286826,CWS,TB,2024 REG,10,8,11,7,15,21,1,0,1,-1,1,1,1,1,1,1,1,0,0,0.5184560714286826,0.48154392857131745
94096,0.37593984962406013,0.6666666666666666,166,-200,0.35992236229671926,0.6400776377032807,home,CWS,under,8.5,0.5024875621890548,-101,0.48154392857131745,CWS,TB,2024 REG,10,8,11,7,15,21,1,0,1,-1,1,1,1,1,1,1,1,0,0,0.5184560714286826,0.48154392857131745
94099,0.5475113122171946,0.4926108374384236,-121,103,0.5255439814102724,0.47445601858972763,away,CIN,over,7.5,0.5238095238095238,-110,0.4988662131519274,STL,CIN,2024 REG,7,2,2,0,2,9,1,0,2,-2,0,0,0,0,0,0,0,0,0,0.4988662131519274,0.5011337868480725
94099,0.5475113122171946,0.4926108374384236,-121,103,0.5255439814102724,0.47445601858972763,home,STL,under,7.5,0.5238095238095238,-110,0.5011337868480725,STL,CIN,2024 REG,7,2,2,0,2,9,1,0,2,-2,0,0,0,0,0,0,0,0,0,0.4988662131519274,0.5011337868480725
94100,0.6721311475409836,0.36900369003690037,-205,171,0.6444831419558484,0.35551685804415156,away,CWS,over,6.5,0.5327102803738317,-114,0.5075272610403079,MIN,CWS,2024 REG,13,6,4,3,9,17,1,0,3,-3,1,1,1,0,0,0,0,0,0,0.5075272610403079,0.4924727389596921
94100,0.6721311475409836,0.36900369003690037,-205,171,0.6444831419558484,0.35551685804415156,home,MIN,under,6.5,0.5145631067961165,-106,0.4924727389596921,MIN,CWS,2024 REG,13,6,4,3,9,17,1,0,3,-3,1,1,1,0,0,0,0,0,0,0.5075272610403079,0.4924727389596921
94101,0.5348837209302326,0.5121951219512195,-115,-105,0.5097020142727117,0.49029798572728833,away,LAA,over,8.5,0.5412844036697247,-118,0.5136310900085983,MIA,LAA,2024 REG,4,2,12,10,12,16,0,1,-8,8,1,1,0,0,0,0,0,0,0,0.5136310900085983,0.4863689099914017
94101,0.5348837209302326,0.5121951219512195,-115,-105,0.5097020142727117,0.49029798572728833,home,MIA,under,8.5,0.5098039215686274,-104,0.4863689099914017,MIA,LAA,2024 REG,4,2,12,10,12,16,0,1,-8,8,1,1,0,0,0,0,0,0,0,0.5136310900085983,0.4863689099914017
94105,0.5901639344262295,0.4504504504504505,-144,122,0.5661947892531068,0.43380521074689316,away,BAL,over,7,0.5433789954337899,-119,0.5184560714286826,SEA,BAL,2024 REG,5,1,6,4,5,11,0,1,-3,3,1,0,0,0,0,0,0,0,0,0.5184560714286826,0.48154392857131745
94105,0.5901639344262295,0.4504504504504505,-144,122,0.5661947892531068,0.43380521074689316,home,SEA,under,7,0.5024875621890548,-101,0.48154392857131745,SEA,BAL,2024 REG,5,1,6,4,5,11,0,1,-3,3,1,0,0,0,0,0,0,0,0,0.5184560714286826,0.48154392857131745
94106,0.5348837209302326,0.5073891625615764,-115,-103,0.5122726437136835,0.48772735628631647,away,LAA,over,9,0.5238095238095238,-110,0.4988662131519274,BOS,LAA,2024 REG,3,0,12,7,7,15,0,1,-7,7,0,0,0,0,0,0,0,0,0,0.4988662131519274,0.5011337868480725
94106,0.5348837209302326,0.5073891625615764,-115,-103,0.5122726437136835,0.48772735628631647,home,BOS,under,9,0.5238095238095238,-110,0.5011337868480725,BOS,LAA,2024 REG,3,0,12,7,7,15,0,1,-7,7,0,0,0,0,0,0,0,0,0,0.4988662131519274,0.5011337868480725
94107,0.4629629629629629,0.576271186440678,116,-136,0.4447990049057217,0.5552009950942782,away,PHI,over,7.5,0.5,100,0.4772727272727273,STL,PHI,2024 REG,7,3,8,0,3,15,1,0,3,-3,0,0,0,0,0,0,0,0,0,0.4772727272727273,0.5227272727272727
94107,0.4629629629629629,0.576271186440678,116,-136,0.4447990049057217,0.5552009950942782,home,STL,under,7.5,0.5454545454545454,-120,0.5227272727272727,STL,PHI,2024 REG,7,3,8,0,3,15,1,0,3,-3,0,0,0,0,0,0,0,0,0,0.4772727272727273,0.5227272727272727
94108,0.7198879551820728,0.3225806451612903,-257,210,0.6893153213214445,0.31068467867855554,away,OAK,over,8.5,0.5238095238095238,-110,0.4988662131519274,NYY,OAK,2024 REG,3,0,4,2,2,7,0,1,-2,2,0,0,0,0,0,0,0,0,0,0.4988662131519274,0.5011337868480725
94108,0.7198879551820728,0.3225806451612903,-257,210,0.6893153213214445,0.31068467867855554,home,NYY,under,8.5,0.5238095238095238,-110,0.5011337868480725,NYY,OAK,2024 REG,3,0,4,2,2,7,0,1,-2,2,0,0,0,0,0,0,0,0,0,0.4988662131519274,0.5011337868480725
94109,0.5454545454545454,0.49751243781094534,-120,101,0.5220180091279142,0.4779819908720858,away,TEX,over,10,0.5145631067961165,-106,0.49023796582517226,PHI,TEX,2024 REG,8,11,7,4,15,15,1,0,7,-7,1,1,1,1,0,0,0,0,0,0.49023796582517226,0.5097620341748277
94109,0.5454545454545454,0.49751243781094534,-120,101,0.5220180091279142,0.4779819908720858,home,PHI,under,10,0.5327102803738317,-114,0.5097620341748277,PHI,TEX,2024 REG,8,11,7,4,15,15,1,0,7,-7,1,1,1,1,0,0,0,0,0,0.49023796582517226,0.5097620341748277
94110,0.33557046979865773,0.7058823529411764,198,-240,0.32166012659737114,0.6783398734026289,away,TB,over,7.5,0.504950495049505,-102,0.48054649490447493,CWS,TB,2024 REG,12,9,9,4,13,21,1,0,5,-5,1,1,1,1,0,0,0,0,0,0.48054649490447493,0.5194535050955251
94110,0.33557046979865773,0.7058823529411764,198,-240,0.32166012659737114,0.6783398734026289,home,CWS,under,7.5,0.5433789954337899,-119,0.5194535050955251,CWS,TB,2024 REG,12,9,9,4,13,21,1,0,5,-5,1,1,1,1,0,0,0,0,0,0.48054649490447493,0.5194535050955251
94111,0.5238095238095238,0.5215311004784688,-110,-109,0.5000596729920038,0.4999403270079962,away,BAL,over,7,0.5192307692307692,-108,0.49455035168025013,SEA,BAL,2024 REG,2,0,9,2,2,11,0,1,-2,2,0,0,0,0,0,0,0,0,0,0.49455035168025013,0.5054496483197499
94111,0.5238095238095238,0.5215311004784688,-110,-109,0.5000596729920038,0.4999403270079962,home,SEA,under,7,0.5283018867924528,-112,0.5054496483197499,SEA,BAL,2024 REG,2,0,9,2,2,11,0,1,-2,2,0,0,0,0,0,0,0,0,0,0.49455035168025013,0.5054496483197499
94117,0.47619047619047616,0.5652173913043479,110,-130,0.4564724440500838,0.5435275559499162,away,ATL,over,8.5,0.5454545454545454,-120,0.5206611570247933,CHC,ATL,2024 REG,3,2,9,9,11,12,0,1,-7,7,1,1,0,0,0,0,0,0,0,0.5206611570247933,0.4793388429752067
94117,0.47619047619047616,0.5652173913043479,110,-130,0.4564724440500838,0.5435275559499162,home,CHC,under,8.5,0.5,100,0.4793388429752067,CHC,ATL,2024 REG,3,2,9,9,11,12,0,1,-7,7,1,1,0,0,0,0,0,0,0,0.5206611570247933,0.4793388429752067
94118,0.4273504273504274,0.613899613899614,134,-159,0.40972220459399944,0.5902777954060006,away,BAL,over,9,0.5121951219512195,-105,0.48808156828023186,STL,BAL,2024 REG,5,3,3,1,4,8,1,0,2,-2,1,0,0,0,0,0,0,0,0,0.48808156828023186,0.5119184317197681
94118,0.4273504273504274,0.613899613899614,134,-159,0.40972220459399944,0.5902777954060006,home,STL,under,9,0.5348837209302326,-115,0.5119184317197681,STL,BAL,2024 REG,5,3,3,1,4,8,1,0,2,-2,1,0,0,0,0,0,0,0,0,0.48808156828023186,0.5119184317197681
94120,0.48309178743961345,0.5555555555555556,107,-125,0.4644215734322854,0.5355784265677146,away,STL,over,8,0.5145631067961165,-106,0.49023796582517226,OAK,STL,2024 REG,10,6,6,3,9,16,1,0,3,-3,1,1,1,0,0,0,0,0,0,0.49023796582517226,0.5097620341748277
94120,0.48309178743961345,0.5555555555555556,107,-125,0.4644215734322854,0.5355784265677146,home,OAK,under,8,0.5327102803738317,-114,0.5097620341748277,OAK,STL,2024 REG,10,6,6,3,9,16,1,0,3,-3,1,1,1,0,0,0,0,0,0,0.49023796582517226,0.5097620341748277
94121,0.7530864197530864,0.2898550724637681,-305,245,0.7207477651206404,0.2792522348793596,away,MIA,over,8,0.5145631067961165,-106,0.4891195935000339,PHI,MIA,2024 REG,8,4,13,7,11,21,0,1,-3,3,1,1,1,1,0,0,0,0,0,0.4891195935000339,0.5108804064999661
94121,0.7530864197530864,0.2898550724637681,-305,245,0.7207477651206404,0.2792522348793596,home,PHI,under,8,0.5348837209302326,-115,0.5108804064999661,PHI,MIA,2024 REG,8,4,13,7,11,21,0,1,-3,3,1,1,1,1,0,0,0,0,0,0.4891195935000339,0.5108804064999661
94123,0.4484304932735426,0.5918367346938775,123,-145,0.43037344037335423,0.5696265596266458,away,BAL,over,7.5,0.5348837209302326,-115,0.5097020142727117,TB,BAL,2024 REG,6,2,13,9,11,19,0,1,-7,7,1,1,0,0,0,0,0,0,0,0.5097020142727117,0.49029798572728833
94123,0.4484304932735426,0.5918367346938775,123,-145,0.43037344037335423,0.5696265596266458,home,TB,under,7.5,0.5121951219512195,-105,0.49029798572728833,TB,BAL,2024 REG,6,2,13,9,11,19,0,1,-7,7,1,1,0,0,0,0,0,0,0,0.5097020142727117,0.49029798572728833
94124,0.6491228070175439,0.3921568627450981,-185,155,0.6223272319084604,0.3776727680915396,away,CLE,over,8.5,0.5305164319248826,-113,0.5066009958897986,HOU,CLE,2024 REG,7,2,9,3,5,16,0,1,-1,1,1,1,0,0,0,0,0,0,0,0.5066009958897986,0.49339900411020143
94124,0.6491228070175439,0.3921568627450981,-185,155,0.6223272319084604,0.3776727680915396,home,HOU,under,8.5,0.5145631067961165,-106,0.49339900411020143,HOU,CLE,2024 REG,7,2,9,3,5,16,0,1,-1,1,1,1,0,0,0,0,0,0,0,0.5066009958897986,0.49339900411020143
94127,0.6000000000000001,0.4424778761061947,-150,126,0.5745132743362832,0.4254867256637168,away,PIT,over,8,0.5348837209302326,-115,0.5097020142727117,MIL,PIT,2024 REG,13,10,8,2,12,21,1,0,8,-8,1,1,0,0,0,0,0,0,0,0.5097020142727117,0.49029798572728833
94127,0.6000000000000001,0.4424778761061947,-150,126,0.5745132743362832,0.4254867256637168,home,MIL,under,8,0.5121951219512195,-105,0.49029798572728833,MIL,PIT,2024 REG,13,10,8,2,12,21,1,0,8,-8,1,1,0,0,0,0,0,0,0,0.5097020142727117,0.49029798572728833
94128,0.48780487804878053,0.5555555555555556,105,-125,0.4666534470222751,0.5333465529777248,away,MIL,over,7,0.5370370370370371,-116,0.5118817074154765,STL,MIL,2024 REG,5,1,5,2,3,10,0,1,-1,1,1,0,0,0,0,0,0,0,0,0.5118817074154765,0.48811829258452355
94128,0.48780487804878053,0.5555555555555556,105,-125,0.4666534470222751,0.5333465529777248,home,STL,under,7,0.5098039215686274,-104,0.48811829258452355,STL,MIL,2024 REG,5,1,5,2,3,10,0,1,-1,1,1,0,0,0,0,0,0,0,0,0.5118817074154765,0.48811829258452355
94130,0.6923076923076923,0.3508771929824561,-225,185,0.6624104640298972,0.33758953597010277,away,MIA,over,8,0.5327102803738317,-114,0.5075272610403079,PHI,MIA,2024 REG,7,2,3,0,2,10,1,0,2,-2,0,0,0,0,0,0,0,0,0,0.5075272610403079,0.4924727389596921
94130,0.6923076923076923,0.3508771929824561,-225,185,0.6624104640298972,0.33758953597010277,home,PHI,under,8,0.5145631067961165,-106,0.4924727389596921,PHI,MIA,2024 REG,7,2,3,0,2,10,1,0,2,-2,0,0,0,0,0,0,0,0,0,0.5075272610403079,0.4924727389596921
94131,0.5283018867924528,0.5121951219512195,-112,-105,0.5069072406637203,0.4930927593362797,away,MIL,over,9,0.5,100,0.4772727272727273,LAD,MIL,2024 REG,9,5,5,3,8,14,1,0,2,-2,1,1,1,0,0,0,0,0,0,0.4772727272727273,0.5227272727272727
94131,0.5283018867924528,0.5121951219512195,-112,-105,0.5069072406637203,0.4930927593362797,home,LAD,under,9,0.5454545454545454,-120,0.5227272727272727,LAD,MIL,2024 REG,9,5,5,3,8,14,1,0,2,-2,1,1,1,0,0,0,0,0,0,0.4772727272727273,0.5227272727272727
94133,0.7214484679665738,0.3225806451612903,-259,210,0.6896837317545493,0.31031626824545067,away,MIA,over,9.5,0.5,100,0.4762443438914027,KC,MIA,2024 REG,6,4,4,1,5,10,1,0,3,-3,1,0,0,0,0,0,0,0,0,0.4762443438914027,0.5237556561085973
94133,0.7214484679665738,0.3225806451612903,-259,210,0.6896837317545493,0.31031626824545067,home,KC,under,9.5,0.5475113122171946,-121,0.5237556561085973,KC,MIA,2024 REG,6,4,4,1,5,10,1,0,3,-3,1,0,0,0,0,0,0,0,0,0.4762443438914027,0.5237556561085973
94134,0.5918367346938775,0.4484304932735426,-145,123,0.5680051099784656,0.43199489002153435,away,TEX,over,7.5,0.5215311004784688,-109,0.49670754937970685,DET,TEX,2024 REG,7,4,7,5,9,14,0,1,-1,1,1,1,1,1,0,0,0,0,0,0.49670754937970685,0.5032924506202932
94134,0.5918367346938775,0.4484304932735426,-145,123,0.5680051099784656,0.43199489002153435,home,DET,under,7.5,0.5260663507109005,-111,0.5032924506202932,DET,TEX,2024 REG,7,4,7,5,9,14,0,1,-1,1,1,1,1,1,0,0,0,0,0,0.49670754937970685,0.5032924506202932
94136,0.6124031007751938,0.425531914893617,-158,135,0.5891715795516586,0.41082842044834145,away,MIL,over,7.5,0.5348837209302326,-115,0.5097020142727117,SD,MIL,2024 REG,15,9,11,5,14,26,1,0,4,-4,1,1,1,1,1,0,0,0,0,0.5097020142727117,0.49029798572728833
94136,0.6124031007751938,0.425531914893617,-158,135,0.5891715795516586,0.41082842044834145,home,SD,under,7.5,0.5121951219512195,-105,0.49029798572728833,SD,MIL,2024 REG,15,9,11,5,14,26,1,0,4,-4,1,1,1,1,1,0,0,0,0,0.5097020142727117,0.49029798572728833
94138,0.4347826086956522,0.6047430830039526,130,-153,0.4175975253479979,0.5824024746520021,away,ATL,over,8.5,0.5121951219512195,-105,0.48808156828023186,LAD,ATL,2024 REG,5,5,5,1,6,10,1,0,4,-4,1,0,0,0,0,0,0,0,0,0.48808156828023186,0.5119184317197681
94138,0.4347826086956522,0.6047430830039526,130,-153,0.4175975253479979,0.5824024746520021,home,LAD,under,8.5,0.5348837209302326,-115,0.5119184317197681,LAD,ATL,2024 REG,5,5,5,1,6,10,1,0,4,-4,1,0,0,0,0,0,0,0,0,0.48808156828023186,0.5119184317197681
94139,0.6815286624203821,0.36101083032490977,-214,177,0.6525367788296419,0.3474632211703581,away,MIA,over,8.5,0.5098039215686274,-104,0.4870219861770517,NYY,MIA,2024 REG,7,3,4,2,5,11,1,0,1,-1,1,1,0,0,0,0,0,0,0,0.4870219861770517,0.5129780138229483
94139,0.6815286624203821,0.36101083032490977,-214,177,0.6525367788296419,0.3474632211703581,home,NYY,under,8.5,0.5348837209302326,-115,0.5129780138229483,NYY,MIA,2024 REG,7,3,4,2,5,11,1,0,1,-1,1,1,0,0,0,0,0,0,0,0.4870219861770517,0.5129780138229483
94140,0.6153846153846154,0.425531914893617,-160,135,0.5902052121364724,0.40979478786352763,away,CLE,over,9.5,0.5215311004784688,-109,0.4978845547971712,BOS,CLE,2024 REG,3,0,9,6,6,12,0,1,-6,6,0,0,0,0,0,0,0,0,0,0.4978845547971712,0.5021154452028288
94140,0.6153846153846154,0.425531914893617,-160,135,0.5902052121364724,0.40979478786352763,home,BOS,under,9.5,0.5238095238095238,-110,0.5021154452028288,BOS,CLE,2024 REG,3,0,9,6,6,12,0,1,-6,6,0,0,0,0,0,0,0,0,0,0.4978845547971712,0.5021154452028288
94141,0.574468085106383,0.46511627906976744,-135,115,0.5517281312179562,0.44827186878204384,away,ARI,over,9,0.5192307692307692,-108,0.49455035168025013,TEX,ARI,2024 REG,8,6,9,1,7,17,1,0,5,-5,1,0,0,0,0,0,0,0,0,0.49455035168025013,0.5054496483197499
94141,0.574468085106383,0.46511627906976744,-135,115,0.5517281312179562,0.44827186878204384,home,TEX,under,9,0.5283018867924528,-112,0.5054496483197499,TEX,ARI,2024 REG,8,6,9,1,7,17,1,0,5,-5,1,0,0,0,0,0,0,0,0,0.49455035168025013,0.5054496483197499
94143,0.5238095238095238,0.5238095238095238,-110,-110,0.4988662131519274,0.5011337868480725,away,SD,over,8.5,0.5305164319248826,-113,0.5053568787472517,LAA,SD,2024 REG,5,4,7,2,6,12,1,0,2,-2,1,1,0,0,0,0,0,0,0,0.5053568787472517,0.49464312125274834
94143,0.5238095238095238,0.5238095238095238,-110,-110,0.4988662131519274,0.5011337868480725,home,LAA,under,8.5,0.5169082125603864,-107,0.49464312125274834,LAA,SD,2024 REG,5,4,7,2,6,12,1,0,2,-2,1,1,0,0,0,0,0,0,0,0.5053568787472517,0.49464312125274834
94148,0.574468085106383,0.4694835680751174,-135,113,0.5492192630659467,0.4507807369340533,away,SEA,over,8.5,0.5495495495495495,-122,0.5236866555946829,CLE,SEA,2024 REG,10,5,11,8,13,21,0,1,-3,3,1,1,1,1,1,0,0,0,0,0.5236866555946829,0.47631334440531714
94148,0.574468085106383,0.4694835680751174,-135,113,0.5492192630659467,0.4507807369340533,home,CLE,under,8.5,0.49751243781094534,101,0.47631334440531714,CLE,SEA,2024 REG,10,5,11,8,13,21,0,1,-3,3,1,1,1,1,1,0,0,0,0,0.5236866555946829,0.47631334440531714
94151,0.4926108374384236,0.5495495495495495,103,-122,0.4718421738975501,0.5281578261024499,away,MIL,over,8,0.5348837209302326,-115,0.5097020142727117,PIT,MIL,2024 REG,4,2,7,3,5,11,0,1,-1,1,1,1,0,0,0,0,0,0,0,0.5097020142727117,0.49029798572728833
94151,0.4926108374384236,0.5495495495495495,103,-122,0.4718421738975501,0.5281578261024499,home,PIT,under,8,0.5121951219512195,-105,0.49029798572728833,PIT,MIL,2024 REG,4,2,7,3,5,11,0,1,-1,1,1,1,0,0,0,0,0,0,0,0.5097020142727117,0.49029798572728833
94152,0.5215311004784688,0.5238095238095238,-109,-110,0.4978845547971712,0.5021154452028288,away,CHC,over,7.5,0.5348837209302326,-115,0.5097020142727117,BOS,CHC,2024 REG,7,1,14,7,8,21,0,1,-6,6,1,0,0,0,0,0,0,0,0,0.5097020142727117,0.49029798572728833
94152,0.5215311004784688,0.5238095238095238,-109,-110,0.4978845547971712,0.5021154452028288,home,BOS,under,7.5,0.5121951219512195,-105,0.49029798572728833,BOS,CHC,2024 REG,7,1,14,7,8,21,0,1,-6,6,1,0,0,0,0,0,0,0,0,0.5097020142727117,0.49029798572728833
94153,0.4424778761061947,0.6000000000000001,126,-150,0.42368235570522356,0.5763176442947764,away,BAL,over,7.5,0.5348837209302326,-115,0.5097020142727117,HOU,BAL,2024 REG,6,5,4,1,6,10,1,0,4,-4,1,0,0,0,0,0,0,0,0,0.5097020142727117,0.49029798572728833
94153,0.4424778761061947,0.6000000000000001,126,-150,0.42368235570522356,0.5763176442947764,home,HOU,under,7.5,0.5121951219512195,-105,0.49029798572728833,HOU,BAL,2024 REG,6,5,4,1,6,10,1,0,4,-4,1,0,0,0,0,0,0,0,0,0.5097020142727117,0.49029798572728833
94156,0.46511627906976744,0.574468085106383,115,-135,0.44670494689481377,0.5532950531051862,away,CLE,over,10.5,0.5215311004784688,-109,0.4978845547971712,COL,CLE,2024 REG,10,7,13,13,20,23,0,1,-6,6,1,1,1,1,1,1,1,0,0,0.4978845547971712,0.5021154452028288
94156,0.46511627906976744,0.574468085106383,115,-135,0.44670494689481377,0.5532950531051862,home,COL,under,10.5,0.5238095238095238,-110,0.5021154452028288,COL,CLE,2024 REG,10,7,13,13,20,23,0,1,-6,6,1,1,1,1,1,1,1,0,0,0.4978845547971712,0.5021154452028288
94157,0.7590361445783133,0.2857142857142857,-315,250,0.7250689505007983,0.27493104949920166,away,CWS,over,8.5,0.5121951219512195,-105,0.48808156828023186,NYY,CWS,2024 REG,10,7,6,2,9,16,1,0,5,-5,1,1,0,0,0,0,0,0,0,0.48808156828023186,0.5119184317197681
94157,0.7590361445783133,0.2857142857142857,-315,250,0.7250689505007983,0.27493104949920166,home,NYY,under,8.5,0.5348837209302326,-115,0.5119184317197681,NYY,CWS,2024 REG,10,7,6,2,9,16,1,0,5,-5,1,1,0,0,0,0,0,0,0,0.48808156828023186,0.5119184317197681
94158,0.5348837209302326,0.5121951219512195,-115,-105,0.5097020142727117,0.49029798572728833,away,TOR,over,8,0.5348837209302326,-115,0.5097020142727117,DET,TOR,2024 REG,8,2,6,1,3,14,1,0,1,-1,1,0,0,0,0,0,0,0,0,0.5097020142727117,0.49029798572728833
94158,0.5348837209302326,0.5121951219512195,-115,-105,0.5097020142727117,0.49029798572728833,home,DET,under,8,0.5121951219512195,-105,0.49029798572728833,DET,TOR,2024 REG,8,2,6,1,3,14,1,0,1,-1,1,0,0,0,0,0,0,0,0,0.5097020142727117,0.49029798572728833
94159,0.6666666666666666,0.37037037037037035,-200,170,0.6419753086419753,0.3580246913580247,away,CWS,over,9.5,0.5098039215686274,-104,0.48375889301574193,CHC,CWS,2024 REG,8,7,13,6,13,21,1,0,1,-1,1,1,1,1,1,1,0,0,0,0.48375889301574193,0.5162411069842581
94159,0.6666666666666666,0.37037037037037035,-200,170,0.6419753086419753,0.3580246913580247,home,CHC,under,9.5,0.5412844036697247,-118,0.5162411069842581,CHC,CWS,2024 REG,8,7,13,6,13,21,1,0,1,-1,1,1,1,1,1,1,0,0,0,0.48375889301574193,0.5162411069842581
94160,0.5934959349593496,0.4464285714285714,-146,124,0.5698009027128599,0.4301990972871401,away,CIN,over,7,0.5348837209302326,-115,0.5097020142727117,SEA,CIN,2024 REG,10,9,7,3,12,17,1,0,6,-6,1,1,1,0,0,0,0,0,0,0.5097020142727117,0.49029798572728833
94160,0.5934959349593496,0.4464285714285714,-146,124,0.5698009027128599,0.4301990972871401,home,SEA,under,7,0.5121951219512195,-105,0.49029798572728833,SEA,CIN,2024 REG,10,9,7,3,12,17,1,0,6,-6,1,1,1,0,0,0,0,0,0,0.5097020142727117,0.49029798572728833
94161,0.46511627906976744,0.574468085106383,115,-135,0.44670494689481377,0.5532950531051862,away,BAL,over,8,0.5145631067961165,-106,0.49023796582517226,TB,BAL,2024 REG,2,0,9,5,5,11,0,1,-5,5,0,0,0,0,0,0,0,0,0,0.49023796582517226,0.5097620341748277
94161,0.46511627906976744,0.574468085106383,115,-135,0.44670494689481377,0.5532950531051862,home,TB,under,8,0.5327102803738317,-114,0.5097620341748277,TB,BAL,2024 REG,2,0,9,5,5,11,0,1,-5,5,0,0,0,0,0,0,0,0,0,0.49023796582517226,0.5097620341748277
94162,0.6047430830039526,0.4347826086956522,-153,130,0.5808401943476698,0.41915980565233024,away,NYY,over,9,0.5238095238095238,-110,0.4988662131519274,HOU,NYY,2024 REG,13,4,8,5,9,21,0,1,-1,1,1,1,1,1,0,0,0,0,0,0.4988662131519274,0.5011337868480725
94162,0.6047430830039526,0.4347826086956522,-153,130,0.5808401943476698,0.41915980565233024,home,HOU,under,9,0.5238095238095238,-110,0.5011337868480725,HOU,NYY,2024 REG,13,4,8,5,9,21,0,1,-1,1,1,1,1,1,0,0,0,0,0,0.4988662131519274,0.5011337868480725
94164,0.46511627906976744,0.574468085106383,115,-135,0.44670494689481377,0.5532950531051862,away,TEX,over,8.5,0.5238095238095238,-110,0.4988662131519274,KC,TEX,2024 REG,7,2,8,3,5,15,0,1,-1,1,1,1,0,0,0,0,0,0,0,0.4988662131519274,0.5011337868480725
94164,0.46511627906976744,0.574468085106383,115,-135,0.44670494689481377,0.5532950531051862,home,KC,under,8.5,0.5238095238095238,-110,0.5011337868480725,KC,TEX,2024 REG,7,2,8,3,5,15,0,1,-1,1,1,1,0,0,0,0,0,0,0,0.4988662131519274,0.5011337868480725
94167,0.5614035087719298,0.47846889952153115,-128,109,0.5390189988527938,0.4609810011472062,away,TOR,over,8.5,0.5454545454545454,-120,0.5206611570247933,CLE,TOR,2024 REG,5,7,6,1,8,11,1,0,6,-6,1,0,0,0,0,0,0,0,0,0.5206611570247933,0.4793388429752067
94167,0.5614035087719298,0.47846889952153115,-128,109,0.5390189988527938,0.4609810011472062,home,CLE,under,8.5,0.5,100,0.4793388429752067,CLE,TOR,2024 REG,5,7,6,1,8,11,1,0,6,-6,1,0,0,0,0,0,0,0,0,0.5206611570247933,0.4793388429752067
94169,0.5918367346938775,0.45248868778280543,-145,121,0.5656033213913509,0.43439667860864906,away,CIN,over,8,0.5348837209302326,-115,0.5097020142727117,PHI,CIN,2024 REG,7,3,8,6,9,15,0,1,-3,3,1,1,1,0,0,0,0,0,0,0.5097020142727117,0.49029798572728833
94169,0.5918367346938775,0.45248868778280543,-145,121,0.5656033213913509,0.43439667860864906,home,PHI,under,8,0.5121951219512195,-105,0.49029798572728833,PHI,CIN,2024 REG,7,3,8,6,9,15,0,1,-3,3,1,1,1,0,0,0,0,0,0,0.5097020142727117,0.49029798572728833
94171,0.5,0.5454545454545454,100,-120,0.4772727272727273,0.5227272727272727,away,MIN,over,7,0.5121951219512195,-105,0.48808156828023186,SEA,MIN,2024 REG,6,1,10,5,6,16,0,1,-4,4,1,0,0,0,0,0,0,0,0,0.48808156828023186,0.5119184317197681
94171,0.5,0.5454545454545454,100,-120,0.4772727272727273,0.5227272727272727,home,SEA,under,7,0.5348837209302326,-115,0.5119184317197681,SEA,MIN,2024 REG,6,1,10,5,6,16,0,1,-4,4,1,0,0,0,0,0,0,0,0,0.48808156828023186,0.5119184317197681
94174,0.6226415094339623,0.4166666666666667,-165,140,0.5981666073335706,0.40183339266642937,away,TB,over,7.5,0.5412844036697247,-118,0.5149381613977361,PIT,TB,2024 REG,3,1,9,3,4,12,0,1,-2,2,1,0,0,0,0,0,0,0,0,0.5149381613977361,0.48506183860226393
94174,0.6226415094339623,0.4166666666666667,-165,140,0.5981666073335706,0.40183339266642937,home,PIT,under,7.5,0.5073891625615764,-103,0.48506183860226393,PIT,TB,2024 REG,3,1,9,3,4,12,0,1,-2,2,1,0,0,0,0,0,0,0,0,0.5149381613977361,0.48506183860226393
94176,0.4,0.6415770609318996,150,-179,0.38336917562724016,0.6166308243727598,away,HOU,over,8.5,0.5121951219512195,-105,0.48808156828023186,OAK,HOU,2024 REG,10,3,12,6,9,22,0,1,-3,3,1,1,1,0,0,0,0,0,0,0.48808156828023186,0.5119184317197681
94176,0.4,0.6415770609318996,150,-179,0.38336917562724016,0.6166308243727598,home,OAK,under,8.5,0.5348837209302326,-115,0.5119184317197681,OAK,HOU,2024 REG,10,3,12,6,9,22,0,1,-3,3,1,1,1,0,0,0,0,0,0,0.48808156828023186,0.5119184317197681
94177,0.4347826086956522,0.607843137254902,130,-155,0.41624967567367205,0.583750324326328,away,BAL,over,8.5,0.5145631067961165,-106,0.49023796582517226,HOU,BAL,2024 REG,14,14,18,11,25,32,1,0,3,-3,1,1,1,1,1,1,1,1,1,0.49023796582517226,0.5097620341748277
94177,0.4347826086956522,0.607843137254902,130,-155,0.41624967567367205,0.583750324326328,home,HOU,under,8.5,0.5327102803738317,-114,0.5097620341748277,HOU,BAL,2024 REG,14,14,18,11,25,32,1,0,3,-3,1,1,1,1,1,1,1,1,1,0.49023796582517226,0.5097620341748277
94179,0.6515679442508712,0.390625,-187,156,0.6240763743034393,0.3759236256965607,away,CIN,over,8,0.5348837209302326,-115,0.5097020142727117,PIT,CIN,2024 REG,8,4,7,1,5,15,1,0,3,-3,1,0,0,0,0,0,0,0,0,0.5097020142727117,0.49029798572728833
94179,0.6515679442508712,0.390625,-187,156,0.6240763743034393,0.3759236256965607,home,PIT,under,8,0.5121951219512195,-105,0.49029798572728833,PIT,CIN,2024 REG,8,4,7,1,5,15,1,0,3,-3,1,0,0,0,0,0,0,0,0,0.5097020142727117,0.49029798572728833
94181,0.425531914893617,0.613899613899614,135,-159,0.40875254093905067,0.5912474590609493,away,ATL,over,1.5,0.42194092827004215,137,0.3962320261834884,SEA,ATL,2024 REG,4,2,3,1,3,7,1,0,1,-1,1,0,0,0,0,0,0,0,0,0.3962320261834884,0.6037679738165116
94181,0.425531914893617,0.613899613899614,135,-159,0.40875254093905067,0.5912474590609493,away,ATL,over,2.5,0.31446540880503143,218,0.3080667415892428,SEA,ATL,2024 REG,4,2,3,1,3,7,1,0,1,-1,1,0,0,0,0,0,0,0,0,0.3962320261834884,0.6037679738165116
94181,0.425531914893617,0.613899613899614,135,-159,0.40875254093905067,0.5912474590609493,home,SEA,under,1.5,0.6389891696750902,-177,0.6037679738165116,SEA,ATL,2024 REG,4,2,3,1,3,7,1,0,1,-1,1,0,0,0,0,0,0,0,0,0.3962320261834884,0.6037679738165116
94181,0.425531914893617,0.613899613899614,135,-159,0.40875254093905067,0.5912474590609493,home,SEA,under,2.5,0.7058823529411764,-240,0.6919332584107571,SEA,ATL,2024 REG,4,2,3,1,3,7,1,0,1,-1,1,0,0,0,0,0,0,0,0,0.3962320261834884,0.6037679738165116
94182,0.6721311475409836,0.37037037037037035,-205,170,0.6435645535349916,0.35643544646500835,away,OAK,over,8.5,0.5215311004784688,-109,0.4978845547971712,KC,OAK,2024 REG,11,6,4,2,8,15,1,0,4,-4,1,1,0,0,0,0,0,0,0,0.4978845547971712,0.5021154452028288
94182,0.6721311475409836,0.37037037037037035,-205,170,0.6435645535349916,0.35643544646500835,home,KC,under,8.5,0.5238095238095238,-110,0.5021154452028288,KC,OAK,2024 REG,11,6,4,2,8,15,1,0,4,-4,1,1,0,0,0,0,0,0,0,0.4978845547971712,0.5021154452028288
94183,0.6226415094339623,0.4166666666666667,-165,140,0.5981666073335706,0.40183339266642937,away,MIL,over,7.5,0.5121951219512195,-105,0.48808156828023186,STL,MIL,2024 REG,6,0,6,2,2,12,0,1,-2,2,0,0,0,0,0,0,0,0,0,0.48808156828023186,0.5119184317197681
94183,0.6226415094339623,0.4166666666666667,-165,140,0.5981666073335706,0.40183339266642937,home,STL,under,7.5,0.5348837209302326,-115,0.5119184317197681,STL,MIL,2024 REG,6,0,6,2,2,12,0,1,-2,2,0,0,0,0,0,0,0,0,0,0.48808156828023186,0.5119184317197681
94184,0.4672897196261683,0.574468085106383,114,-135,0.4477767267604901,0.5522232732395099,away,MIL,over,8,0.5238095238095238,-110,0.4988662131519274,MIA,MIL,2024 REG,12,5,11,7,12,23,0,1,-2,2,1,1,1,1,1,0,0,0,0,0.4988662131519274,0.5011337868480725
94184,0.4672897196261683,0.574468085106383,114,-135,0.4477767267604901,0.5522232732395099,home,MIA,under,8,0.5238095238095238,-110,0.5011337868480725,MIA,MIL,2024 REG,12,5,11,7,12,23,0,1,-2,2,1,1,1,1,1,0,0,0,0,0.4988662131519274,0.5011337868480725
94185,0.5283018867924528,0.5145631067961165,-112,-106,0.5056562298022652,0.4943437701977348,away,CLE,over,8,0.5283018867924528,-112,0.5031902949311281,CIN,CLE,2024 REG,6,4,7,2,6,13,1,0,2,-2,1,1,0,0,0,0,0,0,0,0.5031902949311281,0.4968097050688719
94185,0.5283018867924528,0.5145631067961165,-112,-106,0.5056562298022652,0.4943437701977348,home,CIN,under,8,0.5192307692307692,-108,0.4968097050688719,CIN,CLE,2024 REG,6,4,7,2,6,13,1,0,2,-2,1,1,0,0,0,0,0,0,0,0.5031902949311281,0.4968097050688719
94186,0.5145631067961165,0.5283018867924528,-106,-112,0.4925063625223866,0.5074936374776133,away,CLE,over,7.5,0.5348837209302326,-115,0.5097020142727117,TB,CLE,2024 REG,8,2,10,4,6,18,0,1,-2,2,1,1,0,0,0,0,0,0,0,0.5097020142727117,0.49029798572728833
94186,0.5145631067961165,0.5283018867924528,-106,-112,0.4925063625223866,0.5074936374776133,home,TB,under,7.5,0.5121951219512195,-105,0.49029798572728833,TB,CLE,2024 REG,8,2,10,4,6,18,0,1,-2,2,1,1,0,0,0,0,0,0,0,0.5097020142727117,0.49029798572728833
94187,0.5215311004784688,0.5215311004784688,-109,-109,0.49907282342437215,0.5009271765756278,away,HOU,over,7,0.5391705069124424,-117,0.5127649394825569,SEA,HOU,2024 REG,4,2,7,1,3,11,1,0,1,-1,1,0,0,0,0,0,0,0,0,0.5127649394825569,0.48723506051744314
94187,0.5215311004784688,0.5215311004784688,-109,-109,0.49907282342437215,0.5009271765756278,home,SEA,under,7,0.5098039215686274,-104,0.48723506051744314,SEA,HOU,2024 REG,4,2,7,1,3,11,1,0,1,-1,1,0,0,0,0,0,0,0,0,0.5127649394825569,0.48723506051744314
94190,0.574468085106383,0.4672897196261683,-135,114,0.550479558983428,0.44952044101657196,away,PIT,over,9.5,0.5391705069124424,-117,0.5140669063204599,CIN,PIT,2024 REG,12,11,10,5,16,22,1,0,6,-6,1,1,1,1,1,0,0,0,0,0.5140669063204599,0.4859330936795401
94190,0.574468085106383,0.4672897196261683,-135,114,0.550479558983428,0.44952044101657196,home,CIN,under,9.5,0.5073891625615764,-103,0.4859330936795401,CIN,PIT,2024 REG,12,11,10,5,16,22,1,0,6,-6,1,1,1,1,1,0,0,0,0,0.5140669063204599,0.4859330936795401
94194,0.5515695067264574,0.48780487804878053,-123,105,0.5298517967383217,0.4701482032616783,away,TEX,over,6.5,0.5348837209302326,-115,0.5097020142727117,SEA,TEX,2024 REG,7,7,9,5,12,16,1,0,2,-2,1,1,1,1,1,0,0,0,0,0.5097020142727117,0.49029798572728833
94194,0.5515695067264574,0.48780487804878053,-123,105,0.5298517967383217,0.4701482032616783,home,SEA,under,6.5,0.5121951219512195,-105,0.49029798572728833,SEA,TEX,2024 REG,7,7,9,5,12,16,1,0,2,-2,1,1,1,1,1,0,0,0,0,0.5097020142727117,0.49029798572728833
94195,0.4329004329004329,0.607843137254902,131,-155,0.41526252374227923,0.5847374762577208,away,HOU,over,8.5,0.5121951219512195,-105,0.48808156828023186,OAK,HOU,2024 REG,6,3,4,1,4,10,1,0,2,-2,1,0,0,0,0,0,0,0,0,0.48808156828023186,0.5119184317197681
94195,0.4329004329004329,0.607843137254902,131,-155,0.41526252374227923,0.5847374762577208,home,OAK,under,8.5,0.5348837209302326,-115,0.5119184317197681,OAK,HOU,2024 REG,6,3,4,1,4,10,1,0,2,-2,1,0,0,0,0,0,0,0,0,0.48808156828023186,0.5119184317197681
94196,0.5983935742971888,0.4444444444444444,-149,125,0.5727595791465728,0.42724042085342717,away,TOR,over,8.5,0.5260663507109005,-111,0.5010269332605688,HOU,TOR,2024 REG,8,1,8,2,3,16,0,1,-1,1,1,0,0,0,0,0,0,0,0,0.5010269332605688,0.4989730667394312
94196,0.5983935742971888,0.4444444444444444,-149,125,0.5727595791465728,0.42724042085342717,home,HOU,under,8.5,0.5215311004784688,-109,0.4989730667394312,HOU,TOR,2024 REG,8,1,8,2,3,16,0,1,-1,1,1,0,0,0,0,0,0,0,0,0.5010269332605688,0.4989730667394312
94197,0.7142857142857143,0.32573289902280134,-250,207,0.6857009904939174,0.3142990095060826,away,WSH,over,7.5,0.5454545454545454,-120,0.5206611570247933,PHI,WSH,2024 REG,5,4,4,2,6,9,1,0,2,-2,1,1,0,0,0,0,0,0,0,0.5206611570247933,0.4793388429752067
94197,0.7142857142857143,0.32573289902280134,-250,207,0.6857009904939174,0.3142990095060826,home,PHI,under,7.5,0.5,100,0.4793388429752067,PHI,WSH,2024 REG,5,4,4,2,6,9,1,0,2,-2,1,1,0,0,0,0,0,0,0,0.5206611570247933,0.4793388429752067
94198,0.5850622406639003,0.45454545454545453,-141,120,0.5618892737571823,0.43811072624281766,away,WSH,over,7.5,0.5215311004784688,-109,0.4978845547971712,MIA,WSH,2024 REG,13,4,11,11,15,24,0,1,-7,7,1,1,1,1,0,0,0,0,0,0.4978845547971712,0.5021154452028288
94198,0.5850622406639003,0.45454545454545453,-141,120,0.5618892737571823,0.43811072624281766,home,MIA,under,7.5,0.5238095238095238,-110,0.5021154452028288,MIA,WSH,2024 REG,13,4,11,11,15,24,0,1,-7,7,1,1,1,1,0,0,0,0,0,0.4978845547971712,0.5021154452028288
94199,0.4347826086956522,0.607843137254902,130,-155,0.41624967567367205,0.583750324326328,away,CWS,over,7,0.5121951219512195,-105,0.48808156828023186,MIA,CWS,2024 REG,9,4,6,3,7,15,1,0,1,-1,1,1,1,0,0,0,0,0,0,0.48808156828023186,0.5119184317197681
94199,0.4347826086956522,0.607843137254902,130,-155,0.41624967567367205,0.583750324326328,home,MIA,under,7,0.5348837209302326,-115,0.5119184317197681,MIA,CWS,2024 REG,9,4,6,3,7,15,1,0,1,-1,1,1,1,0,0,0,0,0,0,0.48808156828023186,0.5119184317197681
94200,0.6491228070175439,0.3921568627450981,-185,155,0.6223272319084604,0.3776727680915396,away,COL,over,8.5,0.5238095238095238,-110,0.4988662131519274,CHC,COL,2024 REG,14,12,7,2,14,21,1,0,10,-10,1,1,0,0,0,0,0,0,0,0.4988662131519274,0.5011337868480725
94200,0.6491228070175439,0.3921568627450981,-185,155,0.6223272319084604,0.3776727680915396,home,CHC,under,8.5,0.5238095238095238,-110,0.5011337868480725,CHC,COL,2024 REG,14,12,7,2,14,21,1,0,10,-10,1,1,0,0,0,0,0,0,0,0.4988662131519274,0.5011337868480725
94201,0.504950495049505,0.5370370370370371,-102,-116,0.4837488699364985,0.5162511300635015,away,CHC,over,7,0.5238095238095238,-110,0.4988662131519274,SF,CHC,2024 REG,9,5,10,4,9,19,1,0,1,-1,1,1,1,1,0,0,0,0,0,0.4988662131519274,0.5011337868480725
94201,0.504950495049505,0.5370370370370371,-102,-116,0.4837488699364985,0.5162511300635015,home,SF,under,7,0.5238095238095238,-110,0.5011337868480725,SF,CHC,2024 REG,9,5,10,4,9,19,1,0,1,-1,1,1,1,1,0,0,0,0,0,0.4988662131519274,0.5011337868480725
94203,0.3846153846153846,0.6551724137931035,160,-190,0.3693123852275045,0.6306876147724956,away,KC,over,7,0.5348837209302326,-115,0.5097020142727117,OAK,KC,2024 REG,8,5,8,1,6,16,1,0,4,-4,1,0,0,0,0,0,0,0,0,0.5097020142727117,0.49029798572728833
94203,0.3846153846153846,0.6551724137931035,160,-190,0.3693123852275045,0.6306876147724956,home,OAK,under,7,0.5121951219512195,-105,0.49029798572728833,OAK,KC,2024 REG,8,5,8,1,6,16,1,0,4,-4,1,0,0,0,0,0,0,0,0,0.5097020142727117,0.49029798572728833
94204,0.6323529411764706,0.4081632653061224,-172,145,0.6067323988418897,0.3932676011581103,away,BOS,over,8,0.5348837209302326,-115,0.5097020142727117,BAL,BOS,2024 REG,8,3,11,8,11,19,0,1,-5,5,1,1,1,0,0,0,0,0,0,0.5097020142727117,0.49029798572728833
94204,0.6323529411764706,0.4081632653061224,-172,145,0.6067323988418897,0.3932676011581103,home,BAL,under,8,0.5121951219512195,-105,0.49029798572728833,BAL,BOS,2024 REG,8,3,11,8,11,19,0,1,-5,5,1,1,1,0,0,0,0,0,0,0.5097020142727117,0.49029798572728833
94208,0.5260663507109005,0.5169082125603864,-111,-107,0.5034588790373798,0.49654112096262015,away,PIT,over,7,0.5555555555555556,-125,0.5274416330521942,NYM,PIT,2024 REG,4,3,5,1,4,9,1,0,2,-2,1,0,0,0,0,0,0,0,0,0.5274416330521942,0.47255836694780584
94208,0.5260663507109005,0.5169082125603864,-111,-107,0.5034588790373798,0.49654112096262015,home,NYM,under,7,0.49504950495049505,102,0.47255836694780584,NYM,PIT,2024 REG,4,3,5,1,4,9,1,0,2,-2,1,0,0,0,0,0,0,0,0,0.5274416330521942,0.47255836694780584
94210,0.7395833333333334,0.30303030303030304,-284,230,0.7080669981060606,0.29193300189393945,away,CWS,over,7.5,0.5454545454545454,-120,0.5166307047184789,NYY,CWS,2024 REG,9,4,8,2,6,17,1,0,2,-2,1,1,0,0,0,0,0,0,0,0.5166307047184789,0.48336929528152106
94210,0.7395833333333334,0.30303030303030304,-284,230,0.7080669981060606,0.29193300189393945,home,NYY,under,7.5,0.5073891625615764,-103,0.48336929528152106,NYY,CWS,2024 REG,9,4,8,2,6,17,1,0,2,-2,1,1,0,0,0,0,0,0,0,0.5166307047184789,0.48336929528152106
94211,0.5454545454545454,0.5,-120,100,0.5206611570247933,0.4793388429752067,away,COL,over,7.5,0.5327102803738317,-114,0.508788710910954,OAK,COL,2024 REG,17,10,11,9,19,28,1,0,1,-1,1,1,1,1,1,1,1,1,1,0.508788710910954,0.491211289089046
94211,0.5454545454545454,0.5,-120,100,0.5206611570247933,0.4793388429752067,home,OAK,under,7.5,0.5121951219512195,-105,0.491211289089046,OAK,COL,2024 REG,17,10,11,9,19,28,1,0,1,-1,1,1,1,1,1,1,1,1,1,0.508788710910954,0.491211289089046
94212,0.3846153846153846,0.6551724137931035,160,-190,0.3693123852275045,0.6306876147724956,away,SEA,over,10.5,0.5098039215686274,-104,0.48592421718142587,COL,SEA,2024 REG,10,2,6,1,3,16,1,0,1,-1,1,0,0,0,0,0,0,0,0,0.48592421718142587,0.5140757828185741
94212,0.3846153846153846,0.6551724137931035,160,-190,0.3693123852275045,0.6306876147724956,home,COL,under,10.5,0.5370370370370371,-116,0.5140757828185741,COL,SEA,2024 REG,10,2,6,1,3,16,1,0,1,-1,1,0,0,0,0,0,0,0,0,0.48592421718142587,0.5140757828185741
94213,0.45454545454545453,0.5815899581589958,120,-139,0.43812026695252254,0.5618797330474774,away,PIT,over,8.5,0.5238095238095238,-110,0.4988662131519274,CWS,PIT,2024 REG,5,2,9,6,8,14,0,1,-4,4,1,1,0,0,0,0,0,0,0,0.4988662131519274,0.5011337868480725
94213,0.45454545454545453,0.5815899581589958,120,-139,0.43812026695252254,0.5618797330474774,home,CWS,under,8.5,0.5238095238095238,-110,0.5011337868480725,CWS,PIT,2024 REG,5,2,9,6,8,14,0,1,-4,4,1,1,0,0,0,0,0,0,0,0.4988662131519274,0.5011337868480725
94216,0.4504504504504505,0.5901639344262295,122,-144,0.43215568248798203,0.567844317512018,away,BOS,over,9,0.5454545454545454,-120,0.5206611570247933,CWS,BOS,2024 REG,7,4,8,6,10,15,0,1,-2,2,1,1,1,1,0,0,0,0,0,0.5206611570247933,0.4793388429752067
94216,0.4504504504504505,0.5901639344262295,122,-144,0.43215568248798203,0.567844317512018,home,CWS,under,9,0.5,100,0.4793388429752067,CWS,BOS,2024 REG,7,4,8,6,10,15,0,1,-2,2,1,1,1,1,0,0,0,0,0,0.5206611570247933,0.4793388429752067
94218,0.5652173913043479,0.47619047619047616,-130,110,0.5418129444594474,0.4581870555405526,away,MIN,over,8.5,0.5238095238095238,-110,0.4988662131519274,DET,MIN,2024 REG,8,4,6,3,7,14,1,0,1,-1,1,1,1,0,0,0,0,0,0,0.4988662131519274,0.5011337868480725
94218,0.5652173913043479,0.47619047619047616,-130,110,0.5418129444594474,0.4581870555405526,home,DET,under,8.5,0.5238095238095238,-110,0.5011337868480725,DET,MIN,2024 REG,8,4,6,3,7,14,1,0,1,-1,1,1,1,0,0,0,0,0,0,0.4988662131519274,0.5011337868480725
94219,0.45454545454545453,0.5850622406639003,120,-141,0.4365419567230205,0.5634580432769796,away,STL,over,7,0.5454545454545454,-120,0.5206611570247933,LAA,STL,2024 REG,12,6,12,7,13,24,0,1,-1,1,1,1,1,1,1,1,0,0,0,0.5206611570247933,0.4793388429752067
94219,0.45454545454545453,0.5850622406639003,120,-141,0.4365419567230205,0.5634580432769796,home,LAA,under,7,0.5,100,0.4793388429752067,LAA,STL,2024 REG,12,6,12,7,13,24,0,1,-1,1,1,1,1,1,1,1,0,0,0,0.5206611570247933,0.4793388429752067
94221,0.5348837209302326,0.5073891625615764,-115,-103,0.5122726437136835,0.48772735628631647,away,HOU,over,8,0.5121951219512195,-105,0.48808156828023186,SF,HOU,2024 REG,3,1,7,3,4,10,0,1,-2,2,1,0,0,0,0,0,0,0,0,0.48808156828023186,0.5119184317197681
94221,0.5348837209302326,0.5073891625615764,-115,-103,0.5122726437136835,0.48772735628631647,home,SF,under,8,0.5348837209302326,-115,0.5119184317197681,SF,HOU,2024 REG,3,1,7,3,4,10,0,1,-2,2,1,0,0,0,0,0,0,0,0,0.48808156828023186,0.5119184317197681
94223,0.5121951219512195,0.5305164319248826,-105,-113,0.4903184724049234,0.5096815275950766,away,SD,over,9.5,0.5073891625615764,-103,0.4826927225525911,CIN,SD,2024 REG,8,4,12,6,10,20,0,1,-2,2,1,1,1,1,0,0,0,0,0,0.4826927225525911,0.5173072774474089
94223,0.5121951219512195,0.5305164319248826,-105,-113,0.4903184724049234,0.5096815275950766,home,CIN,under,9.5,0.5412844036697247,-118,0.5173072774474089,CIN,SD,2024 REG,8,4,12,6,10,20,0,1,-2,2,1,1,1,1,0,0,0,0,0,0.4826927225525911,0.5173072774474089
94225,0.6923076923076923,0.3448275862068966,-225,190,0.6665986533360538,0.33340134666394616,away,COL,over,7.5,0.49504950495049505,102,0.47097973588023584,STL,COL,2024 REG,8,2,4,3,5,12,0,1,-1,1,1,1,0,0,0,0,0,0,0,0.47097973588023584,0.5290202641197641
94225,0.6923076923076923,0.3448275862068966,-225,190,0.6665986533360538,0.33340134666394616,home,STL,under,7.5,0.5535714285714286,-124,0.5290202641197641,STL,COL,2024 REG,8,2,4,3,5,12,0,1,-1,1,1,1,0,0,0,0,0,0,0,0.47097973588023584,0.5290202641197641
94227,0.5815899581589958,0.4587155963302753,-139,118,0.5581486524100054,0.44185134758999456,away,BOS,over,8.5,0.5073891625615764,-103,0.4826927225525911,TB,BOS,2024 REG,7,2,7,5,7,14,0,1,-3,3,1,1,0,0,0,0,0,0,0,0.4826927225525911,0.5173072774474089
94227,0.5815899581589958,0.4587155963302753,-139,118,0.5581486524100054,0.44185134758999456,home,TB,under,8.5,0.5412844036697247,-118,0.5173072774474089,TB,BOS,2024 REG,7,2,7,5,7,14,0,1,-3,3,1,1,0,0,0,0,0,0,0,0.4826927225525911,0.5173072774474089
94228,0.39525691699604737,0.6453900709219857,153,-182,0.37919091386639003,0.62080908613361,away,NYY,over,9,0.5238095238095238,-110,0.4988662131519274,BOS,NYY,2024 REG,12,8,6,4,12,18,1,0,4,-4,1,1,1,1,0,0,0,0,0,0.4988662131519274,0.5011337868480725
94228,0.39525691699604737,0.6453900709219857,153,-182,0.37919091386639003,0.62080908613361,home,BOS,under,9,0.5238095238095238,-110,0.5011337868480725,BOS,NYY,2024 REG,12,8,6,4,12,18,1,0,4,-4,1,1,1,1,0,0,0,0,0,0.4988662131519274,0.5011337868480725
94232,0.49504950495049505,0.5495495495495495,102,-122,0.47297076509898783,0.5270292349010122,away,SEA,over,9,0.5283018867924528,-112,0.5031902949311281,KC,SEA,2024 REG,10,10,10,9,19,20,1,0,1,-1,1,1,1,1,1,1,1,1,1,0.5031902949311281,0.4968097050688719
94232,0.49504950495049505,0.5495495495495495,102,-122,0.47297076509898783,0.5270292349010122,home,KC,under,9,0.5192307692307692,-108,0.4968097050688719,KC,SEA,2024 REG,10,10,10,9,19,20,1,0,1,-1,1,1,1,1,1,1,1,1,1,0.5031902949311281,0.4968097050688719
94233,0.5555555555555556,0.48780487804878053,-125,105,0.5314664257753688,0.46853357422463116,away,NYM,over,9,0.5192307692307692,-108,0.49455035168025013,CLE,NYM,2024 REG,4,3,6,1,4,10,1,0,2,-2,1,0,0,0,0,0,0,0,0,0.49455035168025013,0.5054496483197499
94233,0.5555555555555556,0.48780487804878053,-125,105,0.5314664257753688,0.46853357422463116,home,CLE,under,9,0.5283018867924528,-112,0.5054496483197499,CLE,NYM,2024 REG,4,3,6,1,4,10,1,0,2,-2,1,0,0,0,0,0,0,0,0,0.49455035168025013,0.5054496483197499
94234,0.4366812227074236,0.607843137254902,129,-155,0.41723827075880976,0.5827617292411902,away,BAL,over,8.5,0.5348837209302326,-115,0.5097020142727117,LAA,BAL,2024 REG,11,7,8,4,11,19,1,0,3,-3,1,1,1,1,0,0,0,0,0,0.5097020142727117,0.49029798572728833
94234,0.4366812227074236,0.607843137254902,129,-155,0.41723827075880976,0.5827617292411902,home,LAA,under,8.5,0.5121951219512195,-105,0.49029798572728833,LAA,BAL,2024 REG,11,7,8,4,11,19,1,0,3,-3,1,1,1,1,0,0,0,0,0,0.5097020142727117,0.49029798572728833
94235,0.574468085106383,0.46511627906976744,-135,115,0.5517281312179562,0.44827186878204384,away,LAD,over,9,0.5238095238095238,-110,0.4988662131519274,PHI,LAD,2024 REG,10,4,9,3,7,19,1,0,1,-1,1,1,1,0,0,0,0,0,0,0.4988662131519274,0.5011337868480725
94235,0.574468085106383,0.46511627906976744,-135,115,0.5517281312179562,0.44827186878204384,home,PHI,under,9,0.5238095238095238,-110,0.5011337868480725,PHI,LAD,2024 REG,10,4,9,3,7,19,1,0,1,-1,1,1,1,0,0,0,0,0,0,0.4988662131519274,0.5011337868480725
94237,0.6183206106870228,0.42372881355932196,-162,136,0.5923205850079852,0.40767941499201477,away,DET,over,9,0.5454545454545454,-120,0.5179608869977906,CIN,DET,2024 REG,6,3,7,5,8,13,0,1,-2,2,1,1,1,0,0,0,0,0,0,0.5179608869977906,0.48203911300220936
94237,0.6183206106870228,0.42372881355932196,-162,136,0.5923205850079852,0.40767941499201477,home,CIN,under,9,0.504950495049505,-102,0.48203911300220936,CIN,DET,2024 REG,6,3,7,5,8,13,0,1,-2,2,1,1,1,0,0,0,0,0,0,0.5179608869977906,0.48203911300220936
94238,0.5412844036697247,0.5,-118,100,0.5189377998484975,0.4810622001515025,away,SEA,over,8.5,0.5073891625615764,-103,0.4826927225525911,HOU,SEA,2024 REG,7,5,7,3,8,14,1,0,2,-2,1,1,1,0,0,0,0,0,0,0.4826927225525911,0.5173072774474089
94238,0.5412844036697247,0.5,-118,100,0.5189377998484975,0.4810622001515025,home,HOU,under,8.5,0.5412844036697247,-118,0.5173072774474089,HOU,SEA,2024 REG,7,5,7,3,8,14,1,0,2,-2,1,1,1,0,0,0,0,0,0,0.4826927225525911,0.5173072774474089
94239,0.5652173913043479,0.4716981132075471,-130,112,0.5443521061454507,0.4556478938545493,away,KC,over,7.5,0.5098039215686274,-104,0.48592421718142587,MIN,KC,2024 REG,8,1,10,6,7,18,0,1,-5,5,1,0,0,0,0,0,0,0,0,0.48592421718142587,0.5140757828185741
94239,0.5652173913043479,0.4716981132075471,-130,112,0.5443521061454507,0.4556478938545493,home,MIN,under,7.5,0.5370370370370371,-116,0.5140757828185741,MIN,KC,2024 REG,8,1,10,6,7,18,0,1,-5,5,1,0,0,0,0,0,0,0,0,0.48592421718142587,0.5140757828185741
94240,0.5348837209302326,0.5073891625615764,-115,-103,0.5122726437136835,0.48772735628631647,away,TB,over,8,0.5238095238095238,-110,0.4988662131519274,TOR,TB,2024 REG,7,5,4,2,7,11,1,0,3,-3,1,1,0,0,0,0,0,0,0,0.4988662131519274,0.5011337868480725
94240,0.5348837209302326,0.5073891625615764,-115,-103,0.5122726437136835,0.48772735628631647,home,TOR,under,8,0.5238095238095238,-110,0.5011337868480725,TOR,TB,2024 REG,7,5,4,2,7,11,1,0,3,-3,1,1,0,0,0,0,0,0,0,0.4988662131519274,0.5011337868480725
94241,0.4716981132075471,0.5689655172413793,112,-132,0.45251715544861953,0.5474828445513804,away,MIL,over,8.5,0.5454545454545454,-120,0.5166307047184789,LAA,MIL,2024 REG,6,5,5,3,8,11,1,0,2,-2,1,1,1,0,0,0,0,0,0,0.5166307047184789,0.48336929528152106
94241,0.4716981132075471,0.5689655172413793,112,-132,0.45251715544861953,0.5474828445513804,home,LAA,under,8.5,0.5073891625615764,-103,0.48336929528152106,LAA,MIL,2024 REG,6,5,5,3,8,11,1,0,2,-2,1,1,1,0,0,0,0,0,0,0.5166307047184789,0.48336929528152106
94244,0.4672897196261683,0.5689655172413793,114,-132,0.4503480201553517,0.5496519798446483,away,SEA,over,8.5,0.5348837209302326,-115,0.5097020142727117,KC,SEA,2024 REG,9,8,7,4,12,16,1,0,4,-4,1,1,1,1,0,0,0,0,0,0.5097020142727117,0.49029798572728833
94244,0.4672897196261683,0.5689655172413793,114,-132,0.4503480201553517,0.5496519798446483,home,KC,under,8.5,0.5121951219512195,-105,0.49029798572728833,KC,SEA,2024 REG,9,8,7,4,12,16,1,0,4,-4,1,1,1,1,0,0,0,0,0,0.5097020142727117,0.49029798572728833
94245,0.635036496350365,0.4081632653061224,-174,145,0.6076030710648583,0.39239692893514166,away,WSH,over,7,0.5475113122171946,-121,0.5228602997583487,PHI,WSH,2024 REG,7,4,11,3,7,18,1,0,1,-1,1,1,1,0,0,0,0,0,0,0.5228602997583487,0.4771397002416513
94245,0.635036496350365,0.4081632653061224,-174,145,0.6076030710648583,0.39239692893514166,home,PHI,under,7,0.49751243781094534,101,0.4771397002416513,PHI,WSH,2024 REG,7,4,11,3,7,18,1,0,1,-1,1,1,1,0,0,0,0,0,0,0.5228602997583487,0.4771397002416513
94248,0.6666666666666666,0.37593984962406013,-200,166,0.6382623224728488,0.36173767752715125,away,NYM,over,8.5,0.5098039215686274,-104,0.48592421718142587,LAD,NYM,2024 REG,6,4,14,9,13,20,0,1,-5,5,1,1,1,1,0,0,0,0,0,0.48592421718142587,0.5140757828185741
94248,0.6666666666666666,0.37593984962406013,-200,166,0.6382623224728488,0.36173767752715125,home,LAD,under,8.5,0.5370370370370371,-116,0.5140757828185741,LAD,NYM,2024 REG,6,4,14,9,13,20,0,1,-5,5,1,1,1,1,0,0,0,0,0,0.48592421718142587,0.5140757828185741
94249,0.5884773662551441,0.45248868778280543,-143,121,0.5643697706690257,0.4356302293309743,away,LAA,over,9,0.5098039215686274,-104,0.48592421718142587,MIA,LAA,2024 REG,5,1,7,3,4,12,0,1,-2,2,1,0,0,0,0,0,0,0,0,0.48592421718142587,0.5140757828185741
94249,0.5884773662551441,0.45248868778280543,-143,121,0.5643697706690257,0.4356302293309743,home,MIA,under,9,0.5370370370370371,-116,0.5140757828185741,MIA,LAA,2024 REG,5,1,7,3,4,12,0,1,-2,2,1,0,0,0,0,0,0,0,0,0.48592421718142587,0.5140757828185741
94250,0.46511627906976744,0.574468085106383,115,-135,0.44670494689481377,0.5532950531051862,away,ATL,over,9.5,0.5,100,0.4772727272727273,HOU,ATL,2024 REG,9,4,7,5,9,16,0,1,-1,1,1,1,1,1,0,0,0,0,0,0.4772727272727273,0.5227272727272727
94250,0.46511627906976744,0.574468085106383,115,-135,0.44670494689481377,0.5532950531051862,home,HOU,under,9.5,0.5454545454545454,-120,0.5227272727272727,HOU,ATL,2024 REG,9,4,7,5,9,16,0,1,-1,1,1,1,1,1,0,0,0,0,0,0.4772727272727273,0.5227272727272727
94252,0.5535714285714286,0.48780487804878053,-124,105,0.53066668740667,0.46933331259333,away,BAL,over,8,0.5145631067961165,-106,0.49023796582517226,STL,BAL,2024 REG,8,6,3,3,9,11,1,0,3,-3,1,1,1,0,0,0,0,0,0,0.49023796582517226,0.5097620341748277
94252,0.5535714285714286,0.48780487804878053,-124,105,0.53066668740667,0.46933331259333,home,STL,under,8,0.5327102803738317,-114,0.5097620341748277,STL,BAL,2024 REG,8,6,3,3,9,11,1,0,3,-3,1,1,1,0,0,0,0,0,0,0.49023796582517226,0.5097620341748277
94254,0.5708154506437768,0.4672897196261683,-133,114,0.5490644307042802,0.45093556929571976,away,TB,over,7.5,0.5348837209302326,-115,0.5097020142727117,TEX,TB,2024 REG,19,13,5,2,15,24,1,0,11,-11,1,1,0,0,0,0,0,0,0,0.5097020142727117,0.49029798572728833
94254,0.5708154506437768,0.4672897196261683,-133,114,0.5490644307042802,0.45093556929571976,home,TEX,under,7.5,0.5121951219512195,-105,0.49029798572728833,TEX,TB,2024 REG,19,13,5,2,15,24,1,0,11,-11,1,1,0,0,0,0,0,0,0,0.5097020142727117,0.49029798572728833
94256,0.574468085106383,0.46511627906976744,-135,115,0.5517281312179562,0.44827186878204384,away,ARI,over,8,0.5348837209302326,-115,0.5097020142727117,SF,ARI,2024 REG,5,3,6,5,8,11,0,1,-2,2,1,1,1,0,0,0,0,0,0,0.5097020142727117,0.49029798572728833
94256,0.574468085106383,0.46511627906976744,-135,115,0.5517281312179562,0.44827186878204384,home,SF,under,8,0.5121951219512195,-105,0.49029798572728833,SF,ARI,2024 REG,5,3,6,5,8,11,0,1,-2,2,1,1,1,0,0,0,0,0,0,0.5097020142727117,0.49029798572728833
94257,0.7142857142857143,0.33112582781456956,-250,202,0.6818488984997972,0.31815110150020276,away,ARI,over,9,0.5348837209302326,-115,0.5097020142727117,ATL,ARI,2024 REG,7,5,5,2,7,12,1,0,3,-3,1,1,0,0,0,0,0,0,0,0.5097020142727117,0.49029798572728833
94257,0.7142857142857143,0.33112582781456956,-250,202,0.6818488984997972,0.31815110150020276,home,ATL,under,9,0.5121951219512195,-105,0.49029798572728833,ATL,ARI,2024 REG,7,5,5,2,7,12,1,0,3,-3,1,1,0,0,0,0,0,0,0,0.5097020142727117,0.49029798572728833
94260,0.48780487804878053,0.5555555555555556,105,-125,0.4666534470222751,0.5333465529777248,away,NYM,over,7.5,0.5121951219512195,-105,0.48808156828023186,MIA,NYM,2024 REG,13,8,6,0,8,19,1,0,8,-8,0,0,0,0,0,0,0,0,0,0.48808156828023186,0.5119184317197681
94260,0.48780487804878053,0.5555555555555556,105,-125,0.4666534470222751,0.5333465529777248,home,MIA,under,7.5,0.5348837209302326,-115,0.5119184317197681,MIA,NYM,2024 REG,13,8,6,0,8,19,1,0,8,-8,0,0,0,0,0,0,0,0,0,0.48808156828023186,0.5119184317197681
94262,0.5535714285714286,0.48780487804878053,-124,105,0.53066668740667,0.46933331259333,away,MIA,over,8.5,0.5121951219512195,-105,0.48808156828023186,WSH,MIA,2024 REG,9,3,8,1,4,17,1,0,2,-2,1,0,0,0,0,0,0,0,0,0.48808156828023186,0.5119184317197681
94262,0.5535714285714286,0.48780487804878053,-124,105,0.53066668740667,0.46933331259333,home,WSH,under,8.5,0.5348837209302326,-115,0.5119184317197681,WSH,MIA,2024 REG,9,3,8,1,4,17,1,0,2,-2,1,0,0,0,0,0,0,0,0,0.48808156828023186,0.5119184317197681
94263,0.36363636363636365,0.6774193548387096,175,-210,0.3487070114636097,0.6512929885363903,away,PHI,over,7,0.5238095238095238,-110,0.4988662131519274,MIA,PHI,2024 REG,8,7,6,6,13,14,1,0,1,-1,1,1,1,1,1,1,0,0,0,0.4988662131519274,0.5011337868480725
94263,0.36363636363636365,0.6774193548387096,175,-210,0.3487070114636097,0.6512929885363903,home,MIA,under,7,0.5238095238095238,-110,0.5011337868480725,MIA,PHI,2024 REG,8,7,6,6,13,14,1,0,1,-1,1,1,1,1,1,1,0,0,0,0.4988662131519274,0.5011337868480725
94264,0.5555555555555556,0.48780487804878053,-125,105,0.5314664257753688,0.46853357422463116,away,TEX,over,9,0.5348837209302326,-115,0.5097020142727117,HOU,TEX,2024 REG,11,8,12,12,20,23,0,1,-4,4,1,1,1,1,1,1,1,1,0,0.5097020142727117,0.49029798572728833
94264,0.5555555555555556,0.48780487804878053,-125,105,0.5314664257753688,0.46853357422463116,home,HOU,under,9,0.5121951219512195,-105,0.49029798572728833,HOU,TEX,2024 REG,11,8,12,12,20,23,0,1,-4,4,1,1,1,1,1,1,1,1,0,0.5097020142727117,0.49029798572728833
94266,0.5348837209302326,0.5121951219512195,-115,-105,0.5097020142727117,0.49029798572728833,away,MIN,over,7.5,0.5121951219512195,-105,0.48697865027430753,CLE,MIN,2024 REG,4,5,4,2,7,8,1,0,3,-3,1,1,0,0,0,0,0,0,0,0.48697865027430753,0.5130213497256925
94266,0.5348837209302326,0.5121951219512195,-115,-105,0.5097020142727117,0.49029798572728833,home,CLE,under,7.5,0.5370370370370371,-116,0.5130213497256925,CLE,MIN,2024 REG,4,5,4,2,7,8,1,0,3,-3,1,1,0,0,0,0,0,0,0,0.48697865027430753,0.5130213497256925
94267,0.5555555555555556,0.48780487804878053,-125,105,0.5314664257753688,0.46853357422463116,away,CHC,over,8.5,0.5,100,0.4772727272727273,MIL,CHC,2024 REG,9,6,9,4,10,18,1,0,2,-2,1,1,1,1,0,0,0,0,0,0.4772727272727273,0.5227272727272727
94267,0.5555555555555556,0.48780487804878053,-125,105,0.5314664257753688,0.46853357422463116,home,MIL,under,8.5,0.5454545454545454,-120,0.5227272727272727,MIL,CHC,2024 REG,9,6,9,4,10,18,1,0,2,-2,1,1,1,1,0,0,0,0,0,0.4772727272727273,0.5227272727272727
94268,0.6062992125984252,0.4347826086956522,-154,130,0.581391336695717,0.41860866330428304,away,STL,over,9,0.5412844036697247,-118,0.5162581740877563,MIL,STL,2024 REG,7,3,11,4,7,18,0,1,-1,1,1,1,1,0,0,0,0,0,0,0.5162581740877563,0.4837418259122437
94268,0.6062992125984252,0.4347826086956522,-154,130,0.581391336695717,0.41860866330428304,home,MIL,under,9,0.504950495049505,-102,0.4837418259122437,MIL,STL,2024 REG,7,3,11,4,7,18,0,1,-1,1,1,1,1,0,0,0,0,0,0,0.5162581740877563,0.4837418259122437
94269,0.4464285714285714,0.5934959349593496,124,-146,0.42860513107682097,0.571394868923179,away,HOU,over,7.5,0.5,100,0.4772727272727273,CHC,HOU,2024 REG,7,3,4,1,4,11,1,0,2,-2,1,0,0,0,0,0,0,0,0,0.4772727272727273,0.5227272727272727
94269,0.4464285714285714,0.5934959349593496,124,-146,0.42860513107682097,0.571394868923179,home,CHC,under,7.5,0.5454545454545454,-120,0.5227272727272727,CHC,HOU,2024 REG,7,3,4,1,4,11,1,0,2,-2,1,0,0,0,0,0,0,0,0,0.4772727272727273,0.5227272727272727
94270,0.6226415094339623,0.4166666666666667,-165,140,0.5981666073335706,0.40183339266642937,away,CWS,over,8.5,0.5121951219512195,-105,0.48808156828023186,TB,CWS,2024 REG,13,8,4,2,10,17,1,0,6,-6,1,1,0,0,0,0,0,0,0,0.48808156828023186,0.5119184317197681
94270,0.6226415094339623,0.4166666666666667,-165,140,0.5981666073335706,0.40183339266642937,home,TB,under,8.5,0.5348837209302326,-115,0.5119184317197681,TB,CWS,2024 REG,13,8,4,2,10,17,1,0,6,-6,1,1,0,0,0,0,0,0,0,0.48808156828023186,0.5119184317197681
94271,0.7142857142857143,0.33112582781456956,-250,202,0.6818488984997972,0.31815110150020276,away,CWS,over,8.5,0.5098039215686274,-104,0.48375889301574193,CLE,CWS,2024 REG,10,4,4,0,4,14,1,0,4,-4,0,0,0,0,0,0,0,0,0,0.48375889301574193,0.5162411069842581
94271,0.7142857142857143,0.33112582781456956,-250,202,0.6818488984997972,0.31815110150020276,home,CLE,under,8.5,0.5412844036697247,-118,0.5162411069842581,CLE,CWS,2024 REG,10,4,4,0,4,14,1,0,4,-4,0,0,0,0,0,0,0,0,0,0.48375889301574193,0.5162411069842581
94272,0.4672897196261683,0.574468085106383,114,-135,0.4477767267604901,0.5522232732395099,away,WSH,over,10.5,0.5348837209302326,-115,0.5097020142727117,COL,WSH,2024 REG,5,1,4,2,3,9,0,1,-1,1,1,0,0,0,0,0,0,0,0,0.5097020142727117,0.49029798572728833
94272,0.4672897196261683,0.574468085106383,114,-135,0.4477767267604901,0.5522232732395099,home,COL,under,10.5,0.5121951219512195,-105,0.49029798572728833,COL,WSH,2024 REG,5,1,4,2,3,9,0,1,-1,1,1,0,0,0,0,0,0,0,0,0.5097020142727117,0.49029798572728833
94273,0.4629629629629629,0.576271186440678,116,-136,0.4447990049057217,0.5552009950942782,away,MIL,over,10.5,0.5454545454545454,-120,0.5206611570247933,COL,MIL,2024 REG,8,4,8,3,7,16,1,0,1,-1,1,1,1,0,0,0,0,0,0,0.5206611570247933,0.4793388429752067
94273,0.4629629629629629,0.576271186440678,116,-136,0.4447990049057217,0.5552009950942782,home,COL,under,10.5,0.5,100,0.4793388429752067,COL,MIL,2024 REG,8,4,8,3,7,16,1,0,1,-1,1,1,1,0,0,0,0,0,0,0.5206611570247933,0.4793388429752067
94274,0.6551724137931035,0.3861003861003861,-190,159,0.6281316138628862,0.3718683861371138,away,BOS,over,8.5,0.5391705069124424,-117,0.5127649394825569,ATL,BOS,2024 REG,7,4,8,2,6,15,1,0,2,-2,1,1,0,0,0,0,0,0,0,0.5127649394825569,0.48723506051744314
94274,0.6551724137931035,0.3861003861003861,-190,159,0.6281316138628862,0.3718683861371138,home,ATL,under,8.5,0.5098039215686274,-104,0.48723506051744314,ATL,BOS,2024 REG,7,4,8,2,6,15,1,0,2,-2,1,1,0,0,0,0,0,0,0,0.5127649394825569,0.48723506051744314
94276,0.47846889952153115,0.5614035087719298,109,-128,0.45939119220408575,0.5406088077959142,away,SEA,over,7.5,0.5121951219512195,-105,0.48808156828023186,TB,SEA,2024 REG,11,11,6,3,14,17,1,0,8,-8,1,1,1,0,0,0,0,0,0,0.48808156828023186,0.5119184317197681
94276,0.47846889952153115,0.5614035087719298,109,-128,0.45939119220408575,0.5406088077959142,home,TB,under,7.5,0.5348837209302326,-115,0.5119184317197681,TB,SEA,2024 REG,11,11,6,3,14,17,1,0,8,-8,1,1,1,0,0,0,0,0,0,0.48808156828023186,0.5119184317197681
94278,0.6124031007751938,0.425531914893617,-158,135,0.5891715795516586,0.41082842044834145,away,CLE,over,9,0.5412844036697247,-118,0.5136310900085983,ATL,CLE,2024 REG,9,4,10,3,7,19,1,0,1,-1,1,1,1,0,0,0,0,0,0,0.5136310900085983,0.4863689099914017
94278,0.6124031007751938,0.425531914893617,-158,135,0.5891715795516586,0.41082842044834145,home,ATL,under,9,0.5098039215686274,-104,0.4863689099914017,ATL,CLE,2024 REG,9,4,10,3,7,19,1,0,1,-1,1,1,1,0,0,0,0,0,0,0.5136310900085983,0.4863689099914017
94279,0.5348837209302326,0.5121951219512195,-115,-105,0.5097020142727117,0.49029798572728833,away,TB,over,8,0.5238095238095238,-110,0.4988662131519274,MIL,TB,2024 REG,3,0,6,1,1,9,0,1,-1,1,0,0,0,0,0,0,0,0,0,0.4988662131519274,0.5011337868480725
94279,0.5348837209302326,0.5121951219512195,-115,-105,0.5097020142727117,0.49029798572728833,home,MIL,under,8,0.5238095238095238,-110,0.5011337868480725,MIL,TB,2024 REG,3,0,6,1,1,9,0,1,-1,1,0,0,0,0,0,0,0,0,0,0.4988662131519274,0.5011337868480725
94281,0.5918367346938775,0.4484304932735426,-145,123,0.5680051099784656,0.43199489002153435,away,PHI,over,8,0.5238095238095238,-110,0.5000596729920038,SD,PHI,2024 REG,9,6,12,8,14,21,0,1,-2,2,1,1,1,1,1,1,0,0,0,0.5000596729920038,0.4999403270079962
94281,0.5918367346938775,0.4484304932735426,-145,123,0.5680051099784656,0.43199489002153435,home,SD,under,8,0.5215311004784688,-109,0.4999403270079962,SD,PHI,2024 REG,9,6,12,8,14,21,0,1,-2,2,1,1,1,1,1,1,0,0,0,0.5000596729920038,0.4999403270079962
94282,0.4,0.6389891696750902,150,-177,0.3844043321299639,0.6155956678700361,away,CLE,over,8,0.5238095238095238,-110,0.4988662131519274,CWS,CLE,2024 REG,7,3,4,1,4,11,1,0,2,-2,1,0,0,0,0,0,0,0,0,0.4988662131519274,0.5011337868480725
94282,0.4,0.6389891696750902,150,-177,0.3844043321299639,0.6155956678700361,home,CWS,under,8,0.5238095238095238,-110,0.5011337868480725,CWS,CLE,2024 REG,7,3,4,1,4,11,1,0,2,-2,1,0,0,0,0,0,0,0,0,0.4988662131519274,0.5011337868480725
94284,0.425531914893617,0.6168582375478928,135,-161,0.407493552152549,0.592506447847451,away,SEA,over,7.5,0.5475113122171946,-121,0.5214983313199976,OAK,SEA,2024 REG,8,3,10,4,7,18,0,1,-1,1,1,1,1,0,0,0,0,0,0,0.5214983313199976,0.47850166868000243
94284,0.425531914893617,0.6168582375478928,135,-161,0.407493552152549,0.592506447847451,home,OAK,under,7.5,0.5,100,0.47850166868000243,OAK,SEA,2024 REG,8,3,10,4,7,18,0,1,-1,1,1,1,1,0,0,0,0,0,0,0.5214983313199976,0.47850166868000243
94286,0.613899613899614,0.4273504273504274,-159,134,0.5885762295028705,0.4114237704971295,away,STL,over,8.5,0.5192307692307692,-108,0.49455035168025013,SD,STL,2024 REG,7,3,6,2,5,13,1,0,1,-1,1,1,0,0,0,0,0,0,0,0.49455035168025013,0.5054496483197499
94286,0.613899613899614,0.4273504273504274,-159,134,0.5885762295028705,0.4114237704971295,home,SD,under,8.5,0.5283018867924528,-112,0.5054496483197499,SD,STL,2024 REG,7,3,6,2,5,13,1,0,1,-1,1,1,0,0,0,0,0,0,0,0.49455035168025013,0.5054496483197499
94288,0.5555555555555556,0.48780487804878053,-125,105,0.5314664257753688,0.46853357422463116,away,NYM,over,9.5,0.5098039215686274,-104,0.48483656587239576,CIN,NYM,2024 REG,8,9,11,6,15,19,1,0,3,-3,1,1,1,1,1,1,0,0,0,0.48483656587239576,0.5151634341276042
94288,0.5555555555555556,0.48780487804878053,-125,105,0.5314664257753688,0.46853357422463116,home,CIN,under,9.5,0.5391705069124424,-117,0.5151634341276042,CIN,NYM,2024 REG,8,9,11,6,15,19,1,0,3,-3,1,1,1,1,1,1,0,0,0,0.48483656587239576,0.5151634341276042
94289,0.5833333333333333,0.4608294930875576,-140,117,0.5575716845878136,0.4424283154121864,away,PHI,over,7.5,0.5,100,0.4772727272727273,ATL,PHI,2024 REG,8,6,15,8,14,23,0,1,-2,2,1,1,1,1,1,1,0,0,0,0.4772727272727273,0.5227272727272727
94289,0.5833333333333333,0.4608294930875576,-140,117,0.5575716845878136,0.4424283154121864,home,ATL,under,7.5,0.5454545454545454,-120,0.5227272727272727,ATL,PHI,2024 REG,8,6,15,8,14,23,0,1,-2,2,1,1,1,1,1,1,0,0,0,0.4772727272727273,0.5227272727272727
94290,0.5391705069124424,0.5024875621890548,-117,-101,0.5167097046779946,0.4832902953220054,away,TEX,over,8,0.5238095238095238,-110,0.4988662131519274,MIA,TEX,2024 REG,7,0,13,7,7,20,0,1,-7,7,0,0,0,0,0,0,0,0,0,0.4988662131519274,0.5011337868480725
94290,0.5391705069124424,0.5024875621890548,-117,-101,0.5167097046779946,0.4832902953220054,home,MIA,under,8,0.5238095238095238,-110,0.5011337868480725,MIA,TEX,2024 REG,7,0,13,7,7,20,0,1,-7,7,0,0,0,0,0,0,0,0,0,0.4988662131519274,0.5011337868480725
94291,0.47619047619047616,0.5652173913043479,110,-130,0.4564724440500838,0.5435275559499162,away,MIN,over,9,0.5348837209302326,-115,0.5097020142727117,PIT,MIN,2024 REG,10,4,6,0,4,16,1,0,4,-4,0,0,0,0,0,0,0,0,0,0.5097020142727117,0.49029798572728833
94291,0.47619047619047616,0.5652173913043479,110,-130,0.4564724440500838,0.5435275559499162,home,PIT,under,9,0.5121951219512195,-105,0.49029798572728833,PIT,MIN,2024 REG,10,4,6,0,4,16,1,0,4,-4,0,0,0,0,0,0,0,0,0,0.5097020142727117,0.49029798572728833
94293,0.4,0.6415770609318996,150,-179,0.38336917562724016,0.6166308243727598,away,ATL,over,9,0.5348837209302326,-115,0.5097020142727117,PIT,ATL,2024 REG,14,11,7,5,16,21,1,0,6,-6,1,1,1,1,1,0,0,0,0,0.5097020142727117,0.49029798572728833
94293,0.4,0.6415770609318996,150,-179,0.38336917562724016,0.6166308243727598,home,PIT,under,9,0.5121951219512195,-105,0.49029798572728833,PIT,ATL,2024 REG,14,11,7,5,16,21,1,0,6,-6,1,1,1,1,1,0,0,0,0,0.5097020142727117,0.49029798572728833
94296,0.46511627906976744,0.574468085106383,115,-135,0.44670494689481377,0.5532950531051862,away,KC,over,7.5,0.5121951219512195,-105,0.48808156828023186,MIN,KC,2024 REG,11,4,5,2,6,16,1,0,2,-2,1,1,0,0,0,0,0,0,0,0.48808156828023186,0.5119184317197681
94296,0.46511627906976744,0.574468085106383,115,-135,0.44670494689481377,0.5532950531051862,home,MIN,under,7.5,0.5348837209302326,-115,0.5119184317197681,MIN,KC,2024 REG,11,4,5,2,6,16,1,0,2,-2,1,1,0,0,0,0,0,0,0,0.48808156828023186,0.5119184317197681
94297,0.4484304932735426,0.5918367346938775,123,-145,0.43037344037335423,0.5696265596266458,away,CLE,over,7.5,0.5283018867924528,-112,0.5044173060022736,DET,CLE,2024 REG,7,5,7,4,9,14,1,0,1,-1,1,1,1,1,0,0,0,0,0,0.5044173060022736,0.49558269399772636
94297,0.4484304932735426,0.5918367346938775,123,-145,0.43037344037335423,0.5696265596266458,home,DET,under,7.5,0.5169082125603864,-107,0.49558269399772636,DET,CLE,2024 REG,7,5,7,4,9,14,1,0,1,-1,1,1,1,1,0,0,0,0,0,0.5044173060022736,0.49558269399772636
94298,0.5238095238095238,0.5238095238095238,-110,-110,0.4988662131519274,0.5011337868480725,away,NYY,over,8,0.5283018867924528,-112,0.5031902949311281,TB,NYY,2024 REG,8,7,5,2,9,13,1,0,5,-5,1,1,0,0,0,0,0,0,0,0.5031902949311281,0.4968097050688719
94298,0.5238095238095238,0.5238095238095238,-110,-110,0.4988662131519274,0.5011337868480725,home,TB,under,8,0.5192307692307692,-108,0.4968097050688719,TB,NYY,2024 REG,8,7,5,2,9,13,1,0,5,-5,1,1,0,0,0,0,0,0,0,0.5031902949311281,0.4968097050688719
94299,0.6491228070175439,0.39370078740157477,-185,154,0.6213250352016247,0.37867496479837526,away,COL,over,8,0.5348837209302326,-115,0.5097020142727117,PIT,COL,2024 REG,4,2,12,3,5,16,0,1,-1,1,1,1,0,0,0,0,0,0,0,0.5097020142727117,0.49029798572728833
94299,0.6491228070175439,0.39370078740157477,-185,154,0.6213250352016247,0.37867496479837526,home,PIT,under,8,0.5121951219512195,-105,0.49029798572728833,PIT,COL,2024 REG,4,2,12,3,5,16,0,1,-1,1,1,1,0,0,0,0,0,0,0,0.5097020142727117,0.49029798572728833
94300,0.5815899581589958,0.4587155963302753,-139,118,0.5581486524100054,0.44185134758999456,away,STL,over,9.5,0.5238095238095238,-110,0.5000596729920038,PHI,STL,2024 REG,7,4,9,5,9,16,0,1,-1,1,1,1,1,1,0,0,0,0,0,0.5000596729920038,0.4999403270079962
94300,0.5815899581589958,0.4587155963302753,-139,118,0.5581486524100054,0.44185134758999456,home,PHI,under,9.5,0.5215311004784688,-109,0.4999403270079962,PHI,STL,2024 REG,7,4,9,5,9,16,0,1,-1,1,1,1,1,1,0,0,0,0,0,0.5000596729920038,0.4999403270079962
94302,0.607843137254902,0.4347826086956522,-155,130,0.5819333701084867,0.41806662989151333,away,BOS,over,7.5,0.5,100,0.4772727272727273,SEA,BOS,2024 REG,7,4,7,3,7,14,1,0,1,-1,1,1,1,0,0,0,0,0,0,0.4772727272727273,0.5227272727272727
94302,0.607843137254902,0.4347826086956522,-155,130,0.5819333701084867,0.41806662989151333,home,SEA,under,7.5,0.5454545454545454,-120,0.5227272727272727,SEA,BOS,2024 REG,7,4,7,3,7,14,1,0,1,-1,1,1,1,0,0,0,0,0,0,0.4772727272727273,0.5227272727272727
94303,0.425531914893617,0.6153846153846154,135,-160,0.4081206254135181,0.5918793745864819,away,BOS,over,8.5,0.5238095238095238,-110,0.4988662131519274,OAK,BOS,2024 REG,4,0,9,9,9,13,0,1,-9,9,0,0,0,0,0,0,0,0,0,0.4988662131519274,0.5011337868480725
94303,0.425531914893617,0.6153846153846154,135,-160,0.4081206254135181,0.5918793745864819,home,OAK,under,8.5,0.5238095238095238,-110,0.5011337868480725,OAK,BOS,2024 REG,4,0,9,9,9,13,0,1,-9,9,0,0,0,0,0,0,0,0,0,0.4988662131519274,0.5011337868480725
94304,0.5798319327731092,0.4608294930875576,-138,117,0.5562551396270082,0.44374486037299177,away,CLE,over,9,0.5348837209302326,-115,0.5097020142727117,HOU,CLE,2024 REG,10,8,7,2,10,17,1,0,6,-6,1,1,0,0,0,0,0,0,0,0.5097020142727117,0.49029798572728833
94304,0.5798319327731092,0.4608294930875576,-138,117,0.5562551396270082,0.44374486037299177,home,HOU,under,9,0.5121951219512195,-105,0.49029798572728833,HOU,CLE,2024 REG,10,8,7,2,10,17,1,0,6,-6,1,1,0,0,0,0,0,0,0,0.5097020142727117,0.49029798572728833
94306,0.5145631067961165,0.5260663507109005,-106,-111,0.49365668691386505,0.506343313086135,away,NYY,over,8,0.5121951219512195,-105,0.48808156828023186,TOR,NYY,2024 REG,4,1,12,8,9,16,0,1,-7,7,1,0,0,0,0,0,0,0,0,0.48808156828023186,0.5119184317197681
94306,0.5145631067961165,0.5260663507109005,-106,-111,0.49365668691386505,0.506343313086135,home,TOR,under,8,0.5348837209302326,-115,0.5119184317197681,TOR,NYY,2024 REG,4,1,12,8,9,16,0,1,-7,7,1,0,0,0,0,0,0,0,0,0.48808156828023186,0.5119184317197681
94307,0.5833333333333333,0.4566210045662101,-140,119,0.5600266362252664,0.4399733637747336,away,ARI,over,6.5,0.5433789954337899,-119,0.5184560714286826,SEA,ARI,2024 REG,5,2,6,3,5,11,0,1,-1,1,1,1,0,0,0,0,0,0,0,0.5184560714286826,0.48154392857131745
94307,0.5833333333333333,0.4566210045662101,-140,119,0.5600266362252664,0.4399733637747336,home,SEA,under,6.5,0.5024875621890548,-101,0.48154392857131745,SEA,ARI,2024 REG,5,2,6,3,5,11,0,1,-1,1,1,1,0,0,0,0,0,0,0,0.5184560714286826,0.48154392857131745
94309,0.5073891625615764,0.5348837209302326,-103,-115,0.4859403596076043,0.5140596403923957,away,BAL,over,7.5,0.5260663507109005,-111,0.5010269332605688,TOR,BAL,2024 REG,8,2,10,7,9,18,0,1,-5,5,1,1,0,0,0,0,0,0,0,0.5010269332605688,0.4989730667394312
94309,0.5073891625615764,0.5348837209302326,-103,-115,0.4859403596076043,0.5140596403923957,home,TOR,under,7.5,0.5215311004784688,-109,0.4989730667394312,TOR,BAL,2024 REG,8,2,10,7,9,18,0,1,-5,5,1,1,0,0,0,0,0,0,0,0.5010269332605688,0.4989730667394312
94310,0.49504950495049505,0.5475113122171946,102,-121,0.4739797934813417,0.5260202065186583,away,DET,over,8,0.5121951219512195,-105,0.48808156828023186,LAA,DET,2024 REG,9,6,7,5,11,16,1,0,1,-1,1,1,1,1,1,0,0,0,0,0.48808156828023186,0.5119184317197681
94310,0.49504950495049505,0.5475113122171946,102,-121,0.4739797934813417,0.5260202065186583,home,LAA,under,8,0.5348837209302326,-115,0.5119184317197681,LAA,DET,2024 REG,9,6,7,5,11,16,1,0,1,-1,1,1,1,1,1,0,0,0,0,0.48808156828023186,0.5119184317197681
94313,0.5867768595041323,0.45454545454545453,-142,120,0.5625298818386723,0.43747011816132775,away,MIL,over,8.5,0.5121951219512195,-105,0.48808156828023186,BOS,MIL,2024 REG,9,2,8,1,3,17,1,0,1,-1,1,0,0,0,0,0,0,0,0,0.48808156828023186,0.5119184317197681
94313,0.5867768595041323,0.45454545454545453,-142,120,0.5625298818386723,0.43747011816132775,home,BOS,under,8.5,0.5348837209302326,-115,0.5119184317197681,BOS,MIL,2024 REG,9,2,8,1,3,17,1,0,1,-1,1,0,0,0,0,0,0,0,0,0.48808156828023186,0.5119184317197681
94318,0.45454545454545453,0.5833333333333333,120,-140,0.43732782369146006,0.5626721763085399,away,NYM,over,9,0.5454545454545454,-120,0.5179608869977906,WSH,NYM,2024 REG,6,3,13,6,9,19,0,1,-3,3,1,1,1,0,0,0,0,0,0,0.5179608869977906,0.48203911300220936
94318,0.45454545454545453,0.5833333333333333,120,-140,0.43732782369146006,0.5626721763085399,home,WSH,under,9,0.504950495049505,-102,0.48203911300220936,WSH,NYM,2024 REG,6,3,13,6,9,19,0,1,-3,3,1,1,1,0,0,0,0,0,0,0.5179608869977906,0.48203911300220936
94323,0.609375,0.4273504273504274,-156,134,0.5869954427083333,0.41300455729166674,away,WSH,over,8.5,0.5238095238095238,-110,0.4988662131519274,BOS,WSH,2024 REG,6,4,4,2,6,10,1,0,2,-2,1,1,0,0,0,0,0,0,0,0.4988662131519274,0.5011337868480725
94323,0.609375,0.4273504273504274,-156,134,0.5869954427083333,0.41300455729166674,home,BOS,under,8.5,0.5238095238095238,-110,0.5011337868480725,BOS,WSH,2024 REG,6,4,4,2,6,10,1,0,2,-2,1,1,0,0,0,0,0,0,0,0.4988662131519274,0.5011337868480725
94325,0.5884773662551441,0.45248868778280543,-143,121,0.5643697706690257,0.4356302293309743,away,SEA,over,7.5,0.5,100,0.4772727272727273,HOU,SEA,2024 REG,3,0,10,5,5,13,0,1,-5,5,0,0,0,0,0,0,0,0,0,0.4772727272727273,0.5227272727272727
94325,0.5884773662551441,0.45248868778280543,-143,121,0.5643697706690257,0.4356302293309743,home,HOU,under,7.5,0.5454545454545454,-120,0.5227272727272727,HOU,SEA,2024 REG,3,0,10,5,5,13,0,1,-5,5,0,0,0,0,0,0,0,0,0,0.4772727272727273,0.5227272727272727
94327,0.5726495726495727,0.4672897196261683,-134,114,0.5497783539959433,0.4502216460040567,away,WSH,over,8,0.5121951219512195,-105,0.48808156828023186,OAK,WSH,2024 REG,3,2,8,1,3,11,1,0,1,-1,1,0,0,0,0,0,0,0,0,0.48808156828023186,0.5119184317197681
94327,0.5726495726495727,0.4672897196261683,-134,114,0.5497783539959433,0.4502216460040567,home,OAK,under,8,0.5348837209302326,-115,0.5119184317197681,OAK,WSH,2024 REG,3,2,8,1,3,11,1,0,1,-1,1,0,0,0,0,0,0,0,0,0.48808156828023186,0.5119184317197681
94328,0.5238095238095238,0.5238095238095238,-110,-110,0.4988662131519274,0.5011337868480725,away,TB,over,7.5,0.5348837209302326,-115,0.5097020142727117,BOS,TB,2024 REG,9,5,8,7,12,17,0,1,-2,2,1,1,1,1,1,0,0,0,0,0.5097020142727117,0.49029798572728833
94328,0.5238095238095238,0.5238095238095238,-110,-110,0.4988662131519274,0.5011337868480725,home,BOS,under,7.5,0.5121951219512195,-105,0.49029798572728833,BOS,TB,2024 REG,9,5,8,7,12,17,0,1,-2,2,1,1,1,1,1,0,0,0,0,0.5097020142727117,0.49029798572728833
94330,0.4926108374384236,0.5495495495495495,103,-122,0.4718421738975501,0.5281578261024499,away,SD,over,9,0.5412844036697247,-118,0.5162581740877563,CIN,SD,2024 REG,3,2,5,0,2,8,1,0,2,-2,0,0,0,0,0,0,0,0,0,0.5162581740877563,0.4837418259122437
94330,0.4926108374384236,0.5495495495495495,103,-122,0.4718421738975501,0.5281578261024499,home,CIN,under,9,0.504950495049505,-102,0.4837418259122437,CIN,SD,2024 REG,3,2,5,0,2,8,1,0,2,-2,0,0,0,0,0,0,0,0,0,0.5162581740877563,0.4837418259122437
94332,0.7402597402597403,0.29850746268656714,-285,235,0.7115619406761102,0.2884380593238898,away,CWS,over,7,0.5283018867924528,-112,0.5031902949311281,MIN,CWS,2024 REG,10,6,8,5,11,18,1,0,1,-1,1,1,1,1,1,0,0,0,0,0.5031902949311281,0.4968097050688719
94332,0.7402597402597403,0.29850746268656714,-285,235,0.7115619406761102,0.2884380593238898,home,MIN,under,7,0.5192307692307692,-108,0.4968097050688719,MIN,CWS,2024 REG,10,6,8,5,11,18,1,0,1,-1,1,1,1,1,1,0,0,0,0,0.5031902949311281,0.4968097050688719
94334,0.574468085106383,0.4672897196261683,-135,114,0.550479558983428,0.44952044101657196,away,LAA,over,7.5,0.5433789954337899,-119,0.5184560714286826,PIT,LAA,2024 REG,3,0,15,9,9,18,0,1,-9,9,0,0,0,0,0,0,0,0,0,0.5184560714286826,0.48154392857131745
94334,0.574468085106383,0.4672897196261683,-135,114,0.550479558983428,0.44952044101657196,home,PIT,under,7.5,0.5024875621890548,-101,0.48154392857131745,PIT,LAA,2024 REG,3,0,15,9,9,18,0,1,-9,9,0,0,0,0,0,0,0,0,0,0.5184560714286826,0.48154392857131745
94335,0.607843137254902,0.43103448275862066,-155,132,0.5842116427368785,0.41578835726312147,away,TOR,over,8.5,0.5348837209302326,-115,0.5097020142727117,NYY,TOR,2024 REG,6,0,7,3,3,13,0,1,-3,3,0,0,0,0,0,0,0,0,0,0.5097020142727117,0.49029798572728833
94335,0.607843137254902,0.43103448275862066,-155,132,0.5842116427368785,0.41578835726312147,home,NYY,under,8.5,0.5121951219512195,-105,0.49029798572728833,NYY,TOR,2024 REG,6,0,7,3,3,13,0,1,-3,3,0,0,0,0,0,0,0,0,0,0.5097020142727117,0.49029798572728833
94336,0.5,0.5454545454545454,100,-120,0.4772727272727273,0.5227272727272727,away,ARI,over,8,0.5121951219512195,-105,0.48808156828023186,SF,ARI,2024 REG,16,7,7,3,10,23,1,0,4,-4,1,1,1,0,0,0,0,0,0,0.48808156828023186,0.5119184317197681
94336,0.5,0.5454545454545454,100,-120,0.4772727272727273,0.5227272727272727,home,SF,under,8,0.5348837209302326,-115,0.5119184317197681,SF,ARI,2024 REG,16,7,7,3,10,23,1,0,4,-4,1,1,1,0,0,0,0,0,0,0.48808156828023186,0.5119184317197681
94338,0.48780487804878053,0.5555555555555556,105,-125,0.4666534470222751,0.5333465529777248,away,SF,over,7.5,0.5121951219512195,-105,0.48808156828023186,TEX,SF,2024 REG,5,2,11,5,7,16,0,1,-3,3,1,1,0,0,0,0,0,0,0,0.48808156828023186,0.5119184317197681
94338,0.48780487804878053,0.5555555555555556,105,-125,0.4666534470222751,0.5333465529777248,home,TEX,under,7.5,0.5348837209302326,-115,0.5119184317197681,TEX,SF,2024 REG,5,2,11,5,7,16,0,1,-3,3,1,1,0,0,0,0,0,0,0,0.48808156828023186,0.5119184317197681
94340,0.4672897196261683,0.5689655172413793,114,-132,0.4503480201553517,0.5496519798446483,away,BOS,over,7.5,0.5238095238095238,-110,0.4988662131519274,TOR,BOS,2024 REG,7,3,12,4,7,19,0,1,-1,1,1,1,1,0,0,0,0,0,0,0.4988662131519274,0.5011337868480725
94340,0.4672897196261683,0.5689655172413793,114,-132,0.4503480201553517,0.5496519798446483,home,TOR,under,7.5,0.5238095238095238,-110,0.5011337868480725,TOR,BOS,2024 REG,7,3,12,4,7,19,0,1,-1,1,1,1,1,0,0,0,0,0,0,0.4988662131519274,0.5011337868480725
94346,0.4739336492890995,0.5670995670995671,111,-131,0.4544866273039494,0.5455133726960506,away,TB,over,7.5,0.5,100,0.4772727272727273,MIA,TB,2024 REG,12,5,12,9,14,24,0,1,-4,4,1,1,1,1,1,0,0,0,0,0.4772727272727273,0.5227272727272727
94346,0.4739336492890995,0.5670995670995671,111,-131,0.4544866273039494,0.5455133726960506,home,MIA,under,7.5,0.5454545454545454,-120,0.5227272727272727,MIA,TB,2024 REG,12,5,12,9,14,24,0,1,-4,4,1,1,1,1,1,0,0,0,0,0.4772727272727273,0.5227272727272727
94347,0.6551724137931035,0.3846153846153846,-190,160,0.6291045458703008,0.37089545412969915,away,COL,over,9,0.5169082125603864,-107,0.49239402434819424,TOR,COL,2024 REG,9,5,7,3,8,16,1,0,2,-2,1,1,1,0,0,0,0,0,0,0.49239402434819424,0.5076059756518058
94347,0.6551724137931035,0.3846153846153846,-190,160,0.6291045458703008,0.37089545412969915,home,TOR,under,9,0.5305164319248826,-113,0.5076059756518058,TOR,COL,2024 REG,9,5,7,3,8,16,1,0,2,-2,1,1,1,0,0,0,0,0,0,0.49239402434819424,0.5076059756518058
94348,0.6551724137931035,0.3846153846153846,-190,160,0.6291045458703008,0.37089545412969915,away,STL,over,8,0.5121951219512195,-105,0.48808156828023186,HOU,STL,2024 REG,9,7,8,4,11,17,1,0,3,-3,1,1,1,1,0,0,0,0,0,0.48808156828023186,0.5119184317197681
94348,0.6551724137931035,0.3846153846153846,-190,160,0.6291045458703008,0.37089545412969915,home,HOU,under,8,0.5348837209302326,-115,0.5119184317197681,HOU,STL,2024 REG,9,7,8,4,11,17,1,0,3,-3,1,1,1,1,0,0,0,0,0,0.48808156828023186,0.5119184317197681
94350,0.4672897196261683,0.574468085106383,114,-135,0.4477767267604901,0.5522232732395099,away,NYY,over,8.5,0.5454545454545454,-120,0.5206611570247933,MIL,NYY,2024 REG,9,7,6,6,13,15,1,0,1,-1,1,1,1,1,1,1,0,0,0,0.5206611570247933,0.4793388429752067
94350,0.4672897196261683,0.574468085106383,114,-135,0.4477767267604901,0.5522232732395099,home,MIL,under,8.5,0.5,100,0.4793388429752067,MIL,NYY,2024 REG,9,7,6,6,13,15,1,0,1,-1,1,1,1,1,1,1,0,0,0,0.5206611570247933,0.4793388429752067
94353,0.6515679442508712,0.3921568627450981,-187,155,0.6230782616437414,0.37692173835625864,away,CHC,over,9,0.5121951219512195,-105,0.48808156828023186,ATL,CHC,2024 REG,8,1,13,7,8,21,0,1,-6,6,1,0,0,0,0,0,0,0,0,0.48808156828023186,0.5119184317197681
94353,0.6515679442508712,0.3921568627450981,-187,155,0.6230782616437414,0.37692173835625864,home,ATL,under,9,0.5348837209302326,-115,0.5119184317197681,ATL,CHC,2024 REG,8,1,13,7,8,21,0,1,-6,6,1,0,0,0,0,0,0,0,0,0.48808156828023186,0.5119184317197681
94356,0.3861003861003861,0.6551724137931035,159,-190,0.37016494212606577,0.6298350578739342,away,LAD,over,7.5,0.5,100,0.4772727272727273,CHC,LAD,2024 REG,9,9,12,7,16,21,1,0,2,-2,1,1,1,1,1,1,1,0,0,0.4772727272727273,0.5227272727272727
94356,0.3861003861003861,0.6551724137931035,159,-190,0.37016494212606577,0.6298350578739342,home,CHC,under,7.5,0.5454545454545454,-120,0.5227272727272727,CHC,LAD,2024 REG,9,9,12,7,16,21,1,0,2,-2,1,1,1,1,1,1,1,0,0,0.4772727272727273,0.5227272727272727
94357,0.6226415094339623,0.4166666666666667,-165,140,0.5981666073335706,0.40183339266642937,away,KC,over,7,0.5495495495495495,-122,0.5223196169142115,SEA,KC,2024 REG,7,2,5,4,6,12,0,1,-2,2,1,1,0,0,0,0,0,0,0,0.5223196169142115,0.47768038308578853
94357,0.6226415094339623,0.4166666666666667,-165,140,0.5981666073335706,0.40183339266642937,home,SEA,under,7,0.5,100,0.47768038308578853,SEA,KC,2024 REG,7,2,5,4,6,12,0,1,-2,2,1,1,0,0,0,0,0,0,0,0.5223196169142115,0.47768038308578853
94360,0.5515695067264574,0.49019607843137253,-123,104,0.5285328835228112,0.47146711647718875,away,ARI,over,7.5,0.49751243781094534,101,0.4740985137509976,SF,ARI,2024 REG,4,1,22,17,18,26,0,1,-16,16,1,0,0,0,0,0,0,0,0,0.4740985137509976,0.5259014862490023
94360,0.5515695067264574,0.49019607843137253,-123,104,0.5285328835228112,0.47146711647718875,home,SF,under,7.5,0.5495495495495495,-122,0.5259014862490023,SF,ARI,2024 REG,4,1,22,17,18,26,0,1,-16,16,1,0,0,0,0,0,0,0,0,0.4740985137509976,0.5259014862490023
94362,0.5238095238095238,0.5238095238095238,-110,-110,0.4988662131519274,0.5011337868480725,away,NYM,over,7.5,0.5121951219512195,-105,0.48808156828023186,TB,NYM,2024 REG,7,3,6,1,4,13,1,0,2,-2,1,0,0,0,0,0,0,0,0,0.48808156828023186,0.5119184317197681
94362,0.5238095238095238,0.5238095238095238,-110,-110,0.4988662131519274,0.5011337868480725,home,TB,under,7.5,0.5348837209302326,-115,0.5119184317197681,TB,NYM,2024 REG,7,3,6,1,4,13,1,0,2,-2,1,0,0,0,0,0,0,0,0,0.48808156828023186,0.5119184317197681
94365,0.4672897196261683,0.5726495726495727,114,-134,0.44862649893656975,0.5513735010634302,away,DET,over,8.5,0.5433789954337899,-119,0.5184560714286826,CWS,DET,2024 REG,10,6,12,7,13,22,0,1,-1,1,1,1,1,1,1,1,0,0,0,0.5184560714286826,0.48154392857131745
94365,0.4672897196261683,0.5726495726495727,114,-134,0.44862649893656975,0.5513735010634302,home,CWS,under,8.5,0.5024875621890548,-101,0.48154392857131745,CWS,DET,2024 REG,10,6,12,7,13,22,0,1,-1,1,1,1,1,1,1,1,0,0,0,0.5184560714286826,0.48154392857131745
94367,0.5798319327731092,0.4587155963302753,-138,118,0.557480844469466,0.442519155530534,away,MIL,over,7.5,0.5305164319248826,-113,0.5066009958897986,SD,MIL,2024 REG,8,2,14,6,8,22,0,1,-4,4,1,1,0,0,0,0,0,0,0,0.5066009958897986,0.49339900411020143
94367,0.5798319327731092,0.4587155963302753,-138,118,0.557480844469466,0.442519155530534,home,SD,under,7.5,0.5145631067961165,-106,0.49339900411020143,SD,MIL,2024 REG,8,2,14,6,8,22,0,1,-4,4,1,1,0,0,0,0,0,0,0,0.5066009958897986,0.49339900411020143
94372,0.6688741721854304,0.37453183520599254,-202,167,0.6398410149236177,0.36015898507638233,away,CIN,over,8,0.5348837209302326,-115,0.5097020142727117,LAD,CIN,2024 REG,6,4,3,0,4,9,1,0,4,-4,0,0,0,0,0,0,0,0,0,0.5097020142727117,0.49029798572728833
94372,0.6688741721854304,0.37453183520599254,-202,167,0.6398410149236177,0.36015898507638233,home,LAD,under,8,0.5121951219512195,-105,0.49029798572728833,LAD,CIN,2024 REG,6,4,3,0,4,9,1,0,4,-4,0,0,0,0,0,0,0,0,0,0.5097020142727117,0.49029798572728833
94374,0.6551724137931035,0.3861003861003861,-190,159,0.6281316138628862,0.3718683861371138,away,WSH,over,9,0.5073891625615764,-103,0.48057683780462784,ATL,WSH,2024 REG,5,1,8,3,4,13,0,1,-2,2,1,0,0,0,0,0,0,0,0,0.48057683780462784,0.5194231621953722
94374,0.6551724137931035,0.3861003861003861,-190,159,0.6281316138628862,0.3718683861371138,home,ATL,under,9,0.5454545454545454,-120,0.5194231621953722,ATL,WSH,2024 REG,5,1,8,3,4,13,0,1,-2,2,1,0,0,0,0,0,0,0,0,0.48057683780462784,0.5194231621953722
94376,0.6491228070175439,0.39370078740157477,-185,154,0.6213250352016247,0.37867496479837526,away,CWS,over,7.5,0.5121951219512195,-105,0.48919479393107135,DET,CWS,2024 REG,5,2,6,1,3,11,1,0,1,-1,1,0,0,0,0,0,0,0,0,0.48919479393107135,0.5108052060689287
94376,0.6491228070175439,0.39370078740157477,-185,154,0.6213250352016247,0.37867496479837526,home,DET,under,7.5,0.5327102803738317,-114,0.5108052060689287,DET,CWS,2024 REG,5,2,6,1,3,11,1,0,1,-1,1,0,0,0,0,0,0,0,0,0.48919479393107135,0.5108052060689287
94377,0.5121951219512195,0.5348837209302326,-105,-115,0.48808156828023186,0.5119184317197681,away,CLE,over,9,0.5121951219512195,-105,0.48808156828023186,KC,CLE,2024 REG,6,2,7,1,3,13,1,0,1,-1,1,0,0,0,0,0,0,0,0,0.48808156828023186,0.5119184317197681
94377,0.5121951219512195,0.5348837209302326,-105,-115,0.48808156828023186,0.5119184317197681,home,KC,under,9,0.5348837209302326,-115,0.5119184317197681,KC,CLE,2024 REG,6,2,7,1,3,13,1,0,1,-1,1,0,0,0,0,0,0,0,0,0.48808156828023186,0.5119184317197681
94386,0.5575221238938054,0.48309178743961345,-126,107,0.534878969787563,0.465121030212437,away,SD,over,8,0.5370370370370371,-116,0.5118817074154765,KC,SD,2024 REG,7,4,10,3,7,17,1,0,1,-1,1,1,1,0,0,0,0,0,0,0.5118817074154765,0.48811829258452355
94386,0.5575221238938054,0.48309178743961345,-126,107,0.534878969787563,0.465121030212437,home,KC,under,8,0.5098039215686274,-104,0.48811829258452355,KC,SD,2024 REG,7,4,10,3,7,17,1,0,1,-1,1,1,1,0,0,0,0,0,0,0.5118817074154765,0.48811829258452355
94389,0.390625,0.6551724137931035,156,-190,0.3727353852370689,0.627264614762931,away,MIL,over,8.5,0.5,100,0.4772727272727273,LAA,MIL,2024 REG,4,0,6,2,2,10,0,1,-2,2,0,0,0,0,0,0,0,0,0,0.4772727272727273,0.5227272727272727
94389,0.390625,0.6551724137931035,156,-190,0.3727353852370689,0.627264614762931,home,LAA,under,8.5,0.5454545454545454,-120,0.5227272727272727,LAA,MIL,2024 REG,4,0,6,2,2,10,0,1,-2,2,0,0,0,0,0,0,0,0,0,0.4772727272727273,0.5227272727272727
94390,0.4672897196261683,0.574468085106383,114,-135,0.4477767267604901,0.5522232732395099,away,NYY,over,9.5,0.5121951219512195,-105,0.48808156828023186,KC,NYY,2024 REG,5,1,10,10,11,15,0,1,-9,9,1,0,0,0,0,0,0,0,0,0.48808156828023186,0.5119184317197681
94390,0.4672897196261683,0.574468085106383,114,-135,0.4477767267604901,0.5522232732395099,home,KC,under,9.5,0.5348837209302326,-115,0.5119184317197681,KC,NYY,2024 REG,5,1,10,10,11,15,0,1,-9,9,1,0,0,0,0,0,0,0,0,0.48808156828023186,0.5119184317197681
94392,0.5833333333333333,0.45454545454545453,-140,120,0.5612373737373737,0.4387626262626263,away,OAK,over,9,0.5145631067961165,-106,0.49023796582517226,LAA,OAK,2024 REG,7,5,7,2,7,14,1,0,3,-3,1,1,0,0,0,0,0,0,0,0.49023796582517226,0.5097620341748277
94392,0.5833333333333333,0.45454545454545453,-140,120,0.5612373737373737,0.4387626262626263,home,LAA,under,9,0.5327102803738317,-114,0.5097620341748277,LAA,OAK,2024 REG,7,5,7,2,7,14,1,0,3,-3,1,1,0,0,0,0,0,0,0,0.49023796582517226,0.5097620341748277
94396,0.5169082125603864,0.5260663507109005,-107,-111,0.4946943078742622,0.5053056921257377,away,WSH,over,10.5,0.5260663507109005,-111,0.5022370601254724,COL,WSH,2024 REG,12,8,11,7,15,23,1,0,1,-1,1,1,1,1,1,1,1,0,0,0.5022370601254724,0.4977629398745276
94396,0.5169082125603864,0.5260663507109005,-107,-111,0.4946943078742622,0.5053056921257377,home,COL,under,10.5,0.5192307692307692,-108,0.4977629398745276,COL,WSH,2024 REG,12,8,11,7,15,23,1,0,1,-1,1,1,1,1,1,1,1,0,0,0.5022370601254724,0.4977629398745276
94398,0.6610169491525424,0.3846153846153846,-195,160,0.6308532031025568,0.36914679689744323,away,OAK,over,9,0.5238095238095238,-110,0.4988662131519274,TEX,OAK,2024 REG,12,6,9,2,8,21,1,0,4,-4,1,1,0,0,0,0,0,0,0,0.4988662131519274,0.5011337868480725
94398,0.6610169491525424,0.3846153846153846,-195,160,0.6308532031025568,0.36914679689744323,home,TEX,under,9,0.5238095238095238,-110,0.5011337868480725,TEX,OAK,2024 REG,12,6,9,2,8,21,1,0,4,-4,1,1,0,0,0,0,0,0,0,0.4988662131519274,0.5011337868480725
94399,0.607843137254902,0.4329004329004329,-155,131,0.583077437748718,0.416922562251282,away,CHC,over,8.5,0.5495495495495495,-122,0.5223196169142115,ARI,CHC,2024 REG,3,2,9,3,5,12,0,1,-1,1,1,1,0,0,0,0,0,0,0,0.5223196169142115,0.47768038308578853
94399,0.607843137254902,0.4329004329004329,-155,131,0.583077437748718,0.416922562251282,home,ARI,under,8.5,0.5,100,0.47768038308578853,ARI,CHC,2024 REG,3,2,9,3,5,12,0,1,-1,1,1,1,0,0,0,0,0,0,0,0.5223196169142115,0.47768038308578853
94400,0.45454545454545453,0.5850622406639003,120,-141,0.4365419567230205,0.5634580432769796,away,MIL,over,6.5,0.5145631067961165,-106,0.4913668392989033,CHC,MIL,2024 REG,7,5,5,0,5,12,1,0,5,-5,0,0,0,0,0,0,0,0,0,0.4913668392989033,0.5086331607010968
94400,0.45454545454545453,0.5850622406639003,120,-141,0.4365419567230205,0.5634580432769796,home,CHC,under,6.5,0.5305164319248826,-113,0.5086331607010968,CHC,MIL,2024 REG,7,5,5,0,5,12,1,0,5,-5,0,0,0,0,0,0,0,0,0,0.4913668392989033,0.5086331607010968
94402,0.5670995670995671,0.4739336492890995,-131,111,0.5438296478488513,0.45617035215114865,away,SEA,over,8.5,0.5169082125603864,-107,0.49239402434819424,HOU,SEA,2024 REG,8,4,10,5,9,18,0,1,-1,1,1,1,1,1,0,0,0,0,0,0.49239402434819424,0.5076059756518058
94402,0.5670995670995671,0.4739336492890995,-131,111,0.5438296478488513,0.45617035215114865,home,HOU,under,8.5,0.5305164319248826,-113,0.5076059756518058,HOU,SEA,2024 REG,8,4,10,5,9,18,0,1,-1,1,1,1,1,1,0,0,0,0,0,0.49239402434819424,0.5076059756518058
94403,0.37037037037037035,0.6688741721854304,170,-202,0.35583535460896265,0.6441646453910373,away,PHI,over,7.5,0.48780487804878053,105,0.4666534470222751,SF,PHI,2024 REG,4,1,7,0,1,11,1,0,1,-1,0,0,0,0,0,0,0,0,0,0.4666534470222751,0.5333465529777248
94403,0.37037037037037035,0.6688741721854304,170,-202,0.35583535460896265,0.6441646453910373,home,SF,under,7.5,0.5555555555555556,-125,0.5333465529777248,SF,PHI,2024 REG,4,1,7,0,1,11,1,0,1,-1,0,0,0,0,0,0,0,0,0,0.4666534470222751,0.5333465529777248
94407,0.4926108374384236,0.5495495495495495,103,-122,0.4718421738975501,0.5281578261024499,away,BAL,over,7.5,0.5348837209302326,-115,0.5097020142727117,PIT,BAL,2024 REG,6,2,12,5,7,18,0,1,-3,3,1,1,0,0,0,0,0,0,0,0.5097020142727117,0.49029798572728833
94407,0.4926108374384236,0.5495495495495495,103,-122,0.4718421738975501,0.5281578261024499,home,PIT,under,7.5,0.5121951219512195,-105,0.49029798572728833,PIT,BAL,2024 REG,6,2,12,5,7,18,0,1,-3,3,1,1,0,0,0,0,0,0,0,0.5097020142727117,0.49029798572728833
94413,0.5475113122171946,0.49504950495049505,-121,102,0.5242087833606768,0.4757912166393232,away,WSH,over,7.5,0.5454545454545454,-120,0.5206611570247933,DET,WSH,2024 REG,12,5,13,7,12,25,0,1,-2,2,1,1,1,1,1,0,0,0,0,0.5206611570247933,0.4793388429752067
94413,0.5475113122171946,0.49504950495049505,-121,102,0.5242087833606768,0.4757912166393232,home,DET,under,7.5,0.5,100,0.4793388429752067,DET,WSH,2024 REG,12,5,13,7,12,25,0,1,-2,2,1,1,1,1,1,0,0,0,0,0.5206611570247933,0.4793388429752067
94414,0.5983935742971888,0.4444444444444444,-149,125,0.5727595791465728,0.42724042085342717,away,DET,over,8.5,0.5454545454545454,-120,0.5206611570247933,TEX,DET,2024 REG,12,9,2,1,10,14,1,0,8,-8,1,0,0,0,0,0,0,0,0,0.5206611570247933,0.4793388429752067
94414,0.5983935742971888,0.4444444444444444,-149,125,0.5727595791465728,0.42724042085342717,home,TEX,under,8.5,0.5,100,0.4793388429752067,TEX,DET,2024 REG,12,9,2,1,10,14,1,0,8,-8,1,0,0,0,0,0,0,0,0,0.5206611570247933,0.4793388429752067
94417,0.4444444444444444,0.5967741935483871,125,-148,0.42612504978096366,0.5738749502190363,away,TB,over,8.5,0.5348837209302326,-115,0.5097020142727117,LAA,TB,2024 REG,14,7,8,1,8,22,1,0,6,-6,1,0,0,0,0,0,0,0,0,0.5097020142727117,0.49029798572728833
94417,0.4444444444444444,0.5967741935483871,125,-148,0.42612504978096366,0.5738749502190363,home,LAA,under,8.5,0.5121951219512195,-105,0.49029798572728833,LAA,TB,2024 REG,14,7,8,1,8,22,1,0,6,-6,1,0,0,0,0,0,0,0,0,0.5097020142727117,0.49029798572728833
94419,0.5689655172413793,0.4716981132075471,-132,112,0.5458293137100936,0.4541706862899064,away,MIL,over,8.5,0.5238095238095238,-110,0.4988662131519274,CHC,MIL,2024 REG,8,6,8,5,11,16,1,0,1,-1,1,1,1,1,1,0,0,0,0,0.4988662131519274,0.5011337868480725
94419,0.5689655172413793,0.4716981132075471,-132,112,0.5458293137100936,0.4541706862899064,home,CHC,under,8.5,0.5238095238095238,-110,0.5011337868480725,CHC,MIL,2024 REG,8,6,8,5,11,16,1,0,1,-1,1,1,1,1,1,0,0,0,0,0.4988662131519274,0.5011337868480725
94421,0.5555555555555556,0.48780487804878053,-125,105,0.5314664257753688,0.46853357422463116,away,SEA,over,8.5,0.504950495049505,-102,0.48160416005266615,CLE,SEA,2024 REG,9,6,5,3,9,14,1,0,3,-3,1,1,1,0,0,0,0,0,0,0.48160416005266615,0.5183958399473338
94421,0.5555555555555556,0.48780487804878053,-125,105,0.5314664257753688,0.46853357422463116,home,CLE,under,8.5,0.5412844036697247,-118,0.5183958399473338,CLE,SEA,2024 REG,9,6,5,3,9,14,1,0,3,-3,1,1,1,0,0,0,0,0,0,0.48160416005266615,0.5183958399473338
94422,0.4291845493562232,0.607843137254902,133,-155,0.41329283836432396,0.586707161635676,away,BAL,over,9,0.5121951219512195,-105,0.48808156828023186,OAK,BAL,2024 REG,18,19,16,8,27,34,1,0,11,-11,1,1,1,1,1,1,1,1,0,0.48808156828023186,0.5119184317197681
94422,0.4291845493562232,0.607843137254902,133,-155,0.41329283836432396,0.586707161635676,home,OAK,under,9,0.5348837209302326,-115,0.5119184317197681,OAK,BAL,2024 REG,18,19,16,8,27,34,1,0,11,-11,1,1,1,1,1,1,1,1,0,0.48808156828023186,0.5119184317197681
94424,0.5238095238095238,0.5238095238095238,-110,-110,0.4988662131519274,0.5011337868480725,away,TEX,over,9,0.5238095238095238,-110,0.5000596729920038,MIL,TEX,2024 REG,8,3,5,1,4,13,1,0,2,-2,1,0,0,0,0,0,0,0,0,0.5000596729920038,0.4999403270079962
94424,0.5238095238095238,0.5238095238095238,-110,-110,0.4988662131519274,0.5011337868480725,home,MIL,under,9,0.5215311004784688,-109,0.4999403270079962,MIL,TEX,2024 REG,8,3,5,1,4,13,1,0,2,-2,1,0,0,0,0,0,0,0,0,0.5000596729920038,0.4999403270079962
94427,0.5475113122171946,0.49751243781094534,-121,101,0.5228602997583487,0.4771397002416513,away,ARI,over,7,0.5433789954337899,-119,0.5184560714286826,NYM,ARI,2024 REG,14,10,9,9,19,23,1,0,1,-1,1,1,1,1,1,1,1,1,1,0.5184560714286826,0.48154392857131745
94427,0.5475113122171946,0.49751243781094534,-121,101,0.5228602997583487,0.4771397002416513,home,NYM,under,7,0.5024875621890548,-101,0.48154392857131745,NYM,ARI,2024 REG,14,10,9,9,19,23,1,0,1,-1,1,1,1,1,1,1,1,1,1,0.5184560714286826,0.48154392857131745
94428,0.5370370370370371,0.5024875621890548,-116,-101,0.5158108633785803,0.4841891366214197,away,ATL,over,9,0.49751243781094534,101,0.47511256217505476,ARI,ATL,2024 REG,9,7,8,5,12,17,1,0,2,-2,1,1,1,1,1,0,0,0,0,0.47511256217505476,0.5248874378249453
94428,0.5370370370370371,0.5024875621890548,-116,-101,0.5158108633785803,0.4841891366214197,home,ARI,under,9,0.5475113122171946,-121,0.5248874378249453,ARI,ATL,2024 REG,9,7,8,5,12,17,1,0,2,-2,1,1,1,1,1,0,0,0,0,0.47511256217505476,0.5248874378249453
94429,0.6610169491525424,0.37878787878787884,-195,164,0.6347052832258232,0.3652947167741768,away,CWS,over,7,0.5192307692307692,-108,0.49455035168025013,TOR,CWS,2024 REG,2,0,8,5,5,10,0,1,-5,5,0,0,0,0,0,0,0,0,0,0.49455035168025013,0.5054496483197499
94429,0.6610169491525424,0.37878787878787884,-195,164,0.6347052832258232,0.3652947167741768,home,TOR,under,7,0.5283018867924528,-112,0.5054496483197499,TOR,CWS,2024 REG,2,0,8,5,5,10,0,1,-5,5,0,0,0,0,0,0,0,0,0,0.49455035168025013,0.5054496483197499
94431,0.5652173913043479,0.4716981132075471,-130,112,0.5443521061454507,0.4556478938545493,away,NYY,over,9,0.5238095238095238,-110,0.4988662131519274,HOU,NYY,2024 REG,4,3,8,5,8,12,0,1,-2,2,1,1,1,0,0,0,0,0,0,0.4988662131519274,0.5011337868480725
94431,0.5652173913043479,0.4716981132075471,-130,112,0.5443521061454507,0.4556478938545493,home,HOU,under,9,0.5238095238095238,-110,0.5011337868480725,HOU,NYY,2024 REG,4,3,8,5,8,12,0,1,-2,2,1,1,1,0,0,0,0,0,0,0.4988662131519274,0.5011337868480725
94433,0.5260663507109005,0.5215311004784688,-111,-109,0.5010269332605688,0.4989730667394312,away,DET,over,7,0.5348837209302326,-115,0.5097020142727117,TEX,DET,2024 REG,8,1,4,2,3,12,0,1,-1,1,1,0,0,0,0,0,0,0,0,0.5097020142727117,0.49029798572728833
94433,0.5260663507109005,0.5215311004784688,-111,-109,0.5010269332605688,0.4989730667394312,home,TEX,under,7,0.5121951219512195,-105,0.49029798572728833,TEX,DET,2024 REG,8,1,4,2,3,12,0,1,-1,1,1,0,0,0,0,0,0,0,0,0.5097020142727117,0.49029798572728833
94438,0.5708154506437768,0.4694835680751174,-133,113,0.5478121481132493,0.4521878518867507,away,ARI,over,8,0.5348837209302326,-115,0.5097020142727117,SD,ARI,2024 REG,7,3,15,9,12,22,0,1,-6,6,1,1,1,0,0,0,0,0,0,0.5097020142727117,0.49029798572728833
94438,0.5708154506437768,0.4694835680751174,-133,113,0.5478121481132493,0.4521878518867507,home,SD,under,8,0.5121951219512195,-105,0.49029798572728833,SD,ARI,2024 REG,7,3,15,9,12,22,0,1,-6,6,1,1,1,0,0,0,0,0,0,0.5097020142727117,0.49029798572728833
94440,0.37037037037037035,0.6688741721854304,170,-202,0.35583535460896265,0.6441646453910373,away,ATL,over,8.5,0.5454545454545454,-120,0.5206611570247933,MIA,ATL,2024 REG,6,1,14,8,9,20,0,1,-7,7,1,0,0,0,0,0,0,0,0,0.5206611570247933,0.4793388429752067
94440,0.37037037037037035,0.6688741721854304,170,-202,0.35583535460896265,0.6441646453910373,home,MIA,under,8.5,0.5,100,0.4793388429752067,MIA,ATL,2024 REG,6,1,14,8,9,20,0,1,-7,7,1,0,0,0,0,0,0,0,0,0.5206611570247933,0.4793388429752067
94441,0.49504950495049505,0.5454545454545454,102,-120,0.47499799484898986,0.5250020051510101,away,SEA,over,11,0.5238095238095238,-110,0.4988662131519274,COL,SEA,2024 REG,6,2,13,10,12,19,0,1,-8,8,1,1,0,0,0,0,0,0,0,0.4988662131519274,0.5011337868480725
94441,0.49504950495049505,0.5454545454545454,102,-120,0.47499799484898986,0.5250020051510101,home,COL,under,11,0.5238095238095238,-110,0.5011337868480725,COL,SEA,2024 REG,6,2,13,10,12,19,0,1,-8,8,1,1,0,0,0,0,0,0,0,0.4988662131519274,0.5011337868480725
94442,0.5798319327731092,0.4608294930875576,-138,117,0.5562551396270082,0.44374486037299177,away,WSH,over,8.5,0.5121951219512195,-105,0.48808156828023186,NYM,WSH,2024 REG,11,7,6,5,12,17,1,0,2,-2,1,1,1,1,1,0,0,0,0,0.48808156828023186,0.5119184317197681
94442,0.5798319327731092,0.4608294930875576,-138,117,0.5562551396270082,0.44374486037299177,home,NYM,under,8.5,0.5348837209302326,-115,0.5119184317197681,NYM,WSH,2024 REG,11,7,6,5,12,17,1,0,2,-2,1,1,1,1,1,0,0,0,0,0.48808156828023186,0.5119184317197681
94443,0.5348837209302326,0.5098039215686274,-115,-104,0.5109810284308424,0.48901897156915763,away,TOR,over,8.5,0.5238095238095238,-110,0.4988662131519274,CLE,TOR,2024 REG,13,6,9,5,11,22,1,0,1,-1,1,1,1,1,1,0,0,0,0,0.4988662131519274,0.5011337868480725
94443,0.5348837209302326,0.5098039215686274,-115,-104,0.5109810284308424,0.48901897156915763,home,CLE,under,8.5,0.5238095238095238,-110,0.5011337868480725,CLE,TOR,2024 REG,13,6,9,5,11,22,1,0,1,-1,1,1,1,1,1,0,0,0,0,0.4988662131519274,0.5011337868480725
94444,0.5884773662551441,0.45248868778280543,-143,121,0.5643697706690257,0.4356302293309743,away,ARI,over,9,0.5121951219512195,-105,0.48808156828023186,CIN,ARI,2024 REG,9,4,9,5,9,18,0,1,-1,1,1,1,1,1,0,0,0,0,0,0.48808156828023186,0.5119184317197681
94444,0.5884773662551441,0.45248868778280543,-143,121,0.5643697706690257,0.4356302293309743,home,CIN,under,9,0.5348837209302326,-115,0.5119184317197681,CIN,ARI,2024 REG,9,4,9,5,9,18,0,1,-1,1,1,1,1,1,0,0,0,0,0,0.48808156828023186,0.5119184317197681
94446,0.5238095238095238,0.5215311004784688,-110,-109,0.5000596729920038,0.4999403270079962,away,BAL,over,8.5,0.5433789954337899,-119,0.5184560714286826,LAA,BAL,2024 REG,8,2,6,4,6,14,0,1,-2,2,1,1,0,0,0,0,0,0,0,0.5184560714286826,0.48154392857131745
94446,0.5238095238095238,0.5215311004784688,-110,-109,0.5000596729920038,0.4999403270079962,home,LAA,under,8.5,0.5024875621890548,-101,0.48154392857131745,LAA,BAL,2024 REG,8,2,6,4,6,14,0,1,-2,2,1,1,0,0,0,0,0,0,0,0.5184560714286826,0.48154392857131745
94447,0.4065040650406504,0.6363636363636364,146,-175,0.389078170160859,0.610921829839141,away,CIN,over,9.5,0.5,100,0.4772727272727273,CWS,CIN,2024 REG,4,1,12,11,12,16,0,1,-10,10,1,0,0,0,0,0,0,0,0,0.4772727272727273,0.5227272727272727
94447,0.4065040650406504,0.6363636363636364,146,-175,0.389078170160859,0.610921829839141,home,CWS,under,9.5,0.5454545454545454,-120,0.5227272727272727,CWS,CIN,2024 REG,4,1,12,11,12,16,0,1,-10,10,1,0,0,0,0,0,0,0,0,0.4772727272727273,0.5227272727272727
94449,0.5260663507109005,0.5169082125603864,-111,-107,0.5034588790373798,0.49654112096262015,away,MIN,over,9,0.5121951219512195,-105,0.48808156828023186,LAA,MIN,2024 REG,11,5,17,16,21,28,0,1,-11,11,1,1,1,1,1,0,0,0,0,0.48808156828023186,0.5119184317197681
94449,0.5260663507109005,0.5169082125603864,-111,-107,0.5034588790373798,0.49654112096262015,home,LAA,under,9,0.5348837209302326,-115,0.5119184317197681,LAA,MIN,2024 REG,11,5,17,16,21,28,0,1,-11,11,1,1,1,1,1,0,0,0,0,0.48808156828023186,0.5119184317197681
94451,0.4081632653061224,0.635036496350365,145,-174,0.39053070952796426,0.6094692904720358,away,STL,over,7.5,0.5238095238095238,-110,0.4988662131519274,OAK,STL,2024 REG,5,1,8,3,4,13,0,1,-2,2,1,0,0,0,0,0,0,0,0,0.4988662131519274,0.5011337868480725
94451,0.4081632653061224,0.635036496350365,145,-174,0.39053070952796426,0.6094692904720358,home,OAK,under,7.5,0.5238095238095238,-110,0.5011337868480725,OAK,STL,2024 REG,5,1,8,3,4,13,0,1,-2,2,1,0,0,0,0,0,0,0,0,0.4988662131519274,0.5011337868480725
94454,0.49019607843137253,0.5475113122171946,104,-121,0.47171206340756505,0.5282879365924349,away,NYY,over,7,0.5348837209302326,-115,0.5097020142727117,SD,NYY,2024 REG,3,0,10,8,8,13,0,1,-8,8,0,0,0,0,0,0,0,0,0,0.5097020142727117,0.49029798572728833
94454,0.49019607843137253,0.5475113122171946,104,-121,0.47171206340756505,0.5282879365924349,home,SD,under,7,0.5121951219512195,-105,0.49029798572728833,SD,NYY,2024 REG,3,0,10,8,8,13,0,1,-8,8,0,0,0,0,0,0,0,0,0,0.5097020142727117,0.49029798572728833
94455,0.4081632653061224,0.6336996336996338,145,-173,0.39107636775275256,0.6089236322472474,away,MIL,over,8,0.5169082125603864,-107,0.49239402434819424,DET,MIL,2024 REG,5,4,10,5,9,15,0,1,-1,1,1,1,1,1,0,0,0,0,0,0.49239402434819424,0.5076059756518058
94455,0.4081632653061224,0.6336996336996338,145,-173,0.39107636775275256,0.6089236322472474,home,DET,under,8,0.5305164319248826,-113,0.5076059756518058,DET,MIL,2024 REG,5,4,10,5,9,15,0,1,-1,1,1,1,1,1,0,0,0,0,0,0.49239402434819424,0.5076059756518058
94456,0.5454545454545454,0.49751243781094534,-120,101,0.5220180091279142,0.4779819908720858,away,SD,over,8.5,0.5454545454545454,-120,0.5206611570247933,ARI,SD,2024 REG,8,1,18,13,14,26,0,1,-12,12,1,0,0,0,0,0,0,0,0,0.5206611570247933,0.4793388429752067
94456,0.5454545454545454,0.49751243781094534,-120,101,0.5220180091279142,0.4779819908720858,home,ARI,under,8.5,0.5,100,0.4793388429752067,ARI,SD,2024 REG,8,1,18,13,14,26,0,1,-12,12,1,0,0,0,0,0,0,0,0,0.5206611570247933,0.4793388429752067
94457,0.5867768595041323,0.45454545454545453,-142,120,0.5625298818386723,0.43747011816132775,away,PIT,over,8.5,0.5024875621890548,-101,0.47839724939301687,MIL,PIT,2024 REG,13,6,13,8,14,26,0,1,-2,2,1,1,1,1,1,1,0,0,0,0.47839724939301687,0.5216027506069831
94457,0.5867768595041323,0.45454545454545453,-142,120,0.5625298818386723,0.43747011816132775,home,MIL,under,8.5,0.5454545454545454,-120,0.5216027506069831,MIL,PIT,2024 REG,13,6,13,8,14,26,0,1,-2,2,1,1,1,1,1,1,0,0,0,0.47839724939301687,0.5216027506069831
94459,0.576271186440678,0.4629629629629629,-136,116,0.553661676614851,0.446338323385149,away,MIL,over,8.5,0.5370370370370371,-116,0.5131785224377817,KC,MIL,2024 REG,5,3,3,2,5,8,1,0,1,-1,1,1,0,0,0,0,0,0,0,0.5131785224377817,0.4868214775622183
94459,0.576271186440678,0.4629629629629629,-136,116,0.553661676614851,0.446338323385149,home,KC,under,8.5,0.5073891625615764,-103,0.4868214775622183,KC,MIL,2024 REG,5,3,3,2,5,8,1,0,1,-1,1,1,0,0,0,0,0,0,0,0.5131785224377817,0.4868214775622183
94461,0.5238095238095238,0.5192307692307692,-110,-108,0.5012646084074657,0.4987353915925343,away,NYY,over,8.5,0.5348837209302326,-115,0.5097020142727117,CLE,NYY,2024 REG,7,2,9,8,10,16,0,1,-6,6,1,1,0,0,0,0,0,0,0,0.5097020142727117,0.49029798572728833
94461,0.5238095238095238,0.5192307692307692,-110,-108,0.5012646084074657,0.4987353915925343,home,CLE,under,8.5,0.5121951219512195,-105,0.49029798572728833,CLE,NYY,2024 REG,7,2,9,8,10,16,0,1,-6,6,1,1,0,0,0,0,0,0,0,0.5097020142727117,0.49029798572728833
94462,0.5192307692307692,0.5238095238095238,-108,-110,0.49688292476754015,0.5031170752324599,away,NYY,over,8.5,0.5121951219512195,-105,0.48808156828023186,TOR,NYY,2024 REG,10,5,18,16,21,28,0,1,-11,11,1,1,1,1,1,0,0,0,0,0.48808156828023186,0.5119184317197681
94462,0.5192307692307692,0.5238095238095238,-108,-110,0.49688292476754015,0.5031170752324599,home,TOR,under,8.5,0.5348837209302326,-115,0.5119184317197681,TOR,NYY,2024 REG,10,5,18,16,21,28,0,1,-11,11,1,1,1,1,1,0,0,0,0,0.48808156828023186,0.5119184317197681
94463,0.5934959349593496,0.4464285714285714,-146,124,0.5698009027128599,0.4301990972871401,away,CIN,over,7.5,0.5370370370370371,-116,0.5118817074154765,STL,CIN,2024 REG,7,4,16,11,15,23,0,1,-7,7,1,1,1,1,0,0,0,0,0,0.5118817074154765,0.48811829258452355
94463,0.5934959349593496,0.4464285714285714,-146,124,0.5698009027128599,0.4301990972871401,home,STL,under,7.5,0.5098039215686274,-104,0.48811829258452355,STL,CIN,2024 REG,7,4,16,11,15,23,0,1,-7,7,1,1,1,1,0,0,0,0,0,0.5118817074154765,0.48811829258452355
94465,0.4484304932735426,0.5983935742971888,123,-149,0.4274331535557258,0.5725668464442741,away,ATL,over,8,0.5121951219512195,-105,0.48808156828023186,PHI,ATL,2024 REG,9,5,7,4,9,16,1,0,1,-1,1,1,1,1,0,0,0,0,0,0.48808156828023186,0.5119184317197681
94465,0.4484304932735426,0.5983935742971888,123,-149,0.4274331535557258,0.5725668464442741,home,PHI,under,8,0.5348837209302326,-115,0.5119184317197681,PHI,ATL,2024 REG,9,5,7,4,9,16,1,0,1,-1,1,1,1,1,0,0,0,0,0,0.48808156828023186,0.5119184317197681
94466,0.5454545454545454,0.5,-120,100,0.5206611570247933,0.4793388429752067,away,CHC,over,8,0.5098039215686274,-104,0.48592421718142587,MIL,CHC,2024 REG,11,3,8,5,8,19,0,1,-2,2,1,1,1,0,0,0,0,0,0,0.48592421718142587,0.5140757828185741
94466,0.5454545454545454,0.5,-120,100,0.5206611570247933,0.4793388429752067,home,MIL,under,8,0.5370370370370371,-116,0.5140757828185741,MIL,CHC,2024 REG,11,3,8,5,8,19,0,1,-2,2,1,1,1,0,0,0,0,0,0,0.48592421718142587,0.5140757828185741
94467,0.576271186440678,0.46511627906976744,-136,115,0.552420782587201,0.44757921741279905,away,LAA,over,9.5,0.5121951219512195,-105,0.48808156828023186,CIN,LAA,2024 REG,5,7,7,1,8,12,1,0,6,-6,1,0,0,0,0,0,0,0,0,0.48808156828023186,0.5119184317197681
94467,0.576271186440678,0.46511627906976744,-136,115,0.552420782587201,0.44757921741279905,home,CIN,under,9.5,0.5348837209302326,-115,0.5119184317197681,CIN,LAA,2024 REG,5,7,7,1,8,12,1,0,6,-6,1,0,0,0,0,0,0,0,0,0.48808156828023186,0.5119184317197681
94468,0.5433789954337899,0.5,-119,100,0.5198077604720502,0.48019223952794976,away,PHI,over,8,0.5238095238095238,-110,0.4988662131519274,ATL,PHI,2024 REG,6,5,7,1,6,13,1,0,4,-4,1,0,0,0,0,0,0,0,0,0.4988662131519274,0.5011337868480725
94468,0.5433789954337899,0.5,-119,100,0.5198077604720502,0.48019223952794976,home,ATL,under,8,0.5238095238095238,-110,0.5011337868480725,ATL,PHI,2024 REG,6,5,7,1,6,13,1,0,4,-4,1,0,0,0,0,0,0,0,0,0.4988662131519274,0.5011337868480725
94469,0.3508771929824561,0.6923076923076923,185,-225,0.3357246016525795,0.6642753983474206,away,LAD,over,9.5,0.5024875621890548,-101,0.47839724939301687,CWS,LAD,2024 REG,8,3,7,4,7,15,0,1,-1,1,1,1,1,0,0,0,0,0,0,0.47839724939301687,0.5216027506069831
94469,0.3508771929824561,0.6923076923076923,185,-225,0.3357246016525795,0.6642753983474206,home,CWS,under,9.5,0.5454545454545454,-120,0.5216027506069831,CWS,LAD,2024 REG,8,3,7,4,7,15,0,1,-1,1,1,1,1,0,0,0,0,0,0,0.47839724939301687,0.5216027506069831
94470,0.6551724137931035,0.3846153846153846,-190,160,0.6291045458703008,0.37089545412969915,away,LAA,over,9,0.5121951219512195,-105,0.48808156828023186,TEX,LAA,2024 REG,5,3,14,9,12,19,0,1,-6,6,1,1,1,0,0,0,0,0,0,0.48808156828023186,0.5119184317197681
94470,0.6551724137931035,0.3846153846153846,-190,160,0.6291045458703008,0.37089545412969915,home,TEX,under,9,0.5348837209302326,-115,0.5119184317197681,TEX,LAA,2024 REG,5,3,14,9,12,19,0,1,-6,6,1,1,1,0,0,0,0,0,0,0.48808156828023186,0.5119184317197681
94471,0.5238095238095238,0.5238095238095238,-110,-110,0.4988662131519274,0.5011337868480725,away,KC,over,8,0.5348837209302326,-115,0.5097020142727117,LAA,KC,2024 REG,6,2,11,4,6,17,0,1,-2,2,1,1,0,0,0,0,0,0,0,0.5097020142727117,0.49029798572728833
94471,0.5238095238095238,0.5238095238095238,-110,-110,0.4988662131519274,0.5011337868480725,home,LAA,under,8,0.5121951219512195,-105,0.49029798572728833,LAA,KC,2024 REG,6,2,11,4,6,17,0,1,-2,2,1,1,0,0,0,0,0,0,0,0.5097020142727117,0.49029798572728833
94473,0.5121951219512195,0.5348837209302326,-105,-115,0.48808156828023186,0.5119184317197681,away,MIL,over,8.5,0.5348837209302326,-115,0.5097020142727117,PIT,MIL,2024 REG,7,2,3,1,3,10,1,0,1,-1,1,0,0,0,0,0,0,0,0,0.5097020142727117,0.49029798572728833
94473,0.5121951219512195,0.5348837209302326,-105,-115,0.48808156828023186,0.5119184317197681,home,PIT,under,8.5,0.5121951219512195,-105,0.49029798572728833,PIT,MIL,2024 REG,7,2,3,1,3,10,1,0,1,-1,1,0,0,0,0,0,0,0,0,0.5097020142727117,0.49029798572728833
94474,0.5918367346938775,0.4484304932735426,-145,123,0.5680051099784656,0.43199489002153435,away,TEX,over,7,0.5121951219512195,-105,0.48808156828023186,SEA,TEX,2024 REG,6,5,2,0,5,8,1,0,5,-5,0,0,0,0,0,0,0,0,0,0.48808156828023186,0.5119184317197681
94474,0.5918367346938775,0.4484304932735426,-145,123,0.5680051099784656,0.43199489002153435,home,SEA,under,7,0.5348837209302326,-115,0.5119184317197681,SEA,TEX,2024 REG,6,5,2,0,5,8,1,0,5,-5,0,0,0,0,0,0,0,0,0,0.48808156828023186,0.5119184317197681
94475,0.6153846153846154,0.425531914893617,-160,135,0.5902052121364724,0.40979478786352763,away,TEX,over,8.5,0.5454545454545454,-120,0.5206611570247933,MIN,TEX,2024 REG,10,3,4,2,5,14,1,0,1,-1,1,1,0,0,0,0,0,0,0,0.5206611570247933,0.4793388429752067
94475,0.6153846153846154,0.425531914893617,-160,135,0.5902052121364724,0.40979478786352763,home,MIN,under,8.5,0.5,100,0.4793388429752067,MIN,TEX,2024 REG,10,3,4,2,5,14,1,0,1,-1,1,1,0,0,0,0,0,0,0,0.5206611570247933,0.4793388429752067
94478,0.6666666666666666,0.37037037037037035,-200,170,0.6419753086419753,0.3580246913580247,away,MIA,over,8.5,0.5433789954337899,-119,0.5171177654451503,NYM,MIA,2024 REG,3,3,8,2,5,11,1,0,1,-1,1,1,0,0,0,0,0,0,0,0.5171177654451503,0.4828822345548497
94478,0.6666666666666666,0.37037037037037035,-200,170,0.6419753086419753,0.3580246913580247,home,NYM,under,8.5,0.504950495049505,-102,0.4828822345548497,NYM,MIA,2024 REG,3,3,8,2,5,11,1,0,1,-1,1,1,0,0,0,0,0,0,0,0.5171177654451503,0.4828822345548497
94479,0.5260663507109005,0.5192307692307692,-111,-108,0.5022370601254724,0.4977629398745276,away,BOS,over,8,0.5121951219512195,-105,0.48808156828023186,CWS,BOS,2024 REG,8,7,6,2,9,14,1,0,5,-5,1,1,0,0,0,0,0,0,0,0.48808156828023186,0.5119184317197681
94479,0.5260663507109005,0.5192307692307692,-111,-108,0.5022370601254724,0.4977629398745276,home,CWS,under,8,0.5348837209302326,-115,0.5119184317197681,CWS,BOS,2024 REG,8,7,6,2,9,14,1,0,5,-5,1,1,0,0,0,0,0,0,0,0.48808156828023186,0.5119184317197681
94480,0.5951417004048584,0.4444444444444444,-147,125,0.5715823348467713,0.42841766515322866,away,COL,over,8,0.5121951219512195,-105,0.48808156828023186,OAK,COL,2024 REG,8,3,12,4,7,20,0,1,-1,1,1,1,1,0,0,0,0,0,0,0.48808156828023186,0.5119184317197681
94480,0.5951417004048584,0.4444444444444444,-147,125,0.5715823348467713,0.42841766515322866,home,OAK,under,8,0.5348837209302326,-115,0.5119184317197681,OAK,COL,2024 REG,8,3,12,4,7,20,0,1,-1,1,1,1,1,0,0,0,0,0,0,0.48808156828023186,0.5119184317197681
94481,0.6655518394648829,0.37735849056603776,-199,165,0.6369927903807584,0.3630072096192416,away,WSH,over,8,0.5121951219512195,-105,0.48808156828023186,TEX,WSH,2024 REG,9,6,4,0,6,13,1,0,6,-6,0,0,0,0,0,0,0,0,0,0.48808156828023186,0.5119184317197681
94481,0.6655518394648829,0.37735849056603776,-199,165,0.6369927903807584,0.3630072096192416,home,TEX,under,8,0.5348837209302326,-115,0.5119184317197681,TEX,WSH,2024 REG,9,6,4,0,6,13,1,0,6,-6,0,0,0,0,0,0,0,0,0,0.48808156828023186,0.5119184317197681
94484,0.5850622406639003,0.45454545454545453,-141,120,0.5618892737571823,0.43811072624281766,away,BOS,over,8,0.5121951219512195,-105,0.48808156828023186,TOR,BOS,2024 REG,10,3,10,7,10,20,0,1,-4,4,1,1,1,0,0,0,0,0,0,0.48808156828023186,0.5119184317197681
94484,0.5850622406639003,0.45454545454545453,-141,120,0.5618892737571823,0.43811072624281766,home,TOR,under,8,0.5348837209302326,-115,0.5119184317197681,TOR,BOS,2024 REG,10,3,10,7,10,20,0,1,-4,4,1,1,1,0,0,0,0,0,0,0.48808156828023186,0.5119184317197681
94486,0.7222222222222222,0.3225806451612903,-260,210,0.6898645957785743,0.3101354042214257,away,NYM,over,9,0.5073891625615764,-103,0.4826927225525911,LAD,NYM,2024 REG,9,10,7,0,10,16,1,0,10,-10,0,0,0,0,0,0,0,0,0,0.4826927225525911,0.5173072774474089
94486,0.7222222222222222,0.3225806451612903,-260,210,0.6898645957785743,0.3101354042214257,home,LAD,under,9,0.5412844036697247,-118,0.5173072774474089,LAD,NYM,2024 REG,9,10,7,0,10,16,1,0,10,-10,0,0,0,0,0,0,0,0,0,0.4826927225525911,0.5173072774474089
94487,0.5412844036697247,0.5,-118,100,0.5189377998484975,0.4810622001515025,away,STL,over,9,0.5412844036697247,-118,0.5136310900085983,WSH,STL,2024 REG,8,0,11,6,6,19,0,1,-6,6,0,0,0,0,0,0,0,0,0,0.5136310900085983,0.4863689099914017
94487,0.5412844036697247,0.5,-118,100,0.5189377998484975,0.4810622001515025,home,WSH,under,9,0.5098039215686274,-104,0.4863689099914017,WSH,STL,2024 REG,8,0,11,6,6,19,0,1,-6,6,0,0,0,0,0,0,0,0,0,0.5136310900085983,0.4863689099914017
94488,0.3717472118959108,0.6666666666666666,169,-200,0.3574669596421646,0.6425330403578354,away,TOR,over,8.5,0.5348837209302326,-115,0.5097020142727117,WSH,TOR,2024 REG,12,9,7,3,12,19,1,0,6,-6,1,1,1,0,0,0,0,0,0,0.5097020142727117,0.49029798572728833
94488,0.3717472118959108,0.6666666666666666,169,-200,0.3574669596421646,0.6425330403578354,home,WSH,under,8.5,0.5121951219512195,-105,0.49029798572728833,WSH,TOR,2024 REG,12,9,7,3,12,19,1,0,6,-6,1,1,1,0,0,0,0,0,0,0.5097020142727117,0.49029798572728833
94489,0.5555555555555556,0.48309178743961345,-125,107,0.5340848094471283,0.46591519055287167,away,TEX,over,8.5,0.5238095238095238,-110,0.4988662131519274,TB,TEX,2024 REG,5,3,8,9,12,13,0,1,-6,6,1,1,1,0,0,0,0,0,0,0.4988662131519274,0.5011337868480725
94489,0.5555555555555556,0.48309178743961345,-125,107,0.5340848094471283,0.46591519055287167,home,TB,under,8.5,0.5238095238095238,-110,0.5011337868480725,TB,TEX,2024 REG,5,3,8,9,12,13,0,1,-6,6,1,1,1,0,0,0,0,0,0,0.4988662131519274,0.5011337868480725
94490,0.42194092827004215,0.6197718631178707,137,-163,0.40434059435109154,0.5956594056489084,away,SF,over,10,0.5283018867924528,-112,0.5044173060022736,COL,SF,2024 REG,4,0,10,5,5,14,0,1,-5,5,0,0,0,0,0,0,0,0,0,0.5044173060022736,0.49558269399772636
94490,0.42194092827004215,0.6197718631178707,137,-163,0.40434059435109154,0.5956594056489084,home,COL,under,10,0.5169082125603864,-107,0.49558269399772636,COL,SF,2024 REG,4,0,10,5,5,14,0,1,-5,5,0,0,0,0,0,0,0,0,0,0.5044173060022736,0.49558269399772636
94492,0.6124031007751938,0.425531914893617,-158,135,0.5891715795516586,0.41082842044834145,away,ARI,over,8,0.5098039215686274,-104,0.48375889301574193,SD,ARI,2024 REG,14,13,5,1,14,19,1,0,12,-12,1,0,0,0,0,0,0,0,0,0.48375889301574193,0.5162411069842581
94492,0.6124031007751938,0.425531914893617,-158,135,0.5891715795516586,0.41082842044834145,home,SD,under,8,0.5412844036697247,-118,0.5162411069842581,SD,ARI,2024 REG,14,13,5,1,14,19,1,0,12,-12,1,0,0,0,0,0,0,0,0,0.48375889301574193,0.5162411069842581
94493,0.5215311004784688,0.5238095238095238,-109,-110,0.4978845547971712,0.5021154452028288,away,TEX,over,8.5,0.5,100,0.4772727272727273,KC,TEX,2024 REG,9,4,17,15,19,26,0,1,-11,11,1,1,1,1,0,0,0,0,0,0.4772727272727273,0.5227272727272727
94493,0.5215311004784688,0.5238095238095238,-109,-110,0.4978845547971712,0.5021154452028288,home,KC,under,8.5,0.5454545454545454,-120,0.5227272727272727,KC,TEX,2024 REG,9,4,17,15,19,26,0,1,-11,11,1,1,1,1,0,0,0,0,0,0.4772727272727273,0.5227272727272727
94495,0.38314176245210724,0.6587030716723549,161,-193,0.3671092589561447,0.6328907410438553,away,LAD,over,11,0.5098039215686274,-104,0.48592421718142587,COL,LAD,2024 REG,11,9,9,11,20,20,0,1,-2,2,1,1,1,1,1,1,1,1,1,0.48592421718142587,0.5140757828185741
94495,0.38314176245210724,0.6587030716723549,161,-193,0.3671092589561447,0.6328907410438553,home,COL,under,11,0.5370370370370371,-116,0.5140757828185741,COL,LAD,2024 REG,11,9,9,11,20,20,0,1,-2,2,1,1,1,1,1,1,1,1,1,0.48592421718142587,0.5140757828185741
94496,0.5145631067961165,0.5283018867924528,-106,-112,0.4925063625223866,0.5074936374776133,away,HOU,over,7.5,0.5348837209302326,-115,0.5097020142727117,CHC,HOU,2024 REG,8,4,10,3,7,18,1,0,1,-1,1,1,1,0,0,0,0,0,0,0.5097020142727117,0.49029798572728833
94496,0.5145631067961165,0.5283018867924528,-106,-112,0.4925063625223866,0.5074936374776133,home,CHC,under,7.5,0.5121951219512195,-105,0.49029798572728833,CHC,HOU,2024 REG,8,4,10,3,7,18,1,0,1,-1,1,1,1,0,0,0,0,0,0,0.5097020142727117,0.49029798572728833
94498,0.5555555555555556,0.4854368932038835,-125,106,0.5327819729114227,0.4672180270885773,away,ARI,over,9,0.5348837209302326,-115,0.5097020142727117,WSH,ARI,2024 REG,4,0,14,5,5,18,0,1,-5,5,0,0,0,0,0,0,0,0,0,0.5097020142727117,0.49029798572728833
94498,0.5555555555555556,0.4854368932038835,-125,106,0.5327819729114227,0.4672180270885773,home,WSH,under,9,0.5121951219512195,-105,0.49029798572728833,WSH,ARI,2024 REG,4,0,14,5,5,18,0,1,-5,5,0,0,0,0,0,0,0,0,0,0.5097020142727117,0.49029798572728833
94500,0.6254681647940076,0.4132231404958678,-167,142,0.6012679850808645,0.39873201491913546,away,COL,over,9,0.5238095238095238,-110,0.5000596729920038,CIN,COL,2024 REG,8,6,4,0,6,12,1,0,6,-6,0,0,0,0,0,0,0,0,0,0.5000596729920038,0.4999403270079962
94500,0.6254681647940076,0.4132231404958678,-167,142,0.6012679850808645,0.39873201491913546,home,CIN,under,9,0.5215311004784688,-109,0.4999403270079962,CIN,COL,2024 REG,8,6,4,0,6,12,1,0,6,-6,0,0,0,0,0,0,0,0,0,0.5000596729920038,0.4999403270079962
94501,0.5454545454545454,0.4926108374384236,-120,103,0.5246916093311078,0.4753083906688922,away,CLE,over,9,0.5454545454545454,-120,0.5206611570247933,TEX,CLE,2024 REG,7,4,7,7,11,14,0,1,-3,3,1,1,1,1,0,0,0,0,0,0.5206611570247933,0.4793388429752067
94501,0.5454545454545454,0.4926108374384236,-120,103,0.5246916093311078,0.4753083906688922,home,TEX,under,9,0.5,100,0.4793388429752067,TEX,CLE,2024 REG,7,4,7,7,11,14,0,1,-3,3,1,1,1,1,0,0,0,0,0,0.5206611570247933,0.4793388429752067
94503,0.6153846153846154,0.425531914893617,-160,135,0.5902052121364724,0.40979478786352763,away,PIT,over,8.5,0.504950495049505,-102,0.47949844489399435,MIL,PIT,2024 REG,10,4,3,3,7,13,1,0,1,-1,1,1,1,0,0,0,0,0,0,0.47949844489399435,0.5205015551060057
94503,0.6153846153846154,0.425531914893617,-160,135,0.5902052121364724,0.40979478786352763,home,MIL,under,8.5,0.5454545454545454,-120,0.5205015551060057,MIL,PIT,2024 REG,10,4,3,3,7,13,1,0,1,-1,1,1,1,0,0,0,0,0,0,0.47949844489399435,0.5205015551060057
94504,0.6666666666666666,0.373134328358209,-200,168,0.6401326699834162,0.3598673300165838,away,SF,over,8,0.5238095238095238,-110,0.4988662131519274,ATL,SF,2024 REG,6,3,9,5,8,15,0,1,-2,2,1,1,1,0,0,0,0,0,0,0.4988662131519274,0.5011337868480725
94504,0.6666666666666666,0.373134328358209,-200,168,0.6401326699834162,0.3598673300165838,home,ATL,under,8,0.5238095238095238,-110,0.5011337868480725,ATL,SF,2024 REG,6,3,9,5,8,15,0,1,-2,2,1,1,1,0,0,0,0,0,0,0.4988662131519274,0.5011337868480725
94505,0.5780590717299579,0.46511627906976744,-137,115,0.5531011685250534,0.4468988314749466,away,NYM,over,8,0.5412844036697247,-118,0.5149381613977361,TEX,NYM,2024 REG,6,2,22,14,16,28,0,1,-12,12,1,1,0,0,0,0,0,0,0,0.5149381613977361,0.48506183860226393
94505,0.5780590717299579,0.46511627906976744,-137,115,0.5531011685250534,0.4468988314749466,home,TEX,under,8,0.5073891625615764,-103,0.48506183860226393,TEX,NYM,2024 REG,6,2,22,14,16,28,0,1,-12,12,1,1,0,0,0,0,0,0,0,0.5149381613977361,0.48506183860226393
94506,0.5238095238095238,0.5215311004784688,-110,-109,0.5000596729920038,0.4999403270079962,away,PIT,over,7.5,0.49504950495049505,102,0.46999749479898484,SF,PIT,2024 REG,8,3,5,2,5,13,1,0,1,-1,1,1,0,0,0,0,0,0,0,0.46999749479898484,0.5300025052010151
94506,0.5238095238095238,0.5215311004784688,-110,-109,0.5000596729920038,0.4999403270079962,home,SF,under,7.5,0.5555555555555556,-125,0.5300025052010151,SF,PIT,2024 REG,8,3,5,2,5,13,1,0,1,-1,1,1,0,0,0,0,0,0,0,0.46999749479898484,0.5300025052010151
94510,0.6323529411764706,0.41152263374485604,-172,143,0.604608092329161,0.395391907670839,away,DET,over,7.5,0.5238095238095238,-110,0.4988662131519274,NYY,DET,2024 REG,6,2,5,1,3,11,1,0,1,-1,1,0,0,0,0,0,0,0,0,0.4988662131519274,0.5011337868480725
94510,0.6323529411764706,0.41152263374485604,-172,143,0.604608092329161,0.395391907670839,home,NYY,under,7.5,0.5238095238095238,-110,0.5011337868480725,NYY,DET,2024 REG,6,2,5,1,3,11,1,0,1,-1,1,0,0,0,0,0,0,0,0,0.4988662131519274,0.5011337868480725
94511,0.5652173913043479,0.47619047619047616,-130,110,0.5418129444594474,0.4581870555405526,away,CWS,over,9,0.5238095238095238,-110,0.4988662131519274,KC,CWS,2024 REG,5,5,12,3,8,17,1,0,2,-2,1,1,1,0,0,0,0,0,0,0.4988662131519274,0.5011337868480725
94511,0.5652173913043479,0.47619047619047616,-130,110,0.5418129444594474,0.4581870555405526,home,KC,under,9,0.5238095238095238,-110,0.5011337868480725,KC,CWS,2024 REG,5,5,12,3,8,17,1,0,2,-2,1,1,1,0,0,0,0,0,0,0.4988662131519274,0.5011337868480725
94512,0.626865671641791,0.4098360655737705,-168,144,0.6038586124917376,0.39614138750826244,away,STL,over,8.5,0.5475113122171946,-121,0.5214983313199976,LAD,STL,2024 REG,8,5,8,4,9,16,1,0,1,-1,1,1,1,1,0,0,0,0,0,0.5214983313199976,0.47850166868000243
94512,0.626865671641791,0.4098360655737705,-168,144,0.6038586124917376,0.39614138750826244,home,LAD,under,8.5,0.5,100,0.47850166868000243,LAD,STL,2024 REG,8,5,8,4,9,16,1,0,1,-1,1,1,1,1,0,0,0,0,0,0.5214983313199976,0.47850166868000243
94513,0.4081632653061224,0.6363636363636364,145,-175,0.3899890197266291,0.6100109802733709,away,KC,over,8,0.5238095238095238,-110,0.5000596729920038,LAA,KC,2024 REG,10,9,8,3,12,18,1,0,6,-6,1,1,1,0,0,0,0,0,0,0.5000596729920038,0.4999403270079962
94513,0.4081632653061224,0.6363636363636364,145,-175,0.3899890197266291,0.6100109802733709,home,LAA,under,8,0.5215311004784688,-109,0.4999403270079962,LAA,KC,2024 REG,10,9,8,3,12,18,1,0,6,-6,1,1,1,0,0,0,0,0,0,0.5000596729920038,0.4999403270079962
94514,0.5305164319248826,0.5121951219512195,-113,-105,0.5078572507605655,0.49214274923943446,away,SEA,over,8,0.5391705069124424,-117,0.5114756747601454,TOR,SEA,2024 REG,11,5,6,3,8,17,1,0,2,-2,1,1,1,0,0,0,0,0,0,0.5114756747601454,0.48852432523985456
94514,0.5305164319248826,0.5121951219512195,-113,-105,0.5078572507605655,0.49214274923943446,home,TOR,under,8,0.5121951219512195,-105,0.48852432523985456,TOR,SEA,2024 REG,11,5,6,3,8,17,1,0,2,-2,1,1,1,0,0,0,0,0,0,0.5114756747601454,0.48852432523985456
94515,0.5348837209302326,0.5121951219512195,-115,-105,0.5097020142727117,0.49029798572728833,away,ATL,over,9,0.5238095238095238,-110,0.4988662131519274,LAD,ATL,2024 REG,9,4,6,3,7,15,1,0,1,-1,1,1,1,0,0,0,0,0,0,0.4988662131519274,0.5011337868480725
94515,0.5348837209302326,0.5121951219512195,-115,-105,0.5097020142727117,0.49029798572728833,home,LAD,under,9,0.5238095238095238,-110,0.5011337868480725,LAD,ATL,2024 REG,9,4,6,3,7,15,1,0,1,-1,1,1,1,0,0,0,0,0,0,0.4988662131519274,0.5011337868480725
94520,0.5867768595041323,0.45454545454545453,-142,120,0.5625298818386723,0.43747011816132775,away,STL,over,8.5,0.5454545454545454,-120,0.5206611570247933,ARI,STL,2024 REG,7,5,4,0,5,11,1,0,5,-5,0,0,0,0,0,0,0,0,0,0.5206611570247933,0.4793388429752067
94520,0.5867768595041323,0.45454545454545453,-142,120,0.5625298818386723,0.43747011816132775,home,ARI,under,8.5,0.5,100,0.4793388429752067,ARI,STL,2024 REG,7,5,4,0,5,11,1,0,5,-5,0,0,0,0,0,0,0,0,0,0.5206611570247933,0.4793388429752067
94521,0.5,0.5412844036697247,100,-118,0.47935779816513757,0.5206422018348624,away,CLE,over,7.5,0.5,100,0.4772727272727273,KC,CLE,2024 REG,6,2,9,7,9,15,0,1,-5,5,1,1,0,0,0,0,0,0,0,0.4772727272727273,0.5227272727272727
94521,0.5,0.5412844036697247,100,-118,0.47935779816513757,0.5206422018348624,home,KC,under,7.5,0.5454545454545454,-120,0.5227272727272727,KC,CLE,2024 REG,6,2,9,7,9,15,0,1,-5,5,1,1,0,0,0,0,0,0,0,0.4772727272727273,0.5227272727272727
94522,0.47619047619047616,0.5652173913043479,110,-130,0.4564724440500838,0.5435275559499162,away,MIN,over,7.5,0.5454545454545454,-120,0.5206611570247933,ARI,MIN,2024 REG,8,5,6,4,9,14,1,0,1,-1,1,1,1,1,0,0,0,0,0,0.5206611570247933,0.4793388429752067
94522,0.47619047619047616,0.5652173913043479,110,-130,0.4564724440500838,0.5435275559499162,home,ARI,under,7.5,0.5,100,0.4793388429752067,ARI,MIN,2024 REG,8,5,6,4,9,14,1,0,1,-1,1,1,1,1,0,0,0,0,0,0.5206611570247933,0.4793388429752067
94528,0.5726495726495727,0.4672897196261683,-134,114,0.5497783539959433,0.4502216460040567,away,TB,over,8,0.5348837209302326,-115,0.5097020142727117,BOS,TB,2024 REG,8,3,7,4,7,15,0,1,-1,1,1,1,1,0,0,0,0,0,0,0.5097020142727117,0.49029798572728833
94528,0.5726495726495727,0.4672897196261683,-134,114,0.5497783539959433,0.4502216460040567,home,BOS,under,8,0.5121951219512195,-105,0.49029798572728833,BOS,TB,2024 REG,8,3,7,4,7,15,0,1,-1,1,1,1,1,0,0,0,0,0,0,0.5097020142727117,0.49029798572728833
94529,0.5708154506437768,0.4694835680751174,-133,113,0.5478121481132493,0.4521878518867507,away,DET,over,6.5,0.5121951219512195,-105,0.48808156828023186,NYY,DET,2024 REG,9,5,5,2,7,14,1,0,3,-3,1,1,0,0,0,0,0,0,0,0.48808156828023186,0.5119184317197681
94529,0.5708154506437768,0.4694835680751174,-133,113,0.5478121481132493,0.4521878518867507,home,NYY,under,6.5,0.5348837209302326,-115,0.5119184317197681,NYY,DET,2024 REG,9,5,5,2,7,14,1,0,3,-3,1,1,0,0,0,0,0,0,0,0.48808156828023186,0.5119184317197681
94530,0.5918367346938775,0.4464285714285714,-145,124,0.5691899208663057,0.4308100791336943,away,MIL,over,8.5,0.5024875621890548,-101,0.47839724939301687,BAL,MIL,2024 REG,12,5,15,11,16,27,0,1,-6,6,1,1,1,1,1,0,0,0,0,0.47839724939301687,0.5216027506069831
94530,0.5918367346938775,0.4464285714285714,-145,124,0.5691899208663057,0.4308100791336943,home,BAL,under,8.5,0.5454545454545454,-120,0.5216027506069831,BAL,MIL,2024 REG,12,5,15,11,16,27,0,1,-6,6,1,1,1,1,1,0,0,0,0,0.47839724939301687,0.5216027506069831
94531,0.3968253968253968,0.6428571428571428,152,-180,0.3810783572688335,0.6189216427311666,away,LAD,over,7.5,0.5327102803738317,-114,0.508788710910954,WSH,LAD,2024 REG,7,1,9,2,3,16,0,1,-1,1,1,0,0,0,0,0,0,0,0,0.508788710910954,0.491211289089046
94531,0.3968253968253968,0.6428571428571428,152,-180,0.3810783572688335,0.6189216427311666,home,WSH,under,7.5,0.5121951219512195,-105,0.491211289089046,WSH,LAD,2024 REG,7,1,9,2,3,16,0,1,-1,1,1,0,0,0,0,0,0,0,0,0.508788710910954,0.491211289089046
94537,0.5652173913043479,0.47619047619047616,-130,110,0.5418129444594474,0.4581870555405526,away,STL,over,9.5,0.5098039215686274,-104,0.48592421718142587,CIN,STL,2024 REG,4,1,13,7,8,17,0,1,-6,6,1,0,0,0,0,0,0,0,0,0.48592421718142587,0.5140757828185741
94537,0.5652173913043479,0.47619047619047616,-130,110,0.5418129444594474,0.4581870555405526,home,CIN,under,9.5,0.5370370370370371,-116,0.5140757828185741,CIN,STL,2024 REG,4,1,13,7,8,17,0,1,-6,6,1,0,0,0,0,0,0,0,0,0.48592421718142587,0.5140757828185741
94539,0.646643109540636,0.39370078740157477,-183,154,0.6205550065709379,0.3794449934290621,away,CIN,over,9.5,0.5098039215686274,-104,0.48375889301574193,NYY,CIN,2024 REG,7,4,9,8,12,16,0,1,-4,4,1,1,1,1,0,0,0,0,0,0.48375889301574193,0.5162411069842581
94539,0.646643109540636,0.39370078740157477,-183,154,0.6205550065709379,0.3794449934290621,home,NYY,under,9.5,0.5412844036697247,-118,0.5162411069842581,NYY,CIN,2024 REG,7,4,9,8,12,16,0,1,-4,4,1,1,1,1,0,0,0,0,0,0.48375889301574193,0.5162411069842581
94540,0.5670995670995671,0.4739336492890995,-131,111,0.5438296478488513,0.45617035215114865,away,CHC,over,9,0.5348837209302326,-115,0.5097020142727117,TEX,CHC,2024 REG,8,5,12,9,14,20,0,1,-4,4,1,1,1,1,1,0,0,0,0,0.5097020142727117,0.49029798572728833
94540,0.5670995670995671,0.4739336492890995,-131,111,0.5438296478488513,0.45617035215114865,home,TEX,under,9,0.5121951219512195,-105,0.49029798572728833,TEX,CHC,2024 REG,8,5,12,9,14,20,0,1,-4,4,1,1,1,1,1,0,0,0,0,0.5097020142727117,0.49029798572728833
94543,0.6226415094339623,0.4166666666666667,-165,140,0.5981666073335706,0.40183339266642937,away,DET,over,8,0.5121951219512195,-105,0.48808156828023186,HOU,DET,2024 REG,5,4,3,1,5,8,1,0,3,-3,1,0,0,0,0,0,0,0,0,0.48808156828023186,0.5119184317197681
94543,0.6226415094339623,0.4166666666666667,-165,140,0.5981666073335706,0.40183339266642937,home,HOU,under,8,0.5348837209302326,-115,0.5119184317197681,HOU,DET,2024 REG,5,4,3,1,5,8,1,0,3,-3,1,0,0,0,0,0,0,0,0,0.48808156828023186,0.5119184317197681
94544,0.5433789954337899,0.5,-119,100,0.5198077604720502,0.48019223952794976,away,HOU,over,8.5,0.5454545454545454,-120,0.5206611570247933,NYM,HOU,2024 REG,11,6,10,9,15,21,0,1,-3,3,1,1,1,1,1,1,0,0,0,0.5206611570247933,0.4793388429752067
94544,0.5433789954337899,0.5,-119,100,0.5198077604720502,0.48019223952794976,home,NYM,under,8.5,0.5,100,0.4793388429752067,NYM,HOU,2024 REG,11,6,10,9,15,21,0,1,-3,3,1,1,1,1,1,1,0,0,0,0.5206611570247933,0.4793388429752067
94545,0.5475113122171946,0.49504950495049505,-121,102,0.5242087833606768,0.4757912166393232,away,NYY,over,8,0.5412844036697247,-118,0.5149381613977361,TB,NYY,2024 REG,10,1,6,2,3,16,0,1,-1,1,1,0,0,0,0,0,0,0,0,0.5149381613977361,0.48506183860226393
94545,0.5475113122171946,0.49504950495049505,-121,102,0.5242087833606768,0.4757912166393232,home,TB,under,8,0.5073891625615764,-103,0.48506183860226393,TB,NYY,2024 REG,10,1,6,2,3,16,0,1,-1,1,1,0,0,0,0,0,0,0,0,0.5149381613977361,0.48506183860226393
94546,0.6389891696750902,0.4,-177,150,0.614075512518083,0.385924487481917,away,TEX,over,9,0.5121951219512195,-105,0.48808156828023186,BAL,TEX,2024 REG,7,2,13,11,13,20,0,1,-9,9,1,1,0,0,0,0,0,0,0,0.48808156828023186,0.5119184317197681
94546,0.6389891696750902,0.4,-177,150,0.614075512518083,0.385924487481917,home,BAL,under,9,0.5348837209302326,-115,0.5119184317197681,BAL,TEX,2024 REG,7,2,13,11,13,20,0,1,-9,9,1,1,0,0,0,0,0,0,0,0.48808156828023186,0.5119184317197681
94547,0.5454545454545454,0.5,-120,100,0.5206611570247933,0.4793388429752067,away,TEX,over,8.5,0.5024875621890548,-101,0.4794401874631478,BAL,TEX,2024 REG,5,2,4,1,3,9,1,0,1,-1,1,0,0,0,0,0,0,0,0,0.4794401874631478,0.5205598125368522
94547,0.5454545454545454,0.5,-120,100,0.5206611570247933,0.4793388429752067,home,BAL,under,8.5,0.5433789954337899,-119,0.5205598125368522,BAL,TEX,2024 REG,5,2,4,1,3,9,1,0,1,-1,1,0,0,0,0,0,0,0,0,0.4794401874631478,0.5205598125368522
94550,0.5,0.5454545454545454,100,-120,0.4772727272727273,0.5227272727272727,away,BOS,over,8.5,0.5305164319248826,-113,0.5066009958897986,LAA,BOS,2024 REG,8,2,12,12,14,20,0,1,-10,10,1,1,0,0,0,0,0,0,0,0.5066009958897986,0.49339900411020143
94550,0.5,0.5454545454545454,100,-120,0.4772727272727273,0.5227272727272727,home,LAA,under,8.5,0.5145631067961165,-106,0.49339900411020143,LAA,BOS,2024 REG,8,2,12,12,14,20,0,1,-10,10,1,1,0,0,0,0,0,0,0,0.5066009958897986,0.49339900411020143
94552,0.607843137254902,0.4347826086956522,-155,130,0.5819333701084867,0.41806662989151333,away,LAA,over,8.5,0.5098039215686274,-104,0.48592421718142587,CLE,LAA,2024 REG,5,4,6,1,5,11,1,0,3,-3,1,0,0,0,0,0,0,0,0,0.48592421718142587,0.5140757828185741
94552,0.607843137254902,0.4347826086956522,-155,130,0.5819333701084867,0.41806662989151333,home,CLE,under,8.5,0.5370370370370371,-116,0.5140757828185741,CLE,LAA,2024 REG,5,4,6,1,5,11,1,0,3,-3,1,0,0,0,0,0,0,0,0,0.48592421718142587,0.5140757828185741
94555,0.7118155619596541,0.33112582781456956,-247,202,0.6812492124661865,0.3187507875338135,away,OAK,over,8.5,0.5121951219512195,-105,0.48808156828023186,NYY,OAK,2024 REG,11,7,4,3,10,15,1,0,4,-4,1,1,1,0,0,0,0,0,0,0.48808156828023186,0.5119184317197681
94555,0.7118155619596541,0.33112582781456956,-247,202,0.6812492124661865,0.3187507875338135,home,NYY,under,8.5,0.5348837209302326,-115,0.5119184317197681,NYY,OAK,2024 REG,11,7,4,3,10,15,1,0,4,-4,1,1,1,0,0,0,0,0,0,0.48808156828023186,0.5119184317197681
94558,0.6515679442508712,0.390625,-187,156,0.6240763743034393,0.3759236256965607,away,COL,over,9.5,0.5238095238095238,-110,0.4988662131519274,ARI,COL,2024 REG,8,4,10,9,13,18,0,1,-5,5,1,1,1,1,0,0,0,0,0,0.4988662131519274,0.5011337868480725
94558,0.6515679442508712,0.390625,-187,156,0.6240763743034393,0.3759236256965607,home,ARI,under,9.5,0.5238095238095238,-110,0.5011337868480725,ARI,COL,2024 REG,8,4,10,9,13,18,0,1,-5,5,1,1,1,1,0,0,0,0,0,0.4988662131519274,0.5011337868480725
94559,0.4566210045662101,0.5815899581589958,119,-139,0.4391730763811846,0.5608269236188155,away,TEX,over,8.5,0.5495495495495495,-122,0.5250401592387142,MIA,TEX,2024 REG,12,8,6,2,10,18,1,0,6,-6,1,1,0,0,0,0,0,0,0,0.5250401592387142,0.47495984076128583
94559,0.4566210045662101,0.5815899581589958,119,-139,0.4391730763811846,0.5608269236188155,home,MIA,under,8.5,0.49504950495049505,102,0.47495984076128583,MIA,TEX,2024 REG,12,8,6,2,10,18,1,0,6,-6,1,1,0,0,0,0,0,0,0,0.5250401592387142,0.47495984076128583
94560,0.5,0.5454545454545454,100,-120,0.4772727272727273,0.5227272727272727,away,KC,over,8,0.5283018867924528,-112,0.5031902949311281,TB,KC,2024 REG,4,1,12,8,9,16,0,1,-7,7,1,0,0,0,0,0,0,0,0,0.5031902949311281,0.4968097050688719
94560,0.5,0.5454545454545454,100,-120,0.4772727272727273,0.5227272727272727,home,TB,under,8,0.5192307692307692,-108,0.4968097050688719,TB,KC,2024 REG,4,1,12,8,9,16,0,1,-7,7,1,0,0,0,0,0,0,0,0,0.5031902949311281,0.4968097050688719
94562,0.5348837209302326,0.5098039215686274,-115,-104,0.5109810284308424,0.48901897156915763,away,MIL,over,8.5,0.5260663507109005,-111,0.5010269332605688,DET,MIL,2024 REG,2,0,16,10,10,18,0,1,-10,10,0,0,0,0,0,0,0,0,0,0.5010269332605688,0.4989730667394312
94562,0.5348837209302326,0.5098039215686274,-115,-104,0.5109810284308424,0.48901897156915763,home,DET,under,8.5,0.5215311004784688,-109,0.4989730667394312,DET,MIL,2024 REG,2,0,16,10,10,18,0,1,-10,10,0,0,0,0,0,0,0,0,0,0.5010269332605688,0.4989730667394312
94563,0.6551724137931035,0.3861003861003861,-190,159,0.6281316138628862,0.3718683861371138,away,OAK,over,8.5,0.5454545454545454,-120,0.5206611570247933,HOU,OAK,2024 REG,6,2,7,1,3,13,1,0,1,-1,1,0,0,0,0,0,0,0,0,0.5206611570247933,0.4793388429752067
94563,0.6551724137931035,0.3861003861003861,-190,159,0.6281316138628862,0.3718683861371138,home,HOU,under,8.5,0.5,100,0.4793388429752067,HOU,OAK,2024 REG,6,2,7,1,3,13,1,0,1,-1,1,0,0,0,0,0,0,0,0,0.5206611570247933,0.4793388429752067
94564,0.6000000000000001,0.43859649122807015,-150,128,0.5768421052631579,0.42315789473684207,away,PHI,over,8.5,0.5,100,0.4772727272727273,CIN,PHI,2024 REG,10,7,11,4,11,21,1,0,3,-3,1,1,1,1,0,0,0,0,0,0.4772727272727273,0.5227272727272727
94564,0.6000000000000001,0.43859649122807015,-150,128,0.5768421052631579,0.42315789473684207,home,CIN,under,8.5,0.5454545454545454,-120,0.5227272727272727,CIN,PHI,2024 REG,10,7,11,4,11,21,1,0,3,-3,1,1,1,1,0,0,0,0,0,0.4772727272727273,0.5227272727272727
94568,0.5833333333333333,0.45454545454545453,-140,120,0.5612373737373737,0.4387626262626263,away,SF,over,7.5,0.5305164319248826,-113,0.5066009958897986,SD,SF,2024 REG,9,3,13,8,11,22,0,1,-5,5,1,1,1,0,0,0,0,0,0,0.5066009958897986,0.49339900411020143
94568,0.5833333333333333,0.45454545454545453,-140,120,0.5612373737373737,0.4387626262626263,home,SD,under,7.5,0.5145631067961165,-106,0.49339900411020143,SD,SF,2024 REG,9,3,13,8,11,22,0,1,-5,5,1,1,1,0,0,0,0,0,0,0.5066009958897986,0.49339900411020143
94572,0.4081632653061224,0.635036496350365,145,-174,0.39053070952796426,0.6094692904720358,away,TOR,over,7.5,0.5348837209302326,-115,0.5097020142727117,WSH,TOR,2024 REG,6,3,9,6,9,15,0,1,-3,3,1,1,1,0,0,0,0,0,0,0.5097020142727117,0.49029798572728833
94572,0.4081632653061224,0.635036496350365,145,-174,0.39053070952796426,0.6094692904720358,home,WSH,under,7.5,0.5121951219512195,-105,0.49029798572728833,WSH,TOR,2024 REG,6,3,9,6,9,15,0,1,-3,3,1,1,1,0,0,0,0,0,0,0.5097020142727117,0.49029798572728833
94573,0.5833333333333333,0.4566210045662101,-140,119,0.5600266362252664,0.4399733637747336,away,CIN,over,7.5,0.5,100,0.4772727272727273,CHC,CIN,2024 REG,6,7,10,5,12,16,1,0,2,-2,1,1,1,1,1,0,0,0,0,0.4772727272727273,0.5227272727272727
94573,0.5833333333333333,0.4566210045662101,-140,119,0.5600266362252664,0.4399733637747336,home,CHC,under,7.5,0.5454545454545454,-120,0.5227272727272727,CHC,CIN,2024 REG,6,7,10,5,12,16,1,0,2,-2,1,1,1,1,1,0,0,0,0,0.4772727272727273,0.5227272727272727
94574,0.7237569060773481,0.3205128205128205,-262,212,0.6917163857275576,0.30828361427244244,away,COL,over,8.5,0.5073891625615764,-103,0.48484779035144243,LAD,COL,2024 REG,8,4,5,0,4,13,1,0,4,-4,0,0,0,0,0,0,0,0,0,0.48484779035144243,0.5151522096485576
94574,0.7237569060773481,0.3205128205128205,-262,212,0.6917163857275576,0.30828361427244244,home,LAD,under,8.5,0.5370370370370371,-116,0.5151522096485576,LAD,COL,2024 REG,8,4,5,0,4,13,1,0,4,-4,0,0,0,0,0,0,0,0,0,0.48484779035144243,0.5151522096485576
94575,0.5983935742971888,0.43859649122807015,-149,128,0.5762589567740419,0.42374104322595807,away,PIT,over,7.5,0.5348837209302326,-115,0.5097020142727117,TOR,PIT,2024 REG,6,1,11,8,9,17,0,1,-7,7,1,0,0,0,0,0,0,0,0,0.5097020142727117,0.49029798572728833
94575,0.5983935742971888,0.43859649122807015,-149,128,0.5762589567740419,0.42374104322595807,home,TOR,under,7.5,0.5121951219512195,-105,0.49029798572728833,TOR,PIT,2024 REG,6,1,11,8,9,17,0,1,-7,7,1,0,0,0,0,0,0,0,0,0.5097020142727117,0.49029798572728833
94578,0.5850622406639003,0.45454545454545453,-141,120,0.5618892737571823,0.43811072624281766,away,DET,over,7.5,0.504950495049505,-102,0.4826715732667395,NYM,DET,2024 REG,6,3,9,6,9,15,0,1,-3,3,1,1,1,0,0,0,0,0,0,0.4826715732667395,0.5173284267332605
94578,0.5850622406639003,0.45454545454545453,-141,120,0.5618892737571823,0.43811072624281766,home,NYM,under,7.5,0.5391705069124424,-117,0.5173284267332605,NYM,DET,2024 REG,6,3,9,6,9,15,0,1,-3,3,1,1,1,0,0,0,0,0,0,0.4826715732667395,0.5173284267332605
94580,0.5121951219512195,0.5348837209302326,-105,-115,0.48808156828023186,0.5119184317197681,away,SF,over,8,0.5348837209302326,-115,0.5097020142727117,TB,SF,2024 REG,10,9,10,4,13,20,1,0,5,-5,1,1,1,1,0,0,0,0,0,0.5097020142727117,0.49029798572728833
94580,0.5121951219512195,0.5348837209302326,-105,-115,0.48808156828023186,0.5119184317197681,home,TB,under,8,0.5121951219512195,-105,0.49029798572728833,TB,SF,2024 REG,10,9,10,4,13,20,1,0,5,-5,1,1,1,1,0,0,0,0,0,0.5097020142727117,0.49029798572728833
94581,0.5454545454545454,0.5,-120,100,0.5206611570247933,0.4793388429752067,away,MIN,over,8.5,0.5238095238095238,-110,0.4988662131519274,BAL,MIN,2024 REG,8,4,5,2,6,13,1,0,2,-2,1,1,0,0,0,0,0,0,0,0.4988662131519274,0.5011337868480725
94581,0.5454545454545454,0.5,-120,100,0.5206611570247933,0.4793388429752067,home,BAL,under,8.5,0.5238095238095238,-110,0.5011337868480725,BAL,MIN,2024 REG,8,4,5,2,6,13,1,0,2,-2,1,1,0,0,0,0,0,0,0,0.4988662131519274,0.5011337868480725
94582,0.5454545454545454,0.5,-120,100,0.5206611570247933,0.4793388429752067,away,CIN,over,8.5,0.5121951219512195,-105,0.48808156828023186,TEX,CIN,2024 REG,7,4,10,8,12,17,0,1,-4,4,1,1,1,1,0,0,0,0,0,0.48808156828023186,0.5119184317197681
94582,0.5454545454545454,0.5,-120,100,0.5206611570247933,0.4793388429752067,home,TEX,under,8.5,0.5348837209302326,-115,0.5119184317197681,TEX,CIN,2024 REG,7,4,10,8,12,17,0,1,-4,4,1,1,1,1,0,0,0,0,0,0.48808156828023186,0.5119184317197681
94583,0.6323529411764706,0.4081632653061224,-172,145,0.6067323988418897,0.3932676011581103,away,CWS,over,7,0.5348837209302326,-115,0.5097020142727117,MIL,CWS,2024 REG,7,4,8,3,7,15,1,0,1,-1,1,1,1,0,0,0,0,0,0,0.5097020142727117,0.49029798572728833
94583,0.6323529411764706,0.4081632653061224,-172,145,0.6067323988418897,0.3932676011581103,home,MIL,under,7,0.5121951219512195,-105,0.49029798572728833,MIL,CWS,2024 REG,7,4,8,3,7,15,1,0,1,-1,1,1,1,0,0,0,0,0,0,0.5097020142727117,0.49029798572728833
94587,0.7481108312342569,0.29411764705882354,-297,240,0.7165192492366628,0.28348075076333723,away,CWS,over,8,0.5238095238095238,-110,0.4988662131519274,NYY,CWS,2024 REG,9,6,6,1,7,15,1,0,5,-5,1,0,0,0,0,0,0,0,0,0.4988662131519274,0.5011337868480725
94587,0.7481108312342569,0.29411764705882354,-297,240,0.7165192492366628,0.28348075076333723,home,NYY,under,8,0.5238095238095238,-110,0.5011337868480725,NYY,CWS,2024 REG,9,6,6,1,7,15,1,0,5,-5,1,0,0,0,0,0,0,0,0,0.4988662131519274,0.5011337868480725
94591,0.4807692307692307,0.5614035087719298,108,-128,0.4604938752205958,0.5395061247794042,away,NYM,over,9,0.5024875621890548,-101,0.4794401874631478,WSH,NYM,2024 REG,9,7,5,5,12,14,1,0,2,-2,1,1,1,1,1,0,0,0,0,0.4794401874631478,0.5205598125368522
94591,0.4807692307692307,0.5614035087719298,108,-128,0.4604938752205958,0.5395061247794042,home,WSH,under,9,0.5433789954337899,-119,0.5205598125368522,WSH,NYM,2024 REG,9,7,5,5,12,14,1,0,2,-2,1,1,1,1,1,0,0,0,0,0.4794401874631478,0.5205598125368522
94595,0.5967741935483871,0.4444444444444444,-148,125,0.5721759741010521,0.42782402589894786,away,KC,over,8,0.5145631067961165,-106,0.4891195935000339,TEX,KC,2024 REG,9,6,6,2,8,15,1,0,4,-4,1,1,0,0,0,0,0,0,0,0.4891195935000339,0.5108804064999661
94595,0.5967741935483871,0.4444444444444444,-148,125,0.5721759741010521,0.42782402589894786,home,TEX,under,8,0.5348837209302326,-115,0.5108804064999661,TEX,KC,2024 REG,9,6,6,2,8,15,1,0,4,-4,1,1,0,0,0,0,0,0,0,0.4891195935000339,0.5108804064999661
94597,0.6875,0.35714285714285715,-220,180,0.6568080357142857,0.3431919642857143,away,LAA,over,8,0.5454545454545454,-120,0.5179608869977906,HOU,LAA,2024 REG,10,7,13,9,16,23,0,1,-2,2,1,1,1,1,1,1,1,0,0,0.5179608869977906,0.48203911300220936
94597,0.6875,0.35714285714285715,-220,180,0.6568080357142857,0.3431919642857143,home,HOU,under,8,0.504950495049505,-102,0.48203911300220936,HOU,LAA,2024 REG,10,7,13,9,16,23,0,1,-2,2,1,1,1,1,1,1,1,0,0,0.5179608869977906,0.48203911300220936
94599,0.5433789954337899,0.5,-119,100,0.5198077604720502,0.48019223952794976,away,SD,over,8,0.5121951219512195,-105,0.48808156828023186,SF,SD,2024 REG,4,0,5,4,4,9,0,1,-4,4,0,0,0,0,0,0,0,0,0,0.48808156828023186,0.5119184317197681
94599,0.5433789954337899,0.5,-119,100,0.5198077604720502,0.48019223952794976,home,SF,under,8,0.5348837209302326,-115,0.5119184317197681,SF,SD,2024 REG,4,0,5,4,4,9,0,1,-4,4,0,0,0,0,0,0,0,0,0,0.48808156828023186,0.5119184317197681
94601,0.5454545454545454,0.5,-120,100,0.5206611570247933,0.4793388429752067,away,SF,over,9,0.5327102803738317,-114,0.508788710910954,ARI,SF,2024 REG,13,8,6,5,13,19,1,0,3,-3,1,1,1,1,1,0,0,0,0,0.508788710910954,0.491211289089046
94601,0.5454545454545454,0.5,-120,100,0.5206611570247933,0.4793388429752067,home,ARI,under,9,0.5121951219512195,-105,0.491211289089046,ARI,SF,2024 REG,13,8,6,5,13,19,1,0,3,-3,1,1,1,1,1,0,0,0,0,0.508788710910954,0.491211289089046
94603,0.5,0.5454545454545454,100,-120,0.4772727272727273,0.5227272727272727,away,BOS,over,8.5,0.5305164319248826,-113,0.5066009958897986,STL,BOS,2024 REG,14,7,6,2,9,20,1,0,5,-5,1,1,0,0,0,0,0,0,0,0.5066009958897986,0.49339900411020143
94603,0.5,0.5454545454545454,100,-120,0.4772727272727273,0.5227272727272727,home,STL,under,8.5,0.5145631067961165,-106,0.49339900411020143,STL,BOS,2024 REG,14,7,6,2,9,20,1,0,5,-5,1,1,0,0,0,0,0,0,0,0.5066009958897986,0.49339900411020143
94604,0.5238095238095238,0.5238095238095238,-110,-110,0.4988662131519274,0.5011337868480725,away,SF,over,8.5,0.5098039215686274,-104,0.48375889301574193,PHI,SF,2024 REG,9,5,7,4,9,16,1,0,1,-1,1,1,1,1,0,0,0,0,0,0.48375889301574193,0.5162411069842581
94604,0.5238095238095238,0.5238095238095238,-110,-110,0.4988662131519274,0.5011337868480725,home,PHI,under,8.5,0.5412844036697247,-118,0.5162411069842581,PHI,SF,2024 REG,9,5,7,4,9,16,1,0,1,-1,1,1,1,1,0,0,0,0,0,0.48375889301574193,0.5162411069842581
94605,0.3333333333333333,0.7076023391812866,200,-242,0.31968810916179335,0.6803118908382066,away,PHI,over,10.5,0.5121951219512195,-105,0.48808156828023186,COL,PHI,2024 REG,9,4,12,8,12,21,0,1,-4,4,1,1,1,1,0,0,0,0,0,0.48808156828023186,0.5119184317197681
94605,0.3333333333333333,0.7076023391812866,200,-242,0.31968810916179335,0.6803118908382066,home,COL,under,10.5,0.5348837209302326,-115,0.5119184317197681,COL,PHI,2024 REG,9,4,12,8,12,21,0,1,-4,4,1,1,1,1,0,0,0,0,0,0.48808156828023186,0.5119184317197681
94606,0.38759689922480617,0.6539792387543253,158,-189,0.3714821170623521,0.6285178829376479,away,ATL,over,9,0.5121951219512195,-105,0.48808156828023186,CWS,ATL,2024 REG,7,3,5,2,5,12,1,0,1,-1,1,1,0,0,0,0,0,0,0,0.48808156828023186,0.5119184317197681
94606,0.38759689922480617,0.6539792387543253,158,-189,0.3714821170623521,0.6285178829376479,home,CWS,under,9,0.5348837209302326,-115,0.5119184317197681,CWS,ATL,2024 REG,7,3,5,2,5,12,1,0,1,-1,1,1,0,0,0,0,0,0,0,0.48808156828023186,0.5119184317197681
94609,0.5901639344262295,0.4484304932735426,-144,123,0.5673868951280033,0.43261310487199667,away,SF,over,7.5,0.5348837209302326,-115,0.5097020142727117,NYM,SF,2024 REG,9,7,9,8,15,18,0,1,-1,1,1,1,1,1,1,1,1,0,0,0.5097020142727117,0.49029798572728833
94609,0.5901639344262295,0.4484304932735426,-144,123,0.5673868951280033,0.43261310487199667,home,NYM,under,7.5,0.5121951219512195,-105,0.49029798572728833,NYM,SF,2024 REG,9,7,9,8,15,18,0,1,-1,1,1,1,1,1,1,1,1,0,0,0.5097020142727117,0.49029798572728833
94610,0.4444444444444444,0.5951417004048584,125,-147,0.4268506022891988,0.5731493977108012,away,TEX,over,10.5,0.5454545454545454,-120,0.5206611570247933,COL,TEX,2024 REG,7,3,9,1,4,16,1,0,2,-2,1,0,0,0,0,0,0,0,0,0.5206611570247933,0.4793388429752067
94610,0.4444444444444444,0.5951417004048584,125,-147,0.4268506022891988,0.5731493977108012,home,COL,under,10.5,0.5,100,0.4793388429752067,COL,TEX,2024 REG,7,3,9,1,4,16,1,0,2,-2,1,0,0,0,0,0,0,0,0,0.5206611570247933,0.4793388429752067
94611,0.613899613899614,0.4273504273504274,-159,134,0.5885762295028705,0.4114237704971295,away,CLE,over,9,0.5454545454545454,-120,0.5206611570247933,BAL,CLE,2024 REG,16,8,14,10,18,30,0,1,-2,2,1,1,1,1,1,1,1,1,0,0.5206611570247933,0.4793388429752067
94611,0.613899613899614,0.4273504273504274,-159,134,0.5885762295028705,0.4114237704971295,home,BAL,under,9,0.5,100,0.4793388429752067,BAL,CLE,2024 REG,16,8,14,10,18,30,0,1,-2,2,1,1,1,1,1,1,1,1,0,0.5206611570247933,0.4793388429752067
94615,0.5238095238095238,0.5238095238095238,-110,-110,0.4988662131519274,0.5011337868480725,away,TOR,over,8,0.5454545454545454,-120,0.5206611570247933,SD,TOR,2024 REG,5,1,11,5,6,16,0,1,-4,4,1,0,0,0,0,0,0,0,0,0.5206611570247933,0.4793388429752067
94615,0.5238095238095238,0.5238095238095238,-110,-110,0.4988662131519274,0.5011337868480725,home,SD,under,8,0.5,100,0.4793388429752067,SD,TOR,2024 REG,5,1,11,5,6,16,0,1,-4,4,1,0,0,0,0,0,0,0,0,0.5206611570247933,0.4793388429752067
94616,0.48780487804878053,0.5555555555555556,105,-125,0.4666534470222751,0.5333465529777248,away,TEX,over,8,0.5283018867924528,-112,0.5031902949311281,DET,TEX,2024 REG,5,4,6,2,6,11,1,0,2,-2,1,1,0,0,0,0,0,0,0,0.5031902949311281,0.4968097050688719
94616,0.48780487804878053,0.5555555555555556,105,-125,0.4666534470222751,0.5333465529777248,home,DET,under,8,0.5192307692307692,-108,0.4968097050688719,DET,TEX,2024 REG,5,4,6,2,6,11,1,0,2,-2,1,1,0,0,0,0,0,0,0,0.5031902949311281,0.4968097050688719
94617,0.6610169491525424,0.3802281368821293,-195,163,0.6337532482143695,0.3662467517856305,away,SD,over,8.5,0.5475113122171946,-121,0.5214983313199976,LAD,SD,2024 REG,16,11,17,15,26,33,0,1,-4,4,1,1,1,1,1,1,1,1,1,0.5214983313199976,0.47850166868000243
94617,0.6610169491525424,0.3802281368821293,-195,163,0.6337532482143695,0.3662467517856305,home,LAD,under,8.5,0.5,100,0.47850166868000243,LAD,SD,2024 REG,16,11,17,15,26,33,0,1,-4,4,1,1,1,1,1,1,1,1,1,0.5214983313199976,0.47850166868000243
94618,0.5454545454545454,0.49751243781094534,-120,101,0.5220180091279142,0.4779819908720858,away,STL,over,7.5,0.5169082125603864,-107,0.49239402434819424,CHC,STL,2024 REG,3,0,9,3,3,12,0,1,-3,3,0,0,0,0,0,0,0,0,0,0.49239402434819424,0.5076059756518058
94618,0.5454545454545454,0.49751243781094534,-120,101,0.5220180091279142,0.4779819908720858,home,CHC,under,7.5,0.5305164319248826,-113,0.5076059756518058,CHC,STL,2024 REG,3,0,9,3,3,12,0,1,-3,3,0,0,0,0,0,0,0,0,0,0.49239402434819424,0.5076059756518058
94619,0.4166666666666667,0.6226415094339623,140,-165,0.4002882599580712,0.5997117400419287,away,SEA,over,8,0.5327102803738317,-114,0.5075272610403079,OAK,SEA,2024 REG,5,2,4,1,3,9,1,0,1,-1,1,0,0,0,0,0,0,0,0,0.5075272610403079,0.4924727389596921
94619,0.4166666666666667,0.6226415094339623,140,-165,0.4002882599580712,0.5997117400419287,home,OAK,under,8,0.5145631067961165,-106,0.4924727389596921,OAK,SEA,2024 REG,5,2,4,1,3,9,1,0,1,-1,1,0,0,0,0,0,0,0,0,0.5075272610403079,0.4924727389596921
94620,0.4329004329004329,0.607843137254902,131,-155,0.41526252374227923,0.5847374762577208,away,PHI,over,7.5,0.5348837209302326,-115,0.5097020142727117,WSH,PHI,2024 REG,8,3,5,2,5,13,1,0,1,-1,1,1,0,0,0,0,0,0,0,0.5097020142727117,0.49029798572728833
94620,0.4329004329004329,0.607843137254902,131,-155,0.41526252374227923,0.5847374762577208,home,WSH,under,7.5,0.5121951219512195,-105,0.49029798572728833,WSH,PHI,2024 REG,8,3,5,2,5,13,1,0,1,-1,1,1,0,0,0,0,0,0,0,0.5097020142727117,0.49029798572728833
94623,0.45248868778280543,0.5918367346938775,121,-145,0.4324319355309127,0.5675680644690873,away,LAD,over,7.5,0.5454545454545454,-120,0.5206611570247933,TOR,LAD,2024 REG,3,2,11,4,6,14,0,1,-2,2,1,1,0,0,0,0,0,0,0,0.5206611570247933,0.4793388429752067
94623,0.45248868778280543,0.5918367346938775,121,-145,0.4324319355309127,0.5675680644690873,home,TOR,under,7.5,0.5,100,0.4793388429752067,TOR,LAD,2024 REG,3,2,11,4,6,14,0,1,-2,2,1,1,0,0,0,0,0,0,0,0.5206611570247933,0.4793388429752067
94624,0.5726495726495727,0.46511627906976744,-134,115,0.5510229738017454,0.44897702619825464,away,PIT,over,9,0.5475113122171946,-121,0.5214983313199976,PHI,PIT,2024 REG,7,5,7,1,6,14,1,0,4,-4,1,0,0,0,0,0,0,0,0,0.5214983313199976,0.47850166868000243
94624,0.5726495726495727,0.46511627906976744,-134,115,0.5510229738017454,0.44897702619825464,home,PHI,under,9,0.5,100,0.47850166868000243,PHI,PIT,2024 REG,7,5,7,1,6,14,1,0,4,-4,1,0,0,0,0,0,0,0,0,0.5214983313199976,0.47850166868000243
94625,0.5391705069124424,0.5073891625615764,-117,-103,0.5140669063204599,0.4859330936795401,away,STL,over,10.5,0.5238095238095238,-110,0.4988662131519274,ARI,STL,2024 REG,6,4,11,2,6,17,1,0,2,-2,1,1,0,0,0,0,0,0,0,0.4988662131519274,0.5011337868480725
94625,0.5391705069124424,0.5073891625615764,-117,-103,0.5140669063204599,0.4859330936795401,home,ARI,under,10.5,0.5238095238095238,-110,0.5011337868480725,ARI,STL,2024 REG,6,4,11,2,6,17,1,0,2,-2,1,1,0,0,0,0,0,0,0,0.4988662131519274,0.5011337868480725
94626,0.4065040650406504,0.6363636363636364,146,-175,0.389078170160859,0.610921829839141,away,ARI,over,9.5,0.5121951219512195,-105,0.48808156828023186,WSH,ARI,2024 REG,6,3,4,1,4,10,1,0,2,-2,1,0,0,0,0,0,0,0,0,0.48808156828023186,0.5119184317197681
94626,0.4065040650406504,0.6363636363636364,146,-175,0.389078170160859,0.610921829839141,home,WSH,under,9.5,0.5348837209302326,-115,0.5119184317197681,WSH,ARI,2024 REG,6,3,4,1,4,10,1,0,2,-2,1,0,0,0,0,0,0,0,0,0.48808156828023186,0.5119184317197681
94628,0.4132231404958678,0.626865671641791,142,-168,0.39665751564559554,0.6033424843544044,away,LAD,over,12,0.5391705069124424,-117,0.5140669063204599,COL,LAD,2024 REG,6,5,14,9,14,20,0,1,-4,4,1,1,1,1,1,0,0,0,0,0.5140669063204599,0.4859330936795401
94628,0.4132231404958678,0.626865671641791,142,-168,0.39665751564559554,0.6033424843544044,home,COL,under,12,0.5073891625615764,-103,0.4859330936795401,COL,LAD,2024 REG,6,5,14,9,14,20,0,1,-4,4,1,1,1,1,1,0,0,0,0,0.5140669063204599,0.4859330936795401
94630,0.5951417004048584,0.4444444444444444,-147,125,0.5715823348467713,0.42841766515322866,away,BOS,over,7,0.5454545454545454,-120,0.5206611570247933,SEA,BOS,2024 REG,4,1,4,0,1,8,1,0,1,-1,0,0,0,0,0,0,0,0,0,0.5206611570247933,0.4793388429752067
94630,0.5951417004048584,0.4444444444444444,-147,125,0.5715823348467713,0.42841766515322866,home,SEA,under,7,0.5,100,0.4793388429752067,SEA,BOS,2024 REG,4,1,4,0,1,8,1,0,1,-1,0,0,0,0,0,0,0,0,0,0.5206611570247933,0.4793388429752067
94631,0.5098039215686274,0.5348837209302326,-104,-115,0.4870219861770517,0.5129780138229483,away,SF,over,8.5,0.5283018867924528,-112,0.5031902949311281,MIA,SF,2024 REG,10,3,8,4,7,18,0,1,-1,1,1,1,1,0,0,0,0,0,0,0.5031902949311281,0.4968097050688719
94631,0.5098039215686274,0.5348837209302326,-104,-115,0.4870219861770517,0.5129780138229483,home,MIA,under,8.5,0.5192307692307692,-108,0.4968097050688719,MIA,SF,2024 REG,10,3,8,4,7,18,0,1,-1,1,1,1,1,0,0,0,0,0,0,0.5031902949311281,0.4968097050688719
94632,0.7014925373134329,0.3389830508474576,-235,195,0.6730992142751963,0.32690078572480374,away,CWS,over,9,0.5454545454545454,-120,0.5206611570247933,KC,CWS,2024 REG,10,3,3,0,3,13,1,0,3,-3,0,0,0,0,0,0,0,0,0,0.5206611570247933,0.4793388429752067
94632,0.7014925373134329,0.3389830508474576,-235,195,0.6730992142751963,0.32690078572480374,home,KC,under,9,0.5,100,0.4793388429752067,KC,CWS,2024 REG,10,3,3,0,3,13,1,0,3,-3,0,0,0,0,0,0,0,0,0,0.5206611570247933,0.4793388429752067
94633,0.48780487804878053,0.5535714285714286,105,-124,0.4676213138438005,0.5323786861561994,away,PIT,over,7.5,0.5260663507109005,-111,0.5010269332605688,OAK,PIT,2024 REG,8,5,2,1,6,10,1,0,4,-4,1,0,0,0,0,0,0,0,0,0.5010269332605688,0.4989730667394312
94633,0.48780487804878053,0.5535714285714286,105,-124,0.4676213138438005,0.5323786861561994,home,OAK,under,7.5,0.5215311004784688,-109,0.4989730667394312,OAK,PIT,2024 REG,8,5,2,1,6,10,1,0,4,-4,1,0,0,0,0,0,0,0,0,0.5010269332605688,0.4989730667394312
94634,0.6226415094339623,0.4166666666666667,-165,140,0.5981666073335706,0.40183339266642937,away,TB,over,8.5,0.5145631067961165,-106,0.49023796582517226,TOR,TB,2024 REG,4,3,8,4,7,12,0,1,-1,1,1,1,1,0,0,0,0,0,0,0.49023796582517226,0.5097620341748277
94634,0.6226415094339623,0.4166666666666667,-165,140,0.5981666073335706,0.40183339266642937,home,TOR,under,8.5,0.5327102803738317,-114,0.5097620341748277,TOR,TB,2024 REG,4,3,8,4,7,12,0,1,-1,1,1,1,1,0,0,0,0,0,0,0.49023796582517226,0.5097620341748277
94635,0.5,0.5454545454545454,100,-120,0.4772727272727273,0.5227272727272727,away,TEX,over,8,0.5283018867924528,-112,0.5031902949311281,HOU,TEX,2024 REG,9,1,4,2,3,13,0,1,-1,1,1,0,0,0,0,0,0,0,0,0.5031902949311281,0.4968097050688719
94635,0.5,0.5454545454545454,100,-120,0.4772727272727273,0.5227272727272727,home,HOU,under,8,0.5192307692307692,-108,0.4968097050688719,HOU,TEX,2024 REG,9,1,4,2,3,13,0,1,-1,1,1,0,0,0,0,0,0,0,0,0.5031902949311281,0.4968097050688719
94636,0.5555555555555556,0.48780487804878053,-125,105,0.5314664257753688,0.46853357422463116,away,TB,over,9,0.5238095238095238,-110,0.4988662131519274,ATL,TB,2024 REG,9,6,8,8,14,17,0,1,-2,2,1,1,1,1,1,1,0,0,0,0.4988662131519274,0.5011337868480725
94636,0.5555555555555556,0.48780487804878053,-125,105,0.5314664257753688,0.46853357422463116,home,ATL,under,9,0.5238095238095238,-110,0.5011337868480725,ATL,TB,2024 REG,9,6,8,8,14,17,0,1,-2,2,1,1,1,1,1,1,0,0,0,0.4988662131519274,0.5011337868480725
94637,0.5652173913043479,0.47619047619047616,-130,110,0.5418129444594474,0.4581870555405526,away,TOR,over,9.5,0.5145631067961165,-106,0.49023796582517226,BOS,TOR,2024 REG,5,4,11,9,13,16,0,1,-5,5,1,1,1,1,0,0,0,0,0,0.49023796582517226,0.5097620341748277
94637,0.5652173913043479,0.47619047619047616,-130,110,0.5418129444594474,0.4581870555405526,home,BOS,under,9.5,0.5327102803738317,-114,0.5097620341748277,BOS,TOR,2024 REG,5,4,11,9,13,16,0,1,-5,5,1,1,1,1,0,0,0,0,0,0.49023796582517226,0.5097620341748277
94638,0.504950495049505,0.5370370370370371,-102,-116,0.4837488699364985,0.5162511300635015,away,NYY,over,8.5,0.5073891625615764,-103,0.4826927225525911,KC,NYY,2024 REG,7,2,9,4,6,16,0,1,-2,2,1,1,0,0,0,0,0,0,0,0.4826927225525911,0.5173072774474089
94638,0.504950495049505,0.5370370370370371,-102,-116,0.4837488699364985,0.5162511300635015,home,KC,under,8.5,0.5412844036697247,-118,0.5173072774474089,KC,NYY,2024 REG,7,2,9,4,6,16,0,1,-2,2,1,1,0,0,0,0,0,0,0,0.4826927225525911,0.5173072774474089
94639,0.5780590717299579,0.4608294930875576,-137,117,0.5555791840506346,0.44442081594936544,away,SEA,over,7.5,0.5,100,0.4762443438914027,KC,SEA,2024 REG,9,5,10,6,11,19,0,1,-1,1,1,1,1,1,1,0,0,0,0,0.4762443438914027,0.5237556561085973
94639,0.5780590717299579,0.4608294930875576,-137,117,0.5555791840506346,0.44442081594936544,home,KC,under,7.5,0.5475113122171946,-121,0.5237556561085973,KC,SEA,2024 REG,9,5,10,6,11,19,0,1,-1,1,1,1,1,1,1,0,0,0,0,0.4762443438914027,0.5237556561085973
94641,0.4347826086956522,0.6062992125984252,130,-154,0.4169209472634447,0.5830790527365552,away,LAD,over,8.5,0.5454545454545454,-120,0.5193043049216726,NYY,LAD,2024 REG,5,1,4,2,3,9,0,1,-1,1,1,0,0,0,0,0,0,0,0,0.5193043049216726,0.48069569507832743
94641,0.4347826086956522,0.6062992125984252,130,-154,0.4169209472634447,0.5830790527365552,home,NYY,under,8.5,0.5024875621890548,-101,0.48069569507832743,NYY,LAD,2024 REG,5,1,4,2,3,9,0,1,-1,1,1,0,0,0,0,0,0,0,0,0.5193043049216726,0.48069569507832743
94644,0.6226415094339623,0.4166666666666667,-165,140,0.5981666073335706,0.40183339266642937,away,HOU,over,9.5,0.5145631067961165,-106,0.4913668392989033,NYY,HOU,2024 REG,11,9,11,4,13,22,1,0,5,-5,1,1,1,1,0,0,0,0,0,0.4913668392989033,0.5086331607010968
94644,0.6226415094339623,0.4166666666666667,-165,140,0.5981666073335706,0.40183339266642937,home,NYY,under,9.5,0.5305164319248826,-113,0.5086331607010968,NYY,HOU,2024 REG,11,9,11,4,13,22,1,0,5,-5,1,1,1,1,0,0,0,0,0,0.4913668392989033,0.5086331607010968
94645,0.5652173913043479,0.47619047619047616,-130,110,0.5418129444594474,0.4581870555405526,away,CIN,over,8.5,0.5454545454545454,-120,0.5206611570247933,STL,CIN,2024 REG,4,1,4,0,1,8,1,0,1,-1,0,0,0,0,0,0,0,0,0,0.5206611570247933,0.4793388429752067
94645,0.5652173913043479,0.47619047619047616,-130,110,0.5418129444594474,0.4581870555405526,home,STL,under,8.5,0.5,100,0.4793388429752067,STL,CIN,2024 REG,4,1,4,0,1,8,1,0,1,-1,0,0,0,0,0,0,0,0,0,0.5206611570247933,0.4793388429752067
94647,0.607843137254902,0.4347826086956522,-155,130,0.5819333701084867,0.41806662989151333,away,SEA,over,7.5,0.5348837209302326,-115,0.5097020142727117,NYY,SEA,2024 REG,11,5,3,0,5,14,1,0,5,-5,0,0,0,0,0,0,0,0,0,0.5097020142727117,0.49029798572728833
94647,0.607843137254902,0.4347826086956522,-155,130,0.5819333701084867,0.41806662989151333,home,NYY,under,7.5,0.5121951219512195,-105,0.49029798572728833,NYY,SEA,2024 REG,11,5,3,0,5,14,1,0,5,-5,0,0,0,0,0,0,0,0,0,0.5097020142727117,0.49029798572728833
94649,0.7058823529411764,0.3389830508474576,-240,195,0.6742126561491995,0.32578734385080055,away,COL,over,8,0.5238095238095238,-110,0.4988662131519274,TOR,COL,2024 REG,11,4,20,12,16,31,0,1,-8,8,1,1,1,1,0,0,0,0,0,0.4988662131519274,0.5011337868480725
94649,0.7058823529411764,0.3389830508474576,-240,195,0.6742126561491995,0.32578734385080055,home,TOR,under,8,0.5238095238095238,-110,0.5011337868480725,TOR,COL,2024 REG,11,4,20,12,16,31,0,1,-8,8,1,1,1,1,0,0,0,0,0,0.4988662131519274,0.5011337868480725
94650,0.6825396825396826,0.35714285714285715,-215,180,0.6554547745023935,0.34454522549760647,away,CWS,over,9,0.5,100,0.4772727272727273,CLE,CWS,2024 REG,7,7,9,6,13,16,1,0,1,-1,1,1,1,1,1,1,0,0,0,0.4772727272727273,0.5227272727272727
94650,0.6825396825396826,0.35714285714285715,-215,180,0.6554547745023935,0.34454522549760647,home,CLE,under,9,0.5454545454545454,-120,0.5227272727272727,CLE,CWS,2024 REG,7,7,9,6,13,16,1,0,1,-1,1,1,1,1,1,1,0,0,0,0.4772727272727273,0.5227272727272727
94654,0.6415770609318996,0.4,-179,150,0.6149021723770248,0.3850978276229752,away,CHC,over,8.5,0.5348837209302326,-115,0.5097020142727117,BAL,CHC,2024 REG,9,0,11,4,4,20,0,1,-4,4,0,0,0,0,0,0,0,0,0,0.5097020142727117,0.49029798572728833
94654,0.6415770609318996,0.4,-179,150,0.6149021723770248,0.3850978276229752,home,BAL,under,8.5,0.5121951219512195,-105,0.49029798572728833,BAL,CHC,2024 REG,9,0,11,4,4,20,0,1,-4,4,0,0,0,0,0,0,0,0,0,0.5097020142727117,0.49029798572728833
94655,0.5918367346938775,0.4484304932735426,-145,123,0.5680051099784656,0.43199489002153435,away,TEX,over,8.5,0.5475113122171946,-121,0.5214983313199976,MIN,TEX,2024 REG,7,5,5,3,8,12,1,0,2,-2,1,1,1,0,0,0,0,0,0,0.5214983313199976,0.47850166868000243
94655,0.5918367346938775,0.4484304932735426,-145,123,0.5680051099784656,0.43199489002153435,home,MIN,under,8.5,0.5,100,0.47850166868000243,MIN,TEX,2024 REG,7,5,5,3,8,12,1,0,2,-2,1,1,1,0,0,0,0,0,0,0.5214983313199976,0.47850166868000243
94657,0.39840637450199207,0.6428571428571428,151,-180,0.3819667261517391,0.6180332738482609,away,LAD,over,9.5,0.5327102803738317,-114,0.5075272610403079,WSH,LAD,2024 REG,3,2,20,11,13,23,0,1,-9,9,1,1,0,0,0,0,0,0,0,0.5075272610403079,0.4924727389596921
94657,0.39840637450199207,0.6428571428571428,151,-180,0.3819667261517391,0.6180332738482609,home,WSH,under,9.5,0.5145631067961165,-106,0.4924727389596921,WSH,LAD,2024 REG,3,2,20,11,13,23,0,1,-9,9,1,1,0,0,0,0,0,0,0,0.5075272610403079,0.4924727389596921
94658,0.5833333333333333,0.45454545454545453,-140,120,0.5612373737373737,0.4387626262626263,away,NYM,over,7.5,0.5454545454545454,-120,0.5206611570247933,PIT,NYM,2024 REG,16,14,5,2,16,21,1,0,12,-12,1,1,0,0,0,0,0,0,0,0.5206611570247933,0.4793388429752067
94658,0.5833333333333333,0.45454545454545453,-140,120,0.5612373737373737,0.4387626262626263,home,PIT,under,7.5,0.5,100,0.4793388429752067,PIT,NYM,2024 REG,16,14,5,2,16,21,1,0,12,-12,1,1,0,0,0,0,0,0,0,0.5206611570247933,0.4793388429752067
94659,0.5708154506437768,0.4694835680751174,-133,113,0.5478121481132493,0.4521878518867507,away,NYM,over,9,0.5,100,0.4772727272727273,CIN,NYM,2024 REG,7,2,4,3,5,11,0,1,-1,1,1,1,0,0,0,0,0,0,0,0.4772727272727273,0.5227272727272727
94659,0.5708154506437768,0.4694835680751174,-133,113,0.5478121481132493,0.4521878518867507,home,CIN,under,9,0.5454545454545454,-120,0.5227272727272727,CIN,NYM,2024 REG,7,2,4,3,5,11,0,1,-1,1,1,1,0,0,0,0,0,0,0,0.4772727272727273,0.5227272727272727
94660,0.4587155963302753,0.5798319327731092,118,-138,0.4410332435305576,0.5589667564694424,away,PHI,over,7.5,0.5454545454545454,-120,0.5206611570247933,STL,PHI,2024 REG,7,3,8,4,7,15,0,1,-1,1,1,1,1,0,0,0,0,0,0,0.5206611570247933,0.4793388429752067
94660,0.4587155963302753,0.5798319327731092,118,-138,0.4410332435305576,0.5589667564694424,home,STL,under,7.5,0.5,100,0.4793388429752067,STL,PHI,2024 REG,7,3,8,4,7,15,0,1,-1,1,1,1,1,0,0,0,0,0,0,0.5206611570247933,0.4793388429752067
94661,0.635036496350365,0.4081632653061224,-174,145,0.6076030710648583,0.39239692893514166,away,WSH,over,9.5,0.5145631067961165,-106,0.4913668392989033,CIN,WSH,2024 REG,14,6,9,5,11,23,1,0,1,-1,1,1,1,1,1,0,0,0,0,0.4913668392989033,0.5086331607010968
94661,0.635036496350365,0.4081632653061224,-174,145,0.6076030710648583,0.39239692893514166,home,CIN,under,9.5,0.5305164319248826,-113,0.5086331607010968,CIN,WSH,2024 REG,14,6,9,5,11,23,1,0,1,-1,1,1,1,1,1,0,0,0,0,0.4913668392989033,0.5086331607010968
94662,0.6441281138790036,0.4,-181,150,0.6157039551170831,0.3842960448829169,away,MIL,over,9.5,0.5,100,0.4762443438914027,LAD,MIL,2024 REG,7,2,12,9,11,19,0,1,-7,7,1,1,0,0,0,0,0,0,0,0.4762443438914027,0.5237556561085973
94662,0.6441281138790036,0.4,-181,150,0.6157039551170831,0.3842960448829169,home,LAD,under,9.5,0.5475113122171946,-121,0.5237556561085973,LAD,MIL,2024 REG,7,2,12,9,11,19,0,1,-7,7,1,1,0,0,0,0,0,0,0,0.4762443438914027,0.5237556561085973
94664,0.4739336492890995,0.5670995670995671,111,-131,0.4544866273039494,0.5455133726960506,away,MIL,over,7,0.5391705069124424,-117,0.5114756747601454,MIA,MIL,2024 REG,4,1,4,0,1,8,1,0,1,-1,0,0,0,0,0,0,0,0,0,0.5114756747601454,0.48852432523985456
94664,0.4739336492890995,0.5670995670995671,111,-131,0.4544866273039494,0.5455133726960506,home,MIA,under,7,0.5121951219512195,-105,0.48852432523985456,MIA,MIL,2024 REG,4,1,4,0,1,8,1,0,1,-1,0,0,0,0,0,0,0,0,0,0.5114756747601454,0.48852432523985456
94666,0.5670995670995671,0.4739336492890995,-131,111,0.5438296478488513,0.45617035215114865,away,CHC,over,7,0.5305164319248826,-113,0.5053568787472517,PIT,CHC,2024 REG,7,2,14,7,9,21,0,1,-5,5,1,1,0,0,0,0,0,0,0,0.5053568787472517,0.49464312125274834
94666,0.5670995670995671,0.4739336492890995,-131,111,0.5438296478488513,0.45617035215114865,home,PIT,under,7,0.5169082125603864,-107,0.49464312125274834,PIT,CHC,2024 REG,7,2,14,7,9,21,0,1,-5,5,1,1,0,0,0,0,0,0,0,0.5053568787472517,0.49464312125274834
94667,0.6923076923076923,0.35460992907801414,-225,182,0.6598262621175878,0.34017373788241223,away,COL,over,7.5,0.5145631067961165,-106,0.4913668392989033,SF,COL,2024 REG,9,4,3,1,5,12,1,0,3,-3,1,0,0,0,0,0,0,0,0,0.4913668392989033,0.5086331607010968
94667,0.6923076923076923,0.35460992907801414,-225,182,0.6598262621175878,0.34017373788241223,home,SF,under,7.5,0.5305164319248826,-113,0.5086331607010968,SF,COL,2024 REG,9,4,3,1,5,12,1,0,3,-3,1,0,0,0,0,0,0,0,0,0.4913668392989033,0.5086331607010968
94672,0.4081632653061224,0.6323529411764706,145,-172,0.39162603817037017,0.6083739618296298,away,KC,over,10.5,0.504950495049505,-102,0.4826715732667395,COL,KC,2024 REG,6,1,12,10,11,18,0,1,-9,9,1,0,0,0,0,0,0,0,0,0.4826715732667395,0.5173284267332605
94672,0.4081632653061224,0.6323529411764706,145,-172,0.39162603817037017,0.6083739618296298,home,COL,under,10.5,0.5391705069124424,-117,0.5173284267332605,COL,KC,2024 REG,6,1,12,10,11,18,0,1,-9,9,1,0,0,0,0,0,0,0,0,0.4826715732667395,0.5173284267332605
94673,0.4854368932038835,0.5555555555555556,106,-125,0.465537646233282,0.534462353766718,away,SEA,over,8,0.5192307692307692,-108,0.49455035168025013,WSH,SEA,2024 REG,8,6,5,1,7,13,1,0,5,-5,1,0,0,0,0,0,0,0,0,0.49455035168025013,0.5054496483197499
94673,0.4854368932038835,0.5555555555555556,106,-125,0.465537646233282,0.534462353766718,home,WSH,under,8,0.5283018867924528,-112,0.5054496483197499,WSH,SEA,2024 REG,8,6,5,1,7,13,1,0,5,-5,1,0,0,0,0,0,0,0,0,0.49455035168025013,0.5054496483197499
94675,0.5260663507109005,0.5169082125603864,-111,-107,0.5034588790373798,0.49654112096262015,away,TB,over,8.5,0.5283018867924528,-112,0.5044173060022736,PIT,TB,2024 REG,5,4,5,3,7,10,1,0,1,-1,1,1,1,0,0,0,0,0,0,0.5044173060022736,0.49558269399772636
94675,0.5260663507109005,0.5169082125603864,-111,-107,0.5034588790373798,0.49654112096262015,home,PIT,under,8.5,0.5169082125603864,-107,0.49558269399772636,PIT,TB,2024 REG,5,4,5,3,7,10,1,0,1,-1,1,1,1,0,0,0,0,0,0,0.5044173060022736,0.49558269399772636
94676,0.35714285714285715,0.6865203761755486,180,-219,0.34154884524342655,0.6584511547565735,away,MIN,over,9,0.5348837209302326,-115,0.5097020142727117,CWS,MIN,2024 REG,7,6,15,8,14,22,0,1,-2,2,1,1,1,1,1,1,0,0,0,0.5097020142727117,0.49029798572728833
94676,0.35714285714285715,0.6865203761755486,180,-219,0.34154884524342655,0.6584511547565735,home,CWS,under,9,0.5121951219512195,-105,0.49029798572728833,CWS,MIN,2024 REG,7,6,15,8,14,22,0,1,-2,2,1,1,1,1,1,1,0,0,0,0.5097020142727117,0.49029798572728833
94677,0.576271186440678,0.4629629629629629,-136,116,0.553661676614851,0.446338323385149,away,WSH,over,7.5,0.5238095238095238,-110,0.4988662131519274,TB,WSH,2024 REG,2,1,13,8,9,15,0,1,-7,7,1,0,0,0,0,0,0,0,0,0.4988662131519274,0.5011337868480725
94677,0.576271186440678,0.4629629629629629,-136,116,0.553661676614851,0.446338323385149,home,TB,under,7.5,0.5238095238095238,-110,0.5011337868480725,TB,WSH,2024 REG,2,1,13,8,9,15,0,1,-7,7,1,0,0,0,0,0,0,0,0,0.4988662131519274,0.5011337868480725
94679,0.7198879551820728,0.3225806451612903,-257,210,0.6893153213214445,0.31068467867855554,away,CWS,over,7.5,0.5024875621890548,-101,0.4794401874631478,SEA,CWS,2024 REG,6,2,3,1,3,9,1,0,1,-1,1,0,0,0,0,0,0,0,0,0.4794401874631478,0.5205598125368522
94679,0.7198879551820728,0.3225806451612903,-257,210,0.6893153213214445,0.31068467867855554,home,SEA,under,7.5,0.5433789954337899,-119,0.5205598125368522,SEA,CWS,2024 REG,6,2,3,1,3,9,1,0,1,-1,1,0,0,0,0,0,0,0,0,0.4794401874631478,0.5205598125368522
94681,0.5934959349593496,0.4484304932735426,-146,123,0.5686127702357632,0.4313872297642368,away,PIT,over,6.5,0.5555555555555556,-125,0.5314664257753688,DET,PIT,2024 REG,10,8,3,0,8,13,1,0,8,-8,0,0,0,0,0,0,0,0,0,0.5314664257753688,0.46853357422463116
94681,0.5934959349593496,0.4484304932735426,-146,123,0.5686127702357632,0.4313872297642368,home,DET,under,6.5,0.48780487804878053,105,0.46853357422463116,DET,PIT,2024 REG,10,8,3,0,8,13,1,0,8,-8,0,0,0,0,0,0,0,0,0,0.5314664257753688,0.46853357422463116
94682,0.5555555555555556,0.49019607843137253,-125,104,0.5301379811183733,0.4698620188816267,away,PIT,over,8,0.5348837209302326,-115,0.5097020142727117,CHC,PIT,2024 REG,7,4,7,5,9,14,0,1,-1,1,1,1,1,1,0,0,0,0,0,0.5097020142727117,0.49029798572728833
94682,0.5555555555555556,0.49019607843137253,-125,104,0.5301379811183733,0.4698620188816267,home,CHC,under,8,0.5121951219512195,-105,0.49029798572728833,CHC,PIT,2024 REG,7,4,7,5,9,14,0,1,-1,1,1,1,1,1,0,0,0,0,0,0.5097020142727117,0.49029798572728833
94683,0.7023809523809524,0.3389830508474576,-236,195,0.6733276643990929,0.32667233560090714,away,STL,over,8.5,0.5348837209302326,-115,0.5097020142727117,LAD,STL,2024 REG,14,5,6,6,11,20,0,1,-1,1,1,1,1,1,1,0,0,0,0,0.5097020142727117,0.49029798572728833
94683,0.7023809523809524,0.3389830508474576,-236,195,0.6733276643990929,0.32667233560090714,home,LAD,under,8.5,0.5121951219512195,-105,0.49029798572728833,LAD,STL,2024 REG,14,5,6,6,11,20,0,1,-1,1,1,1,1,1,1,0,0,0,0,0.5097020142727117,0.49029798572728833
94685,0.6742671009771988,0.37037037037037035,-207,170,0.6441695225767204,0.35583047742327956,away,TEX,over,7.5,0.5283018867924528,-112,0.5031902949311281,BAL,TEX,2024 REG,14,11,12,2,13,26,1,0,9,-9,1,1,0,0,0,0,0,0,0,0.5031902949311281,0.4968097050688719
94685,0.6742671009771988,0.37037037037037035,-207,170,0.6441695225767204,0.35583047742327956,home,BAL,under,7.5,0.5192307692307692,-108,0.4968097050688719,BAL,TEX,2024 REG,14,11,12,2,13,26,1,0,9,-9,1,1,0,0,0,0,0,0,0,0.5031902949311281,0.4968097050688719
94686,0.49751243781094534,0.5454545454545454,101,-120,0.476135829221149,0.523864170778851,away,NYY,over,9.5,0.5348837209302326,-115,0.5097020142727117,ARI,NYY,2024 REG,4,2,8,5,7,12,0,1,-3,3,1,1,0,0,0,0,0,0,0,0.5097020142727117,0.49029798572728833
94686,0.49751243781094534,0.5454545454545454,101,-120,0.476135829221149,0.523864170778851,home,ARI,under,9.5,0.5121951219512195,-105,0.49029798572728833,ARI,NYY,2024 REG,4,2,8,5,7,12,0,1,-3,3,1,1,0,0,0,0,0,0,0,0.5097020142727117,0.49029798572728833
94687,0.5024875621890548,0.5412844036697247,-101,-118,0.48049269377245407,0.5195073062275459,away,BOS,over,9.5,0.5169082125603864,-107,0.49353874091423283,CIN,BOS,2024 REG,11,3,9,4,7,20,0,1,-1,1,1,1,1,0,0,0,0,0,0,0.49353874091423283,0.5064612590857671
94687,0.5024875621890548,0.5412844036697247,-101,-118,0.48049269377245407,0.5195073062275459,home,CIN,under,9.5,0.5283018867924528,-112,0.5064612590857671,CIN,BOS,2024 REG,11,3,9,4,7,20,0,1,-1,1,1,1,1,0,0,0,0,0,0,0.49353874091423283,0.5064612590857671
94688,0.5495495495495495,0.49019607843137253,-122,104,0.5277073575960698,0.4722926424039302,away,DET,over,7.5,0.49504950495049505,102,0.47097973588023584,BOS,DET,2024 REG,2,0,8,5,5,10,0,1,-5,5,0,0,0,0,0,0,0,0,0,0.47097973588023584,0.5290202641197641
94688,0.5495495495495495,0.49019607843137253,-122,104,0.5277073575960698,0.4722926424039302,home,BOS,under,7.5,0.5535714285714286,-124,0.5290202641197641,BOS,DET,2024 REG,2,0,8,5,5,10,0,1,-5,5,0,0,0,0,0,0,0,0,0,0.47097973588023584,0.5290202641197641
94691,0.5652173913043479,0.47619047619047616,-130,110,0.5418129444594474,0.4581870555405526,away,TB,over,8.5,0.5454545454545454,-120,0.5206611570247933,ATL,TB,2024 REG,11,9,6,2,11,17,1,0,7,-7,1,1,0,0,0,0,0,0,0,0.5206611570247933,0.4793388429752067
94691,0.5652173913043479,0.47619047619047616,-130,110,0.5418129444594474,0.4581870555405526,home,ATL,under,8.5,0.5,100,0.4793388429752067,ATL,TB,2024 REG,11,9,6,2,11,17,1,0,7,-7,1,1,0,0,0,0,0,0,0,0.5206611570247933,0.4793388429752067
94693,0.75,0.29239766081871343,-300,242,0.718201754385965,0.281798245614035,away,CWS,over,7.5,0.5121951219512195,-105,0.48808156828023186,STL,CWS,2024 REG,6,3,3,0,3,9,1,0,3,-3,0,0,0,0,0,0,0,0,0,0.48808156828023186,0.5119184317197681
94693,0.75,0.29239766081871343,-300,242,0.718201754385965,0.281798245614035,home,STL,under,7.5,0.5348837209302326,-115,0.5119184317197681,STL,CWS,2024 REG,6,3,3,0,3,9,1,0,3,-3,0,0,0,0,0,0,0,0,0,0.48808156828023186,0.5119184317197681
94694,0.7175141242937854,0.32573289902280134,-254,207,0.6864837742304717,0.3135162257695283,away,OAK,over,8.5,0.5454545454545454,-120,0.5206611570247933,ATL,OAK,2024 REG,7,3,2,1,4,9,1,0,2,-2,1,0,0,0,0,0,0,0,0,0.5206611570247933,0.4793388429752067
94694,0.7175141242937854,0.32573289902280134,-254,207,0.6864837742304717,0.3135162257695283,home,ATL,under,8.5,0.5,100,0.4793388429752067,ATL,OAK,2024 REG,7,3,2,1,4,9,1,0,2,-2,1,0,0,0,0,0,0,0,0,0.5206611570247933,0.4793388429752067
94695,0.5652173913043479,0.47619047619047616,-130,110,0.5418129444594474,0.4581870555405526,away,SF,over,9,0.5121951219512195,-105,0.48808156828023186,ARI,SF,2024 REG,9,4,8,2,6,17,1,0,2,-2,1,1,0,0,0,0,0,0,0,0.48808156828023186,0.5119184317197681
94695,0.5652173913043479,0.47619047619047616,-130,110,0.5418129444594474,0.4581870555405526,home,ARI,under,9,0.5348837209302326,-115,0.5119184317197681,ARI,SF,2024 REG,9,4,8,2,6,17,1,0,2,-2,1,1,0,0,0,0,0,0,0,0.48808156828023186,0.5119184317197681
94698,0.5,0.5391705069124424,100,-117,0.4804147465437788,0.5195852534562212,away,ARI,over,8.5,0.5238095238095238,-110,0.4988662131519274,SD,ARI,2024 REG,14,10,12,8,18,26,1,0,2,-2,1,1,1,1,1,1,1,1,0,0.4988662131519274,0.5011337868480725
94698,0.5,0.5391705069124424,100,-117,0.4804147465437788,0.5195852534562212,home,SD,under,8.5,0.5238095238095238,-110,0.5011337868480725,SD,ARI,2024 REG,14,10,12,8,18,26,1,0,2,-2,1,1,1,1,1,1,1,1,0,0.4988662131519274,0.5011337868480725
94704,0.6197718631178707,0.42194092827004215,-163,137,0.5939194486835369,0.40608055131646315,away,BOS,over,9.5,0.5,100,0.4762443438914027,CIN,BOS,2024 REG,10,4,10,7,11,20,0,1,-3,3,1,1,1,1,0,0,0,0,0,0.4762443438914027,0.5237556561085973
94704,0.6197718631178707,0.42194092827004215,-163,137,0.5939194486835369,0.40608055131646315,home,CIN,under,9.5,0.5475113122171946,-121,0.5237556561085973,CIN,BOS,2024 REG,10,4,10,7,11,20,0,1,-3,3,1,1,1,1,0,0,0,0,0,0.4762443438914027,0.5237556561085973
94706,0.425531914893617,0.6153846153846154,135,-160,0.4081206254135181,0.5918793745864819,away,MIN,over,7.5,0.5327102803738317,-114,0.508788710910954,WSH,MIN,2024 REG,14,12,8,3,15,22,1,0,9,-9,1,1,1,0,0,0,0,0,0,0.508788710910954,0.491211289089046
94706,0.425531914893617,0.6153846153846154,135,-160,0.4081206254135181,0.5918793745864819,home,WSH,under,7.5,0.5121951219512195,-105,0.491211289089046,WSH,MIN,2024 REG,14,12,8,3,15,22,1,0,9,-9,1,1,1,0,0,0,0,0,0,0.508788710910954,0.491211289089046
94707,0.5555555555555556,0.48780487804878053,-125,105,0.5314664257753688,0.46853357422463116,away,TEX,over,7.5,0.5260663507109005,-111,0.5010269332605688,TB,TEX,2024 REG,8,1,10,4,5,18,0,1,-3,3,1,0,0,0,0,0,0,0,0,0.5010269332605688,0.4989730667394312
94707,0.5555555555555556,0.48780487804878053,-125,105,0.5314664257753688,0.46853357422463116,home,TB,under,7.5,0.5215311004784688,-109,0.4989730667394312,TB,TEX,2024 REG,8,1,10,4,5,18,0,1,-3,3,1,0,0,0,0,0,0,0,0,0.5010269332605688,0.4989730667394312
94708,0.47619047619047616,0.5652173913043479,110,-130,0.4564724440500838,0.5435275559499162,away,TB,over,7.5,0.504950495049505,-102,0.4826715732667395,MIA,TB,2024 REG,7,3,8,5,8,15,0,1,-2,2,1,1,1,0,0,0,0,0,0,0.4826715732667395,0.5173284267332605
94708,0.47619047619047616,0.5652173913043479,110,-130,0.4564724440500838,0.5435275559499162,home,MIA,under,7.5,0.5391705069124424,-117,0.5173284267332605,MIA,TB,2024 REG,7,3,8,5,8,15,0,1,-2,2,1,1,1,0,0,0,0,0,0,0.4826715732667395,0.5173284267332605
94709,0.48780487804878053,0.5555555555555556,105,-125,0.4666534470222751,0.5333465529777248,away,NYY,over,8.5,0.5454545454545454,-120,0.5206611570247933,ARI,NYY,2024 REG,9,5,8,6,11,17,0,1,-1,1,1,1,1,1,1,0,0,0,0,0.5206611570247933,0.4793388429752067
94709,0.48780487804878053,0.5555555555555556,105,-125,0.4666534470222751,0.5333465529777248,home,ARI,under,8.5,0.5,100,0.4793388429752067,ARI,NYY,2024 REG,9,5,8,6,11,17,0,1,-1,1,1,1,1,1,1,0,0,0,0,0.5206611570247933,0.4793388429752067
94711,0.47846889952153115,0.5614035087719298,109,-128,0.45939119220408575,0.5406088077959142,away,PHI,over,7.5,0.5348837209302326,-115,0.5097020142727117,CHC,PHI,2024 REG,12,10,6,2,12,18,1,0,8,-8,1,1,0,0,0,0,0,0,0,0.5097020142727117,0.49029798572728833
94711,0.47846889952153115,0.5614035087719298,109,-128,0.45939119220408575,0.5406088077959142,home,CHC,under,7.5,0.5121951219512195,-105,0.49029798572728833,CHC,PHI,2024 REG,12,10,6,2,12,18,1,0,8,-8,1,1,0,0,0,0,0,0,0,0.5097020142727117,0.49029798572728833
94712,0.6168582375478928,0.425531914893617,-161,135,0.5907095228234366,0.4092904771765634,away,SD,over,9,0.5,100,0.4772727272727273,TEX,SD,2024 REG,9,4,13,6,10,22,0,1,-2,2,1,1,1,1,0,0,0,0,0,0.4772727272727273,0.5227272727272727
94712,0.6168582375478928,0.425531914893617,-161,135,0.5907095228234366,0.4092904771765634,home,TEX,under,9,0.5454545454545454,-120,0.5227272727272727,TEX,SD,2024 REG,9,4,13,6,10,22,0,1,-2,2,1,1,1,1,0,0,0,0,0,0.4772727272727273,0.5227272727272727
94715,0.5983935742971888,0.4444444444444444,-149,125,0.5727595791465728,0.42724042085342717,away,HOU,over,8.5,0.5391705069124424,-117,0.5140669063204599,NYY,HOU,2024 REG,6,3,11,4,7,17,0,1,-1,1,1,1,1,0,0,0,0,0,0,0.5140669063204599,0.4859330936795401
94715,0.5983935742971888,0.4444444444444444,-149,125,0.5727595791465728,0.42724042085342717,home,NYY,under,8.5,0.5073891625615764,-103,0.4859330936795401,NYY,HOU,2024 REG,6,3,11,4,7,17,0,1,-1,1,1,1,1,0,0,0,0,0,0,0.5140669063204599,0.4859330936795401
94716,0.46511627906976744,0.574468085106383,115,-135,0.44670494689481377,0.5532950531051862,away,SD,over,8,0.504950495049505,-102,0.48160416005266615,KC,SD,2024 REG,13,8,18,11,19,31,0,1,-3,3,1,1,1,1,1,1,1,1,0,0.48160416005266615,0.5183958399473338
94716,0.46511627906976744,0.574468085106383,115,-135,0.44670494689481377,0.5532950531051862,home,KC,under,8,0.5412844036697247,-118,0.5183958399473338,KC,SD,2024 REG,13,8,18,11,19,31,0,1,-3,3,1,1,1,1,1,1,1,1,0,0.48160416005266615,0.5183958399473338
94720,0.6978851963746223,0.3424657534246575,-231,192,0.6697248658500494,0.3302751341499506,away,NYM,over,10,0.5121951219512195,-105,0.48808156828023186,ATL,NYM,2024 REG,12,7,11,8,15,23,0,1,-1,1,1,1,1,1,1,1,1,0,0,0.48808156828023186,0.5119184317197681
94720,0.6978851963746223,0.3424657534246575,-231,192,0.6697248658500494,0.3302751341499506,home,ATL,under,10,0.5348837209302326,-115,0.5119184317197681,ATL,NYM,2024 REG,12,7,11,8,15,23,0,1,-1,1,1,1,1,1,1,1,1,0,0,0.48808156828023186,0.5119184317197681
94722,0.4716981132075471,0.5670995670995671,112,-131,0.4533973206098518,0.5466026793901482,away,CLE,over,8,0.5121951219512195,-105,0.48808156828023186,OAK,CLE,2024 REG,8,4,9,6,10,17,0,1,-2,2,1,1,1,1,0,0,0,0,0,0.48808156828023186,0.5119184317197681
94722,0.4716981132075471,0.5670995670995671,112,-131,0.4533973206098518,0.5466026793901482,home,OAK,under,8,0.5348837209302326,-115,0.5119184317197681,OAK,CLE,2024 REG,8,4,9,6,10,17,0,1,-2,2,1,1,1,1,0,0,0,0,0,0.48808156828023186,0.5119184317197681
94726,0.41493775933609955,0.626865671641791,141,-168,0.39759193735357234,0.6024080626464277,away,MIN,over,7.5,0.5,100,0.4772727272727273,CWS,MIN,2024 REG,8,2,4,3,5,12,0,1,-1,1,1,1,0,0,0,0,0,0,0,0.4772727272727273,0.5227272727272727
94726,0.41493775933609955,0.626865671641791,141,-168,0.39759193735357234,0.6024080626464277,home,CWS,under,7.5,0.5454545454545454,-120,0.5227272727272727,CWS,MIN,2024 REG,8,2,4,3,5,12,0,1,-1,1,1,1,0,0,0,0,0,0,0,0.4772727272727273,0.5227272727272727
94727,0.6000000000000001,0.44052863436123346,-150,127,0.57568281938326,0.42431718061673995,away,MIA,over,8,0.5348837209302326,-115,0.5097020142727117,NYY,MIA,2024 REG,9,7,2,0,7,11,1,0,7,-7,0,0,0,0,0,0,0,0,0,0.5097020142727117,0.49029798572728833
94727,0.6000000000000001,0.44052863436123346,-150,127,0.57568281938326,0.42431718061673995,home,NYY,under,8,0.5121951219512195,-105,0.49029798572728833,NYY,MIA,2024 REG,9,7,2,0,7,11,1,0,7,-7,0,0,0,0,0,0,0,0,0,0.5097020142727117,0.49029798572728833
94728,0.5901639344262295,0.4484304932735426,-144,123,0.5673868951280033,0.43261310487199667,away,MIA,over,8.5,0.5121951219512195,-105,0.48808156828023186,STL,MIA,2024 REG,10,8,9,5,13,19,1,0,3,-3,1,1,1,1,1,0,0,0,0,0.48808156828023186,0.5119184317197681
94728,0.5901639344262295,0.4484304932735426,-144,123,0.5673868951280033,0.43261310487199667,home,STL,under,8.5,0.5348837209302326,-115,0.5119184317197681,STL,MIA,2024 REG,10,8,9,5,13,19,1,0,3,-3,1,1,1,1,1,0,0,0,0,0.48808156828023186,0.5119184317197681
94729,0.5121951219512195,0.5348837209302326,-105,-115,0.48808156828023186,0.5119184317197681,away,SF,over,7.5,0.5412844036697247,-118,0.5149381613977361,NYM,SF,2024 REG,8,4,7,3,7,15,1,0,1,-1,1,1,1,0,0,0,0,0,0,0.5149381613977361,0.48506183860226393
94729,0.5121951219512195,0.5348837209302326,-105,-115,0.48808156828023186,0.5119184317197681,home,NYM,under,7.5,0.5073891625615764,-103,0.48506183860226393,NYM,SF,2024 REG,8,4,7,3,7,15,1,0,1,-1,1,1,1,0,0,0,0,0,0,0.5149381613977361,0.48506183860226393
94730,0.5918367346938775,0.4484304932735426,-145,123,0.5680051099784656,0.43199489002153435,away,KC,over,8,0.5260663507109005,-111,0.5010269332605688,TEX,KC,2024 REG,7,6,3,0,6,10,1,0,6,-6,0,0,0,0,0,0,0,0,0,0.5010269332605688,0.4989730667394312
94730,0.5918367346938775,0.4484304932735426,-145,123,0.5680051099784656,0.43199489002153435,home,TEX,under,8,0.5215311004784688,-109,0.4989730667394312,TEX,KC,2024 REG,7,6,3,0,6,10,1,0,6,-6,0,0,0,0,0,0,0,0,0,0.5010269332605688,0.4989730667394312
94734,0.36363636363636365,0.6774193548387096,175,-210,0.3487070114636097,0.6512929885363903,away,NYY,over,8.5,0.5073891625615764,-103,0.48057683780462784,LAA,NYY,2024 REG,3,1,6,2,3,9,0,1,-1,1,1,0,0,0,0,0,0,0,0,0.48057683780462784,0.5194231621953722
94734,0.36363636363636365,0.6774193548387096,175,-210,0.3487070114636097,0.6512929885363903,home,LAA,under,8.5,0.5454545454545454,-120,0.5194231621953722,LAA,NYY,2024 REG,3,1,6,2,3,9,0,1,-1,1,1,0,0,0,0,0,0,0,0,0.48057683780462784,0.5194231621953722
94737,0.5121951219512195,0.5305164319248826,-105,-113,0.4903184724049234,0.5096815275950766,away,NYM,over,7.5,0.5305164319248826,-113,0.5041247242695369,SF,NYM,2024 REG,8,2,10,8,10,18,0,1,-6,6,1,1,0,0,0,0,0,0,0,0.5041247242695369,0.4958752757304631
94737,0.5121951219512195,0.5305164319248826,-105,-113,0.4903184724049234,0.5096815275950766,home,SF,under,7.5,0.5192307692307692,-108,0.4958752757304631,SF,NYM,2024 REG,8,2,10,8,10,18,0,1,-6,6,1,1,0,0,0,0,0,0,0,0.5041247242695369,0.4958752757304631
94738,0.6000000000000001,0.4444444444444444,-150,125,0.5733333333333334,0.42666666666666664,away,MIN,over,8.5,0.5073891625615764,-103,0.4826927225525911,NYY,MIN,2024 REG,7,8,10,5,13,17,1,0,3,-3,1,1,1,1,1,0,0,0,0,0.4826927225525911,0.5173072774474089
94738,0.6000000000000001,0.4444444444444444,-150,125,0.5733333333333334,0.42666666666666664,home,NYY,under,8.5,0.5412844036697247,-118,0.5173072774474089,NYY,MIN,2024 REG,7,8,10,5,13,17,1,0,3,-3,1,1,1,1,1,0,0,0,0,0.4826927225525911,0.5173072774474089
94739,0.6721311475409836,0.37037037037037035,-205,170,0.6435645535349916,0.35643544646500835,away,COL,over,8.5,0.5454545454545454,-120,0.5206611570247933,CIN,COL,2024 REG,14,8,3,1,9,17,1,0,7,-7,1,0,0,0,0,0,0,0,0,0.5206611570247933,0.4793388429752067
94739,0.6721311475409836,0.37037037037037035,-205,170,0.6435645535349916,0.35643544646500835,home,CIN,under,8.5,0.5,100,0.4793388429752067,CIN,COL,2024 REG,14,8,3,1,9,17,1,0,7,-7,1,0,0,0,0,0,0,0,0,0.5206611570247933,0.4793388429752067
94741,0.5370370370370371,0.504950495049505,-116,-102,0.514488177212783,0.48551182278721705,away,SD,over,7.5,0.49504950495049505,102,0.4719707862985384,TEX,SD,2024 REG,6,1,9,3,4,15,0,1,-2,2,1,0,0,0,0,0,0,0,0,0.4719707862985384,0.5280292137014616
94741,0.5370370370370371,0.504950495049505,-116,-102,0.514488177212783,0.48551182278721705,home,TEX,under,7.5,0.5515695067264574,-123,0.5280292137014616,TEX,SD,2024 REG,6,1,9,3,4,15,0,1,-2,2,1,0,0,0,0,0,0,0,0,0.4719707862985384,0.5280292137014616
94744,0.5475113122171946,0.49504950495049505,-121,102,0.5242087833606768,0.4757912166393232,away,OAK,over,8,0.5412844036697247,-118,0.5149381613977361,LAA,OAK,2024 REG,9,7,9,5,12,18,1,0,2,-2,1,1,1,1,1,0,0,0,0,0.5149381613977361,0.48506183860226393
94744,0.5475113122171946,0.49504950495049505,-121,102,0.5242087833606768,0.4757912166393232,home,LAA,under,8,0.5073891625615764,-103,0.48506183860226393,LAA,OAK,2024 REG,9,7,9,5,12,18,1,0,2,-2,1,1,1,1,1,0,0,0,0,0.5149381613977361,0.48506183860226393
94746,0.5121951219512195,0.5305164319248826,-105,-113,0.4903184724049234,0.5096815275950766,away,MIN,over,6.5,0.5495495495495495,-122,0.5236866555946829,SEA,MIN,2024 REG,9,3,8,5,8,17,0,1,-2,2,1,1,1,0,0,0,0,0,0,0.5236866555946829,0.47631334440531714
94746,0.5121951219512195,0.5305164319248826,-105,-113,0.4903184724049234,0.5096815275950766,home,SEA,under,6.5,0.49751243781094534,101,0.47631334440531714,SEA,MIN,2024 REG,9,3,8,5,8,17,0,1,-2,2,1,1,1,0,0,0,0,0,0,0.5236866555946829,0.47631334440531714
94750,0.35714285714285715,0.6875,180,-220,0.3411989795918367,0.6588010204081634,away,LAD,over,7.5,0.5433789954337899,-119,0.5184560714286826,SF,LAD,2024 REG,6,4,11,6,10,17,0,1,-2,2,1,1,1,1,0,0,0,0,0,0.5184560714286826,0.48154392857131745
94750,0.35714285714285715,0.6875,180,-220,0.3411989795918367,0.6588010204081634,home,SF,under,7.5,0.5024875621890548,-101,0.48154392857131745,SF,LAD,2024 REG,6,4,11,6,10,17,0,1,-2,2,1,1,1,1,0,0,0,0,0,0.5184560714286826,0.48154392857131745
94751,0.6453900709219857,0.4,-182,150,0.6160957698304913,0.3839042301695087,away,MIA,over,8.5,0.5121951219512195,-105,0.48919479393107135,WSH,MIA,2024 REG,13,8,7,1,9,20,1,0,7,-7,1,0,0,0,0,0,0,0,0,0.48919479393107135,0.5108052060689287
94751,0.6453900709219857,0.4,-182,150,0.6160957698304913,0.3839042301695087,home,WSH,under,8.5,0.5327102803738317,-114,0.5108052060689287,WSH,MIA,2024 REG,13,8,7,1,9,20,1,0,7,-7,1,0,0,0,0,0,0,0,0,0.48919479393107135,0.5108052060689287
94752,0.4444444444444444,0.5983935742971888,125,-149,0.4254053250037185,0.5745946749962815,away,CHC,over,7.5,0.5348837209302326,-115,0.5097020142727117,MIL,CHC,2024 REG,10,10,9,6,16,19,1,0,4,-4,1,1,1,1,1,1,0,0,0,0.5097020142727117,0.49029798572728833
94752,0.4444444444444444,0.5983935742971888,125,-149,0.4254053250037185,0.5745946749962815,home,MIL,under,7.5,0.5121951219512195,-105,0.49029798572728833,MIL,CHC,2024 REG,10,10,9,6,16,19,1,0,4,-4,1,1,1,1,1,1,0,0,0,0.5097020142727117,0.49029798572728833
94754,0.39370078740157477,0.6491228070175439,154,-185,0.37684110455940206,0.623158895440598,away,TEX,over,8.5,0.5215311004784688,-109,0.49670754937970685,LAA,TEX,2024 REG,9,4,8,5,9,17,0,1,-1,1,1,1,1,1,0,0,0,0,0,0.49670754937970685,0.5032924506202932
94754,0.39370078740157477,0.6491228070175439,154,-185,0.37684110455940206,0.623158895440598,home,LAA,under,8.5,0.5260663507109005,-111,0.5032924506202932,LAA,TEX,2024 REG,9,4,8,5,9,17,0,1,-1,1,1,1,1,1,0,0,0,0,0,0.49670754937970685,0.5032924506202932
94755,0.4444444444444444,0.6000000000000001,125,-150,0.4246913580246913,0.5753086419753086,away,ATL,over,8.5,0.5192307692307692,-108,0.49455035168025013,MIA,ATL,2024 REG,9,7,12,9,16,21,0,1,-2,2,1,1,1,1,1,1,1,0,0,0.49455035168025013,0.5054496483197499
94755,0.4444444444444444,0.6000000000000001,125,-150,0.4246913580246913,0.5753086419753086,home,MIA,under,8.5,0.5283018867924528,-112,0.5054496483197499,MIA,ATL,2024 REG,9,7,12,9,16,21,0,1,-2,2,1,1,1,1,1,1,1,0,0,0.49455035168025013,0.5054496483197499
94759,0.5555555555555556,0.48780487804878053,-125,105,0.5314664257753688,0.46853357422463116,away,STL,over,7.5,0.5348837209302326,-115,0.5097020142727117,NYM,STL,2024 REG,8,2,5,4,6,13,0,1,-2,2,1,1,0,0,0,0,0,0,0,0.5097020142727117,0.49029798572728833
94759,0.5555555555555556,0.48780487804878053,-125,105,0.5314664257753688,0.46853357422463116,home,NYM,under,7.5,0.5121951219512195,-105,0.49029798572728833,NYM,STL,2024 REG,8,2,5,4,6,13,0,1,-2,2,1,1,0,0,0,0,0,0,0,0.5097020142727117,0.49029798572728833
94761,0.47846889952153115,0.5614035087719298,109,-128,0.45939119220408575,0.5406088077959142,away,NYY,over,8.5,0.5121951219512195,-105,0.48808156828023186,NYM,NYY,2024 REG,12,12,6,2,14,18,1,0,10,-10,1,1,0,0,0,0,0,0,0,0.48808156828023186,0.5119184317197681
94761,0.47846889952153115,0.5614035087719298,109,-128,0.45939119220408575,0.5406088077959142,home,NYM,under,8.5,0.5348837209302326,-115,0.5119184317197681,NYM,NYY,2024 REG,12,12,6,2,14,18,1,0,10,-10,1,1,0,0,0,0,0,0,0,0.48808156828023186,0.5119184317197681
94762,0.6254681647940076,0.4132231404958678,-167,142,0.6012679850808645,0.39873201491913546,away,TEX,over,8,0.5192307692307692,-108,0.49455035168025013,MIN,TEX,2024 REG,3,2,9,6,8,12,0,1,-4,4,1,1,0,0,0,0,0,0,0,0.49455035168025013,0.5054496483197499
94762,0.6254681647940076,0.4132231404958678,-167,142,0.6012679850808645,0.39873201491913546,home,MIN,under,8,0.5283018867924528,-112,0.5054496483197499,MIN,TEX,2024 REG,3,2,9,6,8,12,0,1,-4,4,1,1,0,0,0,0,0,0,0,0.49455035168025013,0.5054496483197499
94764,0.5,0.5348837209302326,100,-115,0.4825581395348837,0.5174418604651163,away,PIT,over,7.5,0.5024875621890548,-101,0.4794401874631478,CHC,PIT,2024 REG,4,3,15,9,12,19,0,1,-6,6,1,1,1,0,0,0,0,0,0,0.4794401874631478,0.5205598125368522
94764,0.5,0.5348837209302326,100,-115,0.4825581395348837,0.5174418604651163,home,CHC,under,7.5,0.5433789954337899,-119,0.5205598125368522,CHC,PIT,2024 REG,4,3,15,9,12,19,0,1,-6,6,1,1,1,0,0,0,0,0,0,0.4794401874631478,0.5205598125368522
94765,0.5454545454545454,0.5,-120,100,0.5206611570247933,0.4793388429752067,away,DET,over,7,0.5121951219512195,-105,0.48808156828023186,HOU,DET,2024 REG,6,4,5,0,4,11,1,0,4,-4,0,0,0,0,0,0,0,0,0,0.48808156828023186,0.5119184317197681
94765,0.5454545454545454,0.5,-120,100,0.5206611570247933,0.4793388429752067,home,HOU,under,7,0.5348837209302326,-115,0.5119184317197681,HOU,DET,2024 REG,6,4,5,0,4,11,1,0,4,-4,0,0,0,0,0,0,0,0,0,0.48808156828023186,0.5119184317197681
94766,0.7142857142857143,0.3278688524590164,-250,205,0.6841753094680495,0.3158246905319505,away,COL,over,7,0.5454545454545454,-120,0.5206611570247933,CHC,COL,2024 REG,9,5,3,0,5,12,1,0,5,-5,0,0,0,0,0,0,0,0,0,0.5206611570247933,0.4793388429752067
94766,0.7142857142857143,0.3278688524590164,-250,205,0.6841753094680495,0.3158246905319505,home,CHC,under,7,0.5,100,0.4793388429752067,CHC,COL,2024 REG,9,5,3,0,5,12,1,0,5,-5,0,0,0,0,0,0,0,0,0,0.5206611570247933,0.4793388429752067
94768,0.6721311475409836,0.36900369003690037,-205,171,0.6444831419558484,0.35551685804415156,away,COL,over,8,0.5238095238095238,-110,0.4988662131519274,NYM,COL,2024 REG,6,7,8,3,10,14,1,0,4,-4,1,1,1,0,0,0,0,0,0,0.4988662131519274,0.5011337868480725
94768,0.6721311475409836,0.36900369003690037,-205,171,0.6444831419558484,0.35551685804415156,home,NYM,under,8,0.5238095238095238,-110,0.5011337868480725,NYM,COL,2024 REG,6,7,8,3,10,14,1,0,4,-4,1,1,1,0,0,0,0,0,0,0.4988662131519274,0.5011337868480725
94772,0.5833333333333333,0.45454545454545453,-140,120,0.5612373737373737,0.4387626262626263,away,MIA,over,8,0.5348837209302326,-115,0.5097020142727117,CHC,MIA,2024 REG,7,2,8,3,5,15,0,1,-1,1,1,1,0,0,0,0,0,0,0,0.5097020142727117,0.49029798572728833
94772,0.5833333333333333,0.45454545454545453,-140,120,0.5612373737373737,0.4387626262626263,home,CHC,under,8,0.5121951219512195,-105,0.49029798572728833,CHC,MIA,2024 REG,7,2,8,3,5,15,0,1,-1,1,1,1,0,0,0,0,0,0,0,0.5097020142727117,0.49029798572728833
94773,0.4,0.6428571428571428,150,-180,0.38285714285714295,0.617142857142857,away,LAD,over,7.5,0.5238095238095238,-110,0.4988662131519274,SD,LAD,2024 REG,3,2,4,1,3,7,1,0,1,-1,1,0,0,0,0,0,0,0,0,0.4988662131519274,0.5011337868480725
94773,0.4,0.6428571428571428,150,-180,0.38285714285714295,0.617142857142857,home,SD,under,7.5,0.5238095238095238,-110,0.5011337868480725,SD,LAD,2024 REG,3,2,4,1,3,7,1,0,1,-1,1,0,0,0,0,0,0,0,0,0.4988662131519274,0.5011337868480725
94774,0.5535714285714286,0.48780487804878053,-124,105,0.53066668740667,0.46933331259333,away,BAL,over,9,0.5145631067961165,-106,0.49023796582517226,CIN,BAL,2024 REG,6,1,7,2,3,13,0,1,-1,1,1,0,0,0,0,0,0,0,0,0.49023796582517226,0.5097620341748277
94774,0.5535714285714286,0.48780487804878053,-124,105,0.53066668740667,0.46933331259333,home,CIN,under,9,0.5327102803738317,-114,0.5097620341748277,CIN,BAL,2024 REG,6,1,7,2,3,13,0,1,-1,1,1,0,0,0,0,0,0,0,0,0.49023796582517226,0.5097620341748277
94775,0.5850622406639003,0.45454545454545453,-141,120,0.5618892737571823,0.43811072624281766,away,NYY,over,8.5,0.5348837209302326,-115,0.5097020142727117,BAL,NYY,2024 REG,8,1,10,6,7,18,0,1,-5,5,1,0,0,0,0,0,0,0,0,0.5097020142727117,0.49029798572728833
94775,0.5850622406639003,0.45454545454545453,-141,120,0.5618892737571823,0.43811072624281766,home,BAL,under,8.5,0.5121951219512195,-105,0.49029798572728833,BAL,NYY,2024 REG,8,1,10,6,7,18,0,1,-5,5,1,0,0,0,0,0,0,0,0,0.5097020142727117,0.49029798572728833
94778,0.6551724137931035,0.3861003861003861,-190,159,0.6281316138628862,0.3718683861371138,away,NYM,over,9.5,0.5121951219512195,-105,0.48808156828023186,ATL,NYM,2024 REG,11,6,12,5,11,23,1,0,1,-1,1,1,1,1,1,0,0,0,0,0.48808156828023186,0.5119184317197681
94778,0.6551724137931035,0.3861003861003861,-190,159,0.6281316138628862,0.3718683861371138,home,ATL,under,9.5,0.5348837209302326,-115,0.5119184317197681,ATL,NYM,2024 REG,11,6,12,5,11,23,1,0,1,-1,1,1,1,1,1,0,0,0,0,0.48808156828023186,0.5119184317197681
94779,0.6240601503759399,0.4184100418410042,-166,139,0.5975561958345387,0.4024438041654613,away,CWS,over,8.5,0.504950495049505,-102,0.47949844489399435,ARI,CWS,2024 REG,10,2,12,9,11,22,0,1,-7,7,1,1,0,0,0,0,0,0,0,0.47949844489399435,0.5205015551060057
94779,0.6240601503759399,0.4184100418410042,-166,139,0.5975561958345387,0.4024438041654613,home,ARI,under,8.5,0.5454545454545454,-120,0.5205015551060057,ARI,CWS,2024 REG,10,2,12,9,11,22,0,1,-7,7,1,1,0,0,0,0,0,0,0,0.47949844489399435,0.5205015551060057
94781,0.5145631067961165,0.5260663507109005,-106,-111,0.49365668691386505,0.506343313086135,away,NYM,over,8.5,0.5192307692307692,-108,0.49340049170764233,TEX,NYM,2024 REG,5,5,5,3,8,10,1,0,2,-2,1,1,1,0,0,0,0,0,0,0.49340049170764233,0.5065995082923577
94781,0.5145631067961165,0.5260663507109005,-106,-111,0.49365668691386505,0.506343313086135,home,TEX,under,8.5,0.5305164319248826,-113,0.5065995082923577,TEX,NYM,2024 REG,5,5,5,3,8,10,1,0,2,-2,1,1,1,0,0,0,0,0,0,0.49340049170764233,0.5065995082923577
94782,0.35842293906810035,0.6845425867507886,179,-217,0.3430231090254878,0.6569768909745122,away,PHI,over,9.5,0.5348837209302326,-115,0.5097020142727117,COL,PHI,2024 REG,6,5,5,2,7,11,1,0,3,-3,1,1,0,0,0,0,0,0,0,0.5097020142727117,0.49029798572728833
94782,0.35842293906810035,0.6845425867507886,179,-217,0.3430231090254878,0.6569768909745122,home,COL,under,9.5,0.5121951219512195,-105,0.49029798572728833,COL,PHI,2024 REG,6,5,5,2,7,11,1,0,3,-3,1,1,0,0,0,0,0,0,0,0.5097020142727117,0.49029798572728833
94783,0.4672897196261683,0.5726495726495727,114,-134,0.44862649893656975,0.5513735010634302,away,SF,over,8,0.5238095238095238,-110,0.4988662131519274,BOS,SF,2024 REG,11,4,4,0,4,15,1,0,4,-4,0,0,0,0,0,0,0,0,0,0.4988662131519274,0.5011337868480725
94783,0.4672897196261683,0.5726495726495727,114,-134,0.44862649893656975,0.5513735010634302,home,BOS,under,8,0.5238095238095238,-110,0.5011337868480725,BOS,SF,2024 REG,11,4,4,0,4,15,1,0,4,-4,0,0,0,0,0,0,0,0,0,0.4988662131519274,0.5011337868480725
94784,0.5614035087719298,0.47846889952153115,-128,109,0.5390189988527938,0.4609810011472062,away,MIN,over,8.5,0.5121951219512195,-105,0.48808156828023186,CLE,MIN,2024 REG,7,3,4,2,5,11,1,0,1,-1,1,1,0,0,0,0,0,0,0,0.48808156828023186,0.5119184317197681
94784,0.5614035087719298,0.47846889952153115,-128,109,0.5390189988527938,0.4609810011472062,home,CLE,under,8.5,0.5348837209302326,-115,0.5119184317197681,CLE,MIN,2024 REG,7,3,4,2,5,11,1,0,1,-1,1,1,0,0,0,0,0,0,0,0.48808156828023186,0.5119184317197681
94785,0.6491228070175439,0.39370078740157477,-185,154,0.6213250352016247,0.37867496479837526,away,MIA,over,7,0.5238095238095238,-110,0.4988662131519274,SD,MIA,2024 REG,8,1,16,9,10,24,0,1,-8,8,1,0,0,0,0,0,0,0,0,0.4988662131519274,0.5011337868480725
94785,0.6491228070175439,0.39370078740157477,-185,154,0.6213250352016247,0.37867496479837526,home,SD,under,7,0.5238095238095238,-110,0.5011337868480725,SD,MIA,2024 REG,8,1,16,9,10,24,0,1,-8,8,1,0,0,0,0,0,0,0,0,0.4988662131519274,0.5011337868480725
94786,0.5475113122171946,0.49504950495049505,-121,102,0.5242087833606768,0.4757912166393232,away,LAA,over,9,0.5454545454545454,-120,0.5193043049216726,CIN,LAA,2024 REG,5,3,6,0,3,11,1,0,3,-3,0,0,0,0,0,0,0,0,0,0.5193043049216726,0.48069569507832743
94786,0.5475113122171946,0.49504950495049505,-121,102,0.5242087833606768,0.4757912166393232,home,CIN,under,9,0.5024875621890548,-101,0.48069569507832743,CIN,LAA,2024 REG,5,3,6,0,3,11,1,0,3,-3,0,0,0,0,0,0,0,0,0,0.5193043049216726,0.48069569507832743
94788,0.5238095238095238,0.5238095238095238,-110,-110,0.4988662131519274,0.5011337868480725,away,NYM,over,8.5,0.5073891625615764,-103,0.4816299493915137,CHC,NYM,2024 REG,7,2,9,5,7,16,0,1,-3,3,1,1,0,0,0,0,0,0,0,0.4816299493915137,0.5183700506084863
94788,0.5238095238095238,0.5238095238095238,-110,-110,0.4988662131519274,0.5011337868480725,home,CHC,under,8.5,0.5433789954337899,-119,0.5183700506084863,CHC,NYM,2024 REG,7,2,9,5,7,16,0,1,-3,3,1,1,0,0,0,0,0,0,0,0.4816299493915137,0.5183700506084863
94790,0.5073891625615764,0.5348837209302326,-103,-115,0.4859403596076043,0.5140596403923957,away,SD,over,9,0.5348837209302326,-115,0.5097020142727117,ARI,SD,2024 REG,3,1,12,7,8,15,0,1,-6,6,1,0,0,0,0,0,0,0,0,0.5097020142727117,0.49029798572728833
94790,0.5073891625615764,0.5348837209302326,-103,-115,0.4859403596076043,0.5140596403923957,home,ARI,under,9,0.5121951219512195,-105,0.49029798572728833,ARI,SD,2024 REG,3,1,12,7,8,15,0,1,-6,6,1,0,0,0,0,0,0,0,0,0.5097020142727117,0.49029798572728833
94792,0.5495495495495495,0.4926108374384236,-122,103,0.5263803278714742,0.47361967212852585,away,NYY,over,9,0.5348837209302326,-115,0.5097020142727117,HOU,NYY,2024 REG,7,1,12,7,8,19,0,1,-6,6,1,0,0,0,0,0,0,0,0,0.5097020142727117,0.49029798572728833
94792,0.5495495495495495,0.4926108374384236,-122,103,0.5263803278714742,0.47361967212852585,home,HOU,under,9,0.5121951219512195,-105,0.49029798572728833,HOU,NYY,2024 REG,7,1,12,7,8,19,0,1,-6,6,1,0,0,0,0,0,0,0,0,0.5097020142727117,0.49029798572728833
94793,0.5555555555555556,0.48780487804878053,-125,105,0.5314664257753688,0.46853357422463116,away,STL,over,9.5,0.5073891625615764,-103,0.4826927225525911,CIN,STL,2024 REG,8,3,12,5,8,20,0,1,-2,2,1,1,1,0,0,0,0,0,0,0.4826927225525911,0.5173072774474089
94793,0.5555555555555556,0.48780487804878053,-125,105,0.5314664257753688,0.46853357422463116,home,CIN,under,9.5,0.5412844036697247,-118,0.5173072774474089,CIN,STL,2024 REG,8,3,12,5,8,20,0,1,-2,2,1,1,1,0,0,0,0,0,0,0.4826927225525911,0.5173072774474089
94795,0.5348837209302326,0.5121951219512195,-115,-105,0.5097020142727117,0.49029798572728833,away,CHC,over,8,0.5121951219512195,-105,0.48808156828023186,TB,CHC,2024 REG,7,3,9,4,7,16,0,1,-1,1,1,1,1,0,0,0,0,0,0,0.48808156828023186,0.5119184317197681
94795,0.5348837209302326,0.5121951219512195,-115,-105,0.5097020142727117,0.49029798572728833,home,TB,under,8,0.5348837209302326,-115,0.5119184317197681,TB,CHC,2024 REG,7,3,9,4,7,16,0,1,-1,1,1,1,1,0,0,0,0,0,0,0.48808156828023186,0.5119184317197681
94797,0.7333333333333333,0.3105590062111801,-275,222,0.7011456176673567,0.2988543823326433,away,CWS,over,7.5,0.504950495049505,-102,0.48160416005266615,CLE,CWS,2024 REG,8,7,10,6,13,18,1,0,1,-1,1,1,1,1,1,1,0,0,0,0.48160416005266615,0.5183958399473338
94797,0.7333333333333333,0.3105590062111801,-275,222,0.7011456176673567,0.2988543823326433,home,CLE,under,7.5,0.5412844036697247,-118,0.5183958399473338,CLE,CWS,2024 REG,8,7,10,6,13,18,1,0,1,-1,1,1,1,1,1,1,0,0,0,0.48160416005266615,0.5183958399473338
94798,0.7368421052631579,0.30303030303030304,-280,230,0.7074624359942919,0.2925375640057081,away,OAK,over,7.5,0.5238095238095238,-110,0.4988662131519274,NYY,OAK,2024 REG,11,1,6,3,4,17,0,1,-2,2,1,0,0,0,0,0,0,0,0,0.4988662131519274,0.5011337868480725
94798,0.7368421052631579,0.30303030303030304,-280,230,0.7074624359942919,0.2925375640057081,home,NYY,under,7.5,0.5238095238095238,-110,0.5011337868480725,NYY,OAK,2024 REG,11,1,6,3,4,17,0,1,-2,2,1,0,0,0,0,0,0,0,0,0.4988662131519274,0.5011337868480725
94799,0.6168582375478928,0.425531914893617,-161,135,0.5907095228234366,0.4092904771765634,away,PHI,over,8,0.5348837209302326,-115,0.5097020142727117,ATL,PHI,2024 REG,9,6,5,0,6,14,1,0,6,-6,0,0,0,0,0,0,0,0,0,0.5097020142727117,0.49029798572728833
94799,0.6168582375478928,0.425531914893617,-161,135,0.5907095228234366,0.4092904771765634,home,ATL,under,8,0.5121951219512195,-105,0.49029798572728833,ATL,PHI,2024 REG,9,6,5,0,6,14,1,0,6,-6,0,0,0,0,0,0,0,0,0,0.5097020142727117,0.49029798572728833
94800,0.574468085106383,0.4672897196261683,-135,114,0.550479558983428,0.44952044101657196,away,MIL,over,9.5,0.5238095238095238,-110,0.4988662131519274,BOS,MIL,2024 REG,9,2,11,7,9,20,0,1,-5,5,1,1,0,0,0,0,0,0,0,0.4988662131519274,0.5011337868480725
94800,0.574468085106383,0.4672897196261683,-135,114,0.550479558983428,0.44952044101657196,home,BOS,under,9.5,0.5238095238095238,-110,0.5011337868480725,BOS,MIL,2024 REG,9,2,11,7,9,20,0,1,-5,5,1,1,0,0,0,0,0,0,0,0.4988662131519274,0.5011337868480725
94801,0.5121951219512195,0.5348837209302326,-105,-115,0.48808156828023186,0.5119184317197681,away,CHC,over,7,0.5238095238095238,-110,0.4988662131519274,PIT,CHC,2024 REG,11,10,10,9,19,21,1,0,1,-1,1,1,1,1,1,1,1,1,1,0.4988662131519274,0.5011337868480725
94801,0.5121951219512195,0.5348837209302326,-105,-115,0.48808156828023186,0.5119184317197681,home,PIT,under,7,0.5238095238095238,-110,0.5011337868480725,PIT,CHC,2024 REG,11,10,10,9,19,21,1,0,1,-1,1,1,1,1,1,1,1,1,1,0.4988662131519274,0.5011337868480725
94802,0.6941896024464832,0.34602076124567477,-227,189,0.6662759860607955,0.3337240139392045,away,CWS,over,8.5,0.5145631067961165,-106,0.4891195935000339,CLE,CWS,2024 REG,12,8,8,4,12,20,1,0,4,-4,1,1,1,1,0,0,0,0,0,0.4891195935000339,0.5108804064999661
94802,0.6941896024464832,0.34602076124567477,-227,189,0.6662759860607955,0.3337240139392045,home,CLE,under,8.5,0.5348837209302326,-115,0.5108804064999661,CLE,CWS,2024 REG,12,8,8,4,12,20,1,0,4,-4,1,1,1,1,0,0,0,0,0,0.4891195935000339,0.5108804064999661
94803,0.6108949416342413,0.425531914893617,-157,135,0.5886419592417365,0.41135804075826354,away,DET,over,9.5,0.49751243781094534,101,0.47511256217505476,BOS,DET,2024 REG,8,4,14,8,12,22,0,1,-4,4,1,1,1,1,0,0,0,0,0,0.47511256217505476,0.5248874378249453
94803,0.6108949416342413,0.425531914893617,-157,135,0.5886419592417365,0.41135804075826354,home,BOS,under,9.5,0.5475113122171946,-121,0.5248874378249453,BOS,DET,2024 REG,8,4,14,8,12,22,0,1,-4,4,1,1,1,1,0,0,0,0,0,0.47511256217505476,0.5248874378249453
94804,0.4291845493562232,0.607843137254902,133,-155,0.41329283836432396,0.586707161635676,away,STL,over,8,0.5283018867924528,-112,0.5031902949311281,MIA,STL,2024 REG,8,4,10,3,7,18,1,0,1,-1,1,1,1,0,0,0,0,0,0,0.5031902949311281,0.4968097050688719
94804,0.4291845493562232,0.607843137254902,133,-155,0.41329283836432396,0.586707161635676,home,MIA,under,8,0.5192307692307692,-108,0.4968097050688719,MIA,STL,2024 REG,8,4,10,3,7,18,1,0,1,-1,1,1,1,0,0,0,0,0,0,0.5031902949311281,0.4968097050688719
94805,0.6183206106870228,0.42194092827004215,-162,137,0.5934260713318911,0.40657392866810893,away,SD,over,8.5,0.5348837209302326,-115,0.5097020142727117,PHI,SD,2024 REG,13,4,4,3,7,17,1,0,1,-1,1,1,1,0,0,0,0,0,0,0.5097020142727117,0.49029798572728833
94805,0.6183206106870228,0.42194092827004215,-162,137,0.5934260713318911,0.40657392866810893,home,PHI,under,8.5,0.5121951219512195,-105,0.49029798572728833,PHI,SD,2024 REG,13,4,4,3,7,17,1,0,1,-1,1,1,1,0,0,0,0,0,0,0.5097020142727117,0.49029798572728833
94806,0.6551724137931035,0.3846153846153846,-190,160,0.6291045458703008,0.37089545412969915,away,PIT,over,8.5,0.5475113122171946,-121,0.5214983313199976,PHI,PIT,2024 REG,8,2,10,9,11,18,0,1,-7,7,1,1,0,0,0,0,0,0,0,0.5214983313199976,0.47850166868000243
94806,0.6551724137931035,0.3846153846153846,-190,160,0.6291045458703008,0.37089545412969915,home,PHI,under,8.5,0.5,100,0.47850166868000243,PHI,PIT,2024 REG,8,2,10,9,11,18,0,1,-7,7,1,1,0,0,0,0,0,0,0,0.5214983313199976,0.47850166868000243
94808,0.6875,0.35714285714285715,-220,180,0.6568080357142857,0.3431919642857143,away,SD,over,8,0.5348837209302326,-115,0.5097020142727117,ATL,SD,2024 REG,7,1,13,3,4,20,0,1,-2,2,1,0,0,0,0,0,0,0,0,0.5097020142727117,0.49029798572728833
94808,0.6875,0.35714285714285715,-220,180,0.6568080357142857,0.3431919642857143,home,ATL,under,8,0.5121951219512195,-105,0.49029798572728833,ATL,SD,2024 REG,7,1,13,3,4,20,0,1,-2,2,1,0,0,0,0,0,0,0,0,0.5097020142727117,0.49029798572728833
94810,0.4807692307692307,0.5594713656387665,108,-127,0.46142279018846283,0.5385772098115371,away,ATL,over,9,0.5,100,0.4772727272727273,STL,ATL,2024 REG,11,4,6,3,7,17,1,0,1,-1,1,1,1,0,0,0,0,0,0,0.4772727272727273,0.5227272727272727
94810,0.4807692307692307,0.5594713656387665,108,-127,0.46142279018846283,0.5385772098115371,home,STL,under,9,0.5454545454545454,-120,0.5227272727272727,STL,ATL,2024 REG,11,4,6,3,7,17,1,0,1,-1,1,1,1,0,0,0,0,0,0,0.4772727272727273,0.5227272727272727
94811,0.574468085106383,0.46511627906976744,-135,115,0.5517281312179562,0.44827186878204384,away,CIN,over,7,0.5073891625615764,-103,0.4816299493915137,SEA,CIN,2024 REG,8,3,4,1,4,12,1,0,2,-2,1,0,0,0,0,0,0,0,0,0.4816299493915137,0.5183700506084863
94811,0.574468085106383,0.46511627906976744,-135,115,0.5517281312179562,0.44827186878204384,home,SEA,under,7,0.5433789954337899,-119,0.5183700506084863,SEA,CIN,2024 REG,8,3,4,1,4,12,1,0,2,-2,1,0,0,0,0,0,0,0,0,0.4816299493915137,0.5183700506084863
94812,0.6655518394648829,0.37878787878787884,-199,164,0.6360414584204026,0.3639585415795974,away,COL,over,8.5,0.5192307692307692,-108,0.49455035168025013,CIN,COL,2024 REG,13,12,10,6,18,23,1,0,6,-6,1,1,1,1,1,1,0,0,0,0.49455035168025013,0.5054496483197499
94812,0.6655518394648829,0.37878787878787884,-199,164,0.6360414584204026,0.3639585415795974,home,CIN,under,8.5,0.5283018867924528,-112,0.5054496483197499,CIN,COL,2024 REG,13,12,10,6,18,23,1,0,6,-6,1,1,1,1,1,1,0,0,0,0.49455035168025013,0.5054496483197499
94813,0.6774193548387096,0.36363636363636365,-210,175,0.6496074165168858,0.3503925834831142,away,WSH,over,9,0.5238095238095238,-110,0.4988662131519274,ATL,WSH,2024 REG,8,4,15,8,12,23,0,1,-4,4,1,1,1,1,0,0,0,0,0,0.4988662131519274,0.5011337868480725
94813,0.6774193548387096,0.36363636363636365,-210,175,0.6496074165168858,0.3503925834831142,home,ATL,under,9,0.5238095238095238,-110,0.5011337868480725,ATL,WSH,2024 REG,8,4,15,8,12,23,0,1,-4,4,1,1,1,1,0,0,0,0,0,0.4988662131519274,0.5011337868480725
94816,0.47619047619047616,0.5652173913043479,110,-130,0.4564724440500838,0.5435275559499162,away,BOS,over,8,0.5215311004784688,-109,0.4978845547971712,MIA,BOS,2024 REG,9,2,12,7,9,21,0,1,-5,5,1,1,0,0,0,0,0,0,0,0.4978845547971712,0.5021154452028288
94816,0.47619047619047616,0.5652173913043479,110,-130,0.4564724440500838,0.5435275559499162,home,MIA,under,8,0.5238095238095238,-110,0.5021154452028288,MIA,BOS,2024 REG,9,2,12,7,9,21,0,1,-5,5,1,1,0,0,0,0,0,0,0,0.4978845547971712,0.5021154452028288
94817,0.4081632653061224,0.6323529411764706,145,-172,0.39162603817037017,0.6083739618296298,away,PHI,over,8,0.5348837209302326,-115,0.5097020142727117,LAA,PHI,2024 REG,9,5,11,7,12,20,0,1,-2,2,1,1,1,1,1,0,0,0,0,0.5097020142727117,0.49029798572728833
94817,0.4081632653061224,0.6323529411764706,145,-172,0.39162603817037017,0.6083739618296298,home,LAA,under,8,0.5121951219512195,-105,0.49029798572728833,LAA,PHI,2024 REG,9,5,11,7,12,20,0,1,-2,2,1,1,1,1,1,0,0,0,0,0.5097020142727117,0.49029798572728833
94819,0.7297297297297298,0.3125,-270,220,0.6989134404674946,0.3010865595325054,away,ARI,over,9.5,0.5,100,0.4762443438914027,PHI,ARI,2024 REG,14,12,2,1,13,16,1,0,11,-11,1,0,0,0,0,0,0,0,0,0.4762443438914027,0.5237556561085973
94819,0.7297297297297298,0.3125,-270,220,0.6989134404674946,0.3010865595325054,home,PHI,under,9.5,0.5475113122171946,-121,0.5237556561085973,PHI,ARI,2024 REG,14,12,2,1,13,16,1,0,11,-11,1,0,0,0,0,0,0,0,0,0.4762443438914027,0.5237556561085973
94820,0.5867768595041323,0.45454545454545453,-142,120,0.5625298818386723,0.43747011816132775,away,CIN,over,8,0.5348837209302326,-115,0.5097020142727117,PHI,CIN,2024 REG,9,9,8,4,13,17,1,0,5,-5,1,1,1,1,0,0,0,0,0,0.5097020142727117,0.49029798572728833
94820,0.5867768595041323,0.45454545454545453,-142,120,0.5625298818386723,0.43747011816132775,home,PHI,under,8,0.5121951219512195,-105,0.49029798572728833,PHI,CIN,2024 REG,9,9,8,4,13,17,1,0,5,-5,1,1,1,1,0,0,0,0,0,0.5097020142727117,0.49029798572728833
94822,0.4672897196261683,0.574468085106383,114,-135,0.4477767267604901,0.5522232732395099,away,CHC,over,9,0.5238095238095238,-110,0.4988662131519274,CIN,CHC,2024 REG,5,2,11,4,6,16,0,1,-2,2,1,1,0,0,0,0,0,0,0,0.4988662131519274,0.5011337868480725
94822,0.4672897196261683,0.574468085106383,114,-135,0.4477767267604901,0.5522232732395099,home,CIN,under,9,0.5238095238095238,-110,0.5011337868480725,CIN,CHC,2024 REG,5,2,11,4,6,16,0,1,-2,2,1,1,0,0,0,0,0,0,0,0.4988662131519274,0.5011337868480725
94823,0.5967741935483871,0.4444444444444444,-148,125,0.5721759741010521,0.42782402589894786,away,SEA,over,9,0.5121951219512195,-105,0.48808156828023186,TEX,SEA,2024 REG,8,5,8,1,6,16,1,0,4,-4,1,0,0,0,0,0,0,0,0,0.48808156828023186,0.5119184317197681
94823,0.5967741935483871,0.4444444444444444,-148,125,0.5721759741010521,0.42782402589894786,home,TEX,under,9,0.5348837209302326,-115,0.5119184317197681,TEX,SEA,2024 REG,8,5,8,1,6,16,1,0,4,-4,1,0,0,0,0,0,0,0,0,0.48808156828023186,0.5119184317197681
94828,0.574468085106383,0.4694835680751174,-135,113,0.5492192630659467,0.4507807369340533,away,TOR,over,8.5,0.5,100,0.4772727272727273,TB,TOR,2024 REG,11,5,6,1,6,17,1,0,4,-4,1,0,0,0,0,0,0,0,0,0.4772727272727273,0.5227272727272727
94828,0.574468085106383,0.4694835680751174,-135,113,0.5492192630659467,0.4507807369340533,home,TB,under,8.5,0.5454545454545454,-120,0.5227272727272727,TB,TOR,2024 REG,11,5,6,1,6,17,1,0,4,-4,1,0,0,0,0,0,0,0,0,0.4772727272727273,0.5227272727272727
94830,0.574468085106383,0.46511627906976744,-135,115,0.5517281312179562,0.44827186878204384,away,NYM,over,8,0.5433789954337899,-119,0.5171177654451503,STL,NYM,2024 REG,8,3,10,4,7,18,0,1,-1,1,1,1,1,0,0,0,0,0,0,0.5171177654451503,0.4828822345548497
94830,0.574468085106383,0.46511627906976744,-135,115,0.5517281312179562,0.44827186878204384,home,STL,under,8,0.504950495049505,-102,0.4828822345548497,STL,NYM,2024 REG,8,3,10,4,7,18,0,1,-1,1,1,1,1,0,0,0,0,0,0,0.5171177654451503,0.4828822345548497
94831,0.5121951219512195,0.5305164319248826,-105,-113,0.4903184724049234,0.5096815275950766,away,MIL,over,7.5,0.5260663507109005,-111,0.5010269332605688,HOU,MIL,2024 REG,10,5,7,4,9,17,1,0,1,-1,1,1,1,1,0,0,0,0,0,0.5010269332605688,0.4989730667394312
94831,0.5121951219512195,0.5305164319248826,-105,-113,0.4903184724049234,0.5096815275950766,home,HOU,under,7.5,0.5215311004784688,-109,0.4989730667394312,HOU,MIL,2024 REG,10,5,7,4,9,17,1,0,1,-1,1,1,1,1,0,0,0,0,0,0.5010269332605688,0.4989730667394312
94832,0.6309963099630996,0.4081632653061224,-171,145,0.6062867624684983,0.39371323753150167,away,MIL,over,8,0.5238095238095238,-110,0.4988662131519274,DET,MIL,2024 REG,12,10,7,2,12,19,1,0,8,-8,1,1,0,0,0,0,0,0,0,0.4988662131519274,0.5011337868480725
94832,0.6309963099630996,0.4081632653061224,-171,145,0.6062867624684983,0.39371323753150167,home,DET,under,8,0.5238095238095238,-110,0.5011337868480725,DET,MIL,2024 REG,12,10,7,2,12,19,1,0,8,-8,1,1,0,0,0,0,0,0,0,0.4988662131519274,0.5011337868480725
94835,0.5073891625615764,0.5348837209302326,-103,-115,0.4859403596076043,0.5140596403923957,away,STL,over,9,0.5238095238095238,-110,0.4988662131519274,DET,STL,2024 REG,8,4,7,1,5,15,1,0,3,-3,1,0,0,0,0,0,0,0,0,0.4988662131519274,0.5011337868480725
94835,0.5073891625615764,0.5348837209302326,-103,-115,0.4859403596076043,0.5140596403923957,home,DET,under,9,0.5238095238095238,-110,0.5011337868480725,DET,STL,2024 REG,8,4,7,1,5,15,1,0,3,-3,1,0,0,0,0,0,0,0,0,0.4988662131519274,0.5011337868480725
94838,0.6923076923076923,0.35460992907801414,-225,182,0.6598262621175878,0.34017373788241223,away,COL,over,7,0.5454545454545454,-120,0.5179608869977906,CWS,COL,2024 REG,10,4,6,5,9,16,0,1,-1,1,1,1,1,1,0,0,0,0,0,0.5179608869977906,0.48203911300220936
94838,0.6923076923076923,0.35460992907801414,-225,182,0.6598262621175878,0.34017373788241223,home,CWS,under,7,0.504950495049505,-102,0.48203911300220936,CWS,COL,2024 REG,10,4,6,5,9,16,0,1,-1,1,1,1,1,1,0,0,0,0,0,0.5179608869977906,0.48203911300220936
94839,0.6031746031746031,0.4347826086956522,-152,130,0.5802797769671475,0.4197202230328525,away,HOU,over,8,0.5238095238095238,-110,0.4988662131519274,MIN,HOU,2024 REG,17,12,16,13,25,33,0,1,-1,1,1,1,1,1,1,1,1,1,1,0.4988662131519274,0.5011337868480725
94839,0.6031746031746031,0.4347826086956522,-152,130,0.5802797769671475,0.4197202230328525,home,MIN,under,8,0.5238095238095238,-110,0.5011337868480725,MIN,HOU,2024 REG,17,12,16,13,25,33,0,1,-1,1,1,1,1,1,1,1,1,1,1,0.4988662131519274,0.5011337868480725
94841,0.45454545454545453,0.5850622406639003,120,-141,0.4365419567230205,0.5634580432769796,away,CLE,over,8.5,0.5121951219512195,-105,0.48808156828023186,DET,CLE,2024 REG,11,8,14,9,17,25,0,1,-1,1,1,1,1,1,1,1,1,1,0,0.48808156828023186,0.5119184317197681
94841,0.45454545454545453,0.5850622406639003,120,-141,0.4365419567230205,0.5634580432769796,home,DET,under,8.5,0.5348837209302326,-115,0.5119184317197681,DET,CLE,2024 REG,11,8,14,9,17,25,0,1,-1,1,1,1,1,1,1,1,1,1,0,0.48808156828023186,0.5119184317197681
94843,0.4065040650406504,0.6336996336996338,146,-173,0.39016109807305516,0.6098389019269448,away,BAL,over,8,0.5348837209302326,-115,0.5097020142727117,CWS,BAL,2024 REG,5,3,8,5,8,13,0,1,-2,2,1,1,1,0,0,0,0,0,0,0.5097020142727117,0.49029798572728833
94843,0.4065040650406504,0.6336996336996338,146,-173,0.39016109807305516,0.6098389019269448,home,CWS,under,8,0.5121951219512195,-105,0.49029798572728833,CWS,BAL,2024 REG,5,3,8,5,8,13,0,1,-2,2,1,1,1,0,0,0,0,0,0,0.5097020142727117,0.49029798572728833
94844,0.6226415094339623,0.4166666666666667,-165,140,0.5981666073335706,0.40183339266642937,away,LAA,over,8.5,0.5454545454545454,-120,0.5206611570247933,SF,LAA,2024 REG,16,13,9,6,19,25,1,0,7,-7,1,1,1,1,1,1,0,0,0,0.5206611570247933,0.4793388429752067
94844,0.6226415094339623,0.4166666666666667,-165,140,0.5981666073335706,0.40183339266642937,home,SF,under,8.5,0.5,100,0.4793388429752067,SF,LAA,2024 REG,16,13,9,6,19,25,1,0,7,-7,1,1,1,1,1,1,0,0,0,0.5206611570247933,0.4793388429752067
94845,0.5192307692307692,0.5238095238095238,-108,-110,0.49688292476754015,0.5031170752324599,away,STL,over,9,0.5192307692307692,-108,0.49455035168025013,PIT,STL,2024 REG,7,2,10,3,5,17,0,1,-1,1,1,1,0,0,0,0,0,0,0,0.49455035168025013,0.5054496483197499
94845,0.5192307692307692,0.5238095238095238,-108,-110,0.49688292476754015,0.5031170752324599,home,PIT,under,9,0.5283018867924528,-112,0.5054496483197499,PIT,STL,2024 REG,7,2,10,3,5,17,0,1,-1,1,1,1,0,0,0,0,0,0,0,0.49455035168025013,0.5054496483197499
94846,0.6000000000000001,0.43859649122807015,-150,128,0.5768421052631579,0.42315789473684207,away,TOR,over,9,0.5348837209302326,-115,0.5097020142727117,HOU,TOR,2024 REG,12,10,0,0,10,12,1,0,10,-10,0,0,0,0,0,0,0,0,0,0.5097020142727117,0.49029798572728833
94846,0.6000000000000001,0.43859649122807015,-150,128,0.5768421052631579,0.42315789473684207,home,HOU,under,9,0.5121951219512195,-105,0.49029798572728833,HOU,TOR,2024 REG,12,10,0,0,10,12,1,0,10,-10,0,0,0,0,0,0,0,0,0,0.5097020142727117,0.49029798572728833
94847,0.576271186440678,0.4629629629629629,-136,116,0.553661676614851,0.446338323385149,away,MIL,over,8,0.5412844036697247,-118,0.5136310900085983,STL,MIL,2024 REG,6,5,18,12,17,24,0,1,-7,7,1,1,1,1,1,0,0,0,0,0.5136310900085983,0.4863689099914017
94847,0.576271186440678,0.4629629629629629,-136,116,0.553661676614851,0.446338323385149,home,STL,under,8,0.5098039215686274,-104,0.4863689099914017,STL,MIL,2024 REG,6,5,18,12,17,24,0,1,-7,7,1,1,1,1,1,0,0,0,0,0.5136310900085983,0.4863689099914017
94848,0.6845425867507886,0.35714285714285715,-217,180,0.6560071251579774,0.34399287484202257,away,CWS,over,8.5,0.5121951219512195,-105,0.48808156828023186,CLE,CWS,2024 REG,5,2,12,8,10,17,0,1,-6,6,1,1,0,0,0,0,0,0,0,0.48808156828023186,0.5119184317197681
94848,0.6845425867507886,0.35714285714285715,-217,180,0.6560071251579774,0.34399287484202257,home,CLE,under,8.5,0.5348837209302326,-115,0.5119184317197681,CLE,CWS,2024 REG,5,2,12,8,10,17,0,1,-6,6,1,1,0,0,0,0,0,0,0,0.48808156828023186,0.5119184317197681
94849,0.5833333333333333,0.45454545454545453,-140,120,0.5612373737373737,0.4387626262626263,away,DET,over,8.5,0.5238095238095238,-110,0.4988662131519274,CLE,DET,2024 REG,8,7,15,11,18,23,0,1,-4,4,1,1,1,1,1,1,1,0,0,0.4988662131519274,0.5011337868480725
94849,0.5833333333333333,0.45454545454545453,-140,120,0.5612373737373737,0.4387626262626263,home,CLE,under,8.5,0.5238095238095238,-110,0.5011337868480725,CLE,DET,2024 REG,8,7,15,11,18,23,0,1,-4,4,1,1,1,1,1,1,1,0,0,0.4988662131519274,0.5011337868480725
94850,0.6644295302013422,0.37735849056603776,-198,165,0.636664335194828,0.363335664805172,away,CHC,over,7.5,0.5433789954337899,-119,0.5171177654451503,ATL,CHC,2024 REG,9,7,3,0,7,12,1,0,7,-7,0,0,0,0,0,0,0,0,0,0.5171177654451503,0.4828822345548497
94850,0.6644295302013422,0.37735849056603776,-198,165,0.636664335194828,0.363335664805172,home,ATL,under,7.5,0.504950495049505,-102,0.4828822345548497,ATL,CHC,2024 REG,9,7,3,0,7,12,1,0,7,-7,0,0,0,0,0,0,0,0,0,0.5171177654451503,0.4828822345548497
94853,0.5348837209302326,0.5121951219512195,-115,-105,0.5097020142727117,0.49029798572728833,away,BOS,over,7.5,0.5348837209302326,-115,0.5097020142727117,SEA,BOS,2024 REG,4,1,10,5,6,14,0,1,-4,4,1,0,0,0,0,0,0,0,0,0.5097020142727117,0.49029798572728833
94853,0.5348837209302326,0.5121951219512195,-115,-105,0.5097020142727117,0.49029798572728833,home,SEA,under,7.5,0.5121951219512195,-105,0.49029798572728833,SEA,BOS,2024 REG,4,1,10,5,6,14,0,1,-4,4,1,0,0,0,0,0,0,0,0,0.5097020142727117,0.49029798572728833
94855,0.47619047619047616,0.5652173913043479,110,-130,0.4564724440500838,0.5435275559499162,away,HOU,over,8.5,0.5238095238095238,-110,0.4988662131519274,KC,HOU,2024 REG,16,13,11,3,16,27,1,0,10,-10,1,1,1,0,0,0,0,0,0,0.4988662131519274,0.5011337868480725
94855,0.47619047619047616,0.5652173913043479,110,-130,0.4564724440500838,0.5435275559499162,home,KC,under,8.5,0.5238095238095238,-110,0.5011337868480725,KC,HOU,2024 REG,16,13,11,3,16,27,1,0,10,-10,1,1,1,0,0,0,0,0,0,0.4988662131519274,0.5011337868480725
94856,0.7311827956989247,0.3125,-272,220,0.69924268701584,0.30075731298416,away,CLE,over,8.5,0.5121951219512195,-105,0.48919479393107135,ATL,CLE,2024 REG,8,6,5,2,8,13,1,0,4,-4,1,1,0,0,0,0,0,0,0,0.48919479393107135,0.5108052060689287
94856,0.7311827956989247,0.3125,-272,220,0.69924268701584,0.30075731298416,home,ATL,under,8.5,0.5327102803738317,-114,0.5108052060689287,ATL,CLE,2024 REG,8,6,5,2,8,13,1,0,4,-4,1,1,0,0,0,0,0,0,0,0.48919479393107135,0.5108052060689287
94859,0.6282527881040892,0.4132231404958678,-169,142,0.60219542032196,0.39780457967803995,away,TB,over,7.5,0.5,100,0.4772727272727273,MIN,TB,2024 REG,9,2,8,3,5,17,0,1,-1,1,1,1,0,0,0,0,0,0,0,0.4772727272727273,0.5227272727272727
94859,0.6282527881040892,0.4132231404958678,-169,142,0.60219542032196,0.39780457967803995,home,MIN,under,7.5,0.5454545454545454,-120,0.5227272727272727,MIN,TB,2024 REG,9,2,8,3,5,17,0,1,-1,1,1,1,0,0,0,0,0,0,0,0.4772727272727273,0.5227272727272727
94860,0.6621621621621622,0.37735849056603776,-196,165,0.6359930813015974,0.3640069186984026,away,OAK,over,8.5,0.5121951219512195,-105,0.48808156828023186,ARI,OAK,2024 REG,12,3,2,0,3,14,1,0,3,-3,0,0,0,0,0,0,0,0,0,0.48808156828023186,0.5119184317197681
94860,0.6621621621621622,0.37735849056603776,-196,165,0.6359930813015974,0.3640069186984026,home,ARI,under,8.5,0.5348837209302326,-115,0.5119184317197681,ARI,OAK,2024 REG,12,3,2,0,3,14,1,0,3,-3,0,0,0,0,0,0,0,0,0,0.48808156828023186,0.5119184317197681
94861,0.5454545454545454,0.5,-120,100,0.5206611570247933,0.4793388429752067,away,KC,over,8.5,0.5348837209302326,-115,0.5097020142727117,STL,KC,2024 REG,10,5,12,8,13,22,0,1,-3,3,1,1,1,1,1,0,0,0,0,0.5097020142727117,0.49029798572728833
94861,0.5454545454545454,0.5,-120,100,0.5206611570247933,0.4793388429752067,home,STL,under,8.5,0.5121951219512195,-105,0.49029798572728833,STL,KC,2024 REG,10,5,12,8,13,22,0,1,-3,3,1,1,1,1,1,0,0,0,0,0.5097020142727117,0.49029798572728833
94862,0.4484304932735426,0.5951417004048584,123,-147,0.4288913929693269,0.5711086070306731,away,TB,over,11,0.5348837209302326,-115,0.5097020142727117,COL,TB,2024 REG,7,2,8,3,5,15,0,1,-1,1,1,1,0,0,0,0,0,0,0,0.5097020142727117,0.49029798572728833
94862,0.4484304932735426,0.5951417004048584,123,-147,0.4288913929693269,0.5711086070306731,home,COL,under,11,0.5121951219512195,-105,0.49029798572728833,COL,TB,2024 REG,7,2,8,3,5,15,0,1,-1,1,1,1,0,0,0,0,0,0,0,0.5097020142727117,0.49029798572728833
94865,0.6865203761755486,0.35714285714285715,-219,180,0.656544676812756,0.34345532318724403,away,OAK,over,8,0.5348837209302326,-115,0.5097020142727117,NYY,OAK,2024 REG,5,4,7,3,7,12,1,0,1,-1,1,1,1,0,0,0,0,0,0,0.5097020142727117,0.49029798572728833
94865,0.6865203761755486,0.35714285714285715,-219,180,0.656544676812756,0.34345532318724403,home,NYY,under,8,0.5121951219512195,-105,0.49029798572728833,NYY,OAK,2024 REG,5,4,7,3,7,12,1,0,1,-1,1,1,1,0,0,0,0,0,0,0.5097020142727117,0.49029798572728833
94866,0.6453900709219857,0.39370078740157477,-182,154,0.6201612190961417,0.37983878090385825,away,CWS,over,7.5,0.49504950495049505,102,0.47297076509898783,SEA,CWS,2024 REG,5,4,10,3,7,15,1,0,1,-1,1,1,1,0,0,0,0,0,0,0.47297076509898783,0.5270292349010122
94866,0.6453900709219857,0.39370078740157477,-182,154,0.6201612190961417,0.37983878090385825,home,SEA,under,7.5,0.5495495495495495,-122,0.5270292349010122,SEA,CWS,2024 REG,5,4,10,3,7,15,1,0,1,-1,1,1,1,0,0,0,0,0,0,0.47297076509898783,0.5270292349010122
94868,0.5515695067264574,0.49019607843137253,-123,104,0.5285328835228112,0.47146711647718875,away,NYY,over,7.5,0.49019607843137253,104,0.46680480278177555,SD,NYY,2024 REG,4,1,9,4,5,13,0,1,-3,3,1,0,0,0,0,0,0,0,0,0.46680480278177555,0.5331951972182245
94868,0.5515695067264574,0.49019607843137253,-123,104,0.5285328835228112,0.47146711647718875,home,SD,under,7.5,0.5575221238938054,-126,0.5331951972182245,SD,NYY,2024 REG,4,1,9,4,5,13,0,1,-3,3,1,0,0,0,0,0,0,0,0,0.46680480278177555,0.5331951972182245
94870,0.3508771929824561,0.6923076923076923,185,-225,0.3357246016525795,0.6642753983474206,away,BAL,over,8.5,0.5391705069124424,-117,0.5140669063204599,WSH,BAL,2024 REG,6,3,3,0,3,9,1,0,3,-3,0,0,0,0,0,0,0,0,0,0.5140669063204599,0.4859330936795401
94870,0.3508771929824561,0.6923076923076923,185,-225,0.3357246016525795,0.6642753983474206,home,WSH,under,8.5,0.5073891625615764,-103,0.4859330936795401,WSH,BAL,2024 REG,6,3,3,0,3,9,1,0,3,-3,0,0,0,0,0,0,0,0,0,0.5140669063204599,0.4859330936795401
94871,0.5348837209302326,0.5073891625615764,-115,-103,0.5122726437136835,0.48772735628631647,away,CWS,over,6.5,0.5454545454545454,-120,0.5206611570247933,SEA,CWS,2024 REG,3,2,8,3,5,11,0,1,-1,1,1,1,0,0,0,0,0,0,0,0.5206611570247933,0.4793388429752067
94871,0.5348837209302326,0.5073891625615764,-115,-103,0.5122726437136835,0.48772735628631647,home,SEA,under,6.5,0.5,100,0.4793388429752067,SEA,CWS,2024 REG,3,2,8,3,5,11,0,1,-1,1,1,1,0,0,0,0,0,0,0,0.5206611570247933,0.4793388429752067
94877,0.6047430830039526,0.4366812227074236,-153,129,0.5796920206567566,0.4203079793432434,away,KC,over,7.5,0.5238095238095238,-110,0.4988662131519274,LAD,KC,2024 REG,8,4,5,3,7,13,1,0,1,-1,1,1,1,0,0,0,0,0,0,0.4988662131519274,0.5011337868480725
94877,0.6047430830039526,0.4366812227074236,-153,129,0.5796920206567566,0.4203079793432434,home,LAD,under,7.5,0.5238095238095238,-110,0.5011337868480725,LAD,KC,2024 REG,8,4,5,3,7,13,1,0,1,-1,1,1,1,0,0,0,0,0,0,0.4988662131519274,0.5011337868480725
94878,0.48780487804878053,0.5555555555555556,105,-125,0.4666534470222751,0.5333465529777248,away,DET,over,9.5,0.504950495049505,-102,0.47949844489399435,LAA,DET,2024 REG,10,5,2,2,7,12,1,0,3,-3,1,1,0,0,0,0,0,0,0,0.47949844489399435,0.5205015551060057
94878,0.48780487804878053,0.5555555555555556,105,-125,0.4666534470222751,0.5333465529777248,home,LAA,under,9.5,0.5454545454545454,-120,0.5205015551060057,LAA,DET,2024 REG,10,5,2,2,7,12,1,0,3,-3,1,1,0,0,0,0,0,0,0,0.47949844489399435,0.5205015551060057
94879,0.4,0.6428571428571428,150,-180,0.38285714285714295,0.617142857142857,away,HOU,over,9,0.5,100,0.4772727272727273,CWS,HOU,2024 REG,2,2,7,0,2,9,1,0,2,-2,0,0,0,0,0,0,0,0,0,0.4772727272727273,0.5227272727272727
94879,0.4,0.6428571428571428,150,-180,0.38285714285714295,0.617142857142857,home,CWS,under,9,0.5454545454545454,-120,0.5227272727272727,CWS,HOU,2024 REG,2,2,7,0,2,9,1,0,2,-2,0,0,0,0,0,0,0,0,0,0.4772727272727273,0.5227272727272727
94880,0.4,0.6428571428571428,150,-180,0.38285714285714295,0.617142857142857,away,MIN,over,8.5,0.5348837209302326,-115,0.5097020142727117,CWS,MIN,2024 REG,12,5,9,6,11,21,0,1,-1,1,1,1,1,1,1,0,0,0,0,0.5097020142727117,0.49029798572728833
94880,0.4,0.6428571428571428,150,-180,0.38285714285714295,0.617142857142857,home,CWS,under,8.5,0.5121951219512195,-105,0.49029798572728833,CWS,MIN,2024 REG,12,5,9,6,11,21,0,1,-1,1,1,1,1,1,1,0,0,0,0,0.5097020142727117,0.49029798572728833
94882,0.5238095238095238,0.5192307692307692,-110,-108,0.5012646084074657,0.4987353915925343,away,BAL,over,8.5,0.5238095238095238,-110,0.4988662131519274,TB,BAL,2024 REG,9,3,9,6,9,18,0,1,-3,3,1,1,1,0,0,0,0,0,0,0.4988662131519274,0.5011337868480725
94882,0.5238095238095238,0.5192307692307692,-110,-108,0.5012646084074657,0.4987353915925343,home,TB,under,8.5,0.5238095238095238,-110,0.5011337868480725,TB,BAL,2024 REG,9,3,9,6,9,18,0,1,-3,3,1,1,1,0,0,0,0,0,0,0.4988662131519274,0.5011337868480725
94885,0.5918367346938775,0.45454545454545453,-145,120,0.5643860512665178,0.43561394873348225,away,ARI,over,9.5,0.5327102803738317,-114,0.5075272610403079,PHI,ARI,2024 REG,7,4,9,5,9,16,0,1,-1,1,1,1,1,1,0,0,0,0,0,0.5075272610403079,0.4924727389596921
94885,0.5918367346938775,0.45454545454545453,-145,120,0.5643860512665178,0.43561394873348225,home,PHI,under,9.5,0.5145631067961165,-106,0.4924727389596921,PHI,ARI,2024 REG,7,4,9,5,9,16,0,1,-1,1,1,1,1,1,0,0,0,0,0,0.5075272610403079,0.4924727389596921
94887,0.48780487804878053,0.5535714285714286,105,-124,0.4676213138438005,0.5323786861561994,away,CIN,over,8,0.5348837209302326,-115,0.5097020142727117,PIT,CIN,2024 REG,4,1,9,2,3,13,0,1,-1,1,1,0,0,0,0,0,0,0,0,0.5097020142727117,0.49029798572728833
94887,0.48780487804878053,0.5535714285714286,105,-124,0.4676213138438005,0.5323786861561994,home,PIT,under,8,0.5121951219512195,-105,0.49029798572728833,PIT,CIN,2024 REG,4,1,9,2,3,13,0,1,-1,1,1,0,0,0,0,0,0,0,0,0.5097020142727117,0.49029798572728833
94889,0.6610169491525424,0.3802281368821293,-195,163,0.6337532482143695,0.3662467517856305,away,LAA,over,8,0.504950495049505,-102,0.48160416005266615,BAL,LAA,2024 REG,10,11,2,3,14,12,1,0,8,-8,1,1,1,0,0,0,0,0,0,0.48160416005266615,0.5183958399473338
94889,0.6610169491525424,0.3802281368821293,-195,163,0.6337532482143695,0.3662467517856305,home,BAL,under,8,0.5412844036697247,-118,0.5183958399473338,BAL,LAA,2024 REG,10,11,2,3,14,12,1,0,8,-8,1,1,1,0,0,0,0,0,0,0.48160416005266615,0.5183958399473338
94892,0.47846889952153115,0.5614035087719298,109,-128,0.45939119220408575,0.5406088077959142,away,ARI,over,7.5,0.5121951219512195,-105,0.48808156828023186,SEA,ARI,2024 REG,5,6,3,1,7,8,1,0,5,-5,1,0,0,0,0,0,0,0,0,0.48808156828023186,0.5119184317197681
94892,0.47846889952153115,0.5614035087719298,109,-128,0.45939119220408575,0.5406088077959142,home,SEA,under,7.5,0.5348837209302326,-115,0.5119184317197681,SEA,ARI,2024 REG,5,6,3,1,7,8,1,0,5,-5,1,0,0,0,0,0,0,0,0,0.48808156828023186,0.5119184317197681
94895,0.6240601503759399,0.41493775933609955,-166,141,0.5997231089766972,0.40027689102330277,away,DET,over,8,0.504950495049505,-102,0.4826715732667395,TB,DET,2024 REG,7,2,6,4,6,13,0,1,-2,2,1,1,0,0,0,0,0,0,0,0.4826715732667395,0.5173284267332605
94895,0.6240601503759399,0.41493775933609955,-166,141,0.5997231089766972,0.40027689102330277,home,TB,under,8,0.5391705069124424,-117,0.5173284267332605,TB,DET,2024 REG,7,2,6,4,6,13,0,1,-2,2,1,1,0,0,0,0,0,0,0,0.4826715732667395,0.5173284267332605
94897,0.4081632653061224,0.6323529411764706,145,-172,0.39162603817037017,0.6083739618296298,away,KC,over,8.5,0.5515695067264574,-123,0.5258558814517258,CWS,KC,2024 REG,6,2,5,1,3,11,1,0,1,-1,1,0,0,0,0,0,0,0,0,0.5258558814517258,0.4741441185482742
94897,0.4081632653061224,0.6323529411764706,145,-172,0.39162603817037017,0.6083739618296298,home,CWS,under,8.5,0.49504950495049505,102,0.4741441185482742,CWS,KC,2024 REG,6,2,5,1,3,11,1,0,1,-1,1,0,0,0,0,0,0,0,0,0.5258558814517258,0.4741441185482742
94899,0.6774193548387096,0.36363636363636365,-210,175,0.6496074165168858,0.3503925834831142,away,OAK,over,9,0.5121951219512195,-105,0.48808156828023186,MIN,OAK,2024 REG,12,6,9,2,8,21,1,0,4,-4,1,1,0,0,0,0,0,0,0,0.48808156828023186,0.5119184317197681
94899,0.6774193548387096,0.36363636363636365,-210,175,0.6496074165168858,0.3503925834831142,home,MIN,under,9,0.5348837209302326,-115,0.5119184317197681,MIN,OAK,2024 REG,12,6,9,2,8,21,1,0,4,-4,1,1,0,0,0,0,0,0,0,0.48808156828023186,0.5119184317197681
94901,0.5454545454545454,0.49751243781094534,-120,101,0.5220180091279142,0.4779819908720858,away,SD,over,7.5,0.5348837209302326,-115,0.5097020142727117,SF,SD,2024 REG,5,3,6,2,5,11,1,0,1,-1,1,1,0,0,0,0,0,0,0,0.5097020142727117,0.49029798572728833
94901,0.5454545454545454,0.49751243781094534,-120,101,0.5220180091279142,0.4779819908720858,home,SF,under,7.5,0.5121951219512195,-105,0.49029798572728833,SF,SD,2024 REG,5,3,6,2,5,11,1,0,1,-1,1,1,0,0,0,0,0,0,0,0.5097020142727117,0.49029798572728833
94903,0.6363636363636364,0.40485829959514175,-175,147,0.6101314952989593,0.38986850470104073,away,CIN,over,7.5,0.5238095238095238,-110,0.4988662131519274,PHI,CIN,2024 REG,6,1,6,4,5,12,0,1,-3,3,1,0,0,0,0,0,0,0,0,0.4988662131519274,0.5011337868480725
94903,0.6363636363636364,0.40485829959514175,-175,147,0.6101314952989593,0.38986850470104073,home,PHI,under,7.5,0.5238095238095238,-110,0.5011337868480725,PHI,CIN,2024 REG,6,1,6,4,5,12,0,1,-3,3,1,0,0,0,0,0,0,0,0,0.4988662131519274,0.5011337868480725
94904,0.574468085106383,0.4672897196261683,-135,114,0.550479558983428,0.44952044101657196,away,SEA,over,7,0.5515695067264574,-123,0.5258558814517258,BAL,SEA,2024 REG,6,3,7,4,7,13,0,1,-1,1,1,1,1,0,0,0,0,0,0,0.5258558814517258,0.4741441185482742
94904,0.574468085106383,0.4672897196261683,-135,114,0.550479558983428,0.44952044101657196,home,BAL,under,7,0.49504950495049505,102,0.4741441185482742,BAL,SEA,2024 REG,6,3,7,4,7,13,0,1,-1,1,1,1,1,0,0,0,0,0,0,0.5258558814517258,0.4741441185482742
94905,0.6774193548387096,0.36363636363636365,-210,175,0.6496074165168858,0.3503925834831142,away,OAK,over,8.5,0.5475113122171946,-121,0.5214983313199976,TEX,OAK,2024 REG,7,3,5,4,7,12,0,1,-1,1,1,1,1,0,0,0,0,0,0,0.5214983313199976,0.47850166868000243
94905,0.6774193548387096,0.36363636363636365,-210,175,0.6496074165168858,0.3503925834831142,home,TEX,under,8.5,0.5,100,0.47850166868000243,TEX,OAK,2024 REG,7,3,5,4,7,12,0,1,-1,1,1,1,1,0,0,0,0,0,0,0.5214983313199976,0.47850166868000243
94906,0.6491228070175439,0.39525691699604737,-185,153,0.6203149159911776,0.3796850840088224,away,LAA,over,8.5,0.5454545454545454,-120,0.5206611570247933,LAD,LAA,2024 REG,5,2,4,3,5,9,0,1,-1,1,1,1,0,0,0,0,0,0,0,0.5206611570247933,0.4793388429752067
94906,0.6491228070175439,0.39525691699604737,-185,153,0.6203149159911776,0.3796850840088224,home,LAD,under,8.5,0.5,100,0.4793388429752067,LAD,LAA,2024 REG,5,2,4,3,5,9,0,1,-1,1,1,1,0,0,0,0,0,0,0,0.5206611570247933,0.4793388429752067
94907,0.6610169491525424,0.3846153846153846,-195,160,0.6308532031025568,0.36914679689744323,away,LAA,over,9.5,0.5169082125603864,-107,0.49353874091423283,CHC,LAA,2024 REG,9,5,2,1,6,11,1,0,4,-4,1,0,0,0,0,0,0,0,0,0.49353874091423283,0.5064612590857671
94907,0.6610169491525424,0.3846153846153846,-195,160,0.6308532031025568,0.36914679689744323,home,CHC,under,9.5,0.5283018867924528,-112,0.5064612590857671,CHC,LAA,2024 REG,9,5,2,1,6,11,1,0,4,-4,1,0,0,0,0,0,0,0,0,0.49353874091423283,0.5064612590857671
94908,0.4347826086956522,0.607843137254902,130,-155,0.41624967567367205,0.583750324326328,away,MIL,over,9,0.5348837209302326,-115,0.5097020142727117,LAA,MIL,2024 REG,9,3,8,6,9,17,0,1,-3,3,1,1,1,0,0,0,0,0,0,0.5097020142727117,0.49029798572728833
94908,0.4347826086956522,0.607843137254902,130,-155,0.41624967567367205,0.583750324326328,home,LAA,under,9,0.5121951219512195,-105,0.49029798572728833,LAA,MIL,2024 REG,9,3,8,6,9,17,0,1,-3,3,1,1,1,0,0,0,0,0,0,0.5097020142727117,0.49029798572728833
94909,0.6047430830039526,0.4366812227074236,-153,129,0.5796920206567566,0.4203079793432434,away,LAA,over,8,0.5238095238095238,-110,0.4988662131519274,SF,LAA,2024 REG,10,6,11,8,14,21,0,1,-2,2,1,1,1,1,1,1,0,0,0,0.4988662131519274,0.5011337868480725
94909,0.6047430830039526,0.4366812227074236,-153,129,0.5796920206567566,0.4203079793432434,home,SF,under,8,0.5238095238095238,-110,0.5011337868480725,SF,LAA,2024 REG,10,6,11,8,14,21,0,1,-2,2,1,1,1,1,1,1,0,0,0,0.4988662131519274,0.5011337868480725
94910,0.45454545454545453,0.5833333333333333,120,-140,0.43732782369146006,0.5626721763085399,away,CHC,over,8,0.5121951219512195,-105,0.48808156828023186,SEA,CHC,2024 REG,6,1,6,4,5,12,0,1,-3,3,1,0,0,0,0,0,0,0,0,0.48808156828023186,0.5119184317197681
94910,0.45454545454545453,0.5833333333333333,120,-140,0.43732782369146006,0.5626721763085399,home,SEA,under,8,0.5348837209302326,-115,0.5119184317197681,SEA,CHC,2024 REG,6,1,6,4,5,12,0,1,-3,3,1,0,0,0,0,0,0,0,0,0.48808156828023186,0.5119184317197681
94912,0.5283018867924528,0.5145631067961165,-112,-106,0.5056562298022652,0.4943437701977348,away,LAD,over,8.5,0.5,100,0.4772727272727273,TOR,LAD,2024 REG,8,3,6,1,4,14,1,0,2,-2,1,0,0,0,0,0,0,0,0,0.4772727272727273,0.5227272727272727
94912,0.5283018867924528,0.5145631067961165,-112,-106,0.5056562298022652,0.4943437701977348,home,TOR,under,8.5,0.5454545454545454,-120,0.5227272727272727,TOR,LAD,2024 REG,8,3,6,1,4,14,1,0,2,-2,1,0,0,0,0,0,0,0,0,0.4772727272727273,0.5227272727272727
94913,0.6610169491525424,0.3802281368821293,-195,163,0.6337532482143695,0.3662467517856305,away,ATL,over,8.5,0.5121951219512195,-105,0.4826672435238765,LAD,ATL,2024 REG,16,11,6,2,13,22,1,0,9,-9,1,1,0,0,0,0,0,0,0,0.4826672435238765,0.5173327564761234
94913,0.6610169491525424,0.3802281368821293,-195,163,0.6337532482143695,0.3662467517856305,home,LAD,under,8.5,0.5454545454545454,-120,0.5173327564761234,LAD,ATL,2024 REG,16,11,6,2,13,22,1,0,9,-9,1,1,0,0,0,0,0,0,0,0.4826672435238765,0.5173327564761234
94914,0.5098039215686274,0.5348837209302326,-104,-115,0.4870219861770517,0.5129780138229483,away,CIN,over,11,0.5024875621890548,-101,0.4794401874631478,COL,CIN,2024 REG,9,3,18,13,16,27,0,1,-10,10,1,1,1,0,0,0,0,0,0,0.4794401874631478,0.5205598125368522
94914,0.5098039215686274,0.5348837209302326,-104,-115,0.4870219861770517,0.5129780138229483,home,COL,under,11,0.5433789954337899,-119,0.5205598125368522,COL,CIN,2024 REG,9,3,18,13,16,27,0,1,-10,10,1,1,1,0,0,0,0,0,0,0.4794401874631478,0.5205598125368522
94915,0.4504504504504505,0.5884773662551441,122,-143,0.4329153978803628,0.5670846021196372,away,NYY,over,8.5,0.5,100,0.4772727272727273,NYM,NYY,2024 REG,12,9,7,7,16,19,1,0,2,-2,1,1,1,1,1,1,1,0,0,0.4772727272727273,0.5227272727272727
94915,0.4504504504504505,0.5884773662551441,122,-143,0.4329153978803628,0.5670846021196372,home,NYM,under,8.5,0.5454545454545454,-120,0.5227272727272727,NYM,NYY,2024 REG,12,9,7,7,16,19,1,0,2,-2,1,1,1,1,1,1,1,0,0,0.4772727272727273,0.5227272727272727
94916,0.601593625498008,0.4347826086956522,-151,130,0.5797099148874794,0.42029008511252064,away,MIA,over,7.5,0.5283018867924528,-112,0.5044173060022736,OAK,MIA,2024 REG,5,3,7,1,4,12,1,0,2,-2,1,0,0,0,0,0,0,0,0,0.5044173060022736,0.49558269399772636
94916,0.601593625498008,0.4347826086956522,-151,130,0.5797099148874794,0.42029008511252064,home,OAK,under,7.5,0.5169082125603864,-107,0.49558269399772636,OAK,MIA,2024 REG,5,3,7,1,4,12,1,0,2,-2,1,0,0,0,0,0,0,0,0,0.5044173060022736,0.49558269399772636
