game_date,game_id.x,team,team_score,closing_total_line,closing_total_price,team_abbr,team_name,closing_spread_line,closing_spread_price,game_id.y,home_half_score,away_half_score,race_to_10,race_to_15,race_to_20,race_to_25,race_to_30,race_to_35,race_to_40,home_score,away_score,home_win_margin,total_1h,home_spread_1h,result_1h,home_away,team_half_score,team_spread,game_total
5/19/2018,303,CSChicago Sky,82,153,-110,CHI,Chicago Sky,2,-110,1021800002,34,36,0,0,1,1,1,1,1,64,82,18,70,2,away,away,36,-2,146
5/19/2018,304,IFIndiana Fever,64,153,-110,IND,Indiana Fever,-2,-110,1021800002,34,36,1,1,0,0,0,0,0,64,82,18,70,2,away,home,34,2,146
6/8/2018,305,ADAtlanta Dream,87,162.5,-110,ATL,Atlanta Dream,-4.5,-108,1021800044,32,38,1,0,1,1,1,1,1,83,87,4,70,6,away,away,38,-6,170
6/8/2018,306,LVLas Vegas Aces,83,162.5,-110,LVA,Las Vegas Aces,4.5,-112,1021800044,32,38,0,1,0,0,0,0,0,83,87,4,70,6,away,home,32,6,170
6/8/2018,301,DWDallas Wings,89,167,-110,DAL,Dallas Wings,-7,-110,1021800042,48,44,1,1,0,1,0,0,0,83,89,6,92,-4,home,away,44,4,172
6/8/2018,302,IFIndiana Fever,83,167.5,-110,IND,Indiana Fever,7,-110,1021800042,48,44,0,0,1,0,1,1,1,83,89,6,92,-4,home,home,48,-4,172
6/8/2018,303,CSChicago Sky,79,168,-110,CHI,Chicago Sky,9,-110,1021800043,49,35,0,0,0,0,0,0,0,96,79,-17,84,-14,home,away,35,14,175
6/8/2018,304,PPhoenix,96,168.5,-119,PHO,Phoenix Mercury,-9.5,103,1021800043,49,35,1,1,1,1,1,1,1,96,79,-17,84,-14,home,home,49,-14,175
6/10/2018,309,IFIndiana Fever,75,157,-110,IND,Indiana Fever,10,-105,1021800046,38,36,0,1,0,0,0,0,0,78,75,-3,74,-2,home,away,36,2,153
6/10/2018,310,NYNew York Liberty,78,157,-110,NYL,New York Liberty,-10,-115,1021800046,38,36,1,0,1,1,1,1,1,78,75,-3,74,-2,home,home,38,-2,153
6/10/2018,311,CSChicago Sky,59,166.5,-115,CHI,Chicago Sky,14,-110,1021800047,38,31,0,0,0,0,0,0,0,77,59,-18,69,-7,home,away,31,7,136
6/10/2018,312,LSL.A. Sparks,77,166.5,-105,LAS,Los Angeles Sparks,-14,-110,1021800047,38,31,1,1,1,1,1,1,1,77,59,-18,69,-7,home,home,38,-7,136
6/10/2018,313,LVLas Vegas Aces,66,167.5,-110,LVA,Las Vegas Aces,12,-110,1021800048,50,37,0,0,0,0,0,0,0,72,66,-6,87,-13,home,away,37,13,138
6/10/2018,314,PPhoenix,72,167.5,-110,PHO,Phoenix Mercury,-12,-110,1021800048,50,37,1,1,1,1,1,1,1,72,66,-6,87,-13,home,home,50,-13,138
6/10/2018,315,ADAtlanta Dream,67,166.5,-115,ATL,Atlanta Dream,7.5,-110,1021800049,31,39,1,1,1,1,1,1,1,64,67,3,70,8,away,away,39,-8,131
6/10/2018,316,SSSeattle Storm,64,166.5,-110,SEA,Seattle Storm,-7.5,-110,1021800049,31,39,0,0,0,0,0,0,0,64,67,3,70,8,away,home,31,8,131
6/27/2018,319,ADAtlanta Dream,80,157.5,-110,ATL,Atlanta Dream,2,-105,1021800085,30,38,1,1,1,1,1,1,1,93,80,-13,68,8,away,away,38,-8,173
6/27/2018,320,CSChicago Sky,93,157.5,-110,CHI,Chicago Sky,-2,-115,1021800085,30,38,0,0,0,0,0,0,0,93,80,-13,68,8,away,home,30,8,173
6/27/2018,321,IFIndiana Fever,89,166,-110,IND,Indiana Fever,11,-110,1021800086,52,36,0,0,0,0,0,0,0,101,89,-12,88,-16,home,away,36,16,190
6/27/2018,322,CSConnecticut Sun,101,166,-110,CON,Connecticut Sun,-11,-110,1021800086,52,36,1,1,1,1,1,1,1,101,89,-12,88,-16,home,home,52,-16,190
6/27/2018,323,DWDallas Wings,97,167.5,-110,DAL,Dallas Wings,-2,103,1021800087,52,55,0,0,0,1,0,1,1,91,97,6,107,3,away,away,55,-3,188
6/27/2018,324,LVLas Vegas Aces,91,167.5,-110,LVA,Las Vegas Aces,2,-123,1021800087,52,55,1,1,1,0,1,0,0,91,97,6,107,3,away,home,52,3,188
6/30/2018,613,PPhoenix,84,167.5,-110,PHO,Phoenix Mercury,NA,NA,1021800094,35,39,0,1,1,1,1,0,1,74,84,10,74,4,away,away,39,-4,158
6/30/2018,614,WMWashington Mystics,74,167.5,-110,WAS,Washington Mystics,NA,NA,1021800094,35,39,1,0,0,0,0,1,0,74,84,10,74,4,away,home,35,4,158
7/5/2018,601,NYNew York Liberty,67,160,-130,NYL,New York Liberty,8.5,-110,1021800104,42,41,0,0,0,0,1,1,0,86,67,-19,83,-1,home,away,41,1,153
7/5/2018,602,WMWashington Mystics,86,160,110,WAS,Washington Mystics,-8.5,-110,1021800104,42,41,1,1,1,1,0,0,1,86,67,-19,83,-1,home,home,42,-1,153
7/5/2018,605,IFIndiana Fever,63,167,-110,IND,Indiana Fever,10,-110,1021800105,44,32,0,0,0,0,0,0,0,90,63,-27,76,-12,home,away,32,12,153
7/5/2018,606,DWDallas Wings,90,167,-110,DAL,Dallas Wings,-10,-110,1021800105,44,32,1,1,1,1,1,1,1,90,63,-27,76,-12,home,home,44,-12,153
7/5/2018,603,LSL.A. Sparks,72,153.5,-110,LAS,Los Angeles Sparks,3.5,-110,1021800106,38,35,0,0,0,0,0,0,0,83,72,-11,73,-3,home,away,35,3,155
7/5/2018,604,MLMinnesota Lynx,83,153.5,-110,MIN,Minnesota Lynx,-3.5,-110,1021800106,38,35,1,1,1,1,1,1,1,83,72,-11,73,-3,home,home,38,-3,155
7/5/2018,609,CSChicago Sky,80,175.5,-110,CHI,Chicago Sky,4.5,-115,1021800107,51,53,0,0,1,1,1,0,0,84,80,-4,104,2,away,away,53,-2,164
7/5/2018,610,LVLas Vegas Aces,84,175.5,-110,LVA,Las Vegas Aces,-4.5,-105,1021800107,51,53,1,1,0,0,0,1,1,84,80,-4,104,2,away,home,51,2,164
7/5/2018,607,CSConnecticut Sun,77,170,-110,CON,Connecticut Sun,6.5,-110,1021800108,50,41,0,0,0,0,0,0,0,84,77,-7,91,-9,home,away,41,9,161
7/5/2018,608,PPhoenix,84,170,-110,PHO,Phoenix Mercury,-6.5,-110,1021800108,50,41,1,1,1,1,1,1,1,84,77,-7,91,-9,home,home,50,-9,161
7/11/2018,323,ADAtlanta Dream,106,164.5,-110,ATL,Atlanta Dream,7.5,-110,1021800120,50,59,0,0,0,0,0,1,1,89,106,17,109,9,away,away,59,-9,195
7/11/2018,324,WMWashington Mystics,89,164.5,-110,WAS,Washington Mystics,-7.5,-110,1021800120,50,59,1,1,1,1,1,0,0,89,106,17,109,9,away,home,50,9,195
7/11/2018,321,NYNew York Liberty,79,164,-125,NYL,New York Liberty,9,-110,1021800119,42,38,0,0,0,0,0,0,0,76,79,3,80,-4,home,away,38,4,155
7/11/2018,322,CSConnecticut Sun,76,164,105,CON,Connecticut Sun,-9,-110,1021800119,42,38,1,1,1,1,1,1,1,76,79,3,80,-4,home,home,42,-4,155
7/11/2018,325,MLMinnesota Lynx,87,155.5,-110,MIN,Minnesota Lynx,-9.5,-110,1021800121,33,44,1,1,1,1,1,1,1,65,87,22,77,11,away,away,44,-11,152
7/11/2018,326,IFIndiana Fever,65,155.5,-110,IND,Indiana Fever,9.5,-110,1021800121,33,44,0,0,0,0,0,0,0,65,87,22,77,11,away,home,33,11,152
7/13/2018,603,IFIndiana Fever,74,158.5,-115,IND,Indiana Fever,10,-110,1021800123,48,29,1,1,1,1,0,0,0,98,74,-24,77,-19,home,away,29,19,172
7/13/2018,604,ADAtlanta Dream,98,158.5,-105,ATL,Atlanta Dream,-10,-110,1021800123,48,29,0,0,0,0,1,1,1,98,74,-24,77,-19,home,home,48,-19,172
7/13/2018,605,PPhoenix,87,169,-110,PHO,Phoenix Mercury,5,-110,1021800124,43,45,0,0,0,0,0,0,0,91,87,-4,88,2,away,away,45,-2,178
7/13/2018,606,CSConnecticut Sun,91,169,-110,CON,Connecticut Sun,-5,-110,1021800124,43,45,1,1,1,1,1,1,1,91,87,-4,88,2,away,home,43,2,178
7/13/2018,607,CSChicago Sky,72,175,-110,CHI,Chicago Sky,10,-110,1021800125,45,33,0,0,1,1,0,0,0,88,72,-16,78,-12,home,away,33,12,160
7/13/2018,608,WMWashington Mystics,88,175,-110,WAS,Washington Mystics,-10,-110,1021800125,45,33,1,1,0,0,1,1,1,88,72,-16,78,-12,home,home,45,-12,160
7/13/2018,609,LVLas Vegas Aces,85,163.5,-115,LVA,Las Vegas Aces,8.5,-110,1021800126,46,49,0,0,0,1,1,0,0,77,85,8,95,3,away,away,49,-3,162
7/13/2018,610,MLMinnesota Lynx,77,163.5,-105,MIN,Minnesota Lynx,-8.5,-110,1021800126,46,49,1,1,1,0,0,1,1,77,85,8,95,3,away,home,46,3,162
7/14/2018,611,DWDallas Wings,84,175,-110,DAL,Dallas Wings,4.5,-110,1021800127,46,44,0,0,1,1,0,0,0,91,84,-7,90,-2,home,away,44,2,175
7/14/2018,612,SSSeattle Storm,91,175,-110,SEA,Seattle Storm,-4.5,-110,1021800127,46,44,1,1,0,0,1,1,1,91,84,-7,90,-2,home,home,46,-2,175
7/15/2018,615,WMWashington Mystics,77,166.5,-115,WAS,Washington Mystics,-3,-110,1021800128,37,36,1,1,1,1,1,0,0,80,77,-3,73,-1,home,away,36,1,157
7/15/2018,616,ADAtlanta Dream,80,166.5,-110,ATL,Atlanta Dream,3,-110,1021800128,37,36,0,0,0,0,0,1,1,80,77,-3,73,-1,home,home,37,-1,157
7/15/2018,613,CSChicago Sky,84,164,-110,CHI,Chicago Sky,4.5,-105,1021800129,53,47,0,0,0,0,1,0,0,107,84,-23,100,-6,home,away,47,6,191
7/15/2018,614,NYNew York Liberty,107,164,-110,NYL,New York Liberty,-4.5,-115,1021800129,53,47,1,1,1,1,0,1,1,107,84,-23,100,-6,home,home,53,-6,191
7/15/2018,617,PPhoenix,101,162.5,-110,PHO,Phoenix Mercury,-9.5,-110,1021800130,48,46,1,1,1,1,1,1,1,82,101,19,94,-2,home,away,46,2,183
7/15/2018,618,IFIndiana Fever,82,162.5,-110,IND,Indiana Fever,9.5,-110,1021800130,48,46,0,0,0,0,0,0,0,82,101,19,94,-2,home,home,48,-2,183
7/15/2018,619,LSL.A. Sparks,99,161.5,-110,LAS,Los Angeles Sparks,-5,-115,1021800131,47,48,0,1,1,1,0,1,1,78,99,21,95,1,away,away,48,-1,177
7/15/2018,620,LVLas Vegas Aces,78,161.5,-110,LVA,Las Vegas Aces,5,-110,1021800131,47,48,1,0,0,0,1,0,0,78,99,21,95,1,away,home,47,1,177
7/15/2018,621,CSConnecticut Sun,83,164,-110,CON,Connecticut Sun,3,-110,1021800132,33,44,0,1,1,1,1,1,1,64,83,19,77,11,away,away,44,-11,147
7/15/2018,622,MLMinnesota Lynx,64,164,-110,MIN,Minnesota Lynx,-3,-105,1021800132,33,44,1,0,0,0,0,0,0,64,83,19,77,11,away,home,33,11,147
7/17/2018,301,NYNew York Liberty,87,171.5,-110,NYL,New York Liberty,7.5,-110,1021800133,57,44,0,0,0,0,0,0,0,104,87,-17,101,-13,home,away,44,13,191
7/17/2018,302,DWDallas Wings,104,171.5,-110,DAL,Dallas Wings,-8,-103,1021800133,57,44,1,1,1,1,1,1,1,104,87,-17,101,-13,home,home,57,-13,191
7/17/2018,303,ADAtlanta Dream,86,170.5,-108,ATL,Atlanta Dream,7,-110,1021800134,42,35,0,0,0,0,0,0,0,83,86,3,77,-7,home,away,35,7,169
7/17/2018,304,CSConnecticut Sun,83,170.5,-112,CON,Connecticut Sun,-7,-110,1021800134,42,35,1,1,1,1,1,1,1,83,86,3,77,-7,home,home,42,-7,169
7/18/2018,305,SSSeattle Storm,101,178.5,-110,SEA,Seattle Storm,-8.5,-110,1021800135,37,54,1,0,1,1,1,1,1,83,101,18,91,17,away,away,54,-17,184
7/18/2018,306,CSChicago Sky,83,178.5,-110,CHI,Chicago Sky,8.5,-110,1021800135,37,54,0,1,0,0,0,0,0,83,101,18,91,17,away,home,37,17,184
7/18/2018,307,IFIndiana Fever,65,155.5,-110,IND,Indiana Fever,15,-110,1021800136,51,36,0,0,0,0,0,0,0,89,65,-24,87,-15,home,away,36,15,154
7/18/2018,308,MLMinnesota Lynx,89,155.5,-110,MIN,Minnesota Lynx,-15,-110,1021800136,51,36,1,1,1,1,1,1,1,89,65,-24,87,-15,home,home,51,-15,154
7/19/2018,309,NYNew York Liberty,68,164.5,-110,NYL,New York Liberty,7,-115,1021800137,50,31,0,0,0,0,0,0,0,82,68,-14,81,-19,home,away,31,19,150
7/19/2018,310,ADAtlanta Dream,82,164.5,-110,ATL,Atlanta Dream,-7,-105,1021800137,50,31,1,1,1,1,1,1,1,82,68,-14,81,-19,home,home,50,-19,150
7/19/2018,311,WMWashington Mystics,81,178,-110,WAS,Washington Mystics,4,-110,1021800138,48,39,0,0,0,0,0,0,0,90,81,-9,87,-9,home,away,39,9,171
7/19/2018,312,DWDallas Wings,90,178,-110,DAL,Dallas Wings,-4,-110,1021800138,48,39,1,1,1,1,1,1,1,90,81,-9,87,-9,home,home,48,-9,171
7/19/2018,313,LVLas Vegas Aces,85,172,-110,LVA,Las Vegas Aces,8.5,-110,1021800139,37,46,0,1,0,1,1,1,1,82,85,3,83,9,away,away,46,-9,167
7/19/2018,314,PPhoenix,82,172,-110,PHO,Phoenix Mercury,-8.5,-110,1021800139,37,46,1,0,1,0,0,0,0,82,85,3,83,9,away,home,37,9,167
7/20/2018,315,SSSeattle Storm,78,177.5,-110,SEA,Seattle Storm,2.5,-115,1021800140,33,29,0,0,0,1,0,0,0,65,78,13,62,-4,home,away,29,4,143
7/20/2018,316,CSConnecticut Sun,65,177.5,-110,CON,Connecticut Sun,-2.5,-105,1021800140,33,29,1,1,1,0,1,1,1,65,78,13,62,-4,home,home,33,-4,143
7/20/2018,317,DWDallas Wings,99,181,-110,DAL,Dallas Wings,-7,-115,1021800141,57,52,0,0,0,0,0,0,0,114,99,-15,109,-5,home,away,52,5,213
7/20/2018,318,CSChicago Sky,114,181,-110,CHI,Chicago Sky,7,-105,1021800141,57,52,1,1,1,1,1,1,1,114,99,-15,109,-5,home,home,57,-5,213
7/20/2018,319,IFIndiana Fever,78,153.5,-110,IND,Indiana Fever,13,-105,1021800142,40,37,0,0,0,0,0,1,0,76,78,2,77,-3,home,away,37,3,154
7/20/2018,320,LSL.A. Sparks,76,153.5,-110,LAS,Los Angeles Sparks,-13,-115,1021800142,40,37,1,1,1,1,1,0,1,76,78,2,77,-3,home,home,40,-3,154
7/21/2018,601,WMWashington Mystics,95,166,-110,WAS,Washington Mystics,-6,-110,1021800143,35,43,1,1,1,1,1,1,1,78,95,17,78,8,away,away,43,-8,173
7/21/2018,602,NYNew York Liberty,78,166,-110,NYL,New York Liberty,6,-110,1021800143,35,43,0,0,0,0,0,0,0,78,95,17,78,8,away,home,35,8,173
7/21/2018,603,MLMinnesota Lynx,80,161,-110,MIN,Minnesota Lynx,3.5,-110,1021800144,38,40,0,0,1,1,1,1,1,75,80,5,78,2,away,away,40,-2,155
7/21/2018,604,PPhoenix,75,161,-110,PHO,Phoenix Mercury,-3.5,-110,1021800144,38,40,1,1,0,0,0,0,0,75,80,5,78,2,away,home,38,2,155
7/22/2018,605,SSSeattle Storm,74,163.5,-110,SEA,Seattle Storm,-2,-110,1021800145,47,34,1,0,0,0,0,0,0,87,74,-13,81,-13,home,away,34,13,161
7/22/2018,606,ADAtlanta Dream,87,163.5,-110,ATL,Atlanta Dream,2,-110,1021800145,47,34,0,1,1,1,1,1,1,87,74,-13,81,-13,home,home,47,-13,161
7/22/2018,607,CSConnecticut Sun,92,178,-110,CON,Connecticut Sun,4,-110,1021800146,38,44,1,1,1,1,1,1,1,75,92,17,82,6,away,away,44,-6,167
7/22/2018,608,DWDallas Wings,75,178,-110,DAL,Dallas Wings,-4,-110,1021800146,38,44,0,0,0,0,0,0,0,75,92,17,82,6,away,home,38,6,167
7/22/2018,609,IFIndiana Fever,74,167.5,-110,IND,Indiana Fever,9.5,-110,1021800147,40,37,1,0,0,0,0,0,0,88,74,-14,77,-3,home,away,37,3,162
7/22/2018,610,LVLas Vegas Aces,88,167.5,-110,LVA,Las Vegas Aces,-9.5,-110,1021800147,40,37,0,1,1,1,1,1,1,88,74,-14,77,-3,home,home,40,-3,162
7/22/2018,611,LSL.A. Sparks,93,165,-110,LAS,Los Angeles Sparks,-3.5,-105,1021800148,38,40,0,0,0,1,0,0,1,76,93,17,78,2,away,away,40,-2,169
7/22/2018,612,CSChicago Sky,76,165,-110,CHI,Chicago Sky,3.5,-115,1021800148,38,40,1,1,1,0,1,1,0,76,93,17,78,2,away,home,38,2,169
7/24/2018,613,WMWashington Mystics,68,170.5,-110,WAS,Washington Mystics,5,-110,1021800149,45,35,1,1,1,1,0,0,0,94,68,-26,80,-10,home,away,35,10,162
7/24/2018,614,CSConnecticut Sun,94,170.5,-110,CON,Connecticut Sun,-5,-110,1021800149,45,35,0,0,0,0,1,1,1,94,68,-26,80,-10,home,home,45,-10,162
7/24/2018,615,SSSeattle Storm,92,166,-110,SEA,Seattle Storm,-11,-110,1021800150,34,46,1,1,1,1,1,1,1,72,92,20,80,12,away,away,46,-12,164
7/24/2018,616,IFIndiana Fever,72,166,-110,IND,Indiana Fever,11,-110,1021800150,34,46,0,0,0,0,0,0,0,72,92,20,80,12,away,home,34,12,164
7/24/2018,617,NYNew York Liberty,82,157,-110,NYL,New York Liberty,12.5,-110,1021800151,46,50,1,1,1,1,1,1,1,85,82,-3,96,4,away,away,50,-4,167
7/24/2018,618,MLMinnesota Lynx,85,157,-110,MIN,Minnesota Lynx,-12.5,-110,1021800151,46,50,0,0,0,0,0,0,0,85,82,-3,96,4,away,home,46,4,167
7/24/2018,619,ADAtlanta Dream,81,157.5,-115,ATL,Atlanta Dream,2.5,-110,1021800152,41,37,1,0,0,0,0,1,0,71,81,10,78,-4,home,away,37,4,152
7/24/2018,620,LSL.A. Sparks,71,157.5,-105,LAS,Los Angeles Sparks,-2.5,-110,1021800152,41,37,0,1,1,1,1,0,1,71,81,10,78,-4,home,home,41,-4,152
7/25/2018,621,CSChicago Sky,101,172,-110,CHI,Chicago Sky,7,-110,1021800153,43,56,1,1,1,0,1,1,1,87,101,14,99,13,away,away,56,-13,188
7/25/2018,622,PPhoenix,87,172,-110,PHO,Phoenix Mercury,-7,-110,1021800153,43,56,0,0,0,1,0,0,0,87,101,14,99,13,away,home,43,13,188
7/31/2018,301,WMWashington Mystics,86,164,-110,WAS,Washington Mystics,5,-110,1021800154,43,50,0,0,0,0,1,1,1,71,86,15,93,7,away,away,50,-7,157
7/31/2018,302,ADAtlanta Dream,71,164,-110,ATL,Atlanta Dream,-5,-110,1021800154,43,50,1,1,1,1,0,0,0,71,86,15,93,7,away,home,43,7,157
7/31/2018,303,CSChicago Sky,92,185,-110,CHI,Chicago Sky,12,-115,1021800155,36,55,1,1,1,1,1,1,1,91,92,1,91,19,away,away,55,-19,183
7/31/2018,304,DWDallas Wings,91,185,-110,DAL,Dallas Wings,-12,-110,1021800155,36,55,0,0,0,0,0,0,0,91,92,1,91,19,away,home,36,19,183
7/31/2018,305,SSSeattle Storm,102,170,-110,SEA,Seattle Storm,-3.5,-110,1021800156,44,53,1,1,1,1,1,1,1,91,102,11,97,9,away,away,53,-9,193
7/31/2018,306,PPhoenix,91,170,-110,PHO,Phoenix Mercury,3.5,-110,1021800156,44,53,0,0,0,0,0,0,0,91,102,11,97,9,away,home,44,9,193
8/1/2018,307,NYNew York Liberty,77,166.5,-110,NYL,New York Liberty,12,-110,1021800157,48,39,0,0,0,0,0,0,0,92,77,-15,87,-9,home,away,39,9,169
8/1/2018,308,CSConnecticut Sun,92,166.5,-110,CON,Connecticut Sun,-12,-110,1021800157,48,39,1,1,1,1,1,1,1,92,77,-15,87,-9,home,home,48,-9,169
8/1/2018,309,PPhoenix,104,173.5,-110,PHO,Phoenix Mercury,4,-110,1021800158,42,48,0,1,1,1,1,1,1,93,104,11,90,6,away,away,48,-6,197
8/1/2018,310,LVLas Vegas Aces,93,173.5,-110,LVA,Las Vegas Aces,-4,-110,1021800158,42,48,1,0,0,0,0,0,0,93,104,11,90,6,away,home,42,6,197
8/2/2018,601,DWDallas Wings,78,169,-110,DAL,Dallas Wings,-7,-110,1021800159,43,39,0,1,1,1,1,1,0,84,78,-6,82,-4,home,away,39,4,162
8/2/2018,602,IFIndiana Fever,84,169,-110,IND,Indiana Fever,7,-110,1021800159,43,39,1,0,0,0,0,0,1,84,78,-6,82,-4,home,home,43,-4,162
8/2/2018,603,MLMinnesota Lynx,57,155.5,-110,MIN,Minnesota Lynx,2.5,-110,1021800160,40,29,0,0,0,0,0,0,0,79,57,-22,69,-11,home,away,29,11,136
8/2/2018,604,LSL.A. Sparks,79,155.5,-110,LAS,Los Angeles Sparks,-2.5,-110,1021800160,40,29,1,1,1,1,1,1,1,79,57,-22,69,-11,home,home,40,-11,136
8/7/2018,603,SSSeattle Storm,94,167,-110,SEA,Seattle Storm,-11.5,-110,1021800171,44,51,1,0,0,0,1,1,1,79,94,15,95,7,away,away,51,-7,173
8/7/2018,604,IFIndiana Fever,79,167,-110,IND,Indiana Fever,11.5,-115,1021800171,44,51,0,1,1,1,0,0,0,79,94,15,95,7,away,home,44,7,173
8/7/2018,601,LVLas Vegas Aces,100,167.5,-110,LVA,Las Vegas Aces,8,-110,1021800170,56,60,1,1,1,1,1,0,0,109,100,-9,116,4,away,away,60,-4,209
8/7/2018,602,ADAtlanta Dream,109,167.5,-110,ATL,Atlanta Dream,-8,-110,1021800170,56,60,0,0,0,0,0,1,1,109,100,-9,116,4,away,home,56,4,209
8/7/2018,605,MLMinnesota Lynx,85,166.5,-110,MIN,Minnesota Lynx,-4,-110,1021800172,38,39,0,0,0,0,0,0,1,64,85,21,77,1,away,away,39,-1,149
8/7/2018,606,CSChicago Sky,64,166,-110,CHI,Chicago Sky,4,-110,1021800172,38,39,1,1,1,1,1,1,0,64,85,21,77,1,away,home,38,1,149
8/7/2018,607,WMWashington Mystics,103,171.5,-110,WAS,Washington Mystics,2,-105,1021800173,50,57,1,1,1,1,1,1,1,98,103,5,107,7,away,away,57,-7,201
8/7/2018,608,PPhoenix,98,171.5,-110,PHO,Phoenix Mercury,-2,-115,1021800173,50,57,0,0,0,0,0,0,0,98,103,5,107,7,away,home,50,7,201
8/17/2018,307,MLMinnesota Lynx,79,161,-110,MIN,Minnesota Lynx,5.5,-110,1021800193,43,46,0,0,1,1,1,1,1,96,79,-17,89,3,away,away,46,-3,175
8/17/2018,308,CSConnecticut Sun,96,161,-110,CON,Connecticut Sun,-5.5,-110,1021800193,43,46,1,1,0,0,0,0,0,96,79,-17,89,3,away,home,43,3,175
8/17/2018,305,LSL.A. Sparks,67,158.5,-110,LAS,Los Angeles Sparks,4,-110,1021800194,40,40,1,1,1,0,0,0,0,69,67,-2,80,0,tie,away,40,-0,136
8/17/2018,306,WMWashington Mystics,69,158.5,-110,WAS,Washington Mystics,-4,-110,1021800194,40,40,0,0,0,1,1,1,1,69,67,-2,80,0,tie,home,40,0,136
8/17/2018,309,LVLas Vegas Aces,102,176,-110,LVA,Las Vegas Aces,5.5,-115,1021800195,51,57,1,1,1,1,1,1,1,107,102,-5,108,6,away,away,57,-6,209
8/17/2018,310,DWDallas Wings,107,176,-110,DAL,Dallas Wings,-5.5,-110,1021800195,51,57,0,0,0,0,0,0,0,107,102,-5,108,6,away,home,51,6,209
8/17/2018,313,ADAtlanta Dream,95,168,-110,ATL,Atlanta Dream,4,-110,1021800196,50,47,1,1,0,0,1,0,0,104,95,-9,97,-3,home,away,47,3,199
8/17/2018,314,PPhoenix,104,168.5,-115,PHO,Phoenix Mercury,-4,-110,1021800196,50,47,0,0,1,1,0,1,1,104,95,-9,97,-3,home,home,50,-3,199
8/17/2018,311,NYNew York Liberty,77,164,-110,NYL,New York Liberty,15.5,-110,1021800197,46,43,0,0,0,0,0,0,0,85,77,-8,89,-3,home,away,43,3,162
8/17/2018,312,SSSeattle Storm,85,164,-110,SEA,Seattle Storm,-15.5,-110,1021800197,46,43,1,1,1,1,1,1,1,85,77,-8,89,-3,home,home,46,-3,162
8/21/2018,305,DWDallas Wings,83,178.5,-110,DAL,Dallas Wings,7,-110,1041800101,53,49,0,1,0,0,0,0,0,101,83,-18,102,-4,home,away,49,4,184
8/21/2018,306,PPhoenix,101,178.5,-110,PHO,Phoenix Mercury,-7,-110,1041800101,53,49,1,0,1,1,1,1,1,101,83,-18,102,-4,home,home,53,-4,184
8/21/2018,307,MLMinnesota Lynx,68,149.5,-110,MIN,Minnesota Lynx,6,-110,1041800111,40,37,0,0,1,1,1,0,0,75,68,-7,77,-3,home,away,37,3,143
8/21/2018,308,LSL.A. Sparks,75,149.5,-110,LAS,Los Angeles Sparks,-6,-110,1041800111,40,37,1,1,0,0,0,1,1,75,68,-7,77,-3,home,home,40,-3,143
8/23/2018,309,LSL.A. Sparks,64,157.5,-110,LAS,Los Angeles Sparks,4,-110,1041800201,50,29,1,0,0,0,0,0,0,96,64,-32,79,-21,home,away,29,21,160
8/23/2018,310,WMWashington Mystics,96,157.5,-110,WAS,Washington Mystics,-4,-110,1041800201,50,29,0,1,1,1,1,1,1,96,64,-32,79,-21,home,home,50,-21,160
8/23/2018,311,PPhoenix,96,176,-110,PHO,Phoenix Mercury,4,-110,1041800211,44,40,0,0,0,0,0,0,0,86,96,10,84,-4,home,away,40,4,182
8/23/2018,312,CSConnecticut Sun,86,176,-110,CON,Connecticut Sun,-4,-110,1041800211,44,40,1,1,1,1,1,1,1,86,96,10,84,-4,home,home,44,-4,182
8/26/2018,315,WMWashington Mystics,87,163.5,-110,WAS,Washington Mystics,-2.5,-110,1041800311,42,51,1,1,1,1,1,1,1,84,87,3,93,9,away,away,51,-9,171
8/26/2018,316,ADAtlanta Dream,84,163.5,-110,ATL,Atlanta Dream,2.5,-110,1041800311,42,51,0,0,0,0,0,0,0,84,87,3,93,9,away,home,42,9,171
8/26/2018,313,PPhoenix,87,175.5,-110,PHO,Phoenix Mercury,6.5,-110,1041800301,54,50,1,0,0,1,0,0,0,91,87,-4,104,-4,home,away,50,4,178
8/26/2018,314,SSSeattle Storm,91,175.5,-106,SEA,Seattle Storm,-6.5,-110,1041800301,54,50,0,1,1,0,1,1,1,91,87,-4,104,-4,home,home,54,-4,178
8/28/2018,317,WMWashington Mystics,75,162,-105,WAS,Washington Mystics,-1,-110,1041800312,34,36,0,0,0,0,0,1,1,78,75,-3,70,2,away,away,36,-2,153
8/28/2018,318,ADAtlanta Dream,78,162,-115,ATL,Atlanta Dream,1,-110,1041800312,34,36,1,1,1,1,1,0,0,78,75,-3,70,2,away,home,34,2,153
8/28/2018,319,PPhoenix,87,178.5,-110,PHO,Phoenix Mercury,5.5,-110,1041800302,44,32,0,1,0,0,0,0,0,91,87,-4,76,-12,home,away,32,12,178
8/28/2018,320,SSSeattle Storm,91,178.5,-110,SEA,Seattle Storm,-5.5,-110,1041800302,44,32,1,0,1,1,1,1,1,91,87,-4,76,-12,home,home,44,-12,178
8/31/2018,601,ADAtlanta Dream,81,157.5,-110,ATL,Atlanta Dream,1.5,-110,1041800313,34,37,0,1,1,0,0,1,1,76,81,5,71,3,away,away,37,-3,157
8/31/2018,602,WMWashington Mystics,76,157.5,-110,WAS,Washington Mystics,-1.5,-110,1041800313,34,37,1,0,0,1,1,0,0,76,81,5,71,3,away,home,34,3,157
8/31/2018,605,SSSeattle Storm,66,172,-110,SEA,Seattle Storm,2,-110,1041800303,42,35,0,0,0,0,0,0,0,86,66,-20,77,-7,home,away,35,7,152
8/31/2018,606,PPhoenix,86,172,-110,PHO,Phoenix Mercury,-2,-110,1041800303,42,35,1,1,1,1,1,1,1,86,66,-20,77,-7,home,home,42,-7,152
9/2/2018,612,ADAtlanta Dream,76,162,-110,ATL,Atlanta Dream,4,-115,1041800314,44,35,1,0,0,0,0,0,0,97,76,-21,79,-9,home,away,35,9,173
9/2/2018,611,WMWashington Mystics,97,162,-110,WAS,Washington Mystics,-4,-110,1041800314,44,35,0,1,1,1,1,1,1,97,76,-21,79,-9,home,home,44,-9,173
9/2/2018,610,SSSeattle Storm,84,170.5,-110,SEA,Seattle Storm,3,-117,1041800304,42,53,1,1,1,1,1,1,1,86,84,-2,95,11,away,away,53,-11,170
9/2/2018,609,PPhoenix,86,170.5,-110,PHO,Phoenix Mercury,-3.5,-110,1041800304,42,53,0,0,0,0,0,0,0,86,84,-2,95,11,away,home,42,11,170
9/4/2018,611,WMWashington Mystics,86,159,-110,WAS,Washington Mystics,-4,-110,1041800315,50,49,1,1,1,0,1,0,1,81,86,5,99,-1,home,away,49,1,167
9/4/2018,612,ADAtlanta Dream,81,159,-110,ATL,Atlanta Dream,4,-110,1041800315,50,49,0,0,0,1,0,1,0,81,86,5,99,-1,home,home,50,-1,167
9/4/2018,609,PPhoenix,84,171.5,-110,PHO,Phoenix Mercury,5.5,-110,1041800305,41,46,1,1,1,1,1,1,1,94,84,-10,87,5,away,away,46,-5,178
9/4/2018,610,SSSeattle Storm,94,171.5,-110,SEA,Seattle Storm,-5.5,-110,1041800305,41,46,0,0,0,0,0,0,0,94,84,-10,87,5,away,home,41,5,178
9/7/2018,613,WMWashington Mystics,76,172.5,-110,WAS,Washington Mystics,4.5,-110,1041800401,48,32,0,0,0,0,0,0,0,89,76,-13,80,-16,home,away,32,16,165
9/7/2018,614,SSSeattle Storm,89,172.5,-110,SEA,Seattle Storm,-4.5,-115,1041800401,48,32,1,1,1,1,1,1,1,89,76,-13,80,-16,home,home,48,-16,165
9/9/2018,615,WMWashington Mystics,73,170,-110,WAS,Washington Mystics,5.5,-105,1041800402,36,40,0,0,0,0,0,0,1,75,73,-2,76,4,away,away,40,-4,148
9/9/2018,616,SSSeattle Storm,75,170,-110,SEA,Seattle Storm,-5.5,-115,1041800402,36,40,1,1,1,1,1,1,0,75,73,-2,76,4,away,home,36,4,148
9/12/2018,617,SSSeattle Storm,98,168,-110,SEA,Seattle Storm,5,-110,1041800403,30,47,1,1,1,1,1,1,1,82,98,16,77,17,away,away,47,-17,180
9/12/2018,618,WMWashington Mystics,82,168,-110,WAS,Washington Mystics,-5,-110,1041800403,30,47,0,0,0,0,0,0,0,82,98,16,77,17,away,home,30,17,180
5/18/2018,301,DWDallas Wings,78,160.5,-106,DAL,Dallas Wings,5.5,-110,1021800001,44,42,0,1,0,0,0,0,1,86,78,-8,86,-2,home,away,42,2,164
5/18/2018,302,PPhoenix,86,160.5,-114,PHO,Phoenix Mercury,-5.5,-110,1021800001,44,42,1,0,1,1,1,1,0,86,78,-8,86,-2,home,home,44,-2,164
5/20/2018,601,LVLas Vegas Aces,65,154,-110,LVA,Las Vegas Aces,19,-110,1021800003,49,37,1,1,1,0,0,0,0,101,65,-36,86,-12,home,away,37,12,166
5/20/2018,602,CSConnecticut Sun,101,154,-110,CON,Connecticut Sun,-19,-110,1021800003,49,37,0,0,0,1,1,1,1,101,65,-36,86,-12,home,home,49,-12,166
5/20/2018,603,IFIndiana Fever,75,153,-110,IND,Indiana Fever,12.5,-110,1021800004,38,30,1,0,0,0,0,0,0,82,75,-7,68,-8,home,away,30,8,157
5/20/2018,604,WMWashington Mystics,82,153,-110,WAS,Washington Mystics,-12.5,-110,1021800004,38,30,0,1,1,1,1,1,1,82,75,-7,68,-8,home,home,38,-8,157
5/20/2018,605,ADAtlanta Dream,78,162,-110,ATL,Atlanta Dream,3.5,-110,1021800005,59,37,1,1,1,0,0,0,0,101,78,-23,96,-22,home,away,37,22,179
5/20/2018,606,DWDallas Wings,101,162,-110,DAL,Dallas Wings,-3.5,-110,1021800005,59,37,0,0,0,1,1,1,1,101,78,-23,96,-22,home,home,59,-22,179
5/20/2018,607,LSL.A. Sparks,77,155,-110,LAS,Los Angeles Sparks,7.5,-110,1021800006,38,32,0,0,0,1,1,0,0,76,77,1,70,-6,home,away,32,6,153
5/20/2018,608,MLMinnesota Lynx,76,155,-110,MIN,Minnesota Lynx,-7.5,-110,1021800006,38,32,1,1,1,0,0,1,1,76,77,1,70,-6,home,home,38,-6,153
5/20/2018,609,NYNew York Liberty,76,153.5,-110,NYL,New York Liberty,-6.5,-115,1021800007,38,40,0,0,0,1,1,1,1,80,76,-4,78,2,away,away,40,-2,156
5/20/2018,610,CSChicago Sky,80,153.5,-110,CHI,Chicago Sky,6.5,-105,1021800007,38,40,1,1,1,0,0,0,0,80,76,-4,78,2,away,home,38,2,156
5/20/2018,611,PPhoenix,87,156,-110,PHO,Phoenix Mercury,2,-110,1021800008,36,46,1,1,1,1,1,1,1,82,87,5,82,10,away,away,46,-10,169
5/20/2018,612,SSSeattle Storm,82,156,-110,SEA,Seattle Storm,-2,-110,1021800008,36,46,0,0,0,0,0,0,0,82,87,5,82,10,away,home,36,10,169
5/22/2018,301,LVLas Vegas Aces,70,155,-110,LVA,Las Vegas Aces,18.5,-110,1021800010,23,31,1,1,1,1,1,1,1,75,70,-5,54,8,away,away,31,-8,145
5/22/2018,302,WMWashington Mystics,75,155,-110,WAS,Washington Mystics,-18.5,-110,1021800010,23,31,0,0,0,0,0,0,0,75,70,-5,54,8,away,home,23,8,145
5/22/2018,303,LSL.A. Sparks,87,150,-120,LAS,Los Angeles Sparks,-8.5,-105,1021800009,36,50,1,1,1,1,1,1,1,70,87,17,86,14,away,away,50,-14,157
5/22/2018,304,IFIndiana Fever,70,150,100,IND,Indiana Fever,8.5,-115,1021800009,36,50,0,0,0,0,0,0,0,70,87,17,86,14,away,home,36,14,157
5/23/2018,305,ADAtlanta Dream,81,162.5,-128,ATL,Atlanta Dream,-1.5,-115,1021800011,27,39,1,1,1,1,1,1,1,63,81,18,66,12,away,away,39,-12,144
5/23/2018,306,CSChicago Sky,63,162.5,108,CHI,Chicago Sky,1.5,-105,1021800011,27,39,0,0,0,0,0,0,0,63,81,18,66,12,away,home,27,12,144
5/23/2018,307,DWDallas Wings,68,164,-110,DAL,Dallas Wings,13,-115,1021800012,46,21,0,0,0,0,0,0,0,76,68,-8,67,-25,home,away,21,25,144
5/23/2018,308,MLMinnesota Lynx,76,164,-110,MIN,Minnesota Lynx,-13,-105,1021800012,46,21,1,1,1,1,1,1,1,76,68,-8,67,-25,home,home,46,-25,144
5/23/2018,309,SSSeattle Storm,87,157,-110,SEA,Seattle Storm,5.5,-105,1021800013,33,46,0,0,0,0,1,1,1,71,87,16,79,13,away,away,46,-13,158
5/23/2018,310,PPhoenix,71,157,-110,PHO,Phoenix Mercury,-5.5,-115,1021800013,33,46,1,1,1,1,0,0,0,71,87,16,79,13,away,home,33,13,158
5/24/2018,311,WMWashington Mystics,93,154.5,-110,WAS,Washington Mystics,-5,-115,1021800015,44,51,0,0,0,0,0,1,1,84,93,9,95,7,away,away,51,-7,177
5/24/2018,312,IFIndiana Fever,84,154.5,-110,IND,Indiana Fever,5,-105,1021800015,44,51,1,1,1,1,1,0,0,84,93,9,95,7,away,home,44,7,177
5/24/2018,313,LSL.A. Sparks,94,162.5,-110,LAS,Los Angeles Sparks,4.5,-110,1021800014,46,47,1,0,0,1,1,1,1,102,94,-8,93,1,away,away,47,-1,196
5/24/2018,314,CSConnecticut Sun,102,162.5,-110,CON,Connecticut Sun,-4.5,-110,1021800014,46,47,0,1,1,0,0,0,0,102,94,-8,93,1,away,home,46,1,196
5/25/2018,315,MLMinnesota Lynx,78,153,-110,MIN,Minnesota Lynx,-7.5,-110,1021800016,36,41,0,0,1,1,0,1,1,72,78,6,77,5,away,away,41,-5,150
5/25/2018,316,NYNew York Liberty,72,153,-110,NYL,New York Liberty,7.5,-110,1021800016,36,41,1,1,0,0,1,0,0,72,78,6,77,5,away,home,36,5,150
5/25/2018,317,CSChicago Sky,91,158.5,-115,CHI,Chicago Sky,10,-110,1021800017,41,44,0,1,1,1,1,1,1,95,91,-4,85,3,away,away,44,-3,186
5/25/2018,318,SSSeattle Storm,95,158.5,-105,SEA,Seattle Storm,-10,-110,1021800017,41,44,1,0,0,0,0,0,0,95,91,-4,85,3,away,home,41,3,186
5/26/2018,319,DWDallas Wings,78,167,-110,DAL,Dallas Wings,4,-110,1021800018,31,39,0,1,1,1,1,1,1,70,78,8,70,8,away,away,39,-8,148
5/26/2018,320,ADAtlanta Dream,70,167,-110,ATL,Atlanta Dream,-4,-110,1021800018,31,39,1,0,0,0,0,0,0,70,78,8,70,8,away,home,31,8,148
5/26/2018,321,IFIndiana Fever,77,163.5,-110,IND,Indiana Fever,17,-110,1021800019,47,38,0,0,0,0,0,0,0,86,77,-9,85,-9,home,away,38,9,163
5/26/2018,322,CSConnecticut Sun,86,163.5,-110,CON,Connecticut Sun,-17,-110,1021800019,47,38,1,1,1,1,1,1,1,86,77,-9,85,-9,home,home,47,-9,163
5/27/2018,323,MLMinnesota Lynx,78,158.5,-110,MIN,Minnesota Lynx,-5,-110,1021800020,46,39,1,1,1,1,1,0,0,90,78,-12,85,-7,home,away,39,7,168
5/27/2018,324,WMWashington Mystics,90,158.5,-110,WAS,Washington Mystics,5,-110,1021800020,46,39,0,0,0,0,0,1,1,90,78,-12,85,-7,home,home,46,-7,168
5/27/2018,325,PPhoenix,72,159,-110,PHO,Phoenix Mercury,7.5,-110,1021800021,48,40,1,1,0,0,0,0,0,80,72,-8,88,-8,home,away,40,8,152
5/27/2018,326,LSL.A. Sparks,80,159,-110,LAS,Los Angeles Sparks,-7.5,-110,1021800021,48,40,0,0,1,1,1,1,1,80,72,-8,88,-8,home,home,48,-8,152
5/27/2018,327,SSSeattle Storm,105,164.5,-110,SEA,Seattle Storm,-6.5,-110,1021800022,35,53,0,1,1,1,1,1,1,98,105,7,88,18,away,away,53,-18,203
5/27/2018,328,LVLas Vegas Aces,98,164.5,-110,LVA,Las Vegas Aces,6.5,-110,1021800022,35,53,1,0,0,0,0,0,0,98,105,7,88,18,away,home,35,18,203
5/29/2018,603,MLMinnesota Lynx,74,156.5,-135,MIN,Minnesota Lynx,-6,-110,1021800023,31,34,1,1,1,1,1,1,1,76,74,-2,65,3,away,away,34,-3,150
5/29/2018,604,ADAtlanta Dream,76,156.5,115,ATL,Atlanta Dream,6,-110,1021800023,31,34,0,0,0,0,0,0,0,76,74,-2,65,3,away,home,31,3,150
5/29/2018,601,DWDallas Wings,89,161,-110,DAL,Dallas Wings,2.5,-115,1021800024,37,46,1,1,1,1,1,1,1,94,89,-5,83,9,away,away,46,-9,183
5/29/2018,602,NYNew York Liberty,94,161,-110,NYL,New York Liberty,-2.5,-105,1021800024,37,46,0,0,0,0,0,0,0,94,89,-5,83,9,away,home,37,9,183
5/29/2018,605,WMWashington Mystics,77,163,-110,WAS,Washington Mystics,7,-110,1021800025,41,39,0,0,0,0,0,0,0,81,77,-4,80,-2,home,away,39,2,158
5/29/2018,606,SSSeattle Storm,81,163,-110,SEA,Seattle Storm,-7,-110,1021800025,41,39,1,1,1,1,1,1,1,81,77,-4,80,-2,home,home,41,-2,158
5/30/2018,607,WMWashington Mystics,103,160,-110,WAS,Washington Mystics,8.5,-110,1021800026,43,49,0,1,1,0,0,1,1,95,103,8,92,6,away,away,49,-6,198
5/30/2018,608,PPhoenix,95,160,-110,PHO,Phoenix Mercury,-8.5,-110,1021800026,43,49,1,0,0,1,1,0,0,95,103,8,92,6,away,home,43,6,198
5/31/2018,611,LVLas Vegas Aces,74,171,-110,LVA,Las Vegas Aces,11,-110,1021800027,60,32,0,0,0,0,0,0,0,101,74,-27,92,-28,home,away,32,28,175
5/31/2018,612,SSSeattle Storm,101,171,-110,SEA,Seattle Storm,-11,-110,1021800027,60,32,1,1,1,1,1,1,1,101,74,-27,92,-28,home,home,60,-28,175
6/1/2018,301,PPhoenix,95,157,-110,PHO,Phoenix Mercury,8,-105,1021800028,50,52,1,1,0,0,0,0,1,85,95,10,102,2,away,away,52,-2,180
6/1/2018,302,MLMinnesota Lynx,85,157,-110,MIN,Minnesota Lynx,-8,-115,1021800028,50,52,0,0,1,1,1,1,0,85,95,10,102,2,away,home,50,2,180
6/1/2018,303,CSConnecticut Sun,110,170.5,-110,CON,Connecticut Sun,-9,-115,1021800029,35,48,0,0,1,1,1,1,1,72,110,38,83,13,away,away,48,-13,182
6/1/2018,304,CSChicago Sky,72,170.5,-110,CHI,Chicago Sky,9,-105,1021800029,35,48,1,1,0,0,0,0,0,72,110,38,83,13,away,home,35,13,182
6/1/2018,305,WMWashington Mystics,73,168.5,-115,WAS,Washington Mystics,-7,-115,1021800030,46,37,0,0,0,0,0,0,0,85,73,-12,83,-9,home,away,37,9,158
6/1/2018,306,LVLas Vegas Aces,85,168.5,-105,LVA,Las Vegas Aces,7,-105,1021800030,46,37,1,1,1,1,1,1,1,85,73,-12,83,-9,home,home,46,-9,158
6/2/2018,307,NYNew York Liberty,87,156,-110,NYL,New York Liberty,-5.5,-110,1021800031,29,46,0,0,1,1,1,1,1,81,87,6,75,17,away,away,46,-17,168
6/2/2018,308,IFIndiana Fever,81,156,-110,IND,Indiana Fever,5.5,-110,1021800031,29,46,1,1,0,0,0,0,0,81,87,6,75,17,away,home,29,17,168
6/2/2018,309,SSSeattle Storm,90,172,-110,SEA,Seattle Storm,3,-115,1021800032,53,36,0,0,0,0,0,0,0,94,90,-4,89,-17,home,away,36,17,184
6/2/2018,310,DWDallas Wings,94,172,-110,DAL,Dallas Wings,-3,-110,1021800032,53,36,1,1,1,1,1,1,1,94,90,-4,89,-17,home,home,53,-17,184
6/3/2018,313,PPhoenix,78,162,-110,PHO,Phoenix Mercury,1.5,-105,1021800033,30,38,1,1,1,1,1,1,1,71,78,7,68,8,away,away,38,-8,149
6/3/2018,314,ADAtlanta Dream,71,162,-110,ATL,Atlanta Dream,-1.5,-115,1021800033,30,38,0,0,0,0,0,0,0,71,78,7,68,8,away,home,30,8,149
6/3/2018,311,CSConnecticut Sun,88,172,-110,CON,Connecticut Sun,-6.5,-110,1021800034,35,49,1,1,1,1,1,1,1,64,88,24,84,14,away,away,49,-14,152
6/3/2018,312,WMWashington Mystics,64,172,-110,WAS,Washington Mystics,6.5,-110,1021800034,35,49,0,0,0,0,0,0,0,64,88,24,84,14,away,home,35,14,152
6/3/2018,315,MLMinnesota Lynx,69,158,-115,MIN,Minnesota Lynx,6,-110,1021800035,40,38,0,0,0,0,0,0,0,77,69,-8,78,-2,home,away,38,2,146
6/3/2018,316,LSL.A. Sparks,77,158,-110,LAS,Los Angeles Sparks,-6,-110,1021800035,40,38,1,1,1,1,1,1,1,77,69,-8,78,-2,home,home,40,-2,146
6/3/2018,317,LVLas Vegas Aces,90,165,-110,LVA,Las Vegas Aces,5,-110,1021800036,45,52,1,1,1,1,1,1,1,95,90,-5,97,7,away,away,52,-7,185
6/3/2018,318,CSChicago Sky,95,165,-110,CHI,Chicago Sky,-5,-115,1021800036,45,52,0,0,0,0,0,0,0,95,90,-5,97,7,away,home,45,7,185
6/5/2018,601,PPhoenix,80,160,-110,PHO,Phoenix Mercury,2.5,-115,1021800037,38,43,1,1,0,0,0,1,1,74,80,6,81,5,away,away,43,-5,154
6/5/2018,602,NYNew York Liberty,74,160,-110,NYL,New York Liberty,-2.5,-105,1021800037,38,43,0,0,1,1,1,0,0,74,80,6,81,5,away,home,38,5,154
6/5/2018,603,CSConnecticut Sun,77,165,-110,CON,Connecticut Sun,-6.5,-110,1021800038,46,40,1,1,1,1,1,1,0,82,77,-5,86,-6,home,away,40,6,159
6/5/2018,604,ADAtlanta Dream,82,165,-110,ATL,Atlanta Dream,6.5,-110,1021800038,46,40,0,0,0,0,0,0,1,82,77,-5,86,-6,home,home,46,-6,159
6/7/2018,607,MLMinnesota Lynx,88,159,-110,MIN,Minnesota Lynx,-4.5,-110,1021800040,42,48,0,0,0,0,1,1,0,80,88,8,90,6,away,away,48,-6,168
6/7/2018,608,WMWashington Mystics,80,159,-110,WAS,Washington Mystics,4.5,-110,1021800040,42,48,1,1,1,1,0,0,1,80,88,8,90,6,away,home,42,6,168
6/7/2018,605,CSConnecticut Sun,88,165.5,-115,CON,Connecticut Sun,-5.5,-105,1021800039,54,41,0,0,0,0,0,0,0,86,88,2,95,-13,home,away,41,13,174
6/7/2018,606,NYNew York Liberty,86,165.5,-105,NYL,New York Liberty,5.5,-115,1021800039,54,41,1,1,1,1,1,1,1,86,88,2,95,-13,home,home,54,-13,174
6/7/2018,609,SSSeattle Storm,88,168,-105,SEA,Seattle Storm,8,-110,1021800041,33,42,1,1,1,1,1,1,1,63,88,25,75,9,away,away,42,-9,151
6/7/2018,610,LSL.A. Sparks,63,168,-115,LAS,Los Angeles Sparks,-8,-110,1021800041,33,42,0,0,0,0,0,0,0,63,88,25,75,9,away,home,33,9,151
6/9/2018,307,MLMinnesota Lynx,75,167.5,-110,MIN,Minnesota Lynx,5.5,-110,1021800045,44,38,0,1,1,1,0,0,0,89,75,-14,82,-6,home,away,38,6,164
6/9/2018,308,CSConnecticut Sun,89,167.5,-110,CON,Connecticut Sun,-5.5,-115,1021800045,44,38,1,0,0,0,1,1,1,89,75,-14,82,-6,home,home,44,-6,164
6/12/2018,601,LVLas Vegas Aces,101,161.5,-110,LVA,Las Vegas Aces,3.5,-110,1021800050,37,46,1,0,1,1,1,1,1,92,101,9,83,9,away,away,46,-9,193
6/12/2018,602,IFIndiana Fever,92,161.5,-110,IND,Indiana Fever,-3.5,-110,1021800050,37,46,0,1,0,0,0,0,0,92,101,9,83,9,away,home,37,9,193
6/12/2018,603,PPhoenix,75,169.5,-110,PHO,Phoenix Mercury,1.5,-115,1021800051,40,37,0,0,0,0,0,0,0,72,75,3,77,-3,home,away,37,3,147
6/12/2018,604,DWDallas Wings,72,169.5,-110,DAL,Dallas Wings,-1.5,-105,1021800051,40,37,1,1,1,1,1,1,1,72,75,3,77,-3,home,home,40,-3,147
6/12/2018,605,CSChicago Sky,85,169.5,-110,CHI,Chicago Sky,10.5,-110,1021800052,50,46,1,1,1,0,0,0,0,96,85,-11,96,-4,home,away,46,4,181
6/12/2018,606,SSSeattle Storm,96,169.5,-110,SEA,Seattle Storm,-10.5,-110,1021800052,50,46,0,0,0,1,1,1,1,96,85,-11,96,-4,home,home,50,-4,181
6/12/2018,607,ADAtlanta Dream,64,151.5,-110,ATL,Atlanta Dream,8,-110,1021800053,43,32,0,1,1,0,0,0,0,72,64,-8,75,-11,home,away,32,11,136
6/12/2018,608,LSL.A. Sparks,72,151.5,-110,LAS,Los Angeles Sparks,-8,-110,1021800053,43,32,1,0,0,1,1,1,1,72,64,-8,75,-11,home,home,43,-11,136
6/13/2018,611,LVLas Vegas Aces,78,163.5,-110,LVA,Las Vegas Aces,10,-115,1021800055,33,37,1,0,1,1,1,1,1,63,78,15,70,4,away,away,37,-4,141
6/13/2018,612,NYNew York Liberty,63,163.5,-110,NYL,New York Liberty,-10,-110,1021800055,33,37,0,1,0,0,0,0,0,63,78,15,70,4,away,home,33,4,141
6/13/2018,609,WMWashington Mystics,95,173,-110,WAS,Washington Mystics,9,-110,1021800054,37,65,1,1,1,1,1,1,1,91,95,4,102,28,away,away,65,-28,186
6/13/2018,610,CSConnecticut Sun,91,173,-110,CON,Connecticut Sun,-9,-110,1021800054,37,65,0,0,0,0,0,0,0,91,95,4,102,28,away,home,37,28,186
6/14/2018,301,IFIndiana Fever,67,153,-110,IND,Indiana Fever,8.5,-110,1021800056,41,40,0,1,0,0,1,1,1,72,67,-5,81,-1,home,away,40,1,139
6/14/2018,302,ADAtlanta Dream,72,153,-110,ATL,Atlanta Dream,-8.5,-110,1021800056,41,40,1,0,1,1,0,0,0,72,67,-5,81,-1,home,home,41,-1,139
6/15/2018,303,LSL.A. Sparks,97,159.5,-110,LAS,Los Angeles Sparks,-4,-110,1021800057,34,52,1,1,1,1,1,1,1,86,97,11,86,18,away,away,52,-18,183
6/15/2018,304,WMWashington Mystics,86,159.5,-110,WAS,Washington Mystics,4,-110,1021800057,34,52,0,0,0,0,0,0,0,86,97,11,86,18,away,home,34,18,183
6/15/2018,305,LVLas Vegas Aces,67,171.5,-110,LVA,Las Vegas Aces,8,-120,1021800058,45,39,1,1,0,0,0,0,0,77,67,-10,84,-6,home,away,39,6,144
6/15/2018,306,DWDallas Wings,77,171.5,-110,DAL,Dallas Wings,-8,100,1021800058,45,39,0,0,1,1,1,1,1,77,67,-10,84,-6,home,home,45,-6,144
6/15/2018,307,CSConnecticut Sun,92,176,-110,CON,Connecticut Sun,1.5,-110,1021800059,52,45,0,0,0,0,0,0,0,103,92,-11,97,-7,home,away,45,7,195
6/15/2018,308,SSSeattle Storm,103,176,-110,SEA,Seattle Storm,-1.5,-110,1021800059,52,45,1,1,1,1,1,1,1,103,92,-11,97,-7,home,home,52,-7,195
6/16/2018,309,ADAtlanta Dream,64,152,-115,ATL,Atlanta Dream,-3.5,-110,1021800060,35,38,1,1,0,1,1,1,0,96,64,-32,73,3,away,away,38,-3,160
6/16/2018,310,IFIndiana Fever,96,152,-110,IND,Indiana Fever,3.5,-110,1021800060,35,38,0,0,1,0,0,0,1,96,64,-32,73,3,away,home,35,3,160
6/16/2018,311,NYNew York Liberty,71,154,-110,NYL,New York Liberty,7,-110,1021800061,54,38,0,0,0,0,0,0,0,85,71,-14,92,-16,home,away,38,16,156
6/16/2018,312,MLMinnesota Lynx,85,154,-110,MIN,Minnesota Lynx,-7,-110,1021800061,54,38,1,1,1,1,1,1,1,85,71,-14,92,-16,home,home,54,-16,156
6/16/2018,313,CSConnecticut Sun,72,172.5,-110,CON,Connecticut Sun,5.5,-110,1021800062,43,21,0,0,0,0,0,0,0,89,72,-17,64,-22,home,away,21,22,161
6/16/2018,314,PPhoenix,89,172.5,-110,PHO,Phoenix Mercury,-5.5,-110,1021800062,43,21,1,1,1,1,1,1,1,89,72,-17,64,-22,home,home,43,-22,161
6/17/2018,315,LSL.A. Sparks,81,163,-110,LAS,Los Angeles Sparks,-8.5,-110,1021800063,33,39,0,0,0,0,1,1,1,72,81,9,72,6,away,away,39,-6,153
6/17/2018,316,CSChicago Sky,72,163,-110,CHI,Chicago Sky,8.5,-110,1021800063,33,39,1,1,1,1,0,0,0,72,81,9,72,6,away,home,33,6,153
6/17/2018,317,PPhoenix,92,163.5,-110,PHO,Phoenix Mercury,-6.5,-110,1021800064,42,46,1,1,1,1,1,1,1,80,92,12,88,4,away,away,46,-4,172
6/17/2018,318,LVLas Vegas Aces,80,163.5,-110,LVA,Las Vegas Aces,6.5,-110,1021800064,42,46,0,0,0,0,0,0,0,80,92,12,88,4,away,home,42,4,172
6/19/2018,603,ADAtlanta Dream,72,150.5,-110,ATL,Atlanta Dream,6,-110,1021800065,34,24,0,0,0,0,0,0,0,79,72,-7,58,-10,home,away,24,10,151
6/19/2018,604,NYNew York Liberty,79,150.5,-110,NYL,New York Liberty,-6,-110,1021800065,34,24,1,1,1,1,1,1,1,79,72,-7,58,-10,home,home,34,-10,151
6/19/2018,601,CSChicago Sky,60,168.5,-110,CHI,Chicago Sky,9.5,-110,1021800066,46,32,0,1,0,0,0,0,0,88,60,-28,78,-14,home,away,32,14,148
6/19/2018,602,WMWashington Mystics,88,168.5,-110,WAS,Washington Mystics,-9.5,-110,1021800066,46,32,1,0,1,1,1,1,1,88,60,-28,78,-14,home,home,46,-14,148
6/19/2018,605,DWDallas Wings,83,165.5,-110,DAL,Dallas Wings,8.5,-110,1021800067,51,36,0,0,0,0,0,0,0,91,83,-8,87,-15,home,away,36,15,174
6/19/2018,606,MLMinnesota Lynx,91,165.5,-110,MIN,Minnesota Lynx,-8.5,-110,1021800067,51,36,1,1,1,1,1,1,1,91,83,-8,87,-15,home,home,51,-15,174
6/19/2018,607,LVLas Vegas Aces,89,168,-110,LVA,Las Vegas Aces,10.5,-110,1021800068,39,38,1,1,1,1,1,1,1,77,89,12,77,-1,home,away,38,1,166
6/19/2018,608,SSSeattle Storm,77,168,-110,SEA,Seattle Storm,-10.5,-110,1021800068,39,38,0,0,0,0,0,0,0,77,89,12,77,-1,home,home,39,-1,166
6/19/2018,609,IFIndiana Fever,55,153.5,-110,IND,Indiana Fever,12.5,-110,1021800069,35,33,1,1,1,0,0,0,0,74,55,-19,68,-2,home,away,33,2,129
6/19/2018,610,LSL.A. Sparks,74,153.5,-110,LAS,Los Angeles Sparks,-12.5,-110,1021800069,35,33,0,0,0,1,1,1,1,74,55,-19,68,-2,home,home,35,-2,129
6/22/2018,611,CSConnecticut Sun,70,164.5,-110,CON,Connecticut Sun,-6,-105,1021800070,29,37,1,1,1,1,1,1,1,75,70,-5,66,8,away,away,37,-8,145
6/22/2018,612,ADAtlanta Dream,75,164.5,-110,ATL,Atlanta Dream,6,-110,1021800070,29,37,0,0,0,0,0,0,0,75,70,-5,66,8,away,home,29,8,145
6/22/2018,613,LSL.A. Sparks,72,163,-110,LAS,Los Angeles Sparks,-4.5,-110,1021800071,47,33,1,0,0,0,0,0,0,101,72,-29,80,-14,home,away,33,14,173
6/22/2018,614,DWDallas Wings,101,163,-110,DAL,Dallas Wings,4.5,-110,1021800071,47,33,0,1,1,1,1,1,1,101,72,-29,80,-14,home,home,47,-14,173
6/22/2018,615,WMWashington Mystics,93,168,-110,WAS,Washington Mystics,-6,-105,1021800072,39,64,1,1,1,1,1,1,1,77,93,16,103,25,away,away,64,-25,170
6/22/2018,616,CSChicago Sky,77,168,-110,CHI,Chicago Sky,6,-115,1021800072,39,64,0,0,0,0,0,0,0,77,93,16,103,25,away,home,39,25,170
6/22/2018,617,MLMinnesota Lynx,83,162,-110,MIN,Minnesota Lynx,2.5,-110,1021800074,30,46,1,1,1,1,1,1,1,72,83,11,76,16,away,away,46,-16,155
6/22/2018,618,PPhoenix,72,162,-110,PHO,Phoenix Mercury,-2.5,-110,1021800074,30,46,0,0,0,0,0,0,0,72,83,11,76,16,away,home,30,16,155
6/22/2018,621,NYNew York Liberty,78,159.5,-110,NYL,New York Liberty,-1,-110,1021800073,34,26,0,0,0,0,0,0,0,88,78,-10,60,-8,home,away,26,8,166
6/22/2018,622,LVLas Vegas Aces,88,159.5,-110,LVA,Las Vegas Aces,1,-110,1021800073,34,26,1,1,1,1,1,1,1,88,78,-10,60,-8,home,home,34,-8,166
6/22/2018,619,IFIndiana Fever,63,166.5,-110,IND,Indiana Fever,11.5,-110,1021800075,37,30,0,0,0,0,0,0,0,72,63,-9,67,-7,home,away,30,7,135
6/22/2018,620,SSSeattle Storm,72,166.5,-110,SEA,Seattle Storm,-11.5,-110,1021800075,37,30,1,1,1,1,1,1,1,72,63,-9,67,-7,home,home,37,-7,135
6/24/2018,301,SSSeattle Storm,97,170.5,-110,SEA,Seattle Storm,2.5,-110,1021800076,42,49,1,1,1,1,1,1,1,76,97,21,91,7,away,away,49,-7,173
6/24/2018,302,DWDallas Wings,76,170.5,-110,DAL,Dallas Wings,-2.5,-110,1021800076,42,49,0,0,0,0,0,0,0,76,97,21,91,7,away,home,42,7,173
6/24/2018,305,NYNew York Liberty,54,151,-110,NYL,New York Liberty,10.5,-110,1021800077,43,27,0,0,0,0,0,0,0,80,54,-26,70,-16,home,away,27,16,134
6/24/2018,306,LSL.A. Sparks,80,151,-110,LAS,Los Angeles Sparks,-10.5,-110,1021800077,43,27,1,1,1,1,1,1,1,80,54,-26,70,-16,home,home,43,-16,134
6/24/2018,309,PPhoenix,88,164.5,-110,PHO,Phoenix Mercury,-6.5,-115,1021800080,47,43,0,0,0,0,0,0,0,97,88,-9,90,-4,home,away,43,4,185
6/24/2018,310,CSChicago Sky,97,164.5,-110,CHI,Chicago Sky,6.5,-105,1021800080,47,43,1,1,1,1,1,1,1,97,88,-9,90,-4,home,home,47,-4,185
6/24/2018,307,MLMinnesota Lynx,88,163,-110,MIN,Minnesota Lynx,-7,-110,1021800079,33,39,1,1,1,1,1,1,1,73,88,15,72,6,away,away,39,-6,161
6/24/2018,308,LVLas Vegas Aces,73,163,-110,LVA,Las Vegas Aces,7,-110,1021800079,33,39,0,0,0,0,0,0,0,73,88,15,72,6,away,home,33,6,161
6/24/2018,303,CSConnecticut Sun,87,165.5,-110,CON,Connecticut Sun,-8.5,-110,1021800078,45,43,1,1,1,1,1,1,1,78,87,9,88,-2,home,away,43,2,165
6/24/2018,304,IFIndiana Fever,78,165.5,-110,IND,Indiana Fever,8.5,-110,1021800078,45,43,0,0,0,0,0,0,0,78,87,9,88,-2,home,home,45,-2,165
6/26/2018,311,PPhoenix,83,160.5,-110,PHO,Phoenix Mercury,-3.5,-110,1021800081,37,44,1,1,1,1,1,1,1,69,83,14,81,7,away,away,44,-7,152
6/26/2018,312,NYNew York Liberty,69,160.5,-110,NYL,New York Liberty,3.5,-110,1021800081,37,44,0,0,0,0,0,0,0,69,83,14,81,7,away,home,37,7,152
6/26/2018,313,CSConnecticut Sun,80,171,-110,CON,Connecticut Sun,3.5,-110,1021800082,43,46,1,1,1,1,1,1,1,92,80,-12,89,3,away,away,46,-3,172
6/26/2018,314,WMWashington Mystics,92,171,-110,WAS,Washington Mystics,-3.5,-110,1021800082,43,46,0,0,0,0,0,0,0,92,80,-12,89,3,away,home,43,3,172
6/26/2018,315,SSSeattle Storm,79,164,-110,SEA,Seattle Storm,7.5,-110,1021800083,43,34,0,0,0,0,0,0,0,91,79,-12,77,-9,home,away,34,9,170
6/26/2018,316,MLMinnesota Lynx,91,164,-110,MIN,Minnesota Lynx,-7.5,-110,1021800083,43,34,1,1,1,1,1,1,1,91,79,-12,77,-9,home,home,43,-9,170
6/26/2018,317,DWDallas Wings,83,158.5,-110,DAL,Dallas Wings,8.5,-133,1021800084,42,46,1,1,1,0,1,1,1,87,83,-4,88,4,away,away,46,-4,170
6/26/2018,318,LSL.A. Sparks,87,158.5,-110,LAS,Los Angeles Sparks,-8.5,113,1021800084,42,46,0,0,0,1,0,0,0,87,83,-4,88,4,away,home,42,4,170
6/28/2018,601,NYNew York Liberty,77,162.5,-110,NYL,New York Liberty,9.5,-115,1021800088,44,39,1,1,1,1,0,1,0,80,77,-3,83,-5,home,away,39,5,157
6/28/2018,602,WMWashington Mystics,80,162.5,-110,WAS,Washington Mystics,-9.5,-110,1021800088,44,39,0,0,0,0,1,0,1,80,77,-3,83,-5,home,home,44,-5,157
6/28/2018,603,LSL.A. Sparks,72,160,-110,LAS,Los Angeles Sparks,3,-110,1021800089,41,35,0,0,0,0,0,0,0,81,72,-9,76,-6,home,away,35,6,153
6/28/2018,604,SSSeattle Storm,81,160,-110,SEA,Seattle Storm,-3,-110,1021800089,41,35,1,1,1,1,1,1,1,81,72,-9,76,-6,home,home,41,-6,153
6/29/2018,605,PPhoenix,95,162.5,-110,PHO,Phoenix Mercury,-7.5,-110,1021800090,39,56,1,1,1,1,1,1,1,77,95,18,95,17,away,away,56,-17,172
6/29/2018,606,IFIndiana Fever,77,162.5,-110,IND,Indiana Fever,7,-110,1021800090,39,56,0,0,0,0,0,0,0,77,95,18,95,17,away,home,39,17,172
6/29/2018,607,CSChicago Sky,103,162,-110,CHI,Chicago Sky,3.5,-110,1021800091,55,52,0,0,0,0,1,0,0,99,103,4,107,-3,home,away,52,3,202
6/29/2018,608,NYNew York Liberty,99,162,-110,NYL,New York Liberty,-3.5,-110,1021800091,55,52,1,1,1,1,0,1,1,99,103,4,107,-3,home,home,55,-3,202
6/29/2018,609,ADAtlanta Dream,74,155.5,105,ATL,Atlanta Dream,12,-115,1021800092,39,36,0,1,1,0,0,0,0,85,74,-11,75,-3,home,away,36,3,159
6/29/2018,610,MLMinnesota Lynx,85,155.5,-125,MIN,Minnesota Lynx,-12,-105,1021800092,39,36,1,0,0,1,1,1,1,85,74,-11,75,-3,home,home,39,-3,159
6/29/2018,611,LSL.A. Sparks,78,159,105,LAS,Los Angeles Sparks,-7,-110,1021800093,44,37,1,1,0,0,0,0,0,94,78,-16,81,-7,home,away,37,7,172
6/29/2018,612,LVLas Vegas Aces,94,158,-105,LVA,Las Vegas Aces,7,-110,1021800093,44,37,0,0,1,1,1,1,1,94,78,-16,81,-7,home,home,44,-7,172
7/3/2018,311,SSSeattle Storm,77,165.5,-110,SEA,Seattle Storm,-4.5,-110,1021800100,28,39,1,1,0,0,1,1,1,62,77,15,67,11,away,away,39,-11,139
7/3/2018,312,NYNew York Liberty,62,165.5,-110,NYL,New York Liberty,4.5,-110,1021800100,28,39,0,0,1,1,0,0,0,62,77,15,67,11,away,home,28,11,139
7/3/2018,315,CSChicago Sky,85,174,-110,CHI,Chicago Sky,6.5,-110,1021800101,51,49,0,1,1,1,0,0,0,108,85,-23,100,-2,home,away,49,2,193
7/3/2018,316,DWDallas Wings,108,174,-110,DAL,Dallas Wings,-6.5,-110,1021800101,51,49,1,0,0,0,1,1,1,108,85,-23,100,-2,home,home,51,-2,193
7/3/2018,313,IFIndiana Fever,71,160,-105,IND,Indiana Fever,14,-110,1021800102,32,34,1,1,1,1,1,0,1,59,71,12,66,2,away,away,34,-2,130
7/3/2018,314,MLMinnesota Lynx,59,160,-110,MIN,Minnesota Lynx,-14,-110,1021800102,32,34,0,0,0,0,0,1,0,59,71,12,66,2,away,home,32,2,130
7/3/2018,317,CSConnecticut Sun,73,162,-110,CON,Connecticut Sun,9.5,-105,1021800103,25,41,1,1,1,1,1,1,1,72,73,1,66,16,away,away,41,-16,145
7/3/2018,318,LSL.A. Sparks,72,162,-110,LAS,Los Angeles Sparks,-9.5,-115,1021800103,25,41,0,0,0,0,0,0,0,72,73,1,66,16,away,home,25,16,145
7/6/2018,611,SSSeattle Storm,95,161,-110,SEA,Seattle Storm,-4.5,-110,1021800109,34,53,0,1,1,1,1,1,1,86,95,9,87,19,away,away,53,-19,181
7/6/2018,612,ADAtlanta Dream,86,161,-110,ATL,Atlanta Dream,4.5,-110,1021800109,34,53,1,0,0,0,0,0,0,86,95,9,87,19,away,home,34,19,181
7/7/2018,301,WMWashington Mystics,83,160,-110,WAS,Washington Mystics,6,-105,1021800110,35,30,1,1,1,1,0,0,0,74,83,9,65,-5,home,away,30,5,157
7/7/2018,302,LSL.A. Sparks,74,160,-110,LAS,Los Angeles Sparks,-6,-115,1021800110,35,30,0,0,0,0,1,1,1,74,83,9,65,-5,home,home,35,-5,157
7/7/2018,303,MLMinnesota Lynx,63,169,-110,MIN,Minnesota Lynx,-8.5,-110,1021800111,42,37,0,0,0,1,0,0,0,77,63,-14,79,-5,home,away,37,5,140
7/7/2018,304,CSChicago Sky,77,169,-110,CHI,Chicago Sky,8.5,-110,1021800111,42,37,1,1,1,0,1,1,1,77,63,-14,79,-5,home,home,42,-5,140
7/7/2018,305,CSConnecticut Sun,90,169,-110,CON,Connecticut Sun,-4.5,-110,1021800112,41,40,0,0,0,0,0,0,1,94,90,-4,81,-1,home,away,40,1,184
7/7/2018,306,LVLas Vegas Aces,94,168,105,LVA,Las Vegas Aces,4.5,-110,1021800112,41,40,1,1,1,1,1,1,0,94,90,-4,81,-1,home,home,41,-1,184
7/8/2018,307,PPhoenix,70,161,-130,PHO,Phoenix Mercury,-4.5,-105,1021800113,44,33,0,0,0,0,0,0,0,76,70,-6,77,-11,home,away,33,11,146
7/8/2018,308,ADAtlanta Dream,76,161,110,ATL,Atlanta Dream,4.5,-115,1021800113,44,33,1,1,1,1,1,1,1,76,70,-6,77,-11,home,home,44,-11,146
7/8/2018,309,DWDallas Wings,97,164.5,-124,DAL,Dallas Wings,-3,-110,1021800114,37,47,1,1,1,1,1,1,1,87,97,10,84,10,away,away,47,-10,184
7/8/2018,310,NYNew York Liberty,87,164.5,104,NYL,New York Liberty,3.5,-125,1021800114,37,47,0,0,0,0,0,0,0,87,97,10,84,10,away,home,37,10,184
7/8/2018,311,WMWashington Mystics,91,171.5,-110,WAS,Washington Mystics,6,-110,1021800115,44,46,0,0,1,0,1,1,1,97,91,-6,90,2,away,away,46,-2,188
7/8/2018,312,SSSeattle Storm,97,171.5,-110,SEA,Seattle Storm,-6,-110,1021800115,44,46,1,1,0,1,0,0,0,97,91,-6,90,2,away,home,44,2,188
7/10/2018,313,LSL.A. Sparks,77,161,-110,LAS,Los Angeles Sparks,3,-110,1021800116,34,36,0,1,1,1,1,1,1,75,77,2,70,2,away,away,36,-2,152
7/10/2018,314,SSSeattle Storm,75,161,-110,SEA,Seattle Storm,-3,-110,1021800116,34,36,1,0,0,0,0,0,0,75,77,2,70,2,away,home,34,2,152
7/10/2018,315,PPhoenix,72,171,-110,PHO,Phoenix Mercury,2.5,-110,1021800117,59,39,0,0,0,0,0,0,0,101,72,-29,98,-20,home,away,39,20,173
7/10/2018,316,DWDallas Wings,101,171,-110,DAL,Dallas Wings,-2.5,-110,1021800117,59,39,1,1,1,1,1,1,1,101,72,-29,98,-20,home,home,59,-20,173
7/10/2018,317,LVLas Vegas Aces,98,175.5,-110,LVA,Las Vegas Aces,4,-110,1021800118,36,49,0,0,0,0,1,1,1,74,98,24,85,13,away,away,49,-13,172
7/10/2018,318,CSChicago Sky,74,175.5,-110,CHI,Chicago Sky,-4,-110,1021800118,36,49,1,1,1,1,0,0,0,74,98,24,85,13,away,home,36,13,172
7/12/2018,601,DWDallas Wings,92,164,-110,DAL,Dallas Wings,6,-110,1021800122,50,48,1,1,1,1,1,1,1,77,92,15,98,-2,home,away,48,2,169
7/12/2018,602,LSL.A. Sparks,77,164,-110,LAS,Los Angeles Sparks,-6,-110,1021800122,50,48,0,0,0,0,0,0,0,77,92,15,98,-2,home,home,50,-2,169
8/3/2018,607,CSChicago Sky,74,170,-110,CHI,Chicago Sky,8.5,-110,1021800161,42,43,0,0,0,0,0,0,0,89,74,-15,85,1,away,away,43,-1,163
8/3/2018,608,ADAtlanta Dream,89,170,-110,ATL,Atlanta Dream,-8.5,-110,1021800161,42,43,1,1,1,1,1,1,1,89,74,-15,85,1,away,home,42,1,163
8/3/2018,609,MLMinnesota Lynx,75,163,-110,MIN,Minnesota Lynx,5.5,-110,1021800163,37,38,1,0,1,1,1,1,1,85,75,-10,75,1,away,away,38,-1,160
8/3/2018,610,SSSeattle Storm,85,163,-110,SEA,Seattle Storm,-5.5,-110,1021800163,37,38,0,1,0,0,0,0,0,85,75,-10,75,1,away,home,37,1,160
8/3/2018,605,LVLas Vegas Aces,NA,169.5,-110,LVA,Las Vegas Aces,9,-110,NA,NA,NA,NA,NA,NA,NA,NA,NA,NA,NA,NA,NA,NA,NA,NA,NA,NA,NA,NA
8/3/2018,606,WMWashington Mystics,NA,169.5,-110,WAS,Washington Mystics,-9,-110,NA,NA,NA,NA,NA,NA,NA,NA,NA,NA,NA,NA,NA,NA,NA,NA,NA,NA,NA,NA
8/4/2018,301,IFIndiana Fever,68,161.5,-110,IND,Indiana Fever,7,-110,1021800164,35,31,0,0,0,0,0,0,0,55,68,13,66,-4,home,away,31,4,123
8/4/2018,302,NYNew York Liberty,55,161.5,-110,NYL,New York Liberty,-7,-110,1021800164,35,31,1,1,1,1,1,1,1,55,68,13,66,-4,home,home,35,-4,123
8/5/2018,303,LVLas Vegas Aces,88,173,-110,LVA,Las Vegas Aces,8.5,-110,1021800165,64,49,0,0,0,0,0,0,0,109,88,-21,113,-15,home,away,49,15,197
8/5/2018,304,CSConnecticut Sun,109,172.5,-110,CON,Connecticut Sun,-8.5,-110,1021800165,64,49,1,1,1,1,1,1,1,109,88,-21,113,-15,home,home,64,-15,197
8/5/2018,305,WMWashington Mystics,76,171,-110,WAS,Washington Mystics,-3.5,-110,1021800166,38,43,0,1,1,0,1,1,1,74,76,2,81,5,away,away,43,-5,150
8/5/2018,306,DWDallas Wings,74,171,-110,DAL,Dallas Wings,3.5,-110,1021800166,38,43,1,0,0,1,0,0,0,74,76,2,81,5,away,home,38,5,150
8/5/2018,309,PPhoenix,75,161,-110,PHO,Phoenix Mercury,7.5,-110,1021800167,40,30,0,0,0,0,0,0,0,78,75,-3,70,-10,home,away,30,10,153
8/5/2018,310,LSL.A. Sparks,78,161,-110,LAS,Los Angeles Sparks,-7.5,-110,1021800167,40,30,1,1,1,1,1,1,1,78,75,-3,70,-10,home,home,40,-10,153
8/5/2018,307,ADAtlanta Dream,86,155.5,-110,ATL,Atlanta Dream,6,-110,1021800168,34,49,0,1,1,0,1,1,1,66,86,20,83,15,away,away,49,-15,152
8/5/2018,308,MLMinnesota Lynx,66,155.5,-110,MIN,Minnesota Lynx,-6,-110,1021800168,34,49,1,0,0,1,0,0,0,66,86,20,83,15,away,home,34,15,152
8/6/2018,311,SSSeattle Storm,96,163,-110,SEA,Seattle Storm,-10,-110,1021800169,44,44,0,0,1,1,1,1,0,80,96,16,88,0,tie,away,44,-0,176
8/6/2018,312,NYNew York Liberty,80,163,-110,NYL,New York Liberty,9.5,-110,1021800169,44,44,1,1,0,0,0,0,1,80,96,16,88,0,tie,home,44,0,176
8/8/2018,609,LSL.A. Sparks,82,155,-110,LAS,Los Angeles Sparks,-9,-110,1021800174,41,41,0,0,0,0,0,0,1,81,82,1,82,0,tie,away,41,-0,163
8/8/2018,610,NYNew York Liberty,81,155,-110,NYL,New York Liberty,9,-110,1021800174,41,41,1,1,1,1,1,1,0,81,82,1,82,0,tie,home,41,0,163
8/8/2018,611,CSConnecticut Sun,101,175,-110,CON,Connecticut Sun,-2,-110,1021800175,32,48,0,1,1,1,1,1,1,92,101,9,80,16,away,away,48,-16,193
8/8/2018,612,DWDallas Wings,92,175,-110,DAL,Dallas Wings,2,-110,1021800175,32,48,1,0,0,0,0,0,0,92,101,9,80,16,away,home,32,16,193
8/9/2018,613,SSSeattle Storm,77,172,-110,SEA,Seattle Storm,-0.5,-110,1021800176,57,40,0,0,0,0,0,0,0,100,77,-23,97,-17,home,away,40,17,177
8/9/2018,614,WMWashington Mystics,100,172,-110,WAS,Washington Mystics,-1,-120,1021800176,57,40,1,1,1,1,1,1,1,100,77,-23,97,-17,home,home,57,-17,177
8/9/2018,615,LSL.A. Sparks,73,155.5,-110,LAS,Los Angeles Sparks,-1.5,-110,1021800177,36,33,1,1,0,1,1,0,0,79,73,-6,69,-3,home,away,33,3,152
8/9/2018,616,ADAtlanta Dream,79,155.5,-110,ATL,Atlanta Dream,1.5,-110,1021800177,36,33,0,0,1,0,0,1,1,79,73,-6,69,-3,home,home,36,-3,152
8/9/2018,617,MLMinnesota Lynx,89,167.5,-110,MIN,Minnesota Lynx,1.5,-115,1021800178,37,43,0,0,1,1,1,1,1,73,89,16,80,6,away,away,43,-6,162
8/9/2018,618,LVLas Vegas Aces,73,167.5,-110,LVA,Las Vegas Aces,-1.5,-105,1021800178,37,43,1,1,0,0,0,0,0,73,89,16,80,6,away,home,37,6,162
8/10/2018,301,CSConnecticut Sun,86,178.5,-110,CON,Connecticut Sun,-9.5,-110,1021800179,54,38,0,0,0,0,0,0,0,97,86,-11,92,-16,home,away,38,16,183
8/10/2018,302,CSChicago Sky,97,178.5,-110,CHI,Chicago Sky,9.5,-110,1021800179,54,38,1,1,1,1,1,1,1,97,86,-11,92,-16,home,home,54,-16,183
8/10/2018,303,IFIndiana Fever,74,168,-110,IND,Indiana Fever,12.5,-115,1021800180,43,29,0,0,0,0,0,0,0,94,74,-20,72,-14,home,away,29,14,168
8/10/2018,304,PPhoenix,94,168,-110,PHO,Phoenix Mercury,-12.5,-110,1021800180,43,29,1,1,1,1,1,1,1,94,74,-20,72,-14,home,home,43,-14,168
8/11/2018,305,DWDallas Wings,82,166,-110,DAL,Dallas Wings,6.5,-110,1021800181,49,39,0,0,0,0,0,0,0,92,82,-10,88,-10,home,away,39,10,174
8/11/2018,306,ADAtlanta Dream,92,166,-110,ATL,Atlanta Dream,-6.5,-110,1021800181,49,39,1,1,1,1,1,1,1,92,82,-10,88,-10,home,home,49,-10,174
8/11/2018,307,IFIndiana Fever,74,166,-110,IND,Indiana Fever,10.5,-110,1021800182,51,40,0,0,0,0,0,0,0,92,74,-18,91,-11,home,away,40,11,166
8/11/2018,308,LVLas Vegas Aces,92,166,-110,LVA,Las Vegas Aces,-10.5,-110,1021800182,51,40,1,1,1,1,1,1,1,92,74,-18,91,-11,home,home,51,-11,166
8/12/2018,601,ADAtlanta Dream,86,159.5,-110,ATL,Atlanta Dream,-5.5,-115,1021800183,48,37,0,1,0,0,0,0,0,77,86,9,85,-11,home,away,37,11,163
8/12/2018,602,NYNew York Liberty,77,159.5,-110,NYL,New York Liberty,5.5,-105,1021800183,48,37,1,0,1,1,1,1,1,77,86,9,85,-11,home,home,48,-11,163
8/12/2018,605,CSChicago Sky,75,178.5,-110,CHI,Chicago Sky,12,-110,1021800184,35,38,1,0,0,0,0,1,1,82,75,-7,73,3,away,away,38,-3,157
8/12/2018,606,CSConnecticut Sun,82,178.5,-110,CON,Connecticut Sun,-12,-110,1021800184,35,38,0,1,1,1,1,0,0,82,75,-7,73,3,away,home,35,3,157
8/12/2018,603,DWDallas Wings,80,174,-110,DAL,Dallas Wings,10.5,-110,1021800185,51,37,0,0,0,0,0,0,0,93,80,-13,88,-14,home,away,37,14,173
8/12/2018,604,WMWashington Mystics,93,174,-110,WAS,Washington Mystics,-10.5,-110,1021800185,51,37,1,1,1,1,1,1,1,93,80,-13,88,-14,home,home,51,-14,173
8/12/2018,609,LSL.A. Sparks,78,162,-110,LAS,Los Angeles Sparks,-3,-110,1021800186,41,34,1,1,1,1,1,0,0,86,78,-8,75,-7,home,away,34,7,164
8/12/2018,610,PPhoenix,86,162,-110,PHO,Phoenix Mercury,3,-110,1021800186,41,34,0,0,0,0,0,1,1,86,78,-8,75,-7,home,home,41,-7,164
8/12/2018,607,SSSeattle Storm,81,163.5,-110,SEA,Seattle Storm,-3,-110,1021800187,30,35,1,1,1,1,1,1,1,72,81,9,65,5,away,away,35,-5,153
8/12/2018,608,MLMinnesota Lynx,72,163.5,-110,MIN,Minnesota Lynx,3,-110,1021800187,30,35,0,0,0,0,0,0,0,72,81,9,65,5,away,home,30,5,153
8/14/2018,611,DWDallas Wings,76,178,-110,DAL,Dallas Wings,7,-110,1021800188,50,38,1,0,0,0,0,0,0,96,76,-20,88,-12,home,away,38,12,172
8/14/2018,612,CSConnecticut Sun,96,178,-110,CON,Connecticut Sun,-7,-110,1021800188,50,38,0,1,1,1,1,1,1,96,76,-20,88,-12,home,home,50,-12,172
8/14/2018,613,CSChicago Sky,91,164,-110,CHI,Chicago Sky,9.5,-115,1021800189,44,39,1,0,1,0,0,0,0,88,91,3,83,-5,home,away,39,5,179
8/14/2018,614,MLMinnesota Lynx,88,164,-110,MIN,Minnesota Lynx,-9.5,-105,1021800189,44,39,0,1,0,1,1,1,1,88,91,3,83,-5,home,home,44,-5,179
8/14/2018,615,NYNew York Liberty,66,154,-110,NYL,New York Liberty,13.5,-110,1021800190,38,44,0,1,0,1,1,1,1,74,66,-8,82,6,away,away,44,-6,140
8/14/2018,616,LSL.A. Sparks,74,154,-110,LAS,Los Angeles Sparks,-13.5,-110,1021800190,38,44,1,0,1,0,0,0,0,74,66,-8,82,6,away,home,38,6,140
8/15/2018,301,WMWashington Mystics,76,165.5,-110,WAS,Washington Mystics,-11,-110,1021800191,41,48,1,1,1,1,1,1,1,62,76,14,89,7,away,away,48,-7,138
8/15/2018,302,IFIndiana Fever,62,165.5,-110,IND,Indiana Fever,11,-110,1021800191,41,48,0,0,0,0,0,0,0,62,76,14,89,7,away,home,41,7,138
8/15/2018,303,NYNew York Liberty,72,168.5,-110,NYL,New York Liberty,13.5,-105,1021800192,46,33,0,0,0,0,0,0,0,85,72,-13,79,-13,home,away,33,13,157
8/15/2018,304,LVLas Vegas Aces,85,168.5,-110,LVA,Las Vegas Aces,-13,-110,1021800192,46,33,1,1,1,1,1,1,1,85,72,-13,79,-13,home,home,46,-13,157
8/18/2018,315,CSChicago Sky,115,166.5,-110,CHI,Chicago Sky,-3.5,-110,1021800198,37,40,0,1,1,1,0,1,1,106,115,9,77,3,away,away,40,-3,221
8/18/2018,316,IFIndiana Fever,106,166.5,-110,IND,Indiana Fever,3.5,-110,1021800198,37,40,1,0,0,0,1,0,0,106,115,9,77,3,away,home,37,3,221
8/19/2018,601,LSL.A. Sparks,86,161,-110,LAS,Los Angeles Sparks,5.5,-110,1021800199,52,41,0,0,0,0,0,0,0,89,86,-3,93,-11,home,away,41,11,175
8/19/2018,602,CSConnecticut Sun,89,161,-110,CON,Connecticut Sun,-5.5,-110,1021800199,52,41,1,1,1,1,1,1,1,89,86,-3,93,-11,home,home,52,-11,175
8/19/2018,605,NYNew York Liberty,85,167.5,-110,NYL,New York Liberty,12,-110,1021800201,49,46,1,1,0,0,1,0,1,96,85,-11,95,-3,home,away,46,3,181
8/19/2018,606,PPhoenix,96,167.5,-110,PHO,Phoenix Mercury,-12,-110,1021800201,49,46,0,0,1,1,0,1,0,96,85,-11,95,-3,home,home,49,-3,181
8/19/2018,603,ADAtlanta Dream,93,175,-110,ATL,Atlanta Dream,-5,-110,1021800200,47,41,1,1,1,0,0,0,0,78,93,15,88,-6,home,away,41,6,171
8/19/2018,604,LVLas Vegas Aces,78,175,-110,LVA,Las Vegas Aces,5,-110,1021800200,47,41,0,0,0,1,1,1,1,78,93,15,88,-6,home,home,47,-6,171
8/19/2018,607,IFIndiana Fever,97,167,-110,IND,Indiana Fever,8.5,-110,1021800202,54,47,0,0,0,0,0,0,0,92,97,5,101,-7,home,away,47,7,189
8/19/2018,608,CSChicago Sky,92,167,-110,CHI,Chicago Sky,-8.5,-110,1021800202,54,47,1,1,1,1,1,1,1,92,97,5,101,-7,home,home,54,-7,189
8/19/2018,611,WMWashington Mystics,83,158,-110,WAS,Washington Mystics,-2,-115,1021800204,44,43,1,1,1,0,1,0,1,88,83,-5,87,-1,home,away,43,1,171
8/19/2018,612,MLMinnesota Lynx,88,158,-110,MIN,Minnesota Lynx,2,-105,1021800204,44,43,0,0,0,1,0,1,0,88,83,-5,87,-1,home,home,44,-1,171
8/19/2018,609,DWDallas Wings,68,172.5,-110,DAL,Dallas Wings,6.5,-110,1021800203,57,45,0,0,0,0,0,0,0,84,68,-16,102,-12,home,away,45,12,152
8/19/2018,610,SSSeattle Storm,84,172.5,-110,SEA,Seattle Storm,-6.5,-110,1021800203,57,45,1,1,1,1,1,1,1,84,68,-16,102,-12,home,home,57,-12,152
6/30/2018,315,PPhoenix,84,NA,NA,PHO,Phoenix Mercury,3.5,-110,1021800094,35,39,0,1,1,1,1,0,1,74,84,10,74,4,away,away,39,-4,158
6/30/2018,316,WMWashington Mystics,74,NA,NA,WAS,Washington Mystics,-3.5,-110,1021800094,35,39,1,0,0,0,0,1,0,74,84,10,74,4,away,home,35,4,158
6/30/2019,621,NYNew York Liberty,74,159.5,-110,NYL,New York Liberty,4,-110,1021900069,28,39,1,1,1,1,1,1,1,58,74,16,67,11,away,away,39,-11,132
6/30/2019,622,ADAtlanta Dream,58,159.5,-110,ATL,Atlanta Dream,-4,-110,1021900069,28,39,0,0,0,0,0,0,0,58,74,16,67,11,away,home,28,11,132
6/30/2019,623,MLMinnesota Lynx,86,145.5,-110,MIN,Minnesota Lynx,-2.5,-110,1021900070,41,53,0,1,1,1,1,1,1,89,86,-3,94,12,away,away,53,-12,175
6/30/2019,624,DWDallas Wings,89,145.5,-110,DAL,Dallas Wings,2.5,-110,1021900070,41,53,1,0,0,0,0,0,0,89,86,-3,94,12,away,home,41,12,175
6/30/2019,625,CSChicago Sky,69,159.5,-110,CHI,Chicago Sky,5.5,-110,1021900071,48,36,0,0,0,0,0,0,0,94,69,-25,84,-12,home,away,36,12,163
6/30/2019,626,LSL.A. Sparks,94,159.5,-110,LAS,Los Angeles Sparks,-5.5,-110,1021900071,48,36,1,1,1,1,1,1,1,94,69,-25,84,-12,home,home,48,-12,163
6/30/2019,627,PPhoenix,69,149,-110,PHO,Phoenix Mercury,1,-110,1021900072,33,34,1,1,1,1,1,0,1,67,69,2,67,1,away,away,34,-1,136
6/30/2019,628,SSSeattle Storm,67,149,-110,SEA,Seattle Storm,-1,-110,1021900072,33,34,0,0,0,0,0,1,0,67,69,2,67,1,away,home,33,1,136
7/17/2019,625,DWDallas Wings,64,148.5,-110,DAL,Dallas Wings,6.5,-110,1021900102,31,34,1,0,0,0,1,1,0,69,64,-5,65,3,away,away,34,-3,133
7/17/2019,626,PPhoenix,69,148,-110,PHO,Phoenix Mercury,-6.5,-110,1021900102,31,34,0,1,1,1,0,0,1,69,64,-5,65,3,away,home,31,3,133
7/17/2019,627,SSSeattle Storm,90,147,-110,SEA,Seattle Storm,5.5,-110,1021900103,40,50,1,1,1,1,1,1,1,79,90,11,90,10,away,away,50,-10,169
7/17/2019,628,MLMinnesota Lynx,79,147,-110,MIN,Minnesota Lynx,-5.5,-110,1021900103,40,50,0,0,0,0,0,0,0,79,90,11,90,10,away,home,40,10,169
8/18/2019,631,DWDallas Wings,68,149,-110,DAL,Dallas Wings,9.5,-110,1021900155,37,34,0,0,0,0,1,0,0,78,68,-10,71,-3,home,away,34,3,146
8/18/2019,632,CSConnecticut Sun,78,149,-110,CON,Connecticut Sun,-9.5,-110,1021900155,37,34,1,1,1,1,0,1,1,78,68,-10,71,-3,home,home,37,-3,146
8/18/2019,629,IFIndiana Fever,68,165,-110,IND,Indiana Fever,13.5,-110,1021900156,43,34,0,0,0,0,0,0,0,107,68,-39,77,-9,home,away,34,9,175
8/18/2019,630,WMWashington Mystics,107,165,-110,WAS,Washington Mystics,-13.5,-110,1021900156,43,34,1,1,1,1,1,1,1,107,68,-39,77,-9,home,home,43,-9,175
8/18/2019,635,LVLas Vegas Aces,100,168.5,-110,LVA,Las Vegas Aces,-2,-110,1021900157,41,47,0,1,0,0,0,1,1,85,100,15,88,6,away,away,47,-6,185
8/18/2019,636,CSChicago Sky,85,168.5,-110,CHI,Chicago Sky,2,-110,1021900157,41,47,1,0,1,1,1,0,0,85,100,15,88,6,away,home,41,6,185
8/18/2019,633,NYNew York Liberty,72,156.5,-110,NYL,New York Liberty,5,-110,1021900158,35,29,1,1,0,0,0,0,0,78,72,-6,64,-6,home,away,29,6,150
8/18/2019,634,PPhoenix,78,156.5,-110,PHO,Phoenix Mercury,-5,-110,1021900158,35,29,0,0,1,1,1,1,1,78,72,-6,64,-6,home,home,35,-6,150
8/18/2019,637,MLMinnesota Lynx,74,150.5,-110,MIN,Minnesota Lynx,3.5,-110,1021900159,48,39,0,0,0,0,0,0,0,82,74,-8,87,-9,home,away,39,9,156
8/18/2019,638,SSSeattle Storm,82,150.5,-110,SEA,Seattle Storm,-3.5,-110,1021900159,48,39,1,1,1,1,1,1,1,82,74,-8,87,-9,home,home,48,-9,156
5/25/2019,605,PPhoenix,68,158,-110,PHO,Phoenix Mercury,-3.5,-115,1021900003,32,32,0,1,1,1,1,0,0,77,68,-9,64,0,tie,away,32,-0,145
5/25/2019,606,SSSeattle Storm,77,158,-110,SEA,Seattle Storm,3.5,-105,1021900003,32,32,1,0,0,0,0,1,1,77,68,-9,64,0,tie,home,32,0,145
5/25/2019,607,WMWashington Mystics,69,166.5,-110,WAS,Washington Mystics,5.5,-110,1021900004,44,41,1,0,0,0,0,1,0,84,69,-15,85,-3,home,away,41,3,153
5/25/2019,608,CSConnecticut Sun,84,166.5,-110,CON,Connecticut Sun,-5.5,-110,1021900004,44,41,0,1,1,1,1,0,1,84,69,-15,85,-3,home,home,44,-3,153
5/25/2019,609,CSChicago Sky,71,162,-110,CHI,Chicago Sky,4,-110,1021900005,46,40,0,0,1,1,0,0,0,89,71,-18,86,-6,home,away,40,6,160
5/25/2019,610,MLMinnesota Lynx,89,161.5,102,MIN,Minnesota Lynx,-4,-110,1021900005,46,40,1,1,0,0,1,1,1,89,71,-18,86,-6,home,home,46,-6,160
6/19/2019,641,IFIndiana Fever,78,150,-110,IND,Indiana Fever,-1,-110,1021900046,45,44,1,1,0,1,0,0,1,88,78,-10,89,-1,home,away,44,1,166
6/19/2019,642,ADAtlanta Dream,88,150,-110,ATL,Atlanta Dream,-1.5,-125,1021900046,45,44,0,0,1,0,1,1,0,88,78,-10,89,-1,home,home,45,-1,166
6/19/2019,643,CSChicago Sky,91,164,-110,CHI,Chicago Sky,2,-110,1021900047,34,41,1,1,1,1,1,1,1,83,91,8,75,7,away,away,41,-7,174
6/19/2019,644,NYNew York Liberty,83,164,-110,NYL,New York Liberty,-2,-110,1021900047,34,41,0,0,0,0,0,0,0,83,91,8,75,7,away,home,34,7,174
7/13/2019,611,LVLas Vegas Aces,85,163,-110,LVA,Las Vegas Aces,2.5,-110,1021900095,44,43,0,0,0,0,0,0,0,81,85,4,87,-1,home,away,43,1,166
7/13/2019,612,WMWashington Mystics,81,163,-110,WAS,Washington Mystics,-2.5,-110,1021900095,44,43,1,1,1,1,1,1,1,81,85,4,87,-1,home,home,44,-1,166
7/30/2019,613,CSChicago Sky,94,161.5,-110,CHI,Chicago Sky,7,-110,1021900118,57,43,0,0,0,1,0,0,0,100,94,-6,100,-14,home,away,43,14,194
7/30/2019,614,CSConnecticut Sun,100,161.5,-110,CON,Connecticut Sun,-7,-112,1021900118,57,43,1,1,1,0,1,1,1,100,94,-6,100,-14,home,home,57,-14,194
7/30/2019,611,PPhoenix,93,158,-110,PHO,Phoenix Mercury,10.5,-110,1021900119,48,38,0,0,0,0,0,0,0,99,93,-6,86,-10,home,away,38,10,192
7/30/2019,612,WMWashington Mystics,99,158,-115,WAS,Washington Mystics,-10.5,-110,1021900119,48,38,1,1,1,1,1,1,1,99,93,-6,86,-10,home,home,48,-10,192
7/30/2019,615,DWDallas Wings,54,150.5,-110,DAL,Dallas Wings,12,-110,1021900120,42,27,0,0,0,0,0,0,0,86,54,-32,69,-15,home,away,27,15,140
7/30/2019,616,LVLas Vegas Aces,86,150.5,-110,LVA,Las Vegas Aces,-12,-105,1021900120,42,27,1,1,1,1,1,1,1,86,54,-32,69,-15,home,home,42,-15,140
8/11/2019,601,MLMinnesota Lynx,78,160,-110,MIN,Minnesota Lynx,8,-115,1021900142,51,41,0,0,0,0,0,0,0,101,78,-23,92,-10,home,away,41,10,179
8/11/2019,602,WMWashington Mystics,101,160,-110,WAS,Washington Mystics,-8,-105,1021900142,51,41,1,1,1,1,1,1,1,101,78,-23,92,-10,home,home,51,-10,179
8/11/2019,603,SSSeattle Storm,84,154.5,-110,SEA,Seattle Storm,-4,-110,1021900141,45,43,0,0,1,1,1,1,1,69,84,15,88,-2,home,away,43,2,153
8/11/2019,604,NYNew York Liberty,69,154.5,-110,NYL,New York Liberty,4,-110,1021900141,45,43,1,1,0,0,0,0,0,69,84,15,88,-2,home,home,45,-2,153
8/11/2019,605,CSChicago Sky,81,162.5,-110,CHI,Chicago Sky,7,-110,1021900143,39,44,1,1,1,1,1,1,1,84,81,-3,83,5,away,away,44,-5,165
8/11/2019,606,LSL.A. Sparks,84,162,-115,LAS,Los Angeles Sparks,-7,-110,1021900143,39,44,0,0,0,0,0,0,0,84,81,-3,83,5,away,home,39,5,165
8/11/2019,607,CSConnecticut Sun,81,159.5,-110,CON,Connecticut Sun,2.5,-105,1021900144,42,42,0,0,1,1,1,1,1,89,81,-8,84,0,tie,away,42,-0,170
8/11/2019,608,LVLas Vegas Aces,89,159.5,-110,LVA,Las Vegas Aces,-2.5,-115,1021900144,42,42,1,1,0,0,0,0,0,89,81,-8,84,0,tie,home,42,0,170
8/16/2019,619,SSSeattle Storm,78,150.5,-113,SEA,Seattle Storm,6.5,-115,1021900150,34,46,0,0,0,1,1,1,1,79,78,-1,80,12,away,away,46,-12,157
8/16/2019,620,CSConnecticut Sun,79,150.5,-107,CON,Connecticut Sun,-6.5,-105,1021900150,34,46,1,1,1,0,0,0,0,79,78,-1,80,12,away,home,34,12,157
8/16/2019,625,WMWashington Mystics,86,162.5,-110,WAS,Washington Mystics,-6,-110,1021900153,41,39,1,1,0,0,0,0,0,79,86,7,80,-2,home,away,39,2,165
8/16/2019,626,MLMinnesota Lynx,79,162.5,-110,MIN,Minnesota Lynx,6,-110,1021900153,41,39,0,0,1,1,1,1,1,79,86,7,80,-2,home,home,41,-2,165
8/16/2019,623,LSL.A. Sparks,81,165.5,-110,LAS,Los Angeles Sparks,-1.5,-110,1021900151,45,37,0,0,0,0,0,0,0,91,81,-10,82,-8,home,away,37,8,172
8/16/2019,624,CSChicago Sky,91,165.5,-110,CHI,Chicago Sky,1.5,-110,1021900151,45,37,1,1,1,1,1,1,1,91,81,-10,82,-8,home,home,45,-8,172
8/16/2019,621,NYNew York Liberty,77,151.5,-110,NYL,New York Liberty,4,-110,1021900152,42,36,1,1,0,0,0,0,0,83,77,-6,78,-6,home,away,36,6,160
8/16/2019,622,DWDallas Wings,83,151.5,-110,DAL,Dallas Wings,-4,-110,1021900152,42,36,0,0,1,1,1,1,1,83,77,-6,78,-6,home,home,42,-6,160
8/16/2019,627,ADAtlanta Dream,68,149.5,-110,ATL,Atlanta Dream,3.5,-110,1021900154,35,39,1,1,1,1,1,0,0,77,68,-9,74,4,away,away,39,-4,145
8/16/2019,628,PPhoenix,77,149.5,-110,PHO,Phoenix Mercury,-3.5,-110,1021900154,35,39,0,0,0,0,0,1,1,77,68,-9,74,4,away,home,35,4,145
8/20/2019,639,NYNew York Liberty,82,159,-110,NYL,New York Liberty,5,-110,1021900161,37,43,1,1,1,1,1,1,1,76,82,6,80,6,away,away,43,-6,158
8/20/2019,640,IFIndiana Fever,76,159,-110,IND,Indiana Fever,-5,-110,1021900161,37,43,0,0,0,0,0,0,0,76,82,6,80,6,away,home,37,6,158
8/20/2019,641,CSChicago Sky,87,165,-110,CHI,Chicago Sky,-5.5,-110,1021900160,44,36,1,1,1,0,0,0,0,83,87,4,80,-8,home,away,36,8,170
8/20/2019,642,ADAtlanta Dream,83,165,-110,ATL,Atlanta Dream,5.5,-110,1021900160,44,36,0,0,0,1,1,1,1,83,87,4,80,-8,home,home,44,-8,170
8/20/2019,643,PPhoenix,79,159.5,-110,PHO,Phoenix Mercury,8.5,-110,1021900162,38,38,0,0,0,0,0,0,0,84,79,-5,76,0,tie,away,38,-0,163
8/20/2019,644,LVLas Vegas Aces,84,159.5,-110,LVA,Las Vegas Aces,-8.5,-110,1021900162,38,38,1,1,1,1,1,1,1,84,79,-5,76,0,tie,home,38,0,163
8/20/2019,645,MLMinnesota Lynx,71,156,-110,MIN,Minnesota Lynx,6,-110,1021900163,49,32,1,0,0,0,0,0,0,81,71,-10,81,-17,home,away,32,17,152
8/20/2019,646,LSL.A. Sparks,81,156,-110,LAS,Los Angeles Sparks,-6,-110,1021900163,49,32,0,1,1,1,1,1,1,81,71,-10,81,-17,home,home,49,-17,152
8/22/2019,647,DWDallas Wings,70,148.5,-110,DAL,Dallas Wings,7.5,-105,1021900164,47,32,0,0,0,0,0,0,0,86,70,-16,79,-15,home,away,32,15,156
8/22/2019,648,MLMinnesota Lynx,86,148.5,-110,MIN,Minnesota Lynx,-7.5,-115,1021900164,47,32,1,1,1,1,1,1,1,86,70,-16,79,-15,home,home,47,-15,156
8/22/2019,649,IFIndiana Fever,65,160,-110,IND,Indiana Fever,9.5,-110,1021900165,43,31,1,1,1,0,0,0,0,98,65,-33,74,-12,home,away,31,12,163
8/22/2019,650,LSL.A. Sparks,98,159.5,-112,LAS,Los Angeles Sparks,-9.5,-110,1021900165,43,31,0,0,0,1,1,1,1,98,65,-33,74,-12,home,home,43,-12,163
8/23/2019,601,ADAtlanta Dream,90,158,-110,ATL,Atlanta Dream,3,-110,1021900167,51,46,1,0,0,0,0,0,0,87,90,3,97,-5,home,away,46,5,177
8/23/2019,602,NYNew York Liberty,87,158,-110,NYL,New York Liberty,-3,-110,1021900167,51,46,0,1,1,1,1,1,1,87,90,3,97,-5,home,home,51,-5,177
8/23/2019,603,LVLas Vegas Aces,85,163.5,-110,LVA,Las Vegas Aces,1.5,-110,1021900166,47,56,0,0,0,0,0,0,1,89,85,-4,103,9,away,away,56,-9,174
8/23/2019,604,CSConnecticut Sun,89,163.5,-110,CON,Connecticut Sun,-1.5,-110,1021900166,47,56,1,1,1,1,1,1,0,89,85,-4,103,9,away,home,47,9,174
8/23/2019,605,WMWashington Mystics,78,175,-110,WAS,Washington Mystics,-6.5,-115,1021900168,42,49,1,0,0,0,0,1,1,85,78,-7,91,7,away,away,49,-7,163
8/23/2019,606,CSChicago Sky,85,175,-110,CHI,Chicago Sky,6.5,-105,1021900168,42,49,0,1,1,1,1,0,0,85,78,-7,91,7,away,home,42,7,163
8/25/2019,607,NYNew York Liberty,72,171,-115,NYL,New York Liberty,15.5,-105,1021900169,47,31,0,0,0,0,0,0,0,101,72,-29,78,-16,home,away,31,16,173
8/25/2019,608,WMWashington Mystics,101,171,-105,WAS,Washington Mystics,-15.5,-115,1021900169,47,31,1,1,1,1,1,1,1,101,72,-29,78,-16,home,home,47,-16,173
8/25/2019,609,ADAtlanta Dream,77,148.5,-110,ATL,Atlanta Dream,5,-108,1021900170,30,37,1,1,1,1,1,1,1,73,77,4,67,7,away,away,37,-7,150
8/25/2019,610,DWDallas Wings,73,148.5,-110,DAL,Dallas Wings,-5,-112,1021900170,30,37,0,0,0,0,0,0,0,73,77,4,67,7,away,home,30,7,150
8/25/2019,611,CSConnecticut Sun,72,157.5,-115,CON,Connecticut Sun,5,-110,1021900171,42,39,1,1,1,1,0,0,0,84,72,-12,81,-3,home,away,39,3,156
8/25/2019,612,LSL.A. Sparks,84,157.5,-105,LAS,Los Angeles Sparks,-5,-110,1021900171,42,39,0,0,0,0,1,1,1,84,72,-12,81,-3,home,home,42,-3,156
8/25/2019,613,CSChicago Sky,94,167,-110,CHI,Chicago Sky,4,-110,1021900172,54,46,1,1,0,0,0,0,0,86,94,8,100,-8,home,away,46,8,180
8/25/2019,614,PPhoenix,86,167,-110,PHO,Phoenix Mercury,-4,-110,1021900172,54,46,0,0,1,1,1,1,1,86,94,8,100,-8,home,home,54,-8,180
8/25/2019,617,LVLas Vegas Aces,77,159,-110,LVA,Las Vegas Aces,-3.5,-105,1021900173,45,43,0,0,0,0,0,0,1,98,77,-21,88,-2,home,away,43,2,175
8/25/2019,618,MLMinnesota Lynx,98,159,-110,MIN,Minnesota Lynx,3.5,-115,1021900173,45,43,1,1,1,1,1,1,0,98,77,-21,88,-2,home,home,45,-2,175
8/25/2019,615,IFIndiana Fever,63,152,-110,IND,Indiana Fever,10,-110,1021900174,26,33,0,1,1,1,1,1,1,54,63,9,59,7,away,away,33,-7,117
8/25/2019,616,SSSeattle Storm,54,152,-110,SEA,Seattle Storm,-10,-110,1021900174,26,33,1,0,0,0,0,0,0,54,63,9,59,7,away,home,26,7,117
8/27/2019,623,LSL.A. Sparks,66,166.5,-110,LAS,Los Angeles Sparks,7.5,-115,1021900177,54,37,0,0,0,0,0,0,0,95,66,-29,91,-17,home,away,37,17,161
8/27/2019,624,WMWashington Mystics,95,166.5,-110,WAS,Washington Mystics,-7.5,-110,1021900177,54,37,1,1,1,1,1,1,1,95,66,-29,91,-17,home,home,54,-17,161
8/27/2019,621,LVLas Vegas Aces,71,162.5,-110,LVA,Las Vegas Aces,-7,-110,1021900175,53,33,0,0,0,0,0,0,0,86,71,-15,86,-20,home,away,33,20,157
8/27/2019,622,IFIndiana Fever,86,162.5,-110,IND,Indiana Fever,7,-110,1021900175,53,33,1,1,1,1,1,1,1,86,71,-15,86,-20,home,home,53,-20,157
8/27/2019,619,PPhoenix,95,160.5,-110,PHO,Phoenix Mercury,-6,-115,1021900176,46,49,1,1,1,1,1,1,1,82,95,13,95,3,away,away,49,-3,177
8/27/2019,620,NYNew York Liberty,82,160.5,-110,NYL,New York Liberty,6,-105,1021900176,46,49,0,0,0,0,0,0,0,82,95,13,95,3,away,home,46,3,177
8/27/2019,625,CSChicago Sky,85,168.5,-110,CHI,Chicago Sky,3.5,-110,1021900178,51,42,0,0,0,1,0,0,0,93,85,-8,93,-9,home,away,42,9,178
8/27/2019,626,MLMinnesota Lynx,93,168.5,-110,MIN,Minnesota Lynx,-3.5,-110,1021900178,51,42,1,1,1,0,1,1,1,93,85,-8,93,-9,home,home,51,-9,178
8/27/2019,627,CSConnecticut Sun,89,150,-110,CON,Connecticut Sun,2,-110,1021900179,36,44,0,1,1,1,1,1,1,70,89,19,80,8,away,away,44,-8,159
8/27/2019,628,SSSeattle Storm,70,150,-110,SEA,Seattle Storm,-2,-110,1021900179,36,44,1,0,0,0,0,0,0,70,89,19,80,8,away,home,36,8,159
8/29/2019,633,PPhoenix,65,157,-110,PHO,Phoenix Mercury,-6,-110,1021900182,25,29,1,1,1,1,1,1,1,58,65,7,54,4,away,away,29,-4,123
8/29/2019,634,ADAtlanta Dream,58,157,-110,ATL,Atlanta Dream,6,-110,1021900182,25,29,0,0,0,0,0,0,0,58,65,7,54,4,away,home,25,4,123
8/29/2019,629,LSL.A. Sparks,87,158.5,-110,LAS,Los Angeles Sparks,-5.5,-110,1021900180,42,33,0,0,0,0,0,0,0,83,87,4,75,-9,home,away,33,9,170
8/29/2019,630,IFIndiana Fever,83,158.5,-110,IND,Indiana Fever,5.5,-110,1021900180,42,33,1,1,1,1,1,1,1,83,87,4,75,-9,home,home,42,-9,170
8/29/2019,631,DWDallas Wings,88,159,-110,DAL,Dallas Wings,11.5,-110,1021900181,35,38,0,1,1,1,1,1,1,83,88,5,73,3,away,away,38,-3,171
8/29/2019,632,CSChicago Sky,83,159,-110,CHI,Chicago Sky,-11.5,-110,1021900181,35,38,1,0,0,0,0,0,0,83,88,5,73,3,away,home,35,3,171
8/30/2019,635,CSConnecticut Sun,94,163,-110,CON,Connecticut Sun,-10.5,-110,1021900183,41,50,0,1,1,1,1,1,1,84,94,10,91,9,away,away,50,-9,178
8/30/2019,636,NYNew York Liberty,84,163,-110,NYL,New York Liberty,10.5,-110,1021900183,41,50,1,0,0,0,0,0,0,84,94,10,91,9,away,home,41,9,178
8/31/2019,637,WMWashington Mystics,91,159,-110,WAS,Washington Mystics,-11.5,-110,1021900184,43,56,1,1,1,1,1,1,1,85,91,6,99,13,away,away,56,-13,176
8/31/2019,638,DWDallas Wings,85,159,-110,DAL,Dallas Wings,11.5,-110,1021900184,43,56,0,0,0,0,0,0,0,85,91,6,99,13,away,home,43,13,176
8/31/2019,639,LSL.A. Sparks,86,164.5,-110,LAS,Los Angeles Sparks,3.5,-110,1021900185,36,44,1,1,1,1,1,1,1,92,86,-6,80,8,away,away,44,-8,178
8/31/2019,640,LVLas Vegas Aces,92,164.5,-110,LVA,Las Vegas Aces,-3.5,-110,1021900185,36,44,0,0,0,0,0,0,0,92,86,-6,80,8,away,home,36,8,178
9/1/2019,641,PPhoenix,78,169,-110,PHO,Phoenix Mercury,4,-115,1021900186,54,53,0,0,0,0,0,0,0,105,78,-27,107,-1,home,away,53,1,183
9/1/2019,642,CSChicago Sky,105,169,-110,CHI,Chicago Sky,-4,-110,1021900186,54,53,1,1,1,1,1,1,1,105,78,-27,107,-1,home,home,54,-1,183
9/1/2019,643,ADAtlanta Dream,75,148.5,-110,ATL,Atlanta Dream,8.5,-105,1021900188,53,36,0,0,0,0,0,0,0,92,75,-17,89,-17,home,away,36,17,167
9/1/2019,644,SSSeattle Storm,92,148.5,-110,SEA,Seattle Storm,-8.5,-115,1021900188,53,36,1,1,1,1,1,1,1,92,75,-17,89,-17,home,home,53,-17,167
9/1/2019,645,IFIndiana Fever,73,158,-110,IND,Indiana Fever,9.5,-110,1021900187,38,41,0,0,1,1,1,1,1,81,73,-8,79,3,away,away,41,-3,154
9/1/2019,646,MLMinnesota Lynx,81,158,-110,MIN,Minnesota Lynx,-9.5,-110,1021900187,38,41,1,1,0,0,0,0,0,81,73,-8,79,3,away,home,38,3,154
9/3/2019,647,WMWashington Mystics,93,172.5,-110,WAS,Washington Mystics,-14.5,-110,1021900189,40,58,1,1,1,1,1,1,1,77,93,16,98,18,away,away,58,-18,170
9/3/2019,648,NYNew York Liberty,77,172.5,-110,NYL,New York Liberty,14.5,-115,1021900189,40,58,0,0,0,0,0,0,0,77,93,16,98,18,away,home,40,18,170
9/3/2019,649,SSSeattle Storm,82,154,-110,SEA,Seattle Storm,5.5,-110,1021900190,35,50,1,1,1,1,1,1,1,70,82,12,85,15,away,away,50,-15,152
9/3/2019,650,PPhoenix,70,154.5,-110,PHO,Phoenix Mercury,-5.5,-110,1021900190,35,50,0,0,0,0,0,0,0,70,82,12,85,15,away,home,35,15,152
9/3/2019,651,ADAtlanta Dream,60,158.5,-110,ATL,Atlanta Dream,10.5,-110,1021900191,34,35,1,1,1,1,0,1,0,70,60,-10,69,1,away,away,35,-1,130
9/3/2019,652,LSL.A. Sparks,70,158.5,-110,LAS,Los Angeles Sparks,-10.5,-110,1021900191,34,35,0,0,0,0,1,0,1,70,60,-10,69,1,away,home,34,1,130
9/4/2019,601,DWDallas Wings,72,156,-110,DAL,Dallas Wings,11,-110,1021900192,49,26,0,0,0,0,0,0,0,102,72,-30,75,-23,home,away,26,23,174
9/4/2019,602,CSConnecticut Sun,102,156,-110,CON,Connecticut Sun,-11,-110,1021900192,49,26,1,1,1,1,1,1,1,102,72,-30,75,-23,home,home,49,-23,174
9/5/2019,603,LVLas Vegas Aces,74,162.5,-115,LVA,Las Vegas Aces,-11.5,-110,1021900193,37,42,1,1,1,1,1,1,1,78,74,-4,79,5,away,away,42,-5,152
9/5/2019,604,ADAtlanta Dream,78,162.5,-105,ATL,Atlanta Dream,11.5,-110,1021900193,37,42,0,0,0,0,0,0,0,78,74,-4,79,5,away,home,37,5,152
9/5/2019,605,SSSeattle Storm,68,155,-110,SEA,Seattle Storm,6.5,-110,1021900194,50,35,1,1,0,0,0,0,0,102,68,-34,85,-15,home,away,35,15,170
9/5/2019,606,LSL.A. Sparks,102,155,-110,LAS,Los Angeles Sparks,-6.5,-110,1021900194,50,35,0,0,1,1,1,1,1,102,68,-34,85,-15,home,home,50,-15,170
9/6/2019,609,IFIndiana Fever,86,163.5,-110,IND,Indiana Fever,-2,-105,1021900197,49,43,0,0,0,0,0,0,0,81,86,5,92,-6,home,away,43,6,167
9/6/2019,610,NYNew York Liberty,81,163.5,-110,NYL,New York Liberty,2,-115,1021900197,49,43,1,1,1,1,1,1,1,81,86,5,92,-6,home,home,49,-6,167
9/6/2019,607,DWDallas Wings,73,166,-110,DAL,Dallas Wings,17.5,-117,1021900195,51,33,0,0,0,0,0,0,0,86,73,-13,84,-18,home,away,33,18,159
9/6/2019,608,WMWashington Mystics,86,166,-113,WAS,Washington Mystics,-17.5,-103,1021900195,51,33,1,1,1,1,1,1,1,86,73,-13,84,-18,home,home,51,-18,159
9/6/2019,611,CSChicago Sky,109,174.5,-110,CHI,Chicago Sky,6,-104,1021900196,52,52,1,1,1,0,0,0,0,104,109,5,104,0,tie,away,52,-0,213
9/6/2019,612,CSConnecticut Sun,104,174.5,-110,CON,Connecticut Sun,-6,-110,1021900196,52,52,0,0,0,1,1,1,1,104,109,5,104,0,tie,home,52,0,213
9/6/2019,613,MLMinnesota Lynx,83,157.5,-110,MIN,Minnesota Lynx,2.5,-115,1021900198,44,40,1,0,0,0,0,0,0,69,83,14,84,-4,home,away,40,4,152
9/6/2019,614,PPhoenix,69,157.5,-110,PHO,Phoenix Mercury,-2.5,-110,1021900198,44,40,0,1,1,1,1,1,1,69,83,14,84,-4,home,home,44,-4,152
9/8/2019,615,CSConnecticut Sun,76,160,-112,CON,Connecticut Sun,-3.5,-110,1021900200,48,39,0,0,0,0,0,0,0,104,76,-28,87,-9,home,away,39,9,180
9/8/2019,616,IFIndiana Fever,104,160,-110,IND,Indiana Fever,3.5,-110,1021900200,48,39,1,1,1,1,1,1,1,104,76,-28,87,-9,home,home,48,-9,180
9/8/2019,623,CSChicago Sky,86,179,-110,CHI,Chicago Sky,7,-110,1021900201,56,39,0,0,0,0,0,0,0,100,86,-14,95,-17,home,away,39,17,186
9/8/2019,624,WMWashington Mystics,100,179,-110,WAS,Washington Mystics,-7,-105,1021900201,56,39,1,1,1,1,1,1,1,100,86,-14,95,-17,home,home,56,-17,186
9/8/2019,619,NYNew York Liberty,71,160.5,-110,NYL,New York Liberty,2.5,-110,1021900199,38,44,1,1,1,1,1,1,1,63,71,8,82,6,away,away,44,-6,134
9/8/2019,620,ADAtlanta Dream,63,160.5,-110,ATL,Atlanta Dream,-2.5,-110,1021900199,38,44,0,0,0,0,0,0,0,63,71,8,82,6,away,home,38,6,134
9/8/2019,625,MLMinnesota Lynx,68,158,-110,MIN,Minnesota Lynx,4,-115,1021900204,36,34,1,1,1,1,1,0,0,77,68,-9,70,-2,home,away,34,2,145
9/8/2019,626,LSL.A. Sparks,77,158,-110,LAS,Los Angeles Sparks,-4,-105,1021900204,36,34,0,0,0,0,0,1,1,77,68,-9,70,-2,home,home,36,-2,145
9/8/2019,617,SSSeattle Storm,78,151,-110,SEA,Seattle Storm,-4.5,-115,1021900202,26,44,0,1,1,1,1,1,1,64,78,14,70,18,away,away,44,-18,142
9/8/2019,618,DWDallas Wings,64,151,-110,DAL,Dallas Wings,4.5,-105,1021900202,26,44,1,0,0,0,0,0,0,64,78,14,70,18,away,home,26,18,142
9/8/2019,621,LVLas Vegas Aces,98,162,-110,LVA,Las Vegas Aces,-3.5,-110,1021900203,48,52,0,0,1,1,1,1,1,89,98,9,100,4,away,away,52,-4,187
9/8/2019,622,PPhoenix,89,162,-110,PHO,Phoenix Mercury,3.5,-110,1021900203,48,52,1,1,0,0,0,0,0,89,98,9,100,4,away,home,48,4,187
9/11/2019,601,PPhoenix,76,171.5,-110,PHO,Phoenix Mercury,7,-110,1041900101,44,41,0,0,0,0,0,0,0,105,76,-29,85,-3,home,away,41,3,181
9/11/2019,602,CSChicago Sky,105,171.5,-110,CHI,Chicago Sky,-7,-110,1041900101,44,41,1,1,1,1,1,1,1,105,76,-29,85,-3,home,home,44,-3,181
9/11/2019,603,MLMinnesota Lynx,74,149.5,-110,MIN,Minnesota Lynx,2.5,-115,1041900111,47,41,0,0,0,0,0,0,0,84,74,-10,88,-6,home,away,41,6,158
9/11/2019,604,SSSeattle Storm,84,149.5,-110,SEA,Seattle Storm,-2.5,-105,1041900111,47,41,1,1,1,1,1,1,1,84,74,-10,88,-6,home,home,47,-6,158
9/15/2019,605,SSSeattle Storm,69,155,-110,SEA,Seattle Storm,7,-110,1041900201,43,36,0,1,0,0,0,0,0,92,69,-23,79,-7,home,away,36,7,161
9/15/2019,606,LSL.A. Sparks,92,155,-110,LAS,Los Angeles Sparks,-7,-110,1041900201,43,36,1,0,1,1,1,1,1,92,69,-23,79,-7,home,home,43,-7,161
9/15/2019,607,CSChicago Sky,92,176,-115,CHI,Chicago Sky,4,-110,1041900211,45,51,1,1,1,1,1,1,0,93,92,-1,96,6,away,away,51,-6,185
9/15/2019,608,LVLas Vegas Aces,93,176,-106,LVA,Las Vegas Aces,-4,-115,1041900211,45,51,0,0,0,0,0,0,1,93,92,-1,96,6,away,home,45,6,185
9/17/2019,611,LSL.A. Sparks,75,162.5,-110,LAS,Los Angeles Sparks,1.5,-115,1041900311,37,40,1,0,0,0,0,0,1,84,75,-9,77,3,away,away,40,-3,159
9/17/2019,612,CSConnecticut Sun,84,162.5,-110,CON,Connecticut Sun,-1.5,-105,1041900311,37,40,0,1,1,1,1,1,0,84,75,-9,77,3,away,home,37,3,159
9/17/2019,613,LVLas Vegas Aces,95,174,-110,LVA,Las Vegas Aces,10,-105,1041900301,50,57,1,0,0,0,0,0,0,97,95,-2,107,7,away,away,57,-7,192
9/17/2019,614,WMWashington Mystics,97,174,-110,WAS,Washington Mystics,-10,-115,1041900301,50,57,0,1,1,1,1,1,1,97,95,-2,107,7,away,home,50,7,192
9/19/2019,615,LSL.A. Sparks,68,163,-110,LAS,Los Angeles Sparks,1.5,-110,1041900312,41,40,1,1,1,1,1,1,1,94,68,-26,81,-1,home,away,40,1,162
9/19/2019,616,CSConnecticut Sun,94,163,-110,CON,Connecticut Sun,-1.5,-110,1041900312,41,40,0,0,0,0,0,0,0,94,68,-26,81,-1,home,home,41,-1,162
9/19/2019,617,LVLas Vegas Aces,91,179,-110,LVA,Las Vegas Aces,10,-115,1041900302,50,49,1,0,0,0,0,0,0,103,91,-12,99,-1,home,away,49,1,194
9/19/2019,618,WMWashington Mystics,103,178.5,-115,WAS,Washington Mystics,-10,-105,1041900302,50,49,0,1,1,1,1,1,1,103,91,-12,99,-1,home,home,50,-1,194
9/22/2019,621,WMWashington Mystics,75,181.5,-110,WAS,Washington Mystics,-4,-110,1041900303,47,37,0,0,1,0,1,0,0,92,75,-17,84,-10,home,away,37,10,167
9/22/2019,622,LVLas Vegas Aces,92,181.5,-110,LVA,Las Vegas Aces,4,-110,1041900303,47,37,1,1,0,1,0,1,1,92,75,-17,84,-10,home,home,47,-10,167
9/22/2019,619,CSConnecticut Sun,78,162,-110,CON,Connecticut Sun,5.5,-105,1041900313,32,40,1,0,1,1,1,1,1,56,78,22,72,8,away,away,40,-8,134
9/22/2019,620,LSL.A. Sparks,56,162,-110,LAS,Los Angeles Sparks,-5.5,-115,1041900313,32,40,0,1,0,0,0,0,0,56,78,22,72,8,away,home,32,8,134
9/24/2019,625,WMWashington Mystics,94,180.5,-110,WAS,Washington Mystics,-4.5,-110,1041900304,43,45,1,0,0,0,0,0,0,90,94,4,88,2,away,away,45,-2,184
9/24/2019,626,LVLas Vegas Aces,90,180.5,-110,LVA,Las Vegas Aces,4.5,-110,1041900304,43,45,0,1,1,1,1,1,1,90,94,4,88,2,away,home,43,2,184
9/29/2019,601,CSConnecticut Sun,86,167,-110,CON,Connecticut Sun,8.5,-113,1041900401,55,46,0,0,0,0,0,0,0,95,86,-9,101,-9,home,away,46,9,181
9/29/2019,602,WMWashington Mystics,95,167,-110,WAS,Washington Mystics,-8.5,-110,1041900401,55,46,1,1,1,1,1,1,1,95,86,-9,101,-9,home,home,55,-9,181
10/1/2019,603,CSConnecticut Sun,99,172.5,-120,CON,Connecticut Sun,7.5,104,1041900402,46,56,1,1,1,1,1,1,1,87,99,12,102,10,away,away,56,-10,186
10/1/2019,604,WMWashington Mystics,87,172.5,100,WAS,Washington Mystics,-7.5,-124,1041900402,46,56,0,0,0,0,0,0,0,87,99,12,102,10,away,home,46,10,186
10/6/2019,605,WMWashington Mystics,94,172.5,-110,WAS,Washington Mystics,2.5,-111,1041900403,39,43,1,1,1,1,1,1,1,81,94,13,82,4,away,away,43,-4,175
10/6/2019,606,CSConnecticut Sun,81,172.5,-110,CON,Connecticut Sun,-2.5,-109,1041900403,39,43,0,0,0,0,0,0,0,81,94,13,82,4,away,home,39,4,175
10/8/2019,607,WMWashington Mystics,86,175,-125,WAS,Washington Mystics,1.5,-110,1041900404,56,40,0,0,0,0,0,0,0,90,86,-4,96,-16,home,away,40,16,176
10/8/2019,608,CSConnecticut Sun,90,175,105,CON,Connecticut Sun,-1.5,-110,1041900404,56,40,1,1,1,1,1,1,1,90,86,-4,96,-16,home,home,56,-16,176
10/10/2019,609,CSConnecticut Sun,78,174,-110,CON,Connecticut Sun,6.5,-110,1041900405,42,43,1,0,0,0,0,0,1,89,78,-11,85,1,away,away,43,-1,167
10/10/2019,610,WMWashington Mystics,89,174,-110,WAS,Washington Mystics,-6.5,-110,1041900405,42,43,0,1,1,1,1,1,0,89,78,-11,85,1,away,home,42,1,167
5/24/2019,601,DWDallas Wings,72,156,-110,DAL,Dallas Wings,10.5,-105,1021900001,34,39,0,0,0,1,1,1,1,76,72,-4,73,5,away,away,39,-5,148
5/24/2019,602,ADAtlanta Dream,76,156,-110,ATL,Atlanta Dream,-10.5,-115,1021900001,34,39,1,1,1,0,0,0,0,76,72,-4,73,5,away,home,34,5,148
5/24/2019,603,IFIndiana Fever,81,158.5,-110,IND,Indiana Fever,3.5,-110,1021900002,33,39,0,0,0,0,1,1,1,80,81,1,72,6,away,away,39,-6,161
5/24/2019,604,NYNew York Liberty,80,158.5,-110,NYL,New York Liberty,-3.5,-110,1021900002,33,39,1,1,1,1,0,0,0,80,81,1,72,6,away,home,33,6,161
5/26/2019,611,LSL.A. Sparks,70,162,-110,LAS,Los Angeles Sparks,2.5,-110,1021900006,45,31,1,1,0,0,0,0,0,83,70,-13,76,-14,home,away,31,14,153
5/26/2019,612,LVLas Vegas Aces,83,162,-110,LVA,Las Vegas Aces,-2.5,-110,1021900006,45,31,0,0,1,1,1,1,1,83,70,-13,76,-14,home,home,45,-14,153
5/28/2019,613,IFIndiana Fever,77,163.5,-115,IND,Indiana Fever,9.5,-110,1021900007,40,37,0,0,0,0,0,0,0,88,77,-11,77,-3,home,away,37,3,165
5/28/2019,614,CSConnecticut Sun,88,162.5,-105,CON,Connecticut Sun,-9.5,-110,1021900007,40,37,1,1,1,1,1,1,1,88,77,-11,77,-3,home,home,40,-3,165
5/29/2019,615,SSSeattle Storm,61,152.5,-110,SEA,Seattle Storm,4.5,-110,1021900008,39,24,0,0,0,0,0,0,0,72,61,-11,63,-15,home,away,24,15,133
5/29/2019,616,MLMinnesota Lynx,72,151.5,-110,MIN,Minnesota Lynx,-4.5,-110,1021900008,39,24,1,1,1,1,1,1,1,72,61,-11,63,-15,home,home,39,-15,133
5/31/2019,617,SSSeattle Storm,82,148.5,-110,SEA,Seattle Storm,6.5,-110,1021900009,27,45,1,1,1,1,1,1,1,66,82,16,72,18,away,away,45,-18,148
5/31/2019,618,ADAtlanta Dream,66,148.5,-110,ATL,Atlanta Dream,-6.5,-110,1021900009,27,45,0,0,0,0,0,0,0,66,82,16,72,18,away,home,27,18,148
5/31/2019,619,LVLas Vegas Aces,84,165,-110,LVA,Las Vegas Aces,-2.5,-110,1021900010,42,43,0,0,0,1,1,1,1,86,84,-2,85,1,away,away,43,-1,170
5/31/2019,620,PPhoenix,86,165,-110,PHO,Phoenix Mercury,2.5,-110,1021900010,42,43,1,1,1,0,0,0,0,86,84,-2,85,1,away,home,42,1,170
5/31/2019,621,CSConnecticut Sun,70,164,-110,CON,Connecticut Sun,-2.5,-115,1021900011,38,31,0,0,0,0,0,0,0,77,70,-7,69,-7,home,away,31,7,147
5/31/2019,622,LSL.A. Sparks,77,164.5,-110,LAS,Los Angeles Sparks,2.5,-105,1021900011,38,31,1,1,1,1,1,1,1,77,70,-7,69,-7,home,home,38,-7,147
6/1/2019,623,NYNew York Liberty,77,158.5,-110,NYL,New York Liberty,3,-110,1021900012,45,29,0,0,0,0,0,0,0,92,77,-15,74,-16,home,away,29,16,169
6/1/2019,624,IFIndiana Fever,92,158.5,-110,IND,Indiana Fever,-3,-110,1021900012,45,29,1,1,1,1,1,1,1,92,77,-15,74,-16,home,home,45,-16,169
6/1/2019,625,ADAtlanta Dream,75,158.5,-110,ATL,Atlanta Dream,8.5,-110,1021900013,52,35,0,0,0,0,0,0,0,96,75,-21,87,-17,home,away,35,17,171
6/1/2019,626,WMWashington Mystics,96,158.5,-110,WAS,Washington Mystics,-8.5,-110,1021900013,52,35,1,1,1,1,1,1,1,96,75,-21,87,-17,home,home,52,-17,171
6/1/2019,629,MLMinnesota Lynx,70,153.5,-110,MIN,Minnesota Lynx,-3.5,-110,1021900015,27,41,0,1,1,1,1,1,1,67,70,3,68,14,away,away,41,-14,137
6/1/2019,630,DWDallas Wings,67,153.5,-110,DAL,Dallas Wings,3.5,-110,1021900015,27,41,1,0,0,0,0,0,0,67,70,3,68,14,away,home,27,14,137
6/1/2019,627,SSSeattle Storm,79,162,-112,SEA,Seattle Storm,2.5,-110,1021900014,48,46,1,0,0,0,0,0,0,83,79,-4,94,-2,home,away,46,2,162
6/1/2019,628,CSChicago Sky,83,162,-110,CHI,Chicago Sky,-2.5,-110,1021900014,48,46,0,1,1,1,1,1,1,83,79,-4,94,-2,home,home,48,-2,162
6/2/2019,631,CSConnecticut Sun,80,168,-110,CON,Connecticut Sun,5,-115,1021900016,43,40,1,1,0,0,0,0,0,74,80,6,83,-3,home,away,40,3,154
6/2/2019,632,LVLas Vegas Aces,74,168,-105,LVA,Las Vegas Aces,-4.5,-113,1021900016,43,40,0,0,1,1,1,1,1,74,80,6,83,-3,home,home,43,-3,154
6/4/2019,633,LSL.A. Sparks,78,157.5,-110,LAS,Los Angeles Sparks,-5,-110,1021900017,34,36,1,0,0,1,1,1,1,73,78,5,70,2,away,away,36,-2,151
6/4/2019,634,NYNew York Liberty,73,157.5,-110,NYL,New York Liberty,5,-115,1021900017,34,36,0,1,1,0,0,0,0,73,78,5,70,2,away,home,34,2,151
6/4/2019,635,MLMinnesota Lynx,77,148.5,-110,MIN,Minnesota Lynx,1.5,-110,1021900018,49,39,0,0,0,0,0,0,0,84,77,-7,88,-10,home,away,39,10,161
6/4/2019,636,SSSeattle Storm,84,148.5,-110,SEA,Seattle Storm,-1.5,-110,1021900018,49,39,1,1,1,1,1,1,1,84,77,-7,88,-10,home,home,49,-10,161
6/5/2019,637,CSChicago Sky,85,169,-110,CHI,Chicago Sky,12,-110,1021900019,57,42,0,0,0,0,0,0,0,103,85,-18,99,-15,home,away,42,15,188
6/5/2019,638,WMWashington Mystics,103,169.5,-105,WAS,Washington Mystics,-12,-110,1021900019,57,42,1,1,1,1,1,1,1,103,85,-18,99,-15,home,home,57,-15,188
6/6/2019,641,LSL.A. Sparks,77,158,-110,LAS,Los Angeles Sparks,7.5,-110,1021900021,43,32,0,0,0,0,0,0,0,89,77,-12,75,-11,home,away,32,11,166
6/6/2019,642,CSConnecticut Sun,89,158,-115,CON,Connecticut Sun,-7.5,-110,1021900021,43,32,1,1,1,1,1,1,1,89,77,-12,75,-11,home,home,43,-11,166
6/6/2019,639,LVLas Vegas Aces,92,161.5,-115,LVA,Las Vegas Aces,-4.5,-115,1021900020,25,49,1,1,1,1,1,1,1,69,92,23,74,24,away,away,49,-24,161
6/6/2019,640,ADAtlanta Dream,69,161.5,-105,ATL,Atlanta Dream,4.5,-105,1021900020,25,49,0,0,0,0,0,0,0,69,92,23,74,24,away,home,25,24,161
6/6/2019,643,PPhoenix,56,154,-115,PHO,Phoenix Mercury,2,-115,1021900022,32,24,1,1,0,0,0,0,0,58,56,-2,56,-8,home,away,24,8,114
6/6/2019,644,MLMinnesota Lynx,58,153.5,-110,MIN,Minnesota Lynx,-2,-105,1021900022,32,24,0,0,1,1,1,1,1,58,56,-2,56,-8,home,home,32,-8,114
6/7/2019,645,DWDallas Wings,64,154,-110,DAL,Dallas Wings,5,-105,1021900023,38,26,0,0,0,0,0,0,0,79,64,-15,64,-12,home,away,26,12,143
6/7/2019,646,IFIndiana Fever,79,154,-110,IND,Indiana Fever,-5,-115,1021900023,38,26,1,1,1,1,1,1,1,79,64,-15,64,-12,home,home,38,-12,143
6/7/2019,647,WMWashington Mystics,94,165.5,-110,WAS,Washington Mystics,-9.5,-110,1021900024,49,50,0,0,0,0,0,0,0,85,94,9,99,1,away,away,50,-1,179
6/7/2019,648,NYNew York Liberty,85,165.5,-110,NYL,New York Liberty,9.5,-110,1021900024,49,50,1,1,1,1,1,1,1,85,94,9,99,1,away,home,49,1,179
6/8/2019,649,LSL.A. Sparks,89,149,-110,LAS,Los Angeles Sparks,4.5,-110,1021900025,39,44,1,1,1,1,1,1,1,85,89,4,83,5,away,away,44,-5,174
6/8/2019,650,MLMinnesota Lynx,85,149,-110,MIN,Minnesota Lynx,-4.5,-110,1021900025,39,44,0,0,0,0,0,0,0,85,89,4,83,5,away,home,39,5,174
6/9/2019,605,LVLas Vegas Aces,78,169,-110,LVA,Las Vegas Aces,-11,-115,1021900027,45,37,1,1,1,0,0,0,0,88,78,-10,82,-8,home,away,37,8,166
6/9/2019,606,NYNew York Liberty,88,169,-110,NYL,New York Liberty,11,-110,1021900027,45,37,0,0,0,1,1,1,1,88,78,-10,82,-8,home,home,45,-8,166
6/9/2019,603,CSConnecticut Sun,65,160,-110,CON,Connecticut Sun,-6.5,-110,1021900026,32,44,1,1,1,1,1,1,1,59,65,6,76,12,away,away,44,-12,124
6/9/2019,604,ADAtlanta Dream,59,160,-110,ATL,Atlanta Dream,6.5,-110,1021900026,32,44,0,0,0,0,0,0,0,59,65,6,76,12,away,home,32,12,124
6/9/2019,601,DWDallas Wings,62,158,-110,DAL,Dallas Wings,14,-110,1021900028,40,34,1,1,1,0,0,0,0,86,62,-24,74,-6,home,away,34,6,148
6/9/2019,602,WMWashington Mystics,86,158,-110,WAS,Washington Mystics,-14,-110,1021900028,40,34,0,0,0,1,1,1,1,86,62,-24,74,-6,home,home,40,-6,148
6/9/2019,607,PPhoenix,94,152.5,-110,PHO,Phoenix Mercury,-2.5,-119,1021900029,28,53,1,1,1,1,1,1,1,87,94,7,81,25,away,away,53,-25,181
6/9/2019,608,IFIndiana Fever,87,152.5,-110,IND,Indiana Fever,2.5,-101,1021900029,28,53,0,0,0,0,0,0,0,87,94,7,81,25,away,home,28,25,181
6/9/2019,609,SSSeattle Storm,71,164.5,-110,SEA,Seattle Storm,-2,-110,1021900030,44,34,0,0,0,0,0,0,0,78,71,-7,78,-10,home,away,34,10,149
6/9/2019,610,CSChicago Sky,78,164.5,-110,CHI,Chicago Sky,2,-110,1021900030,44,34,1,1,1,1,1,1,1,78,71,-7,78,-10,home,home,44,-10,149
6/11/2019,611,SSSeattle Storm,84,156.5,-115,SEA,Seattle Storm,1.5,-110,1021900032,39,46,1,1,1,1,1,1,1,82,84,2,85,7,away,away,46,-7,166
6/11/2019,612,IFIndiana Fever,82,156.5,-110,IND,Indiana Fever,-1.5,-110,1021900032,39,46,0,0,0,0,0,0,0,82,84,2,85,7,away,home,39,7,166
6/11/2019,613,WMWashington Mystics,75,166.5,-110,WAS,Washington Mystics,3,-115,1021900031,33,37,1,1,1,1,1,1,1,83,75,-8,70,4,away,away,37,-4,158
6/11/2019,614,CSConnecticut Sun,83,166.5,-110,CON,Connecticut Sun,-2.5,-115,1021900031,33,37,0,0,0,0,0,0,0,83,75,-8,70,4,away,home,33,4,158
6/11/2019,615,PPhoenix,75,165.5,-110,PHO,Phoenix Mercury,-3.5,-115,1021900033,43,41,0,0,1,1,1,1,0,82,75,-7,84,-2,home,away,41,2,157
6/11/2019,616,CSChicago Sky,82,165.5,-110,CHI,Chicago Sky,4,-113,1021900033,43,41,1,1,0,0,0,0,1,82,75,-7,84,-2,home,home,43,-2,157
6/12/2019,617,MLMinnesota Lynx,69,156,-110,MIN,Minnesota Lynx,-3,-110,1021900034,38,28,0,0,0,0,0,0,0,75,69,-6,66,-10,home,away,28,10,144
6/12/2019,618,NYNew York Liberty,75,156,-110,NYL,New York Liberty,3,-110,1021900034,38,28,1,1,1,1,1,1,1,75,69,-6,66,-10,home,home,38,-10,144
6/13/2019,619,IFIndiana Fever,76,150.5,-110,IND,Indiana Fever,-3,-102,1021900035,31,34,0,0,1,1,1,1,1,72,76,4,65,3,away,away,34,-3,148
6/13/2019,620,DWDallas Wings,72,150.5,-110,DAL,Dallas Wings,3,-118,1021900035,31,34,1,1,0,0,0,0,0,72,76,4,65,3,away,home,31,3,148
6/14/2019,621,SSSeattle Storm,74,159,-110,SEA,Seattle Storm,9.5,-110,1021900036,46,38,1,1,0,0,1,0,0,71,74,3,84,-8,home,away,38,8,145
6/14/2019,622,WMWashington Mystics,71,159,-110,WAS,Washington Mystics,-9.5,-110,1021900036,46,38,0,0,1,1,0,1,1,71,74,3,84,-8,home,home,46,-8,145
6/14/2019,623,CSConnecticut Sun,85,151,-110,CON,Connecticut Sun,-6,-110,1021900037,43,44,1,1,0,1,1,1,1,81,85,4,87,1,away,away,44,-1,166
6/14/2019,624,MLMinnesota Lynx,81,151,-102,MIN,Minnesota Lynx,6,-110,1021900037,43,44,0,0,1,0,0,0,0,81,85,4,87,1,away,home,43,1,166
6/14/2019,625,LSL.A. Sparks,85,154,-105,LAS,Los Angeles Sparks,3.5,-110,1021900038,36,38,1,1,1,0,1,1,1,68,85,17,74,2,away,away,38,-2,153
6/14/2019,626,PPhoenix,68,154,-115,PHO,Phoenix Mercury,-3.5,-110,1021900038,36,38,0,0,0,1,0,0,0,68,85,17,74,2,away,home,36,2,153
6/14/2019,627,NYNew York Liberty,65,165,-115,NYL,New York Liberty,13,-110,1021900039,66,31,0,0,0,0,0,0,0,100,65,-35,97,-35,home,away,31,35,165
6/14/2019,628,LVLas Vegas Aces,100,165.5,-110,LVA,Las Vegas Aces,-13,-110,1021900039,66,31,1,1,1,1,1,1,1,100,65,-35,97,-35,home,home,66,-35,165
6/15/2019,629,CSChicago Sky,70,165.5,-110,CHI,Chicago Sky,3.5,-110,1021900040,29,30,0,0,0,1,1,0,1,64,70,6,59,1,away,away,30,-1,134
6/15/2019,630,IFIndiana Fever,64,165.5,-105,IND,Indiana Fever,-3.5,-110,1021900040,29,30,1,1,1,0,0,1,0,64,70,6,59,1,away,home,29,1,134
6/15/2019,631,ADAtlanta Dream,61,146,-110,ATL,Atlanta Dream,-3.5,-115,1021900041,28,32,1,1,1,1,1,1,1,71,61,-10,60,4,away,away,32,-4,132
6/15/2019,632,DWDallas Wings,71,146,-110,DAL,Dallas Wings,3.5,-105,1021900041,28,32,0,0,0,0,0,0,0,71,61,-10,60,4,away,home,28,4,132
6/15/2019,633,NYNew York Liberty,98,156.5,-110,NYL,New York Liberty,11,-110,1021900042,50,48,0,0,0,0,0,0,0,92,98,6,98,-2,home,away,48,2,190
6/15/2019,634,LSL.A. Sparks,92,156.5,-110,LAS,Los Angeles Sparks,-11,-110,1021900042,50,48,1,1,1,1,1,1,1,92,98,6,98,-2,home,home,50,-2,190
6/16/2019,635,SSSeattle Storm,67,155,-110,SEA,Seattle Storm,9,-110,1021900043,44,33,0,0,0,0,0,0,0,81,67,-14,77,-11,home,away,33,11,148
6/16/2019,636,CSConnecticut Sun,81,155,-110,CON,Connecticut Sun,-9,-110,1021900043,44,33,1,1,1,1,1,1,1,81,67,-14,77,-11,home,home,44,-11,148
6/16/2019,637,LVLas Vegas Aces,80,160.5,-110,LVA,Las Vegas Aces,-6,-110,1021900044,39,35,0,0,0,0,0,0,0,75,80,5,74,-4,home,away,35,4,155
6/16/2019,638,MLMinnesota Lynx,75,160.5,-110,MIN,Minnesota Lynx,6,-110,1021900044,39,35,1,1,1,1,1,1,1,75,80,5,74,-4,home,home,39,-4,155
6/18/2019,639,WMWashington Mystics,81,165.5,-116,WAS,Washington Mystics,1.5,-110,1021900045,27,48,1,1,1,1,1,1,1,52,81,29,75,21,away,away,48,-21,133
6/18/2019,640,LSL.A. Sparks,52,165.5,-104,LAS,Los Angeles Sparks,-1.5,-110,1021900045,27,48,0,0,0,0,0,0,0,52,81,29,75,21,away,home,27,21,133
6/20/2019,645,PPhoenix,54,145.5,-105,PHO,Phoenix Mercury,-6,-110,1021900048,33,27,0,0,0,0,0,0,0,69,54,-15,60,-6,home,away,27,6,123
6/20/2019,646,DWDallas Wings,69,145,-110,DAL,Dallas Wings,6,-110,1021900048,33,27,1,1,1,1,1,1,1,69,54,-15,60,-6,home,home,33,-6,123
6/20/2019,647,WMWashington Mystics,95,166.5,-110,WAS,Washington Mystics,3.5,-110,1021900049,39,51,1,1,1,1,1,1,1,72,95,23,90,12,away,away,51,-12,167
6/20/2019,648,LVLas Vegas Aces,72,166.5,-110,LVA,Las Vegas Aces,-3.5,-110,1021900049,39,51,0,0,0,0,0,0,0,72,95,23,90,12,away,home,39,12,167
6/21/2019,651,ADAtlanta Dream,76,152.5,-110,ATL,Atlanta Dream,12.5,-110,1021900050,39,25,0,0,0,0,0,0,0,86,76,-10,64,-14,home,away,25,14,162
6/21/2019,652,CSConnecticut Sun,86,152.5,-110,CON,Connecticut Sun,-12.5,-110,1021900050,39,25,1,1,1,1,1,1,1,86,76,-10,64,-14,home,home,39,-14,162
6/21/2019,653,IFIndiana Fever,76,162.5,-110,IND,Indiana Fever,4.5,-110,1021900051,31,40,1,1,1,1,1,1,1,69,76,7,71,9,away,away,40,-9,145
6/21/2019,654,CSChicago Sky,69,162.5,-110,CHI,Chicago Sky,-4.5,-110,1021900051,31,40,0,0,0,0,0,0,0,69,76,7,71,9,away,home,31,9,145
6/21/2019,655,LSL.A. Sparks,62,154,-110,LAS,Los Angeles Sparks,-1.5,-110,1021900052,46,34,1,0,0,0,0,0,0,84,62,-22,80,-12,home,away,34,12,146
6/21/2019,656,SSSeattle Storm,84,154,-110,SEA,Seattle Storm,1.5,-110,1021900052,46,34,0,1,1,1,1,1,1,84,62,-22,80,-12,home,home,46,-12,146
6/22/2019,657,NYNew York Liberty,83,156.5,-108,NYL,New York Liberty,8.5,-110,1021900053,42,43,1,1,0,1,0,0,0,92,83,-9,85,1,away,away,43,-1,175
6/22/2019,658,MLMinnesota Lynx,92,156.5,-112,MIN,Minnesota Lynx,-8.5,-115,1021900053,42,43,0,0,1,0,1,1,1,92,83,-9,85,1,away,home,42,1,175
6/22/2019,659,DWDallas Wings,68,153,-105,DAL,Dallas Wings,14.5,-115,1021900054,49,34,0,0,1,0,0,0,0,86,68,-18,83,-15,home,away,34,15,154
6/22/2019,660,LVLas Vegas Aces,86,152.5,-110,LVA,Las Vegas Aces,-14.5,-105,1021900054,49,34,1,1,0,1,1,1,1,86,68,-18,83,-15,home,home,49,-15,154
6/23/2019,661,WMWashington Mystics,89,156,-110,WAS,Washington Mystics,-9.5,-110,1021900055,45,42,1,1,1,0,1,1,0,73,89,16,87,-3,home,away,42,3,162
6/23/2019,662,ADAtlanta Dream,73,156,-110,ATL,Atlanta Dream,9.5,-110,1021900055,45,42,0,0,0,1,0,0,1,73,89,16,87,-3,home,home,45,-3,162
6/23/2019,665,CSConnecticut Sun,75,164,-110,CON,Connecticut Sun,-5,-110,1021900056,56,35,0,0,0,0,0,0,0,93,75,-18,91,-21,home,away,35,21,168
6/23/2019,666,CSChicago Sky,93,164,-110,CHI,Chicago Sky,5,-110,1021900056,56,35,1,1,1,1,1,1,1,93,75,-18,91,-21,home,home,56,-21,168
6/23/2019,663,LSL.A. Sparks,72,152.5,-110,LAS,Los Angeles Sparks,-1.5,-105,1021900057,44,42,1,1,0,0,1,1,0,82,72,-10,86,-2,home,away,42,2,154
6/23/2019,664,PPhoenix,82,152.5,-110,PHO,Phoenix Mercury,1.5,-115,1021900057,44,42,0,0,1,1,0,0,1,82,72,-10,86,-2,home,home,44,-2,154
6/23/2019,667,IFIndiana Fever,61,153,-110,IND,Indiana Fever,6,-110,1021900058,32,35,0,0,0,0,0,1,0,65,61,-4,67,3,away,away,35,-3,126
6/23/2019,668,SSSeattle Storm,65,153,-110,SEA,Seattle Storm,-6,-110,1021900058,32,35,1,1,1,1,1,0,1,65,61,-4,67,3,away,home,32,3,126
6/25/2019,601,MLMinnesota Lynx,78,151,-110,MIN,Minnesota Lynx,-2.5,-110,1021900059,23,43,1,1,1,1,1,1,1,74,78,4,66,20,away,away,43,-20,152
6/25/2019,602,IFIndiana Fever,74,151,-110,IND,Indiana Fever,2.5,-110,1021900059,23,43,0,0,0,0,0,0,0,74,78,4,66,20,away,home,23,20,152
6/25/2019,603,SSSeattle Storm,56,158.5,-110,SEA,Seattle Storm,6.5,-110,1021900060,36,32,0,0,0,0,0,0,0,60,56,-4,68,-4,home,away,32,4,116
6/25/2019,604,LVLas Vegas Aces,60,158.5,-110,LVA,Las Vegas Aces,-6.5,-110,1021900060,36,32,1,1,1,1,1,1,1,60,56,-4,68,-4,home,home,36,-4,116
6/26/2019,605,WMWashington Mystics,81,164.5,-110,WAS,Washington Mystics,-6.5,-105,1021900061,45,50,1,0,1,1,1,1,1,74,81,7,95,5,away,away,50,-5,155
6/26/2019,606,CSChicago Sky,74,164.5,-105,CHI,Chicago Sky,6.5,-115,1021900061,45,50,0,1,0,0,0,0,0,74,81,7,95,5,away,home,45,5,155
6/26/2019,607,CSConnecticut Sun,73,148.5,-110,CON,Connecticut Sun,-9,-110,1021900062,37,34,1,0,0,0,0,0,0,74,73,-1,71,-3,home,away,34,3,147
6/26/2019,608,DWDallas Wings,74,148.5,-110,DAL,Dallas Wings,9,-110,1021900062,37,34,0,1,1,1,1,1,1,74,73,-1,71,-3,home,home,37,-3,147
6/27/2019,609,LVLas Vegas Aces,74,158,-110,LVA,Las Vegas Aces,-2,-105,1021900063,40,34,1,1,0,0,0,0,0,86,74,-12,74,-6,home,away,34,6,160
6/27/2019,610,LSL.A. Sparks,86,158,-110,LAS,Los Angeles Sparks,2,-115,1021900063,40,34,0,0,1,1,1,1,1,86,74,-12,74,-6,home,home,40,-6,160
6/28/2019,611,DWDallas Wings,68,153.5,-115,DAL,Dallas Wings,4.5,-115,1021900064,38,33,1,0,0,0,0,0,0,69,68,-1,71,-5,home,away,33,5,137
6/28/2019,612,NYNew York Liberty,69,153.5,-110,NYL,New York Liberty,-4,-105,1021900064,38,33,0,1,1,1,1,1,1,69,68,-1,71,-5,home,home,38,-5,137
6/28/2019,613,CSChicago Sky,76,152.5,-110,CHI,Chicago Sky,3,-110,1021900066,51,43,0,0,0,0,0,0,0,79,76,-3,94,-8,home,away,43,8,155
6/28/2019,614,SSSeattle Storm,79,152.5,-110,SEA,Seattle Storm,-3,-110,1021900066,51,43,1,1,1,1,1,1,1,79,76,-3,94,-8,home,home,51,-8,155
6/28/2019,615,IFIndiana Fever,69,151.5,-110,IND,Indiana Fever,5,-110,1021900065,50,38,1,1,1,0,0,0,0,91,69,-22,88,-12,home,away,38,12,160
6/28/2019,616,PPhoenix,91,151.5,-110,PHO,Phoenix Mercury,-5,-110,1021900065,50,38,0,0,0,1,1,1,1,91,69,-22,88,-12,home,home,50,-12,160
6/29/2019,617,CSConnecticut Sun,59,161.5,-110,CON,Connecticut Sun,7,-110,1021900067,56,30,0,0,0,0,0,0,0,102,59,-43,86,-26,home,away,30,26,161
6/29/2019,618,WMWashington Mystics,102,161.5,-110,WAS,Washington Mystics,-7,-110,1021900067,56,30,1,1,1,1,1,1,1,102,59,-43,86,-26,home,home,56,-26,161
6/29/2019,619,IFIndiana Fever,97,159.5,-110,IND,Indiana Fever,13,-110,1021900068,45,45,1,1,1,1,1,1,1,102,97,-5,90,0,tie,away,45,-0,199
6/29/2019,620,LVLas Vegas Aces,102,159.5,-110,LVA,Las Vegas Aces,-13,-110,1021900068,45,45,0,0,0,0,0,0,0,102,97,-5,90,0,tie,home,45,0,199
7/2/2019,629,CSChicago Sky,82,162,-110,CHI,Chicago Sky,9,-110,1021900073,55,54,0,1,0,0,0,0,0,90,82,-8,109,-1,home,away,54,1,172
7/2/2019,630,LVLas Vegas Aces,90,162,-110,LVA,Las Vegas Aces,-9,-110,1021900073,55,54,1,0,1,1,1,1,1,90,82,-8,109,-1,home,home,55,-1,172
7/2/2019,631,ADAtlanta Dream,68,152,-105,ATL,Atlanta Dream,7.5,-110,1021900074,38,34,1,0,0,0,0,0,0,85,68,-17,72,-4,home,away,34,4,153
7/2/2019,632,MLMinnesota Lynx,85,152,-115,MIN,Minnesota Lynx,-7.5,-110,1021900074,38,34,0,1,1,1,1,1,1,85,68,-17,72,-4,home,home,38,-4,153
7/3/2019,633,NYNew York Liberty,84,150,-110,NYL,New York Liberty,7,-115,1021900075,40,41,0,0,1,0,1,0,1,83,84,1,81,1,away,away,41,-1,167
7/3/2019,634,SSSeattle Storm,83,150,-110,SEA,Seattle Storm,-7,-105,1021900075,40,41,1,1,0,1,0,1,0,83,84,1,81,1,away,home,40,1,167
7/5/2019,635,IFIndiana Fever,76,148.5,-110,IND,Indiana Fever,4,-110,1021900076,30,37,0,1,1,1,1,1,1,56,76,20,67,7,away,away,37,-7,132
7/5/2019,636,DWDallas Wings,56,148.5,-110,DAL,Dallas Wings,-4,-110,1021900076,30,37,1,0,0,0,0,0,0,56,76,20,67,7,away,home,30,7,132
7/5/2019,637,ADAtlanta Dream,77,147.5,-110,ATL,Atlanta Dream,9,-115,1021900078,24,32,0,1,1,1,1,1,1,66,77,11,56,8,away,away,32,-8,143
7/5/2019,638,SSSeattle Storm,66,147.5,-110,SEA,Seattle Storm,-9,-105,1021900078,24,32,1,0,0,0,0,0,0,66,77,11,56,8,away,home,24,8,143
7/5/2019,639,NYNew York Liberty,80,160,-110,NYL,New York Liberty,7,-110,1021900077,41,40,0,0,0,0,0,0,0,76,80,4,81,-1,home,away,40,1,156
7/5/2019,640,PPhoenix,76,160,-110,PHO,Phoenix Mercury,-7,-110,1021900077,41,40,1,1,1,1,1,1,1,76,80,4,81,-1,home,home,41,-1,156
7/5/2019,641,WMWashington Mystics,99,166,-115,WAS,Washington Mystics,-1,-110,1021900079,70,99,1,1,1,1,1,1,1,70,99,29,169,29,away,away,99,-29,169
7/5/2019,642,LVLas Vegas Aces,70,166,-105,LVA,Las Vegas Aces,1,-110,1021900079,70,99,0,0,0,0,0,0,0,70,99,29,169,29,away,home,70,29,169
7/6/2019,643,MLMinnesota Lynx,74,157,-110,MIN,Minnesota Lynx,8.5,-110,1021900080,43,44,1,1,1,0,0,0,0,71,74,3,87,1,away,away,44,-1,145
7/6/2019,644,CSConnecticut Sun,71,157,-110,CON,Connecticut Sun,-8.5,-110,1021900080,43,44,0,0,0,1,1,1,1,71,74,3,87,1,away,home,43,1,145
7/7/2019,645,LVLas Vegas Aces,90,164.5,-110,LVA,Las Vegas Aces,-5.5,-110,1021900081,32,44,1,1,1,1,1,1,1,58,90,32,76,12,away,away,44,-12,148
7/7/2019,646,NYNew York Liberty,58,164.5,-110,NYL,New York Liberty,5.5,-110,1021900081,32,44,0,0,0,0,0,0,0,58,90,32,76,12,away,home,32,12,148
7/7/2019,647,WMWashington Mystics,81,161,-110,WAS,Washington Mystics,-5,-110,1021900082,51,46,0,0,0,0,0,0,0,98,81,-17,97,-5,home,away,46,5,179
7/7/2019,648,LSL.A. Sparks,98,161,-110,LAS,Los Angeles Sparks,5,-110,1021900082,51,46,1,1,1,1,1,1,1,98,81,-17,97,-5,home,home,51,-5,179
7/7/2019,651,DWDallas Wings,66,154.5,-110,DAL,Dallas Wings,6.5,-110,1021900083,41,35,0,0,0,0,0,0,0,78,66,-12,76,-6,home,away,35,6,144
7/7/2019,652,CSChicago Sky,78,154.5,-110,CHI,Chicago Sky,-6.5,-110,1021900083,41,35,1,1,1,1,1,1,1,78,66,-12,76,-6,home,home,41,-6,144
7/7/2019,649,ADAtlanta Dream,63,153.5,-110,ATL,Atlanta Dream,7.5,-110,1021900084,29,25,0,0,0,0,0,0,0,65,63,-2,54,-4,home,away,25,4,128
7/7/2019,650,PPhoenix,65,153.5,-110,PHO,Phoenix Mercury,-7.5,-110,1021900084,29,25,1,1,1,1,1,1,1,65,63,-2,54,-4,home,home,29,-4,128
7/9/2019,653,LSL.A. Sparks,62,151,-110,LAS,Los Angeles Sparks,-5,-110,1021900085,37,32,0,1,1,0,0,0,0,74,62,-12,69,-5,home,away,32,5,136
7/9/2019,654,DWDallas Wings,74,151,-110,DAL,Dallas Wings,5,-110,1021900085,37,32,1,0,0,1,1,1,1,74,62,-12,69,-5,home,home,37,-5,136
7/10/2019,655,CSConnecticut Sun,75,151.5,-110,CON,Connecticut Sun,-6,-110,1021900086,43,41,0,0,0,0,0,1,0,78,75,-3,84,-2,home,away,41,2,153
7/10/2019,656,ADAtlanta Dream,78,151.5,-110,ATL,Atlanta Dream,6,-110,1021900086,43,41,1,1,1,1,1,0,1,78,75,-3,84,-2,home,home,43,-2,153
7/10/2019,657,PPhoenix,91,157.5,-110,PHO,Phoenix Mercury,8.5,-110,1021900087,44,49,0,0,0,0,0,0,1,68,91,23,93,5,away,away,49,-5,159
7/10/2019,658,WMWashington Mystics,68,157.5,-110,WAS,Washington Mystics,-8.5,-110,1021900087,44,49,1,1,1,1,1,1,0,68,91,23,93,5,away,home,44,5,159
7/10/2019,659,LVLas Vegas Aces,74,161.5,-110,LVA,Las Vegas Aces,-5.5,-117,1021900088,35,38,0,1,0,1,1,1,1,71,74,3,73,3,away,away,38,-3,145
7/10/2019,660,IFIndiana Fever,71,161.5,-110,IND,Indiana Fever,6,-110,1021900088,35,38,1,0,1,0,0,0,0,71,74,3,73,3,away,home,35,3,145
7/10/2019,661,MLMinnesota Lynx,73,158.5,-110,MIN,Minnesota Lynx,1.5,-105,1021900089,32,40,1,1,1,1,1,1,1,72,73,1,72,8,away,away,40,-8,145
7/10/2019,662,CSChicago Sky,72,158.5,-110,CHI,Chicago Sky,-1.5,-115,1021900089,32,40,0,0,0,0,0,0,0,72,73,1,72,8,away,home,32,8,145
7/12/2019,601,LSL.A. Sparks,90,155.5,-110,LAS,Los Angeles Sparks,-2.5,-110,1021900090,35,45,1,1,1,1,1,1,1,84,90,6,80,10,away,away,45,-10,174
7/12/2019,602,IFIndiana Fever,84,155.5,-110,IND,Indiana Fever,2.5,-110,1021900090,35,45,0,0,0,0,0,0,0,84,90,6,80,10,away,home,35,10,174
7/12/2019,603,MLMinnesota Lynx,53,149.5,-110,MIN,Minnesota Lynx,-1.5,-110,1021900091,37,32,0,0,0,0,0,0,0,60,53,-7,69,-5,home,away,32,5,113
7/12/2019,604,ADAtlanta Dream,60,149,-105,ATL,Atlanta Dream,1.5,-110,1021900091,37,32,1,1,1,1,1,1,1,60,53,-7,69,-5,home,home,37,-5,113
7/12/2019,607,NYNew York Liberty,83,162,-110,NYL,New York Liberty,3.5,-110,1021900093,55,35,0,0,0,0,1,0,0,99,83,-16,90,-20,home,away,35,20,182
7/12/2019,608,CSChicago Sky,99,162,-110,CHI,Chicago Sky,-3.5,-110,1021900093,55,35,1,1,1,1,0,1,1,99,83,-16,90,-20,home,home,55,-20,182
7/12/2019,605,PPhoenix,64,154,-110,PHO,Phoenix Mercury,3.5,-110,1021900092,30,36,1,1,1,1,1,1,0,79,64,-15,66,6,away,away,36,-6,143
7/12/2019,606,CSConnecticut Sun,79,154,-110,CON,Connecticut Sun,-3.5,-110,1021900092,30,36,0,0,0,0,0,0,1,79,64,-15,66,6,away,home,30,6,143
7/12/2019,609,DWDallas Wings,81,145,-110,DAL,Dallas Wings,5.5,-110,1021900094,52,29,0,0,0,0,0,0,0,95,81,-14,81,-23,home,away,29,23,176
7/12/2019,610,SSSeattle Storm,95,145,-110,SEA,Seattle Storm,-5.5,-110,1021900094,52,29,1,1,1,1,1,1,1,95,81,-14,81,-23,home,home,52,-23,176
7/14/2019,613,LSL.A. Sparks,76,152.5,-110,LAS,Los Angeles Sparks,-3.5,-105,1021900096,30,32,1,1,1,0,1,1,1,71,76,5,62,2,away,away,32,-2,147
7/14/2019,614,ADAtlanta Dream,71,152.5,-110,ATL,Atlanta Dream,3.5,-115,1021900096,30,32,0,0,0,1,0,0,0,71,76,5,62,2,away,home,30,2,147
7/14/2019,617,CSChicago Sky,89,152.5,-110,CHI,Chicago Sky,1,-110,1021900098,46,41,0,0,1,1,1,1,0,79,89,10,87,-5,home,away,41,5,168
7/14/2019,618,DWDallas Wings,79,152.5,-110,DAL,Dallas Wings,-1,-110,1021900098,46,41,1,1,0,0,0,0,1,79,89,10,87,-5,home,home,46,-5,168
7/14/2019,615,CSConnecticut Sun,76,155.5,-115,CON,Connecticut Sun,-4,-110,1021900097,30,39,0,1,1,1,1,1,1,63,76,13,69,9,away,away,39,-9,139
7/14/2019,616,IFIndiana Fever,63,155.5,-105,IND,Indiana Fever,4,-110,1021900097,30,39,1,0,0,0,0,0,0,63,76,13,69,9,away,home,30,9,139
7/14/2019,621,NYNew York Liberty,69,155.5,-110,NYL,New York Liberty,5.5,-110,1021900100,43,30,0,0,0,0,0,0,0,78,69,-9,73,-13,home,away,30,13,147
7/14/2019,622,SSSeattle Storm,78,155.5,-110,SEA,Seattle Storm,-5.5,-110,1021900100,43,30,1,1,1,1,1,1,1,78,69,-9,73,-13,home,home,43,-13,147
7/14/2019,619,PPhoenix,62,152,-110,PHO,Phoenix Mercury,1,-110,1021900099,36,35,1,0,0,0,0,1,0,75,62,-13,71,-1,home,away,35,1,137
7/14/2019,620,MLMinnesota Lynx,75,152,-110,MIN,Minnesota Lynx,-1,-110,1021900099,36,35,0,1,1,1,1,0,1,75,62,-13,71,-1,home,home,36,-1,137
7/18/2019,629,DWDallas Wings,64,150.5,-110,DAL,Dallas Wings,7.5,-110,1021900104,32,42,1,1,1,1,1,1,1,69,64,-5,74,10,away,away,42,-10,133
7/18/2019,630,LSL.A. Sparks,69,150.5,-110,LAS,Los Angeles Sparks,-7.5,-110,1021900104,32,42,0,0,0,0,0,0,0,69,64,-5,74,10,away,home,32,10,133
7/19/2019,631,WMWashington Mystics,95,161,-110,WAS,Washington Mystics,-8,-110,1021900105,37,41,1,1,1,1,1,1,1,88,95,7,78,4,away,away,41,-4,183
7/19/2019,632,IFIndiana Fever,88,161,-110,IND,Indiana Fever,8,-110,1021900105,37,41,0,0,0,0,0,0,0,88,95,7,78,4,away,home,37,4,183
7/19/2019,633,ADAtlanta Dream,69,150,-110,ATL,Atlanta Dream,9,-110,1021900106,49,40,0,0,0,0,0,0,0,98,69,-29,89,-9,home,away,40,9,167
7/19/2019,634,CSConnecticut Sun,98,150,-110,CON,Connecticut Sun,-9,-110,1021900106,49,40,1,1,1,1,1,1,1,98,69,-29,89,-9,home,home,49,-9,167
7/19/2019,635,LVLas Vegas Aces,66,157,-110,LVA,Las Vegas Aces,-1.5,-115,1021900107,43,35,0,0,0,0,0,0,0,69,66,-3,78,-8,home,away,35,8,135
7/19/2019,636,SSSeattle Storm,69,157,-110,SEA,Seattle Storm,1.5,-105,1021900107,43,35,1,1,1,1,1,1,1,69,66,-3,78,-8,home,home,43,-8,135
7/20/2019,637,LSL.A. Sparks,78,157.5,-110,LAS,Los Angeles Sparks,-2,-110,1021900108,44,37,0,0,0,0,0,0,0,83,78,-5,81,-7,home,away,37,7,161
7/20/2019,638,NYNew York Liberty,83,157.5,-110,NYL,New York Liberty,2,-110,1021900108,44,37,1,1,1,1,1,1,1,83,78,-5,81,-7,home,home,44,-7,161
7/20/2019,639,PPhoenix,70,145.5,-110,PHO,Phoenix Mercury,-2,-110,1021900109,32,36,1,0,0,1,1,1,1,66,70,4,68,4,away,away,36,-4,136
7/20/2019,640,DWDallas Wings,66,145.5,-110,DAL,Dallas Wings,2,-105,1021900109,32,36,0,1,1,0,0,0,0,66,70,4,68,4,away,home,32,4,136
7/21/2019,641,ADAtlanta Dream,65,159,-110,ATL,Atlanta Dream,13,-115,1021900110,45,31,0,0,0,0,0,0,0,93,65,-28,76,-14,home,away,31,14,158
7/21/2019,642,WMWashington Mystics,93,159,-110,WAS,Washington Mystics,-13,-110,1021900110,45,31,1,1,1,1,1,1,1,93,65,-28,76,-14,home,home,45,-14,158
7/21/2019,643,IFIndiana Fever,70,158.5,-110,IND,Indiana Fever,5.5,-110,1021900111,27,36,0,0,1,1,1,1,1,78,70,-8,63,9,away,away,36,-9,148
7/21/2019,644,CSChicago Sky,78,158.5,-110,CHI,Chicago Sky,-5.5,-115,1021900111,27,36,1,1,0,0,0,0,0,78,70,-8,63,9,away,home,27,9,148
7/21/2019,645,MLMinnesota Lynx,74,156,105,MIN,Minnesota Lynx,6,-110,1021900112,39,37,1,1,0,0,0,0,0,79,74,-5,76,-2,home,away,37,2,153
7/21/2019,646,LVLas Vegas Aces,79,156,-125,LVA,Las Vegas Aces,-6,-110,1021900112,39,37,0,0,1,1,1,1,1,79,74,-5,76,-2,home,home,39,-2,153
7/23/2019,647,LSL.A. Sparks,78,148,-110,LAS,Los Angeles Sparks,-1,-110,1021900113,32,30,1,0,0,1,1,0,1,66,78,12,62,-2,home,away,30,2,144
7/23/2019,648,ADAtlanta Dream,66,148,-110,ATL,Atlanta Dream,1,-110,1021900113,32,30,0,1,1,0,0,1,0,66,78,12,62,-2,home,home,32,-2,144
7/23/2019,649,SSSeattle Storm,62,153.5,-110,SEA,Seattle Storm,5,-110,1021900114,36,35,0,0,0,1,0,1,0,79,62,-17,71,-1,home,away,35,1,141
7/23/2019,650,LVLas Vegas Aces,79,153.5,-110,LVA,Las Vegas Aces,-5,-110,1021900114,36,35,1,1,1,0,1,0,1,79,62,-17,71,-1,home,home,36,-1,141
7/23/2019,651,IFIndiana Fever,77,149.5,-115,IND,Indiana Fever,5.5,-110,1021900115,44,43,1,1,1,0,1,0,0,95,77,-18,87,-1,home,away,43,1,172
7/23/2019,652,PPhoenix,95,149.5,-105,PHO,Phoenix Mercury,-5.5,-110,1021900115,44,43,0,0,0,1,0,1,1,95,77,-18,87,-1,home,home,44,-1,172
7/24/2019,653,NYNew York Liberty,63,160.5,-110,NYL,New York Liberty,9.5,-110,1021900116,36,39,0,0,1,1,1,1,0,70,63,-7,75,3,away,away,39,-3,133
7/24/2019,654,CSConnecticut Sun,70,160.5,-110,CON,Connecticut Sun,-9.5,-110,1021900116,36,39,1,1,0,0,0,0,1,70,63,-7,75,3,away,home,36,3,133
7/24/2019,655,WMWashington Mystics,79,160,-115,WAS,Washington Mystics,-5.5,-110,1021900117,32,44,1,1,1,1,1,1,1,71,79,8,76,12,away,away,44,-12,150
7/24/2019,656,MLMinnesota Lynx,71,160,-110,MIN,Minnesota Lynx,5.5,-110,1021900117,32,44,0,0,0,0,0,0,0,71,79,8,76,12,away,home,32,12,150
7/31/2019,617,ADAtlanta Dream,59,152,-110,ATL,Atlanta Dream,5,-110,1021900121,32,25,1,0,1,0,0,0,0,61,59,-2,57,-7,home,away,25,7,120
7/31/2019,618,IFIndiana Fever,61,152,-110,IND,Indiana Fever,-5,-110,1021900121,32,25,0,1,0,1,1,1,1,61,59,-2,57,-7,home,home,32,-7,120
8/1/2019,619,PPhoenix,62,154,-110,PHO,Phoenix Mercury,7,-105,1021900122,32,36,1,0,1,1,1,1,0,68,62,-6,68,4,away,away,36,-4,130
8/1/2019,620,CSConnecticut Sun,68,154,-110,CON,Connecticut Sun,-7,-115,1021900122,32,36,0,1,0,0,0,0,1,68,62,-6,68,4,away,home,32,4,130
8/1/2019,621,NYNew York Liberty,64,151,-110,NYL,New York Liberty,-1,-105,1021900123,55,37,0,0,0,0,1,0,0,87,64,-23,92,-18,home,away,37,18,151
8/1/2019,622,DWDallas Wings,87,151,-110,DAL,Dallas Wings,1,-115,1021900123,55,37,1,1,1,1,0,1,1,87,64,-23,92,-18,home,home,55,-18,151
8/1/2019,623,LVLas Vegas Aces,68,154.5,-115,LVA,Las Vegas Aces,1,-105,1021900124,40,40,0,0,0,0,0,0,0,76,68,-8,80,0,tie,away,40,-0,144
8/1/2019,624,LSL.A. Sparks,76,154.5,-110,LAS,Los Angeles Sparks,-1.5,-110,1021900124,40,40,1,1,1,1,1,1,1,76,68,-8,80,0,tie,home,40,0,144
8/2/2019,625,WMWashington Mystics,99,158.5,-105,WAS,Washington Mystics,-5,-110,1021900125,34,48,1,1,1,1,1,1,1,79,99,20,82,14,away,away,48,-14,178
8/2/2019,626,SSSeattle Storm,79,158.5,-115,SEA,Seattle Storm,5,-110,1021900125,34,48,0,0,0,0,0,0,0,79,99,20,82,14,away,home,34,14,178
8/3/2019,627,MLMinnesota Lynx,75,150.5,-110,MIN,Minnesota Lynx,-3,-110,1021900127,38,48,1,1,1,1,1,1,1,86,75,-11,86,10,away,away,48,-10,161
8/3/2019,628,IFIndiana Fever,86,150.5,-110,IND,Indiana Fever,3,-110,1021900127,38,48,0,0,0,0,0,0,0,86,75,-11,86,10,away,home,38,10,161
8/3/2019,629,CSChicago Sky,87,157.5,-110,CHI,Chicago Sky,-4,-110,1021900126,42,46,0,0,0,0,0,0,0,75,87,12,88,4,away,away,46,-4,162
8/3/2019,630,ADAtlanta Dream,75,157.5,-110,ATL,Atlanta Dream,4,-110,1021900126,42,46,1,1,1,1,1,1,1,75,87,12,88,4,away,home,42,4,162
8/3/2019,631,LVLas Vegas Aces,75,145,-110,LVA,Las Vegas Aces,-4.5,-110,1021900128,37,42,1,1,1,1,1,1,1,70,75,5,79,5,away,away,42,-5,145
8/3/2019,632,DWDallas Wings,70,145,-110,DAL,Dallas Wings,4.5,-110,1021900128,37,42,0,0,0,0,0,0,0,70,75,5,79,5,away,home,37,5,145
8/4/2019,633,CSConnecticut Sun,94,158,-110,CON,Connecticut Sun,-6,-110,1021900129,38,53,1,1,1,1,1,1,1,79,94,15,91,15,away,away,53,-15,173
8/4/2019,634,NYNew York Liberty,79,158,-110,NYL,New York Liberty,6,-110,1021900129,38,53,0,0,0,0,0,0,0,79,94,15,91,15,away,home,38,15,173
8/4/2019,635,SSSeattle Storm,75,148,-110,SEA,Seattle Storm,4.5,-110,1021900130,50,41,0,0,0,0,0,0,0,83,75,-8,91,-9,home,away,41,9,158
8/4/2019,636,LSL.A. Sparks,83,148,-110,LAS,Los Angeles Sparks,-4.5,-110,1021900130,50,41,1,1,1,1,1,1,1,83,75,-8,91,-9,home,home,50,-9,158
8/4/2019,637,WMWashington Mystics,82,160,-110,WAS,Washington Mystics,-7.5,-110,1021900131,60,43,0,1,1,0,0,0,0,103,82,-21,103,-17,home,away,43,17,185
8/4/2019,638,PPhoenix,103,160,-110,PHO,Phoenix Mercury,7.5,-110,1021900131,60,43,1,0,0,1,1,1,1,103,82,-21,103,-17,home,home,60,-17,185
8/6/2019,639,MLMinnesota Lynx,85,145.5,-124,MIN,Minnesota Lynx,-5,-110,1021900132,41,41,0,0,0,0,0,1,1,69,85,16,82,0,tie,away,41,-0,154
8/6/2019,640,ADAtlanta Dream,69,145.5,104,ATL,Atlanta Dream,5,-110,1021900132,41,41,1,1,1,1,1,0,0,69,85,16,82,0,tie,home,41,0,154
8/7/2019,641,NYNew York Liberty,92,165,-110,NYL,New York Liberty,7.5,-115,1021900133,42,49,1,0,1,1,1,1,1,101,92,-9,91,7,away,away,49,-7,193
8/7/2019,642,CSChicago Sky,101,165,-110,CHI,Chicago Sky,-7.5,-105,1021900133,42,49,0,1,0,0,0,0,0,101,92,-9,91,7,away,home,42,7,193
8/8/2019,643,IFIndiana Fever,78,164.5,-110,IND,Indiana Fever,13,-112,1021900134,44,42,0,0,0,0,0,0,1,91,78,-13,86,-2,home,away,42,2,169
8/8/2019,644,WMWashington Mystics,91,164.5,-110,WAS,Washington Mystics,-13,-108,1021900134,44,42,1,1,1,1,1,1,0,91,78,-13,86,-2,home,home,44,-2,169
8/8/2019,645,PPhoenix,74,152,-110,PHO,Phoenix Mercury,6,-106,1021900135,44,32,0,0,0,0,0,0,0,84,74,-10,76,-12,home,away,32,12,158
8/8/2019,646,LSL.A. Sparks,84,152,-110,LAS,Los Angeles Sparks,-6,-114,1021900135,44,32,1,1,1,1,1,1,1,84,74,-10,76,-12,home,home,44,-12,158
8/8/2019,647,DWDallas Wings,57,146,-110,DAL,Dallas Wings,9.5,-115,1021900136,37,38,1,1,1,1,1,1,0,69,57,-12,75,1,away,away,38,-1,126
8/8/2019,648,SSSeattle Storm,69,146,-110,SEA,Seattle Storm,-9.5,-105,1021900136,37,38,0,0,0,0,0,0,1,69,57,-12,75,1,away,home,37,1,126
8/9/2019,649,CSConnecticut Sun,57,155,-110,CON,Connecticut Sun,-3,-110,1021900137,54,25,0,0,0,0,0,0,0,89,57,-32,79,-29,home,away,25,29,146
8/9/2019,650,MLMinnesota Lynx,89,155,-110,MIN,Minnesota Lynx,3,-110,1021900137,54,25,1,1,1,1,1,1,1,89,57,-32,79,-29,home,home,54,-29,146
8/9/2019,651,CSChicago Sky,87,164.5,-110,CHI,Chicago Sky,7,-110,1021900138,41,48,1,1,1,1,1,1,1,84,87,3,89,7,away,away,48,-7,171
8/9/2019,652,LVLas Vegas Aces,84,164.5,-110,LVA,Las Vegas Aces,-7,-110,1021900138,41,48,0,0,0,0,0,0,0,84,87,3,89,7,away,home,41,7,171
8/10/2019,653,ADAtlanta Dream,82,151,-110,ATL,Atlanta Dream,5.5,-110,1021900139,41,39,0,0,0,1,0,0,0,87,82,-5,80,-2,home,away,39,2,169
8/10/2019,654,IFIndiana Fever,87,151,-115,IND,Indiana Fever,-5.5,-110,1021900139,41,39,1,1,1,0,1,1,1,87,82,-5,80,-2,home,home,41,-2,169
8/10/2019,655,DWDallas Wings,80,145.5,-110,DAL,Dallas Wings,9,-110,1021900140,46,40,1,0,1,0,0,0,0,77,80,3,86,-6,home,away,40,6,157
8/10/2019,656,PPhoenix,77,145.5,-115,PHO,Phoenix Mercury,-9,-110,1021900140,46,40,0,1,0,1,1,1,1,77,80,3,86,-6,home,home,46,-6,157
8/13/2019,609,MLMinnesota Lynx,89,156.5,-110,MIN,Minnesota Lynx,-6,-105,1021900145,40,42,0,1,1,1,1,1,1,73,89,16,82,2,away,away,42,-2,162
8/13/2019,610,NYNew York Liberty,73,156.5,-110,NYL,New York Liberty,6,-115,1021900145,40,42,1,0,0,0,0,0,0,73,89,16,82,2,away,home,40,2,162
8/13/2019,611,ADAtlanta Dream,90,152.5,-110,ATL,Atlanta Dream,13,-110,1021900146,43,49,0,0,0,0,1,1,1,94,90,-4,92,6,away,away,49,-6,184
8/13/2019,612,LVLas Vegas Aces,94,152.5,-110,LVA,Las Vegas Aces,-13,-110,1021900146,43,49,1,1,1,1,0,0,0,94,90,-4,92,6,away,home,43,6,184
8/14/2019,613,LSL.A. Sparks,78,147.5,-110,LAS,Los Angeles Sparks,-7,-110,1021900148,39,42,0,0,0,0,0,1,1,84,78,-6,81,3,away,away,42,-3,162
8/14/2019,614,DWDallas Wings,84,147.5,-110,DAL,Dallas Wings,7,-115,1021900148,39,42,1,1,1,1,1,0,0,84,78,-6,81,3,away,home,39,3,162
8/14/2019,615,SSSeattle Storm,59,161.5,-110,SEA,Seattle Storm,9,-110,1021900147,38,35,0,1,1,1,1,1,0,88,59,-29,73,-3,home,away,35,3,147
8/14/2019,616,WMWashington Mystics,88,161.5,-110,WAS,Washington Mystics,-9,-110,1021900147,38,35,1,0,0,0,0,0,1,88,59,-29,73,-3,home,home,38,-3,147
8/14/2019,617,CSConnecticut Sun,78,154.5,-110,CON,Connecticut Sun,-7,-115,1021900149,34,49,1,1,1,1,1,1,1,71,78,7,83,15,away,away,49,-15,149
8/14/2019,618,PPhoenix,71,154.5,-110,PHO,Phoenix Mercury,7,-105,1021900149,34,49,0,0,0,0,0,0,0,71,78,7,83,15,away,home,34,15,149
7/26/2020,659,CSChicago Sky,88,175,-110,CHI,Chicago Sky,-3.5,-110,1022001005,48,46,0,0,0,0,0,1,0,86,88,2,94,-2,home,away,46,2,174
7/26/2020,660,LVLas Vegas Aces,86,175,-110,LVA,Las Vegas Aces,3.5,-110,1022001005,48,46,1,1,1,1,1,0,1,86,88,2,94,-2,home,home,48,-2,174
7/26/2020,661,DWDallas Wings,95,154.5,-110,DAL,Dallas Wings,-6,-108,1022001006,53,49,0,0,0,1,1,1,0,105,95,-10,102,-4,home,away,49,4,200
7/26/2020,662,ADAtlanta Dream,105,154.5,-110,ATL,Atlanta Dream,6,-112,1022001006,53,49,1,1,1,0,0,0,1,105,95,-10,102,-4,home,home,53,-4,200
7/30/2020,675,SSSeattle Storm,71,174,-110,SEA,Seattle Storm,-7.5,-115,1022001013,50,32,0,0,0,0,0,0,0,89,71,-18,82,-18,home,away,32,18,160
7/30/2020,676,WMWashington Mystics,89,174,-110,WAS,Washington Mystics,7.5,-110,1022001013,50,32,1,1,1,1,1,1,1,89,71,-18,82,-18,home,home,50,-18,160
7/30/2020,677,CSChicago Sky,81,167,-110,CHI,Chicago Sky,-5,-110,1022001014,38,34,1,1,0,0,0,0,0,83,81,-2,72,-4,home,away,34,4,164
7/30/2020,678,MLMinnesota Lynx,83,167,-110,MIN,Minnesota Lynx,5,-110,1022001014,38,34,0,0,1,1,1,1,1,83,81,-2,72,-4,home,home,38,-4,164
7/30/2020,679,CSConnecticut Sun,76,166,-115,CON,Connecticut Sun,6.5,-110,1022001015,41,36,1,1,1,0,0,0,0,81,76,-5,77,-5,home,away,36,5,157
7/30/2020,680,LSL.A. Sparks,81,166,-110,LAS,Los Angeles Sparks,-6.5,-110,1022001015,41,36,0,0,0,1,1,1,1,81,76,-5,77,-5,home,home,41,-5,157
8/18/2020,607,IFIndiana Fever,62,164.5,-110,IND,Indiana Fever,5.5,-110,1022001064,37,34,0,0,0,0,0,0,0,84,62,-22,71,-3,home,away,34,3,146
8/18/2020,608,CSConnecticut Sun,84,164.5,-110,CON,Connecticut Sun,-5.5,-110,1022001064,37,34,1,1,1,1,1,1,1,84,62,-22,71,-3,home,home,37,-3,146
8/18/2020,609,LVLas Vegas Aces,82,171.5,-105,LVA,Las Vegas Aces,-4.5,-110,1022001065,39,46,1,1,1,1,1,1,1,84,82,-2,85,7,away,away,46,-7,166
8/18/2020,610,CSChicago Sky,84,171.5,-110,CHI,Chicago Sky,4.5,-110,1022001065,39,46,0,0,0,0,0,0,0,84,82,-2,85,7,away,home,39,7,166
8/18/2020,611,NYNew York Liberty,64,158,-110,NYL,New York Liberty,19,-105,1022001066,61,28,0,0,0,0,0,0,0,105,64,-41,89,-33,home,away,28,33,169
8/18/2020,612,SSSeattle Storm,105,158,-110,SEA,Seattle Storm,-19,-115,1022001066,61,28,1,1,1,1,1,1,1,105,64,-41,89,-33,home,home,61,-33,169
8/19/2020,613,ADAtlanta Dream,91,160,-110,ATL,Atlanta Dream,7,-110,1022001067,45,39,0,0,1,0,0,0,0,98,91,-7,84,-6,home,away,39,6,189
8/19/2020,614,WMWashington Mystics,98,160,-110,WAS,Washington Mystics,-7,-110,1022001067,45,39,1,1,0,1,1,1,1,98,91,-7,84,-6,home,home,45,-6,189
8/19/2020,615,DWDallas Wings,84,156.5,-110,DAL,Dallas Wings,6,-110,1022001068,39,43,0,1,1,1,0,1,1,91,84,-7,82,4,away,away,43,-4,175
8/19/2020,616,MLMinnesota Lynx,91,156.5,-110,MIN,Minnesota Lynx,-6,-110,1022001068,39,43,1,0,0,0,1,0,0,91,84,-7,82,4,away,home,39,4,175
8/19/2020,617,PPhoenix,74,168.5,-115,PHO,Phoenix Mercury,5.5,-110,1022001069,42,26,0,0,0,0,0,0,0,83,74,-9,68,-16,home,away,26,16,157
8/19/2020,618,LSL.A. Sparks,83,168.5,-105,LAS,Los Angeles Sparks,-5.5,-110,1022001069,42,26,1,1,1,1,1,1,1,83,74,-9,68,-16,home,home,42,-16,157
8/21/2020,625,LSL.A. Sparks,93,163.5,-110,LAS,Los Angeles Sparks,-15.5,-110,1022001073,35,40,0,1,1,1,1,1,1,85,93,8,75,5,away,away,40,-5,178
8/21/2020,626,ADAtlanta Dream,85,163.5,-110,ATL,Atlanta Dream,15.5,-110,1022001073,35,40,1,0,0,0,0,0,0,85,93,8,75,5,away,home,35,5,178
8/21/2020,627,WMWashington Mystics,92,160,-110,WAS,Washington Mystics,3.5,-110,1022001074,56,36,0,0,0,0,0,0,0,101,92,-9,92,-20,home,away,36,20,193
8/21/2020,628,DWDallas Wings,101,160,-110,DAL,Dallas Wings,-3.5,-110,1022001074,56,36,1,1,1,1,1,1,1,101,92,-9,92,-20,home,home,56,-20,193
8/21/2020,629,MLMinnesota Lynx,90,164,-110,MIN,Minnesota Lynx,1.5,-110,1022001075,42,51,1,1,1,1,1,1,0,80,90,10,93,9,away,away,51,-9,170
8/21/2020,630,PPhoenix,80,164,-110,PHO,Phoenix Mercury,-1.5,-110,1022001075,42,51,0,0,0,0,0,0,1,80,90,10,93,9,away,home,42,9,170
8/23/2020,637,ADAtlanta Dream,78,162.5,-110,ATL,Atlanta Dream,11.5,-110,1022001079,41,30,0,0,0,0,0,0,0,75,78,3,71,-11,home,away,30,11,153
8/23/2020,638,MLMinnesota Lynx,75,162.5,-110,MIN,Minnesota Lynx,-11.5,-110,1022001079,41,30,1,1,1,1,1,1,1,75,78,3,71,-11,home,home,41,-11,153
8/23/2020,639,DWDallas Wings,81,161.5,-110,DAL,Dallas Wings,10.5,-110,1022001080,38,42,0,0,0,0,0,1,1,84,81,-3,80,4,away,away,42,-4,165
8/23/2020,640,LSL.A. Sparks,84,161.5,-110,LAS,Los Angeles Sparks,-10.5,-110,1022001080,38,42,1,1,1,1,1,0,0,84,81,-3,80,4,away,home,38,4,165
8/23/2020,641,PPhoenix,88,167,-110,PHO,Phoenix Mercury,-4.5,-112,1022001081,39,38,0,0,1,0,1,1,1,87,88,1,77,-1,home,away,38,1,175
8/23/2020,642,WMWashington Mystics,87,167,-110,WAS,Washington Mystics,4.5,-108,1022001081,39,38,1,1,0,1,0,0,0,87,88,1,77,-1,home,home,39,-1,175
9/11/2020,649,ADAtlanta Dream,82,166,-115,ATL,Atlanta Dream,2,-110,1022001127,36,33,0,0,0,0,0,0,0,75,82,7,69,-3,home,away,33,3,157
9/11/2020,650,CSConnecticut Sun,75,166,-105,CON,Connecticut Sun,-2,-110,1022001127,36,33,1,1,1,1,1,1,1,75,82,7,69,-3,home,home,36,-3,157
9/11/2020,651,CSChicago Sky,95,172.5,-110,CHI,Chicago Sky,-5,-110,1022001128,44,50,1,0,1,1,0,0,1,88,95,7,94,6,away,away,50,-6,183
9/11/2020,652,DWDallas Wings,88,172.5,-110,DAL,Dallas Wings,5.5,-115,1022001128,44,50,0,1,0,0,1,1,0,88,95,7,94,6,away,home,44,6,183
9/11/2020,653,SSSeattle Storm,83,166.5,-110,SEA,Seattle Storm,-4.5,-110,1022001129,26,50,1,1,1,1,1,1,1,60,83,23,76,24,away,away,50,-24,143
9/11/2020,654,PPhoenix,60,166.5,-110,PHO,Phoenix Mercury,4.5,-110,1022001129,26,50,0,0,0,0,0,0,0,60,83,23,76,24,away,home,26,24,143
9/15/2020,601,CSConnecticut Sun,94,165.5,-110,CON,Connecticut Sun,2,-105,1042000111,41,41,0,0,1,1,1,1,0,81,94,13,82,0,tie,away,41,-0,175
9/15/2020,602,CSChicago Sky,81,165.5,-110,CHI,Chicago Sky,-2,-105,1042000111,41,41,1,1,0,0,0,0,1,81,94,13,82,0,tie,home,41,0,175
9/15/2020,603,WMWashington Mystics,84,164.5,-110,WAS,Washington Mystics,4.5,-110,1042000101,35,46,1,1,1,1,1,1,1,85,84,-1,81,11,away,away,46,-11,169
9/15/2020,604,PPhoenix,85,164.5,-110,PHO,Phoenix Mercury,-4.5,-110,1042000101,35,46,0,0,0,0,0,0,0,85,84,-1,81,11,away,home,35,11,169
9/17/2020,605,PPhoenix,79,167.5,-110,PHO,Phoenix Mercury,4.5,-110,1042000211,37,46,1,1,1,0,1,0,1,80,79,-1,83,9,away,away,46,-9,159
9/17/2020,606,MLMinnesota Lynx,80,167,100,MIN,Minnesota Lynx,-4.5,-110,1042000211,37,46,0,0,0,1,0,1,0,80,79,-1,83,9,away,home,37,9,159
9/17/2020,607,CSConnecticut Sun,73,159,-110,CON,Connecticut Sun,5,-105,1042000201,23,39,1,1,1,1,1,1,1,59,73,14,62,16,away,away,39,-16,132
9/17/2020,608,LSL.A. Sparks,59,158,-102,LAS,Los Angeles Sparks,-5,-115,1042000201,23,39,0,0,0,0,0,0,0,59,73,14,62,16,away,home,23,16,132
9/20/2020,611,CSConnecticut Sun,87,162.5,-110,CON,Connecticut Sun,6,-110,1042000301,25,36,0,1,1,1,1,1,1,62,87,25,61,11,away,away,36,-11,149
9/20/2020,612,LVLas Vegas Aces,62,162.5,-110,LVA,Las Vegas Aces,-6,-110,1042000301,25,36,1,0,0,0,0,0,0,62,87,25,61,11,away,home,25,11,149
9/20/2020,613,MLMinnesota Lynx,NA,162.5,-110,MIN,Minnesota Lynx,8.5,-115,NA,NA,NA,NA,NA,NA,NA,NA,NA,NA,NA,NA,NA,NA,NA,NA,NA,NA,NA,NA
9/20/2020,614,SSSeattle Storm,NA,162.5,-110,SEA,Seattle Storm,-8.5,-105,NA,NA,NA,NA,NA,NA,NA,NA,NA,NA,NA,NA,NA,NA,NA,NA,NA,NA,NA,NA
9/22/2020,617,CSConnecticut Sun,75,161,-110,CON,Connecticut Sun,5.5,-110,1042000302,38,39,0,0,1,1,1,1,0,83,75,-8,77,1,away,away,39,-1,158
9/22/2020,618,LVLas Vegas Aces,83,161,-110,LVA,Las Vegas Aces,-5.5,-110,1042000302,38,39,1,1,0,0,0,0,1,83,75,-8,77,1,away,home,38,1,158
9/22/2020,615,MLMinnesota Lynx,86,163,-110,MIN,Minnesota Lynx,9,-110,1042000311,50,45,1,1,1,1,1,1,1,88,86,-2,95,-5,home,away,45,5,174
9/22/2020,616,SSSeattle Storm,88,163,-110,SEA,Seattle Storm,-9,-110,1042000311,50,45,0,0,0,0,0,0,0,88,86,-2,95,-5,home,home,50,-5,174
9/24/2020,631,MLMinnesota Lynx,79,164,-110,MIN,Minnesota Lynx,8,-105,1042000312,46,33,1,0,0,0,0,0,0,89,79,-10,79,-13,home,away,33,13,168
9/24/2020,632,SSSeattle Storm,89,164,-110,SEA,Seattle Storm,-8,-115,1042000312,46,33,0,1,1,1,1,1,1,89,79,-10,79,-13,home,home,46,-13,168
9/24/2020,619,LVLas Vegas Aces,68,160.5,-110,LVA,Las Vegas Aces,-6,-110,1042000303,38,32,1,1,0,1,0,0,0,77,68,-9,70,-6,home,away,32,6,145
9/24/2020,620,CSConnecticut Sun,77,160.5,-110,CON,Connecticut Sun,6,-110,1042000303,38,32,0,0,1,0,1,1,1,77,68,-9,70,-6,home,home,38,-6,145
9/27/2020,623,LVLas Vegas Aces,84,156.5,-110,LVA,Las Vegas Aces,-2.5,-110,1042000304,38,37,1,1,0,0,0,0,1,75,84,9,75,-1,home,away,37,1,159
9/27/2020,624,CSConnecticut Sun,75,156.5,-110,CON,Connecticut Sun,2.5,-110,1042000304,38,37,0,0,1,1,1,1,0,75,84,9,75,-1,home,home,38,-1,159
9/27/2020,625,SSSeattle Storm,92,165,-110,SEA,Seattle Storm,-8.5,-105,1042000313,31,46,1,1,1,1,1,1,1,71,92,21,77,15,away,away,46,-15,163
9/27/2020,626,MLMinnesota Lynx,71,165,-110,MIN,Minnesota Lynx,8.5,-115,1042000313,31,46,0,0,0,0,0,0,0,71,92,21,77,15,away,home,31,15,163
9/29/2020,627,CSConnecticut Sun,63,157,-110,CON,Connecticut Sun,3,-110,1042000305,39,45,1,1,1,1,1,1,1,66,63,-3,84,6,away,away,45,-6,129
9/29/2020,628,LVLas Vegas Aces,66,157,-110,LVA,Las Vegas Aces,-2.5,-115,1042000305,39,45,0,0,0,0,0,0,0,66,63,-3,84,6,away,home,39,6,129
10/2/2020,601,SSSeattle Storm,93,164,-110,SEA,Seattle Storm,-6,-110,1042000401,40,57,0,1,1,0,0,1,1,80,93,13,97,17,away,away,57,-17,173
10/2/2020,602,LVLas Vegas Aces,80,164,-110,LVA,Las Vegas Aces,6,-110,1042000401,40,57,1,0,0,1,1,0,0,80,93,13,97,17,away,home,40,17,173
10/4/2020,603,SSSeattle Storm,104,167,-110,SEA,Seattle Storm,-7.5,-110,1042000402,42,48,1,1,1,1,1,1,1,91,104,13,90,6,away,away,48,-6,195
10/4/2020,604,LVLas Vegas Aces,91,167,-110,LVA,Las Vegas Aces,7,-105,1042000402,42,48,0,0,0,0,0,0,0,91,104,13,90,6,away,home,42,6,195
10/6/2020,605,LVLas Vegas Aces,59,171.5,-112,LVA,Las Vegas Aces,7.5,-110,1042000403,43,34,1,1,1,0,0,0,0,92,59,-33,77,-9,home,away,34,9,151
10/6/2020,606,SSSeattle Storm,92,171.5,-108,SEA,Seattle Storm,-7.5,-110,1042000403,43,34,0,0,0,1,1,1,1,92,59,-33,77,-9,home,home,43,-9,151
7/28/2020,663,WMWashington Mystics,94,166.5,-110,WAS,Washington Mystics,-3,-110,1022001007,52,48,1,1,1,1,1,1,1,89,94,5,100,-4,home,away,48,4,183
7/28/2020,664,CSConnecticut Sun,89,166.5,-110,CON,Connecticut Sun,3.5,-115,1022001007,52,48,0,0,0,0,0,0,0,89,94,5,100,-4,home,home,52,-4,183
7/28/2020,665,LSL.A. Sparks,78,172.5,-110,LAS,Los Angeles Sparks,-5.5,-110,1022001008,40,36,0,0,0,0,0,1,0,96,78,-18,76,-4,home,away,36,4,174
7/28/2020,666,CSChicago Sky,96,172.5,-110,CHI,Chicago Sky,5.5,-110,1022001008,40,36,1,1,1,1,1,0,1,96,78,-18,76,-4,home,home,40,-4,174
7/28/2020,667,MLMinnesota Lynx,66,156.5,-118,MIN,Minnesota Lynx,9.5,-105,1022001009,41,35,0,0,0,0,0,0,0,90,66,-24,76,-6,home,away,35,6,156
7/28/2020,668,SSSeattle Storm,90,156.5,-102,SEA,Seattle Storm,-9.5,-115,1022001009,41,35,1,1,1,1,1,1,1,90,66,-24,76,-6,home,home,41,-6,156
7/29/2020,669,PPhoenix,100,165,-115,PHO,Phoenix Mercury,-5,-110,1022001010,56,53,1,1,1,1,1,1,0,106,100,-6,109,-3,home,away,53,3,206
7/29/2020,670,IFIndiana Fever,106,165,-105,IND,Indiana Fever,5,-110,1022001010,56,53,0,0,0,0,0,0,1,106,100,-6,109,-3,home,home,56,-3,206
7/29/2020,671,NYNew York Liberty,80,166,-110,NYL,New York Liberty,4.5,-110,1022001011,58,43,1,0,0,0,0,0,0,93,80,-13,101,-15,home,away,43,15,173
7/29/2020,672,DWDallas Wings,93,166,-110,DAL,Dallas Wings,-4.5,-110,1022001011,58,43,0,1,1,1,1,1,1,93,80,-13,101,-15,home,home,58,-15,173
7/29/2020,673,ADAtlanta Dream,70,175,-110,ATL,Atlanta Dream,8,-110,1022001012,47,35,0,0,0,0,0,0,0,100,70,-30,82,-12,home,away,35,12,170
7/29/2020,674,LVLas Vegas Aces,100,175,-110,LVA,Las Vegas Aces,-8,-110,1022001012,47,35,1,1,1,1,1,1,1,100,70,-30,82,-12,home,home,47,-12,170
7/31/2020,681,NYNew York Liberty,78,168.5,-110,NYL,New York Liberty,5,-110,1022001016,41,43,0,0,0,0,0,0,1,84,78,-6,84,2,away,away,43,-2,162
7/31/2020,682,ADAtlanta Dream,84,168.5,-110,ATL,Atlanta Dream,-5,-110,1022001016,41,43,1,1,1,1,1,1,0,84,78,-6,84,2,away,home,41,2,162
7/31/2020,683,IFIndiana Fever,73,171.5,-110,IND,Indiana Fever,2.5,-110,1022001017,31,43,1,1,1,1,1,1,1,76,73,-3,74,12,away,away,43,-12,149
7/31/2020,684,DWDallas Wings,76,171.5,-110,DAL,Dallas Wings,-2.5,-110,1022001017,31,43,0,0,0,0,0,0,0,76,73,-3,74,12,away,home,31,12,149
7/31/2020,685,LVLas Vegas Aces,95,176,-108,LVA,Las Vegas Aces,-7,-110,1022001018,50,41,0,0,0,0,0,0,0,102,95,-7,91,-9,home,away,41,9,197
7/31/2020,686,PPhoenix,102,175.5,-110,PHO,Phoenix Mercury,7,-110,1022001018,50,41,1,1,1,1,1,1,1,102,95,-7,91,-9,home,home,50,-9,197
8/1/2020,601,MLMinnesota Lynx,78,156,-110,MIN,Minnesota Lynx,4,-112,1022001019,42,35,0,0,1,0,0,0,0,69,78,9,77,-7,home,away,35,7,147
8/1/2020,602,CSConnecticut Sun,69,156,-110,CON,Connecticut Sun,-3.5,-115,1022001019,42,35,1,1,0,1,1,1,1,69,78,9,77,-7,home,home,42,-7,147
8/1/2020,603,WMWashington Mystics,86,178,-115,WAS,Washington Mystics,-3.5,-115,1022001020,35,37,1,1,0,0,0,0,1,88,86,-2,72,2,away,away,37,-2,174
8/1/2020,604,CSChicago Sky,88,178,-110,CHI,Chicago Sky,3.5,-105,1022001020,35,37,0,0,1,1,1,1,0,88,86,-2,72,2,away,home,35,2,174
8/1/2020,605,LSL.A. Sparks,75,162.5,-110,LAS,Los Angeles Sparks,4.5,-115,1022001021,45,29,0,0,0,0,0,0,0,81,75,-6,74,-16,home,away,29,16,156
8/1/2020,606,SSSeattle Storm,81,162.5,-110,SEA,Seattle Storm,-4.5,-105,1022001021,45,29,1,1,1,1,1,1,1,81,75,-6,74,-16,home,home,45,-16,156
8/2/2020,607,PPhoenix,96,169.5,-115,PHO,Phoenix Mercury,-11,-110,1022001022,27,41,1,1,1,1,1,1,1,67,96,29,68,14,away,away,41,-14,163
8/2/2020,608,NYNew York Liberty,67,169.5,-110,NYL,New York Liberty,11,-110,1022001022,27,41,0,0,0,0,0,0,0,67,96,29,68,14,away,home,27,14,163
8/2/2020,609,ADAtlanta Dream,77,170,-110,ATL,Atlanta Dream,-1,-115,1022001023,47,39,1,0,0,0,0,0,0,93,77,-16,86,-8,home,away,39,8,170
8/2/2020,610,IFIndiana Fever,93,170,-110,IND,Indiana Fever,1,-110,1022001023,47,39,0,1,1,1,1,1,1,93,77,-16,86,-8,home,home,47,-8,170
8/2/2020,611,DWDallas Wings,70,171,-110,DAL,Dallas Wings,6.5,-110,1022001024,42,37,0,0,0,0,0,0,0,79,70,-9,79,-5,home,away,37,5,149
8/2/2020,612,LVLas Vegas Aces,79,171,-110,LVA,Las Vegas Aces,-6.5,-110,1022001024,42,37,1,1,1,1,1,1,1,79,70,-9,79,-5,home,home,42,-5,149
8/4/2020,613,DWDallas Wings,79,172,-110,DAL,Dallas Wings,6.5,-110,1022001025,43,42,0,0,1,1,0,0,0,82,79,-3,85,-1,home,away,42,1,161
8/4/2020,614,CSChicago Sky,82,172,-110,CHI,Chicago Sky,-6.5,-110,1022001025,43,42,1,1,0,0,1,1,1,82,79,-3,85,-1,home,home,43,-1,161
8/4/2020,615,PPhoenix,81,177.5,-110,PHO,Phoenix Mercury,-6,-115,1022001026,35,33,1,1,0,0,0,0,0,74,81,7,68,-2,home,away,33,2,155
8/4/2020,616,ADAtlanta Dream,74,177.5,-110,ATL,Atlanta Dream,6,-105,1022001026,35,33,0,0,1,1,1,1,1,74,81,7,68,-2,home,home,35,-2,155
8/4/2020,617,CSConnecticut Sun,74,156,-110,CON,Connecticut Sun,10.5,-110,1022001027,38,40,1,1,0,0,1,1,1,87,74,-13,78,2,away,away,40,-2,161
8/4/2020,618,SSSeattle Storm,87,156,-110,SEA,Seattle Storm,-10.5,-110,1022001027,38,40,0,0,1,1,0,0,0,87,74,-13,78,2,away,home,38,2,161
8/5/2020,619,MLMinnesota Lynx,92,157,-110,MIN,Minnesota Lynx,-5.5,-110,1022001028,39,44,0,1,1,1,1,1,1,66,92,26,83,5,away,away,44,-5,158
8/5/2020,620,NYNew York Liberty,66,157,-110,NYL,New York Liberty,5.5,-110,1022001028,39,44,1,0,0,0,0,0,0,66,92,26,83,5,away,home,39,5,158
8/5/2020,621,LVLas Vegas Aces,83,176,-110,LVA,Las Vegas Aces,2.5,-110,1022001029,37,35,0,0,0,0,0,0,0,77,83,6,72,-2,home,away,35,2,160
8/5/2020,622,WMWashington Mystics,77,176,-110,WAS,Washington Mystics,-2.5,-110,1022001029,37,35,1,1,1,1,1,1,1,77,83,6,72,-2,home,home,37,-2,160
8/5/2020,623,IFIndiana Fever,75,163.5,-110,IND,Indiana Fever,7.5,-110,1022001030,42,31,0,0,0,0,0,0,0,86,75,-11,73,-11,home,away,31,11,161
8/5/2020,624,LSL.A. Sparks,86,163.5,-110,LAS,Los Angeles Sparks,-8,-110,1022001030,42,31,1,1,1,1,1,1,1,86,75,-11,73,-11,home,home,42,-11,161
8/6/2020,625,SSSeattle Storm,93,157,-110,SEA,Seattle Storm,-11,-110,1022001031,39,54,0,1,1,1,1,1,1,92,93,1,93,15,away,away,54,-15,185
8/6/2020,626,ADAtlanta Dream,92,157,-110,ATL,Atlanta Dream,11,-110,1022001031,39,54,1,0,0,0,0,0,0,92,93,1,93,15,away,home,39,15,185
8/6/2020,627,CSConnecticut Sun,91,160,-110,CON,Connecticut Sun,-3.5,-110,1022001032,31,43,1,1,1,1,1,1,1,68,91,23,74,12,away,away,43,-12,159
8/6/2020,628,DWDallas Wings,68,160,-110,DAL,Dallas Wings,3.5,-110,1022001032,31,43,0,0,0,0,0,0,0,68,91,23,74,12,away,home,31,12,159
8/6/2020,629,CSChicago Sky,86,176.5,-110,CHI,Chicago Sky,-4.5,-110,1022001033,55,49,1,1,0,0,0,0,0,96,86,-10,104,-6,home,away,49,6,182
8/6/2020,630,PPhoenix,96,176.5,-110,PHO,Phoenix Mercury,4.5,-110,1022001033,55,49,0,0,1,1,1,1,1,96,86,-10,104,-6,home,home,55,-6,182
8/7/2020,631,IFIndiana Fever,80,158.5,-110,IND,Indiana Fever,5,-105,1022001034,41,34,0,1,1,1,0,0,0,87,80,-7,75,-7,home,away,34,7,167
8/7/2020,632,MLMinnesota Lynx,87,158,-115,MIN,Minnesota Lynx,-5,-115,1022001034,41,34,1,0,0,0,1,1,1,87,80,-7,75,-7,home,home,41,-7,167
8/7/2020,633,NYNew York Liberty,74,167,-110,NYL,New York Liberty,16.5,-110,1022001035,31,40,0,1,1,1,1,1,1,66,74,8,71,9,away,away,40,-9,140
8/7/2020,634,WMWashington Mystics,66,167,-110,WAS,Washington Mystics,-16.5,-110,1022001035,31,40,1,0,0,0,0,0,0,66,74,8,71,9,away,home,31,9,140
8/7/2020,635,LSL.A. Sparks,82,166,-110,LAS,Los Angeles Sparks,5,-115,1022001036,43,42,0,0,0,0,0,0,0,86,82,-4,85,-1,home,away,42,1,168
8/7/2020,636,LVLas Vegas Aces,86,166,-110,LVA,Las Vegas Aces,-5,-105,1022001036,43,42,1,1,1,1,1,1,1,86,82,-4,85,-1,home,home,43,-1,168
8/8/2020,637,ADAtlanta Dream,75,167,-110,ATL,Atlanta Dream,1.5,-110,1022001037,41,42,0,0,0,0,1,1,1,85,75,-10,83,1,away,away,42,-1,160
8/8/2020,638,DWDallas Wings,85,165.5,-110,DAL,Dallas Wings,-1.5,-110,1022001037,41,42,1,1,1,1,0,0,0,85,75,-10,83,1,away,home,41,1,160
8/8/2020,639,PPhoenix,68,166.5,-110,PHO,Phoenix Mercury,5,-110,1022001038,42,23,1,1,0,0,0,0,0,74,68,-6,65,-19,home,away,23,19,142
8/8/2020,640,SSSeattle Storm,74,166.5,-110,SEA,Seattle Storm,-5,-110,1022001038,42,23,0,0,1,1,1,1,1,74,68,-6,65,-19,home,home,42,-19,142
8/8/2020,641,CSChicago Sky,100,168.5,-110,CHI,Chicago Sky,-2.5,-115,1022001039,46,52,1,1,1,1,1,1,1,93,100,7,98,6,away,away,52,-6,193
8/8/2020,642,CSConnecticut Sun,93,167,-115,CON,Connecticut Sun,2.5,-105,1022001039,46,52,0,0,0,0,0,0,0,93,100,7,98,6,away,home,46,6,193
8/9/2020,647,MLMinnesota Lynx,81,152,-110,MIN,Minnesota Lynx,8,-110,1022001042,48,38,0,0,0,0,0,0,0,97,81,-16,86,-10,home,away,38,10,178
8/9/2020,648,LSL.A. Sparks,97,152,-110,LAS,Los Angeles Sparks,-8,-110,1022001042,48,38,1,1,1,1,1,1,1,97,81,-16,86,-10,home,home,48,-10,178
8/9/2020,643,LVLas Vegas Aces,78,164,-110,LVA,Las Vegas Aces,-13.5,-110,1022001040,44,37,0,0,0,0,1,0,0,76,78,2,81,-7,home,away,37,7,154
8/9/2020,644,NYNew York Liberty,76,164,-110,NYL,New York Liberty,13.5,-110,1022001040,44,37,1,1,1,1,0,1,1,76,78,2,81,-7,home,home,44,-7,154
8/9/2020,645,WMWashington Mystics,84,167.5,-110,WAS,Washington Mystics,-4,-110,1022001041,52,39,1,0,1,1,1,1,0,91,84,-7,91,-13,home,away,39,13,175
8/9/2020,646,IFIndiana Fever,91,167.5,-110,IND,Indiana Fever,4,-110,1022001041,52,39,0,1,0,0,0,0,1,91,84,-7,91,-13,home,home,52,-13,175
8/10/2020,649,CSConnecticut Sun,93,166,-110,CON,Connecticut Sun,-5,-110,1022001043,46,56,0,0,1,0,1,1,1,82,93,11,102,10,away,away,56,-10,175
8/10/2020,650,ADAtlanta Dream,82,166,-110,ATL,Atlanta Dream,5,-115,1022001043,46,56,1,1,0,1,0,0,0,82,93,11,102,10,away,home,46,10,175
8/10/2020,651,PPhoenix,91,165.5,-110,PHO,Phoenix Mercury,-3.5,-110,1022001044,38,44,0,0,0,1,1,1,1,79,91,12,82,6,away,away,44,-6,170
8/10/2020,652,DWDallas Wings,79,165,-110,DAL,Dallas Wings,3.5,-110,1022001044,38,44,1,1,1,0,0,0,0,79,91,12,82,6,away,home,38,6,170
8/10/2020,653,CSChicago Sky,71,170,-110,CHI,Chicago Sky,4.5,-110,1022001045,46,28,0,0,0,0,0,0,0,89,71,-18,74,-18,home,away,28,18,160
8/10/2020,654,SSSeattle Storm,89,170,-110,SEA,Seattle Storm,-4.5,-110,1022001045,46,28,1,1,1,1,1,1,1,89,71,-18,74,-18,home,home,46,-18,160
8/11/2020,657,LVLas Vegas Aces,98,167.5,-110,LVA,Las Vegas Aces,-6.5,-110,1022001047,59,60,0,1,1,1,1,1,1,79,98,19,119,1,away,away,60,-1,177
8/11/2020,658,IFIndiana Fever,79,167.5,-110,IND,Indiana Fever,6.5,-110,1022001047,59,60,1,0,0,0,0,0,0,79,98,19,119,1,away,home,59,1,177
8/11/2020,655,WMWashington Mystics,48,160.5,-110,WAS,Washington Mystics,-1.5,-110,1022001046,48,27,0,0,0,0,0,0,0,68,48,-20,75,-21,home,away,27,21,116
8/11/2020,656,MLMinnesota Lynx,68,160.5,-110,MIN,Minnesota Lynx,1.5,-110,1022001046,48,27,1,1,1,1,1,1,1,68,48,-20,75,-21,home,home,48,-21,116
8/11/2020,659,NYNew York Liberty,78,160.5,-110,NYL,New York Liberty,13,-110,1022001048,51,34,0,0,0,0,0,0,0,93,78,-15,85,-17,home,away,34,17,171
8/11/2020,660,LSL.A. Sparks,93,160.5,-110,LAS,Los Angeles Sparks,-13,-110,1022001048,51,34,1,1,1,1,1,1,1,93,78,-15,85,-17,home,home,51,-17,171
8/12/2020,661,DWDallas Wings,66,161.5,-110,DAL,Dallas Wings,4.5,-105,1022001049,25,34,1,1,1,1,1,1,1,70,66,-4,59,9,away,away,34,-9,136
8/12/2020,662,CSConnecticut Sun,70,161.5,-110,CON,Connecticut Sun,-4.5,-115,1022001049,25,34,0,0,0,0,0,0,0,70,66,-4,59,9,away,home,25,9,136
8/12/2020,663,PPhoenix,71,175.5,-115,PHO,Phoenix Mercury,5.5,-115,1022001050,42,36,1,0,0,0,0,0,0,89,71,-18,78,-6,home,away,36,6,160
8/12/2020,664,CSChicago Sky,89,175,103,CHI,Chicago Sky,-5.5,-110,1022001050,42,36,0,1,1,1,1,1,1,89,71,-18,78,-6,home,home,42,-6,160
8/12/2020,665,ADAtlanta Dream,63,159,-110,ATL,Atlanta Dream,13.5,-110,1022001051,47,28,0,0,0,0,0,0,0,100,63,-37,75,-19,home,away,28,19,163
8/12/2020,666,SSSeattle Storm,100,159,-110,SEA,Seattle Storm,-14,-110,1022001051,47,28,1,1,1,1,1,1,1,100,63,-37,75,-19,home,home,47,-19,163
8/13/2020,667,IFIndiana Fever,86,163.5,-110,IND,Indiana Fever,-7,-105,1022001052,40,51,0,1,1,1,1,1,1,79,86,7,91,11,away,away,51,-11,165
8/13/2020,668,NYNew York Liberty,79,163.5,-110,NYL,New York Liberty,7,-115,1022001052,40,51,1,0,0,0,0,0,0,79,86,7,91,11,away,home,40,11,165
8/13/2020,669,LSL.A. Sparks,81,162,-110,LAS,Los Angeles Sparks,-7.5,-115,1022001053,34,47,1,1,1,1,1,1,1,64,81,17,81,13,away,away,47,-13,145
8/13/2020,670,WMWashington Mystics,64,162,-110,WAS,Washington Mystics,7.5,-105,1022001053,34,47,0,0,0,0,0,0,0,64,81,17,81,13,away,home,34,13,145
8/13/2020,671,MLMinnesota Lynx,77,158.5,-115,MIN,Minnesota Lynx,3.5,-110,1022001054,53,37,1,1,1,0,0,0,0,87,77,-10,90,-16,home,away,37,16,164
8/13/2020,672,LVLas Vegas Aces,87,158.5,-105,LVA,Las Vegas Aces,-3.5,-110,1022001054,53,37,0,0,0,1,1,1,1,87,77,-10,90,-16,home,home,53,-16,164
8/14/2020,673,CSConnecticut Sun,77,168,-115,CON,Connecticut Sun,6,-118,1022001055,28,37,0,0,0,1,1,1,1,74,77,3,65,9,away,away,37,-9,151
8/14/2020,674,CSChicago Sky,74,168,-110,CHI,Chicago Sky,-6,-105,1022001055,28,37,1,1,1,0,0,0,0,74,77,3,65,9,away,home,28,9,151
8/14/2020,675,SSSeattle Storm,83,157,-110,SEA,Seattle Storm,-13.5,-110,1022001056,31,44,1,1,1,1,1,1,1,65,83,18,75,13,away,away,44,-13,148
8/14/2020,676,DWDallas Wings,65,157,-110,DAL,Dallas Wings,13.5,-110,1022001056,31,44,0,0,0,0,0,0,0,65,83,18,75,13,away,home,31,13,148
8/14/2020,677,ADAtlanta Dream,80,166.5,-108,ATL,Atlanta Dream,9,-110,1022001057,44,34,0,0,0,0,0,0,0,96,80,-16,78,-10,home,away,34,10,176
8/14/2020,678,PPhoenix,96,166.5,-112,PHO,Phoenix Mercury,-9,-110,1022001057,44,34,1,1,1,1,1,1,1,96,80,-16,78,-10,home,home,44,-10,176
8/15/2020,683,WMWashington Mystics,73,162,-110,WAS,Washington Mystics,9,-108,1022001060,43,31,1,0,0,0,0,0,0,88,73,-15,74,-12,home,away,31,12,161
8/15/2020,684,LVLas Vegas Aces,88,162,-110,LVA,Las Vegas Aces,-9.5,-110,1022001060,43,31,0,1,1,1,1,1,1,88,73,-15,74,-12,home,home,43,-12,161
8/15/2020,679,LSL.A. Sparks,90,167,-110,LAS,Los Angeles Sparks,-8,-110,1022001058,32,52,1,1,1,1,1,1,1,76,90,14,84,20,away,away,52,-20,166
8/15/2020,680,IFIndiana Fever,76,167,-110,IND,Indiana Fever,8,-110,1022001058,32,52,0,0,0,0,0,0,0,76,90,14,84,20,away,home,32,20,166
8/15/2020,681,NYNew York Liberty,64,154.5,-110,NYL,New York Liberty,7.5,-112,1022001059,42,33,1,1,0,0,0,0,0,94,64,-30,75,-9,home,away,33,9,158
8/15/2020,682,MLMinnesota Lynx,94,154.5,-110,MIN,Minnesota Lynx,-7.5,-108,1022001059,42,33,0,0,1,1,1,1,1,94,64,-30,75,-9,home,home,42,-9,158
8/16/2020,605,DWDallas Wings,95,164.5,-110,DAL,Dallas Wings,9,-110,1022001063,44,44,0,1,1,1,0,0,1,89,95,6,88,0,tie,away,44,-0,184
8/16/2020,606,PPhoenix,89,164.5,-110,PHO,Phoenix Mercury,-9,-110,1022001063,44,44,1,0,0,0,1,1,0,89,95,6,88,0,tie,home,44,0,184
8/16/2020,603,SSSeattle Storm,95,156,-110,SEA,Seattle Storm,-9.5,-110,1022001062,33,42,1,1,1,1,1,1,1,72,95,23,75,9,away,away,42,-9,167
8/16/2020,604,CSConnecticut Sun,72,156,-110,CON,Connecticut Sun,9.5,-110,1022001062,33,42,0,0,0,0,0,0,0,72,95,23,75,9,away,home,33,9,167
8/16/2020,601,CSChicago Sky,92,167.5,-110,CHI,Chicago Sky,-11.5,-115,1022001061,37,46,0,1,1,1,1,1,1,67,92,25,83,9,away,away,46,-9,159
8/16/2020,602,ADAtlanta Dream,67,167.5,-110,ATL,Atlanta Dream,11.5,-115,1022001061,37,46,1,0,0,0,0,0,0,67,92,25,83,9,away,home,37,9,159
8/20/2020,619,CSChicago Sky,101,166,-115,CHI,Chicago Sky,-15.5,-110,1022001070,44,57,0,1,1,1,1,1,1,85,101,16,101,13,away,away,57,-13,186
8/20/2020,620,NYNew York Liberty,85,166,-110,NYL,New York Liberty,15.5,-110,1022001070,44,57,1,0,0,0,0,0,0,85,101,16,101,13,away,home,44,13,186
8/20/2020,621,SSSeattle Storm,84,163,-110,SEA,Seattle Storm,-17,-112,1022001071,44,41,0,1,1,0,0,0,0,90,84,-6,85,-3,home,away,41,3,174
8/20/2020,622,IFIndiana Fever,90,163,-110,IND,Indiana Fever,17,-108,1022001071,44,41,1,0,0,1,1,1,1,90,84,-6,85,-3,home,home,44,-3,174
8/20/2020,623,CSConnecticut Sun,78,162.5,-110,CON,Connecticut Sun,6.5,-110,1022001072,53,42,1,1,1,1,0,0,0,99,78,-21,95,-11,home,away,42,11,177
8/20/2020,624,LVLas Vegas Aces,99,162.5,-110,LVA,Las Vegas Aces,-6.5,-110,1022001072,53,42,0,0,0,0,1,1,1,99,78,-21,95,-11,home,home,53,-11,177
8/22/2020,635,SSSeattle Storm,74,164.5,-115,SEA,Seattle Storm,-5,-110,1022001078,45,29,1,1,0,0,0,0,0,82,74,-8,74,-16,home,away,29,16,156
8/22/2020,636,LVLas Vegas Aces,82,165.5,-110,LVA,Las Vegas Aces,5,-110,1022001078,45,29,0,0,1,1,1,1,1,82,74,-8,74,-16,home,home,45,-16,156
8/22/2020,631,IFIndiana Fever,76,169.5,-105,IND,Indiana Fever,9,-105,1022001076,43,34,0,0,0,0,0,0,0,87,76,-11,77,-9,home,away,34,9,163
8/22/2020,632,CSChicago Sky,87,169.5,-115,CHI,Chicago Sky,-9,-115,1022001076,43,34,1,1,1,1,1,1,1,87,76,-11,77,-9,home,home,43,-9,163
8/22/2020,633,NYNew York Liberty,65,163,-115,NYL,New York Liberty,12,-110,1022001077,45,38,0,0,0,0,0,0,0,82,65,-17,83,-7,home,away,38,7,147
8/22/2020,634,CSConnecticut Sun,82,163,-110,CON,Connecticut Sun,-12,-110,1022001077,45,38,1,1,1,1,1,1,1,82,65,-17,83,-7,home,home,45,-7,147
8/25/2020,643,NYNew York Liberty,101,169,-115,NYL,New York Liberty,18,-115,1022001082,49,46,0,0,0,0,0,0,0,99,101,2,95,-3,home,away,46,3,200
8/25/2020,644,CSChicago Sky,99,169.5,-110,CHI,Chicago Sky,-17.5,-110,1022001082,49,46,1,1,1,1,1,1,1,99,101,2,95,-3,home,home,49,-3,200
8/25/2020,645,LVLas Vegas Aces,96,167.5,-110,LVA,Las Vegas Aces,-9.5,-110,1022001083,43,52,0,0,0,1,1,1,1,92,96,4,95,9,away,away,52,-9,188
8/25/2020,646,DWDallas Wings,92,167.5,-110,DAL,Dallas Wings,9.5,-110,1022001083,43,52,1,1,1,0,0,0,0,92,96,4,95,9,away,home,43,9,188
8/25/2020,647,IFIndiana Fever,74,164.5,-105,IND,Indiana Fever,15,-110,1022001084,46,35,1,1,1,1,0,0,0,87,74,-13,81,-11,home,away,35,11,161
8/25/2020,648,SSSeattle Storm,87,164.5,-115,SEA,Seattle Storm,-15,-110,1022001084,46,35,0,0,0,0,1,1,1,87,74,-13,81,-11,home,home,46,-11,161
8/28/2020,661,MLMinnesota Lynx,88,161.5,-110,MIN,Minnesota Lynx,-7,-125,1022001091,43,51,1,1,1,1,1,1,1,79,88,9,94,8,away,away,51,-8,167
8/28/2020,662,ADAtlanta Dream,79,161.5,-110,ATL,Atlanta Dream,7,105,1022001091,43,51,0,0,0,0,0,0,0,79,88,9,94,8,away,home,43,8,167
8/28/2020,663,LSL.A. Sparks,80,159,-110,LAS,Los Angeles Sparks,-5.5,-110,1022001092,39,32,0,1,0,1,0,0,0,76,80,4,71,-7,home,away,32,7,156
8/28/2020,664,CSConnecticut Sun,76,159,-110,CON,Connecticut Sun,5.5,-110,1022001092,39,32,1,0,1,0,1,1,1,76,80,4,71,-7,home,home,39,-7,156
8/28/2020,665,WMWashington Mystics,72,169.5,100,WAS,Washington Mystics,2.5,-109,1022001093,33,41,0,0,1,1,1,1,1,94,72,-22,74,8,away,away,41,-8,166
8/28/2020,666,PPhoenix,94,169.5,-120,PHO,Phoenix Mercury,-2.5,-111,1022001093,33,41,1,1,0,0,0,0,0,94,72,-22,74,8,away,home,33,8,166
8/29/2020,671,NYNew York Liberty,63,169,-110,NYL,New York Liberty,16.5,-110,1022001096,39,35,0,0,0,1,0,0,0,80,63,-17,74,-4,home,away,35,4,143
8/29/2020,672,LVLas Vegas Aces,80,169,-110,LVA,Las Vegas Aces,-16.5,-110,1022001096,39,35,1,1,1,0,1,1,1,80,63,-17,74,-4,home,home,39,-4,143
8/29/2020,669,SSSeattle Storm,88,167,-110,SEA,Seattle Storm,-6,-110,1022001095,34,49,1,1,1,1,1,1,1,74,88,14,83,15,away,away,49,-15,162
8/29/2020,670,CSChicago Sky,74,167,-110,CHI,Chicago Sky,6,-110,1022001095,34,49,0,0,0,0,0,0,0,74,88,14,83,15,away,home,34,15,162
8/29/2020,667,DWDallas Wings,82,167.5,-110,DAL,Dallas Wings,-2,-105,1022001094,37,44,1,1,1,1,1,1,1,78,82,4,81,7,away,away,44,-7,160
8/29/2020,668,IFIndiana Fever,78,167.5,-110,IND,Indiana Fever,2,-115,1022001094,37,44,0,0,0,0,0,0,0,78,82,4,81,7,away,home,37,7,160
8/30/2020,673,CSConnecticut Sun,76,161,-110,CON,Connecticut Sun,-7,-110,1022001097,28,39,1,1,1,1,1,1,1,63,76,13,67,11,away,away,39,-11,139
8/30/2020,674,WMWashington Mystics,63,161,-110,WAS,Washington Mystics,7,-110,1022001097,28,39,0,0,0,0,0,0,0,63,76,13,67,11,away,home,28,11,139
8/30/2020,675,PPhoenix,83,164.5,-110,PHO,Phoenix Mercury,4.5,-110,1022001098,36,51,1,1,1,1,1,1,1,79,83,4,87,15,away,away,51,-15,162
8/30/2020,676,MLMinnesota Lynx,79,164.5,-110,MIN,Minnesota Lynx,-4.5,-110,1022001098,36,51,0,0,0,0,0,0,0,79,83,4,87,15,away,home,36,15,162
8/30/2020,677,ADAtlanta Dream,79,164,-110,ATL,Atlanta Dream,13.5,-110,1022001099,37,38,1,0,1,0,1,1,0,84,79,-5,75,1,away,away,38,-1,163
8/30/2020,678,LSL.A. Sparks,84,164,-110,LAS,Los Angeles Sparks,-13.5,-110,1022001099,37,38,0,1,0,1,0,0,1,84,79,-5,75,1,away,home,37,1,163
9/1/2020,679,CSConnecticut Sun,70,156.5,-110,CON,Connecticut Sun,-11.5,-105,1022001100,32,29,1,1,1,0,0,1,1,65,70,5,61,-3,home,away,29,3,135
9/1/2020,680,NYNew York Liberty,65,156.5,-110,NYL,New York Liberty,11.5,-115,1022001100,32,29,0,0,0,1,1,0,0,65,70,5,61,-3,home,home,32,-3,135
9/1/2020,681,IFIndiana Fever,90,167,-110,IND,Indiana Fever,1.5,-105,1022001101,43,38,1,0,1,0,0,0,0,102,90,-12,81,-5,home,away,38,5,192
9/1/2020,682,ADAtlanta Dream,102,167,-110,ATL,Atlanta Dream,-1.5,-115,1022001101,43,38,0,1,0,1,1,1,1,102,90,-12,81,-5,home,home,43,-5,192
9/1/2020,683,PPhoenix,92,170.5,-110,PHO,Phoenix Mercury,8.5,-110,1022001102,45,52,1,1,1,1,1,1,1,85,92,7,97,7,away,away,52,-7,177
9/1/2020,684,LVLas Vegas Aces,85,170,-110,LVA,Las Vegas Aces,-8.5,-110,1022001102,45,52,0,0,0,0,0,0,0,85,92,7,97,7,away,home,45,7,177
9/2/2020,601,MLMinnesota Lynx,86,167.5,-110,MIN,Minnesota Lynx,3,-105,1022001103,40,50,1,1,1,1,1,1,1,83,86,3,90,10,away,away,50,-10,169
9/2/2020,602,CSChicago Sky,83,167.5,-110,CHI,Chicago Sky,-3,-115,1022001103,40,50,0,0,0,0,0,0,0,83,86,3,90,10,away,home,40,10,169
9/2/2020,603,LSL.A. Sparks,91,164,-110,LAS,Los Angeles Sparks,-6.5,-105,1022001104,39,48,0,0,0,0,0,1,1,83,91,8,87,9,away,away,48,-9,174
9/2/2020,604,DWDallas Wings,83,164,-110,DAL,Dallas Wings,6.5,-115,1022001104,39,48,1,1,1,1,1,0,0,83,91,8,87,9,away,home,39,9,174
9/2/2020,605,WMWashington Mystics,64,160,-110,WAS,Washington Mystics,15,-110,1022001105,38,30,0,0,0,0,0,0,0,71,64,-7,68,-8,home,away,30,8,135
9/2/2020,606,SSSeattle Storm,71,160,-110,SEA,Seattle Storm,-15,-110,1022001105,38,30,1,1,1,1,1,1,1,71,64,-7,68,-8,home,home,38,-8,135
9/3/2020,607,ADAtlanta Dream,62,165.5,-110,ATL,Atlanta Dream,-6.5,-110,1022001106,29,31,0,0,0,1,1,1,1,56,62,6,60,2,away,away,31,-2,118
9/3/2020,608,NYNew York Liberty,56,165.5,-110,NYL,New York Liberty,6.5,-110,1022001106,29,31,1,1,1,0,0,0,0,56,62,6,60,2,away,home,29,2,118
9/3/2020,609,LVLas Vegas Aces,93,159.5,-110,LVA,Las Vegas Aces,-9,-110,1022001107,36,43,0,1,1,1,1,1,1,78,93,15,79,7,away,away,43,-7,171
9/3/2020,610,CSConnecticut Sun,78,159.5,-110,CON,Connecticut Sun,9,-110,1022001107,36,43,1,0,0,0,0,0,0,78,93,15,79,7,away,home,36,7,171
9/3/2020,611,IFIndiana Fever,81,173.5,-110,IND,Indiana Fever,7,-105,1022001108,54,46,0,0,0,0,0,0,0,105,81,-24,100,-8,home,away,46,8,186
9/3/2020,612,PPhoenix,105,173.5,-110,PHO,Phoenix Mercury,-7,-115,1022001108,54,46,1,1,1,1,1,1,1,105,81,-24,100,-8,home,home,54,-8,186
9/4/2020,613,CSChicago Sky,69,165.5,-112,CHI,Chicago Sky,-8.5,-110,1022001109,45,40,0,0,0,0,0,0,0,79,69,-10,85,-5,home,away,40,5,148
9/4/2020,614,WMWashington Mystics,79,165.5,-110,WAS,Washington Mystics,8.5,-110,1022001109,45,40,1,1,1,1,1,1,1,79,69,-10,85,-5,home,home,45,-5,148
9/4/2020,615,MLMinnesota Lynx,88,165.5,-110,MIN,Minnesota Lynx,-4,-110,1022001110,49,41,1,1,1,1,0,0,0,75,88,13,90,-8,home,away,41,8,163
9/4/2020,616,DWDallas Wings,75,165,-104,DAL,Dallas Wings,4,-110,1022001110,49,41,0,0,0,0,1,1,1,75,88,13,90,-8,home,home,49,-8,163
9/4/2020,617,SSSeattle Storm,90,161,-120,SEA,Seattle Storm,-6.5,-115,1022001111,49,45,0,0,0,0,0,0,0,89,90,1,94,-4,home,away,45,4,179
9/4/2020,618,LSL.A. Sparks,89,161,100,LAS,Los Angeles Sparks,6.5,-105,1022001111,49,45,1,1,1,1,1,1,1,89,90,1,94,-4,home,home,49,-4,179
9/5/2020,619,CSConnecticut Sun,96,160.5,-110,CON,Connecticut Sun,-7,-110,1022001112,37,47,1,1,1,1,1,1,1,77,96,19,84,10,away,away,47,-10,173
9/5/2020,620,IFIndiana Fever,77,160.5,-110,IND,Indiana Fever,7,-110,1022001112,37,47,0,0,0,0,0,0,0,77,96,19,84,10,away,home,37,10,173
9/5/2020,621,LVLas Vegas Aces,89,170,-110,LVA,Las Vegas Aces,-10.5,-110,1022001113,44,45,0,0,0,0,1,0,0,79,89,10,89,1,away,away,45,-1,168
9/5/2020,622,ADAtlanta Dream,79,170,-110,ATL,Atlanta Dream,10.5,-110,1022001113,44,45,1,1,1,1,0,1,1,79,89,10,89,1,away,home,44,1,168
9/5/2020,623,NYNew York Liberty,67,167.5,-108,NYL,New York Liberty,12.5,-105,1022001114,45,38,0,0,0,1,1,0,0,83,67,-16,83,-7,home,away,38,7,150
9/5/2020,624,PPhoenix,83,167.5,-112,PHO,Phoenix Mercury,-12.5,-115,1022001114,45,38,1,1,1,0,0,1,1,83,67,-16,83,-7,home,home,45,-7,150
9/6/2020,625,DWDallas Wings,101,161,-110,DAL,Dallas Wings,1,-110,1022001115,44,38,1,1,1,1,1,0,0,94,101,7,82,-6,home,away,38,6,195
9/6/2020,626,WMWashington Mystics,94,161,-110,WAS,Washington Mystics,-1,-110,1022001115,44,38,0,0,0,0,0,1,1,94,101,7,82,-6,home,home,44,-6,195
9/6/2020,627,SSSeattle Storm,103,161.5,-110,SEA,Seattle Storm,-7,-110,1022001116,38,45,0,1,1,1,1,1,1,88,103,15,83,7,away,away,45,-7,191
9/6/2020,628,MLMinnesota Lynx,88,161.5,-110,MIN,Minnesota Lynx,7,-110,1022001116,38,45,1,0,0,0,0,0,0,88,103,15,83,7,away,home,38,7,191
9/6/2020,629,CSChicago Sky,80,170,-105,CHI,Chicago Sky,5,100,1022001117,47,48,1,1,1,1,1,1,1,86,80,-6,95,1,away,away,48,-1,166
9/6/2020,630,LSL.A. Sparks,86,170,-115,LAS,Los Angeles Sparks,-5,-120,1022001117,47,48,0,0,0,0,0,0,0,86,80,-6,95,1,away,home,47,1,166
9/8/2020,631,LSL.A. Sparks,96,160,-110,LAS,Los Angeles Sparks,-13.5,-108,1022001118,31,42,1,1,1,1,1,1,1,70,96,26,73,11,away,away,42,-11,166
9/8/2020,632,NYNew York Liberty,70,160,-110,NYL,New York Liberty,13.5,-112,1022001118,31,42,0,0,0,0,0,0,0,70,96,26,73,11,away,home,31,11,166
9/8/2020,633,MLMinnesota Lynx,86,158.5,-110,MIN,Minnesota Lynx,-8,-110,1022001119,48,41,0,0,0,0,0,0,0,89,86,-3,89,-7,home,away,41,7,175
9/8/2020,634,WMWashington Mystics,89,158.5,-110,WAS,Washington Mystics,8,-110,1022001119,48,41,1,1,1,1,1,1,1,89,86,-3,89,-7,home,home,48,-7,175
9/8/2020,635,IFIndiana Fever,86,172.5,-110,IND,Indiana Fever,14.5,-110,1022001120,58,41,0,0,0,0,0,0,0,92,86,-6,99,-17,home,away,41,17,178
9/8/2020,636,LVLas Vegas Aces,92,172.5,-110,LVA,Las Vegas Aces,-14.5,-110,1022001120,58,41,1,1,1,1,1,1,1,92,86,-6,99,-17,home,home,58,-17,178
9/9/2020,637,PPhoenix,100,161.5,-110,PHO,Phoenix Mercury,-4,-105,1022001121,31,51,1,1,1,1,1,1,1,95,100,5,82,20,away,away,51,-20,195
9/9/2020,638,CSConnecticut Sun,95,161.5,-110,CON,Connecticut Sun,4,-115,1022001121,31,51,0,0,0,0,0,0,0,95,100,5,82,20,away,home,31,20,195
9/9/2020,639,ADAtlanta Dream,97,169.5,-110,ATL,Atlanta Dream,7.5,-110,1022001122,55,45,1,0,0,0,0,0,0,89,97,8,100,-10,home,away,45,10,186
9/9/2020,640,CSChicago Sky,89,169.5,-110,CHI,Chicago Sky,-7.5,-110,1022001122,55,45,0,1,1,1,1,1,1,89,97,8,100,-10,home,home,55,-10,186
9/9/2020,641,DWDallas Wings,95,166,-110,DAL,Dallas Wings,12.5,-105,1022001123,55,54,1,1,1,1,0,0,1,107,95,-12,109,-1,home,away,54,1,202
9/9/2020,642,SSSeattle Storm,107,166,-110,SEA,Seattle Storm,-12.5,-115,1022001123,55,54,0,0,0,0,1,1,0,107,95,-12,109,-1,home,home,55,-1,202
9/10/2020,643,NYNew York Liberty,75,165,-110,NYL,New York Liberty,5.5,-112,1022001124,46,42,1,1,1,1,0,0,0,85,75,-10,88,-4,home,away,42,4,160
9/10/2020,644,IFIndiana Fever,85,165,-110,IND,Indiana Fever,-5.5,-108,1022001124,46,42,0,0,0,0,1,1,1,85,75,-10,88,-4,home,home,46,-4,160
9/10/2020,645,LVLas Vegas Aces,104,165.5,-115,LVA,Las Vegas Aces,-5.5,-110,1022001125,54,56,1,0,1,1,0,0,1,89,104,15,110,2,away,away,56,-2,193
9/10/2020,646,MLMinnesota Lynx,89,165.5,-105,MIN,Minnesota Lynx,5.5,-110,1022001125,54,56,0,1,0,0,1,1,0,89,104,15,110,2,away,home,54,2,193
9/10/2020,647,WMWashington Mystics,80,161.5,-115,WAS,Washington Mystics,7.5,-110,1022001126,45,39,0,0,0,1,1,1,0,72,80,8,84,-6,home,away,39,6,152
9/10/2020,648,LSL.A. Sparks,72,161.5,-110,LAS,Los Angeles Sparks,-7.5,-110,1022001126,45,39,1,1,1,0,0,0,1,72,80,8,84,-6,home,home,45,-6,152
9/12/2020,655,WMWashington Mystics,75,156,-110,WAS,Washington Mystics,-8,-110,1022001130,29,36,1,1,1,1,1,1,1,58,75,17,65,7,away,away,36,-7,133
9/12/2020,656,NYNew York Liberty,58,156,-110,NYL,New York Liberty,8,-110,1022001130,29,36,0,0,0,0,0,0,0,58,75,17,65,7,away,home,29,7,133
9/12/2020,659,LVLas Vegas Aces,84,168,-110,LVA,Las Vegas Aces,-4,-110,1022001132,35,43,1,1,1,1,1,1,1,70,84,14,78,8,away,away,43,-8,154
9/12/2020,660,LSL.A. Sparks,70,168,-110,LAS,Los Angeles Sparks,4,-110,1022001132,35,43,0,0,0,0,0,0,0,70,84,14,78,8,away,home,35,8,154
9/12/2020,657,MLMinnesota Lynx,98,168,-110,MIN,Minnesota Lynx,-5,-110,1022001131,48,49,1,1,1,1,1,1,1,86,98,12,97,1,away,away,49,-1,184
9/12/2020,658,IFIndiana Fever,86,168,-110,IND,Indiana Fever,5,-110,1022001131,48,49,0,0,0,0,0,0,0,86,98,12,97,1,away,home,48,1,184
9/13/2021,615,DDallas,75,164,-110,DAL,Dallas Wings,10.5,-110,1022100180,36,45,1,1,1,1,1,1,1,85,75,-10,81,9,away,away,45,-9,160
9/13/2021,616,LVLas Vegas,85,164,-110,LVA,Las Vegas Aces,-10.5,-110,1022100180,36,45,0,0,0,0,0,0,0,85,75,-10,81,9,away,home,36,9,160
9/15/2021,619,NYNew York,69,147,-110,NYL,New York Liberty,13,-110,1022100182,98,69,1,1,1,1,0,1,0,98,69,-29,167,-29,home,away,69,29,167
9/15/2021,620,CConnecticut,98,147,-110,CON,Connecticut Sun,-13,-110,1022100182,98,69,0,0,0,0,1,0,1,98,69,-29,167,-29,home,home,98,-29,167
9/17/2021,623,WWashington,80,163,-110,WAS,Washington Mystics,-1.5,-115,1022100185,46,29,0,0,0,0,0,0,0,91,80,-11,75,-17,home,away,29,17,171
9/17/2021,624,NYNew York,91,163,-110,NYL,New York Liberty,1.5,-105,1022100185,46,29,1,1,1,1,1,1,1,91,80,-11,75,-17,home,home,46,-17,171
9/17/2021,625,MMinnesota,92,163,-110,MIN,Minnesota Lynx,-9.5,-110,1022100184,44,51,1,1,1,1,1,1,1,73,92,19,95,7,away,away,51,-7,165
9/17/2021,626,IIndiana,73,163,-110,IND,Indiana Fever,9.5,-110,1022100184,44,51,0,0,0,0,0,0,0,73,92,19,95,7,away,home,44,7,165
9/17/2021,627,LVLas Vegas,103,171.5,-110,LVA,Las Vegas Aces,-3.5,-115,1022100186,39,61,1,0,0,1,1,1,1,70,103,33,100,22,away,away,61,-22,173
9/17/2021,628,CChicago,70,171.5,-110,CHI,Chicago Sky,3.5,-105,1022100186,39,61,0,1,1,0,0,0,0,70,103,33,100,22,away,home,39,22,173
9/17/2021,629,PPhoenix,85,156,-110,PHO,Phoenix Mercury,-2.5,-115,1022100187,61,47,0,0,0,0,0,0,0,94,85,-9,108,-14,home,away,47,14,179
9/17/2021,630,SSeattle,94,156,-110,SEA,Seattle Storm,2.5,-105,1022100187,61,47,1,1,1,1,1,1,1,94,85,-9,108,-14,home,home,61,-14,179
9/26/2021,611,PPhoenix,85,159.5,-110,PHO,Phoenix Mercury,-3.5,-110,1042100211,35,32,1,1,1,1,1,0,0,80,85,5,67,-3,home,away,32,3,165
9/26/2021,612,SSeattle,80,159.5,-110,SEA,Seattle Storm,3.5,-110,1042100211,35,32,0,0,0,0,0,1,1,80,85,5,67,-3,home,home,35,-3,165
9/26/2021,609,CChicago,89,166,-110,CHI,Chicago Sky,4,-110,1042100201,38,42,0,0,0,0,1,1,1,76,89,13,80,4,away,away,42,-4,165
9/26/2021,610,MMinnesota,76,166,-110,MIN,Minnesota Lynx,-4,-110,1042100201,38,42,1,1,1,1,0,0,0,76,89,13,80,4,away,home,38,4,165
9/28/2021,613,CChicago,101,154,-110,CHI,Chicago Sky,7.5,-110,1042100301,46,47,1,1,1,1,1,0,0,95,101,6,93,1,away,away,47,-1,196
9/28/2021,614,CConnecticut,95,154,-110,CON,Connecticut Sun,-7.5,-110,1042100301,46,47,0,0,0,0,0,1,1,95,101,6,93,1,away,home,46,1,196
9/28/2021,615,PPhoenix,90,169.5,-110,PHO,Phoenix Mercury,6.5,-110,1042100311,52,49,1,1,1,1,1,1,0,96,90,-6,101,-3,home,away,49,3,186
9/28/2021,616,LVLas Vegas,96,169.5,-110,LVA,Las Vegas Aces,-6.5,-110,1042100311,52,49,0,0,0,0,0,0,1,96,90,-6,101,-3,home,home,52,-3,186
10/15/2021,605,PPhoenix,50,165,-110,PHO,Phoenix Mercury,3,-110,1042100403,46,24,0,0,0,0,0,0,0,86,50,-36,70,-22,home,away,24,22,136
10/15/2021,606,CChicago,86,165,-110,CHI,Chicago Sky,-3,-110,1042100403,46,24,1,1,1,1,1,1,1,86,50,-36,70,-22,home,home,46,-22,136
6/10/2021,629,LALos Angeles,71,158,-110,LAS,Los Angeles Sparks,7,-108,1022100056,45,35,0,0,0,0,0,0,0,89,71,-18,80,-10,home,away,35,10,160
6/10/2021,630,WWashington,89,158,-110,WAS,Washington Mystics,-7,-112,1022100056,45,35,1,1,1,1,1,1,1,89,71,-18,80,-10,home,home,45,-10,160
6/17/2021,671,AAtlanta,93,165,-110,ATL,Atlanta Dream,-1,-110,1022100070,38,46,1,1,1,1,1,1,1,96,93,-3,84,8,away,away,46,-8,189
6/17/2021,672,WWashington,96,165,-110,WAS,Washington Mystics,1,-110,1022100070,38,46,0,0,0,0,0,0,0,96,93,-3,84,8,away,home,38,8,189
6/17/2021,673,SSeattle,79,164,-110,SEA,Seattle Storm,-16.5,-105,1022100069,36,40,1,1,1,0,0,1,1,69,79,10,76,4,away,away,40,-4,148
6/17/2021,674,IIndiana,69,164,-110,IND,Indiana Fever,16.5,-115,1022100069,36,40,0,0,0,1,1,0,0,69,79,10,76,4,away,home,36,4,148
6/17/2021,677,CConnecticut,75,155.5,-110,CON,Connecticut Sun,5,-110,1022100071,31,36,0,1,1,1,1,1,1,81,75,-6,67,5,away,away,36,-5,156
6/17/2021,678,CChicago,81,155.5,-110,CHI,Chicago Sky,-5,-110,1022100071,31,36,1,0,0,0,0,0,0,81,75,-6,67,5,away,home,31,5,156
6/17/2021,675,MMinnesota,85,167.5,-110,MIN,Minnesota Lynx,4,-110,1022100072,33,43,1,1,1,1,1,1,1,73,85,12,76,10,away,away,43,-10,158
6/17/2021,676,DDallas,73,167.5,-110,DAL,Dallas Wings,-4,-110,1022100072,33,43,0,0,0,0,0,0,0,73,85,12,76,10,away,home,33,10,158
6/17/2021,679,NYNew York,76,173,-110,NYL,New York Liberty,16,-115,1022100073,55,34,0,1,0,0,0,0,0,103,76,-27,89,-21,home,away,34,21,179
6/17/2021,680,LVLas Vegas,103,173,-110,LVA,Las Vegas Aces,-16,-105,1022100073,55,34,1,0,1,1,1,1,1,103,76,-27,89,-21,home,home,55,-21,179
6/27/2021,633,CChicago,58,158,-110,CHI,Chicago Sky,-5,-110,1022100090,36,30,0,0,0,0,0,0,0,74,58,-16,66,-6,home,away,30,6,132
6/27/2021,634,CConnecticut,74,158,-110,CON,Connecticut Sun,5,-110,1022100090,36,30,1,1,1,1,1,1,1,74,58,-16,66,-6,home,home,36,-6,132
6/27/2021,635,SSeattle,92,170.5,-110,SEA,Seattle Storm,2.5,-115,1022100091,37,42,0,1,1,1,1,1,1,95,92,-3,79,5,away,away,42,-5,187
6/27/2021,636,LVLas Vegas,95,170.5,-110,LVA,Las Vegas Aces,-2.5,-105,1022100091,37,42,1,0,0,0,0,0,0,95,92,-3,79,5,away,home,37,5,187
6/27/2021,637,LALos Angeles,79,156,-110,LAS,Los Angeles Sparks,7,-110,1022100089,47,43,0,0,0,1,0,0,0,88,79,-9,90,-4,home,away,43,4,167
6/27/2021,638,PPhoenix,88,156.5,-110,PHO,Phoenix Mercury,-7,-110,1022100089,47,43,1,1,1,0,1,1,1,88,79,-9,90,-4,home,home,47,-4,167
7/3/2021,657,WWashington,79,166.5,-110,WAS,Washington Mystics,1.5,-110,1022100103,33,51,1,1,1,1,1,1,1,82,79,-3,84,18,away,away,51,-18,161
7/3/2021,658,NYNew York,82,166.5,-110,NYL,New York Liberty,-1.5,-110,1022100103,33,51,0,0,0,0,0,0,0,82,79,-3,84,18,away,home,33,18,161
7/3/2021,659,CConnecticut,67,156,-105,CON,Connecticut Sun,-15,-110,1022100102,28,29,0,1,0,0,1,0,0,73,67,-6,57,1,away,away,29,-1,140
7/3/2021,660,IIndiana,73,156,-115,IND,Indiana Fever,15,-110,1022100102,28,29,1,0,1,1,0,1,1,73,67,-6,57,1,away,home,28,1,140
7/3/2021,661,MMinnesota,99,165.5,-110,MIN,Minnesota Lynx,4.5,-110,1022100100,41,59,1,1,1,1,1,1,1,68,99,31,100,18,away,away,59,-18,167
7/3/2021,662,PPhoenix,68,165.5,-110,PHO,Phoenix Mercury,-4.5,-110,1022100100,41,59,0,0,0,0,0,0,0,68,99,31,100,18,away,home,41,18,167
8/19/2021,627,MMinnesota,71,150.5,-110,MIN,Minnesota Lynx,6.5,-110,1022100132,42,36,0,0,0,0,0,0,0,82,71,-11,78,-6,home,away,36,6,153
8/19/2021,628,CConnecticut,82,150.5,-110,CON,Connecticut Sun,-6.5,-110,1022100132,42,36,1,1,1,1,1,1,1,82,71,-11,78,-6,home,home,42,-6,153
8/19/2021,629,WWashington,64,168,-110,WAS,Washington Mystics,4,-110,1022100133,39,44,1,1,1,1,1,1,1,77,64,-13,83,5,away,away,44,-5,141
8/19/2021,630,PPhoenix,77,168,-110,PHO,Phoenix Mercury,-4,-110,1022100133,39,44,0,0,0,0,0,0,0,77,64,-13,83,5,away,home,39,5,141
8/19/2021,631,AAtlanta,64,156.5,-110,ATL,Atlanta Dream,4,-105,1022100134,36,28,0,0,0,0,0,0,0,66,64,-2,64,-8,home,away,28,8,130
8/19/2021,632,LALos Angeles,66,156.5,-110,LAS,Los Angeles Sparks,-4,-115,1022100134,36,28,1,1,1,1,1,1,1,66,64,-2,64,-8,home,home,36,-8,130
8/31/2021,623,CConnecticut,85,149,-110,CON,Connecticut Sun,-9,-110,1022100156,37,45,1,1,1,1,1,1,1,75,85,10,82,8,away,away,45,-8,160
8/31/2021,624,WWashington,75,149,-110,WAS,Washington Mystics,9,-110,1022100156,37,45,0,0,0,0,0,0,0,75,85,10,82,8,away,home,37,8,160
8/31/2021,621,LALos Angeles,72,152.5,-110,LAS,Los Angeles Sparks,-5,-110,1022100155,35,30,1,0,1,0,1,0,0,74,72,-2,65,-5,home,away,30,5,146
8/31/2021,622,IIndiana,74,152.5,-110,IND,Indiana Fever,5,-110,1022100155,35,30,0,1,0,1,0,1,1,74,72,-2,65,-5,home,home,35,-5,146
8/31/2021,625,NYNew York,66,164.5,-110,NYL,New York Liberty,9.5,-105,1022100157,39,37,1,1,0,0,0,0,0,74,66,-8,76,-2,home,away,37,2,140
8/31/2021,626,MMinnesota,74,164.5,-110,MIN,Minnesota Lynx,-9.5,-115,1022100157,39,37,0,0,1,1,1,1,1,74,66,-8,76,-2,home,home,39,-2,140
8/31/2021,627,CChicago,83,167,-110,CHI,Chicago Sky,-1.5,-110,1022100158,49,46,0,0,0,0,0,0,0,103,83,-20,95,-3,home,away,46,3,186
8/31/2021,628,PPhoenix,103,167,-110,PHO,Phoenix Mercury,1.5,-110,1022100158,49,46,1,1,1,1,1,1,1,103,83,-20,95,-3,home,home,49,-3,186
9/5/2021,641,LVLas Vegas,84,169.5,-110,LVA,Las Vegas Aces,-2,-105,1022100165,54,46,0,0,0,0,0,0,0,92,84,-8,100,-8,home,away,46,8,176
9/5/2021,642,CChicago,92,169.5,-110,CHI,Chicago Sky,2,-115,1022100165,54,46,1,1,1,1,1,1,1,92,84,-8,100,-8,home,home,54,-8,176
9/5/2021,643,AAtlanta,69,156,-110,ATL,Atlanta Dream,6.5,-110,1022100166,32,32,1,1,1,1,0,0,1,64,69,5,64,0,tie,away,32,-0,133
9/5/2021,644,DDallas,64,156,-110,DAL,Dallas Wings,-6.5,-110,1022100166,32,32,0,0,0,0,1,1,0,64,69,5,64,0,tie,home,32,0,133
9/10/2021,601,AAtlanta,74,156,-110,ATL,Atlanta Dream,5,-110,1022100173,40,34,1,1,0,1,0,0,0,82,74,-8,74,-6,home,away,34,6,156
9/10/2021,602,WWashington,82,156,-110,WAS,Washington Mystics,-5,-110,1022100173,40,34,0,0,1,0,1,1,1,82,74,-8,74,-6,home,home,40,-6,156
9/10/2021,603,IIndiana,72,158,-110,IND,Indiana Fever,11.5,-112,1022100174,39,34,0,1,1,1,1,0,0,89,72,-17,73,-5,home,away,34,5,161
9/10/2021,604,MMinnesota,89,158,-110,MIN,Minnesota Lynx,-11.5,-108,1022100174,39,34,1,0,0,0,0,1,1,89,72,-17,73,-5,home,home,39,-5,161
9/11/2021,605,NYNew York,76,158.5,-105,NYL,New York Liberty,4.5,-110,1022100175,40,41,1,0,0,0,1,0,1,77,76,-1,81,1,away,away,41,-1,153
9/11/2021,606,DDallas,77,158.5,-115,DAL,Dallas Wings,-4.5,-110,1022100175,40,41,0,1,1,1,0,1,0,77,76,-1,81,1,away,home,40,1,153
9/11/2021,607,CConnecticut,76,148.5,-110,CON,Connecticut Sun,-3.5,-110,1022100176,43,49,0,0,1,1,1,1,1,67,76,9,92,6,away,away,49,-6,143
9/11/2021,608,PPhoenix,67,148.5,-110,PHO,Phoenix Mercury,3.5,-110,1022100176,43,49,1,1,0,0,0,0,0,67,76,9,92,6,away,home,43,6,143
9/12/2021,609,WWashington,79,166.5,-110,WAS,Washington Mystics,8.5,-110,1022100177,37,47,0,1,1,1,1,1,1,71,79,8,84,10,away,away,47,-10,150
9/12/2021,610,CChicago,71,166.5,-110,CHI,Chicago Sky,-8.5,-110,1022100177,37,47,1,0,0,0,0,0,0,71,79,8,84,10,away,home,37,10,150
9/12/2021,611,IIndiana,80,159.5,-110,IND,Indiana Fever,11.5,-110,1022100178,46,36,0,0,0,0,0,0,0,90,80,-10,82,-10,home,away,36,10,170
9/12/2021,612,MMinnesota,90,159.5,-110,MIN,Minnesota Lynx,-11.5,-110,1022100178,46,36,1,1,1,1,1,1,1,90,80,-10,82,-10,home,home,46,-10,170
9/12/2021,613,SSeattle,53,152,-110,SEA,Seattle Storm,-6,-110,1022100179,45,27,0,0,0,0,0,0,0,81,53,-28,72,-18,home,away,27,18,134
9/12/2021,614,LALos Angeles,81,152,-110,LAS,Los Angeles Sparks,6,-110,1022100179,45,27,1,1,1,1,1,1,1,81,53,-28,72,-18,home,home,45,-18,134
9/14/2021,617,IIndiana,78,154.5,-110,IND,Indiana Fever,3.5,-110,1022100181,39,43,1,1,1,1,1,1,1,85,78,-7,82,4,away,away,43,-4,163
9/14/2021,618,AAtlanta,85,154.5,-110,ATL,Atlanta Dream,-3.5,-110,1022100181,39,43,0,0,0,0,0,0,0,85,78,-7,82,4,away,home,39,4,163
9/16/2021,621,LALos Angeles,74,147.5,-110,LAS,Los Angeles Sparks,-2.5,-110,1022100183,31,34,0,0,0,1,1,1,1,68,74,6,65,3,away,away,34,-3,142
9/16/2021,622,AAtlanta,68,147.5,-110,ATL,Atlanta Dream,2.5,-110,1022100183,31,34,1,1,1,0,0,0,0,68,74,6,65,3,away,home,31,3,142
9/19/2021,631,AAtlanta,64,150,-110,ATL,Atlanta Dream,13,-110,1022100188,46,37,0,0,0,0,0,0,0,84,64,-20,83,-9,home,away,37,9,148
9/19/2021,632,CConnecticut,84,150,-110,CON,Connecticut Sun,-13,-110,1022100188,46,37,1,1,1,1,1,1,1,84,64,-20,83,-9,home,home,46,-9,148
9/19/2021,633,MMinnesota,83,164,-115,MIN,Minnesota Lynx,-5.5,-105,1022100190,41,41,1,1,1,1,1,1,0,77,83,6,82,0,tie,away,41,-0,160
9/19/2021,634,WWashington,77,164,-105,WAS,Washington Mystics,5.5,-115,1022100190,41,41,0,0,0,0,0,0,1,77,83,6,82,0,tie,home,41,0,160
9/19/2021,635,LVLas Vegas,84,168,-110,LVA,Las Vegas Aces,-3.5,-110,1022100189,47,43,1,0,0,0,0,0,0,83,84,1,90,-4,home,away,43,4,167
9/19/2021,636,PPhoenix,83,168,-110,PHO,Phoenix Mercury,3.5,-110,1022100189,47,43,0,1,1,1,1,1,1,83,84,1,90,-4,home,home,47,-4,167
9/19/2021,637,LALos Angeles,84,147.5,-110,LAS,Los Angeles Sparks,3,-110,1022100191,44,41,1,0,0,0,0,1,0,87,84,-3,85,-3,home,away,41,3,171
9/19/2021,638,DDallas,87,147.5,-110,DAL,Dallas Wings,-3,-110,1022100191,44,41,0,1,1,1,1,0,1,87,84,-3,85,-3,home,home,44,-3,171
9/19/2021,639,IIndiana,87,166,-110,IND,Indiana Fever,12.5,-110,1022100192,46,46,0,0,1,0,0,0,1,98,87,-11,92,0,tie,away,46,-0,185
9/19/2021,640,CChicago,98,166,-110,CHI,Chicago Sky,-12.5,-110,1022100192,46,46,1,1,0,1,1,1,0,98,87,-11,92,0,tie,home,46,0,185
9/23/2021,601,DDallas,64,167,-110,DAL,Dallas Wings,5,-110,1042100111,44,29,0,0,0,0,0,0,0,81,64,-17,73,-15,home,away,29,15,145
9/23/2021,602,CChicago,81,167,-110,CHI,Chicago Sky,-5,-110,1042100111,44,29,1,1,1,1,1,1,1,81,64,-17,73,-15,home,home,44,-15,145
9/23/2021,603,NYNew York,82,165,-110,NYL,New York Liberty,10,-105,1042100101,37,41,0,0,0,1,1,1,1,83,82,-1,78,4,away,away,41,-4,165
9/23/2021,604,PPhoenix,83,165,-110,PHO,Phoenix Mercury,-10,-115,1042100101,37,41,1,1,1,0,0,0,0,83,82,-1,78,4,away,home,37,4,165
9/30/2021,617,CChicago,68,155.5,-110,CHI,Chicago Sky,8,-110,1042100302,45,39,1,1,1,1,1,1,0,79,68,-11,84,-6,home,away,39,6,147
9/30/2021,618,CConnecticut,79,155.5,-110,CON,Connecticut Sun,-8,-110,1042100302,45,39,0,0,0,0,0,0,1,79,68,-11,84,-6,home,home,45,-6,147
9/30/2021,619,PPhoenix,117,170.5,-110,PHO,Phoenix Mercury,6,-110,1042100312,52,68,1,1,1,1,1,1,1,91,117,26,120,16,away,away,68,-16,208
9/30/2021,620,LVLas Vegas,91,170.5,-110,LVA,Las Vegas Aces,-6,-110,1042100312,52,68,0,0,0,0,0,0,0,91,117,26,120,16,away,home,52,16,208
10/3/2021,621,CConnecticut,83,153.5,-110,CON,Connecticut Sun,-4.5,-110,1042100303,37,35,0,1,1,1,1,1,0,86,83,-3,72,-2,home,away,35,2,169
10/3/2021,622,CChicago,86,153.5,-110,CHI,Chicago Sky,4.5,-110,1042100303,37,35,1,0,0,0,0,0,1,86,83,-3,72,-2,home,home,37,-2,169
10/3/2021,623,LVLas Vegas,60,173,-110,LVA,Las Vegas Aces,-2,-110,1042100313,46,31,0,0,0,0,0,0,0,87,60,-27,77,-15,home,away,31,15,147
10/3/2021,624,PPhoenix,87,173,-110,PHO,Phoenix Mercury,2,-110,1042100313,46,31,1,1,1,1,1,1,1,87,60,-27,77,-15,home,home,46,-15,147
10/6/2021,633,CConnecticut,69,156,-110,CON,Connecticut Sun,-4,-110,1042100304,54,41,0,0,0,0,0,0,0,79,69,-10,95,-13,home,away,41,13,148
10/6/2021,634,CChicago,79,156,-110,CHI,Chicago Sky,4,-110,1042100304,54,41,1,1,1,1,1,1,1,79,69,-10,95,-13,home,home,54,-13,148
10/6/2021,631,LVLas Vegas,93,171,-110,LVA,Las Vegas Aces,1,-110,1042100314,46,49,0,0,0,0,0,1,1,76,93,17,95,3,away,away,49,-3,169
10/6/2021,632,PPhoenix,76,171,-110,PHO,Phoenix Mercury,-1,-110,1042100314,46,49,1,1,1,1,1,0,0,76,93,17,95,3,away,home,46,3,169
10/8/2021,635,PPhoenix,87,168.5,-110,PHO,Phoenix Mercury,5.5,-110,1042100315,42,44,1,1,1,1,1,1,1,84,87,3,86,2,away,away,44,-2,171
10/8/2021,636,LVLas Vegas,84,168.5,-110,LVA,Las Vegas Aces,-5.5,-110,1042100315,42,44,0,0,0,0,0,0,0,84,87,3,86,2,away,home,42,2,171
10/10/2021,601,CChicago,91,167.5,-110,CHI,Chicago Sky,2.5,-110,1042100401,35,46,0,0,0,0,0,1,1,77,91,14,81,11,away,away,46,-11,168
10/10/2021,602,PPhoenix,77,167.5,-110,PHO,Phoenix Mercury,-2.5,-110,1042100401,35,46,1,1,1,1,1,0,0,77,91,14,81,11,away,home,35,11,168
10/13/2021,603,CChicago,86,169,-110,CHI,Chicago Sky,4.5,-110,1042100402,40,40,1,1,1,1,1,1,0,91,86,-5,80,0,tie,away,40,-0,177
10/13/2021,604,PPhoenix,91,169,-110,PHO,Phoenix Mercury,-4.5,-110,1042100402,40,40,0,0,0,0,0,0,1,91,86,-5,80,0,tie,home,40,0,177
10/17/2021,607,PPhoenix,74,164,-110,PHO,Phoenix Mercury,4.5,-110,1042100404,37,44,0,0,0,1,1,0,1,80,74,-6,81,7,away,away,44,-7,154
10/17/2021,608,CChicago,80,164,-110,CHI,Chicago Sky,-4.5,-110,1042100404,37,44,1,1,1,0,0,1,0,80,74,-6,81,7,away,home,37,7,154
5/14/2021,601,IIndiana,87,161,-110,IND,Indiana Fever,-2.5,-110,1022100001,47,47,0,0,0,0,0,0,0,90,87,-3,94,0,tie,away,47,-0,177
5/14/2021,602,NYNew York,90,161,-110,NYL,New York Liberty,2.5,-110,1022100001,47,47,1,1,1,1,1,1,1,90,87,-3,94,0,tie,home,47,0,177
5/14/2021,603,CConnecticut,78,163,-105,CON,Connecticut Sun,-3,-105,1022100002,33,43,1,1,1,1,1,1,1,67,78,11,76,10,away,away,43,-10,145
5/14/2021,604,AAtlanta,67,163,-115,ATL,Atlanta Dream,3,-115,1022100002,33,43,0,0,0,0,0,0,0,67,78,11,76,10,away,home,33,10,145
5/14/2021,605,PPhoenix,77,164,-110,PHO,Phoenix Mercury,1,-105,1022100003,24,33,1,1,1,1,1,1,0,75,77,2,57,9,away,away,33,-9,152
5/14/2021,606,MMinnesota,75,164,-110,MIN,Minnesota Lynx,-1,-115,1022100003,24,33,0,0,0,0,0,0,1,75,77,2,57,9,away,home,24,9,152
5/14/2021,607,DDallas,94,165,-110,DAL,Dallas Wings,6,-110,1022100004,41,44,0,0,0,0,1,1,1,71,94,23,85,3,away,away,44,-3,165
5/14/2021,608,LALos Angeles,71,165,-110,LAS,Los Angeles Sparks,-6,-110,1022100004,41,44,1,1,1,1,0,0,0,71,94,23,85,3,away,home,41,3,165
5/15/2021,609,CChicago,70,165.5,-110,CHI,Chicago Sky,-2.5,-115,1022100005,30,46,1,0,1,1,1,1,1,56,70,14,76,16,away,away,46,-16,126
5/15/2021,610,WWashington,56,165.5,-110,WAS,Washington Mystics,2.5,-105,1022100005,30,46,0,1,0,0,0,0,0,56,70,14,76,16,away,home,30,16,126
5/15/2021,611,LVLas Vegas,83,166.5,-110,LVA,Las Vegas Aces,-1,-115,1022100006,49,40,1,1,1,0,0,0,0,97,83,-14,89,-9,home,away,40,9,180
5/15/2021,612,SSeattle,97,166.5,-110,SEA,Seattle Storm,1,-105,1022100006,49,40,0,0,0,1,1,1,1,97,83,-14,89,-9,home,home,49,-9,180
5/16/2021,613,NYNew York,73,164.5,-126,NYL,New York Liberty,5.5,-108,1022100007,35,41,1,1,1,1,1,1,1,65,73,8,76,6,away,away,41,-6,138
5/16/2021,614,IIndiana,65,164.5,106,IND,Indiana Fever,-5.5,-112,1022100007,35,41,0,0,0,0,0,0,0,65,73,8,76,6,away,home,35,6,138
5/16/2021,615,PPhoenix,78,162,-110,PHO,Phoenix Mercury,1,-110,1022100008,37,33,1,1,1,0,0,0,0,86,78,-8,70,-4,home,away,33,4,164
5/16/2021,616,CConnecticut,86,162,-110,CON,Connecticut Sun,-1,-110,1022100008,37,33,0,0,0,1,1,1,1,86,78,-8,70,-4,home,home,37,-4,164
5/18/2021,617,MMinnesota,75,158,-110,MIN,Minnesota Lynx,-5.5,-112,1022100009,43,45,0,0,1,0,0,0,1,86,75,-11,88,2,away,away,45,-2,161
5/18/2021,618,NYNew York,86,158,-110,NYL,New York Liberty,5.5,-108,1022100009,43,45,1,1,0,1,1,1,0,86,75,-11,88,2,away,home,43,2,161
5/18/2021,619,PPhoenix,91,163,-110,PHO,Phoenix Mercury,-3.5,-109,1022100010,37,44,1,1,1,1,1,1,1,70,91,21,81,7,away,away,44,-7,161
5/18/2021,620,WWashington,70,163,-110,WAS,Washington Mystics,3,-115,1022100010,37,44,0,0,0,0,0,0,0,70,91,21,81,7,away,home,37,7,161
5/18/2021,621,LVLas Vegas,96,167.5,-115,LVA,Las Vegas Aces,1.5,-105,1022100011,31,45,1,1,1,1,1,1,1,80,96,16,76,14,away,away,45,-14,176
5/18/2021,622,SSeattle,80,167.5,-110,SEA,Seattle Storm,-1.5,-115,1022100011,31,45,0,0,0,0,0,0,0,80,96,16,76,14,away,home,31,14,176
5/19/2021,623,CChicago,85,163,-110,CHI,Chicago Sky,-3.5,-110,1022100012,26,46,1,1,1,1,1,1,1,77,85,8,72,20,away,away,46,-20,162
5/19/2021,624,AAtlanta,77,163,-110,ATL,Atlanta Dream,3.5,-110,1022100012,26,46,0,0,0,0,0,0,0,77,85,8,72,20,away,home,26,20,162
5/19/2021,625,IIndiana,67,161,-110,IND,Indiana Fever,7,-105,1022100013,50,33,1,1,0,0,0,0,0,88,67,-21,83,-17,home,away,33,17,155
5/19/2021,626,CConnecticut,88,161,-110,CON,Connecticut Sun,-7,-115,1022100013,50,33,0,0,1,1,1,1,1,88,67,-21,83,-17,home,home,50,-17,155
5/20/2021,627,SSeattle,90,163.5,-120,SEA,Seattle Storm,-4,-110,1022100014,48,33,0,0,0,0,0,0,0,78,90,12,81,-15,home,away,33,15,168
5/20/2021,628,MMinnesota,78,163.5,100,MIN,Minnesota Lynx,4,-110,1022100014,48,33,1,1,1,1,1,1,1,78,90,12,81,-15,home,home,48,-15,168
5/21/2021,629,AAtlanta,83,162.5,-115,ATL,Atlanta Dream,2,-110,1022100015,34,41,1,1,0,0,0,1,1,79,83,4,75,7,away,away,41,-7,162
5/21/2021,630,IIndiana,79,162.5,-105,IND,Indiana Fever,-2,-110,1022100015,34,41,0,0,1,1,1,0,0,79,83,4,75,7,away,home,34,7,162
5/21/2021,631,NYNew York,72,159,-110,NYL,New York Liberty,3,-105,1022100016,52,46,0,0,0,0,0,0,0,101,72,-29,98,-6,home,away,46,6,173
5/21/2021,632,WWashington,101,159,-110,WAS,Washington Mystics,-3,-115,1022100016,52,46,1,1,1,1,1,1,1,101,72,-29,98,-6,home,home,52,-6,173
5/21/2021,633,CConnecticut,84,162,-110,CON,Connecticut Sun,2.5,-105,1022100017,30,48,1,1,1,1,1,1,1,67,84,17,78,18,away,away,48,-18,151
5/21/2021,634,PPhoenix,67,162,-110,PHO,Phoenix Mercury,-2.5,-115,1022100017,30,48,0,0,0,0,0,0,0,67,84,17,78,18,away,home,30,18,151
5/21/2021,635,LALos Angeles,69,168.5,-110,LAS,Los Angeles Sparks,9.5,-110,1022100018,56,36,1,1,0,0,0,0,0,97,69,-28,92,-20,home,away,36,20,166
5/21/2021,636,LVLas Vegas,97,168.5,-110,LVA,Las Vegas Aces,-9.5,-110,1022100018,56,36,0,0,1,1,1,1,1,97,69,-28,92,-20,home,home,56,-20,166
5/22/2021,637,SSeattle,100,170,-110,SEA,Seattle Storm,-7.5,-110,1022100019,45,44,1,1,1,1,1,1,1,97,100,3,89,-1,home,away,44,1,197
5/22/2021,638,DDallas,97,170,-110,DAL,Dallas Wings,7.5,-110,1022100019,45,44,0,0,0,0,0,0,0,97,100,3,89,-1,home,home,45,-1,197
5/23/2021,641,NYNew York,93,165,-110,NYL,New York Liberty,5.5,-110,1022100020,52,52,0,0,0,1,0,0,0,85,93,8,104,0,tie,away,52,-0,178
5/23/2021,642,CChicago,85,165,-110,CHI,Chicago Sky,-5.5,-110,1022100020,52,52,1,1,1,0,1,1,1,85,93,8,104,0,tie,home,52,0,178
5/23/2021,639,WWashington,77,161,-110,WAS,Washington Mystics,-2.5,-110,1022100021,42,39,0,0,0,0,0,0,0,89,77,-12,81,-3,home,away,39,3,166
5/23/2021,640,IIndiana,89,161,-110,IND,Indiana Fever,2.5,-110,1022100021,42,39,1,1,1,1,1,1,1,89,77,-12,81,-3,home,home,42,-3,166
5/23/2021,643,CConnecticut,72,162,-110,CON,Connecticut Sun,6,-115,1022100022,33,27,1,1,1,0,0,0,1,65,72,7,60,-6,home,away,27,6,137
5/23/2021,644,LVLas Vegas,65,162,-110,LVA,Las Vegas Aces,-6,-106,1022100022,33,27,0,0,0,1,1,1,0,65,72,7,60,-6,home,home,33,-6,137
5/24/2021,665,DDallas,81,170,-110,DAL,Dallas Wings,1,-115,1022100024,39,39,0,1,1,1,1,1,0,88,81,-7,78,0,tie,away,39,-0,169
5/24/2021,666,NYNew York,88,170,-110,NYL,New York Liberty,-1,-105,1022100024,39,39,1,0,0,0,0,0,1,88,81,-7,78,0,tie,home,39,0,169
5/25/2021,645,WWashington,85,161,-110,WAS,Washington Mystics,-2.5,-110,1022100023,35,49,1,1,1,1,1,1,1,69,85,16,84,14,away,away,49,-14,154
5/25/2021,646,IIndiana,69,161,-110,IND,Indiana Fever,2.5,-110,1022100023,35,49,0,0,0,0,0,0,0,69,85,16,84,14,away,home,35,14,154
5/25/2021,649,AAtlanta,90,169.5,-112,ATL,Atlanta Dream,6,-105,1022100025,33,43,1,1,1,1,1,1,1,83,90,7,76,10,away,away,43,-10,173
5/25/2021,650,CChicago,83,169,-110,CHI,Chicago Sky,-6,-115,1022100025,33,43,0,0,0,0,0,0,0,83,90,7,76,10,away,home,33,10,173
5/25/2021,651,CConnecticut,87,161.5,-110,CON,Connecticut Sun,3.5,-110,1022100026,46,40,0,0,0,0,0,0,1,90,87,-3,86,-6,home,away,40,6,177
5/25/2021,652,SSeattle,90,161.5,-110,SEA,Seattle Storm,-3.5,-110,1022100026,46,40,1,1,1,1,1,1,0,90,87,-3,86,-6,home,home,46,-6,177
5/26/2021,653,LVLas Vegas,85,167,-110,LVA,Las Vegas Aces,-6,-110,1022100027,44,45,1,1,1,1,1,1,1,79,85,6,89,1,away,away,45,-1,164
5/26/2021,654,PPhoenix,79,167,-110,PHO,Phoenix Mercury,6,-110,1022100027,44,45,0,0,0,0,0,0,0,79,85,6,89,1,away,home,44,1,164
5/27/2021,655,DDallas,95,167.5,-110,DAL,Dallas Wings,-1,-110,1022100028,53,47,0,0,1,1,0,0,0,101,95,-6,100,-6,home,away,47,6,196
5/27/2021,656,AAtlanta,101,167.5,-110,ATL,Atlanta Dream,1,-110,1022100028,53,47,1,1,0,0,1,1,1,101,95,-6,100,-6,home,home,53,-6,196
5/28/2021,657,WWashington,81,156,-110,WAS,Washington Mystics,7.5,-105,1022100029,44,47,1,1,1,1,1,1,0,86,81,-5,91,3,away,away,47,-3,167
5/28/2021,658,CConnecticut,86,156,-110,CON,Connecticut Sun,-7.5,-115,1022100029,44,47,0,0,0,0,0,0,1,86,81,-5,91,3,away,home,44,3,167
5/28/2021,659,LALos Angeles,76,170.5,-110,LAS,Los Angeles Sparks,4,-110,1022100030,33,38,0,0,1,1,1,1,1,61,76,15,71,5,away,away,38,-5,137
5/28/2021,660,CChicago,61,170.5,-110,CHI,Chicago Sky,-4,-110,1022100030,33,38,1,1,0,0,0,0,0,61,76,15,71,5,away,home,33,5,137
5/28/2021,661,MMinnesota,72,166,-110,MIN,Minnesota Lynx,6,-115,1022100031,58,36,0,0,0,0,0,0,0,82,72,-10,94,-22,home,away,36,22,154
5/28/2021,662,SSeattle,82,166,-110,SEA,Seattle Storm,-6,-105,1022100031,58,36,1,1,1,1,1,1,1,82,72,-10,94,-22,home,home,58,-22,154
5/28/2021,663,IIndiana,77,165.5,-110,IND,Indiana Fever,11.5,-110,1022100032,59,47,0,0,0,0,0,0,0,113,77,-36,106,-12,home,away,47,12,190
5/28/2021,664,LVLas Vegas,113,165.5,-110,LVA,Las Vegas Aces,-11.5,-110,1022100032,59,47,1,1,1,1,1,1,1,113,77,-36,106,-12,home,home,59,-12,190
5/29/2021,665,AAtlanta,90,169,-110,ATL,Atlanta Dream,2,-110,1022100033,45,49,0,1,1,1,1,1,1,87,90,3,94,4,away,away,49,-4,177
5/29/2021,666,NYNew York,87,169,-110,NYL,New York Liberty,-2,-110,1022100033,45,49,1,0,0,0,0,0,0,87,90,3,94,4,away,home,45,4,177
5/29/2021,667,PPhoenix,89,168.5,-110,PHO,Phoenix Mercury,-1,-110,1022100034,37,44,1,1,1,1,1,1,1,85,89,4,81,7,away,away,44,-7,174
5/29/2021,668,DDallas,85,168.5,-110,DAL,Dallas Wings,1,-110,1022100034,37,44,0,0,0,0,0,0,0,85,89,4,81,7,away,home,37,7,174
5/30/2021,671,IIndiana,78,168.5,-110,IND,Indiana Fever,13.5,-110,1022100036,48,29,0,0,0,0,0,0,0,101,78,-23,77,-19,home,away,29,19,179
5/30/2021,672,LVLas Vegas,101,168.5,-110,LVA,Las Vegas Aces,-13.5,-110,1022100036,48,29,1,1,1,1,1,1,1,101,78,-23,77,-19,home,home,48,-19,179
5/30/2021,669,LALos Angeles,82,165,-110,LAS,Los Angeles Sparks,3,-110,1022100035,37,37,0,0,0,0,0,1,0,79,82,3,74,0,tie,away,37,-0,161
5/30/2021,670,CChicago,79,165,-110,CHI,Chicago Sky,-3,-110,1022100035,37,37,1,1,1,1,1,0,1,79,82,3,74,0,tie,home,37,0,161
5/30/2021,673,CConnecticut,74,156.5,-110,CON,Connecticut Sun,-2.5,-110,1022100037,33,37,1,1,1,1,1,1,1,79,74,-5,70,4,away,away,37,-4,153
5/30/2021,674,MMinnesota,79,156.5,-110,MIN,Minnesota Lynx,2.5,-110,1022100037,33,37,0,0,0,0,0,0,0,79,74,-5,70,4,away,home,33,4,153
6/1/2021,675,LVLas Vegas,67,160,-110,LVA,Las Vegas Aces,-1.5,-110,1022100038,33,30,0,0,0,0,0,0,0,74,67,-7,63,-3,home,away,30,3,141
6/1/2021,676,CConnecticut,74,160,-110,CON,Connecticut Sun,1.5,-110,1022100038,33,30,1,1,1,1,1,1,1,74,67,-7,63,-3,home,home,33,-3,141
6/1/2021,679,LALos Angeles,69,165.5,-110,LAS,Los Angeles Sparks,-1.5,-110,1022100040,38,28,1,1,1,1,0,0,0,79,69,-10,66,-10,home,away,28,10,148
6/1/2021,680,DDallas,79,165.5,-110,DAL,Dallas Wings,1.5,-110,1022100040,38,28,0,0,0,0,1,1,1,79,69,-10,66,-10,home,home,38,-10,148
6/1/2021,677,PPhoenix,84,163,-110,PHO,Phoenix Mercury,1.5,-113,1022100039,36,47,1,1,1,1,0,1,1,83,84,1,83,11,away,away,47,-11,167
6/1/2021,678,CChicago,83,163,-110,CHI,Chicago Sky,-1,-110,1022100039,36,47,0,0,0,0,1,0,0,83,84,1,83,11,away,home,36,11,167
6/1/2021,681,IIndiana,73,170,-110,IND,Indiana Fever,15.5,-110,1022100041,43,38,1,0,0,0,0,0,0,88,73,-15,81,-5,home,away,38,5,161
6/1/2021,682,SSeattle,88,170,-110,SEA,Seattle Storm,-15.5,-110,1022100041,43,38,0,1,1,1,1,1,1,88,73,-15,81,-5,home,home,43,-5,161
6/3/2021,601,LVLas Vegas,94,170.5,-110,LVA,Las Vegas Aces,-9,-115,1022100042,44,52,1,1,1,1,1,1,1,82,94,12,96,8,away,away,52,-8,176
6/3/2021,602,NYNew York,82,170.5,-110,NYL,New York Liberty,9,-105,1022100042,44,52,0,0,0,0,0,0,0,82,94,12,96,8,away,home,44,8,176
6/3/2021,603,CChicago,74,164.5,-110,CHI,Chicago Sky,1,-120,1022100043,34,26,0,0,0,0,0,0,1,77,74,-3,60,-8,home,away,26,8,151
6/3/2021,604,PPhoenix,77,164.5,-110,PHO,Phoenix Mercury,-1,100,1022100043,34,26,1,1,1,1,1,1,0,77,74,-3,60,-8,home,home,34,-8,151
6/3/2021,605,IIndiana,63,158,-110,IND,Indiana Fever,5,-110,1022100044,48,25,1,0,0,0,0,0,0,98,63,-35,73,-23,home,away,25,23,161
6/3/2021,606,LALos Angeles,98,158,-110,LAS,Los Angeles Sparks,-5,-110,1022100044,48,25,0,1,1,1,1,1,1,98,63,-35,73,-23,home,home,48,-23,161
6/4/2021,607,AAtlanta,84,161.5,-110,ATL,Atlanta Dream,6.5,-110,1022100045,41,42,0,0,0,1,1,1,0,86,84,-2,83,1,away,away,42,-1,170
6/4/2021,608,MMinnesota,86,161.5,-110,MIN,Minnesota Lynx,-7.5,-102,1022100045,41,42,1,1,1,0,0,0,1,86,84,-2,83,1,away,home,41,1,170
6/4/2021,609,DDallas,102,172.5,-110,DAL,Dallas Wings,9,-105,1022100046,57,54,1,1,1,0,0,0,0,105,102,-3,111,-3,home,away,54,3,207
6/4/2021,610,SSeattle,105,172.5,-110,SEA,Seattle Storm,-9,-115,1022100046,57,54,0,0,0,1,1,1,1,105,102,-3,111,-3,home,home,57,-3,207
6/5/2021,611,LVLas Vegas,96,167,-110,LVA,Las Vegas Aces,-7,-110,1022100047,57,56,1,0,0,0,0,0,0,93,96,3,113,-1,home,away,56,1,189
6/5/2021,612,WWashington,93,167,-110,WAS,Washington Mystics,7,-110,1022100047,57,56,0,1,1,1,1,1,1,93,96,3,113,-1,home,home,57,-1,189
6/5/2021,613,CChicago,63,157,-110,CHI,Chicago Sky,-1,-130,1022100048,40,31,0,0,0,0,0,0,0,68,63,-5,71,-9,home,away,31,9,131
6/5/2021,614,LALos Angeles,68,157,-110,LAS,Los Angeles Sparks,1,110,1022100048,40,31,1,1,1,1,1,1,1,68,63,-5,71,-9,home,home,40,-9,131
6/5/2021,615,NYNew York,64,158.5,-110,NYL,New York Liberty,9.5,-110,1022100049,43,37,1,0,0,0,1,1,0,85,64,-21,80,-6,home,away,37,6,149
6/5/2021,616,CConnecticut,85,158.5,-110,CON,Connecticut Sun,-9.5,-110,1022100049,43,37,0,1,1,1,0,0,1,85,64,-21,80,-6,home,home,43,-6,149
6/6/2021,619,DDallas,68,178.5,-110,DAL,Dallas Wings,9,-110,1022100051,33,28,0,1,0,0,0,0,0,67,68,1,61,-5,home,away,28,5,135
6/6/2021,620,SSeattle,67,178.5,-110,SEA,Seattle Storm,-9,-110,1022100051,33,28,1,0,1,1,1,1,1,67,68,1,61,-5,home,home,33,-5,135
6/6/2021,617,AAtlanta,80,163,-110,ATL,Atlanta Dream,4.5,-110,1022100050,52,38,0,0,0,0,0,0,0,100,80,-20,90,-14,home,away,38,14,180
6/6/2021,618,MMinnesota,100,163,-110,MIN,Minnesota Lynx,-4.5,-110,1022100050,52,38,1,1,1,1,1,1,1,100,80,-20,90,-14,home,home,52,-14,180
6/8/2021,621,MMinnesota,81,164.5,-110,MIN,Minnesota Lynx,-2,-110,1022100052,43,38,1,1,1,0,0,0,0,85,81,-4,81,-5,home,away,38,5,166
6/8/2021,622,WWashington,85,164.5,-110,WAS,Washington Mystics,2,-110,1022100052,43,38,0,0,0,1,1,1,1,85,81,-4,81,-5,home,home,43,-5,166
6/8/2021,623,DDallas,85,166,-110,DAL,Dallas Wings,2,-105,1022100055,35,42,0,1,1,1,1,1,1,81,85,4,77,7,away,away,42,-7,166
6/8/2021,624,PPhoenix,81,166,-110,PHO,Phoenix Mercury,-2,-115,1022100055,35,42,1,0,0,0,0,0,0,81,85,4,77,7,away,home,35,7,166
6/9/2021,625,SSeattle,95,170.5,-110,SEA,Seattle Storm,-8.5,-115,1022100053,43,45,1,1,1,1,1,1,1,71,95,24,88,2,away,away,45,-2,166
6/9/2021,626,AAtlanta,71,170.5,-110,ATL,Atlanta Dream,8.5,-105,1022100053,43,45,0,0,0,0,0,0,0,71,95,24,88,2,away,home,43,2,166
6/9/2021,627,IIndiana,76,159.5,-110,IND,Indiana Fever,11,-115,1022100054,51,39,0,0,0,0,0,0,0,92,76,-16,90,-12,home,away,39,12,168
6/9/2021,628,CChicago,92,159.5,-110,CHI,Chicago Sky,-11,-110,1022100054,51,39,1,1,1,1,1,1,1,92,76,-16,90,-12,home,home,51,-12,168
6/11/2021,631,SSeattle,86,171,-110,SEA,Seattle Storm,-9.5,-105,1022100057,35,45,1,1,1,0,1,1,1,75,86,11,80,10,away,away,45,-10,161
6/11/2021,632,AAtlanta,75,171,-110,ATL,Atlanta Dream,9.5,-115,1022100057,35,45,0,0,0,1,0,0,0,75,86,11,80,10,away,home,35,10,161
6/11/2021,633,DDallas,77,167,-110,DAL,Dallas Wings,2.5,-110,1022100058,33,40,1,1,1,1,1,1,1,59,77,18,73,7,away,away,40,-7,136
6/11/2021,634,PPhoenix,59,167,-110,PHO,Phoenix Mercury,-2.5,-110,1022100058,33,40,0,0,0,0,0,0,0,59,77,18,73,7,away,home,33,7,136
6/12/2021,635,CChicago,83,161,-112,CHI,Chicago Sky,-11,-110,1022100059,49,56,1,1,1,1,1,1,1,79,83,4,105,7,away,away,56,-7,162
6/12/2021,636,IIndiana,79,161,-108,IND,Indiana Fever,11,-110,1022100059,49,56,0,0,0,0,0,0,0,79,83,4,105,7,away,home,49,7,162
6/12/2021,637,LALos Angeles,64,157,-110,LAS,Los Angeles Sparks,10,-110,1022100060,49,35,0,0,0,0,0,0,0,80,64,-16,84,-14,home,away,35,14,144
6/12/2021,638,MMinnesota,80,157,-110,MIN,Minnesota Lynx,-10,-110,1022100060,49,35,1,1,1,1,1,1,1,80,64,-16,84,-14,home,home,49,-14,144
6/13/2021,639,SSeattle,89,157,-110,SEA,Seattle Storm,-5,-110,1022100061,29,43,1,1,1,1,1,1,1,66,89,23,72,14,away,away,43,-14,155
6/13/2021,640,CConnecticut,66,157,-110,CON,Connecticut Sun,5,-110,1022100061,29,43,0,0,0,0,0,0,0,66,89,23,72,14,away,home,29,14,155
6/13/2021,641,WWashington,78,167.5,-110,WAS,Washington Mystics,-4,-110,1022100062,51,49,1,1,1,1,1,1,1,101,78,-23,100,-2,home,away,49,2,179
6/13/2021,642,AAtlanta,101,167.5,-110,ATL,Atlanta Dream,4,-115,1022100062,51,49,0,0,0,0,0,0,0,101,78,-23,100,-2,home,home,51,-2,179
6/13/2021,643,NYNew York,85,159.5,-105,NYL,New York Liberty,7,-110,1022100064,36,48,1,1,1,1,1,1,1,83,85,2,84,12,away,away,48,-12,168
6/13/2021,644,PPhoenix,83,159.5,-115,PHO,Phoenix Mercury,-7,-110,1022100064,36,48,0,0,0,0,0,0,0,83,85,2,84,12,away,home,36,12,168
6/13/2021,645,DDallas,78,172,-110,DAL,Dallas Wings,8.5,-105,1022100063,43,41,0,0,0,0,0,1,1,85,78,-7,84,-2,home,away,41,2,163
6/13/2021,646,LVLas Vegas,85,172,-110,LVA,Las Vegas Aces,-8.5,-115,1022100063,43,41,1,1,1,1,1,0,0,85,78,-7,84,-2,home,home,43,-2,163
6/15/2021,651,SSeattle,87,166.5,-110,SEA,Seattle Storm,-15,-110,1022100065,33,41,0,1,1,1,1,1,1,70,87,17,74,8,away,away,41,-8,157
6/15/2021,652,IIndiana,70,166.5,-110,IND,Indiana Fever,15,-110,1022100065,33,41,1,0,0,0,0,0,0,70,87,17,74,8,away,home,33,8,157
6/15/2021,653,CChicago,105,160,-115,CHI,Chicago Sky,4,-110,1022100066,49,58,1,1,1,1,1,1,1,89,105,16,107,9,away,away,58,-9,194
6/15/2021,654,MMinnesota,89,159,-110,MIN,Minnesota Lynx,-4,-110,1022100066,49,58,0,0,0,0,0,0,0,89,105,16,107,9,away,home,49,9,194
6/15/2021,655,NYNew York,78,172.5,-110,NYL,New York Liberty,14,-105,1022100067,48,45,0,1,1,1,1,1,1,100,78,-22,93,-3,home,away,45,3,178
6/15/2021,656,LVLas Vegas,100,172.5,-110,LVA,Las Vegas Aces,-14,-115,1022100067,48,45,1,0,0,0,0,0,0,100,78,-22,93,-3,home,home,48,-3,178
6/16/2021,661,PPhoenix,80,153.5,-110,PHO,Phoenix Mercury,-5,-110,1022100068,53,43,0,0,0,0,0,0,0,85,80,-5,96,-10,home,away,43,10,165
6/16/2021,662,LALos Angeles,85,153.5,-110,LAS,Los Angeles Sparks,5,-110,1022100068,53,43,1,1,1,1,1,1,1,85,80,-5,96,-10,home,home,53,-10,165
6/18/2021,681,PPhoenix,80,155,-110,PHO,Phoenix Mercury,-3.5,-110,1022100074,36,44,1,1,1,1,1,1,1,66,80,14,80,8,away,away,44,-8,146
6/18/2021,682,LALos Angeles,66,155,-110,LAS,Los Angeles Sparks,3.5,-110,1022100074,36,44,0,0,0,0,0,0,0,66,80,14,80,8,away,home,36,8,146
6/19/2021,601,CConnecticut,81,156.5,-110,CON,Connecticut Sun,6.5,-110,1022100075,40,34,1,1,1,1,0,0,0,91,81,-10,74,-6,home,away,34,6,172
6/19/2021,602,CChicago,91,156.5,-110,CHI,Chicago Sky,-6.5,-110,1022100075,40,34,0,0,0,0,1,1,1,91,81,-10,74,-6,home,home,40,-6,172
6/19/2021,603,IIndiana,77,165,-110,IND,Indiana Fever,9.5,-110,1022100076,46,39,1,1,1,1,1,0,0,82,77,-5,85,-7,home,away,39,7,159
6/19/2021,604,WWashington,82,165,-110,WAS,Washington Mystics,-9.5,-110,1022100076,46,39,0,0,0,0,0,1,1,82,77,-5,85,-7,home,home,46,-7,159
6/19/2021,605,MMinnesota,77,165,-110,MIN,Minnesota Lynx,3,-113,1022100077,55,35,0,0,0,0,0,0,0,95,77,-18,90,-20,home,away,35,20,172
6/19/2021,606,DDallas,95,165,-110,DAL,Dallas Wings,-3,-110,1022100077,55,35,1,1,1,1,1,1,1,95,77,-18,90,-20,home,home,55,-20,172
6/20/2021,611,NYNew York,76,160.5,-110,NYL,New York Liberty,2.5,-110,1022100078,36,44,1,0,1,1,1,1,1,73,76,3,80,8,away,away,44,-8,149
6/20/2021,612,LALos Angeles,73,160.5,-110,LAS,Los Angeles Sparks,-2.5,-110,1022100078,36,44,0,1,0,0,0,0,0,73,76,3,80,8,away,home,36,8,149
6/22/2021,615,CChicago,92,171,-107,CHI,Chicago Sky,-6.5,-110,1022100080,32,48,1,1,1,1,1,1,1,72,92,20,80,16,away,away,48,-16,164
6/22/2021,616,NYNew York,72,171,-113,NYL,New York Liberty,6.5,-110,1022100080,32,48,0,0,0,0,0,0,0,72,92,20,80,16,away,home,32,16,164
6/22/2021,613,DDallas,70,155.5,-110,DAL,Dallas Wings,-0.5,-110,1022100079,30,38,0,0,0,1,1,1,1,80,70,-10,68,8,away,away,38,-8,150
6/22/2021,614,CConnecticut,80,155.5,-110,CON,Connecticut Sun,-0.5,-110,1022100079,30,38,1,1,1,0,0,0,0,80,70,-10,68,8,away,home,30,8,150
6/22/2021,617,WWashington,87,167.5,-110,WAS,Washington Mystics,13.5,-110,1022100081,36,43,1,1,1,1,1,1,1,83,87,4,79,7,away,away,43,-7,170
6/22/2021,618,SSeattle,83,167.5,-110,SEA,Seattle Storm,-13.5,-110,1022100081,36,43,0,0,0,0,0,0,0,83,87,4,79,7,away,home,36,7,170
6/23/2021,619,MMinnesota,87,167.5,-110,MIN,Minnesota Lynx,-4,-110,1022100082,46,40,1,0,0,0,0,0,0,85,87,2,86,-6,home,away,40,6,172
6/23/2021,620,AAtlanta,85,167,-110,ATL,Atlanta Dream,4,-110,1022100082,46,40,0,1,1,1,1,1,1,85,87,2,86,-6,home,home,46,-6,172
6/24/2021,623,CChicago,91,171,-110,CHI,Chicago Sky,-6,-110,1022100084,27,55,1,1,1,1,1,1,1,68,91,23,82,28,away,away,55,-28,159
6/24/2021,624,NYNew York,68,171,-110,NYL,New York Liberty,7,-110,1022100084,27,55,0,0,0,0,0,0,0,68,91,23,82,28,away,home,27,28,159
6/24/2021,621,DDallas,89,162.5,-110,DAL,Dallas Wings,-8,-120,1022100083,24,43,1,1,1,1,1,1,1,64,89,25,67,19,away,away,43,-19,153
6/24/2021,622,IIndiana,64,162.5,-110,IND,Indiana Fever,8.5,-110,1022100083,24,43,0,0,0,0,0,0,0,64,89,25,67,19,away,home,24,19,153
6/24/2021,625,WWashington,82,156.5,-110,WAS,Washington Mystics,-3.5,-110,1022100085,49,44,1,1,1,1,1,0,1,89,82,-7,93,-5,home,away,44,5,171
6/24/2021,626,LALos Angeles,89,156.5,-110,LAS,Los Angeles Sparks,3.5,-110,1022100085,49,44,0,0,0,0,0,1,0,89,82,-7,93,-5,home,home,49,-5,171
6/25/2021,627,LVLas Vegas,89,172,-110,LVA,Las Vegas Aces,-6,-110,1022100086,44,48,0,0,0,0,1,0,1,90,89,-1,92,4,away,away,48,-4,179
6/25/2021,628,MMinnesota,90,172,-110,MIN,Minnesota Lynx,6,-110,1022100086,44,48,1,1,1,1,0,1,0,90,89,-1,92,4,away,home,44,4,179
6/26/2021,629,WWashington,74,167.5,-110,WAS,Washington Mystics,6.5,-115,1022100087,46,30,0,0,0,0,0,0,0,85,74,-11,76,-16,home,away,30,16,159
6/26/2021,630,DDallas,85,167.5,-110,DAL,Dallas Wings,-6,-112,1022100087,46,30,1,1,1,1,1,1,1,85,74,-11,76,-16,home,home,46,-16,159
6/26/2021,631,NYNew York,101,170,-110,NYL,New York Liberty,5,-110,1022100088,40,43,1,1,1,1,1,1,1,78,101,23,83,3,away,away,43,-3,179
6/26/2021,632,AAtlanta,78,170,-110,ATL,Atlanta Dream,-5,-110,1022100088,40,43,0,0,0,0,0,0,0,78,101,23,83,3,away,home,40,3,179
6/29/2021,639,NYNew York,69,170.5,-110,NYL,New York Liberty,3.5,-110,1022100092,40,34,1,1,1,1,0,0,0,73,69,-4,74,-6,home,away,34,6,142
6/29/2021,640,AAtlanta,73,170.5,-110,ATL,Atlanta Dream,-3.5,-110,1022100092,40,34,0,0,0,0,1,1,1,73,69,-4,74,-6,home,home,40,-6,142
6/29/2021,641,CConnecticut,90,158,-110,CON,Connecticut Sun,-6.5,-110,1022100093,33,49,1,1,1,1,1,1,1,71,90,19,82,16,away,away,49,-16,161
6/29/2021,642,WWashington,71,158,-110,WAS,Washington Mystics,6.5,-110,1022100093,33,49,0,0,0,0,0,0,0,71,90,19,82,16,away,home,33,16,161
6/30/2021,643,CChicago,91,166,-110,CHI,Chicago Sky,-2,-105,1022100094,29,51,1,1,1,1,1,1,1,81,91,10,80,22,away,away,51,-22,172
6/30/2021,644,DDallas,81,166,-105,DAL,Dallas Wings,2,-115,1022100094,29,51,0,0,0,0,0,0,0,81,91,10,80,22,away,home,29,22,172
6/30/2021,645,MMinnesota,82,165.5,-110,MIN,Minnesota Lynx,2.5,-110,1022100095,44,45,1,0,0,0,0,1,1,76,82,6,89,1,away,away,45,-1,158
6/30/2021,646,PPhoenix,76,165.5,-110,PHO,Phoenix Mercury,-2.5,-110,1022100095,44,45,0,1,1,1,1,0,0,76,82,6,89,1,away,home,44,1,158
6/30/2021,647,LVLas Vegas,99,164.5,-110,LVA,Las Vegas Aces,-12,-110,1022100096,37,56,0,0,1,1,1,1,1,75,99,24,93,19,away,away,56,-19,174
6/30/2021,648,LALos Angeles,75,164.5,-110,LAS,Los Angeles Sparks,12,-110,1022100096,37,56,1,1,0,0,0,0,0,75,99,24,93,19,away,home,37,19,174
7/1/2021,649,CConnecticut,86,153.5,-110,CON,Connecticut Sun,-15,-110,1022100097,37,55,0,1,1,1,1,1,1,80,86,6,92,18,away,away,55,-18,166
7/1/2021,650,IIndiana,80,153.5,-110,IND,Indiana Fever,15,-110,1022100097,37,55,1,0,0,0,0,0,0,80,86,6,92,18,away,home,37,18,166
7/2/2021,651,CChicago,91,167.5,-110,CHI,Chicago Sky,-2.5,-115,1022100098,51,48,1,1,1,1,1,1,1,100,91,-9,99,-3,home,away,48,3,191
7/2/2021,652,DDallas,100,167.5,-110,DAL,Dallas Wings,2.5,-110,1022100098,51,48,0,0,0,0,0,0,0,100,91,-9,99,-3,home,home,51,-3,191
7/2/2021,655,LVLas Vegas,66,167.5,-110,LVA,Las Vegas Aces,-15,-110,1022100099,30,38,1,1,0,0,1,1,1,58,66,8,68,8,away,away,38,-8,124
7/2/2021,656,LALos Angeles,58,167.5,-110,LAS,Los Angeles Sparks,15,-110,1022100099,30,38,0,0,1,1,0,0,0,58,66,8,68,8,away,home,30,8,124
7/2/2021,653,AAtlanta,88,166.5,-110,ATL,Atlanta Dream,15.5,-105,1022100101,50,47,0,0,1,0,0,0,0,91,88,-3,97,-3,home,away,47,3,179
7/2/2021,654,SSeattle,91,166.5,-110,SEA,Seattle Storm,-15.5,-115,1022100101,50,47,1,1,0,1,1,1,1,91,88,-3,97,-3,home,home,50,-3,179
7/4/2021,601,AAtlanta,95,174,-110,ATL,Atlanta Dream,15,-112,1022100104,51,48,1,0,1,1,1,0,0,118,95,-23,99,-3,home,away,48,3,213
7/4/2021,602,LVLas Vegas,118,174,-110,LVA,Las Vegas Aces,-15,-108,1022100104,51,48,0,1,0,0,0,1,1,118,95,-23,99,-3,home,home,51,-3,213
7/4/2021,603,SSeattle,84,159.5,-110,SEA,Seattle Storm,-11.5,-105,1022100105,30,39,0,1,1,1,1,1,1,74,84,10,69,9,away,away,39,-9,158
7/4/2021,604,LALos Angeles,74,159.5,-110,LAS,Los Angeles Sparks,11.5,-115,1022100105,30,39,1,0,0,0,0,0,0,74,84,10,69,9,away,home,30,9,158
7/5/2021,605,DDallas,96,166.5,-110,DAL,Dallas Wings,-5.5,-110,1022100106,51,47,1,0,0,0,0,1,0,99,96,-3,98,-4,home,away,47,4,195
7/5/2021,606,NYNew York,99,166.5,-110,NYL,New York Liberty,5.5,-110,1022100106,51,47,0,1,1,1,1,0,1,99,96,-3,98,-4,home,home,51,-4,195
7/7/2021,607,DDallas,79,167.5,-115,DAL,Dallas Wings,4.5,-110,1022100107,38,46,0,0,0,1,1,1,1,85,79,-6,84,8,away,away,46,-8,164
7/7/2021,608,MMinnesota,85,167.5,-105,MIN,Minnesota Lynx,-4,-111,1022100107,38,46,1,1,1,0,0,0,0,85,79,-6,84,8,away,home,38,8,164
7/7/2021,611,PPhoenix,99,173,-110,PHO,Phoenix Mercury,10.5,-105,1022100108,43,50,1,0,0,1,1,1,1,90,99,9,93,7,away,away,50,-7,189
7/7/2021,612,LVLas Vegas,90,173,-110,LVA,Las Vegas Aces,-10.5,-115,1022100108,43,50,0,1,1,0,0,0,0,90,99,9,93,7,away,home,43,7,189
7/7/2021,609,LALos Angeles,62,158,-110,LAS,Los Angeles Sparks,15.5,-110,1022100109,38,29,0,0,0,0,0,0,0,71,62,-9,67,-9,home,away,29,9,133
7/7/2021,610,SSeattle,71,158,-110,SEA,Seattle Storm,-15.5,-110,1022100109,38,29,1,1,1,1,1,1,1,71,62,-9,67,-9,home,home,38,-9,133
7/9/2021,615,NYNew York,69,164,-110,NYL,New York Liberty,-3.5,-110,1022100111,44,40,1,1,1,1,1,0,0,82,69,-13,84,-4,home,away,40,4,151
7/9/2021,616,IIndiana,82,164,-110,IND,Indiana Fever,3.5,-110,1022100111,44,40,0,0,0,0,0,1,1,82,69,-13,84,-4,home,home,44,-4,151
7/9/2021,613,AAtlanta,72,159.5,-110,ATL,Atlanta Dream,14,-110,1022100110,43,39,0,0,0,0,0,1,0,84,72,-12,82,-4,home,away,39,4,156
7/9/2021,614,CConnecticut,84,159.5,-110,CON,Connecticut Sun,-14,-110,1022100110,43,39,1,1,1,1,1,0,1,84,72,-12,82,-4,home,home,43,-4,156
7/9/2021,617,SSeattle,77,164,-110,SEA,Seattle Storm,-7,-120,1022100112,39,34,1,1,1,1,0,0,0,85,77,-8,73,-5,home,away,34,5,162
7/9/2021,618,PPhoenix,85,164,-110,PHO,Phoenix Mercury,7,100,1022100112,39,34,0,0,0,0,1,1,1,85,77,-8,73,-5,home,home,39,-5,162
7/9/2021,619,MMinnesota,77,171.5,-110,MIN,Minnesota Lynx,4.5,-110,1022100113,37,49,1,1,1,1,1,1,1,67,77,10,86,12,away,away,49,-12,144
7/9/2021,620,LVLas Vegas,67,171.5,-110,LVA,Las Vegas Aces,-4.5,-110,1022100113,37,49,0,0,0,0,0,0,0,67,77,10,86,12,away,home,37,12,144
7/10/2021,621,WWashington,89,170.5,-105,WAS,Washington Mystics,9,-110,1022100114,44,46,0,1,1,1,1,1,1,85,89,4,90,2,away,away,46,-2,174
7/10/2021,622,CChicago,85,170.5,-115,CHI,Chicago Sky,-9,-111,1022100114,44,46,1,0,0,0,0,0,0,85,89,4,90,2,away,home,44,2,174
7/11/2021,623,LVLas Vegas,95,173.5,-110,LVA,Las Vegas Aces,-3.5,-110,1022100115,42,48,0,0,0,0,0,1,1,79,95,16,90,6,away,away,48,-6,174
7/11/2021,624,DDallas,79,173.5,-110,DAL,Dallas Wings,3.5,-110,1022100115,42,48,1,1,1,1,1,0,0,79,95,16,90,6,away,home,42,6,174
7/11/2021,625,CConnecticut,71,157,-110,CON,Connecticut Sun,-8.5,-112,1022100116,28,37,1,1,1,1,1,1,1,54,71,17,65,9,away,away,37,-9,125
7/11/2021,626,NYNew York,54,157,-110,NYL,New York Liberty,8.5,-108,1022100116,28,37,0,0,0,0,0,0,0,54,71,17,65,9,away,home,28,9,125
7/11/2021,627,IIndiana,79,166.5,-110,IND,Indiana Fever,5.5,-113,1022100117,40,42,0,0,0,0,1,1,1,68,79,11,82,2,away,away,42,-2,147
7/11/2021,628,AAtlanta,68,166.5,-110,ATL,Atlanta Dream,-5.5,-107,1022100117,40,42,1,1,1,1,0,0,0,68,79,11,82,2,away,home,40,2,147
7/11/2021,629,PPhoenix,75,162,-110,PHO,Phoenix Mercury,9,-115,1022100118,44,39,1,1,1,0,0,0,0,82,75,-7,83,-5,home,away,39,5,157
7/11/2021,630,SSeattle,82,162,-110,SEA,Seattle Storm,-9,-105,1022100118,44,39,0,0,0,1,1,1,1,82,75,-7,83,-5,home,home,44,-5,157
7/11/2021,631,MMinnesota,86,153.5,-110,MIN,Minnesota Lynx,-8,-110,1022100119,31,43,1,1,1,1,1,1,1,61,86,25,74,12,away,away,43,-12,147
7/11/2021,632,LALos Angeles,61,153.5,-110,LAS,Los Angeles Sparks,8,-110,1022100119,31,43,0,0,0,0,0,0,0,61,86,25,74,12,away,home,31,12,147
8/15/2021,603,SSeattle,85,160,-110,SEA,Seattle Storm,6.5,-110,1022100120,35,32,1,1,1,1,0,0,0,87,85,-2,67,-3,home,away,32,3,172
8/15/2021,604,CChicago,87,160,-110,CHI,Chicago Sky,-6.5,-110,1022100120,35,32,0,0,0,0,1,1,1,87,85,-2,67,-3,home,home,35,-3,172
8/15/2021,605,CConnecticut,80,156.5,-110,CON,Connecticut Sun,-4.5,-110,1022100121,27,47,1,1,1,1,1,1,1,59,80,21,74,20,away,away,47,-20,139
8/15/2021,606,DDallas,59,156.5,-110,DAL,Dallas Wings,4.5,-110,1022100121,27,47,0,0,0,0,0,0,0,59,80,21,74,20,away,home,27,20,139
8/15/2021,609,AAtlanta,81,164,-115,ATL,Atlanta Dream,6,-105,1022100123,40,35,0,0,0,0,0,0,0,92,81,-11,75,-5,home,away,35,5,173
8/15/2021,610,PPhoenix,92,164,-105,PHO,Phoenix Mercury,-6,-115,1022100123,40,35,1,1,1,1,1,1,1,92,81,-11,75,-5,home,home,40,-5,173
8/15/2021,607,WWashington,83,173,-118,WAS,Washington Mystics,11,-110,1022100122,35,50,1,1,1,1,1,1,1,84,83,-1,85,15,away,away,50,-15,167
8/15/2021,608,LVLas Vegas,84,173,-102,LVA,Las Vegas Aces,-11,-110,1022100122,35,50,0,0,0,0,0,0,0,84,83,-1,85,15,away,home,35,15,167
8/15/2021,611,NYNew York,78,162.5,-110,NYL,New York Liberty,6.5,-110,1022100124,45,41,0,0,0,0,0,0,0,88,78,-10,86,-4,home,away,41,4,166
8/15/2021,612,MMinnesota,88,162.5,-110,MIN,Minnesota Lynx,-6.5,-110,1022100124,45,41,1,1,1,1,1,1,1,88,78,-10,86,-4,home,home,45,-4,166
8/15/2021,613,IIndiana,70,155,-110,IND,Indiana Fever,4.5,-107,1022100125,49,46,0,0,0,0,0,0,0,75,70,-5,95,-3,home,away,46,3,145
8/15/2021,614,LALos Angeles,75,155,-110,LAS,Los Angeles Sparks,-4.5,-113,1022100125,49,46,1,1,1,1,1,1,1,75,70,-5,95,-3,home,home,49,-3,145
8/17/2021,615,MMinnesota,60,154,-110,MIN,Minnesota Lynx,3.5,-110,1022100126,42,28,0,0,0,0,0,0,0,72,60,-12,70,-14,home,away,28,14,132
8/17/2021,616,CConnecticut,72,154,-110,CON,Connecticut Sun,-3.5,-110,1022100126,42,28,1,1,1,1,1,1,1,72,60,-12,70,-14,home,home,42,-14,132
8/17/2021,617,DDallas,80,167,-110,DAL,Dallas Wings,6,-113,1022100127,36,33,1,1,1,1,0,0,0,76,80,4,69,-3,home,away,33,3,156
8/17/2021,618,CChicago,76,167,-110,CHI,Chicago Sky,-6,-107,1022100127,36,33,0,0,0,0,1,1,1,76,80,4,69,-3,home,home,36,-3,156
8/17/2021,619,IIndiana,80,160.5,-110,IND,Indiana Fever,10,-110,1022100129,35,39,0,1,1,1,1,1,1,84,80,-4,74,4,away,away,39,-4,164
8/17/2021,620,PPhoenix,84,160.5,-110,PHO,Phoenix Mercury,-10,-110,1022100129,35,39,1,0,0,0,0,0,0,84,80,-4,74,4,away,home,35,4,164
8/17/2021,621,WWashington,83,172.5,-110,WAS,Washington Mystics,9.5,-110,1022100128,41,49,0,0,0,0,0,0,1,93,83,-10,90,8,away,away,49,-8,176
8/17/2021,622,LVLas Vegas,93,172.5,-110,LVA,Las Vegas Aces,-9.5,-110,1022100128,41,49,1,1,1,1,1,1,0,93,83,-10,90,8,away,home,41,8,176
8/17/2021,623,AAtlanta,80,158.5,-110,ATL,Atlanta Dream,4,-110,1022100130,30,36,1,0,0,1,1,1,1,85,80,-5,66,6,away,away,36,-6,165
8/17/2021,624,LALos Angeles,85,158.5,-110,LAS,Los Angeles Sparks,-4,-110,1022100130,30,36,0,1,1,0,0,0,0,85,80,-5,66,6,away,home,30,6,165
8/18/2021,625,SSeattle,79,157,-110,SEA,Seattle Storm,2,-110,1022100131,42,41,0,0,1,1,1,0,0,83,79,-4,83,-1,home,away,41,1,162
8/18/2021,626,NYNew York,83,157,-110,NYL,New York Liberty,-2,-110,1022100131,42,41,1,1,0,0,0,1,1,83,79,-4,83,-1,home,home,42,-1,162
8/20/2021,633,SSeattle,99,164.5,-110,SEA,Seattle Storm,-9,-110,1022100135,47,46,1,0,0,0,0,0,0,83,99,16,93,-1,home,away,46,1,182
8/20/2021,634,NYNew York,83,164.5,-110,NYL,New York Liberty,9,-110,1022100135,47,46,0,1,1,1,1,1,1,83,99,16,93,-1,home,home,47,-1,182
8/20/2021,635,IIndiana,83,159,-110,IND,Indiana Fever,7.5,-110,1022100136,48,45,1,0,0,0,0,0,0,81,83,2,93,-3,home,away,45,3,164
8/20/2021,636,DDallas,81,159,-110,DAL,Dallas Wings,-7.5,-110,1022100136,48,45,0,1,1,1,1,1,1,81,83,2,93,-3,home,home,48,-3,164
8/21/2021,637,PPhoenix,84,164.5,-110,PHO,Phoenix Mercury,-5.5,-110,1022100137,32,39,1,1,1,1,1,1,1,69,84,15,71,7,away,away,39,-7,153
8/21/2021,638,AAtlanta,69,164.5,-110,ATL,Atlanta Dream,5.5,-110,1022100137,32,39,0,0,0,0,0,0,0,69,84,15,71,7,away,home,32,7,153
8/21/2021,639,MMinnesota,101,161.5,-110,MIN,Minnesota Lynx,-2.5,-115,1022100138,44,48,1,1,1,1,1,1,1,95,101,6,92,4,away,away,48,-4,196
8/21/2021,640,CChicago,95,161.5,-110,CHI,Chicago Sky,2.5,-105,1022100138,44,48,0,0,0,0,0,0,0,95,101,6,92,4,away,home,44,4,196
8/22/2021,641,LALos Angeles,86,154,-110,LAS,Los Angeles Sparks,3.5,-115,1022100139,45,38,1,1,1,1,1,0,0,83,86,3,83,-7,home,away,38,7,169
8/22/2021,642,NYNew York,83,154,-110,NYL,New York Liberty,-3.5,-105,1022100139,45,38,0,0,0,0,0,1,1,83,86,3,83,-7,home,home,45,-7,169
8/22/2021,643,SSeattle,85,167.5,-110,SEA,Seattle Storm,-8,-110,1022100140,33,43,0,0,0,1,1,1,1,78,85,7,76,10,away,away,43,-10,163
8/22/2021,644,WWashington,78,167.5,-110,WAS,Washington Mystics,8,-110,1022100140,33,43,1,1,1,0,0,0,0,78,85,7,76,10,away,home,33,10,163
8/24/2021,649,LALos Angeles,68,157,-110,LAS,Los Angeles Sparks,2,-110,1022100144,56,23,0,0,0,0,0,0,0,78,68,-10,79,-33,home,away,23,33,146
8/24/2021,650,WWashington,78,157,-110,WAS,Washington Mystics,-2,-110,1022100144,56,23,1,1,1,1,1,1,1,78,68,-10,79,-33,home,home,56,-33,146
8/24/2021,651,SSeattle,70,165.5,-110,SEA,Seattle Storm,-4,-115,1022100141,40,33,0,0,0,0,0,0,0,76,70,-6,73,-7,home,away,33,7,146
8/24/2021,652,MMinnesota,76,165.5,-110,MIN,Minnesota Lynx,4,-105,1022100141,40,33,1,1,1,1,1,1,1,76,70,-6,73,-7,home,home,40,-7,146
8/24/2021,645,LVLas Vegas,62,156,-107,LVA,Las Vegas Aces,3,-105,1022100143,40,32,1,0,1,0,0,0,0,76,62,-14,72,-8,home,away,32,8,138
8/24/2021,646,CConnecticut,76,156,-113,CON,Connecticut Sun,-3,-115,1022100143,40,32,0,1,0,1,1,1,1,76,62,-14,72,-8,home,home,40,-8,138
8/24/2021,647,CChicago,86,167.5,-110,CHI,Chicago Sky,-7,-110,1022100142,33,40,1,1,1,1,1,1,1,79,86,7,73,7,away,away,40,-7,165
8/24/2021,648,AAtlanta,79,167.5,-110,ATL,Atlanta Dream,7,-110,1022100142,33,40,0,0,0,0,0,0,0,79,86,7,73,7,away,home,33,7,165
8/25/2021,601,PPhoenix,106,162.5,-110,PHO,Phoenix Mercury,-6.5,-110,1022100145,42,55,1,1,1,1,1,1,1,79,106,27,97,13,away,away,55,-13,185
8/25/2021,602,NYNew York,79,162.5,-110,NYL,New York Liberty,6.5,-110,1022100145,42,55,0,0,0,0,0,0,0,79,106,27,97,13,away,home,42,13,185
8/26/2021,603,LALos Angeles,72,145.5,-110,LAS,Los Angeles Sparks,12,-115,1022100147,36,39,0,0,0,0,1,1,0,76,72,-4,75,3,away,away,39,-3,148
8/26/2021,604,CConnecticut,76,145.5,-110,CON,Connecticut Sun,-12,-105,1022100147,36,39,1,1,1,1,0,0,1,76,72,-4,75,3,away,home,36,3,148
8/26/2021,607,DDallas,82,162.5,-110,DAL,Dallas Wings,4.5,-105,1022100148,43,34,0,0,0,0,0,0,0,77,82,5,77,-9,home,away,34,9,159
8/26/2021,608,WWashington,77,162.5,-110,WAS,Washington Mystics,-4.5,-115,1022100148,43,34,1,1,1,1,1,1,1,77,82,5,77,-9,home,home,43,-9,159
8/26/2021,605,LVLas Vegas,78,166.5,-110,LVA,Las Vegas Aces,-12.5,-115,1022100146,48,40,0,0,0,1,1,1,0,71,78,7,88,-8,home,away,40,8,149
8/26/2021,606,AAtlanta,71,166.5,-110,ATL,Atlanta Dream,12.5,-105,1022100146,48,40,1,1,1,0,0,0,1,71,78,7,88,-8,home,home,48,-8,149
8/27/2021,609,PPhoenix,80,165.5,-110,PHO,Phoenix Mercury,-3.5,-105,1022100149,32,42,1,1,1,1,1,1,1,64,80,16,74,10,away,away,42,-10,144
8/27/2021,610,NYNew York,64,165.5,-110,NYL,New York Liberty,3.5,-115,1022100149,32,42,0,0,0,0,0,0,0,64,80,16,74,10,away,home,32,10,144
8/27/2021,611,CChicago,73,167,-110,CHI,Chicago Sky,6,-110,1022100150,32,28,1,0,0,0,0,0,0,69,73,4,60,-4,home,away,28,4,142
8/27/2021,612,SSeattle,69,167,-110,SEA,Seattle Storm,-6,-110,1022100150,32,28,0,1,1,1,1,1,1,69,73,4,60,-4,home,home,32,-4,142
8/28/2021,613,LVLas Vegas,87,164.5,-115,LVA,Las Vegas Aces,-12.5,-110,1022100151,31,50,1,1,1,1,1,1,1,71,87,16,81,19,away,away,50,-19,158
8/28/2021,614,IIndiana,71,164.5,-105,IND,Indiana Fever,12.5,-110,1022100151,31,50,0,0,0,0,0,0,0,71,87,16,81,19,away,home,31,19,158
8/28/2021,615,DDallas,75,161,-110,DAL,Dallas Wings,-1,-105,1022100153,19,35,1,1,1,1,1,1,1,76,75,-1,54,16,away,away,35,-16,151
8/28/2021,616,WWashington,76,161,-110,WAS,Washington Mystics,1,-115,1022100153,19,35,0,0,0,0,0,0,0,76,75,-1,54,16,away,home,19,16,151
8/28/2021,617,LALos Angeles,61,144.5,-110,LAS,Los Angeles Sparks,9.5,-110,1022100152,40,37,0,1,1,1,1,0,0,76,61,-15,77,-3,home,away,37,3,137
8/28/2021,618,CConnecticut,76,144.5,-110,CON,Connecticut Sun,-9.5,-110,1022100152,40,37,1,0,0,0,0,1,1,76,61,-15,77,-3,home,home,40,-3,137
8/29/2021,619,CChicago,107,164,-110,CHI,Chicago Sky,6.5,-109,1022100154,41,63,1,1,1,1,1,1,1,75,107,32,104,22,away,away,63,-22,182
8/29/2021,620,SSeattle,75,164,-110,SEA,Seattle Storm,-6.5,-111,1022100154,41,63,0,0,0,0,0,0,0,75,107,32,104,22,away,home,41,22,182
9/2/2021,629,AAtlanta,68,159,-110,ATL,Atlanta Dream,6.5,-105,1022100159,36,31,0,0,0,1,1,0,0,72,68,-4,67,-5,home,away,31,5,140
9/2/2021,630,DDallas,72,159,-110,DAL,Dallas Wings,-6.5,-115,1022100159,36,31,1,1,1,0,0,1,1,72,68,-4,67,-5,home,home,36,-5,140
9/2/2021,631,LALos Angeles,57,152,-110,LAS,Los Angeles Sparks,7.5,-110,1022100160,35,41,0,0,1,1,1,1,1,66,57,-9,76,6,away,away,41,-6,123
9/2/2021,632,MMinnesota,66,152,-110,MIN,Minnesota Lynx,-7.5,-110,1022100160,35,41,1,1,0,0,0,0,0,66,57,-9,76,6,away,home,35,6,123
9/2/2021,633,NYNew York,75,163.5,-110,NYL,New York Liberty,12,-110,1022100162,40,45,0,0,0,1,1,1,1,85,75,-10,85,5,away,away,45,-5,160
9/2/2021,634,SSeattle,85,163.5,-110,SEA,Seattle Storm,-12,-110,1022100162,40,45,1,1,1,0,0,0,0,85,75,-10,85,5,away,home,40,5,160
9/2/2021,635,CChicago,83,171,-110,CHI,Chicago Sky,3.5,-115,1022100161,52,36,0,0,0,0,0,0,0,90,83,-7,88,-16,home,away,36,16,173
9/2/2021,636,LVLas Vegas,90,171,-110,LVA,Las Vegas Aces,-3.5,-105,1022100161,52,36,1,1,1,1,1,1,1,90,83,-7,88,-16,home,home,52,-16,173
9/4/2021,637,PPhoenix,87,160,-110,PHO,Phoenix Mercury,-7.5,-110,1022100163,44,40,1,1,0,0,0,0,0,65,87,22,84,-4,home,away,40,4,152
9/4/2021,638,IIndiana,65,160,-110,IND,Indiana Fever,7.5,-110,1022100163,44,40,0,0,1,1,1,1,1,65,87,22,84,-4,home,home,44,-4,152
9/4/2021,639,WWashington,75,159.5,-110,WAS,Washington Mystics,7.5,-110,1022100164,50,35,0,0,0,0,0,0,0,93,75,-18,85,-15,home,away,35,15,168
9/4/2021,640,MMinnesota,93,159.5,-110,MIN,Minnesota Lynx,-7.5,-110,1022100164,50,35,1,1,1,1,1,1,1,93,75,-18,85,-15,home,home,50,-15,168
9/6/2021,645,PPhoenix,86,159.5,-110,PHO,Phoenix Mercury,-11,-110,1022100167,42,43,0,0,0,0,0,1,1,81,86,5,85,1,away,away,43,-1,167
9/6/2021,646,IIndiana,81,159.5,-110,IND,Indiana Fever,11,-110,1022100167,42,43,1,1,1,1,1,0,0,81,86,5,85,1,away,home,42,1,167
9/7/2021,647,CConnecticut,83,148.5,-110,CON,Connecticut Sun,-9,-110,1022100168,25,48,1,1,1,1,1,1,1,56,83,27,73,23,away,away,48,-23,139
9/7/2021,648,DDallas,56,148.5,-110,DAL,Dallas Wings,9,-110,1022100168,25,48,0,0,0,0,0,0,0,56,83,27,73,23,away,home,25,23,139
9/7/2021,649,WWashington,71,163.5,-110,WAS,Washington Mystics,10,-110,1022100169,54,39,0,0,0,0,0,0,0,105,71,-34,93,-15,home,away,39,15,176
9/7/2021,650,SSeattle,105,163.5,-110,SEA,Seattle Storm,-10,-110,1022100169,54,39,1,1,1,1,1,1,1,105,71,-34,93,-15,home,home,54,-15,176
9/8/2021,651,PPhoenix,76,155,-110,PHO,Phoenix Mercury,-4,-110,1022100170,48,34,0,0,0,0,0,0,0,75,76,1,82,-14,home,away,34,14,151
9/8/2021,652,AAtlanta,75,155,-110,ATL,Atlanta Dream,4,-110,1022100170,48,34,1,1,1,1,1,1,1,75,76,1,82,-14,home,home,48,-14,151
9/8/2021,653,MMinnesota,81,167,-110,MIN,Minnesota Lynx,4,-110,1022100171,55,41,1,0,0,0,0,0,0,102,81,-21,96,-14,home,away,41,14,183
9/8/2021,654,LVLas Vegas,102,167,-110,LVA,Las Vegas Aces,-4,-110,1022100171,55,41,0,1,1,1,1,1,1,102,81,-21,96,-14,home,home,55,-14,183
9/9/2021,655,CConnecticut,75,142,-105,CON,Connecticut Sun,-10,-110,1022100172,28,45,1,1,1,1,1,1,1,57,75,18,73,17,away,away,45,-17,132
9/9/2021,656,LALos Angeles,57,142,-115,LAS,Los Angeles Sparks,10,-110,1022100172,28,45,0,0,0,0,0,0,0,57,75,18,73,17,away,home,28,17,132
7/7/2022,645,CChicago,93,168,-110,CHI,Chicago Sky,-9,-110,1022200134,38,48,0,1,1,1,1,1,1,84,93,9,86,10,away,away,48,-10,177
7/7/2022,646,IIndiana,84,168,-110,IND,Indiana Fever,9,-110,1022200134,38,48,1,0,0,0,0,0,0,84,93,9,86,10,away,home,38,10,177
7/7/2022,647,NYNew York,81,164.5,-120,NYL,New York Liberty,4.5,-110,1022200135,42,34,0,0,0,0,0,0,0,84,81,-3,76,-8,home,away,34,8,165
7/7/2022,648,PPhoenix,84,164.5,100,PHO,Phoenix Mercury,-4.5,-110,1022200135,42,34,1,1,1,1,1,1,1,84,81,-3,76,-8,home,home,42,-8,165
7/7/2022,649,SSeattle,106,161,-115,SEA,Seattle Storm,-4.5,-110,1022200136,32,51,1,1,1,1,1,1,1,69,106,37,83,19,away,away,51,-19,175
7/7/2022,650,LALos Angeles,69,161,-105,LAS,Los Angeles Sparks,4.5,-110,1022200136,32,51,0,0,0,0,0,0,0,69,106,37,83,19,away,home,32,19,175
7/15/2022,621,MMinnesota,87,167,-110,MIN,Minnesota Lynx,-4,-110,1022200147,38,37,1,0,1,0,0,0,0,77,87,10,75,-1,home,away,37,1,164
7/15/2022,622,IIndiana,77,167,-110,IND,Indiana Fever,4,-110,1022200147,38,37,0,1,0,1,1,1,1,77,87,10,75,-1,home,home,38,-1,164
7/15/2022,623,CConnecticut,93,156,-110,CON,Connecticut Sun,-8,-110,1022200148,33,51,1,1,1,1,1,1,1,68,93,25,84,18,away,away,51,-18,161
7/15/2022,624,AAtlanta,68,156,-110,ATL,Atlanta Dream,8,-110,1022200148,33,51,0,0,0,0,0,0,0,68,93,25,84,18,away,home,33,18,161
9/4/2022,635,CChicago,76,162,-110,CHI,Chicago Sky,0.5,-110,1042200213,38,40,1,0,0,0,0,0,1,72,76,4,78,2,away,away,40,-2,148
9/4/2022,636,CConnecticut,72,162,-110,CON,Connecticut Sun,-0.5,-110,1042200213,38,40,0,1,1,1,1,1,0,72,76,4,78,2,away,home,38,2,148
9/4/2022,637,LVLas Vegas,110,165,-110,LVA,Las Vegas Aces,1,-110,1042200203,40,48,1,1,1,1,1,1,1,98,110,12,88,8,away,away,48,-8,208
9/4/2022,638,SSeattle,98,165,-110,SEA,Seattle Storm,-1,-110,1042200203,40,48,0,0,0,0,0,0,0,98,110,12,88,8,away,home,40,8,208
9/11/2022,601,CConnecticut,64,168,-110,CON,Connecticut Sun,6,-110,1042200301,34,38,0,0,0,0,1,1,1,67,64,-3,72,4,away,away,38,-4,131
9/11/2022,602,LVLas Vegas,67,168.5,-110,LVA,Las Vegas Aces,-6,-110,1042200301,34,38,1,1,1,1,0,0,0,67,64,-3,72,4,away,home,34,4,131
9/15/2022,605,LVLas Vegas,76,160.5,-110,LVA,Las Vegas Aces,1,-107,1042200303,53,42,1,1,0,0,0,0,0,105,76,-29,95,-11,home,away,42,11,181
9/15/2022,606,CConnecticut,105,160.5,-110,CON,Connecticut Sun,-1,-113,1042200303,53,42,0,0,1,1,1,1,1,105,76,-29,95,-11,home,home,53,-11,181
5/6/2022,601,IIndiana,70,162,-110,IND,Indiana Fever,9,-110,1022200001,50,31,1,0,0,0,0,0,0,84,70,-14,81,-19,home,away,31,19,154
5/6/2022,602,WWashington,84,162,-110,WAS,Washington Mystics,-9,-110,1022200001,50,31,0,1,1,1,1,1,1,84,70,-14,81,-19,home,home,50,-19,154
5/6/2022,603,LALos Angeles,98,155,-110,LAS,Los Angeles Sparks,3.5,-110,1022200002,39,42,0,0,1,0,1,1,1,91,98,7,81,3,away,away,42,-3,189
5/6/2022,604,CChicago,91,155,-110,CHI,Chicago Sky,-3.5,-110,1022200002,39,42,1,1,0,1,0,0,0,91,98,7,81,3,away,home,39,3,189
5/6/2022,605,MMinnesota,74,161,-110,MIN,Minnesota Lynx,9,-110,1022200004,41,41,1,1,1,0,0,1,1,97,74,-23,82,0,tie,away,41,-0,171
5/6/2022,606,SSeattle,97,161,-110,SEA,Seattle Storm,-9,-110,1022200004,41,41,0,0,0,1,1,0,0,97,74,-23,82,0,tie,home,41,0,171
5/6/2022,607,LVLas Vegas,106,173,-110,LVA,Las Vegas Aces,-4.5,-110,1022200003,32,54,1,1,1,1,1,1,1,88,106,18,86,22,away,away,54,-22,194
5/6/2022,608,PPhoenix,88,173,-110,PHO,Phoenix Mercury,4.5,-110,1022200003,32,54,0,0,0,0,0,0,0,88,106,18,86,22,away,home,32,22,194
5/14/2022,661,PPhoenix,69,161.5,-110,PHO,Phoenix Mercury,-2,-110,1022200018,32,34,1,0,1,1,0,1,0,64,69,5,66,2,away,away,34,-2,133
5/14/2022,662,SSeattle,64,161.5,-110,SEA,Seattle Storm,2,-110,1022200018,32,34,0,1,0,0,1,0,1,64,69,5,66,2,away,home,32,2,133
5/14/2022,663,LALos Angeles,60,158,-110,LAS,Los Angeles Sparks,7.5,-110,1022200019,49,25,0,0,0,0,0,0,0,77,60,-17,74,-24,home,away,25,24,137
5/14/2022,664,CConnecticut,77,158,-110,CON,Connecticut Sun,-7.5,-110,1022200019,49,25,1,1,1,1,1,1,1,77,60,-17,74,-24,home,home,49,-24,137
5/14/2022,665,CChicago,82,160,-105,CHI,Chicago Sky,-8,-110,1022200020,38,47,1,1,1,1,1,1,1,78,82,4,85,9,away,away,47,-9,160
5/14/2022,666,MMinnesota,78,160,-115,MIN,Minnesota Lynx,8,-110,1022200020,38,47,0,0,0,0,0,0,0,78,82,4,85,9,away,home,38,9,160
5/17/2022,611,CConnecticut,92,155,-110,CON,Connecticut Sun,-8.5,-110,1022200023,32,51,0,0,1,1,1,1,1,65,92,27,83,19,away,away,51,-19,157
5/17/2022,612,NYNew York,65,155,-110,NYL,New York Liberty,8.5,-110,1022200023,32,51,1,1,0,0,0,0,0,65,92,27,83,19,away,home,32,19,157
5/17/2022,609,AAtlanta,101,158.5,-115,ATL,Atlanta Dream,-0.5,-110,1022200024,35,50,1,1,1,1,1,1,1,79,101,22,85,15,away,away,50,-15,180
5/17/2022,610,IIndiana,79,158.5,-105,IND,Indiana Fever,-0.5,-110,1022200024,35,50,0,0,0,0,0,0,0,79,101,22,85,15,away,home,35,15,180
5/17/2022,613,WWashington,84,161,-110,WAS,Washington Mystics,-3,-110,1022200025,34,37,0,0,0,0,0,1,1,68,84,16,71,3,away,away,37,-3,152
5/17/2022,614,DDallas,68,161,-110,DAL,Dallas Wings,3,-110,1022200025,34,37,1,1,1,1,1,0,0,68,84,16,71,3,away,home,34,3,152
5/17/2022,615,PPhoenix,74,170,-110,PHO,Phoenix Mercury,8,-105,1022200026,39,43,1,1,1,1,1,1,1,86,74,-12,82,4,away,away,43,-4,160
5/17/2022,616,LVLas Vegas,86,170,-110,LVA,Las Vegas Aces,-8,-115,1022200026,39,43,0,0,0,0,0,0,0,86,74,-12,82,4,away,home,39,4,160
5/17/2022,617,MMinnesota,87,160,-115,MIN,Minnesota Lynx,7,-110,1022200027,40,46,0,1,1,1,1,1,1,84,87,3,86,6,away,away,46,-6,171
5/17/2022,618,LALos Angeles,84,160,-105,LAS,Los Angeles Sparks,-7,-110,1022200027,40,46,1,0,0,0,0,0,0,84,87,3,86,6,away,home,40,6,171
5/24/2022,601,AAtlanta,50,157.5,-110,ATL,Atlanta Dream,8.5,-110,1022200040,34,25,0,0,0,0,0,0,0,70,50,-20,59,-9,home,away,25,9,120
5/24/2022,602,WWashington,70,157.5,-110,WAS,Washington Mystics,-8.5,-110,1022200040,34,25,1,1,1,1,1,1,1,70,50,-20,59,-9,home,home,34,-9,120
5/24/2022,603,DDallas,85,160,-110,DAL,Dallas Wings,8,-110,1022200039,39,27,0,0,0,0,0,0,0,77,85,8,66,-12,home,away,27,12,162
5/24/2022,604,CConnecticut,77,160,-110,CON,Connecticut Sun,-8,-110,1022200039,39,27,1,1,1,1,1,1,1,77,85,8,66,-12,home,home,39,-12,162
5/24/2022,605,IIndiana,90,162.5,-110,IND,Indiana Fever,13,-105,1022200041,42,49,0,0,0,0,0,0,0,95,90,-5,91,7,away,away,49,-7,185
5/24/2022,606,CChicago,95,162.5,-110,CHI,Chicago Sky,-13,-115,1022200041,42,49,1,1,1,1,1,1,1,95,90,-5,91,7,away,home,42,7,185
5/24/2022,607,NYNew York,78,160.5,-110,NYL,New York Liberty,5,-110,1022200042,45,42,0,0,0,0,0,0,0,84,78,-6,87,-3,home,away,42,3,162
5/24/2022,608,MMinnesota,84,160.5,-110,MIN,Minnesota Lynx,-5,-110,1022200042,45,42,1,1,1,1,1,1,1,84,78,-6,87,-3,home,home,45,-3,162
6/17/2022,613,SSeattle,71,162.5,-115,SEA,Seattle Storm,7.5,-110,1022200089,42,32,1,1,0,0,0,0,0,82,71,-11,74,-10,home,away,32,10,153
6/17/2022,614,CConnecticut,82,162.5,-105,CON,Connecticut Sun,-7.5,-110,1022200089,42,32,0,0,1,1,1,1,1,82,71,-11,74,-10,home,home,42,-10,153
6/17/2022,615,AAtlanta,100,158.5,-115,ATL,Atlanta Dream,7,-110,1022200091,56,42,1,1,0,1,0,0,0,106,100,-6,98,-14,home,away,42,14,206
6/17/2022,616,CChicago,106,158.5,-105,CHI,Chicago Sky,-7,-110,1022200091,56,42,0,0,1,0,1,1,1,106,100,-6,98,-14,home,home,56,-14,206
6/17/2022,617,PPhoenix,88,169.5,-110,PHO,Phoenix Mercury,5,-110,1022200090,53,39,0,0,0,0,0,0,0,93,88,-5,92,-14,home,away,39,14,181
6/17/2022,618,DDallas,93,169.5,-110,DAL,Dallas Wings,-5,-110,1022200090,53,39,1,1,1,1,1,1,1,93,88,-5,92,-14,home,home,53,-14,181
7/14/2022,613,LVLas Vegas,108,175,-110,LVA,Las Vegas Aces,-6,-110,1022200143,36,71,1,1,1,1,1,1,1,74,108,34,107,35,away,away,71,-35,182
7/14/2022,614,NYNew York,74,175,-110,NYL,New York Liberty,6,-110,1022200143,36,71,0,0,0,0,0,0,0,74,108,34,107,35,away,home,36,35,182
7/14/2022,615,DDallas,92,165.5,-110,DAL,Dallas Wings,4.5,-110,1022200144,27,48,1,1,1,1,1,1,1,87,92,5,75,21,away,away,48,-21,179
7/14/2022,616,MMinnesota,87,165.5,-110,MIN,Minnesota Lynx,-4.5,-110,1022200144,27,48,0,0,0,0,0,0,0,87,92,5,75,21,away,home,27,21,179
7/14/2022,617,WWashington,75,160,-110,WAS,Washington Mystics,-4.5,-110,1022200145,43,45,1,1,1,1,1,1,1,80,75,-5,88,2,away,away,45,-2,155
7/14/2022,618,PPhoenix,80,160,-110,PHO,Phoenix Mercury,4.5,-110,1022200145,43,45,0,0,0,0,0,0,0,80,75,-5,88,2,away,home,43,2,155
7/14/2022,619,CChicago,80,169,-110,CHI,Chicago Sky,-6,-110,1022200146,28,37,0,0,1,1,1,1,1,68,80,12,65,9,away,away,37,-9,148
7/14/2022,620,LALos Angeles,68,169,-110,LAS,Los Angeles Sparks,6,-110,1022200146,28,37,1,1,0,0,0,0,0,68,80,12,65,9,away,home,28,9,148
7/19/2022,635,NYNew York,63,161.5,-110,NYL,New York Liberty,5,-110,1022200154,39,35,0,0,1,1,1,0,0,82,63,-19,74,-4,home,away,35,4,145
7/19/2022,636,CConnecticut,82,161.5,-110,CON,Connecticut Sun,-5,-110,1022200154,39,35,1,1,0,0,0,1,1,82,63,-19,74,-4,home,home,39,-4,145
7/19/2022,637,AAtlanta,92,173.5,-110,ATL,Atlanta Dream,13,-110,1022200155,36,52,1,1,1,1,1,1,1,76,92,16,88,16,away,away,52,-16,168
7/19/2022,638,LVLas Vegas,76,173.5,-110,LVA,Las Vegas Aces,-13,-110,1022200155,36,52,0,0,0,0,0,0,0,76,92,16,88,16,away,home,36,16,168
7/19/2022,639,IIndiana,79,162.5,-110,IND,Indiana Fever,8,-110,1022200156,42,40,0,0,0,0,1,1,0,86,79,-7,82,-2,home,away,40,2,165
7/19/2022,640,LALos Angeles,86,162.5,-110,LAS,Los Angeles Sparks,-8,-110,1022200156,42,40,1,1,1,1,0,0,1,86,79,-7,82,-2,home,home,42,-2,165
7/24/2022,601,DDallas,96,167,-110,DAL,Dallas Wings,-6.5,-115,1022200166,39,45,0,0,0,0,1,1,1,86,96,10,84,6,away,away,45,-6,182
7/24/2022,602,IIndiana,86,167,-110,IND,Indiana Fever,6.5,-105,1022200166,39,45,1,1,1,1,0,0,0,86,96,10,84,6,away,home,39,6,182
7/24/2022,603,AAtlanta,72,157.5,-110,ATL,Atlanta Dream,7.5,-108,1022200167,41,34,0,1,1,0,0,0,0,82,72,-10,75,-7,home,away,34,7,154
7/24/2022,604,SSeattle,82,157.5,-110,SEA,Seattle Storm,-7.5,-112,1022200167,41,34,1,0,0,1,1,1,1,82,72,-10,75,-7,home,home,41,-7,154
7/24/2022,605,CConnecticut,86,164,-110,CON,Connecticut Sun,-5.5,-110,1022200168,32,42,1,1,1,1,1,1,1,79,86,7,74,10,away,away,42,-10,165
7/24/2022,606,MMinnesota,79,164,-110,MIN,Minnesota Lynx,5.5,-110,1022200168,32,42,0,0,0,0,0,0,0,79,86,7,74,10,away,home,32,10,165
8/6/2022,601,IIndiana,91,164.5,-110,IND,Indiana Fever,13.5,-115,1022200193,38,50,1,1,1,1,1,1,1,95,91,-4,88,12,away,away,50,-12,186
8/6/2022,602,DDallas,95,164.5,-110,DAL,Dallas Wings,-13.5,-105,1022200193,38,50,0,0,0,0,0,0,0,95,91,-4,88,12,away,home,38,12,186
8/6/2022,603,NYNew York,62,158,-110,NYL,New York Liberty,-5.5,-115,1022200194,43,34,0,0,0,0,0,0,0,76,62,-14,77,-9,home,away,34,9,138
8/6/2022,604,PPhoenix,76,158,-110,PHO,Phoenix Mercury,5.5,-105,1022200194,43,34,1,1,1,1,1,1,1,76,62,-14,77,-9,home,home,43,-9,138
8/8/2022,613,NYNew York,77,162,-110,NYL,New York Liberty,4.5,-110,1022200199,44,38,0,0,0,0,0,0,0,86,77,-9,82,-6,home,away,38,6,163
8/8/2022,614,DDallas,86,162,-110,DAL,Dallas Wings,-4.5,-110,1022200199,44,38,1,1,1,1,1,1,1,86,77,-9,82,-6,home,home,44,-6,163
8/9/2022,615,SSeattle,111,165,-110,SEA,Seattle Storm,5,-110,1022200200,55,66,1,1,1,1,1,1,1,100,111,11,121,11,away,away,66,-11,211
8/9/2022,616,CChicago,100,165,-110,CHI,Chicago Sky,-5,-110,1022200200,55,66,0,0,0,0,0,0,0,100,111,11,121,11,away,home,55,11,211
8/9/2022,617,AAtlanta,90,166.5,-110,ATL,Atlanta Dream,13,-110,1022200201,47,44,0,0,1,0,1,0,0,97,90,-7,91,-3,home,away,44,3,187
8/9/2022,618,LVLas Vegas,97,166.5,-110,LVA,Las Vegas Aces,-13,-110,1022200201,47,44,1,1,0,1,0,1,1,97,90,-7,91,-3,home,home,47,-3,187
8/9/2022,619,CConnecticut,97,159.5,-110,CON,Connecticut Sun,-8.5,-110,1022200202,32,53,0,1,1,1,1,1,1,71,97,26,85,21,away,away,53,-21,168
8/9/2022,620,LALos Angeles,71,159.5,-110,LAS,Los Angeles Sparks,8.5,-110,1022200202,32,53,1,0,0,0,0,0,0,71,97,26,85,21,away,home,32,21,168
8/10/2022,621,NYNew York,91,163,-110,NYL,New York Liberty,2.5,-110,1022200203,39,38,0,0,0,0,0,0,1,73,91,18,77,-1,home,away,38,1,164
8/10/2022,622,DDallas,73,163,-110,DAL,Dallas Wings,-2.5,-110,1022200203,39,38,1,1,1,1,1,1,0,73,91,18,77,-1,home,home,39,-1,164
8/10/2022,623,MMinnesota,86,161,-110,MIN,Minnesota Lynx,-6.5,-110,1022200204,40,42,0,1,1,0,0,0,0,77,86,9,82,2,away,away,42,-2,163
8/10/2022,624,PPhoenix,77,161,-110,PHO,Phoenix Mercury,6.5,-110,1022200204,40,42,1,0,0,1,1,1,1,77,86,9,82,2,away,home,40,2,163
8/11/2022,625,CChicago,78,175.5,-110,CHI,Chicago Sky,1.5,-110,1022200205,47,33,0,0,0,0,0,0,0,89,78,-11,80,-14,home,away,33,14,167
8/11/2022,626,LVLas Vegas,89,175.5,-110,LVA,Las Vegas Aces,-1.5,-110,1022200205,47,33,1,1,1,1,1,1,1,89,78,-11,80,-14,home,home,47,-14,167
8/11/2022,627,CConnecticut,93,162,-110,CON,Connecticut Sun,-11,-110,1022200206,43,54,1,1,1,1,1,1,1,69,93,24,97,11,away,away,54,-11,162
8/11/2022,628,LALos Angeles,69,162,-110,LAS,Los Angeles Sparks,11,-110,1022200206,43,54,0,0,0,0,0,0,0,69,93,24,97,11,away,home,43,11,162
8/12/2022,629,WWashington,82,159,-110,WAS,Washington Mystics,-13.5,-110,1022200207,30,39,1,1,1,1,1,1,1,70,82,12,69,9,away,away,39,-9,152
8/12/2022,630,IIndiana,70,159,-110,IND,Indiana Fever,13.5,-110,1022200207,30,39,0,0,0,0,0,0,0,70,82,12,69,9,away,home,30,9,152
8/12/2022,631,NYNew York,80,159.5,-110,NYL,New York Liberty,-1.5,-110,1022200208,42,53,1,1,1,1,1,1,1,70,80,10,95,11,away,away,53,-11,150
8/12/2022,632,AAtlanta,70,159.5,-110,ATL,Atlanta Dream,1.5,-110,1022200208,42,53,0,0,0,0,0,0,0,70,80,10,95,11,away,home,42,11,150
8/12/2022,633,SSeattle,96,163.5,-110,SEA,Seattle Storm,-0.5,-110,1022200209,28,45,1,1,1,1,1,1,1,69,96,27,73,17,away,away,45,-17,165
8/12/2022,634,MMinnesota,69,163.5,-110,MIN,Minnesota Lynx,-0.5,-110,1022200209,28,45,0,0,0,0,0,0,0,69,96,27,73,17,away,home,28,17,165
8/12/2022,635,DDallas,74,159.5,-110,DAL,Dallas Wings,-1.5,-110,1022200210,39,43,1,1,1,1,1,1,1,86,74,-12,82,4,away,away,43,-4,160
8/12/2022,636,PPhoenix,86,159.5,-110,PHO,Phoenix Mercury,1.5,-110,1022200210,39,43,0,0,0,0,0,0,0,86,74,-12,82,4,away,home,39,4,160
8/14/2022,641,MMinnesota,83,164.5,-110,MIN,Minnesota Lynx,6,-115,1022200211,45,34,0,0,0,0,0,0,0,90,83,-7,79,-11,home,away,34,11,173
8/14/2022,642,CConnecticut,90,164.5,-110,CON,Connecticut Sun,-6,-105,1022200211,45,34,1,1,1,1,1,1,1,90,83,-7,79,-11,home,home,45,-11,173
8/14/2022,643,AAtlanta,83,160.5,-110,ATL,Atlanta Dream,4.5,-107,1022200212,52,49,1,0,0,0,0,0,0,87,83,-4,101,-3,home,away,49,3,170
8/14/2022,644,NYNew York,87,160.5,-110,NYL,New York Liberty,-4.5,-113,1022200212,52,49,0,1,1,1,1,1,1,87,83,-4,101,-3,home,home,52,-3,170
8/14/2022,645,IIndiana,83,158,-110,IND,Indiana Fever,11.5,-110,1022200213,57,40,1,1,0,0,0,0,0,95,83,-12,97,-17,home,away,40,17,178
8/14/2022,646,WWashington,95,158,-110,WAS,Washington Mystics,-11.5,-110,1022200213,57,40,0,0,1,1,1,1,1,95,83,-12,97,-17,home,home,57,-17,178
8/14/2022,649,SSeattle,100,168,-110,SEA,Seattle Storm,6.5,-110,1022200215,50,51,0,0,0,0,1,1,1,109,100,-9,101,1,away,away,51,-1,209
8/14/2022,650,LVLas Vegas,109,168,-110,LVA,Las Vegas Aces,-6.5,-110,1022200215,50,51,1,1,1,1,0,0,0,109,100,-9,101,1,away,home,50,1,209
8/14/2022,647,CChicago,82,165.5,-110,CHI,Chicago Sky,-7.5,-110,1022200214,25,39,1,1,1,1,1,1,1,67,82,15,64,14,away,away,39,-14,149
8/14/2022,648,PPhoenix,67,165.5,-110,PHO,Phoenix Mercury,7.5,-110,1022200214,25,39,0,0,0,0,0,0,0,67,82,15,64,14,away,home,25,14,149
8/14/2022,651,DDallas,116,164,-110,DAL,Dallas Wings,-6,-110,1022200216,29,66,0,0,1,1,1,1,1,88,116,28,95,37,away,away,66,-37,204
8/14/2022,652,LALos Angeles,88,164,-110,LAS,Los Angeles Sparks,6,-110,1022200216,29,66,1,1,0,0,0,0,0,88,116,28,95,37,away,home,29,37,204
8/17/2022,601,NYNew York,98,167.5,-110,NYL,New York Liberty,10,-110,1042200111,45,48,0,1,0,0,0,0,0,91,98,7,93,3,away,away,48,-3,189
8/17/2022,602,CChicago,91,167.5,-110,CHI,Chicago Sky,-10,-110,1042200111,45,48,1,0,1,1,1,1,1,91,98,7,93,3,away,home,45,3,189
8/17/2022,603,PPhoenix,63,168,-110,PHO,Phoenix Mercury,16.5,-110,1042200101,42,37,1,1,1,0,0,0,0,79,63,-16,79,-5,home,away,37,5,142
8/17/2022,604,LVLas Vegas,79,168,-110,LVA,Las Vegas Aces,-16.5,-110,1042200101,42,37,0,0,0,1,1,1,1,79,63,-16,79,-5,home,home,42,-5,142
8/18/2022,605,DDallas,68,163.5,-110,DAL,Dallas Wings,9.5,-107,1042200121,47,37,0,0,0,0,0,0,0,93,68,-25,84,-10,home,away,37,10,161
8/18/2022,606,CConnecticut,93,163.5,-110,CON,Connecticut Sun,-9.5,-113,1042200121,47,37,1,1,1,1,1,1,1,93,68,-25,84,-10,home,home,47,-10,161
8/18/2022,607,WWashington,83,157,-115,WAS,Washington Mystics,4,-110,1042200131,40,42,1,0,0,0,0,0,1,86,83,-3,82,2,away,away,42,-2,169
8/18/2022,608,SSeattle,86,157,-105,SEA,Seattle Storm,-4,-110,1042200131,40,42,0,1,1,1,1,1,0,86,83,-3,82,2,away,home,40,2,169
8/20/2022,609,NYNew York,62,170,-110,NYL,New York Liberty,9,-110,1042200112,52,28,0,0,0,0,0,0,0,100,62,-38,80,-24,home,away,28,24,162
8/20/2022,610,CChicago,100,170,-110,CHI,Chicago Sky,-9,-110,1042200112,52,28,1,1,1,1,1,1,1,100,62,-38,80,-24,home,home,52,-24,162
8/20/2022,611,PPhoenix,80,164.5,-110,PHO,Phoenix Mercury,17.5,-110,1042200102,63,44,0,0,0,0,0,0,0,117,80,-37,107,-19,home,away,44,19,197
8/20/2022,612,LVLas Vegas,117,164.5,-110,LVA,Las Vegas Aces,-17.5,-110,1042200102,63,44,1,1,1,1,1,1,1,117,80,-37,107,-19,home,home,63,-19,197
8/21/2022,613,DDallas,89,164,-110,DAL,Dallas Wings,11.5,-110,1042200122,30,46,1,1,1,1,1,1,1,79,89,10,76,16,away,away,46,-16,168
8/21/2022,614,CConnecticut,79,164,-110,CON,Connecticut Sun,-11.5,-110,1042200122,30,46,0,0,0,0,0,0,0,79,89,10,76,16,away,home,30,16,168
8/21/2022,615,WWashington,84,160,-110,WAS,Washington Mystics,3.5,-110,1042200132,45,43,0,0,0,0,0,0,0,97,84,-13,88,-2,home,away,43,2,181
8/21/2022,616,SSeattle,97,160,-110,SEA,Seattle Storm,-3.5,-110,1042200132,45,43,1,1,1,1,1,1,1,97,84,-13,88,-2,home,home,45,-2,181
8/23/2022,617,CChicago,90,167,-110,CHI,Chicago Sky,-7,-118,1042200113,42,54,1,1,1,1,1,1,1,72,90,18,96,12,away,away,54,-12,162
8/23/2022,618,NYNew York,72,167,-110,NYL,New York Liberty,7,-102,1042200113,42,54,0,0,0,0,0,0,0,72,90,18,96,12,away,home,42,12,162
8/24/2022,621,CConnecticut,73,165,-110,CON,Connecticut Sun,-6.5,-110,1042200123,34,34,0,1,0,0,0,0,1,58,73,15,68,0,tie,away,34,-0,131
8/24/2022,622,DDallas,58,165,-110,DAL,Dallas Wings,6.5,-110,1042200123,34,34,1,0,1,1,1,1,0,58,73,15,68,0,tie,home,34,0,131
8/28/2022,627,SSeattle,76,171.5,-110,SEA,Seattle Storm,5.5,-110,1042200201,36,43,1,1,1,1,1,1,1,73,76,3,79,7,away,away,43,-7,149
8/28/2022,628,LVLas Vegas,73,171.5,-110,LVA,Las Vegas Aces,-5.5,-110,1042200201,36,43,0,0,0,0,0,0,0,73,76,3,79,7,away,home,36,7,149
8/28/2022,629,CConnecticut,68,166,-110,CON,Connecticut Sun,4,-110,1042200211,34,34,1,1,0,0,0,1,1,63,68,5,68,0,tie,away,34,-0,131
8/28/2022,630,CChicago,63,166,-110,CHI,Chicago Sky,-4,-110,1042200211,34,34,0,0,1,1,1,0,0,63,68,5,68,0,tie,home,34,0,131
8/31/2022,631,CConnecticut,77,164.5,-115,CON,Connecticut Sun,5.5,-110,1042200212,47,32,0,0,0,0,0,0,0,85,77,-8,79,-15,home,away,32,15,162
8/31/2022,632,CChicago,85,164.5,-105,CHI,Chicago Sky,-5.5,-110,1042200212,47,32,1,1,1,1,1,1,1,85,77,-8,79,-15,home,home,47,-15,162
8/31/2022,633,SSeattle,73,169.5,-110,SEA,Seattle Storm,6,-110,1042200202,36,36,1,0,1,1,1,1,1,78,73,-5,72,0,tie,away,36,-0,151
8/31/2022,634,LVLas Vegas,78,169.5,-110,LVA,Las Vegas Aces,-6,-110,1042200202,36,36,0,1,0,0,0,0,0,78,73,-5,72,0,tie,home,36,0,151
9/6/2022,641,CChicago,80,160,-110,CHI,Chicago Sky,1.5,-110,1042200214,58,41,0,0,0,0,0,0,0,104,80,-24,99,-17,home,away,41,17,184
9/6/2022,642,CConnecticut,104,160,-110,CON,Connecticut Sun,-1.5,-110,1042200214,58,41,1,1,1,1,1,1,1,104,80,-24,99,-17,home,home,58,-17,184
9/6/2022,639,LVLas Vegas,97,165,-110,LVA,Las Vegas Aces,1,-110,1042200204,47,44,0,0,0,0,0,0,0,92,97,5,91,-3,home,away,44,3,189
9/6/2022,640,SSeattle,92,165,-110,SEA,Seattle Storm,-1,-110,1042200204,47,44,1,1,1,1,1,1,1,92,97,5,91,-3,home,home,47,-3,189
9/8/2022,645,CConnecticut,72,158.5,-110,CON,Connecticut Sun,4,-110,1042200215,40,40,1,1,1,1,1,1,0,63,72,9,80,0,tie,away,40,-0,135
9/8/2022,646,CChicago,63,158.5,-110,CHI,Chicago Sky,-4,-110,1042200215,40,40,0,0,0,0,0,0,1,63,72,9,80,0,tie,home,40,0,135
9/13/2022,603,CConnecticut,71,161.5,-110,CON,Connecticut Sun,4.5,-110,1042200302,45,37,0,0,0,0,0,0,0,85,71,-14,82,-8,home,away,37,8,156
9/13/2022,604,LVLas Vegas,85,161.5,-110,LVA,Las Vegas Aces,-4.5,-110,1042200302,45,37,1,1,1,1,1,1,1,85,71,-14,82,-8,home,home,45,-8,156
9/18/2022,605,LVLas Vegas,78,163,-110,LVA,Las Vegas Aces,-1.5,-110,1042200304,28,30,1,1,1,1,1,1,0,71,78,7,58,2,away,away,30,-2,149
9/18/2022,606,CConnecticut,71,163,-110,CON,Connecticut Sun,1.5,-110,1042200304,28,30,0,0,0,0,0,0,1,71,78,7,58,2,away,home,28,2,149
5/7/2022,611,CConnecticut,79,162,-110,CON,Connecticut Sun,-6,-105,1022200005,38,30,1,1,1,1,1,0,0,81,79,-2,68,-8,home,away,30,8,160
5/7/2022,612,NYNew York,81,162,-110,NYL,New York Liberty,6,-115,1022200005,38,30,0,0,0,0,0,1,1,81,79,-2,68,-8,home,home,38,-8,160
5/7/2022,613,AAtlanta,66,162.5,-115,ATL,Atlanta Dream,8,-110,1022200006,35,39,1,1,1,1,1,1,1,59,66,7,74,4,away,away,39,-4,125
5/7/2022,614,DDallas,59,162.5,-105,DAL,Dallas Wings,-8,-110,1022200006,35,39,0,0,0,0,0,0,0,59,66,7,74,4,away,home,35,4,125
5/8/2022,621,LALos Angeles,87,160.5,-110,LAS,Los Angeles Sparks,-7,-110,1022200007,36,43,0,1,1,0,0,1,1,77,87,10,79,7,away,away,43,-7,164
5/8/2022,622,IIndiana,77,160.5,-110,IND,Indiana Fever,7,-110,1022200007,36,43,1,0,0,1,1,0,0,77,87,10,79,7,away,home,36,7,164
5/8/2022,623,WWashington,78,159,-110,WAS,Washington Mystics,2.5,-105,1022200009,23,47,1,1,1,1,1,1,1,66,78,12,70,24,away,away,47,-24,144
5/8/2022,624,MMinnesota,66,159,-110,MIN,Minnesota Lynx,-2.5,-115,1022200009,23,47,0,0,0,0,0,0,0,66,78,12,70,24,away,home,23,24,144
5/8/2022,625,SSeattle,74,177,-105,SEA,Seattle Storm,4.5,-110,1022200008,39,33,0,0,0,0,0,0,0,85,74,-11,72,-6,home,away,33,6,159
5/8/2022,626,LVLas Vegas,85,177,-115,LVA,Las Vegas Aces,-4.5,-110,1022200008,39,33,1,1,1,1,1,1,1,85,74,-11,72,-6,home,home,39,-6,159
5/10/2022,633,MMinnesota,76,159,-110,MIN,Minnesota Lynx,-3,-110,1022200011,48,39,1,1,1,1,0,0,0,82,76,-6,87,-9,home,away,39,9,158
5/10/2022,634,IIndiana,82,159,-110,IND,Indiana Fever,3,-110,1022200011,48,39,0,0,0,0,1,1,1,82,76,-6,87,-9,home,home,48,-9,158
5/10/2022,631,LVLas Vegas,76,168,-110,LVA,Las Vegas Aces,-5,-110,1022200010,36,49,1,1,1,1,1,1,1,89,76,-13,85,13,away,away,49,-13,165
5/10/2022,632,WWashington,89,168,-110,WAS,Washington Mystics,5,-110,1022200010,36,49,0,0,0,0,0,0,0,89,76,-13,85,13,away,home,36,13,165
5/11/2022,641,LALos Angeles,75,161.5,-110,LAS,Los Angeles Sparks,-5.5,-110,1022200012,40,39,0,0,0,1,0,0,0,77,75,-2,79,-1,home,away,39,1,152
5/11/2022,642,AAtlanta,77,161.5,-110,ATL,Atlanta Dream,5.5,-110,1022200012,40,39,1,1,1,0,1,1,1,77,75,-2,79,-1,home,home,40,-1,152
5/11/2022,643,NYNew York,50,165,-110,NYL,New York Liberty,5,-110,1022200013,36,17,0,0,0,0,0,0,0,83,50,-33,53,-19,home,away,17,19,133
5/11/2022,644,CChicago,83,165,-110,CHI,Chicago Sky,-5,-110,1022200013,36,17,1,1,1,1,1,1,1,83,50,-33,53,-19,home,home,36,-19,133
5/11/2022,645,SSeattle,77,163,-110,SEA,Seattle Storm,2,-110,1022200014,39,31,1,1,1,1,0,0,0,97,77,-20,70,-8,home,away,31,8,174
5/11/2022,646,PPhoenix,97,163,-110,PHO,Phoenix Mercury,-2,-110,1022200014,39,31,0,0,0,0,1,1,1,97,77,-20,70,-8,home,home,39,-8,174
5/13/2022,649,DDallas,94,159.5,-105,DAL,Dallas Wings,7.5,-110,1022200015,44,41,0,0,0,0,0,0,0,86,94,8,85,-3,home,away,41,3,180
5/13/2022,650,WWashington,86,159.5,-115,WAS,Washington Mystics,-7.5,-110,1022200015,44,41,1,1,1,1,1,1,1,86,94,8,85,-3,home,home,44,-3,180
5/13/2022,651,LVLas Vegas,96,167.5,-110,LVA,Las Vegas Aces,-8.5,-110,1022200016,33,49,1,1,1,1,1,1,1,73,96,23,82,16,away,away,49,-16,169
5/13/2022,652,AAtlanta,73,167.5,-110,ATL,Atlanta Dream,8.5,-110,1022200016,33,49,0,0,0,0,0,0,0,73,96,23,82,16,away,home,33,16,169
5/13/2022,653,IIndiana,92,159,-110,IND,Indiana Fever,6,-110,1022200017,41,41,1,0,1,1,1,1,1,86,92,6,82,0,tie,away,41,-0,178
5/13/2022,654,NYNew York,86,159,-110,NYL,New York Liberty,-6,-110,1022200017,41,41,0,1,0,0,0,0,0,86,92,6,82,0,tie,home,41,0,178
5/15/2022,601,DDallas,81,164.5,-115,DAL,Dallas Wings,2,-110,1022200021,37,39,0,1,1,1,0,1,1,71,81,10,76,2,away,away,39,-2,152
5/15/2022,602,NYNew York,71,164.5,-105,NYL,New York Liberty,-2,-110,1022200021,37,39,1,0,0,0,1,0,0,71,81,10,76,2,away,home,37,2,152
5/15/2022,603,AAtlanta,85,157.5,-110,ATL,Atlanta Dream,2,-110,1022200022,36,36,0,0,0,1,1,1,1,79,85,6,72,0,tie,away,36,-0,164
5/15/2022,604,IIndiana,79,157.5,-110,IND,Indiana Fever,-2,-110,1022200022,36,36,1,1,1,0,0,0,0,79,85,6,72,0,tie,home,36,0,164
5/18/2022,621,CChicago,71,162,-110,CHI,Chicago Sky,1,-110,1022200028,46,34,0,0,0,0,0,0,0,74,71,-3,80,-12,home,away,34,12,145
5/18/2022,622,SSeattle,74,162,-110,SEA,Seattle Storm,-1,-110,1022200028,46,34,1,1,1,1,1,1,1,74,71,-3,80,-12,home,home,46,-12,145
5/19/2022,633,DDallas,94,159,-110,DAL,Dallas Wings,2,-115,1022200030,41,44,1,0,1,1,1,1,1,84,94,10,85,3,away,away,44,-3,178
5/19/2022,634,PPhoenix,84,159,-110,PHO,Phoenix Mercury,-2,-105,1022200030,41,44,0,1,0,0,0,0,0,84,94,10,85,3,away,home,41,3,178
5/19/2022,631,MMinnesota,87,168.5,-115,MIN,Minnesota Lynx,10,-110,1022200029,54,43,0,0,0,0,0,0,0,93,87,-6,97,-11,home,away,43,11,180
5/19/2022,632,LVLas Vegas,93,168.5,-105,LVA,Las Vegas Aces,-10,-110,1022200029,54,43,1,1,1,1,1,1,1,93,87,-6,97,-11,home,home,54,-11,180
5/20/2022,641,IIndiana,85,155.5,-110,IND,Indiana Fever,16,-110,1022200031,37,35,1,0,1,0,0,1,0,94,85,-9,72,-2,home,away,35,2,179
5/20/2022,642,CConnecticut,94,155.5,-110,CON,Connecticut Sun,-16,-110,1022200031,37,35,0,1,0,1,1,0,1,94,85,-9,72,-2,home,home,37,-2,179
5/20/2022,643,WWashington,78,158,-110,WAS,Washington Mystics,-1.5,-110,1022200032,44,44,1,1,0,0,0,0,1,73,78,5,88,0,tie,away,44,-0,151
5/20/2022,644,AAtlanta,73,158,-110,ATL,Atlanta Dream,1.5,-110,1022200032,44,44,0,0,1,1,1,1,0,73,78,5,88,0,tie,home,44,0,151
5/20/2022,645,LALos Angeles,80,161,-105,LAS,Los Angeles Sparks,7,-105,1022200033,51,41,0,0,0,0,0,0,0,83,80,-3,92,-10,home,away,41,10,163
5/20/2022,646,SSeattle,83,161,-115,SEA,Seattle Storm,-7,-115,1022200033,51,41,1,1,1,1,1,1,1,83,80,-3,92,-10,home,home,51,-10,163
5/21/2022,649,PPhoenix,80,169,-110,PHO,Phoenix Mercury,10.5,-110,1022200034,44,42,1,1,1,1,1,1,1,100,80,-20,86,-2,home,away,42,2,180
5/21/2022,650,LVLas Vegas,100,169,-110,LVA,Las Vegas Aces,-10.5,-110,1022200034,44,42,0,0,0,0,0,0,0,100,80,-20,86,-2,home,home,44,-2,180
5/21/2022,651,MMinnesota,78,164,-110,MIN,Minnesota Lynx,2,-110,1022200035,43,45,0,1,1,1,1,1,1,94,78,-16,88,2,away,away,45,-2,172
5/21/2022,652,DDallas,94,164,-110,DAL,Dallas Wings,-2,-110,1022200035,43,45,1,0,0,0,0,0,0,94,78,-16,88,2,away,home,43,2,172
5/22/2022,655,CConnecticut,92,161.5,-110,CON,Connecticut Sun,-13,-110,1022200036,41,54,1,1,1,1,1,1,1,70,92,22,95,13,away,away,54,-13,162
5/22/2022,656,IIndiana,70,161.5,-110,IND,Indiana Fever,13,-110,1022200036,41,54,0,0,0,0,0,0,0,70,92,22,95,13,away,home,41,13,162
5/22/2022,657,CChicago,82,162,-110,CHI,Chicago Sky,1.5,-110,1022200037,42,38,0,0,1,1,1,0,0,73,82,9,80,-4,home,away,38,4,155
5/22/2022,658,WWashington,73,162,-110,WAS,Washington Mystics,-1.5,-110,1022200037,42,38,1,1,0,0,0,1,1,73,82,9,80,-4,home,home,42,-4,155
5/23/2022,661,LALos Angeles,76,171,-110,LAS,Los Angeles Sparks,10.5,-110,1022200038,57,36,0,0,0,0,0,0,0,104,76,-28,93,-21,home,away,36,21,180
5/23/2022,662,LVLas Vegas,104,171,-110,LVA,Las Vegas Aces,-10.5,-110,1022200038,57,36,1,1,1,1,1,1,1,104,76,-28,93,-21,home,home,57,-21,180
5/25/2022,611,PPhoenix,94,164,-115,PHO,Phoenix Mercury,2.5,-110,1022200043,56,45,1,1,1,0,0,0,0,99,94,-5,101,-11,home,away,45,11,193
5/25/2022,612,LALos Angeles,99,164,-105,LAS,Los Angeles Sparks,-2.5,-110,1022200043,56,45,0,0,0,1,1,1,1,99,94,-5,101,-11,home,home,56,-11,193
5/26/2022,615,DDallas,68,160.5,-110,DAL,Dallas Wings,8.5,-110,1022200044,47,35,0,0,0,0,0,0,0,99,68,-31,82,-12,home,away,35,12,167
5/26/2022,616,CConnecticut,99,160.5,-110,CON,Connecticut Sun,-8.5,-110,1022200044,47,35,1,1,1,1,1,1,1,99,68,-31,82,-12,home,home,47,-12,167
5/27/2022,621,LALos Angeles,96,168,-110,LAS,Los Angeles Sparks,-6,-115,1022200045,55,47,0,1,0,0,0,0,0,101,96,-5,102,-8,home,away,47,8,197
5/27/2022,622,IIndiana,101,168,-110,IND,Indiana Fever,6,-105,1022200045,55,47,1,0,1,1,1,1,1,101,96,-5,102,-8,home,home,55,-8,197
5/27/2022,623,NYNew York,71,156,-110,NYL,New York Liberty,8.5,-110,1022200046,34,24,1,0,0,0,0,0,0,79,71,-8,58,-10,home,away,24,10,150
5/27/2022,624,SSeattle,79,156,-110,SEA,Seattle Storm,-8.5,-110,1022200046,34,24,0,1,1,1,1,1,1,79,71,-8,58,-10,home,home,34,-10,150
5/28/2022,631,LVLas Vegas,83,172.5,-110,LVA,Las Vegas Aces,-1,-110,1022200047,38,51,1,1,1,1,1,1,1,76,83,7,89,13,away,away,51,-13,159
5/28/2022,632,CChicago,76,172.5,-110,CHI,Chicago Sky,1,-110,1022200047,38,51,0,0,0,0,0,0,0,76,83,7,89,13,away,home,38,13,159
5/28/2022,633,WWashington,71,154,-115,WAS,Washington Mystics,10,-115,1022200048,41,37,1,0,1,0,0,0,0,79,71,-8,78,-4,home,away,37,4,150
5/28/2022,634,CConnecticut,79,154,-105,CON,Connecticut Sun,-10,-105,1022200048,41,37,0,1,0,1,1,1,1,79,71,-8,78,-4,home,home,41,-4,150
5/29/2022,641,PPhoenix,54,162.5,-105,PHO,Phoenix Mercury,-1.5,-110,1022200049,50,23,1,0,0,0,0,0,0,81,54,-27,73,-27,home,away,23,27,135
5/29/2022,642,AAtlanta,81,162.5,-115,ATL,Atlanta Dream,1.5,-110,1022200049,50,23,0,1,1,1,1,1,1,81,54,-27,73,-27,home,home,50,-27,135
5/29/2022,643,NYNew York,61,152,-110,NYL,New York Liberty,7.5,-110,1022200050,49,23,0,0,0,0,0,0,0,92,61,-31,72,-26,home,away,23,26,153
5/29/2022,644,SSeattle,92,152,-110,SEA,Seattle Storm,-7.5,-110,1022200050,49,23,1,1,1,1,1,1,1,92,61,-31,72,-26,home,home,49,-26,153
5/29/2022,645,LALos Angeles,85,169,-105,LAS,Los Angeles Sparks,2,-110,1022200051,34,45,1,1,1,1,1,1,1,83,85,2,79,11,away,away,45,-11,168
5/29/2022,646,MMinnesota,83,169,-115,MIN,Minnesota Lynx,-2,-110,1022200051,34,45,0,0,0,0,0,0,0,83,85,2,79,11,away,home,34,11,168
5/31/2022,649,WWashington,87,165,-110,WAS,Washington Mystics,-7.5,-105,1022200052,46,38,0,0,0,1,0,0,0,75,87,12,84,-8,home,away,38,8,162
5/31/2022,650,IIndiana,75,165,-110,IND,Indiana Fever,7.5,-115,1022200052,46,38,1,1,1,0,1,1,1,75,87,12,84,-8,home,home,46,-8,162
5/31/2022,651,PPhoenix,70,166.5,-110,PHO,Phoenix Mercury,8.5,-110,1022200053,35,28,0,0,0,0,0,0,0,73,70,-3,63,-7,home,away,28,7,143
5/31/2022,652,CChicago,73,166.5,-110,CHI,Chicago Sky,-8.5,-110,1022200053,35,28,1,1,1,1,1,1,1,73,70,-3,63,-7,home,home,35,-7,143
5/31/2022,653,CConnecticut,81,167.5,-110,CON,Connecticut Sun,3.5,-110,1022200054,50,42,0,1,0,0,0,0,0,89,81,-8,92,-8,home,away,42,8,170
5/31/2022,654,LVLas Vegas,89,167.5,-110,LVA,Las Vegas Aces,-3.5,-110,1022200054,50,42,1,0,1,1,1,1,1,89,81,-8,92,-8,home,home,50,-8,170
5/31/2022,655,DDallas,91,169.5,-110,DAL,Dallas Wings,-1.5,-110,1022200055,52,40,0,0,0,0,0,0,0,93,91,-2,92,-12,home,away,40,12,184
5/31/2022,656,LALos Angeles,93,169.5,-110,LAS,Los Angeles Sparks,1.5,-110,1022200055,52,40,1,1,1,1,1,1,1,93,91,-2,92,-12,home,home,52,-12,184
6/1/2022,663,MMinnesota,76,157,-110,MIN,Minnesota Lynx,4.5,-110,1022200056,43,37,0,0,0,0,0,0,0,84,76,-8,80,-6,home,away,37,6,160
6/1/2022,664,AAtlanta,84,157,-110,ATL,Atlanta Dream,-4.5,-110,1022200056,43,37,1,1,1,1,1,1,1,84,76,-8,80,-6,home,home,43,-6,160
6/1/2022,661,IIndiana,74,163,-110,IND,Indiana Fever,4.5,-110,1022200057,40,47,0,0,0,0,0,0,1,87,74,-13,87,7,away,away,47,-7,161
6/1/2022,662,NYNew York,87,163,-110,NYL,New York Liberty,-4.5,-110,1022200057,40,47,1,1,1,1,1,1,0,87,74,-13,87,7,away,home,40,7,161
6/2/2022,601,CConnecticut,97,169,-110,CON,Connecticut Sun,5,-110,1022200058,50,53,1,1,1,1,1,1,1,90,97,7,103,3,away,away,53,-3,187
6/2/2022,602,LVLas Vegas,90,169,-110,LVA,Las Vegas Aces,-5,-110,1022200058,50,53,0,0,0,0,0,0,0,90,97,7,103,3,away,home,50,3,187
6/3/2022,603,NYNew York,74,154,-110,NYL,New York Liberty,12,-110,1022200059,28,30,1,1,1,0,1,1,1,70,74,4,58,2,away,away,30,-2,144
6/3/2022,604,WWashington,70,154,-110,WAS,Washington Mystics,-12,-110,1022200059,28,30,0,0,0,1,0,0,0,70,74,4,58,2,away,home,28,2,144
6/3/2022,605,CChicago,73,156,-110,CHI,Chicago Sky,-4.5,-114,1022200060,31,39,1,1,1,1,1,1,1,65,73,8,70,8,away,away,39,-8,138
6/3/2022,606,AAtlanta,65,156,-110,ATL,Atlanta Dream,4.5,-106,1022200060,31,39,0,0,0,0,0,0,0,65,73,8,70,8,away,home,31,8,138
6/3/2022,607,CConnecticut,92,163.5,-110,CON,Connecticut Sun,-7,-110,1022200061,45,42,1,1,1,0,0,0,0,88,92,4,87,-3,home,away,42,3,180
6/3/2022,608,PPhoenix,88,163.5,-110,PHO,Phoenix Mercury,7,-110,1022200061,45,42,0,0,0,1,1,1,1,88,92,4,87,-3,home,home,45,-3,180
6/3/2022,609,DDallas,68,159.5,-110,DAL,Dallas Wings,6,-110,1022200062,27,31,1,1,1,1,1,1,1,51,68,17,58,4,away,away,31,-4,119
6/3/2022,610,SSeattle,51,159.5,-110,SEA,Seattle Storm,-6,-110,1022200062,27,31,0,0,0,0,0,0,0,51,68,17,58,4,away,home,27,4,119
6/5/2022,611,MMinnesota,84,158,-110,MIN,Minnesota Lynx,1.5,111,1022200063,37,46,0,1,1,1,1,1,1,77,84,7,83,9,away,away,46,-9,161
6/5/2022,612,NYNew York,77,158,-110,NYL,New York Liberty,-1.5,-131,1022200063,37,46,1,0,0,0,0,0,0,77,84,7,83,9,away,home,37,9,161
6/5/2022,613,IIndiana,66,159,-110,IND,Indiana Fever,7,-115,1022200064,29,26,0,0,0,0,0,0,0,75,66,-9,55,-3,home,away,26,3,141
6/5/2022,614,AAtlanta,75,159,-110,ATL,Atlanta Dream,-7,-105,1022200064,29,26,1,1,1,1,1,1,1,75,66,-9,55,-3,home,home,29,-3,141
6/5/2022,615,CConnecticut,93,154.5,-110,CON,Connecticut Sun,4,-107,1022200068,43,42,0,0,0,0,0,0,0,86,93,7,85,-1,home,away,42,1,179
6/5/2022,616,SSeattle,86,154.5,-110,SEA,Seattle Storm,-4,-113,1022200068,43,42,1,1,1,1,1,1,1,86,93,7,85,-1,home,home,43,-1,179
6/5/2022,619,LALos Angeles,74,171,-110,LAS,Los Angeles Sparks,-3,-110,1022200067,43,40,0,0,0,0,0,0,0,81,74,-7,83,-3,home,away,40,3,155
6/5/2022,620,PPhoenix,81,171,-110,PHO,Phoenix Mercury,3,-110,1022200067,43,40,1,1,1,1,1,1,1,81,74,-7,83,-3,home,home,43,-3,155
6/5/2022,621,WWashington,82,154,-110,WAS,Washington Mystics,5.5,-109,1022200065,36,34,0,0,0,0,0,0,0,91,82,-9,70,-2,home,away,34,2,173
6/5/2022,622,CChicago,91,154,-110,CHI,Chicago Sky,-5.5,-111,1022200065,36,34,1,1,1,1,1,1,1,91,82,-9,70,-2,home,home,36,-2,173
6/5/2022,617,DDallas,78,172.5,-110,DAL,Dallas Wings,7.5,-110,1022200066,40,38,1,1,0,0,0,0,0,84,78,-6,78,-2,home,away,38,2,162
6/5/2022,618,LVLas Vegas,84,172.5,-110,LVA,Las Vegas Aces,-7.5,-110,1022200066,40,38,0,0,1,1,1,1,1,84,78,-6,78,-2,home,home,40,-2,162
6/7/2022,623,MMinnesota,69,158.5,-110,MIN,Minnesota Lynx,2.5,-110,1022200069,45,37,0,1,0,0,0,0,0,88,69,-19,82,-8,home,away,37,8,157
6/7/2022,624,NYNew York,88,158.5,-110,NYL,New York Liberty,-2.5,-110,1022200069,45,37,1,0,1,1,1,1,1,88,69,-19,82,-8,home,home,45,-8,157
6/7/2022,625,AAtlanta,60,149.5,-110,ATL,Atlanta Dream,8.5,-113,1022200070,34,33,0,0,0,0,0,0,0,72,60,-12,67,-1,home,away,33,1,132
6/7/2022,626,SSeattle,72,149.5,-110,SEA,Seattle Storm,-8.5,-107,1022200070,34,33,1,1,1,1,1,1,1,72,60,-12,67,-1,home,home,34,-1,132
6/8/2022,627,IIndiana,69,167,-120,IND,Indiana Fever,15.5,-115,1022200071,48,37,0,0,0,0,0,0,0,88,69,-19,85,-11,home,away,37,11,157
6/8/2022,628,CConnecticut,88,167,100,CON,Connecticut Sun,-15.5,-105,1022200071,48,37,1,1,1,1,1,1,1,88,69,-19,85,-11,home,home,48,-11,157
6/8/2022,629,CChicago,82,156,-105,CHI,Chicago Sky,3.5,-110,1022200072,45,40,0,0,0,0,1,1,0,84,82,-2,85,-5,home,away,40,5,166
6/8/2022,630,WWashington,84,156,-115,WAS,Washington Mystics,-3.5,-110,1022200072,45,40,1,1,1,1,0,0,1,84,82,-2,85,-5,home,home,45,-5,166
6/10/2022,635,NYNew York,97,160.5,-105,NYL,New York Liberty,-1.5,-110,1022200074,43,38,0,0,0,0,0,0,0,83,97,14,81,-5,home,away,38,5,180
6/10/2022,636,IIndiana,83,160.5,-115,IND,Indiana Fever,1.5,-110,1022200074,43,38,1,1,1,1,1,1,1,83,97,14,81,-5,home,home,43,-5,180
6/10/2022,637,CChicago,83,163,-110,CHI,Chicago Sky,6,-110,1022200073,44,45,1,1,1,0,1,0,1,79,83,4,89,1,away,away,45,-1,162
6/10/2022,638,CConnecticut,79,163,-110,CON,Connecticut Sun,-6,-110,1022200073,44,45,0,0,0,1,0,1,0,79,83,4,89,1,away,home,44,1,162
6/10/2022,639,WWashington,76,158,-110,WAS,Washington Mystics,-8,-110,1022200076,28,39,1,1,1,1,1,1,1,59,76,17,67,11,away,away,39,-11,135
6/10/2022,640,MMinnesota,59,158,-110,MIN,Minnesota Lynx,8,-110,1022200076,28,39,0,0,0,0,0,0,0,59,76,17,67,11,away,home,28,11,135
6/10/2022,641,SSeattle,89,153.5,-110,SEA,Seattle Storm,-5.5,-110,1022200075,41,42,1,1,1,1,1,1,1,88,89,1,83,1,away,away,42,-1,177
6/10/2022,642,DDallas,88,153.5,-110,DAL,Dallas Wings,5.5,-110,1022200075,41,42,0,0,0,0,0,0,0,88,89,1,83,1,away,home,41,1,177
6/10/2022,643,AAtlanta,88,154,-115,ATL,Atlanta Dream,4,-115,1022200077,38,36,0,0,0,0,0,0,0,90,88,-2,74,-2,home,away,36,2,178
6/10/2022,644,PPhoenix,90,154,-105,PHO,Phoenix Mercury,-4,-105,1022200077,38,36,1,1,1,1,1,1,1,90,88,-2,74,-2,home,home,38,-2,178
6/11/2022,645,LVLas Vegas,89,177,-110,LVA,Las Vegas Aces,-6.5,-110,1022200078,35,52,1,0,1,1,1,1,1,72,89,17,87,17,away,away,52,-17,161
6/11/2022,646,LALos Angeles,72,177,-110,LAS,Los Angeles Sparks,6.5,-110,1022200078,35,52,0,1,0,0,0,0,0,72,89,17,87,17,away,home,35,17,161
6/12/2022,651,CChicago,88,159,-110,CHI,Chicago Sky,-7,-110,1022200079,45,44,0,0,0,0,0,0,0,86,88,2,89,-1,home,away,44,1,174
6/12/2022,652,NYNew York,86,159,-110,NYL,New York Liberty,7,-110,1022200079,45,44,1,1,1,1,1,1,1,86,88,2,89,-1,home,home,45,-1,174
6/12/2022,653,SSeattle,84,157,-110,SEA,Seattle Storm,-3.5,-110,1022200080,38,39,0,0,0,0,0,0,1,79,84,5,77,1,away,away,39,-1,163
6/12/2022,654,DDallas,79,157,-110,DAL,Dallas Wings,3.5,-110,1022200080,38,39,1,1,1,1,1,1,0,79,84,5,77,1,away,home,38,1,163
6/12/2022,655,PPhoenix,99,160.5,-110,PHO,Phoenix Mercury,6,-110,1022200081,39,38,0,1,1,1,0,1,0,90,99,9,77,-1,home,away,38,1,189
6/12/2022,656,WWashington,90,160.5,-110,WAS,Washington Mystics,-6,-110,1022200081,39,38,1,0,0,0,1,0,1,90,99,9,77,-1,home,home,39,-1,189
6/12/2022,657,IIndiana,84,166,-110,IND,Indiana Fever,2,-110,1022200082,36,43,1,0,1,0,1,1,1,80,84,4,79,7,away,away,43,-7,164
6/12/2022,658,MMinnesota,80,166,-110,MIN,Minnesota Lynx,-2,-110,1022200082,36,43,0,1,0,1,0,0,0,80,84,4,79,7,away,home,36,7,164
6/14/2022,601,PPhoenix,65,161,-110,PHO,Phoenix Mercury,8.5,-110,1022200083,44,34,0,1,0,0,0,0,0,83,65,-18,78,-10,home,away,34,10,148
6/14/2022,602,WWashington,83,161,-110,WAS,Washington Mystics,-8.5,-110,1022200083,44,34,1,0,1,1,1,1,1,83,65,-18,78,-10,home,home,44,-10,148
6/14/2022,603,SSeattle,81,156.5,-115,SEA,Seattle Storm,-8,-110,1022200084,46,39,1,0,0,0,0,0,0,79,81,2,85,-7,home,away,39,7,160
6/14/2022,604,MMinnesota,79,156.5,-105,MIN,Minnesota Lynx,8,-110,1022200084,46,39,0,1,1,1,1,1,1,79,81,2,85,-7,home,home,46,-7,160
6/15/2022,605,LVLas Vegas,92,174.5,-110,LVA,Las Vegas Aces,-9,-110,1022200085,44,35,0,0,0,0,0,0,0,84,92,8,79,-9,home,away,35,9,176
6/15/2022,606,DDallas,84,174.5,-110,DAL,Dallas Wings,9,-110,1022200085,44,35,1,1,1,1,1,1,1,84,92,8,79,-9,home,home,44,-9,176
6/15/2022,609,AAtlanta,92,157.5,-110,ATL,Atlanta Dream,10,-105,1022200086,58,41,1,0,0,0,0,0,0,105,92,-13,99,-17,home,away,41,17,197
6/15/2022,610,CConnecticut,105,157.5,-110,CON,Connecticut Sun,-10,-115,1022200086,58,41,0,1,1,1,1,1,1,105,92,-13,99,-17,home,home,58,-17,197
6/15/2022,607,PPhoenix,93,169.5,-110,PHO,Phoenix Mercury,1,-110,1022200087,36,53,1,1,1,1,1,1,1,80,93,13,89,17,away,away,53,-17,173
6/15/2022,608,IIndiana,80,169.5,-110,IND,Indiana Fever,-1,-110,1022200087,36,53,0,0,0,0,0,0,0,80,93,13,89,17,away,home,36,17,173
6/16/2022,611,WWashington,65,157.5,-110,WAS,Washington Mystics,-4,-110,1022200088,40,35,0,0,1,1,1,1,0,77,65,-12,75,-5,home,away,35,5,142
6/16/2022,612,NYNew York,77,157.5,-110,NYL,New York Liberty,4,-110,1022200088,40,35,1,1,0,0,0,0,1,77,65,-12,75,-5,home,home,40,-5,142
6/19/2022,619,SSeattle,81,158.5,-110,SEA,Seattle Storm,-3,-110,1022200092,37,39,1,1,1,1,1,0,1,72,81,9,76,2,away,away,39,-2,153
6/19/2022,620,NYNew York,72,158.5,-110,NYL,New York Liberty,3,-110,1022200092,37,39,0,0,0,0,0,1,0,72,81,9,76,2,away,home,37,2,153
6/19/2022,621,CConnecticut,63,159.5,-110,CON,Connecticut Sun,-3.5,-110,1022200094,43,27,0,0,0,0,0,0,0,71,63,-8,70,-16,home,away,27,16,134
6/19/2022,622,WWashington,71,159.5,-110,WAS,Washington Mystics,3.5,-110,1022200094,43,27,1,1,1,1,1,1,1,71,63,-8,70,-16,home,home,43,-16,134
6/19/2022,623,CChicago,87,171.5,-110,CHI,Chicago Sky,-8,-110,1022200093,37,50,1,0,1,1,0,1,1,89,87,-2,87,13,away,away,50,-13,176
6/19/2022,624,IIndiana,89,171.5,-110,IND,Indiana Fever,8,-110,1022200093,37,50,0,1,0,0,1,0,0,89,87,-2,87,13,away,home,37,13,176
6/19/2022,625,LALos Angeles,82,169,-110,LAS,Los Angeles Sparks,4,-110,1022200095,50,45,0,0,0,0,1,1,1,92,82,-10,95,-5,home,away,45,5,174
6/19/2022,626,DDallas,92,169,-110,DAL,Dallas Wings,-4,-110,1022200095,50,45,1,1,1,1,0,0,0,92,82,-10,95,-5,home,home,50,-5,174
6/19/2022,627,MMinnesota,95,172,-110,MIN,Minnesota Lynx,15,-110,1022200096,39,50,1,1,1,1,1,1,1,96,95,-1,89,11,away,away,50,-11,191
6/19/2022,628,LVLas Vegas,96,172,-110,LVA,Las Vegas Aces,-15,-110,1022200096,39,50,0,0,0,0,0,0,0,96,95,-1,89,11,away,home,39,11,191
6/21/2022,631,DDallas,75,163.5,-110,DAL,Dallas Wings,-4,-105,1022200097,51,40,0,0,0,0,0,0,0,80,75,-5,91,-11,home,away,40,11,155
6/21/2022,632,AAtlanta,80,163.5,-110,ATL,Atlanta Dream,4,-115,1022200097,51,40,1,1,1,1,1,1,1,80,75,-5,91,-11,home,home,51,-11,155
6/21/2022,633,MMinnesota,84,169,-110,MIN,Minnesota Lynx,6,-115,1022200099,40,36,0,0,0,0,0,0,0,71,84,13,76,-4,home,away,36,4,155
6/21/2022,634,PPhoenix,71,169,-110,PHO,Phoenix Mercury,-6,-105,1022200099,40,36,1,1,1,1,1,1,1,71,84,13,76,-4,home,home,40,-4,155
6/21/2022,635,CChicago,104,176.5,-110,CHI,Chicago Sky,8,-110,1022200098,62,51,0,0,0,0,0,0,0,95,104,9,113,-11,home,away,51,11,199
6/21/2022,636,LVLas Vegas,95,176.5,-110,LVA,Las Vegas Aces,-8,-110,1022200098,62,51,1,1,1,1,1,1,1,95,104,9,113,-11,home,home,62,-11,199
6/21/2022,637,WWashington,82,161,-110,WAS,Washington Mystics,-2.5,-110,1022200100,35,31,1,0,0,0,0,0,0,84,82,-2,66,-4,home,away,31,4,166
6/21/2022,638,LALos Angeles,84,161,-110,LAS,Los Angeles Sparks,2.5,-110,1022200100,35,31,0,1,1,1,1,1,1,84,82,-2,66,-4,home,home,35,-4,166
6/22/2022,639,NYNew York,81,163.5,-110,NYL,New York Liberty,10.5,-110,1022200101,42,51,1,1,1,1,1,1,1,77,81,4,93,9,away,away,51,-9,158
6/22/2022,640,CConnecticut,77,163.5,-110,CON,Connecticut Sun,-10.5,-110,1022200101,42,51,0,0,0,0,0,0,0,77,81,4,93,9,away,home,42,9,158
6/23/2022,641,IIndiana,68,170.5,-110,IND,Indiana Fever,9,-110,1022200102,55,38,0,0,0,0,0,0,0,94,68,-26,93,-17,home,away,38,17,162
6/23/2022,642,DDallas,94,170.5,-110,DAL,Dallas Wings,-9,-110,1022200102,55,38,1,1,1,1,1,1,1,94,68,-26,93,-17,home,home,55,-17,162
6/23/2022,643,PPhoenix,88,166.5,-110,PHO,Phoenix Mercury,2.5,-110,1022200103,60,48,1,1,1,1,0,0,0,100,88,-12,108,-12,home,away,48,12,188
6/23/2022,644,MMinnesota,100,166.5,-110,MIN,Minnesota Lynx,-2.5,-110,1022200103,60,48,0,0,0,0,1,1,1,100,88,-12,108,-12,home,home,60,-12,188
6/23/2022,645,WWashington,71,154.5,-110,WAS,Washington Mystics,4.5,-110,1022200104,46,37,0,1,0,0,0,0,0,85,71,-14,83,-9,home,away,37,9,156
6/23/2022,646,SSeattle,85,154.5,-110,SEA,Seattle Storm,-4.5,-110,1022200104,46,37,1,0,1,1,1,1,1,85,71,-14,83,-9,home,home,46,-9,156
6/23/2022,647,CChicago,82,173,-110,CHI,Chicago Sky,-4.5,-110,1022200105,25,54,1,1,1,1,1,1,1,59,82,23,79,29,away,away,54,-29,141
6/23/2022,648,LALos Angeles,59,173,-110,LAS,Los Angeles Sparks,4.5,-110,1022200105,25,54,0,0,0,0,0,0,0,59,82,23,79,29,away,home,25,29,141
6/24/2022,649,NYNew York,89,159,-110,NYL,New York Liberty,1,-110,1022200106,43,53,1,1,1,1,1,1,1,77,89,12,96,10,away,away,53,-10,166
6/24/2022,650,AAtlanta,77,159,-110,ATL,Atlanta Dream,-1,-110,1022200106,43,53,0,0,0,0,0,0,0,77,89,12,96,10,away,home,43,10,166
6/25/2022,651,PPhoenix,83,168.5,-110,PHO,Phoenix Mercury,6.5,-105,1022200107,45,44,0,0,0,0,0,0,0,72,83,11,89,-1,home,away,44,1,155
6/25/2022,652,DDallas,72,168.5,-110,DAL,Dallas Wings,-6.5,-115,1022200107,45,44,1,1,1,1,1,1,1,72,83,11,89,-1,home,home,45,-1,155
6/25/2022,653,LALos Angeles,85,160,-110,LAS,Los Angeles Sparks,7,-115,1022200108,43,49,0,0,0,0,1,1,1,77,85,8,92,6,away,away,49,-6,162
6/25/2022,654,SSeattle,77,160,-110,SEA,Seattle Storm,-7,-105,1022200108,43,49,1,1,1,1,0,0,0,77,85,8,92,6,away,home,43,6,162
6/25/2022,655,WWashington,87,167,-110,WAS,Washington Mystics,9,-110,1022200109,40,46,1,1,1,0,1,1,1,86,87,1,86,6,away,away,46,-6,173
6/25/2022,656,LVLas Vegas,86,167,-110,LVA,Las Vegas Aces,-9,-110,1022200109,40,46,0,0,0,1,0,0,0,86,87,1,86,6,away,home,40,6,173
6/26/2022,661,CConnecticut,72,163.5,-110,CON,Connecticut Sun,-8,-110,1022200110,22,39,1,0,1,1,1,1,1,61,72,11,61,17,away,away,39,-17,133
6/26/2022,662,AAtlanta,61,163.5,-110,ATL,Atlanta Dream,8,-110,1022200110,22,39,0,1,0,0,0,0,0,61,72,11,61,17,away,home,22,17,133
6/26/2022,663,MMinnesota,85,170.5,-105,MIN,Minnesota Lynx,5.5,-110,1022200111,46,44,0,0,1,1,1,1,1,88,85,-3,90,-2,home,away,44,2,173
6/26/2022,664,CChicago,88,170.5,-115,CHI,Chicago Sky,-5.5,-110,1022200111,46,44,1,1,0,0,0,0,0,88,85,-3,90,-2,home,home,46,-2,173
6/27/2022,601,IIndiana,71,169.5,-110,IND,Indiana Fever,7,-110,1022200112,45,41,0,0,0,0,1,1,1,83,71,-12,86,-4,home,away,41,4,154
6/27/2022,602,PPhoenix,83,169.5,-110,PHO,Phoenix Mercury,-7,-110,1022200112,45,41,1,1,1,1,0,0,0,83,71,-12,86,-4,home,home,45,-4,154
6/27/2022,603,LVLas Vegas,79,176,-110,LVA,Las Vegas Aces,-8.5,-105,1022200113,36,40,0,0,0,0,0,1,1,73,79,6,76,4,away,away,40,-4,152
6/27/2022,604,LALos Angeles,73,176,-110,LAS,Los Angeles Sparks,8.5,-115,1022200113,36,40,1,1,1,1,1,0,0,73,79,6,76,4,away,home,36,4,152
6/28/2022,607,AAtlanta,74,153.5,-113,ATL,Atlanta Dream,7.5,-110,1022200114,52,32,0,0,0,0,0,0,0,92,74,-18,84,-20,home,away,32,20,166
6/28/2022,608,WWashington,92,153.5,-107,WAS,Washington Mystics,-7.5,-110,1022200114,52,32,1,1,1,1,1,1,1,92,74,-18,84,-20,home,home,52,-20,166
6/28/2022,605,DDallas,64,165,-110,DAL,Dallas Wings,3,-110,1022200115,50,24,0,0,0,0,0,0,0,92,64,-28,74,-26,home,away,24,26,156
6/28/2022,606,MMinnesota,92,165,-110,MIN,Minnesota Lynx,-3,-110,1022200115,50,24,1,1,1,1,1,1,1,92,64,-28,74,-26,home,home,50,-26,156
6/29/2022,609,CConnecticut,83,165,-110,CON,Connecticut Sun,2,-110,1022200116,55,33,0,0,0,0,0,0,0,91,83,-8,88,-22,home,away,33,22,174
6/29/2022,610,CChicago,91,165,-110,CHI,Chicago Sky,-2,-110,1022200116,55,33,1,1,1,1,1,1,1,91,83,-8,88,-22,home,home,55,-22,174
6/29/2022,611,IIndiana,78,166,-110,IND,Indiana Fever,7,-110,1022200117,49,43,0,0,0,1,1,1,1,99,78,-21,92,-6,home,away,43,6,177
6/29/2022,612,PPhoenix,99,166,-110,PHO,Phoenix Mercury,-7,-110,1022200117,49,43,1,1,1,0,0,0,0,99,78,-21,92,-6,home,home,49,-6,177
6/29/2022,613,LVLas Vegas,78,166,-110,LVA,Las Vegas Aces,-1,-110,1022200118,44,47,1,0,1,1,1,1,1,88,78,-10,91,3,away,away,47,-3,166
6/29/2022,614,SSeattle,88,166,-110,SEA,Seattle Storm,1,-110,1022200118,44,47,0,1,0,0,0,0,0,88,78,-10,91,3,away,home,44,3,166
6/30/2022,615,AAtlanta,92,159.5,-107,ATL,Atlanta Dream,5.5,-110,1022200119,36,41,0,0,0,1,1,1,1,81,92,11,77,5,away,away,41,-5,173
6/30/2022,616,NYNew York,81,159.5,-113,NYL,New York Liberty,-5.5,-110,1022200119,36,41,1,1,1,0,0,0,0,81,92,11,77,5,away,home,36,5,173
7/1/2022,619,LVLas Vegas,91,175.5,-110,LVA,Las Vegas Aces,-4.5,-110,1022200121,33,46,1,1,1,1,1,1,1,85,91,6,79,13,away,away,46,-13,176
7/1/2022,620,MMinnesota,85,175.5,-110,MIN,Minnesota Lynx,4.5,-110,1022200121,33,46,0,0,0,0,0,0,0,85,91,6,79,13,away,home,33,13,176
7/1/2022,617,LALos Angeles,97,167,-110,LAS,Los Angeles Sparks,5,-110,1022200120,49,46,1,1,0,0,0,0,0,89,97,8,95,-3,home,away,46,3,186
7/1/2022,618,DDallas,89,167,-110,DAL,Dallas Wings,-5,-110,1022200120,49,46,0,0,1,1,1,1,1,89,97,8,95,-3,home,home,49,-3,186
7/1/2022,621,IIndiana,57,162,-110,IND,Indiana Fever,13,-110,1022200122,46,27,0,0,0,0,0,0,0,73,57,-16,73,-19,home,away,27,19,130
7/1/2022,622,SSeattle,73,162,-110,SEA,Seattle Storm,-13,-110,1022200122,46,27,1,1,1,1,1,1,1,73,57,-16,73,-19,home,home,46,-19,130
7/2/2022,623,PPhoenix,75,168,-110,PHO,Phoenix Mercury,8.5,-110,1022200123,46,40,0,0,0,0,0,0,0,91,75,-16,86,-6,home,away,40,6,166
7/2/2022,624,CChicago,91,168,-110,CHI,Chicago Sky,-8.5,-110,1022200123,46,40,1,1,1,1,1,1,1,91,75,-16,86,-6,home,home,46,-6,166
7/3/2022,625,WWashington,72,157.5,-110,WAS,Washington Mystics,8,-115,1022200124,34,49,1,1,1,1,1,1,1,74,72,-2,83,15,away,away,49,-15,146
7/3/2022,626,CConnecticut,74,157.5,-110,CON,Connecticut Sun,-8,-105,1022200124,34,49,0,0,0,0,0,0,0,74,72,-2,83,15,away,home,34,15,146
7/3/2022,627,SSeattle,76,155,-105,SEA,Seattle Storm,-5.5,-110,1022200125,46,41,0,0,0,0,0,0,0,90,76,-14,87,-5,home,away,41,5,166
7/3/2022,628,AAtlanta,90,155,-115,ATL,Atlanta Dream,5.5,-110,1022200125,46,41,1,1,1,1,1,1,1,90,76,-14,87,-5,home,home,46,-5,166
7/3/2022,629,NYNew York,74,164.5,-110,NYL,New York Liberty,4,-115,1022200127,40,43,0,0,0,0,0,0,1,84,74,-10,83,3,away,away,43,-3,158
7/3/2022,630,LALos Angeles,84,164.5,-110,LAS,Los Angeles Sparks,-4,-105,1022200127,40,43,1,1,1,1,1,1,0,84,74,-10,83,3,away,home,40,3,158
7/3/2022,631,LVLas Vegas,71,173.5,-110,LVA,Las Vegas Aces,-5,-110,1022200126,49,35,0,0,0,0,0,0,0,102,71,-31,84,-14,home,away,35,14,173
7/3/2022,632,MMinnesota,102,173.5,-110,MIN,Minnesota Lynx,5,-110,1022200126,49,35,1,1,1,1,1,1,1,102,71,-31,84,-14,home,home,49,-14,173
7/4/2022,633,PPhoenix,75,167,-105,PHO,Phoenix Mercury,-1,-109,1022200128,42,40,1,0,1,0,0,0,0,78,75,-3,82,-2,home,away,40,2,153
7/4/2022,634,LALos Angeles,78,167,-115,LAS,Los Angeles Sparks,1,-111,1022200128,42,40,0,1,0,1,1,1,1,78,75,-3,82,-2,home,home,42,-2,153
7/5/2022,635,SSeattle,95,159.5,-110,SEA,Seattle Storm,-11,-110,1022200129,35,44,0,1,1,0,0,1,1,73,95,22,79,9,away,away,44,-9,168
7/5/2022,636,IIndiana,73,159.5,-110,IND,Indiana Fever,11,-110,1022200129,35,44,1,0,0,1,1,0,0,73,95,22,79,9,away,home,35,9,168
7/5/2022,637,CConnecticut,71,162.5,-110,CON,Connecticut Sun,-5,-105,1022200130,41,38,0,0,0,0,0,0,0,82,71,-11,79,-3,home,away,38,3,153
7/5/2022,638,DDallas,82,162.5,-110,DAL,Dallas Wings,5,-115,1022200130,41,38,1,1,1,1,1,1,1,82,71,-11,79,-3,home,home,41,-3,153
7/6/2022,639,CChicago,78,167.5,-110,CHI,Chicago Sky,-1.5,-110,1022200131,42,39,0,0,0,0,0,0,0,81,78,-3,81,-3,home,away,39,3,159
7/6/2022,640,MMinnesota,81,167.5,-110,MIN,Minnesota Lynx,1.5,-110,1022200131,42,39,1,1,1,1,1,1,1,81,78,-3,81,-3,home,home,42,-3,159
7/6/2022,641,WWashington,85,157,-110,WAS,Washington Mystics,-5,-110,1022200132,36,41,0,1,0,0,0,0,1,66,85,19,77,5,away,away,41,-5,151
7/6/2022,642,AAtlanta,66,157,-110,ATL,Atlanta Dream,5,-110,1022200132,36,41,1,0,1,1,1,1,0,66,85,19,77,5,away,home,36,5,151
7/6/2022,643,NYNew York,116,168.5,-110,NYL,New York Liberty,11.5,-115,1022200133,63,55,1,1,1,1,1,0,0,107,116,9,118,-8,home,away,55,8,223
7/6/2022,644,LVLas Vegas,107,168.5,-110,LVA,Las Vegas Aces,-11.5,-105,1022200133,63,55,0,0,0,0,0,1,1,107,116,9,118,-8,home,home,63,-8,223
7/12/2022,601,DDallas,74,160,-110,DAL,Dallas Wings,9.5,-110,1022200137,39,41,0,0,0,0,1,1,1,83,74,-9,80,2,away,away,41,-2,157
7/12/2022,602,SSeattle,83,160,-110,SEA,Seattle Storm,-9.5,-110,1022200137,39,41,1,1,1,1,0,0,0,83,74,-9,80,2,away,home,39,2,157
7/12/2022,603,LVLas Vegas,107,174,-110,LVA,Las Vegas Aces,-6.5,-110,1022200138,28,52,1,1,1,1,1,1,1,101,107,6,80,24,away,away,52,-24,208
7/12/2022,604,NYNew York,101,174,-110,NYL,New York Liberty,6.5,-110,1022200138,28,52,0,0,0,0,0,0,0,101,107,6,80,24,away,home,28,24,208
7/12/2022,607,PPhoenix,107,165,-110,PHO,Phoenix Mercury,7.5,-110,1022200140,47,45,1,0,1,0,0,0,0,118,107,-11,92,-2,home,away,45,2,225
7/12/2022,608,MMinnesota,118,165,-110,MIN,Minnesota Lynx,-7.5,-110,1022200140,47,45,0,1,0,1,1,1,1,118,107,-11,92,-2,home,home,47,-2,225
7/12/2022,605,AAtlanta,75,163.5,-110,ATL,Atlanta Dream,9,-110,1022200139,44,47,0,0,0,0,1,1,1,90,75,-15,91,3,away,away,47,-3,165
7/12/2022,606,CChicago,90,163.5,-110,CHI,Chicago Sky,-9,-110,1022200139,44,47,1,1,1,1,0,0,0,90,75,-15,91,3,away,home,44,3,165
7/12/2022,609,WWashington,94,158,-110,WAS,Washington Mystics,-6.5,-110,1022200141,44,53,1,1,1,1,1,1,1,81,94,13,97,9,away,away,53,-9,175
7/12/2022,610,LALos Angeles,81,158,-110,LAS,Los Angeles Sparks,6.5,-110,1022200141,44,53,0,0,0,0,0,0,0,81,94,13,97,9,away,home,44,9,175
7/13/2022,611,CConnecticut,89,161.5,-110,CON,Connecticut Sun,-10,-105,1022200142,28,41,1,1,1,1,1,1,1,81,89,8,69,13,away,away,41,-13,170
7/13/2022,612,IIndiana,81,161.5,-110,IND,Indiana Fever,10,-115,1022200142,28,41,0,0,0,0,0,0,0,81,89,8,69,13,away,home,28,13,170
7/16/2022,625,CChicago,89,169,-110,CHI,Chicago Sky,-4.5,-110,1022200149,42,41,0,1,1,1,0,0,0,81,89,8,83,-1,home,away,41,1,170
7/16/2022,626,DDallas,81,169,-110,DAL,Dallas Wings,4.5,-110,1022200149,42,41,1,0,0,0,1,1,1,81,89,8,83,-1,home,home,42,-1,170
7/17/2022,627,LVLas Vegas,91,174.5,-110,LVA,Las Vegas Aces,-4,-110,1022200150,37,35,0,0,0,0,0,0,1,83,91,8,72,-2,home,away,35,2,174
7/17/2022,628,CConnecticut,83,174.5,-110,CON,Connecticut Sun,4,-110,1022200150,37,35,1,1,1,1,1,1,0,83,91,8,72,-2,home,home,37,-2,174
7/17/2022,629,MMinnesota,57,161.5,-110,MIN,Minnesota Lynx,5,-110,1022200151,37,28,1,1,0,0,0,0,0,70,57,-13,65,-9,home,away,28,9,127
7/17/2022,630,WWashington,70,161.5,-110,WAS,Washington Mystics,-5,-110,1022200151,37,28,0,0,1,1,1,1,1,70,57,-13,65,-9,home,home,37,-9,127
7/17/2022,633,IIndiana,65,162.5,-110,IND,Indiana Fever,14,-110,1022200153,42,31,1,0,0,0,0,0,0,81,65,-16,73,-11,home,away,31,11,146
7/17/2022,634,SSeattle,81,162.5,-110,SEA,Seattle Storm,-14,-110,1022200153,42,31,0,1,1,1,1,1,1,81,65,-16,73,-11,home,home,42,-11,146
7/17/2022,631,AAtlanta,85,162.5,-110,ATL,Atlanta Dream,6,-110,1022200152,41,41,1,1,1,1,1,1,1,75,85,10,82,0,tie,away,41,-0,160
7/17/2022,632,PPhoenix,75,162.5,-110,PHO,Phoenix Mercury,-6,-110,1022200152,41,41,0,0,0,0,0,0,0,75,85,10,82,0,tie,home,41,0,160
7/20/2022,641,SSeattle,74,159,-105,SEA,Seattle Storm,2.5,-110,1022200157,35,31,1,0,0,0,0,0,0,78,74,-4,66,-4,home,away,31,4,152
7/20/2022,642,CChicago,78,159,-115,CHI,Chicago Sky,-2.5,-110,1022200157,35,31,0,1,1,1,1,1,1,78,74,-4,66,-4,home,home,35,-4,152
7/21/2022,643,NYNew York,69,156.5,-110,NYL,New York Liberty,8,-110,1022200158,40,37,1,1,1,1,1,0,0,78,69,-9,77,-3,home,away,37,3,147
7/21/2022,644,WWashington,78,156.5,-110,WAS,Washington Mystics,-8,-110,1022200158,40,37,0,0,0,0,0,1,1,78,69,-9,77,-3,home,home,40,-3,147
7/21/2022,645,AAtlanta,78,161.5,-110,ATL,Atlanta Dream,2.5,-110,1022200159,52,42,0,0,0,0,0,0,0,85,78,-7,94,-10,home,away,42,10,163
7/21/2022,646,LALos Angeles,85,161.5,-110,LAS,Los Angeles Sparks,-2.5,-110,1022200159,52,42,1,1,1,1,1,1,1,85,78,-7,94,-10,home,home,52,-10,163
7/21/2022,647,IIndiana,77,176.5,-110,IND,Indiana Fever,17,-108,1022200160,52,32,0,0,0,0,0,0,0,90,77,-13,84,-20,home,away,32,20,167
7/21/2022,648,LVLas Vegas,90,176.5,-110,LVA,Las Vegas Aces,-17,-112,1022200160,52,32,1,1,1,1,1,1,1,90,77,-13,84,-20,home,home,52,-20,167
7/22/2022,649,CConnecticut,94,159.5,-110,CON,Connecticut Sun,2.5,-110,1022200161,38,51,1,1,1,1,1,1,1,84,94,10,89,13,away,away,51,-13,178
7/22/2022,650,MMinnesota,84,159.5,-110,MIN,Minnesota Lynx,-2.5,-110,1022200161,38,51,0,0,0,0,0,0,0,84,94,10,89,13,away,home,38,13,178
7/22/2022,651,DDallas,83,164.5,-110,DAL,Dallas Wings,7.5,-110,1022200162,50,39,0,0,0,0,0,0,0,89,83,-6,89,-11,home,away,39,11,172
7/22/2022,652,CChicago,89,164.5,-110,CHI,Chicago Sky,-7.5,-113,1022200162,50,39,1,1,1,1,1,1,1,89,83,-6,89,-11,home,home,50,-11,172
7/22/2022,653,SSeattle,78,160.5,-110,SEA,Seattle Storm,-6,-124,1022200163,42,42,0,1,0,0,0,1,0,94,78,-16,84,0,tie,away,42,-0,172
7/22/2022,654,PPhoenix,94,160.5,-110,PHO,Phoenix Mercury,6,104,1022200163,42,42,1,0,1,1,1,0,1,94,78,-16,84,0,tie,home,42,0,172
7/23/2022,655,CChicago,80,164,-110,CHI,Chicago Sky,-4,-112,1022200164,37,39,1,0,0,0,0,0,0,83,80,-3,76,2,away,away,39,-2,163
7/23/2022,656,NYNew York,83,164,-110,NYL,New York Liberty,4,-108,1022200164,37,39,0,1,1,1,1,1,1,83,80,-3,76,2,away,home,37,2,163
7/23/2022,657,LALos Angeles,66,173,-110,LAS,Los Angeles Sparks,9.5,-108,1022200165,39,39,0,0,0,0,0,1,1,84,66,-18,78,0,tie,away,39,-0,150
7/23/2022,658,LVLas Vegas,84,173,-110,LVA,Las Vegas Aces,-9.5,-112,1022200165,39,39,1,1,1,1,1,0,0,84,66,-18,78,0,tie,home,39,0,150
7/28/2022,613,SSeattle,83,159,-110,SEA,Seattle Storm,3.5,-110,1022200170,44,40,1,1,1,1,1,1,1,88,83,-5,84,-4,home,away,40,4,171
7/28/2022,614,CConnecticut,88,159,-110,CON,Connecticut Sun,-3.5,-110,1022200170,44,40,0,0,0,0,0,0,0,88,83,-5,84,-4,home,home,44,-4,171
7/28/2022,611,MMinnesota,92,160.5,-110,MIN,Minnesota Lynx,1,-110,1022200169,29,49,1,1,1,1,1,1,1,85,92,7,78,20,away,away,49,-20,177
7/28/2022,612,AAtlanta,85,160.5,-110,ATL,Atlanta Dream,-1,-110,1022200169,29,49,0,0,0,0,0,0,0,85,92,7,78,20,away,home,29,20,177
7/28/2022,615,WWashington,87,157.5,-110,WAS,Washington Mystics,1.5,-110,1022200171,36,56,1,1,1,1,1,1,1,77,87,10,92,20,away,away,56,-20,164
7/28/2022,616,DDallas,77,157.5,-110,DAL,Dallas Wings,-1.5,-110,1022200171,36,56,0,0,0,0,0,0,0,77,87,10,92,20,away,home,36,20,164
7/28/2022,617,LALos Angeles,80,167.5,-110,LAS,Los Angeles Sparks,5,-105,1022200172,54,32,1,0,0,0,0,0,0,90,80,-10,86,-22,home,away,32,22,170
7/28/2022,618,PPhoenix,90,167.5,-110,PHO,Phoenix Mercury,-5,-115,1022200172,54,32,0,1,1,1,1,1,1,90,80,-10,86,-22,home,home,54,-22,170
7/29/2022,619,LVLas Vegas,93,175.5,-110,LVA,Las Vegas Aces,-14,-110,1022200173,37,54,1,1,1,1,1,1,1,72,93,21,91,17,away,away,54,-17,165
7/29/2022,620,IIndiana,72,175.5,-110,IND,Indiana Fever,14,-110,1022200173,37,54,0,0,0,0,0,0,0,72,93,21,91,17,away,home,37,17,165
7/29/2022,621,NYNew York,81,166,-110,NYL,New York Liberty,8,-110,1022200174,44,46,1,0,1,1,1,1,1,89,81,-8,90,2,away,away,46,-2,170
7/29/2022,622,CChicago,89,166,-110,CHI,Chicago Sky,-8,-110,1022200174,44,46,0,1,0,0,0,0,0,89,81,-8,90,2,away,home,44,2,170
7/30/2022,623,SSeattle,82,156.5,-115,SEA,Seattle Storm,1.5,-108,1022200175,35,35,0,0,0,0,0,0,0,77,82,5,70,0,tie,away,35,-0,159
7/30/2022,624,WWashington,77,156.5,-105,WAS,Washington Mystics,-1.5,-112,1022200175,35,35,1,1,1,1,1,1,1,77,82,5,70,0,tie,home,35,0,159
7/30/2022,625,DDallas,81,164,-110,DAL,Dallas Wings,2,-110,1022200176,35,42,0,1,1,1,1,1,1,68,81,13,77,7,away,away,42,-7,149
7/30/2022,626,AAtlanta,68,164,-110,ATL,Atlanta Dream,-2,-110,1022200176,35,42,1,0,0,0,0,0,0,68,81,13,77,7,away,home,35,7,149
7/31/2022,627,CChicago,95,164,-115,CHI,Chicago Sky,4,-105,1022200177,44,45,1,1,1,1,1,1,1,92,95,3,89,1,away,away,45,-1,187
7/31/2022,628,CConnecticut,92,164,-105,CON,Connecticut Sun,-4,-115,1022200177,44,45,0,0,0,0,0,0,0,92,95,3,89,1,away,home,44,1,187
7/31/2022,629,PPhoenix,69,166.5,-110,PHO,Phoenix Mercury,-1.5,-110,1022200178,35,27,0,0,0,0,0,0,0,89,69,-20,62,-8,home,away,27,8,158
7/31/2022,630,NYNew York,89,166.5,-110,NYL,New York Liberty,1.5,-110,1022200178,35,27,1,1,1,1,1,1,1,89,69,-20,62,-8,home,home,35,-8,158
7/31/2022,633,SSeattle,75,156,-110,SEA,Seattle Storm,3,-110,1022200180,36,37,0,0,0,1,1,1,0,78,75,-3,73,1,away,away,37,-1,153
7/31/2022,634,WWashington,78,156,-110,WAS,Washington Mystics,-3,-110,1022200180,36,37,1,1,1,0,0,0,1,78,75,-3,73,1,away,home,36,1,153
7/31/2022,631,LVLas Vegas,94,173,-110,LVA,Las Vegas Aces,-17.5,-110,1022200179,31,43,1,1,1,1,1,1,1,69,94,25,74,12,away,away,43,-12,163
7/31/2022,632,IIndiana,69,173,-110,IND,Indiana Fever,17.5,-110,1022200179,31,43,0,0,0,0,0,0,0,69,94,25,74,12,away,home,31,12,163
7/31/2022,635,MMinnesota,84,167.5,-110,MIN,Minnesota Lynx,-3.5,-110,1022200181,43,52,1,1,1,1,1,1,1,77,84,7,95,9,away,away,52,-9,161
7/31/2022,636,LALos Angeles,77,167.5,-110,LAS,Los Angeles Sparks,3.5,-110,1022200181,43,52,0,0,0,0,0,0,0,77,84,7,95,9,away,home,43,9,161
8/2/2022,643,PPhoenix,63,167,-105,PHO,Phoenix Mercury,10,-105,1022200182,35,25,1,0,0,0,0,0,0,87,63,-24,60,-10,home,away,25,10,150
8/2/2022,644,CConnecticut,87,167,-115,CON,Connecticut Sun,-10,-115,1022200182,35,25,0,1,1,1,1,1,1,87,63,-24,60,-10,home,home,35,-10,150
8/2/2022,645,LVLas Vegas,73,165,-115,LVA,Las Vegas Aces,-3,-115,1022200184,39,41,0,1,1,1,0,1,1,83,73,-10,80,2,away,away,41,-2,156
8/2/2022,646,WWashington,83,165,-105,WAS,Washington Mystics,3,-105,1022200184,39,41,1,0,0,0,1,0,0,83,73,-10,80,2,away,home,39,2,156
8/2/2022,641,LALos Angeles,73,165.5,-110,LAS,Los Angeles Sparks,5.5,-110,1022200183,53,41,1,1,1,0,0,0,0,102,73,-29,94,-12,home,away,41,12,175
8/2/2022,642,NYNew York,102,165.5,-110,NYL,New York Liberty,-5.5,-110,1022200183,53,41,0,0,0,1,1,1,1,102,73,-29,94,-12,home,home,53,-12,175
8/2/2022,647,DDallas,84,165.5,-110,DAL,Dallas Wings,11,-110,1022200185,39,42,0,0,1,0,1,1,1,78,84,6,81,3,away,away,42,-3,162
8/2/2022,648,CChicago,78,165.5,-110,CHI,Chicago Sky,-11,-110,1022200185,39,42,1,1,0,1,0,0,0,78,84,6,81,3,away,home,39,3,162
8/3/2022,653,IIndiana,81,158,-110,IND,Indiana Fever,10,-110,1022200186,62,34,0,0,0,0,0,0,0,91,81,-10,96,-28,home,away,34,28,172
8/3/2022,654,AAtlanta,91,158,-110,ATL,Atlanta Dream,-10,-110,1022200186,62,34,1,1,1,1,1,1,1,91,81,-10,96,-28,home,home,62,-28,172
8/3/2022,651,LALos Angeles,61,162.5,-110,LAS,Los Angeles Sparks,7,-110,1022200187,28,39,1,1,1,1,1,1,1,64,61,-3,67,11,away,away,39,-11,125
8/3/2022,652,NYNew York,64,162.5,-110,NYL,New York Liberty,-7,-110,1022200187,28,39,0,0,0,0,0,0,0,64,61,-3,67,11,away,home,28,11,125
8/3/2022,655,MMinnesota,77,162,-110,MIN,Minnesota Lynx,6,-110,1022200188,56,32,0,0,0,0,0,0,0,89,77,-12,88,-24,home,away,32,24,166
8/3/2022,656,SSeattle,89,162,-110,SEA,Seattle Storm,-6,-110,1022200188,56,32,1,1,1,1,1,1,1,89,77,-12,88,-24,home,home,56,-24,166
8/4/2022,657,PPhoenix,64,163.5,-110,PHO,Phoenix Mercury,12.5,-110,1022200189,45,45,1,0,0,1,1,1,1,77,64,-13,90,0,tie,away,45,-0,141
8/4/2022,658,CConnecticut,77,163.5,-110,CON,Connecticut Sun,-12.5,-110,1022200189,45,45,0,1,1,0,0,0,0,77,64,-13,90,0,tie,home,45,0,141
8/4/2022,659,LVLas Vegas,80,171,-110,LVA,Las Vegas Aces,-8.5,-110,1022200190,42,35,1,0,0,0,0,0,0,82,80,-2,77,-7,home,away,35,7,162
8/4/2022,660,DDallas,82,171,-110,DAL,Dallas Wings,8.5,-110,1022200190,42,35,0,1,1,1,1,1,1,82,80,-2,77,-7,home,home,42,-7,162
8/5/2022,661,LALos Angeles,86,157.5,-110,LAS,Los Angeles Sparks,5.5,-110,1022200191,47,45,0,0,0,0,0,0,0,88,86,-2,92,-2,home,away,45,2,174
8/5/2022,662,AAtlanta,88,157.5,-110,ATL,Atlanta Dream,-5.5,-110,1022200191,47,45,1,1,1,1,1,1,1,88,86,-2,92,-2,home,home,47,-2,174
8/5/2022,663,WWashington,83,160.5,-110,WAS,Washington Mystics,6,-110,1022200192,55,34,0,0,0,0,0,0,0,93,83,-10,89,-21,home,away,34,21,176
8/5/2022,664,CChicago,93,160.5,-110,CHI,Chicago Sky,-6,-110,1022200192,55,34,1,1,1,1,1,1,1,93,83,-10,89,-21,home,home,55,-21,176
8/7/2022,605,CConnecticut,91,166.5,-110,CON,Connecticut Sun,4,-110,1022200195,50,46,0,0,0,0,0,0,0,94,91,-3,96,-4,home,away,46,4,185
8/7/2022,606,CChicago,94,166.5,-110,CHI,Chicago Sky,-4,-110,1022200195,50,46,1,1,1,1,1,1,1,94,91,-3,96,-4,home,home,50,-4,185
8/7/2022,607,LVLas Vegas,89,166.5,-110,LVA,Las Vegas Aces,2.5,-103,1022200197,43,44,0,1,1,1,1,1,1,81,89,8,87,1,away,away,44,-1,170
8/7/2022,608,SSeattle,81,166.5,-110,SEA,Seattle Storm,-2.5,-117,1022200197,43,44,1,0,0,0,0,0,0,81,89,8,87,1,away,home,43,1,170
8/7/2022,609,LALos Angeles,79,159,-110,LAS,Los Angeles Sparks,10.5,-110,1022200196,32,40,1,1,1,1,1,1,1,76,79,3,72,8,away,away,40,-8,155
8/7/2022,610,WWashington,76,159,-110,WAS,Washington Mystics,-10.5,-110,1022200196,32,40,0,0,0,0,0,0,0,76,79,3,72,8,away,home,32,8,155
8/7/2022,611,AAtlanta,71,162.5,-112,ATL,Atlanta Dream,6,-110,1022200198,41,36,0,0,0,0,0,0,0,81,71,-10,77,-5,home,away,36,5,152
8/7/2022,612,MMinnesota,81,162.5,-108,MIN,Minnesota Lynx,-6,-110,1022200198,41,36,1,1,1,1,1,1,1,81,71,-10,77,-5,home,home,41,-5,152
8/26/2023,621,LVLas Vegas,62,170,-110,LVA,Las Vegas Aces,-10,-110,1022300203,27,30,0,0,1,0,1,1,1,78,62,-16,57,3,away,away,30,-3,140
8/26/2023,622,WWashington,78,170,-110,WAS,Washington Mystics,10,-110,1022300203,27,30,1,1,0,1,0,0,0,78,62,-16,57,3,away,home,27,3,140
8/26/2023,623,NYNew York,111,166,-110,NYL,New York Liberty,-9,-110,1022300204,35,65,1,1,1,1,1,1,1,76,111,35,100,30,away,away,65,-30,187
8/26/2023,624,MMinnesota,76,166,-110,MIN,Minnesota Lynx,9,-110,1022300204,35,65,0,0,0,0,0,0,0,76,111,35,100,30,away,home,35,30,187
9/1/2023,647,DDallas,110,170.5,-115,DAL,Dallas Wings,-4.5,-115,1022300216,46,54,0,0,0,0,1,1,1,100,110,10,100,8,away,away,54,-8,210
9/1/2023,648,IIndiana,100,170.5,-110,IND,Indiana Fever,4.5,-105,1022300216,46,54,1,1,1,1,0,0,0,100,110,10,100,8,away,home,46,8,210
9/1/2023,649,CConnecticut,58,160.5,-110,CON,Connecticut Sun,7.5,-108,1022300217,49,32,0,0,0,0,0,0,0,89,58,-31,81,-17,home,away,32,17,147
9/1/2023,650,NYNew York,89,160.5,-110,NYL,New York Liberty,-7.5,-112,1022300217,49,32,1,1,1,1,1,1,1,89,58,-31,81,-17,home,home,49,-17,147
9/1/2023,651,AAtlanta,85,164,-110,ATL,Atlanta Dream,1.5,-110,1022300218,43,43,0,0,0,1,1,0,0,91,85,-6,86,0,tie,away,43,-0,176
9/1/2023,652,MMinnesota,91,164,-110,MIN,Minnesota Lynx,-1.5,-110,1022300218,43,43,1,1,1,0,0,1,1,91,85,-6,86,0,tie,home,43,0,176
10/1/2023,623,NYNew York,87,160.5,-107,NYL,New York Liberty,-5.5,-110,1042300214,44,45,0,0,0,0,0,0,0,84,87,3,89,1,away,away,45,-1,171
10/1/2023,624,CConnecticut,84,160.5,-113,CON,Connecticut Sun,5.5,-108,1042300214,44,45,1,1,1,1,1,1,1,84,87,3,89,1,away,home,44,1,171
10/15/2023,633,LVLas Vegas,73,172,-110,LVA,Las Vegas Aces,-2,-113,1042300303,43,40,0,0,0,0,0,0,0,87,73,-14,83,-3,home,away,40,3,160
10/15/2023,634,NYNew York,87,172,-105,NYL,New York Liberty,2,-107,1042300303,43,40,1,1,1,1,1,1,1,87,73,-14,83,-3,home,home,43,-3,160
5/23/2023,649,CConnecticut,88,158.5,-110,CON,Connecticut Sun,5,-110,1022300010,42,43,0,0,1,1,1,1,1,81,88,7,85,1,away,away,43,-1,169
5/23/2023,650,WWashington,81,158.5,-110,WAS,Washington Mystics,-5,-110,1022300010,42,43,1,1,0,0,0,0,0,81,88,7,85,1,away,home,42,1,169
5/23/2023,651,AAtlanta,83,162,-110,ATL,Atlanta Dream,1.5,-110,1022300011,47,40,0,0,0,0,0,0,0,77,83,6,87,-7,home,away,40,7,160
5/23/2023,652,MMinnesota,77,162,-110,MIN,Minnesota Lynx,-1.5,-110,1022300011,47,40,1,1,1,1,1,1,1,77,83,6,87,-7,home,home,47,-7,160
6/11/2023,601,DDallas,93,170,-110,DAL,Dallas Wings,8.5,-110,1022300046,45,51,0,1,0,1,0,1,1,102,93,-9,96,6,away,away,51,-6,195
6/11/2023,602,NYNew York,102,170,-110,NYL,New York Liberty,-8.5,-110,1022300046,45,51,1,0,1,0,1,0,0,102,93,-9,96,6,away,home,45,6,195
6/11/2023,603,CChicago,80,168,-105,CHI,Chicago Sky,13,-105,1022300047,56,39,0,0,0,0,0,0,0,93,80,-13,95,-17,home,away,39,17,173
6/11/2023,604,LVLas Vegas,93,168,-115,LVA,Las Vegas Aces,-13,-115,1022300047,56,39,1,1,1,1,1,1,1,93,80,-13,95,-17,home,home,56,-17,173
6/11/2023,605,WWashington,71,155,-110,WAS,Washington Mystics,-4,-110,1022300050,21,46,1,1,1,1,1,1,1,65,71,6,67,25,away,away,46,-25,136
6/11/2023,606,SSeattle,65,155,-110,SEA,Seattle Storm,4,-110,1022300050,21,46,0,0,0,0,0,0,0,65,71,6,67,25,away,home,21,25,136
6/11/2023,607,CConnecticut,89,163,-112,CON,Connecticut Sun,-3.5,-110,1022300048,44,48,0,0,0,1,1,1,1,77,89,12,92,4,away,away,48,-4,166
6/11/2023,608,AAtlanta,77,163,-108,ATL,Atlanta Dream,3.5,-110,1022300048,44,48,1,1,1,0,0,0,0,77,89,12,92,4,away,home,44,4,166
6/11/2023,609,PPhoenix,85,160.5,-125,PHO,Phoenix Mercury,3,-108,1022300049,42,43,1,1,1,1,1,1,1,82,85,3,85,1,away,away,43,-1,167
6/11/2023,610,IIndiana,82,160.5,105,IND,Indiana Fever,-3,-112,1022300049,42,43,0,0,0,0,0,0,0,82,85,3,85,1,away,home,42,1,167
6/11/2023,611,LALos Angeles,86,160,-108,LAS,Los Angeles Sparks,-1,-115,1022300051,43,43,0,0,0,0,0,0,0,91,86,-5,86,0,tie,away,43,-0,177
6/11/2023,612,MMinnesota,91,160,-112,MIN,Minnesota Lynx,1,-105,1022300051,43,43,1,1,1,1,1,1,1,91,86,-5,86,0,tie,home,43,0,177
6/13/2023,613,WWashington,66,157.5,-107,WAS,Washington Mystics,-4.5,-115,1022300052,41,38,1,0,1,0,0,0,0,87,66,-21,79,-3,home,away,38,3,153
6/13/2023,614,IIndiana,87,157.5,-113,IND,Indiana Fever,4.5,-105,1022300052,41,38,0,1,0,1,1,1,1,87,66,-21,79,-3,home,home,41,-3,153
6/13/2023,615,AAtlanta,86,171.5,-110,ATL,Atlanta Dream,10,-112,1022300053,46,41,1,0,0,1,1,1,0,79,86,7,87,-5,home,away,41,5,165
6/13/2023,616,NYNew York,79,171.5,-110,NYL,New York Liberty,-10,-108,1022300053,46,41,0,1,1,0,0,0,1,79,86,7,87,-5,home,home,46,-5,165
6/13/2023,617,SSeattle,83,162,-107,SEA,Seattle Storm,5.5,122,1022300054,36,50,1,1,1,1,1,1,1,69,83,14,86,14,away,away,50,-14,152
6/13/2023,618,PPhoenix,69,162,-113,PHO,Phoenix Mercury,-5.5,-142,1022300054,36,50,0,0,0,0,0,0,0,69,83,14,86,14,away,home,36,14,152
6/14/2023,619,LALos Angeles,79,169,-110,LAS,Los Angeles Sparks,5.5,-110,1022300055,32,38,1,1,1,1,1,1,1,61,79,18,70,6,away,away,38,-6,140
6/14/2023,620,DDallas,61,169,-111,DAL,Dallas Wings,-5.5,-110,1022300055,32,38,0,0,0,0,0,0,0,61,79,18,70,6,away,home,32,6,140
6/18/2023,633,PPhoenix,71,162,-111,PHO,Phoenix Mercury,14.5,-110,1022300062,53,34,0,0,0,0,0,0,0,89,71,-18,87,-19,home,away,34,19,160
6/18/2023,634,NYNew York,89,162,-110,NYL,New York Liberty,-14.5,-110,1022300062,53,34,1,1,1,1,1,1,1,89,71,-18,87,-19,home,home,53,-19,160
6/18/2023,635,CChicago,69,155.5,-110,CHI,Chicago Sky,4,-118,1022300063,42,38,0,0,0,0,0,0,0,77,69,-8,80,-4,home,away,38,4,146
6/18/2023,636,WWashington,77,155.5,-110,WAS,Washington Mystics,-4,-102,1022300063,42,38,1,1,1,1,1,1,1,77,69,-8,80,-4,home,home,42,-4,146
6/18/2023,637,AAtlanta,100,165.5,-110,ATL,Atlanta Dream,-1,-110,1022300064,41,48,1,1,1,1,1,1,1,94,100,6,89,7,away,away,48,-7,194
6/18/2023,638,IIndiana,94,165.5,-110,IND,Indiana Fever,1,-110,1022300064,41,48,0,0,0,0,0,0,0,94,100,6,89,7,away,home,41,7,194
6/18/2023,639,CConnecticut,83,157,-115,CON,Connecticut Sun,-4,-115,1022300065,44,39,0,0,0,1,1,0,0,74,83,9,83,-5,home,away,39,5,157
6/18/2023,640,LALos Angeles,74,157,-105,LAS,Los Angeles Sparks,4,-105,1022300065,44,39,1,1,1,0,0,1,1,74,83,9,83,-5,home,home,44,-5,157
6/18/2023,641,MMinnesota,62,170,-114,MIN,Minnesota Lynx,17,-110,1022300066,54,41,1,0,0,0,0,0,0,93,62,-31,95,-13,home,away,41,13,155
6/18/2023,642,LVLas Vegas,93,170,-106,LVA,Las Vegas Aces,-17,-110,1022300066,54,41,0,1,1,1,1,1,1,93,62,-31,95,-13,home,home,54,-13,155
6/22/2023,653,WWashington,80,155,-110,WAS,Washington Mystics,-2,-110,1022300071,30,43,1,1,1,1,1,1,1,59,80,21,73,13,away,away,43,-13,139
6/22/2023,654,CChicago,59,155,-110,CHI,Chicago Sky,2,-110,1022300071,30,43,0,0,0,0,0,0,0,59,80,21,73,13,away,home,30,13,139
6/22/2023,651,CConnecticut,89,158.5,110,CON,Connecticut Sun,-4,-110,1022300072,28,41,1,1,1,1,1,1,1,68,89,21,69,13,away,away,41,-13,157
6/22/2023,652,MMinnesota,68,158.5,-130,MIN,Minnesota Lynx,4,-110,1022300072,28,41,0,0,0,0,0,0,0,68,89,21,69,13,away,home,28,13,157
6/22/2023,655,IIndiana,80,164.5,-110,IND,Indiana Fever,3,-110,1022300073,44,48,0,1,1,0,1,1,1,68,80,12,92,4,away,away,48,-4,148
6/22/2023,656,SSeattle,68,164.5,-110,SEA,Seattle Storm,-3,-110,1022300073,44,48,1,0,0,1,0,0,0,68,80,12,92,4,away,home,44,4,148
7/18/2023,647,MMinnesota,73,169.5,-115,MIN,Minnesota Lynx,6,-110,1022300120,54,37,0,0,0,0,0,0,0,82,73,-9,91,-17,home,away,37,17,155
7/18/2023,648,AAtlanta,82,169.5,-105,ATL,Atlanta Dream,-6,-110,1022300120,54,37,1,1,1,1,1,1,1,82,73,-9,91,-17,home,home,54,-17,155
7/18/2023,649,CConnecticut,66,164,-110,CON,Connecticut Sun,-7,-110,1022300121,43,34,0,0,0,0,0,0,0,72,66,-6,77,-9,home,away,34,9,138
7/18/2023,650,PPhoenix,72,164,-110,PHO,Phoenix Mercury,7,-110,1022300121,43,34,1,1,1,1,1,1,1,72,66,-6,77,-9,home,home,43,-9,138
7/21/2023,663,NYNew York,96,163,-110,NYL,New York Liberty,-10.5,-110,1022300128,41,50,0,1,1,1,1,1,1,87,96,9,91,9,away,away,50,-9,183
7/21/2023,664,WWashington,87,163,-110,WAS,Washington Mystics,10.5,-110,1022300128,41,50,1,0,0,0,0,0,0,87,96,9,91,9,away,home,41,9,183
7/23/2023,609,PPhoenix,69,156,-110,PHO,Phoenix Mercury,3,-110,1022300134,46,31,1,0,0,0,0,0,0,84,69,-15,77,-15,home,away,31,15,153
7/23/2023,610,WWashington,84,156,-110,WAS,Washington Mystics,-3,-110,1022300134,46,31,0,1,1,1,1,1,1,84,69,-15,77,-15,home,home,46,-15,153
7/23/2023,611,IIndiana,83,170.5,-110,IND,Indiana Fever,13,-110,1022300133,68,46,0,0,0,0,0,0,0,101,83,-18,114,-22,home,away,46,22,184
7/23/2023,612,NYNew York,101,170.5,-110,NYL,New York Liberty,-13,-110,1022300133,68,46,1,1,1,1,1,1,1,101,83,-18,114,-22,home,home,68,-22,184
7/25/2023,613,SSeattle,82,171,-110,SEA,Seattle Storm,15,-112,1022300136,35,45,1,0,1,1,0,1,1,86,82,-4,80,10,away,away,45,-10,168
7/25/2023,614,NYNew York,86,171,-110,NYL,New York Liberty,-15,-108,1022300136,35,45,0,1,0,0,1,0,0,86,82,-4,80,10,away,home,35,10,168
7/25/2023,615,PPhoenix,65,163.5,-110,PHO,Phoenix Mercury,8,-113,1022300135,45,33,0,0,0,0,0,0,0,78,65,-13,78,-12,home,away,33,12,143
7/25/2023,616,AAtlanta,78,163.5,-110,ATL,Atlanta Dream,-8,-107,1022300135,45,33,1,1,1,1,1,1,1,78,65,-13,78,-12,home,home,45,-12,143
7/25/2023,617,LVLas Vegas,107,167,-110,LVA,Las Vegas Aces,-14.5,-110,1022300137,48,55,1,1,1,1,1,1,1,95,107,12,103,7,away,away,55,-7,202
7/25/2023,618,CChicago,95,167,-110,CHI,Chicago Sky,14.5,-110,1022300137,48,55,0,0,0,0,0,0,0,95,107,12,103,7,away,home,48,7,202
7/25/2023,619,CConnecticut,88,168,-110,CON,Connecticut Sun,4,-112,1022300138,42,40,1,1,1,1,1,1,1,83,88,5,82,-2,home,away,40,2,171
7/25/2023,620,DDallas,83,168,-110,DAL,Dallas Wings,-4,-108,1022300138,42,40,0,0,0,0,0,0,0,83,88,5,82,-2,home,home,42,-2,171
7/25/2023,621,IIndiana,78,163.5,-110,IND,Indiana Fever,4.5,-110,1022300139,47,38,0,1,1,1,0,0,0,79,78,-1,85,-9,home,away,38,9,157
7/25/2023,622,LALos Angeles,79,163.5,-110,LAS,Los Angeles Sparks,-4.5,-110,1022300139,47,38,1,0,0,0,1,1,1,79,78,-1,85,-9,home,home,47,-9,157
7/26/2023,623,WWashington,92,159,-115,WAS,Washington Mystics,4,-102,1022300140,58,60,0,0,1,0,0,0,1,97,92,-5,118,2,away,away,60,-2,189
7/26/2023,624,MMinnesota,97,159,-105,MIN,Minnesota Lynx,-4,-118,1022300140,58,60,1,1,0,1,1,1,0,97,92,-5,118,2,away,home,58,2,189
7/27/2023,625,IIndiana,68,160.5,-110,IND,Indiana Fever,2.5,-110,1022300141,45,39,0,1,0,0,0,0,0,81,68,-13,84,-6,home,away,39,6,149
7/27/2023,626,LALos Angeles,81,160.5,-110,LAS,Los Angeles Sparks,-2.5,-110,1022300141,45,39,1,0,1,1,1,1,1,81,68,-13,84,-6,home,home,45,-6,149
7/27/2023,627,AAtlanta,84,175,-110,ATL,Atlanta Dream,9,-112,1022300142,57,42,0,0,0,0,0,0,0,95,84,-11,99,-15,home,away,42,15,179
7/27/2023,628,NYNew York,95,175,-110,NYL,New York Liberty,-9,-108,1022300142,57,42,1,1,1,1,1,1,1,95,84,-11,99,-15,home,home,57,-15,179
7/28/2023,631,WWashington,62,165,-110,WAS,Washington Mystics,8.5,105,1022300144,43,29,0,0,0,0,0,0,0,90,62,-28,72,-14,home,away,29,14,152
7/28/2023,632,DDallas,90,165,-110,DAL,Dallas Wings,-8.5,-125,1022300144,43,29,1,1,1,1,1,1,1,90,62,-28,72,-14,home,home,43,-14,152
7/28/2023,633,SSeattle,83,160.5,-110,SEA,Seattle Storm,4,-105,1022300143,40,42,1,1,1,1,0,1,0,74,83,9,82,2,away,away,42,-2,157
7/28/2023,634,CChicago,74,160.5,-110,CHI,Chicago Sky,-4,-115,1022300143,40,42,0,0,0,0,1,0,1,74,83,9,82,2,away,home,40,2,157
7/28/2023,629,MMinnesota,88,166,-110,MIN,Minnesota Lynx,14,-110,1022300038,39,48,0,0,1,1,1,1,1,83,88,5,87,9,away,away,48,-9,171
7/28/2023,630,NYNew York,83,166,-110,NYL,New York Liberty,-14,-110,1022300038,39,48,1,1,0,0,0,0,0,83,88,5,87,9,away,home,39,9,171
7/30/2023,635,MMinnesota,87,160.5,-110,MIN,Minnesota Lynx,12.5,100,1022300145,44,48,0,1,1,1,1,0,1,83,87,4,92,4,away,away,48,-4,170
7/30/2023,636,CConnecticut,83,159.5,-105,CON,Connecticut Sun,-12.5,-120,1022300145,44,48,1,0,0,0,0,1,0,83,87,4,92,4,away,home,44,4,170
7/30/2023,637,WWashington,73,166,-110,WAS,Washington Mystics,8.5,-110,1022300146,40,41,0,1,1,1,0,0,0,80,73,-7,81,1,away,away,41,-1,153
7/30/2023,638,AAtlanta,80,166,-110,ATL,Atlanta Dream,-8.5,-110,1022300146,40,41,1,0,0,0,1,1,1,80,73,-7,81,1,away,home,40,1,153
7/30/2023,643,NYNew York,87,168,-110,NYL,New York Liberty,-8.5,-115,1022300150,35,51,1,1,1,1,1,1,1,79,87,8,86,16,away,away,51,-16,166
7/30/2023,644,LALos Angeles,79,168,-110,LAS,Los Angeles Sparks,8.5,-105,1022300150,35,51,0,0,0,0,0,0,0,79,87,8,86,16,away,home,35,16,166
7/30/2023,639,SSeattle,85,162,-115,SEA,Seattle Storm,4,-110,1022300147,27,47,0,1,1,1,1,1,1,62,85,23,74,20,away,away,47,-20,147
7/30/2023,640,IIndiana,62,162,-105,IND,Indiana Fever,-4,-110,1022300147,27,47,1,0,0,0,0,0,0,62,85,23,74,20,away,home,27,20,147
7/30/2023,641,PPhoenix,85,155,-110,PHO,Phoenix Mercury,7,-110,1022300148,57,48,0,0,0,0,0,0,0,104,85,-19,105,-9,home,away,48,9,189
7/30/2023,642,CChicago,104,155,-110,CHI,Chicago Sky,-7,-110,1022300148,57,48,1,1,1,1,1,1,1,104,85,-19,105,-9,home,home,57,-9,189
7/30/2023,645,DDallas,91,176,-110,DAL,Dallas Wings,11,-115,1022300149,58,41,0,0,0,0,0,0,0,104,91,-13,99,-17,home,away,41,17,195
7/30/2023,646,LVLas Vegas,104,176,-110,LVA,Las Vegas Aces,-11,-105,1022300149,58,41,1,1,1,1,1,1,1,104,91,-13,99,-17,home,home,58,-17,195
8/1/2023,649,PPhoenix,71,158,-115,PHO,Phoenix Mercury,6,-110,1022300152,46,43,0,1,1,1,1,0,0,72,71,-1,89,-3,home,away,43,3,143
8/1/2023,650,IIndiana,72,158,-105,IND,Indiana Fever,-6,-110,1022300152,46,43,1,0,0,0,0,1,1,72,71,-1,89,-3,home,home,46,-3,143
8/1/2023,647,MMinnesota,69,164,-110,MIN,Minnesota Lynx,11.5,-110,1022300151,37,30,0,1,0,0,0,0,0,79,69,-10,67,-7,home,away,30,7,148
8/1/2023,648,CConnecticut,79,164,-110,CON,Connecticut Sun,-11.5,-110,1022300151,37,30,1,0,1,1,1,1,1,79,69,-10,67,-7,home,home,37,-7,148
8/1/2023,653,AAtlanta,72,179.5,-110,ATL,Atlanta Dream,13.5,-110,1022300153,54,43,0,0,0,0,0,0,0,93,72,-21,97,-11,home,away,43,11,165
8/1/2023,654,LVLas Vegas,93,179.5,-110,LVA,Las Vegas Aces,-13.5,-110,1022300153,54,43,1,1,1,1,1,1,1,93,72,-21,97,-11,home,home,54,-11,165
8/1/2023,651,NYNew York,76,166.5,-120,NYL,New York Liberty,-8.5,-115,1022300154,34,32,1,0,0,1,0,0,0,69,76,7,66,-2,home,away,32,2,145
8/1/2023,652,LALos Angeles,69,166.5,100,LAS,Los Angeles Sparks,8.5,-105,1022300154,34,32,0,1,1,0,1,1,1,69,76,7,66,-2,home,home,34,-2,145
8/2/2023,655,DDallas,76,167.5,-110,DAL,Dallas Wings,-7,-115,1022300155,33,46,1,1,1,1,1,1,1,65,76,11,79,13,away,away,46,-13,141
8/2/2023,656,SSeattle,65,168,-110,SEA,Seattle Storm,7,-105,1022300155,33,46,0,0,0,0,0,0,0,65,76,11,79,13,away,home,33,13,141
8/3/2023,657,AAtlanta,71,164,-110,ATL,Atlanta Dream,-7.5,-110,1022300156,43,36,1,0,1,1,1,0,0,91,71,-20,79,-7,home,away,36,7,162
8/3/2023,658,PPhoenix,91,164,-110,PHO,Phoenix Mercury,7.5,-110,1022300156,43,36,0,1,0,0,0,1,1,91,71,-20,79,-7,home,home,43,-7,162
8/4/2023,659,CConnecticut,88,160.5,-110,CON,Connecticut Sun,-8,-110,1022300157,33,56,0,1,1,1,1,1,1,72,88,16,89,23,away,away,56,-23,160
8/4/2023,660,IIndiana,72,160.5,-110,IND,Indiana Fever,8,-110,1022300157,33,56,1,0,0,0,0,0,0,72,88,16,89,23,away,home,33,23,160
8/4/2023,661,LALos Angeles,77,157,-110,LAS,Los Angeles Sparks,3,-110,1022300158,48,40,0,0,0,0,0,0,0,79,77,-2,88,-8,home,away,40,8,156
8/4/2023,662,WWashington,79,157,-110,WAS,Washington Mystics,-3,-110,1022300158,48,40,1,1,1,1,1,1,1,79,77,-2,88,-8,home,home,48,-8,156
8/4/2023,665,CChicago,104,165,-110,CHI,Chicago Sky,10.5,-115,1022300159,48,58,1,1,1,1,1,1,1,89,104,15,106,10,away,away,58,-10,193
8/4/2023,666,DDallas,89,165,-110,DAL,Dallas Wings,-10.5,-105,1022300159,48,58,0,0,0,0,0,0,0,89,104,15,106,10,away,home,48,10,193
8/4/2023,663,NYNew York,76,170.5,-110,NYL,New York Liberty,-9,-110,1022300160,42,41,0,1,1,1,1,1,0,66,76,10,83,-1,home,away,41,1,142
8/4/2023,664,MMinnesota,66,170.5,-110,MIN,Minnesota Lynx,9,-110,1022300160,42,41,1,0,0,0,0,0,1,66,76,10,83,-1,home,home,42,-1,142
8/5/2023,601,SSeattle,97,159,-115,SEA,Seattle Storm,4,-110,1022300161,50,41,0,0,0,0,0,0,0,91,97,6,91,-9,home,away,41,9,188
8/5/2023,602,PPhoenix,91,159,-110,PHO,Phoenix Mercury,-4,-110,1022300161,50,41,1,1,1,1,1,1,1,91,97,6,91,-9,home,home,50,-9,188
8/6/2023,605,IIndiana,73,167,-105,IND,Indiana Fever,8,-110,1022300162,43,34,0,0,0,0,0,0,0,82,73,-9,77,-9,home,away,34,9,155
8/6/2023,606,AAtlanta,82,167,-115,ATL,Atlanta Dream,-8,-110,1022300162,43,34,1,1,1,1,1,1,1,82,73,-9,77,-9,home,home,43,-9,155
8/6/2023,603,LALos Angeles,91,155.5,-110,LAS,Los Angeles Sparks,3,-115,1022300164,36,43,0,0,1,1,0,1,1,83,91,8,79,7,away,away,43,-7,174
8/6/2023,604,WWashington,83,155.5,-110,WAS,Washington Mystics,-3,-110,1022300164,36,43,1,1,0,0,1,0,0,83,91,8,79,7,away,home,36,7,174
8/6/2023,607,LVLas Vegas,61,176.5,-110,LVA,Las Vegas Aces,-5,-105,1022300163,49,44,0,0,1,0,0,0,0,99,61,-38,93,-5,home,away,44,5,160
8/6/2023,608,NYNew York,99,176.5,-110,NYL,New York Liberty,5,-115,1022300163,49,44,1,1,0,1,1,1,1,99,61,-38,93,-5,home,home,49,-5,160
8/6/2023,609,CChicago,104,166.5,-110,CHI,Chicago Sky,9,-109,1022300165,37,46,1,1,0,0,1,1,1,96,104,8,83,9,away,away,46,-9,200
8/6/2023,610,DDallas,96,166.5,-110,DAL,Dallas Wings,-9,-110,1022300165,37,46,0,0,1,1,0,0,0,96,104,8,83,9,away,home,37,9,200
8/8/2023,611,CConnecticut,81,160.5,-110,CON,Connecticut Sun,-7.5,-115,1022300166,34,50,0,0,0,1,1,1,1,69,81,12,84,16,away,away,50,-16,150
8/8/2023,612,SSeattle,69,160.5,-110,SEA,Seattle Storm,7.5,-105,1022300166,34,50,1,1,1,0,0,0,0,69,81,12,84,16,away,home,34,16,150
8/8/2023,613,LALos Angeles,87,157.5,-110,LAS,Los Angeles Sparks,-0.5,-110,1022300167,41,40,1,1,1,0,0,0,0,80,87,7,81,-1,home,away,40,1,167
8/8/2023,614,IIndiana,80,157.5,-110,IND,Indiana Fever,-0.5,-110,1022300167,41,40,0,0,0,1,1,1,1,80,87,7,81,-1,home,home,41,-1,167
8/8/2023,617,MMinnesota,88,164.5,-110,MIN,Minnesota Lynx,3,-109,1022300168,38,45,1,1,1,1,1,1,1,79,88,9,83,7,away,away,45,-7,167
8/8/2023,618,CChicago,79,164.5,-110,CHI,Chicago Sky,-3,-111,1022300168,38,45,0,0,0,0,0,0,0,79,88,9,83,7,away,home,38,7,167
8/8/2023,615,LVLas Vegas,104,177.5,-110,LVA,Las Vegas Aces,-8.5,-110,1022300169,26,54,1,1,1,1,1,1,1,84,104,20,80,28,away,away,54,-28,188
8/8/2023,616,DDallas,84,177.5,-110,DAL,Dallas Wings,8.5,-110,1022300169,26,54,0,0,0,0,0,0,0,84,104,20,80,28,away,home,26,28,188
8/8/2023,619,WWashington,72,159.5,-110,WAS,Washington Mystics,3.5,-110,1022300170,44,34,0,0,0,0,0,0,0,91,72,-19,78,-10,home,away,34,10,163
8/8/2023,620,PPhoenix,91,159.5,-110,PHO,Phoenix Mercury,-3.5,-110,1022300170,44,34,1,1,1,1,1,1,1,91,72,-19,78,-10,home,home,44,-10,163
8/10/2023,621,MMinnesota,73,163.5,-115,MIN,Minnesota Lynx,-2.5,-110,1022300171,45,35,1,0,1,0,0,0,0,91,73,-18,80,-10,home,away,35,10,164
8/10/2023,622,IIndiana,91,163.5,-105,IND,Indiana Fever,2.5,-110,1022300171,45,35,0,1,0,1,1,1,1,91,73,-18,80,-10,home,home,45,-10,164
8/10/2023,625,CConnecticut,84,159.5,-110,CON,Connecticut Sun,-7,-110,1022300172,52,48,0,0,0,0,0,0,0,90,84,-6,100,-4,home,away,48,4,174
8/10/2023,626,PPhoenix,90,159.5,-110,PHO,Phoenix Mercury,7,-110,1022300172,52,48,1,1,1,1,1,1,1,90,84,-6,100,-4,home,home,52,-4,174
8/10/2023,623,AAtlanta,67,163,-110,ATL,Atlanta Dream,-5.5,-105,1022300173,27,34,1,1,1,1,1,1,1,68,67,-1,61,7,away,away,34,-7,135
8/10/2023,624,SSeattle,68,163,-110,SEA,Seattle Storm,5.5,-115,1022300173,27,34,0,0,0,0,0,0,0,68,67,-1,61,7,away,home,27,7,135
8/11/2023,627,CChicago,73,169.5,-110,CHI,Chicago Sky,12,-115,1022300174,48,40,0,0,0,0,0,0,0,89,73,-16,88,-8,home,away,40,8,162
8/11/2023,628,NYNew York,89,169.5,-110,NYL,New York Liberty,-12,-105,1022300174,48,40,1,1,1,1,1,1,1,89,73,-16,88,-8,home,home,48,-8,162
8/11/2023,629,WWashington,89,169.5,-110,WAS,Washington Mystics,17.5,-110,1022300175,57,48,0,0,0,0,0,0,0,113,89,-24,105,-9,home,away,48,9,202
8/11/2023,630,LVLas Vegas,113,169.5,-110,LVA,Las Vegas Aces,-17.5,-110,1022300175,57,48,1,1,1,1,1,1,1,113,89,-24,105,-9,home,home,57,-9,202
8/12/2023,631,AAtlanta,74,164,-110,ATL,Atlanta Dream,-0.5,-105,1022300176,38,45,1,1,1,1,1,1,1,85,74,-11,83,7,away,away,45,-7,159
8/12/2023,632,LALos Angeles,85,164,-110,LAS,Los Angeles Sparks,-0.5,-115,1022300176,38,45,0,0,0,0,0,0,0,85,74,-11,83,7,away,home,38,7,159
8/12/2023,633,CConnecticut,81,168.5,-110,CON,Connecticut Sun,3,-105,1022300177,52,43,1,0,0,0,0,0,0,91,81,-10,95,-9,home,away,43,9,172
8/12/2023,634,DDallas,91,168.5,-110,DAL,Dallas Wings,-3,-115,1022300177,52,43,0,1,1,1,1,1,1,91,81,-10,95,-9,home,home,52,-9,172
8/13/2023,637,CChicago,76,162,-125,CHI,Chicago Sky,2.5,-110,1022300178,40,39,0,0,0,0,0,0,0,83,76,-7,79,-1,home,away,39,1,159
8/13/2023,638,WWashington,83,162,105,WAS,Washington Mystics,-2.5,-110,1022300178,40,39,1,1,1,1,1,1,1,83,76,-7,79,-1,home,home,40,-1,159
8/13/2023,635,NYNew York,100,165.5,-115,NYL,New York Liberty,-10.5,-110,1022300180,51,58,1,1,0,0,0,0,0,89,100,11,109,7,away,away,58,-7,189
8/13/2023,636,IIndiana,89,165.5,-105,IND,Indiana Fever,10.5,-110,1022300180,51,58,0,0,1,1,1,1,1,89,100,11,109,7,away,home,51,7,189
8/13/2023,639,PPhoenix,71,160.5,-112,PHO,Phoenix Mercury,2.5,-105,1022300179,51,35,1,1,0,0,0,0,0,81,71,-10,86,-16,home,away,35,16,152
8/13/2023,640,SSeattle,81,160.5,-108,SEA,Seattle Storm,-2.5,-115,1022300179,51,35,0,0,1,1,1,1,1,81,71,-10,86,-16,home,home,51,-16,152
8/13/2023,641,AAtlanta,65,176,-110,ATL,Atlanta Dream,17,-110,1022300181,36,30,1,1,0,0,0,0,0,86,65,-21,66,-6,home,away,30,6,151
8/13/2023,642,LVLas Vegas,86,176,-110,LVA,Las Vegas Aces,-17,-110,1022300181,36,30,0,0,1,1,1,1,1,86,65,-21,66,-6,home,home,36,-6,151
8/17/2023,643,NYNew York,75,175,-110,NYL,New York Liberty,7,100,1022300182,53,40,1,1,0,0,0,0,0,88,75,-13,93,-13,home,away,40,13,163
8/17/2023,644,LVLas Vegas,88,175,-110,LVA,Las Vegas Aces,-7,-120,1022300182,53,40,0,0,1,1,1,1,1,88,75,-13,93,-13,home,home,53,-13,163
8/18/2023,647,WWashington,83,162,-115,WAS,Washington Mystics,-5,-110,1022300184,42,42,0,1,0,1,0,0,1,79,83,4,84,0,tie,away,42,-0,162
8/18/2023,648,IIndiana,79,162,-105,IND,Indiana Fever,5.5,-110,1022300184,42,42,1,0,1,0,1,1,0,79,83,4,84,0,tie,home,42,0,162
8/18/2023,649,DDallas,95,169,-110,DAL,Dallas Wings,5,-110,1022300183,40,46,0,0,0,1,0,1,1,75,95,20,86,6,away,away,46,-6,170
8/18/2023,650,CConnecticut,75,169,-110,CON,Connecticut Sun,-5,-110,1022300183,40,46,1,1,1,0,1,0,0,75,95,20,86,6,away,home,40,6,170
8/18/2023,651,CChicago,67,161,-110,CHI,Chicago Sky,2,-113,1022300185,39,37,0,1,1,1,1,1,1,78,67,-11,76,-2,home,away,37,2,145
8/18/2023,652,AAtlanta,78,161,-110,ATL,Atlanta Dream,-2,-107,1022300185,39,37,1,0,0,0,0,0,0,78,67,-11,76,-2,home,home,39,-2,145
8/18/2023,655,MMinnesota,78,162,-110,MIN,Minnesota Lynx,-1,-105,1022300187,39,46,0,0,1,1,1,1,1,70,78,8,85,7,away,away,46,-7,148
8/18/2023,656,SSeattle,70,161.5,-110,SEA,Seattle Storm,1,-115,1022300187,39,46,1,1,0,0,0,0,0,70,78,8,85,7,away,home,39,7,148
8/18/2023,653,NYNew York,85,164.5,-110,NYL,New York Liberty,-12.5,-110,1022300186,38,43,0,1,0,0,1,1,1,63,85,22,81,5,away,away,43,-5,148
8/18/2023,654,PPhoenix,63,164.5,-110,PHO,Phoenix Mercury,12.5,-110,1022300186,38,43,1,0,1,1,0,0,0,63,85,22,81,5,away,home,38,5,148
8/19/2023,657,LALos Angeles,78,169.5,-110,LAS,Los Angeles Sparks,16.5,-110,1022300188,36,42,1,1,1,1,1,0,1,72,78,6,78,6,away,away,42,-6,150
8/19/2023,658,LVLas Vegas,72,169.5,-110,LVA,Las Vegas Aces,-17,-108,1022300188,36,42,0,0,0,0,0,1,0,72,78,6,78,6,away,home,36,6,150
8/20/2023,659,DDallas,97,166.5,-110,DAL,Dallas Wings,-5.5,-118,1022300189,46,56,1,1,1,1,1,1,1,84,97,13,102,10,away,away,56,-10,181
8/20/2023,660,WWashington,84,166.5,-110,WAS,Washington Mystics,5.5,-102,1022300189,46,56,0,0,0,0,0,0,0,84,97,13,102,10,away,home,46,10,181
8/20/2023,661,CConnecticut,79,160.5,-110,CON,Connecticut Sun,-6,-110,1022300190,40,45,0,1,1,1,0,0,0,73,79,6,85,5,away,away,45,-5,152
8/20/2023,662,CChicago,73,160.5,-110,CHI,Chicago Sky,6,-110,1022300190,40,45,1,0,0,0,1,1,1,73,79,6,85,5,away,home,40,5,152
8/20/2023,663,IIndiana,83,160.5,-115,IND,Indiana Fever,-4,-114,1022300191,32,40,1,1,1,1,1,1,1,73,83,10,72,8,away,away,40,-8,156
8/20/2023,664,PPhoenix,73,160.5,-105,PHO,Phoenix Mercury,4,-106,1022300191,32,40,0,0,0,0,0,0,0,73,83,10,72,8,away,home,32,8,156
8/20/2023,665,SSeattle,88,159.5,-110,SEA,Seattle Storm,5.5,-110,1022300192,40,47,1,1,1,1,1,1,1,74,88,14,87,7,away,away,47,-7,162
8/20/2023,666,MMinnesota,74,159.5,-110,MIN,Minnesota Lynx,-5.5,-110,1022300192,40,47,0,0,0,0,0,0,0,74,88,14,87,7,away,home,40,7,162
8/22/2023,601,LVLas Vegas,112,167,-110,LVA,Las Vegas Aces,-16,-110,1022300193,55,56,1,1,1,1,0,1,1,100,112,12,111,1,away,away,56,-1,212
8/22/2023,602,AAtlanta,100,167,-110,ATL,Atlanta Dream,16,-110,1022300193,55,56,0,0,0,0,1,0,0,100,112,12,111,1,away,home,55,1,212
8/22/2023,603,CConnecticut,68,159,-110,CON,Connecticut Sun,-4,-110,1022300194,31,36,0,0,0,0,1,1,1,64,68,4,67,5,away,away,36,-5,132
8/22/2023,604,WWashington,64,159,-110,WAS,Washington Mystics,4,-110,1022300194,31,36,1,1,1,1,0,0,0,64,68,4,67,5,away,home,31,5,132
8/22/2023,605,SSeattle,79,158,-110,SEA,Seattle Storm,4.5,-110,1022300195,50,40,0,0,0,0,0,0,0,102,79,-23,90,-10,home,away,40,10,181
8/22/2023,606,CChicago,102,158,-110,CHI,Chicago Sky,-4.5,-110,1022300195,50,40,1,1,1,1,1,1,1,102,79,-23,90,-10,home,home,50,-10,181
8/22/2023,607,DDallas,86,169.5,-110,DAL,Dallas Wings,-6,-110,1022300196,39,36,0,0,0,0,1,1,0,91,86,-5,75,-3,home,away,36,3,177
8/22/2023,608,MMinnesota,91,169.5,-110,MIN,Minnesota Lynx,6,-110,1022300196,39,36,1,1,1,1,0,0,1,91,86,-5,75,-3,home,home,39,-3,177
8/23/2023,609,PPhoenix,62,154.5,-110,PHO,Phoenix Mercury,11,-115,1022300197,44,30,0,0,0,0,0,0,0,91,62,-29,74,-14,home,away,30,14,153
8/23/2023,610,LALos Angeles,91,154.5,-110,LAS,Los Angeles Sparks,-11,-110,1022300197,44,30,1,1,1,1,1,1,1,91,62,-29,74,-14,home,home,44,-14,153
8/24/2023,613,NYNew York,95,165.5,-115,NYL,New York Liberty,-6,-110,1022300198,48,34,0,0,1,0,1,0,0,90,95,5,82,-14,home,away,34,14,185
8/24/2023,614,CConnecticut,90,166,-110,CON,Connecticut Sun,6,-110,1022300198,48,34,1,1,0,1,0,1,1,90,95,5,82,-14,home,home,48,-14,185
8/24/2023,611,SSeattle,86,160,-110,SEA,Seattle Storm,4,-115,1022300199,46,38,1,1,0,0,1,0,0,90,86,-4,84,-8,home,away,38,8,176
8/24/2023,612,IIndiana,90,160,-110,IND,Indiana Fever,-4,-105,1022300199,46,38,0,0,1,1,0,1,1,90,86,-4,84,-8,home,home,46,-8,176
8/24/2023,617,MMinnesota,90,166,-112,MIN,Minnesota Lynx,6,-110,1022300201,48,50,0,0,0,1,1,1,0,81,90,9,98,2,away,away,50,-2,171
8/24/2023,618,DDallas,81,166,-108,DAL,Dallas Wings,-6,-110,1022300201,48,50,1,1,1,0,0,0,1,81,90,9,98,2,away,home,48,2,171
8/24/2023,615,LVLas Vegas,94,171.5,-110,LVA,Las Vegas Aces,-14.5,-110,1022300200,50,37,0,0,0,0,0,0,0,87,94,7,87,-13,home,away,37,13,181
8/24/2023,616,CChicago,87,171.5,-110,CHI,Chicago Sky,14.5,-110,1022300200,50,37,1,1,1,1,1,1,1,87,94,7,87,-13,home,home,50,-13,181
8/25/2023,619,LALos Angeles,83,160,-110,LAS,Los Angeles Sparks,-1.5,-112,1022300202,52,39,0,0,0,0,0,0,0,78,83,5,91,-13,home,away,39,13,161
8/25/2023,620,AAtlanta,78,160,-110,ATL,Atlanta Dream,1.5,-108,1022300202,52,39,1,1,1,1,1,1,1,78,83,5,91,-13,home,home,52,-13,161
8/27/2023,625,LALos Angeles,68,156.5,-110,LAS,Los Angeles Sparks,6,-106,1022300205,43,38,1,1,1,1,1,0,0,83,68,-15,81,-5,home,away,38,5,151
8/27/2023,626,CConnecticut,83,156.5,-110,CON,Connecticut Sun,-6,-114,1022300205,43,38,0,0,0,0,0,1,1,83,68,-15,81,-5,home,home,43,-5,151
8/27/2023,627,AAtlanta,80,165,-110,ATL,Atlanta Dream,-1.5,-110,1022300206,47,37,1,0,0,0,0,0,0,83,80,-3,84,-10,home,away,37,10,163
8/27/2023,628,IIndiana,83,165,-110,IND,Indiana Fever,1.5,-110,1022300206,47,37,0,1,1,1,1,1,1,83,80,-3,84,-10,home,home,47,-10,163
8/27/2023,631,DDallas,77,162.5,-114,DAL,Dallas Wings,-7.5,-110,1022300207,42,35,1,0,0,0,0,0,0,74,77,3,77,-7,home,away,35,7,151
8/27/2023,632,PPhoenix,74,162.5,-106,PHO,Phoenix Mercury,7.5,-110,1022300207,42,35,0,1,1,1,1,1,1,74,77,3,77,-7,home,home,42,-7,151
8/27/2023,629,CChicago,90,161.5,-110,CHI,Chicago Sky,-1,-110,1022300208,55,46,0,0,0,0,0,0,0,85,90,5,101,-9,home,away,46,9,175
8/27/2023,630,SSeattle,85,161.5,-110,SEA,Seattle Storm,1,-110,1022300208,55,46,1,1,1,1,1,1,1,85,90,5,101,-9,home,home,55,-9,175
8/28/2023,633,LVLas Vegas,85,174,-110,LVA,Las Vegas Aces,2,-108,1022300209,47,35,1,1,0,0,0,0,0,94,85,-9,82,-12,home,away,35,12,179
8/28/2023,634,NYNew York,94,174.5,-116,NYL,New York Liberty,-2,-112,1022300209,47,35,0,0,1,1,1,1,1,94,85,-9,82,-12,home,home,47,-12,179
8/29/2023,637,PPhoenix,76,160,-110,PHO,Phoenix Mercury,8,-105,1022300210,54,26,0,0,0,0,0,0,0,94,76,-18,80,-28,home,away,26,28,170
8/29/2023,638,AAtlanta,94,159.5,-110,ATL,Atlanta Dream,-8,-115,1022300210,54,26,1,1,1,1,1,1,1,94,76,-18,80,-28,home,home,54,-28,170
8/29/2023,635,MMinnesota,72,161.5,-110,MIN,Minnesota Lynx,7,-110,1022300211,42,37,0,0,0,0,0,0,0,83,72,-11,79,-5,home,away,37,5,155
8/29/2023,636,WWashington,83,161.5,-110,WAS,Washington Mystics,-7,-107,1022300211,42,37,1,1,1,1,1,1,1,83,72,-11,79,-5,home,home,42,-5,155
8/29/2023,639,CChicago,76,162,-110,CHI,Chicago Sky,5,-118,1022300212,43,43,0,0,0,0,0,0,0,75,76,1,86,0,tie,away,43,-0,151
8/29/2023,640,LALos Angeles,75,162,-110,LAS,Los Angeles Sparks,-5,-102,1022300212,43,43,1,1,1,1,1,1,1,75,76,1,86,0,tie,home,43,0,151
8/31/2023,641,PPhoenix,74,154,-105,PHO,Phoenix Mercury,15,-110,1022300213,38,41,1,1,1,0,1,1,1,84,74,-10,79,3,away,away,41,-3,158
8/31/2023,642,CConnecticut,84,154,-115,CON,Connecticut Sun,-15,-110,1022300213,38,41,0,0,0,1,0,0,0,84,74,-10,79,3,away,home,38,3,158
8/31/2023,643,WWashington,75,168.5,-110,WAS,Washington Mystics,10.5,-110,1022300214,40,30,0,0,0,0,0,0,0,84,75,-9,70,-10,home,away,30,10,159
8/31/2023,644,LVLas Vegas,84,168.5,-110,LVA,Las Vegas Aces,-10.5,-110,1022300214,40,30,1,1,1,1,1,1,1,84,75,-9,70,-10,home,home,40,-10,159
8/31/2023,645,SSeattle,72,158.5,-105,SEA,Seattle Storm,7,-101,1022300215,29,38,1,1,1,1,1,1,1,61,72,11,67,9,away,away,38,-9,133
8/31/2023,646,LALos Angeles,61,158.5,-115,LAS,Los Angeles Sparks,-7,-119,1022300215,29,38,0,0,0,0,0,0,0,61,72,11,67,9,away,home,29,9,133
9/2/2023,653,SSeattle,77,170,-110,SEA,Seattle Storm,20,-114,1022300219,49,43,0,0,0,0,0,0,0,103,77,-26,92,-6,home,away,43,6,180
9/2/2023,654,LVLas Vegas,103,170,-110,LVA,Las Vegas Aces,-20,-106,1022300219,49,43,1,1,1,1,1,1,1,103,77,-26,92,-6,home,home,49,-6,180
9/3/2023,655,NYNew York,86,164.5,-110,NYL,New York Liberty,-8.5,-107,1022300220,36,41,0,1,1,1,1,1,1,69,86,17,77,5,away,away,41,-5,155
9/3/2023,656,CChicago,69,164.5,-110,CHI,Chicago Sky,8.5,-113,1022300220,36,41,1,0,0,0,0,0,0,69,86,17,77,5,away,home,36,5,155
9/3/2023,657,IIndiana,97,171,-110,IND,Indiana Fever,9,-105,1022300221,36,39,1,1,1,1,1,1,1,84,97,13,75,3,away,away,39,-3,181
9/3/2023,658,DDallas,84,171,-110,DAL,Dallas Wings,-9,-115,1022300221,36,39,0,0,0,0,0,0,0,84,97,13,75,3,away,home,36,3,181
9/3/2023,659,PPhoenix,73,157,-112,PHO,Phoenix Mercury,8,-110,1022300222,41,41,1,0,1,1,1,1,0,86,73,-13,82,0,tie,away,41,-0,159
9/3/2023,660,MMinnesota,86,157,-108,MIN,Minnesota Lynx,-8,-110,1022300222,41,41,0,1,0,0,0,0,1,86,73,-13,82,0,tie,home,41,0,159
9/3/2023,661,WWashington,64,157.5,-110,WAS,Washington Mystics,-3.5,-127,1022300223,38,34,0,0,1,0,0,0,0,72,64,-8,72,-4,home,away,34,4,136
9/3/2023,662,LALos Angeles,72,157.5,-110,LAS,Los Angeles Sparks,3.5,107,1022300223,38,34,1,1,0,1,1,1,1,72,64,-8,72,-4,home,home,38,-4,136
9/5/2023,601,CChicago,96,165,-110,CHI,Chicago Sky,1,-110,1022300225,34,49,1,1,1,1,1,1,1,69,96,27,83,15,away,away,49,-15,165
9/5/2023,602,IIndiana,69,165,-110,IND,Indiana Fever,-1,-110,1022300225,34,49,0,0,0,0,0,0,0,69,96,27,83,15,away,home,34,15,165
9/5/2023,603,LALos Angeles,76,151.5,-110,LAS,Los Angeles Sparks,10.5,-110,1022300224,49,36,0,0,0,0,0,0,0,90,76,-14,85,-13,home,away,36,13,166
9/5/2023,604,CConnecticut,90,151.5,-110,CON,Connecticut Sun,-10.5,-110,1022300224,49,36,1,1,1,1,1,1,1,90,76,-14,85,-13,home,home,49,-13,166
9/5/2023,605,NYNew York,94,172.5,-110,NYL,New York Liberty,-6.5,-110,1022300226,51,53,1,1,1,1,0,0,0,93,94,1,104,2,away,away,53,-2,187
9/5/2023,606,DDallas,93,172.5,-110,DAL,Dallas Wings,6.5,-110,1022300226,51,53,0,0,0,0,1,1,1,93,94,1,104,2,away,home,51,2,187
9/5/2023,607,WWashington,100,153.5,-110,WAS,Washington Mystics,-7,-110,1022300227,33,50,1,1,1,1,1,1,1,77,100,23,83,17,away,away,50,-17,177
9/5/2023,608,PPhoenix,77,153.5,-110,PHO,Phoenix Mercury,7,-110,1022300227,33,50,0,0,0,0,0,0,0,77,100,23,83,17,away,home,33,17,177
9/6/2023,609,SSeattle,68,164,-108,SEA,Seattle Storm,9,-110,1022300228,47,40,1,1,1,1,1,1,0,79,68,-11,87,-7,home,away,40,7,147
9/6/2023,610,AAtlanta,79,164,-112,ATL,Atlanta Dream,-9,-110,1022300228,47,40,0,0,0,0,0,0,1,79,68,-11,87,-7,home,home,47,-7,147
9/7/2023,611,LALos Angeles,89,160.5,-110,LAS,Los Angeles Sparks,16,-110,1022300229,43,50,0,0,0,1,1,1,1,96,89,-7,93,7,away,away,50,-7,185
9/7/2023,612,NYNew York,96,160.5,-110,NYL,New York Liberty,-16,-110,1022300229,43,50,1,1,1,0,0,0,0,96,89,-7,93,7,away,home,43,7,185
9/8/2023,615,IIndiana,59,161,-110,IND,Indiana Fever,10,-110,1022300230,37,31,0,0,0,0,0,0,0,76,59,-17,68,-6,home,away,31,6,135
9/8/2023,616,CConnecticut,76,161,-110,CON,Connecticut Sun,-10,-110,1022300230,37,31,1,1,1,1,1,1,1,76,59,-17,68,-6,home,home,37,-6,135
9/8/2023,613,AAtlanta,80,162,-110,ATL,Atlanta Dream,5.5,-110,1022300231,35,42,1,1,1,1,1,1,1,75,80,5,77,7,away,away,42,-7,155
9/8/2023,614,WWashington,75,162,-110,WAS,Washington Mystics,-5.5,-110,1022300231,35,42,0,0,0,0,0,0,0,75,80,5,77,7,away,home,35,7,155
9/8/2023,617,MMinnesota,87,165,-110,MIN,Minnesota Lynx,4,-105,1022300232,44,39,1,1,1,1,1,0,0,92,87,-5,83,-5,home,away,39,5,179
9/8/2023,618,CChicago,92,165.5,-110,CHI,Chicago Sky,-4.5,-110,1022300232,44,39,0,0,0,0,0,1,1,92,87,-5,83,-5,home,home,44,-5,179
9/8/2023,619,SSeattle,91,169.5,-110,SEA,Seattle Storm,11.5,-110,1022300233,56,45,0,0,0,0,0,0,0,106,91,-15,101,-11,home,away,45,11,197
9/8/2023,620,DDallas,106,169.5,-112,DAL,Dallas Wings,-11.5,-110,1022300233,56,45,1,1,1,1,1,1,1,106,91,-15,101,-11,home,home,56,-11,197
9/8/2023,621,LVLas Vegas,94,164.5,-110,LVA,Las Vegas Aces,-19.5,-110,1022300234,31,48,1,1,1,1,1,1,1,73,94,21,79,17,away,away,48,-17,167
9/8/2023,622,PPhoenix,73,164.5,-110,PHO,Phoenix Mercury,19.5,-110,1022300234,31,48,0,0,0,0,0,0,0,73,94,21,79,17,away,home,31,17,167
9/10/2023,625,WWashington,90,162,-112,WAS,Washington Mystics,10,-105,1022300238,50,50,0,0,0,0,0,0,0,88,90,2,100,0,tie,away,50,-0,178
9/10/2023,626,NYNew York,88,162,-108,NYL,New York Liberty,-10,-115,1022300238,50,50,1,1,1,1,1,1,1,88,90,2,100,0,tie,home,50,0,178
9/10/2023,629,DDallas,94,172,-115,DAL,Dallas Wings,1,-110,1022300235,39,44,1,1,1,1,1,1,1,77,94,17,83,5,away,away,44,-5,171
9/10/2023,630,AAtlanta,77,172,-105,ATL,Atlanta Dream,-1,-110,1022300235,39,44,0,0,0,0,0,0,0,77,94,17,83,5,away,home,39,5,171
9/10/2023,627,CChicago,102,159,-110,CHI,Chicago Sky,9.5,-107,1022300236,43,41,1,1,1,1,0,1,0,91,102,11,84,-2,home,away,41,2,193
9/10/2023,628,CConnecticut,91,159,-110,CON,Connecticut Sun,-9.5,-113,1022300236,43,41,0,0,0,0,1,0,1,91,102,11,84,-2,home,home,43,-2,193
9/10/2023,623,MMinnesota,72,165.5,-110,MIN,Minnesota Lynx,-2.5,-110,1022300237,56,44,0,0,0,0,0,0,0,87,72,-15,100,-12,home,away,44,12,159
9/10/2023,624,IIndiana,87,165.5,-110,IND,Indiana Fever,2.5,-110,1022300237,56,44,1,1,1,1,1,1,1,87,72,-15,100,-12,home,home,56,-12,159
9/10/2023,631,LALos Angeles,91,158.5,-115,LAS,Los Angeles Sparks,-2,-110,1022300240,53,44,0,0,0,0,0,0,0,89,91,2,97,-9,home,away,44,9,180
9/10/2023,632,SSeattle,89,158.5,-105,SEA,Seattle Storm,2,-110,1022300240,53,44,1,1,1,1,1,1,1,89,91,2,97,-9,home,home,53,-9,180
9/10/2023,633,PPhoenix,85,166,-110,PHO,Phoenix Mercury,21,-110,1022300239,53,41,0,0,0,0,0,0,0,100,85,-15,94,-12,home,away,41,12,185
9/10/2023,634,LVLas Vegas,100,166,-110,LVA,Las Vegas Aces,-21,-105,1022300239,53,41,1,1,1,1,1,1,1,100,85,-15,94,-12,home,home,53,-12,185
9/13/2023,641,MMinnesota,60,159.5,-110,MIN,Minnesota Lynx,9,-107,1042300121,46,32,0,0,0,0,0,0,0,90,60,-30,78,-14,home,away,32,14,150
9/13/2023,642,CConnecticut,90,159.5,-110,CON,Connecticut Sun,-9,-113,1042300121,46,32,1,1,1,1,1,1,1,90,60,-30,78,-14,home,home,46,-14,150
9/13/2023,643,CChicago,59,172.5,-110,CHI,Chicago Sky,16.5,-110,1042300101,53,36,0,0,0,0,0,0,0,87,59,-28,89,-17,home,away,36,17,146
9/13/2023,644,LVLas Vegas,87,172.5,-110,LVA,Las Vegas Aces,-16.5,-110,1042300101,53,36,1,1,1,1,1,1,1,87,59,-28,89,-17,home,home,53,-17,146
9/15/2023,645,WWashington,75,163.5,-110,WAS,Washington Mystics,10,-110,1042300111,46,42,1,1,1,1,0,1,0,90,75,-15,88,-4,home,away,42,4,165
9/15/2023,646,NYNew York,90,164,-116,NYL,New York Liberty,-10,-110,1042300111,46,42,0,0,0,0,1,0,1,90,75,-15,88,-4,home,home,46,-4,165
9/15/2023,647,AAtlanta,82,169,-110,ATL,Atlanta Dream,6,-110,1042300131,49,49,1,1,1,1,1,1,1,94,82,-12,98,0,tie,away,49,-0,176
9/15/2023,648,DDallas,94,169.5,-112,DAL,Dallas Wings,-6,-110,1042300131,49,49,0,0,0,0,0,0,0,94,82,-12,98,0,tie,home,49,0,176
9/17/2023,651,MMinnesota,82,159,-110,MIN,Minnesota Lynx,9.5,-115,1042300122,39,44,1,1,1,1,1,1,1,75,82,7,83,5,away,away,44,-5,157
9/17/2023,652,CConnecticut,75,159,-110,CON,Connecticut Sun,-9.5,-105,1042300122,39,44,0,0,0,0,0,0,0,75,82,7,83,5,away,home,39,5,157
9/17/2023,653,CChicago,70,170.5,-110,CHI,Chicago Sky,17.5,-105,1042300102,44,29,0,0,0,0,0,0,0,92,70,-22,73,-15,home,away,29,15,162
9/17/2023,654,LVLas Vegas,92,170.5,-110,LVA,Las Vegas Aces,-17.5,-115,1042300102,44,29,1,1,1,1,1,1,1,92,70,-22,73,-15,home,home,44,-15,162
9/19/2023,655,WWashington,85,162,-110,WAS,Washington Mystics,10.5,-110,1042300112,46,35,1,1,0,0,0,0,0,90,85,-5,81,-11,home,away,35,11,175
9/19/2023,656,NYNew York,90,162,-110,NYL,New York Liberty,-10.5,-110,1042300112,46,35,0,0,1,1,1,1,1,90,85,-5,81,-11,home,home,46,-11,175
9/19/2023,647,AAtlanta,74,169.5,-105,ATL,Atlanta Dream,7,-110,1042300132,52,34,0,1,1,0,0,0,0,101,74,-27,86,-18,home,away,34,18,175
9/19/2023,648,DDallas,101,169.5,-115,DAL,Dallas Wings,-7,-110,1042300132,52,34,1,0,0,1,1,1,1,101,74,-27,86,-18,home,home,52,-18,175
9/20/2023,603,CConnecticut,90,155,-110,CON,Connecticut Sun,-5.5,-117,1042300123,34,49,1,1,1,1,1,1,1,75,90,15,83,15,away,away,49,-15,165
9/20/2023,604,MMinnesota,75,155,-110,MIN,Minnesota Lynx,5.5,-110,1042300123,34,49,0,0,0,0,0,0,0,75,90,15,83,15,away,home,34,15,165
9/24/2023,609,CConnecticut,78,162,-115,CON,Connecticut Sun,8.5,-112,1042300211,40,37,1,1,1,1,1,1,0,63,78,15,77,-3,home,away,37,3,141
9/24/2023,610,NYNew York,63,162,-105,NYL,New York Liberty,-8.5,-108,1042300211,40,37,0,0,0,0,0,0,1,63,78,15,77,-3,home,home,40,-3,141
9/24/2023,611,DDallas,83,174,-110,DAL,Dallas Wings,10,-110,1042300201,49,45,0,0,0,0,0,0,0,97,83,-14,94,-4,home,away,45,4,180
9/24/2023,612,LVLas Vegas,97,174,-110,LVA,Las Vegas Aces,-10,-110,1042300201,49,45,1,1,1,1,1,1,1,97,83,-14,94,-4,home,home,49,-4,180
9/26/2023,613,CConnecticut,77,159,-115,CON,Connecticut Sun,9.5,-110,1042300212,38,42,0,0,1,1,1,1,1,84,77,-7,80,4,away,away,42,-4,161
9/26/2023,614,NYNew York,84,159,-105,NYL,New York Liberty,-9.5,-110,1042300212,38,42,1,1,0,0,0,0,0,84,77,-7,80,4,away,home,38,4,161
9/26/2023,615,DDallas,84,175,-110,DAL,Dallas Wings,10.5,-108,1042300202,44,37,0,0,0,0,0,0,0,91,84,-7,81,-7,home,away,37,7,175
9/26/2023,616,LVLas Vegas,91,175,-110,LVA,Las Vegas Aces,-10.5,-112,1042300202,44,37,1,1,1,1,1,1,1,91,84,-7,81,-7,home,home,44,-7,175
9/29/2023,617,NYNew York,92,158.5,-110,NYL,New York Liberty,-4.5,100,1042300213,40,54,1,1,1,1,1,1,1,81,92,11,94,14,away,away,54,-14,173
9/29/2023,618,CConnecticut,81,159,-105,CON,Connecticut Sun,4.5,-120,1042300213,40,54,0,0,0,0,0,0,0,81,92,11,94,14,away,home,40,14,173
9/29/2023,619,LVLas Vegas,64,175,-105,LVA,Las Vegas Aces,-6.5,-112,1042300203,36,31,1,1,0,0,0,0,1,61,64,3,67,-5,home,away,31,5,125
9/29/2023,620,DDallas,61,175,-115,DAL,Dallas Wings,6.5,-108,1042300203,36,31,0,0,1,1,1,1,0,61,64,3,67,-5,home,home,36,-5,125
10/8/2023,629,NYNew York,82,170.5,-110,NYL,New York Liberty,4.5,-110,1042300301,46,49,0,0,0,1,1,1,1,99,82,-17,95,3,away,away,49,-3,181
10/8/2023,630,LVLas Vegas,99,170.5,-110,LVA,Las Vegas Aces,-4.5,-110,1042300301,46,49,1,1,1,0,0,0,0,99,82,-17,95,3,away,home,46,3,181
10/11/2023,631,NYNew York,76,171,-110,NYL,New York Liberty,4.5,-112,1042300302,52,44,0,0,0,0,0,0,0,104,76,-28,96,-8,home,away,44,8,180
10/11/2023,632,LVLas Vegas,104,171,-110,LVA,Las Vegas Aces,-4.5,-108,1042300302,52,44,1,1,1,1,1,1,1,104,76,-28,96,-8,home,home,52,-8,180
10/18/2023,633,LVLas Vegas,70,168.5,-110,LVA,Las Vegas Aces,5.5,-110,1042300304,39,30,0,0,0,0,0,0,0,69,70,1,69,-9,home,away,30,9,139
10/18/2023,634,NYNew York,69,168.5,-110,NYL,New York Liberty,-5.5,-110,1042300304,39,30,1,1,1,1,1,1,1,69,70,1,69,-9,home,home,39,-9,139
5/19/2023,631,NYNew York,64,163.5,-110,NYL,New York Liberty,-2,-116,1022300002,39,26,1,0,0,0,0,0,0,80,64,-16,65,-13,home,away,26,13,144
5/19/2023,632,WWashington,80,163.5,-110,WAS,Washington Mystics,2,-104,1022300002,39,26,0,1,1,1,1,1,1,80,64,-16,65,-13,home,home,39,-13,144
5/19/2023,631,CConnecticut,70,162,-110,CON,Connecticut Sun,-7.5,-110,1022300001,28,35,1,1,1,1,1,1,1,61,70,9,63,7,away,away,35,-7,131
5/19/2023,632,IIndiana,61,162,-110,IND,Indiana Fever,7.5,-110,1022300001,28,35,0,0,0,0,0,0,0,61,70,9,63,7,away,home,28,7,131
5/19/2023,635,CChicago,77,162.5,-110,CHI,Chicago Sky,5,-110,1022300003,27,44,0,0,0,1,1,1,1,66,77,11,71,17,away,away,44,-17,143
5/19/2023,636,MMinnesota,66,162.5,-110,MIN,Minnesota Lynx,-5,-110,1022300003,27,44,1,1,1,0,0,0,0,66,77,11,71,17,away,home,27,17,143
5/19/2023,637,PPhoenix,71,156.5,-110,PHO,Phoenix Mercury,2.5,-110,1022300004,54,41,1,1,1,1,0,0,0,94,71,-23,95,-13,home,away,41,13,165
5/19/2023,638,LALos Angeles,94,156.5,-110,LAS,Los Angeles Sparks,-2.5,-110,1022300004,54,41,0,0,0,0,1,1,1,94,71,-23,95,-13,home,home,54,-13,165
5/20/2023,639,AAtlanta,78,161.5,-110,ATL,Atlanta Dream,2,-110,1022300006,47,30,0,1,0,0,0,0,0,85,78,-7,77,-17,home,away,30,17,163
5/20/2023,640,DDallas,85,161.5,-110,DAL,Dallas Wings,-1.5,-110,1022300006,47,30,1,0,1,1,1,1,1,85,78,-7,77,-17,home,home,47,-17,163
5/20/2023,641,LVLas Vegas,105,167.5,-120,LVA,Las Vegas Aces,-13.5,-110,1022300005,28,43,1,1,1,1,1,1,1,64,105,41,71,15,away,away,43,-15,169
5/20/2023,642,SSeattle,64,167.5,100,SEA,Seattle Storm,13.5,-110,1022300005,28,43,0,0,0,0,0,0,0,64,105,41,71,15,away,home,28,15,169
5/21/2023,643,WWashington,74,159,-110,WAS,Washington Mystics,-0.5,-125,1022300007,34,38,1,1,1,1,1,1,1,80,74,-6,72,4,away,away,38,-4,154
5/21/2023,644,CConnecticut,80,159,-110,CON,Connecticut Sun,-0.5,105,1022300007,34,38,0,0,0,0,0,0,0,80,74,-6,72,4,away,home,34,4,154
5/21/2023,645,IIndiana,73,159.5,-110,IND,Indiana Fever,16.5,-110,1022300008,62,35,0,0,0,0,0,0,0,90,73,-17,97,-27,home,away,35,27,163
5/21/2023,646,NYNew York,90,159.5,-110,NYL,New York Liberty,-16.5,-110,1022300008,62,35,1,1,1,1,1,1,1,90,73,-17,97,-27,home,home,62,-27,163
5/21/2023,647,CChicago,75,160,-110,CHI,Chicago Sky,4,-110,1022300009,35,41,1,1,1,1,1,1,1,69,75,6,76,6,away,away,41,-6,144
5/21/2023,648,PPhoenix,69,160,-110,PHO,Phoenix Mercury,-4,-110,1022300009,35,41,0,0,0,0,0,0,0,69,75,6,76,6,away,home,35,6,144
5/25/2023,655,LVLas Vegas,94,169.5,-110,LVA,Las Vegas Aces,-15.5,-110,1022300012,46,36,0,0,0,0,0,0,0,85,94,9,82,-10,home,away,36,10,179
5/25/2023,656,LALos Angeles,85,169.5,-110,LAS,Los Angeles Sparks,15.5,-110,1022300012,46,36,1,1,1,1,1,1,1,85,94,9,82,-10,home,home,46,-10,179
5/25/2023,653,MMinnesota,81,160,-110,MIN,Minnesota Lynx,5,-110,1022300013,57,40,0,0,0,0,0,0,0,90,81,-9,97,-17,home,away,40,17,171
5/25/2023,654,PPhoenix,90,160,-110,PHO,Phoenix Mercury,-5,-110,1022300013,57,40,1,1,1,1,1,1,1,90,81,-9,97,-17,home,home,57,-17,171
5/26/2023,601,WWashington,71,157,-110,WAS,Washington Mystics,-5,-110,1022300014,34,40,0,1,0,1,1,1,1,69,71,2,74,6,away,away,40,-6,140
5/26/2023,602,CChicago,69,157,-110,CHI,Chicago Sky,5,-110,1022300014,34,40,1,0,1,0,0,0,0,69,71,2,74,6,away,home,34,6,140
5/26/2023,603,DDallas,95,161,-110,DAL,Dallas Wings,-4.5,-110,1022300015,41,52,0,0,1,1,1,1,1,91,95,4,93,11,away,away,52,-11,186
5/26/2023,604,SSeattle,91,161,-110,SEA,Seattle Storm,4,-110,1022300015,41,52,1,1,0,0,0,0,0,91,95,4,93,11,away,home,41,11,186
5/27/2023,605,CConnecticut,65,165,-110,CON,Connecticut Sun,6.5,-110,1022300016,32,38,1,1,1,1,1,1,1,81,65,-16,70,6,away,away,38,-6,146
5/27/2023,606,NYNew York,81,165,-110,NYL,New York Liberty,-6.5,-110,1022300016,32,38,0,0,0,0,0,0,0,81,65,-16,70,6,away,home,32,6,146
5/27/2023,607,LALos Angeles,65,171,-110,LAS,Los Angeles Sparks,15.5,-110,1022300017,59,28,0,0,0,0,0,0,0,93,65,-28,87,-31,home,away,28,31,158
5/27/2023,608,LVLas Vegas,93,171,-110,LVA,Las Vegas Aces,-15.5,-110,1022300017,59,28,1,1,1,1,1,1,1,93,65,-28,87,-31,home,home,59,-31,158
5/28/2023,609,IIndiana,90,159.5,-110,IND,Indiana Fever,6.5,109,1022300018,47,41,0,0,0,0,0,0,0,87,90,3,88,-6,home,away,41,6,177
5/28/2023,610,AAtlanta,87,159.5,-110,ATL,Atlanta Dream,-6.5,-129,1022300018,47,41,1,1,1,1,1,1,1,87,90,3,88,-6,home,home,47,-6,177
5/28/2023,611,DDallas,88,161.5,-110,DAL,Dallas Wings,3,-110,1022300019,49,45,0,0,0,1,0,0,0,94,88,-6,94,-4,home,away,45,4,182
5/28/2023,612,CChicago,94,161.5,-110,CHI,Chicago Sky,-3,-110,1022300019,49,45,1,1,1,0,1,1,1,94,88,-6,94,-4,home,home,49,-4,182
5/28/2023,613,MMinnesota,73,170.5,-110,MIN,Minnesota Lynx,14.5,105,1022300020,50,38,1,0,0,0,0,0,0,94,73,-21,88,-12,home,away,38,12,167
5/28/2023,614,LVLas Vegas,94,170,-115,LVA,Las Vegas Aces,-14.5,-125,1022300020,50,38,0,1,1,1,1,1,1,94,73,-21,88,-12,home,home,50,-12,167
5/30/2023,615,CChicago,65,162.5,-110,CHI,Chicago Sky,3.5,-110,1022300021,40,25,0,0,0,0,0,0,0,83,65,-18,65,-15,home,away,25,15,148
5/30/2023,616,AAtlanta,83,162.5,-110,ATL,Atlanta Dream,-3.5,-110,1022300021,40,25,1,1,1,1,1,1,1,83,65,-18,65,-15,home,home,40,-15,148
5/30/2023,617,IIndiana,78,158,-120,IND,Indiana Fever,12,-102,1022300022,38,34,0,0,0,1,1,0,0,81,78,-3,72,-4,home,away,34,4,159
5/30/2023,618,CConnecticut,81,158,100,CON,Connecticut Sun,-12,-118,1022300022,38,34,1,1,1,0,0,1,1,81,78,-3,72,-4,home,home,38,-4,159
5/30/2023,621,MMinnesota,89,169,-116,MIN,Minnesota Lynx,6,-105,1022300023,52,46,1,1,1,1,1,1,0,94,89,-5,98,-6,home,away,46,6,183
5/30/2023,622,DDallas,94,169,-104,DAL,Dallas Wings,-6,-115,1022300023,52,46,0,0,0,0,0,0,1,94,89,-5,98,-6,home,home,52,-6,183
5/30/2023,619,NYNew York,86,163,-110,NYL,New York Liberty,-14.5,-110,1022300024,39,46,1,1,1,1,1,0,1,78,86,8,85,7,away,away,46,-7,164
5/30/2023,620,SSeattle,78,163,-110,SEA,Seattle Storm,14.5,-110,1022300024,39,46,0,0,0,0,0,1,0,78,86,8,85,7,away,home,39,7,164
6/1/2023,623,CConnecticut,89,159.5,-110,CON,Connecticut Sun,-6,-115,1022300025,47,47,1,1,1,1,0,1,1,84,89,5,94,0,tie,away,47,-0,173
6/1/2023,624,MMinnesota,84,159.5,-110,MIN,Minnesota Lynx,6,-105,1022300025,47,47,0,0,0,0,1,0,0,84,89,5,94,0,tie,home,47,0,173
6/2/2023,625,NYNew York,77,159,-105,NYL,New York Liberty,-10,-110,1022300028,43,35,0,0,0,0,0,0,0,76,77,1,78,-8,home,away,35,8,153
6/2/2023,626,CChicago,76,159,-115,CHI,Chicago Sky,10,-110,1022300028,43,35,1,1,1,1,1,1,1,76,77,1,78,-8,home,home,43,-8,153
6/2/2023,627,DDallas,74,168,-110,DAL,Dallas Wings,7,105,1022300026,36,30,0,1,1,0,0,0,0,75,74,-1,66,-6,home,away,30,6,149
6/2/2023,628,WWashington,75,168,-110,WAS,Washington Mystics,-7,-125,1022300026,36,30,1,0,0,1,1,1,1,75,74,-1,66,-6,home,home,36,-6,149
6/2/2023,629,LVLas Vegas,92,173,-116,LVA,Las Vegas Aces,-11.5,-110,1022300027,30,45,1,1,1,1,1,1,1,87,92,5,75,15,away,away,45,-15,179
6/2/2023,630,AAtlanta,87,173,-104,ATL,Atlanta Dream,11.5,-110,1022300027,30,45,0,0,0,0,0,0,0,87,92,5,75,15,away,home,30,15,179
6/2/2023,631,LALos Angeles,99,164,-110,LAS,Los Angeles Sparks,3.5,-110,1022300029,44,44,1,1,1,1,1,1,1,93,99,6,88,0,tie,away,44,-0,192
6/2/2023,632,PPhoenix,93,164,-110,PHO,Phoenix Mercury,-3.5,-110,1022300029,44,44,0,0,0,0,0,0,0,93,99,6,88,0,tie,home,44,0,192
6/3/2023,633,MMinnesota,80,160.5,-110,MIN,Minnesota Lynx,8,-110,1022300030,32,39,0,0,0,1,1,1,1,78,80,2,71,7,away,away,39,-7,158
6/3/2023,634,WWashington,78,160.5,-110,WAS,Washington Mystics,-8,-110,1022300030,32,39,1,1,1,0,0,0,0,78,80,2,71,7,away,home,32,7,158
6/3/2023,635,SSeattle,85,162,-110,SEA,Seattle Storm,6.5,-106,1022300031,39,39,1,1,1,1,1,0,0,92,85,-7,78,0,tie,away,39,-0,177
6/3/2023,636,LALos Angeles,92,162,-110,LAS,Los Angeles Sparks,-6.5,-114,1022300031,39,39,0,0,0,0,0,1,1,92,85,-7,78,0,tie,home,39,0,177
6/4/2023,637,DDallas,74,166,-110,DAL,Dallas Wings,6,-110,1022300032,44,30,0,0,0,0,0,0,0,80,74,-6,74,-14,home,away,30,14,154
6/4/2023,638,CConnecticut,80,166,-110,CON,Connecticut Sun,-6,-110,1022300032,44,30,1,1,1,1,1,1,1,80,74,-6,74,-14,home,home,44,-14,154
6/4/2023,639,CChicago,86,155.5,-110,CHI,Chicago Sky,12,-113,1022300033,47,30,0,0,0,0,0,0,0,82,86,4,77,-17,home,away,30,17,168
6/4/2023,640,NYNew York,82,155.5,-110,NYL,New York Liberty,-12,-107,1022300033,47,30,1,1,1,1,1,1,1,82,86,4,77,-17,home,home,47,-17,168
6/4/2023,641,LVLas Vegas,84,171.5,-110,LVA,Las Vegas Aces,-14.5,-111,1022300034,39,38,0,0,0,0,0,0,0,80,84,4,77,-1,home,away,38,1,164
6/4/2023,642,IIndiana,80,171.5,-110,IND,Indiana Fever,14.5,-109,1022300034,39,38,1,1,1,1,1,1,1,80,84,4,77,-1,home,home,39,-1,164
6/6/2023,645,LVLas Vegas,90,168,-110,LVA,Las Vegas Aces,-5.5,-104,1022300035,31,48,1,1,1,1,1,1,1,84,90,6,79,17,away,away,48,-17,174
6/6/2023,646,CConnecticut,84,168,-110,CON,Connecticut Sun,5.5,-116,1022300035,31,48,0,0,0,0,0,0,0,84,90,6,79,17,away,home,31,17,174
6/6/2023,647,IIndiana,103,157,-110,IND,Indiana Fever,5,-112,1022300036,44,50,0,1,0,0,0,1,1,108,103,-5,94,6,away,away,50,-6,211
6/6/2023,648,CChicago,108,157,-110,CHI,Chicago Sky,-5,-108,1022300036,44,50,1,0,1,1,1,0,0,108,103,-5,94,6,away,home,44,6,211
6/6/2023,649,LALos Angeles,63,164,-110,LAS,Los Angeles Sparks,-3,-117,1022300037,35,38,1,1,1,1,1,1,1,66,63,-3,73,3,away,away,38,-3,129
6/6/2023,650,SSeattle,66,164,-110,SEA,Seattle Storm,3,-103,1022300037,35,38,0,0,0,0,0,0,0,66,63,-3,73,3,away,home,35,3,129
6/7/2023,653,PPhoenix,79,167.5,-115,PHO,Phoenix Mercury,5,-107,1022300039,44,48,1,1,1,1,0,0,0,84,79,-5,92,4,away,away,48,-4,163
6/7/2023,654,DDallas,84,167.5,-110,DAL,Dallas Wings,-5,-113,1022300039,44,48,0,0,0,0,1,1,1,84,79,-5,92,4,away,home,44,4,163
6/7/2023,651,MMinnesota,NA,163,-115,MIN,Minnesota Lynx,13.5,-110,NA,NA,NA,NA,NA,NA,NA,NA,NA,NA,NA,NA,NA,NA,NA,NA,NA,NA,NA,NA
6/7/2023,652,NYNew York,NA,163,-105,NYL,New York Liberty,-13.5,-110,NA,NA,NA,NA,NA,NA,NA,NA,NA,NA,NA,NA,NA,NA,NA,NA,NA,NA,NA,NA
6/8/2023,655,LVLas Vegas,77,167,-115,LVA,Las Vegas Aces,-5.5,-110,1022300040,43,28,0,0,0,0,0,0,0,94,77,-17,71,-15,home,away,28,15,171
6/8/2023,656,CConnecticut,94,168,-110,CON,Connecticut Sun,5.5,-110,1022300040,43,28,1,1,1,1,1,1,1,94,77,-17,71,-15,home,home,43,-15,171
6/9/2023,657,NYNew York,106,165,-115,NYL,New York Liberty,-5.5,-131,1022300041,39,61,0,0,1,1,1,1,1,83,106,23,100,22,away,away,61,-22,189
6/9/2023,658,AAtlanta,83,165,-105,ATL,Atlanta Dream,6.5,-110,1022300041,39,61,1,1,0,0,0,0,0,83,106,23,100,22,away,home,39,22,189
6/9/2023,659,IIndiana,71,160.5,-110,IND,Indiana Fever,3,-115,1022300043,34,36,1,1,0,0,0,1,1,69,71,2,70,2,away,away,36,-2,140
6/9/2023,660,MMinnesota,69,160.5,-110,MIN,Minnesota Lynx,-3,-105,1022300043,34,36,0,0,1,1,1,0,0,69,71,2,70,2,away,home,34,2,140
6/9/2023,661,PPhoenix,77,168,-115,PHO,Phoenix Mercury,4.5,120,1022300042,45,42,1,1,1,1,1,1,0,90,77,-13,87,-3,home,away,42,3,167
6/9/2023,662,DDallas,90,168,-105,DAL,Dallas Wings,-5.5,-115,1022300042,45,42,0,0,0,0,0,0,1,90,77,-13,87,-3,home,home,45,-3,167
6/9/2023,665,CChicago,62,158.5,-110,CHI,Chicago Sky,3.5,-109,1022300044,37,33,0,0,0,0,0,0,0,77,62,-15,70,-4,home,away,33,4,139
6/9/2023,666,LALos Angeles,77,158.5,-110,LAS,Los Angeles Sparks,-3.5,-111,1022300044,37,33,1,1,1,1,1,1,1,77,62,-15,70,-4,home,home,37,-4,139
6/9/2023,663,WWashington,73,156,-110,WAS,Washington Mystics,-12.5,-106,1022300045,32,46,1,1,1,1,1,1,1,66,73,7,78,14,away,away,46,-14,139
6/9/2023,664,SSeattle,66,156,-110,SEA,Seattle Storm,12.5,-114,1022300045,32,46,0,0,0,0,0,0,0,66,73,7,78,14,away,home,32,14,139
6/15/2023,621,AAtlanta,92,164,-110,ATL,Atlanta Dream,9,-110,1022300056,50,40,1,1,0,0,0,0,0,88,92,4,90,-10,home,away,40,10,180
6/15/2023,622,CConnecticut,88,164,-110,CON,Connecticut Sun,-9,-110,1022300056,50,40,0,0,1,1,1,1,1,88,92,4,90,-10,home,home,50,-10,180
6/15/2023,623,IIndiana,92,157,-110,IND,Indiana Fever,-1.5,-112,1022300057,37,38,0,0,0,0,0,0,0,90,92,2,75,1,away,away,38,-1,182
6/15/2023,624,CChicago,90,157,-110,CHI,Chicago Sky,1.5,-108,1022300057,37,38,1,1,1,1,1,1,1,90,92,2,75,1,away,home,37,1,182
6/15/2023,625,SSeattle,63,168,-105,SEA,Seattle Storm,18.5,-115,1022300058,47,37,1,0,0,0,0,1,0,96,63,-33,84,-10,home,away,37,10,159
6/15/2023,626,LVLas Vegas,96,168,-110,LVA,Las Vegas Aces,-18.5,-105,1022300058,47,37,0,1,1,1,1,0,1,96,63,-33,84,-10,home,home,47,-10,159
6/16/2023,627,PPhoenix,69,156,-105,PHO,Phoenix Mercury,12,-110,1022300059,54,38,0,0,0,0,0,0,0,88,69,-19,92,-16,home,away,38,16,157
6/16/2023,628,WWashington,88,156,-115,WAS,Washington Mystics,-12,105,1022300059,54,38,1,1,1,1,1,1,1,88,69,-19,92,-16,home,home,54,-16,157
6/16/2023,629,MMinnesota,77,160,-115,MIN,Minnesota Lynx,5.5,103,1022300060,43,34,0,0,1,0,0,0,0,72,77,5,77,-9,home,away,34,9,149
6/16/2023,630,LALos Angeles,72,160.5,-110,LAS,Los Angeles Sparks,-5.5,-123,1022300060,43,34,1,1,0,1,1,1,1,72,77,5,77,-9,home,home,43,-9,149
6/17/2023,631,SSeattle,109,165,-110,SEA,Seattle Storm,8.5,-105,1022300061,47,55,1,1,1,1,1,1,1,103,109,6,102,8,away,away,55,-8,212
6/17/2023,632,DDallas,103,165,-110,DAL,Dallas Wings,-8.5,-115,1022300061,47,55,0,0,0,0,0,0,0,103,109,6,102,8,away,home,47,8,212
6/20/2023,643,AAtlanta,73,173.5,-110,ATL,Atlanta Dream,4,-110,1022300067,43,32,0,0,0,0,0,0,0,85,73,-12,75,-11,home,away,32,11,158
6/20/2023,644,DDallas,85,173.5,-110,DAL,Dallas Wings,-4,-110,1022300067,43,32,1,1,1,1,1,1,1,85,73,-12,75,-11,home,home,43,-11,158
6/20/2023,647,MMinnesota,67,157.5,-110,MIN,Minnesota Lynx,6.5,-110,1022300068,33,32,0,0,0,1,0,1,1,61,67,6,65,-1,home,away,32,1,128
6/20/2023,648,LALos Angeles,61,157.5,-103,LAS,Los Angeles Sparks,-6.5,-110,1022300068,33,32,1,1,1,0,1,0,0,61,67,6,65,-1,home,home,33,-1,128
6/20/2023,645,CConnecticut,85,160.5,-110,CON,Connecticut Sun,-8,-110,1022300069,48,45,1,1,1,0,1,1,0,79,85,6,93,-3,home,away,45,3,164
6/20/2023,646,SSeattle,79,160.5,-110,SEA,Seattle Storm,8,-110,1022300069,48,45,0,0,0,1,0,0,1,79,85,6,93,-3,home,home,48,-3,164
6/21/2023,649,LVLas Vegas,99,164,-110,LVA,Las Vegas Aces,-19.5,-110,1022300070,40,57,1,1,1,1,1,1,1,79,99,20,97,17,away,away,57,-17,178
6/21/2023,650,PPhoenix,79,164,-110,PHO,Phoenix Mercury,19.5,-110,1022300070,40,57,0,0,0,0,0,0,0,79,99,20,97,17,away,home,40,17,178
6/23/2023,601,NYNew York,110,172,-115,NYL,New York Liberty,-7,-108,1022300074,40,59,1,1,1,1,1,1,1,80,110,30,99,19,away,away,59,-19,190
6/23/2023,602,AAtlanta,80,172,-105,ATL,Atlanta Dream,7,-112,1022300074,40,59,0,0,0,0,0,0,0,80,110,30,99,19,away,home,40,19,190
6/23/2023,603,DDallas,74,163.5,-110,DAL,Dallas Wings,-2.5,-117,1022300075,33,42,1,1,1,1,1,1,1,76,74,-2,75,9,away,away,42,-9,150
6/23/2023,604,LALos Angeles,76,163.5,-110,LAS,Los Angeles Sparks,2.5,-103,1022300075,33,42,0,0,0,0,0,0,0,76,74,-2,75,9,away,home,33,9,150
6/24/2023,605,PPhoenix,74,162.5,-112,PHO,Phoenix Mercury,1.5,-110,1022300077,49,34,0,0,0,0,0,0,0,97,74,-23,83,-15,home,away,34,15,171
6/24/2023,606,SSeattle,97,162.5,-108,SEA,Seattle Storm,-1.5,-110,1022300077,49,34,1,1,1,1,1,1,1,97,74,-23,83,-15,home,home,49,-15,171
6/24/2023,607,IIndiana,88,170,-115,IND,Indiana Fever,15.5,-110,1022300076,57,43,0,0,0,0,0,0,0,101,88,-13,100,-14,home,away,43,14,189
6/24/2023,608,LVLas Vegas,101,170,-105,LVA,Las Vegas Aces,-15.5,-110,1022300076,57,43,1,1,1,1,1,1,1,101,88,-13,100,-14,home,home,57,-14,189
6/25/2023,609,CChicago,72,157.5,-102,CHI,Chicago Sky,6,-112,1022300078,54,42,1,1,1,0,0,0,0,96,72,-24,96,-12,home,away,42,12,168
6/25/2023,610,CConnecticut,96,157.5,-118,CON,Connecticut Sun,-6,-110,1022300078,54,42,0,0,0,1,1,1,1,96,72,-24,96,-12,home,home,54,-12,168
6/25/2023,611,WWashington,88,162,-110,WAS,Washington Mystics,7,-110,1022300079,39,45,1,1,1,1,1,1,1,89,88,-1,84,6,away,away,45,-6,177
6/25/2023,612,NYNew York,89,162.5,-110,NYL,New York Liberty,-7,-110,1022300079,39,45,0,0,0,0,0,0,0,89,88,-1,84,6,away,home,39,6,177
6/25/2023,613,DDallas,83,162.5,-110,DAL,Dallas Wings,-2.5,-110,1022300080,44,44,1,1,0,0,0,0,0,93,83,-10,88,0,tie,away,44,-0,176
6/25/2023,614,LALos Angeles,93,162.5,-110,LAS,Los Angeles Sparks,2.5,-110,1022300080,44,44,0,0,1,1,1,1,1,93,83,-10,88,0,tie,home,44,0,176
6/26/2023,615,IIndiana,80,168.5,-110,IND,Indiana Fever,14.5,-105,1022300081,48,49,1,0,1,0,0,0,1,88,80,-8,97,1,away,away,49,-1,168
6/26/2023,616,LVLas Vegas,88,168.5,-110,LVA,Las Vegas Aces,-14.5,-115,1022300081,48,49,0,1,0,1,1,1,0,88,80,-8,97,1,away,home,48,1,168
6/27/2023,617,NYNew York,89,168,-110,NYL,New York Liberty,-5,-108,1022300082,43,47,1,0,1,0,1,1,0,81,89,8,90,4,away,away,47,-4,170
6/27/2023,618,CConnecticut,81,168,-110,CON,Connecticut Sun,5,-112,1022300082,43,47,0,1,0,1,0,0,1,81,89,8,90,4,away,home,43,4,170
6/27/2023,619,SSeattle,93,161,-110,SEA,Seattle Storm,3.5,-110,1022300083,53,47,0,0,0,0,0,0,0,104,93,-11,100,-6,home,away,47,6,197
6/27/2023,620,MMinnesota,104,161,-110,MIN,Minnesota Lynx,-3.5,-110,1022300083,53,47,1,1,1,1,1,1,1,104,93,-11,100,-6,home,home,53,-6,197
6/27/2023,621,DDallas,77,168,-110,DAL,Dallas Wings,-4,-110,1022300084,32,36,1,1,1,1,1,1,1,62,77,15,68,4,away,away,36,-4,139
6/27/2023,622,PPhoenix,62,168.5,-110,PHO,Phoenix Mercury,4,-110,1022300084,32,36,0,0,0,0,0,0,0,62,77,15,68,4,away,home,32,4,139
6/28/2023,623,LALos Angeles,63,155.5,-115,LAS,Los Angeles Sparks,2.5,-110,1022300085,46,37,1,1,1,0,0,0,0,80,63,-17,83,-9,home,away,37,9,143
6/28/2023,624,CChicago,80,156.5,-110,CHI,Chicago Sky,-2.5,-110,1022300085,46,37,0,0,0,1,1,1,1,80,63,-17,83,-9,home,home,46,-9,143
6/28/2023,625,AAtlanta,86,163,-108,ATL,Atlanta Dream,5,-110,1022300086,61,33,1,0,0,0,0,0,0,109,86,-23,94,-28,home,away,33,28,195
6/28/2023,626,WWashington,109,163,-112,WAS,Washington Mystics,-5,-110,1022300086,61,33,0,1,1,1,1,1,1,109,86,-23,94,-28,home,home,61,-28,195
6/29/2023,627,MMinnesota,99,162,-105,MIN,Minnesota Lynx,2.5,-107,1022300089,46,48,1,1,1,1,1,1,1,97,99,2,94,2,away,away,48,-2,196
6/29/2023,628,SSeattle,97,162,-115,SEA,Seattle Storm,-3,-110,1022300089,46,48,0,0,0,0,0,0,0,97,99,2,94,2,away,home,46,2,196
6/29/2023,629,IIndiana,63,163,-110,IND,Indiana Fever,-3,105,1022300088,52,35,0,0,0,0,0,0,0,85,63,-22,87,-17,home,away,35,17,148
6/29/2023,630,PPhoenix,85,163,-110,PHO,Phoenix Mercury,3,-125,1022300088,52,35,1,1,1,1,1,1,1,85,63,-22,87,-17,home,home,52,-17,148
6/29/2023,631,NYNew York,81,175.5,-105,NYL,New York Liberty,6.5,-110,1022300087,49,42,0,0,0,0,0,0,0,98,81,-17,91,-7,home,away,42,7,179
6/29/2023,632,LVLas Vegas,98,175.5,-115,LVA,Las Vegas Aces,-6.5,-110,1022300087,49,42,1,1,1,1,1,1,1,98,81,-17,91,-7,home,home,49,-7,179
6/30/2023,633,WWashington,89,163.5,-110,WAS,Washington Mystics,-1.5,-110,1022300090,47,48,0,0,0,0,0,0,0,94,89,-5,95,1,away,away,48,-1,183
6/30/2023,634,AAtlanta,94,163.5,-110,ATL,Atlanta Dream,2.5,-125,1022300090,47,48,1,1,1,1,1,1,1,94,89,-5,95,1,away,home,47,1,183
6/30/2023,635,LALos Angeles,78,155.5,-110,LAS,Los Angeles Sparks,2,-110,1022300091,43,38,1,0,0,0,1,1,0,86,78,-8,81,-5,home,away,38,5,164
6/30/2023,636,CChicago,86,155.5,-110,CHI,Chicago Sky,-2,-110,1022300091,43,38,0,1,1,1,0,0,1,86,78,-8,81,-5,home,home,43,-5,164
7/1/2023,637,CConnecticut,84,171,-110,CON,Connecticut Sun,11,-105,1022300092,59,48,0,0,0,0,0,0,0,102,84,-18,107,-11,home,away,48,11,186
7/1/2023,638,LVLas Vegas,102,169.5,-110,LVA,Las Vegas Aces,-11,-115,1022300092,59,48,1,1,1,1,1,1,1,102,84,-18,107,-11,home,home,59,-11,186
7/1/2023,639,MMinnesota,86,158,-135,MIN,Minnesota Lynx,1.5,-115,1022300093,37,46,0,0,0,1,1,1,1,76,86,10,83,9,away,away,46,-9,162
7/1/2023,640,PPhoenix,76,158,115,PHO,Phoenix Mercury,-1.5,-105,1022300093,37,46,1,1,1,0,0,0,0,76,86,10,83,9,away,home,37,9,162
7/2/2023,643,WWashington,72,161.5,-115,WAS,Washington Mystics,6,-102,1022300096,37,33,1,1,1,0,0,0,0,89,72,-17,70,-4,home,away,33,4,161
7/2/2023,644,DDallas,89,161.5,-105,DAL,Dallas Wings,-6,-115,1022300096,37,33,0,0,0,1,1,1,1,89,72,-17,70,-4,home,home,37,-4,161
7/2/2023,641,LALos Angeles,84,165.5,-113,LAS,Los Angeles Sparks,5,-108,1022300094,54,48,0,1,0,0,0,1,1,112,84,-28,102,-6,home,away,48,6,196
7/2/2023,642,AAtlanta,112,165.5,-107,ATL,Atlanta Dream,-5,-112,1022300094,54,48,1,0,1,1,1,0,0,112,84,-28,102,-6,home,home,54,-6,196
7/2/2023,645,CChicago,89,159.5,-110,CHI,Chicago Sky,3,-110,1022300095,47,54,0,0,1,1,1,1,1,87,89,2,101,7,away,away,54,-7,176
7/2/2023,646,IIndiana,87,159.5,-110,IND,Indiana Fever,-3,-110,1022300095,47,54,1,1,0,0,0,0,0,87,89,2,101,7,away,home,47,7,176
7/2/2023,647,NYNew York,81,170.5,-110,NYL,New York Liberty,-10.5,-110,1022300097,27,44,1,1,1,1,1,1,1,66,81,15,71,17,away,away,44,-17,147
7/2/2023,648,SSeattle,66,170.5,-110,SEA,Seattle Storm,10.5,-110,1022300097,27,44,0,0,0,0,0,0,0,66,81,15,71,17,away,home,27,17,147
7/5/2023,649,PPhoenix,95,167,-110,PHO,Phoenix Mercury,15,-115,1022300098,53,46,0,0,0,0,0,0,0,99,95,-4,99,-7,home,away,46,7,194
7/5/2023,650,NYNew York,99,167,-110,NYL,New York Liberty,-15,-110,1022300098,53,46,1,1,1,1,1,1,1,99,95,-4,99,-7,home,home,53,-7,194
7/5/2023,651,IIndiana,83,165.5,-110,IND,Indiana Fever,2,-110,1022300099,47,42,1,0,0,0,0,0,0,90,83,-7,89,-5,home,away,42,5,173
7/5/2023,652,MMinnesota,90,166,-110,MIN,Minnesota Lynx,-2,-110,1022300099,47,42,0,1,1,1,1,1,1,90,83,-7,89,-5,home,home,47,-5,173
7/5/2023,653,DDallas,82,173,106,DAL,Dallas Wings,11.5,-105,1022300100,42,51,1,1,1,1,1,1,1,89,82,-7,93,9,away,away,51,-9,171
7/5/2023,654,LVLas Vegas,89,173,-126,LVA,Las Vegas Aces,-11.5,-115,1022300100,42,51,0,0,0,0,0,0,0,89,82,-7,93,9,away,home,42,9,171
7/5/2023,655,AAtlanta,90,168.5,-110,ATL,Atlanta Dream,1.5,-110,1022300101,40,53,1,1,1,1,1,1,1,79,90,11,93,13,away,away,53,-13,169
7/5/2023,656,LALos Angeles,79,168.5,-110,LAS,Los Angeles Sparks,-1.5,-110,1022300101,40,53,0,0,0,0,0,0,0,79,90,11,93,13,away,home,40,13,169
7/6/2023,601,SSeattle,73,166,-110,SEA,Seattle Storm,10,-110,1022300102,57,24,0,0,0,0,0,0,0,93,73,-20,81,-33,home,away,24,33,166
7/6/2023,602,CConnecticut,93,166,-110,CON,Connecticut Sun,-10,-110,1022300102,57,24,1,1,1,1,1,1,1,93,73,-20,81,-33,home,home,57,-33,166
7/7/2023,603,IIndiana,88,155.5,-110,IND,Indiana Fever,-0.5,-120,1022300103,55,40,0,0,0,0,0,0,0,96,88,-8,95,-15,home,away,40,15,184
7/7/2023,604,WWashington,96,155,-105,WAS,Washington Mystics,-0.5,100,1022300103,55,40,1,1,1,1,1,1,1,96,88,-8,95,-15,home,home,55,-15,184
7/7/2023,607,AAtlanta,82,168.5,-110,ATL,Atlanta Dream,1,-108,1022300104,41,42,1,1,1,1,1,1,1,68,82,14,83,1,away,away,42,-1,150
7/7/2023,608,CChicago,68,168.5,-110,CHI,Chicago Sky,-1,-110,1022300104,41,42,0,0,0,0,0,0,0,68,82,14,83,1,away,home,41,1,150
7/7/2023,609,PPhoenix,64,160.5,-110,PHO,Phoenix Mercury,5.5,-110,1022300106,39,22,0,0,0,0,0,0,0,75,64,-11,61,-17,home,away,22,17,139
7/7/2023,610,MMinnesota,75,160.5,-110,MIN,Minnesota Lynx,-5.5,-110,1022300106,39,22,1,1,1,1,1,1,1,75,64,-11,61,-17,home,home,39,-17,139
7/7/2023,605,LVLas Vegas,78,177.5,-110,LVA,Las Vegas Aces,-10,-105,1022300105,39,40,0,0,0,1,0,1,1,80,78,-2,79,1,away,away,40,-1,158
7/7/2023,606,DDallas,80,177.5,-110,DAL,Dallas Wings,10,-115,1022300105,39,40,1,1,1,0,1,0,0,80,78,-2,79,1,away,home,39,1,158
7/8/2023,611,SSeattle,76,169.5,-110,SEA,Seattle Storm,15.5,-110,1022300107,35,36,0,0,0,0,0,1,1,80,76,-4,71,1,away,away,36,-1,156
7/8/2023,612,NYNew York,80,169.5,-110,NYL,New York Liberty,-15.5,-110,1022300107,35,36,1,1,1,1,1,0,0,80,76,-4,71,1,away,home,35,1,156
7/9/2023,613,WWashington,84,161.5,-110,WAS,Washington Mystics,4.5,-110,1022300108,46,41,0,0,0,1,1,1,0,92,84,-8,87,-5,home,away,41,5,176
7/9/2023,614,CConnecticut,92,161.5,-110,CON,Connecticut Sun,-4.5,-110,1022300108,46,41,1,1,1,0,0,0,1,92,84,-8,87,-5,home,home,46,-5,176
7/9/2023,615,DDallas,77,168.5,-110,DAL,Dallas Wings,-3.5,-110,1022300109,38,38,0,1,1,1,1,1,1,76,77,1,76,0,tie,away,38,-0,153
7/9/2023,616,IIndiana,76,168.5,-110,IND,Indiana Fever,3.5,-110,1022300109,38,38,1,0,0,0,0,0,0,76,77,1,76,0,tie,home,38,0,153
7/9/2023,617,LALos Angeles,72,159,-110,LAS,Los Angeles Sparks,2,-110,1022300110,42,36,1,0,0,0,0,1,0,78,72,-6,78,-6,home,away,36,6,150
7/9/2023,618,PPhoenix,78,159,-110,PHO,Phoenix Mercury,-2,-110,1022300110,42,36,0,1,1,1,1,0,1,78,72,-6,78,-6,home,home,42,-6,150
7/9/2023,619,LVLas Vegas,113,171,-103,LVA,Las Vegas Aces,-11.5,-113,1022300111,42,54,1,1,1,1,1,1,1,89,113,24,96,12,away,away,54,-12,202
7/9/2023,620,MMinnesota,89,171,-117,MIN,Minnesota Lynx,11.5,-107,1022300111,42,54,0,0,0,0,0,0,0,89,113,24,96,12,away,home,42,12,202
7/9/2023,621,AAtlanta,88,166.5,-110,ATL,Atlanta Dream,2,-104,1022300112,33,42,1,0,1,1,1,1,1,77,88,11,75,9,away,away,42,-9,165
7/9/2023,622,CChicago,77,166.5,-116,CHI,Chicago Sky,-2,-116,1022300112,33,42,0,1,0,0,0,0,0,77,88,11,75,9,away,home,33,9,165
7/11/2023,623,SSeattle,86,159,-110,SEA,Seattle Storm,5,-124,1022300113,47,39,1,1,1,0,0,0,0,93,86,-7,86,-8,home,away,39,8,179
7/11/2023,624,WWashington,93,159,-110,WAS,Washington Mystics,-5,-105,1022300113,47,39,0,0,0,1,1,1,1,93,86,-7,86,-8,home,home,47,-8,179
7/11/2023,625,PPhoenix,72,170,-110,PHO,Phoenix Mercury,17,-114,1022300114,52,34,0,1,0,0,0,0,0,98,72,-26,86,-18,home,away,34,18,170
7/11/2023,626,LVLas Vegas,98,170,-110,LVA,Las Vegas Aces,-17,-106,1022300114,52,34,1,0,1,1,1,1,1,98,72,-26,86,-18,home,home,52,-18,170
7/12/2023,627,NYNew York,95,169.5,-110,NYL,New York Liberty,-10,-107,1022300115,41,48,0,0,0,0,0,1,1,87,95,8,89,7,away,away,48,-7,182
7/12/2023,628,IIndiana,87,169.5,-110,IND,Indiana Fever,10,-113,1022300115,41,48,1,1,1,1,1,0,0,87,95,8,89,7,away,home,41,7,182
7/12/2023,629,CConnecticut,84,160.5,-115,CON,Connecticut Sun,-5.5,-110,1022300116,38,36,1,1,1,1,1,0,0,72,84,12,74,-2,home,away,36,2,156
7/12/2023,630,CChicago,72,160.5,-105,CHI,Chicago Sky,5.5,-110,1022300116,38,36,0,0,0,0,0,1,1,72,84,12,74,-2,home,home,38,-2,156
7/12/2023,631,DDallas,107,168,-110,DAL,Dallas Wings,-2.5,-110,1022300117,34,50,1,1,1,1,1,1,1,67,107,40,84,16,away,away,50,-16,174
7/12/2023,632,MMinnesota,67,168,-110,MIN,Minnesota Lynx,2.5,-110,1022300117,34,50,0,0,0,0,0,0,0,67,107,40,84,16,away,home,34,16,174
7/12/2023,633,SSeattle,75,167,-112,SEA,Seattle Storm,14,-108,1022300118,48,33,0,0,0,0,0,0,0,85,75,-10,81,-15,home,away,33,15,160
7/12/2023,634,AAtlanta,85,167,-108,ATL,Atlanta Dream,-14,-110,1022300118,48,33,1,1,1,1,1,1,1,85,75,-10,81,-15,home,home,48,-15,160
7/12/2023,635,LVLas Vegas,97,169.5,-110,LVA,Las Vegas Aces,-13,-110,1022300119,31,54,1,1,1,1,1,1,1,78,97,19,85,23,away,away,54,-23,175
7/12/2023,636,LALos Angeles,78,169.5,-110,LAS,Los Angeles Sparks,13,-110,1022300119,31,54,0,0,0,0,0,0,0,78,97,19,85,23,away,home,31,23,175
7/19/2023,651,IIndiana,82,158,-112,IND,Indiana Fever,2.5,-110,1022300122,36,39,0,1,1,1,1,0,1,76,82,6,75,3,away,away,39,-3,158
7/19/2023,652,WWashington,76,158,-108,WAS,Washington Mystics,-2.5,-110,1022300122,36,39,1,0,0,0,0,1,0,76,82,6,75,3,away,home,36,3,158
7/19/2023,653,DDallas,98,167.5,-110,DAL,Dallas Wings,7,-110,1022300123,51,49,1,1,1,1,1,1,1,88,98,10,100,-2,home,away,49,2,186
7/19/2023,654,NYNew York,88,167.5,-110,NYL,New York Liberty,-7.5,-110,1022300123,51,49,0,0,0,0,0,0,0,88,98,10,100,-2,home,home,51,-2,186
7/20/2023,655,AAtlanta,71,169.5,-110,ATL,Atlanta Dream,5.5,-115,1022300124,38,41,0,0,1,1,1,0,1,82,71,-11,79,3,away,away,41,-3,153
7/20/2023,656,CConnecticut,82,169.5,-110,CON,Connecticut Sun,-5.5,-105,1022300124,38,41,1,1,0,0,0,1,0,82,71,-11,79,3,away,home,38,3,153
7/20/2023,657,LALos Angeles,70,165,-110,LAS,Los Angeles Sparks,3,105,1022300125,46,29,1,1,0,0,0,0,0,73,70,-3,75,-17,home,away,29,17,143
7/20/2023,658,MMinnesota,73,165,-110,MIN,Minnesota Lynx,-3,-125,1022300125,46,29,0,0,1,1,1,1,1,73,70,-3,75,-17,home,home,46,-17,143
7/20/2023,659,CChicago,62,155,-110,CHI,Chicago Sky,-2,-107,1022300126,40,30,0,0,0,0,0,0,0,80,62,-18,70,-10,home,away,30,10,142
7/20/2023,660,PPhoenix,80,155,-110,PHO,Phoenix Mercury,2,-113,1022300126,40,30,1,1,1,1,1,1,1,80,62,-18,70,-10,home,home,40,-10,142
7/20/2023,661,LVLas Vegas,79,170.5,-110,LVA,Las Vegas Aces,-16.5,-110,1022300127,28,39,0,1,1,1,1,1,1,63,79,16,67,11,away,away,39,-11,142
7/20/2023,662,SSeattle,63,170.5,-110,SEA,Seattle Storm,16.5,-109,1022300127,28,39,1,0,0,0,0,0,0,63,79,16,67,11,away,home,28,11,142
7/22/2023,601,CConnecticut,86,167.5,-110,CON,Connecticut Sun,1,-106,1022300129,38,45,1,1,1,1,1,1,1,78,86,8,83,7,away,away,45,-7,164
7/22/2023,602,AAtlanta,78,167.5,-110,ATL,Atlanta Dream,-1,-114,1022300129,38,45,0,0,0,0,0,0,0,78,86,8,83,7,away,home,38,7,164
7/22/2023,603,LVLas Vegas,98,171,-110,LVA,Las Vegas Aces,-14.5,-105,1022300132,30,48,1,1,1,1,1,1,1,81,98,17,78,18,away,away,48,-18,179
7/22/2023,604,MMinnesota,81,171,-110,MIN,Minnesota Lynx,14.5,-115,1022300132,30,48,0,0,0,0,0,0,0,81,98,17,78,18,away,home,30,18,179
7/22/2023,605,LALos Angeles,84,164.5,-110,LAS,Los Angeles Sparks,8,-110,1022300131,52,48,0,0,0,1,1,0,0,98,84,-14,100,-4,home,away,48,4,182
7/22/2023,606,DDallas,98,164.5,-110,DAL,Dallas Wings,-8,-110,1022300131,52,48,1,1,1,0,0,1,1,98,84,-14,100,-4,home,home,52,-4,182
7/22/2023,607,CChicago,90,159,-110,CHI,Chicago Sky,1.5,-110,1022300130,32,49,1,1,1,1,1,1,1,75,90,15,81,17,away,away,49,-17,165
7/22/2023,608,SSeattle,75,159,-110,SEA,Seattle Storm,-1.5,-110,1022300130,32,49,0,0,0,0,0,0,0,75,90,15,81,17,away,home,32,17,165
