game_date,game_id.x,team,team_score,closing_total_line,closing_total_price,team_abbr,team_name,closing_spread_line,closing_spread_price,game_id.y,home_half_score,away_half_score,total_1h,home_spread_1h,result_1h,race_to_10,race_to_15,race_to_20,race_to_25,race_to_30,race_to_35,race_to_40,home_away,team_half_score,team_spread
5/19/2018,303,CSChicago Sky,82,153,-110,CHI,Chicago Sky,2,-110,1021800002,34,36,70,2,away,0,0,1,1,1,1,1,away,36,-2
5/19/2018,304,IFIndiana Fever,64,153,-110,IND,Indiana Fever,-2,-110,1021800002,34,36,70,2,away,1,1,0,0,0,0,0,home,34,2
6/8/2018,305,ADAtlanta Dream,87,162.5,-110,ATL,Atlanta Dream,-4.5,-108,1021800044,32,38,70,6,away,1,0,1,1,1,1,1,away,38,-6
6/8/2018,306,LVLas Vegas Aces,83,162.5,-110,LVA,Las Vegas Aces,4.5,-112,1021800044,32,38,70,6,away,0,1,0,0,0,0,0,home,32,6
6/8/2018,301,DWDallas Wings,89,167,-110,DAL,Dallas Wings,-7,-110,1021800042,48,44,92,-4,home,1,1,0,1,0,0,0,away,44,4
6/8/2018,302,IFIndiana Fever,83,167.5,-110,IND,Indiana Fever,7,-110,1021800042,48,44,92,-4,home,0,0,1,0,1,1,1,home,48,-4
6/8/2018,303,CSChicago Sky,79,168,-110,CHI,Chicago Sky,9,-110,1021800043,49,35,84,-14,home,0,0,0,0,0,0,0,away,35,14
6/8/2018,304,PPhoenix,96,168.5,-119,PHO,Phoenix Mercury,-9.5,103,1021800043,49,35,84,-14,home,1,1,1,1,1,1,1,home,49,-14
6/10/2018,309,IFIndiana Fever,75,157,-110,IND,Indiana Fever,10,-105,1021800046,38,36,74,-2,home,0,1,0,0,0,0,0,away,36,2
6/10/2018,310,NYNew York Liberty,78,157,-110,NYL,New York Liberty,-10,-115,1021800046,38,36,74,-2,home,1,0,1,1,1,1,1,home,38,-2
6/10/2018,311,CSChicago Sky,59,166.5,-115,CHI,Chicago Sky,14,-110,1021800047,38,31,69,-7,home,0,0,0,0,0,0,0,away,31,7
6/10/2018,312,LSL.A. Sparks,77,166.5,-105,LAS,Los Angeles Sparks,-14,-110,1021800047,38,31,69,-7,home,1,1,1,1,1,1,1,home,38,-7
6/10/2018,313,LVLas Vegas Aces,66,167.5,-110,LVA,Las Vegas Aces,12,-110,1021800048,50,37,87,-13,home,0,0,0,0,0,0,0,away,37,13
6/10/2018,314,PPhoenix,72,167.5,-110,PHO,Phoenix Mercury,-12,-110,1021800048,50,37,87,-13,home,1,1,1,1,1,1,1,home,50,-13
6/10/2018,315,ADAtlanta Dream,67,166.5,-115,ATL,Atlanta Dream,7.5,-110,1021800049,31,39,70,8,away,1,1,1,1,1,1,1,away,39,-8
6/10/2018,316,SSSeattle Storm,64,166.5,-110,SEA,Seattle Storm,-7.5,-110,1021800049,31,39,70,8,away,0,0,0,0,0,0,0,home,31,8
6/27/2018,319,ADAtlanta Dream,80,157.5,-110,ATL,Atlanta Dream,2,-105,1021800085,32,38,70,6,away,1,1,1,1,1,1,1,away,38,-6
6/27/2018,320,CSChicago Sky,93,157.5,-110,CHI,Chicago Sky,-2,-115,1021800085,32,38,70,6,away,0,0,0,0,0,0,0,home,32,6
6/27/2018,321,IFIndiana Fever,89,166,-110,IND,Indiana Fever,11,-110,1021800086,52,36,88,-16,home,0,0,0,0,0,0,0,away,36,16
6/27/2018,322,CSConnecticut Sun,101,166,-110,CON,Connecticut Sun,-11,-110,1021800086,52,36,88,-16,home,1,1,1,1,1,1,1,home,52,-16
6/27/2018,323,DWDallas Wings,97,167.5,-110,DAL,Dallas Wings,-2,103,1021800087,52,55,107,3,away,0,0,0,1,0,1,1,away,55,-3
6/27/2018,324,LVLas Vegas Aces,91,167.5,-110,LVA,Las Vegas Aces,2,-123,1021800087,52,55,107,3,away,1,1,1,0,1,0,0,home,52,3
6/30/2018,613,PPhoenix,84,167.5,-110,PHO,Phoenix Mercury,NA,NA,1021800094,35,39,74,4,away,0,1,1,1,1,0,1,away,39,-4
6/30/2018,614,WMWashington Mystics,74,167.5,-110,WAS,Washington Mystics,NA,NA,1021800094,35,39,74,4,away,1,0,0,0,0,1,0,home,35,4
7/5/2018,601,NYNew York Liberty,67,160,-130,NYL,New York Liberty,8.5,-110,1021800104,42,41,83,-1,home,0,0,0,0,1,1,0,away,41,1
7/5/2018,602,WMWashington Mystics,86,160,110,WAS,Washington Mystics,-8.5,-110,1021800104,42,41,83,-1,home,1,1,1,1,0,0,1,home,42,-1
7/5/2018,605,IFIndiana Fever,63,167,-110,IND,Indiana Fever,10,-110,1021800105,44,32,76,-12,home,0,0,0,0,0,0,0,away,32,12
7/5/2018,606,DWDallas Wings,90,167,-110,DAL,Dallas Wings,-10,-110,1021800105,44,32,76,-12,home,1,1,1,1,1,1,1,home,44,-12
7/5/2018,603,LSL.A. Sparks,72,153.5,-110,LAS,Los Angeles Sparks,3.5,-110,1021800106,38,35,73,-3,home,0,0,0,0,0,0,0,away,35,3
7/5/2018,604,MLMinnesota Lynx,83,153.5,-110,MIN,Minnesota Lynx,-3.5,-110,1021800106,38,35,73,-3,home,1,1,1,1,1,1,1,home,38,-3
7/5/2018,609,CSChicago Sky,80,175.5,-110,CHI,Chicago Sky,4.5,-115,1021800107,51,53,104,2,away,0,0,1,1,1,0,0,away,53,-2
7/5/2018,610,LVLas Vegas Aces,84,175.5,-110,LVA,Las Vegas Aces,-4.5,-105,1021800107,51,53,104,2,away,1,1,0,0,0,1,1,home,51,2
7/5/2018,607,CSConnecticut Sun,77,170,-110,CON,Connecticut Sun,6.5,-110,1021800108,50,41,91,-9,home,0,0,0,0,0,0,0,away,41,9
7/5/2018,608,PPhoenix,84,170,-110,PHO,Phoenix Mercury,-6.5,-110,1021800108,50,41,91,-9,home,1,1,1,1,1,1,1,home,50,-9
7/11/2018,323,ADAtlanta Dream,106,164.5,-110,ATL,Atlanta Dream,7.5,-110,1021800120,50,59,109,9,away,0,0,0,0,0,1,1,away,59,-9
7/11/2018,324,WMWashington Mystics,89,164.5,-110,WAS,Washington Mystics,-7.5,-110,1021800120,50,59,109,9,away,1,1,1,1,1,0,0,home,50,9
7/11/2018,321,NYNew York Liberty,79,164,-125,NYL,New York Liberty,9,-110,1021800119,42,38,80,-4,home,0,0,0,0,0,0,0,away,38,4
7/11/2018,322,CSConnecticut Sun,76,164,105,CON,Connecticut Sun,-9,-110,1021800119,42,38,80,-4,home,1,1,1,1,1,1,1,home,42,-4
7/11/2018,325,MLMinnesota Lynx,87,155.5,-110,MIN,Minnesota Lynx,-9.5,-110,1021800121,33,44,77,11,away,1,1,1,1,1,1,1,away,44,-11
7/11/2018,326,IFIndiana Fever,65,155.5,-110,IND,Indiana Fever,9.5,-110,1021800121,33,44,77,11,away,0,0,0,0,0,0,0,home,33,11
7/13/2018,603,IFIndiana Fever,74,158.5,-115,IND,Indiana Fever,10,-110,1021800123,48,29,77,-19,home,1,1,1,1,0,0,0,away,29,19
7/13/2018,604,ADAtlanta Dream,98,158.5,-105,ATL,Atlanta Dream,-10,-110,1021800123,48,29,77,-19,home,0,0,0,0,1,1,1,home,48,-19
7/13/2018,605,PPhoenix,87,169,-110,PHO,Phoenix Mercury,5,-110,1021800124,43,45,88,2,away,0,0,0,0,0,0,0,away,45,-2
7/13/2018,606,CSConnecticut Sun,91,169,-110,CON,Connecticut Sun,-5,-110,1021800124,43,45,88,2,away,1,1,1,1,1,1,1,home,43,2
7/13/2018,607,CSChicago Sky,72,175,-110,CHI,Chicago Sky,10,-110,1021800125,45,33,78,-12,home,0,0,1,1,0,0,0,away,33,12
7/13/2018,608,WMWashington Mystics,88,175,-110,WAS,Washington Mystics,-10,-110,1021800125,45,33,78,-12,home,1,1,0,0,1,1,1,home,45,-12
7/13/2018,609,LVLas Vegas Aces,85,163.5,-115,LVA,Las Vegas Aces,8.5,-110,1021800126,46,49,95,3,away,0,0,0,1,1,0,0,away,49,-3
7/13/2018,610,MLMinnesota Lynx,77,163.5,-105,MIN,Minnesota Lynx,-8.5,-110,1021800126,46,49,95,3,away,1,1,1,0,0,1,1,home,46,3
7/14/2018,611,DWDallas Wings,84,175,-110,DAL,Dallas Wings,4.5,-110,1021800127,46,44,90,-2,home,0,0,1,1,0,0,0,away,44,2
7/14/2018,612,SSSeattle Storm,91,175,-110,SEA,Seattle Storm,-4.5,-110,1021800127,46,44,90,-2,home,1,1,0,0,1,1,1,home,46,-2
7/15/2018,615,WMWashington Mystics,77,166.5,-115,WAS,Washington Mystics,-3,-110,1021800128,37,36,73,-1,home,1,1,1,1,1,0,0,away,36,1
7/15/2018,616,ADAtlanta Dream,80,166.5,-110,ATL,Atlanta Dream,3,-110,1021800128,37,36,73,-1,home,0,0,0,0,0,1,1,home,37,-1
7/15/2018,613,CSChicago Sky,84,164,-110,CHI,Chicago Sky,4.5,-105,1021800129,53,47,100,-6,home,0,0,0,0,1,0,0,away,47,6
7/15/2018,614,NYNew York Liberty,107,164,-110,NYL,New York Liberty,-4.5,-115,1021800129,53,47,100,-6,home,1,1,1,1,0,1,1,home,53,-6
7/15/2018,617,PPhoenix,101,162.5,-110,PHO,Phoenix Mercury,-9.5,-110,1021800130,48,46,94,-2,home,1,1,1,1,1,1,1,away,46,2
7/15/2018,618,IFIndiana Fever,82,162.5,-110,IND,Indiana Fever,9.5,-110,1021800130,48,46,94,-2,home,0,0,0,0,0,0,0,home,48,-2
7/15/2018,619,LSL.A. Sparks,99,161.5,-110,LAS,Los Angeles Sparks,-5,-115,1021800131,47,48,95,1,away,0,1,1,1,0,1,1,away,48,-1
7/15/2018,620,LVLas Vegas Aces,78,161.5,-110,LVA,Las Vegas Aces,5,-110,1021800131,47,48,95,1,away,1,0,0,0,1,0,0,home,47,1
7/15/2018,621,CSConnecticut Sun,83,164,-110,CON,Connecticut Sun,3,-110,1021800132,33,44,77,11,away,0,1,1,1,1,1,1,away,44,-11
7/15/2018,622,MLMinnesota Lynx,64,164,-110,MIN,Minnesota Lynx,-3,-105,1021800132,33,44,77,11,away,1,0,0,0,0,0,0,home,33,11
7/17/2018,301,NYNew York Liberty,87,171.5,-110,NYL,New York Liberty,7.5,-110,1021800133,57,44,101,-13,home,0,0,0,0,0,0,0,away,44,13
7/17/2018,302,DWDallas Wings,104,171.5,-110,DAL,Dallas Wings,-8,-103,1021800133,57,44,101,-13,home,1,1,1,1,1,1,1,home,57,-13
7/17/2018,303,ADAtlanta Dream,86,170.5,-108,ATL,Atlanta Dream,7,-110,1021800134,42,35,77,-7,home,0,0,0,0,0,0,0,away,35,7
7/17/2018,304,CSConnecticut Sun,83,170.5,-112,CON,Connecticut Sun,-7,-110,1021800134,42,35,77,-7,home,1,1,1,1,1,1,1,home,42,-7
7/18/2018,305,SSSeattle Storm,101,178.5,-110,SEA,Seattle Storm,-8.5,-110,1021800135,37,54,91,17,away,1,0,1,1,1,1,1,away,54,-17
7/18/2018,306,CSChicago Sky,83,178.5,-110,CHI,Chicago Sky,8.5,-110,1021800135,37,54,91,17,away,0,1,0,0,0,0,0,home,37,17
7/18/2018,307,IFIndiana Fever,65,155.5,-110,IND,Indiana Fever,15,-110,1021800136,51,36,87,-15,home,0,0,0,0,0,0,0,away,36,15
7/18/2018,308,MLMinnesota Lynx,89,155.5,-110,MIN,Minnesota Lynx,-15,-110,1021800136,51,36,87,-15,home,1,1,1,1,1,1,1,home,51,-15
7/19/2018,309,NYNew York Liberty,68,164.5,-110,NYL,New York Liberty,7,-115,1021800137,50,31,81,-19,home,0,0,0,0,0,0,0,away,31,19
7/19/2018,310,ADAtlanta Dream,82,164.5,-110,ATL,Atlanta Dream,-7,-105,1021800137,50,31,81,-19,home,1,1,1,1,1,1,1,home,50,-19
7/19/2018,311,WMWashington Mystics,81,178,-110,WAS,Washington Mystics,4,-110,1021800138,48,39,87,-9,home,0,0,0,0,0,0,0,away,39,9
7/19/2018,312,DWDallas Wings,90,178,-110,DAL,Dallas Wings,-4,-110,1021800138,48,39,87,-9,home,1,1,1,1,1,1,1,home,48,-9
7/19/2018,313,LVLas Vegas Aces,85,172,-110,LVA,Las Vegas Aces,8.5,-110,1021800139,37,46,83,9,away,0,1,0,1,1,1,1,away,46,-9
7/19/2018,314,PPhoenix,82,172,-110,PHO,Phoenix Mercury,-8.5,-110,1021800139,37,46,83,9,away,1,0,1,0,0,0,0,home,37,9
7/20/2018,315,SSSeattle Storm,78,177.5,-110,SEA,Seattle Storm,2.5,-115,1021800140,33,29,62,-4,home,0,0,0,1,0,0,0,away,29,4
7/20/2018,316,CSConnecticut Sun,65,177.5,-110,CON,Connecticut Sun,-2.5,-105,1021800140,33,29,62,-4,home,1,1,1,0,1,1,1,home,33,-4
7/20/2018,317,DWDallas Wings,99,181,-110,DAL,Dallas Wings,-7,-115,1021800141,57,52,109,-5,home,0,0,0,0,0,0,0,away,52,5
7/20/2018,318,CSChicago Sky,114,181,-110,CHI,Chicago Sky,7,-105,1021800141,57,52,109,-5,home,1,1,1,1,1,1,1,home,57,-5
7/20/2018,319,IFIndiana Fever,78,153.5,-110,IND,Indiana Fever,13,-105,1021800142,40,37,77,-3,home,0,0,0,0,0,1,0,away,37,3
7/20/2018,320,LSL.A. Sparks,76,153.5,-110,LAS,Los Angeles Sparks,-13,-115,1021800142,40,37,77,-3,home,1,1,1,1,1,0,1,home,40,-3
7/21/2018,601,WMWashington Mystics,95,166,-110,WAS,Washington Mystics,-6,-110,1021800143,35,43,78,8,away,1,1,1,1,1,1,1,away,43,-8
7/21/2018,602,NYNew York Liberty,78,166,-110,NYL,New York Liberty,6,-110,1021800143,35,43,78,8,away,0,0,0,0,0,0,0,home,35,8
7/21/2018,603,MLMinnesota Lynx,80,161,-110,MIN,Minnesota Lynx,3.5,-110,1021800144,38,40,78,2,away,0,0,1,1,1,1,1,away,40,-2
7/21/2018,604,PPhoenix,75,161,-110,PHO,Phoenix Mercury,-3.5,-110,1021800144,38,40,78,2,away,1,1,0,0,0,0,0,home,38,2
7/22/2018,605,SSSeattle Storm,74,163.5,-110,SEA,Seattle Storm,-2,-110,1021800145,47,34,81,-13,home,1,0,0,0,0,0,0,away,34,13
7/22/2018,606,ADAtlanta Dream,87,163.5,-110,ATL,Atlanta Dream,2,-110,1021800145,47,34,81,-13,home,0,1,1,1,1,1,1,home,47,-13
7/22/2018,607,CSConnecticut Sun,92,178,-110,CON,Connecticut Sun,4,-110,1021800146,38,44,82,6,away,1,1,1,1,1,1,1,away,44,-6
7/22/2018,608,DWDallas Wings,75,178,-110,DAL,Dallas Wings,-4,-110,1021800146,38,44,82,6,away,0,0,0,0,0,0,0,home,38,6
7/22/2018,609,IFIndiana Fever,74,167.5,-110,IND,Indiana Fever,9.5,-110,1021800147,40,37,77,-3,home,1,0,0,0,0,0,0,away,37,3
7/22/2018,610,LVLas Vegas Aces,88,167.5,-110,LVA,Las Vegas Aces,-9.5,-110,1021800147,40,37,77,-3,home,0,1,1,1,1,1,1,home,40,-3
7/22/2018,611,LSL.A. Sparks,93,165,-110,LAS,Los Angeles Sparks,-3.5,-105,1021800148,38,40,78,2,away,0,0,0,1,0,0,1,away,40,-2
7/22/2018,612,CSChicago Sky,76,165,-110,CHI,Chicago Sky,3.5,-115,1021800148,38,40,78,2,away,1,1,1,0,1,1,0,home,38,2
7/24/2018,613,WMWashington Mystics,68,170.5,-110,WAS,Washington Mystics,5,-110,1021800149,45,35,80,-10,home,1,1,1,1,0,0,0,away,35,10
7/24/2018,614,CSConnecticut Sun,94,170.5,-110,CON,Connecticut Sun,-5,-110,1021800149,45,35,80,-10,home,0,0,0,0,1,1,1,home,45,-10
7/24/2018,615,SSSeattle Storm,92,166,-110,SEA,Seattle Storm,-11,-110,1021800150,34,46,80,12,away,1,1,1,1,1,1,1,away,46,-12
7/24/2018,616,IFIndiana Fever,72,166,-110,IND,Indiana Fever,11,-110,1021800150,34,46,80,12,away,0,0,0,0,0,0,0,home,34,12
7/24/2018,617,NYNew York Liberty,82,157,-110,NYL,New York Liberty,12.5,-110,1021800151,46,50,96,4,away,1,1,1,1,1,1,1,away,50,-4
7/24/2018,618,MLMinnesota Lynx,85,157,-110,MIN,Minnesota Lynx,-12.5,-110,1021800151,46,50,96,4,away,0,0,0,0,0,0,0,home,46,4
7/24/2018,619,ADAtlanta Dream,81,157.5,-115,ATL,Atlanta Dream,2.5,-110,1021800152,41,37,78,-4,home,1,0,0,0,0,1,0,away,37,4
7/24/2018,620,LSL.A. Sparks,71,157.5,-105,LAS,Los Angeles Sparks,-2.5,-110,1021800152,41,37,78,-4,home,0,1,1,1,1,0,1,home,41,-4
7/25/2018,621,CSChicago Sky,101,172,-110,CHI,Chicago Sky,7,-110,1021800153,43,56,99,13,away,1,1,1,0,1,1,1,away,56,-13
7/25/2018,622,PPhoenix,87,172,-110,PHO,Phoenix Mercury,-7,-110,1021800153,43,56,99,13,away,0,0,0,1,0,0,0,home,43,13
7/31/2018,301,WMWashington Mystics,86,164,-110,WAS,Washington Mystics,5,-110,1021800154,43,50,93,7,away,0,0,0,0,1,1,1,away,50,-7
7/31/2018,302,ADAtlanta Dream,71,164,-110,ATL,Atlanta Dream,-5,-110,1021800154,43,50,93,7,away,1,1,1,1,0,0,0,home,43,7
7/31/2018,303,CSChicago Sky,92,185,-110,CHI,Chicago Sky,12,-115,1021800155,36,55,91,19,away,1,1,1,1,1,1,1,away,55,-19
7/31/2018,304,DWDallas Wings,91,185,-110,DAL,Dallas Wings,-12,-110,1021800155,36,55,91,19,away,0,0,0,0,0,0,0,home,36,19
7/31/2018,305,SSSeattle Storm,102,170,-110,SEA,Seattle Storm,-3.5,-110,1021800156,44,53,97,9,away,1,1,1,1,1,1,1,away,53,-9
7/31/2018,306,PPhoenix,91,170,-110,PHO,Phoenix Mercury,3.5,-110,1021800156,44,53,97,9,away,0,0,0,0,0,0,0,home,44,9
8/1/2018,307,NYNew York Liberty,77,166.5,-110,NYL,New York Liberty,12,-110,1021800157,48,39,87,-9,home,0,0,0,0,0,0,0,away,39,9
8/1/2018,308,CSConnecticut Sun,92,166.5,-110,CON,Connecticut Sun,-12,-110,1021800157,48,39,87,-9,home,1,1,1,1,1,1,1,home,48,-9
8/1/2018,309,PPhoenix,104,173.5,-110,PHO,Phoenix Mercury,4,-110,1021800158,42,48,90,6,away,0,1,1,1,1,1,1,away,48,-6
8/1/2018,310,LVLas Vegas Aces,93,173.5,-110,LVA,Las Vegas Aces,-4,-110,1021800158,42,48,90,6,away,1,0,0,0,0,0,0,home,42,6
8/2/2018,601,DWDallas Wings,78,169,-110,DAL,Dallas Wings,-7,-110,1021800159,43,39,82,-4,home,0,1,1,1,1,1,0,away,39,4
8/2/2018,602,IFIndiana Fever,84,169,-110,IND,Indiana Fever,7,-110,1021800159,43,39,82,-4,home,1,0,0,0,0,0,1,home,43,-4
8/2/2018,603,MLMinnesota Lynx,57,155.5,-110,MIN,Minnesota Lynx,2.5,-110,1021800160,40,29,69,-11,home,0,0,0,0,0,0,0,away,29,11
8/2/2018,604,LSL.A. Sparks,79,155.5,-110,LAS,Los Angeles Sparks,-2.5,-110,1021800160,40,29,69,-11,home,1,1,1,1,1,1,1,home,40,-11
8/7/2018,603,SSSeattle Storm,94,167,-110,SEA,Seattle Storm,-11.5,-110,1021800171,44,51,95,7,away,1,0,0,0,1,1,1,away,51,-7
8/7/2018,604,IFIndiana Fever,79,167,-110,IND,Indiana Fever,11.5,-115,1021800171,44,51,95,7,away,0,1,1,1,0,0,0,home,44,7
8/7/2018,601,LVLas Vegas Aces,100,167.5,-110,LVA,Las Vegas Aces,8,-110,1021800170,56,60,116,4,away,1,1,1,1,1,0,0,away,60,-4
8/7/2018,602,ADAtlanta Dream,109,167.5,-110,ATL,Atlanta Dream,-8,-110,1021800170,56,60,116,4,away,0,0,0,0,0,1,1,home,56,4
8/7/2018,605,MLMinnesota Lynx,85,166.5,-110,MIN,Minnesota Lynx,-4,-110,1021800172,38,39,77,1,away,0,0,0,0,0,0,1,away,39,-1
8/7/2018,606,CSChicago Sky,64,166,-110,CHI,Chicago Sky,4,-110,1021800172,38,39,77,1,away,1,1,1,1,1,1,0,home,38,1
8/7/2018,607,WMWashington Mystics,103,171.5,-110,WAS,Washington Mystics,2,-105,1021800173,50,57,107,7,away,1,1,1,1,1,1,1,away,57,-7
8/7/2018,608,PPhoenix,98,171.5,-110,PHO,Phoenix Mercury,-2,-115,1021800173,50,57,107,7,away,0,0,0,0,0,0,0,home,50,7
8/17/2018,307,MLMinnesota Lynx,79,161,-110,MIN,Minnesota Lynx,5.5,-110,1021800193,43,46,89,3,away,0,0,1,1,1,1,1,away,46,-3
8/17/2018,308,CSConnecticut Sun,96,161,-110,CON,Connecticut Sun,-5.5,-110,1021800193,43,46,89,3,away,1,1,0,0,0,0,0,home,43,3
8/17/2018,305,LSL.A. Sparks,67,158.5,-110,LAS,Los Angeles Sparks,4,-110,1021800194,40,40,80,0,tie,1,1,1,0,0,0,0,away,40,-0
8/17/2018,306,WMWashington Mystics,69,158.5,-110,WAS,Washington Mystics,-4,-110,1021800194,40,40,80,0,tie,0,0,0,1,1,1,1,home,40,0
8/17/2018,309,LVLas Vegas Aces,102,176,-110,LVA,Las Vegas Aces,5.5,-115,1021800195,51,57,108,6,away,1,1,1,1,1,1,1,away,57,-6
8/17/2018,310,DWDallas Wings,107,176,-110,DAL,Dallas Wings,-5.5,-110,1021800195,51,57,108,6,away,0,0,0,0,0,0,0,home,51,6
8/17/2018,313,ADAtlanta Dream,95,168,-110,ATL,Atlanta Dream,4,-110,1021800196,50,47,97,-3,home,1,1,0,0,1,0,0,away,47,3
8/17/2018,314,PPhoenix,104,168.5,-115,PHO,Phoenix Mercury,-4,-110,1021800196,50,47,97,-3,home,0,0,1,1,0,1,1,home,50,-3
8/17/2018,311,NYNew York Liberty,77,164,-110,NYL,New York Liberty,15.5,-110,1021800197,46,43,89,-3,home,0,0,0,0,0,0,0,away,43,3
8/17/2018,312,SSSeattle Storm,85,164,-110,SEA,Seattle Storm,-15.5,-110,1021800197,46,43,89,-3,home,1,1,1,1,1,1,1,home,46,-3
8/21/2018,305,DWDallas Wings,83,178.5,-110,DAL,Dallas Wings,7,-110,1041800101,53,49,102,-4,home,0,1,0,0,0,0,0,away,49,4
8/21/2018,306,PPhoenix,101,178.5,-110,PHO,Phoenix Mercury,-7,-110,1041800101,53,49,102,-4,home,1,0,1,1,1,1,1,home,53,-4
8/21/2018,307,MLMinnesota Lynx,68,149.5,-110,MIN,Minnesota Lynx,6,-110,1041800111,40,37,77,-3,home,0,0,1,1,1,0,0,away,37,3
8/21/2018,308,LSL.A. Sparks,75,149.5,-110,LAS,Los Angeles Sparks,-6,-110,1041800111,40,37,77,-3,home,1,1,0,0,0,1,1,home,40,-3
8/23/2018,309,LSL.A. Sparks,64,157.5,-110,LAS,Los Angeles Sparks,4,-110,1041800201,50,29,79,-21,home,1,0,0,0,0,0,0,away,29,21
8/23/2018,310,WMWashington Mystics,96,157.5,-110,WAS,Washington Mystics,-4,-110,1041800201,50,29,79,-21,home,0,1,1,1,1,1,1,home,50,-21
8/23/2018,311,PPhoenix,96,176,-110,PHO,Phoenix Mercury,4,-110,1041800211,44,40,84,-4,home,0,0,0,0,0,0,0,away,40,4
8/23/2018,312,CSConnecticut Sun,86,176,-110,CON,Connecticut Sun,-4,-110,1041800211,44,40,84,-4,home,1,1,1,1,1,1,1,home,44,-4
8/26/2018,315,WMWashington Mystics,87,163.5,-110,WAS,Washington Mystics,-2.5,-110,1041800311,42,51,93,9,away,1,1,1,1,1,1,1,away,51,-9
8/26/2018,316,ADAtlanta Dream,84,163.5,-110,ATL,Atlanta Dream,2.5,-110,1041800311,42,51,93,9,away,0,0,0,0,0,0,0,home,42,9
8/26/2018,313,PPhoenix,87,175.5,-110,PHO,Phoenix Mercury,6.5,-110,1041800301,54,50,104,-4,home,1,0,0,1,0,0,0,away,50,4
8/26/2018,314,SSSeattle Storm,91,175.5,-106,SEA,Seattle Storm,-6.5,-110,1041800301,54,50,104,-4,home,0,1,1,0,1,1,1,home,54,-4
8/28/2018,317,WMWashington Mystics,75,162,-105,WAS,Washington Mystics,-1,-110,1041800312,34,36,70,2,away,0,0,0,0,0,1,1,away,36,-2
8/28/2018,318,ADAtlanta Dream,78,162,-115,ATL,Atlanta Dream,1,-110,1041800312,34,36,70,2,away,1,1,1,1,1,0,0,home,34,2
8/28/2018,319,PPhoenix,87,178.5,-110,PHO,Phoenix Mercury,5.5,-110,1041800302,44,32,76,-12,home,0,1,0,0,0,0,0,away,32,12
8/28/2018,320,SSSeattle Storm,91,178.5,-110,SEA,Seattle Storm,-5.5,-110,1041800302,44,32,76,-12,home,1,0,1,1,1,1,1,home,44,-12
8/31/2018,601,ADAtlanta Dream,81,157.5,-110,ATL,Atlanta Dream,1.5,-110,1041800313,34,37,71,3,away,0,1,1,0,0,1,1,away,37,-3
8/31/2018,602,WMWashington Mystics,76,157.5,-110,WAS,Washington Mystics,-1.5,-110,1041800313,34,37,71,3,away,1,0,0,1,1,0,0,home,34,3
8/31/2018,605,SSSeattle Storm,66,172,-110,SEA,Seattle Storm,2,-110,1041800303,42,35,77,-7,home,0,0,0,0,0,0,0,away,35,7
8/31/2018,606,PPhoenix,86,172,-110,PHO,Phoenix Mercury,-2,-110,1041800303,42,35,77,-7,home,1,1,1,1,1,1,1,home,42,-7
9/2/2018,612,ADAtlanta Dream,76,162,-110,ATL,Atlanta Dream,4,-115,1041800314,44,35,79,-9,home,1,0,0,0,0,0,0,away,35,9
9/2/2018,611,WMWashington Mystics,97,162,-110,WAS,Washington Mystics,-4,-110,1041800314,44,35,79,-9,home,0,1,1,1,1,1,1,home,44,-9
9/2/2018,610,SSSeattle Storm,84,170.5,-110,SEA,Seattle Storm,3,-117,1041800304,42,53,95,11,away,1,1,1,1,1,1,1,away,53,-11
9/2/2018,609,PPhoenix,86,170.5,-110,PHO,Phoenix Mercury,-3.5,-110,1041800304,42,53,95,11,away,0,0,0,0,0,0,0,home,42,11
9/4/2018,611,WMWashington Mystics,86,159,-110,WAS,Washington Mystics,-4,-110,1041800315,50,49,99,-1,home,1,1,1,0,1,0,1,away,49,1
9/4/2018,612,ADAtlanta Dream,81,159,-110,ATL,Atlanta Dream,4,-110,1041800315,50,49,99,-1,home,0,0,0,1,0,1,0,home,50,-1
9/4/2018,609,PPhoenix,84,171.5,-110,PHO,Phoenix Mercury,5.5,-110,1041800305,41,46,87,5,away,1,1,1,1,1,1,1,away,46,-5
9/4/2018,610,SSSeattle Storm,94,171.5,-110,SEA,Seattle Storm,-5.5,-110,1041800305,41,46,87,5,away,0,0,0,0,0,0,0,home,41,5
9/7/2018,613,WMWashington Mystics,76,172.5,-110,WAS,Washington Mystics,4.5,-110,1041800401,48,32,80,-16,home,0,0,0,0,0,0,0,away,32,16
9/7/2018,614,SSSeattle Storm,89,172.5,-110,SEA,Seattle Storm,-4.5,-115,1041800401,48,32,80,-16,home,1,1,1,1,1,1,1,home,48,-16
9/9/2018,615,WMWashington Mystics,73,170,-110,WAS,Washington Mystics,5.5,-105,1041800402,36,40,76,4,away,0,0,0,0,0,0,1,away,40,-4
9/9/2018,616,SSSeattle Storm,75,170,-110,SEA,Seattle Storm,-5.5,-115,1041800402,36,40,76,4,away,1,1,1,1,1,1,0,home,36,4
9/12/2018,617,SSSeattle Storm,98,168,-110,SEA,Seattle Storm,5,-110,1041800403,30,47,77,17,away,1,1,1,1,1,1,1,away,47,-17
9/12/2018,618,WMWashington Mystics,82,168,-110,WAS,Washington Mystics,-5,-110,1041800403,30,47,77,17,away,0,0,0,0,0,0,0,home,30,17
5/18/2018,301,DWDallas Wings,78,160.5,-106,DAL,Dallas Wings,5.5,-110,1021800001,44,42,86,-2,home,0,1,0,0,0,0,1,away,42,2
5/18/2018,302,PPhoenix,86,160.5,-114,PHO,Phoenix Mercury,-5.5,-110,1021800001,44,42,86,-2,home,1,0,1,1,1,1,0,home,44,-2
5/20/2018,601,LVLas Vegas Aces,65,154,-110,LVA,Las Vegas Aces,19,-110,1021800003,49,37,86,-12,home,1,1,1,0,0,0,0,away,37,12
5/20/2018,602,CSConnecticut Sun,101,154,-110,CON,Connecticut Sun,-19,-110,1021800003,49,37,86,-12,home,0,0,0,1,1,1,1,home,49,-12
5/20/2018,603,IFIndiana Fever,75,153,-110,IND,Indiana Fever,12.5,-110,1021800004,38,30,68,-8,home,1,0,0,0,0,0,0,away,30,8
5/20/2018,604,WMWashington Mystics,82,153,-110,WAS,Washington Mystics,-12.5,-110,1021800004,38,30,68,-8,home,0,1,1,1,1,1,1,home,38,-8
5/20/2018,605,ADAtlanta Dream,78,162,-110,ATL,Atlanta Dream,3.5,-110,1021800005,59,37,96,-22,home,1,1,1,0,0,0,0,away,37,22
5/20/2018,606,DWDallas Wings,101,162,-110,DAL,Dallas Wings,-3.5,-110,1021800005,59,37,96,-22,home,0,0,0,1,1,1,1,home,59,-22
5/20/2018,607,LSL.A. Sparks,77,155,-110,LAS,Los Angeles Sparks,7.5,-110,1021800006,38,32,70,-6,home,0,0,0,1,1,0,0,away,32,6
5/20/2018,608,MLMinnesota Lynx,76,155,-110,MIN,Minnesota Lynx,-7.5,-110,1021800006,38,32,70,-6,home,1,1,1,0,0,1,1,home,38,-6
5/20/2018,609,NYNew York Liberty,76,153.5,-110,NYL,New York Liberty,-6.5,-115,1021800007,38,40,78,2,away,0,0,0,1,1,1,1,away,40,-2
5/20/2018,610,CSChicago Sky,80,153.5,-110,CHI,Chicago Sky,6.5,-105,1021800007,38,40,78,2,away,1,1,1,0,0,0,0,home,38,2
5/20/2018,611,PPhoenix,87,156,-110,PHO,Phoenix Mercury,2,-110,1021800008,36,46,82,10,away,1,1,1,1,1,1,1,away,46,-10
5/20/2018,612,SSSeattle Storm,82,156,-110,SEA,Seattle Storm,-2,-110,1021800008,36,46,82,10,away,0,0,0,0,0,0,0,home,36,10
5/22/2018,301,LVLas Vegas Aces,70,155,-110,LVA,Las Vegas Aces,18.5,-110,1021800010,23,31,54,8,away,1,1,1,1,1,1,1,away,31,-8
5/22/2018,302,WMWashington Mystics,75,155,-110,WAS,Washington Mystics,-18.5,-110,1021800010,23,31,54,8,away,0,0,0,0,0,0,0,home,23,8
5/22/2018,303,LSL.A. Sparks,87,150,-120,LAS,Los Angeles Sparks,-8.5,-105,1021800009,36,50,86,14,away,1,1,1,1,1,1,1,away,50,-14
5/22/2018,304,IFIndiana Fever,70,150,100,IND,Indiana Fever,8.5,-115,1021800009,36,50,86,14,away,0,0,0,0,0,0,0,home,36,14
5/23/2018,305,ADAtlanta Dream,81,162.5,-128,ATL,Atlanta Dream,-1.5,-115,1021800011,27,39,66,12,away,1,1,1,1,1,1,1,away,39,-12
5/23/2018,306,CSChicago Sky,63,162.5,108,CHI,Chicago Sky,1.5,-105,1021800011,27,39,66,12,away,0,0,0,0,0,0,0,home,27,12
5/23/2018,307,DWDallas Wings,68,164,-110,DAL,Dallas Wings,13,-115,1021800012,46,21,67,-25,home,0,0,0,0,0,0,0,away,21,25
5/23/2018,308,MLMinnesota Lynx,76,164,-110,MIN,Minnesota Lynx,-13,-105,1021800012,46,21,67,-25,home,1,1,1,1,1,1,1,home,46,-25
5/23/2018,309,SSSeattle Storm,87,157,-110,SEA,Seattle Storm,5.5,-105,1021800013,33,46,79,13,away,0,0,0,0,1,1,1,away,46,-13
5/23/2018,310,PPhoenix,71,157,-110,PHO,Phoenix Mercury,-5.5,-115,1021800013,33,46,79,13,away,1,1,1,1,0,0,0,home,33,13
5/24/2018,311,WMWashington Mystics,93,154.5,-110,WAS,Washington Mystics,-5,-115,1021800015,44,51,95,7,away,0,0,0,0,0,1,1,away,51,-7
5/24/2018,312,IFIndiana Fever,84,154.5,-110,IND,Indiana Fever,5,-105,1021800015,44,51,95,7,away,1,1,1,1,1,0,0,home,44,7
5/24/2018,313,LSL.A. Sparks,94,162.5,-110,LAS,Los Angeles Sparks,4.5,-110,1021800014,46,47,93,1,away,1,0,0,1,1,1,1,away,47,-1
5/24/2018,314,CSConnecticut Sun,102,162.5,-110,CON,Connecticut Sun,-4.5,-110,1021800014,46,47,93,1,away,0,1,1,0,0,0,0,home,46,1
5/25/2018,315,MLMinnesota Lynx,78,153,-110,MIN,Minnesota Lynx,-7.5,-110,1021800016,36,41,77,5,away,0,0,1,1,0,1,1,away,41,-5
5/25/2018,316,NYNew York Liberty,72,153,-110,NYL,New York Liberty,7.5,-110,1021800016,36,41,77,5,away,1,1,0,0,1,0,0,home,36,5
5/25/2018,317,CSChicago Sky,91,158.5,-115,CHI,Chicago Sky,10,-110,1021800017,41,44,85,3,away,0,1,1,1,1,1,1,away,44,-3
5/25/2018,318,SSSeattle Storm,95,158.5,-105,SEA,Seattle Storm,-10,-110,1021800017,41,44,85,3,away,1,0,0,0,0,0,0,home,41,3
5/26/2018,319,DWDallas Wings,78,167,-110,DAL,Dallas Wings,4,-110,1021800018,31,39,70,8,away,0,1,1,1,1,1,1,away,39,-8
5/26/2018,320,ADAtlanta Dream,70,167,-110,ATL,Atlanta Dream,-4,-110,1021800018,31,39,70,8,away,1,0,0,0,0,0,0,home,31,8
5/26/2018,321,IFIndiana Fever,77,163.5,-110,IND,Indiana Fever,17,-110,1021800019,47,38,85,-9,home,0,0,0,0,0,0,0,away,38,9
5/26/2018,322,CSConnecticut Sun,86,163.5,-110,CON,Connecticut Sun,-17,-110,1021800019,47,38,85,-9,home,1,1,1,1,1,1,1,home,47,-9
5/27/2018,323,MLMinnesota Lynx,78,158.5,-110,MIN,Minnesota Lynx,-5,-110,1021800020,46,39,85,-7,home,1,1,1,1,1,0,0,away,39,7
5/27/2018,324,WMWashington Mystics,90,158.5,-110,WAS,Washington Mystics,5,-110,1021800020,46,39,85,-7,home,0,0,0,0,0,1,1,home,46,-7
5/27/2018,325,PPhoenix,72,159,-110,PHO,Phoenix Mercury,7.5,-110,1021800021,48,40,88,-8,home,1,1,0,0,0,0,0,away,40,8
5/27/2018,326,LSL.A. Sparks,80,159,-110,LAS,Los Angeles Sparks,-7.5,-110,1021800021,48,40,88,-8,home,0,0,1,1,1,1,1,home,48,-8
5/27/2018,327,SSSeattle Storm,105,164.5,-110,SEA,Seattle Storm,-6.5,-110,1021800022,35,53,88,18,away,0,1,1,1,1,1,1,away,53,-18
5/27/2018,328,LVLas Vegas Aces,98,164.5,-110,LVA,Las Vegas Aces,6.5,-110,1021800022,35,53,88,18,away,1,0,0,0,0,0,0,home,35,18
5/29/2018,603,MLMinnesota Lynx,74,156.5,-135,MIN,Minnesota Lynx,-6,-110,1021800023,31,34,65,3,away,1,1,1,1,1,1,1,away,34,-3
5/29/2018,604,ADAtlanta Dream,76,156.5,115,ATL,Atlanta Dream,6,-110,1021800023,31,34,65,3,away,0,0,0,0,0,0,0,home,31,3
5/29/2018,601,DWDallas Wings,89,161,-110,DAL,Dallas Wings,2.5,-115,1021800024,37,46,83,9,away,1,1,1,1,1,1,1,away,46,-9
5/29/2018,602,NYNew York Liberty,94,161,-110,NYL,New York Liberty,-2.5,-105,1021800024,37,46,83,9,away,0,0,0,0,0,0,0,home,37,9
5/29/2018,605,WMWashington Mystics,77,163,-110,WAS,Washington Mystics,7,-110,1021800025,41,39,80,-2,home,0,0,0,0,0,0,0,away,39,2
5/29/2018,606,SSSeattle Storm,81,163,-110,SEA,Seattle Storm,-7,-110,1021800025,41,39,80,-2,home,1,1,1,1,1,1,1,home,41,-2
5/30/2018,607,WMWashington Mystics,103,160,-110,WAS,Washington Mystics,8.5,-110,1021800026,43,49,92,6,away,0,1,1,0,0,1,1,away,49,-6
5/30/2018,608,PPhoenix,95,160,-110,PHO,Phoenix Mercury,-8.5,-110,1021800026,43,49,92,6,away,1,0,0,1,1,0,0,home,43,6
5/31/2018,611,LVLas Vegas Aces,74,171,-110,LVA,Las Vegas Aces,11,-110,1021800027,60,32,92,-28,home,0,0,0,0,0,0,0,away,32,28
5/31/2018,612,SSSeattle Storm,101,171,-110,SEA,Seattle Storm,-11,-110,1021800027,60,32,92,-28,home,1,1,1,1,1,1,1,home,60,-28
6/1/2018,301,PPhoenix,95,157,-110,PHO,Phoenix Mercury,8,-105,1021800028,50,52,102,2,away,1,1,0,0,0,0,1,away,52,-2
6/1/2018,302,MLMinnesota Lynx,85,157,-110,MIN,Minnesota Lynx,-8,-115,1021800028,50,52,102,2,away,0,0,1,1,1,1,0,home,50,2
6/1/2018,303,CSConnecticut Sun,110,170.5,-110,CON,Connecticut Sun,-9,-115,1021800029,35,48,83,13,away,0,0,1,1,1,1,1,away,48,-13
6/1/2018,304,CSChicago Sky,72,170.5,-110,CHI,Chicago Sky,9,-105,1021800029,35,48,83,13,away,1,1,0,0,0,0,0,home,35,13
6/1/2018,305,WMWashington Mystics,73,168.5,-115,WAS,Washington Mystics,-7,-115,1021800030,46,37,83,-9,home,0,0,0,0,0,0,0,away,37,9
6/1/2018,306,LVLas Vegas Aces,85,168.5,-105,LVA,Las Vegas Aces,7,-105,1021800030,46,37,83,-9,home,1,1,1,1,1,1,1,home,46,-9
6/2/2018,307,NYNew York Liberty,87,156,-110,NYL,New York Liberty,-5.5,-110,1021800031,29,46,75,17,away,0,0,1,1,1,1,1,away,46,-17
6/2/2018,308,IFIndiana Fever,81,156,-110,IND,Indiana Fever,5.5,-110,1021800031,29,46,75,17,away,1,1,0,0,0,0,0,home,29,17
6/2/2018,309,SSSeattle Storm,90,172,-110,SEA,Seattle Storm,3,-115,1021800032,53,36,89,-17,home,0,0,0,0,0,0,0,away,36,17
6/2/2018,310,DWDallas Wings,94,172,-110,DAL,Dallas Wings,-3,-110,1021800032,53,36,89,-17,home,1,1,1,1,1,1,1,home,53,-17
6/3/2018,313,PPhoenix,78,162,-110,PHO,Phoenix Mercury,1.5,-105,1021800033,30,38,68,8,away,1,1,1,1,1,1,1,away,38,-8
6/3/2018,314,ADAtlanta Dream,71,162,-110,ATL,Atlanta Dream,-1.5,-115,1021800033,30,38,68,8,away,0,0,0,0,0,0,0,home,30,8
6/3/2018,311,CSConnecticut Sun,88,172,-110,CON,Connecticut Sun,-6.5,-110,1021800034,35,49,84,14,away,1,1,1,1,1,1,1,away,49,-14
6/3/2018,312,WMWashington Mystics,64,172,-110,WAS,Washington Mystics,6.5,-110,1021800034,35,49,84,14,away,0,0,0,0,0,0,0,home,35,14
6/3/2018,315,MLMinnesota Lynx,69,158,-115,MIN,Minnesota Lynx,6,-110,1021800035,40,38,78,-2,home,0,0,0,0,0,0,0,away,38,2
6/3/2018,316,LSL.A. Sparks,77,158,-110,LAS,Los Angeles Sparks,-6,-110,1021800035,40,38,78,-2,home,1,1,1,1,1,1,1,home,40,-2
6/3/2018,317,LVLas Vegas Aces,90,165,-110,LVA,Las Vegas Aces,5,-110,1021800036,45,52,97,7,away,1,1,1,1,1,1,1,away,52,-7
6/3/2018,318,CSChicago Sky,95,165,-110,CHI,Chicago Sky,-5,-115,1021800036,45,52,97,7,away,0,0,0,0,0,0,0,home,45,7
6/5/2018,601,PPhoenix,80,160,-110,PHO,Phoenix Mercury,2.5,-115,1021800037,38,43,81,5,away,1,1,0,0,0,1,1,away,43,-5
6/5/2018,602,NYNew York Liberty,74,160,-110,NYL,New York Liberty,-2.5,-105,1021800037,38,43,81,5,away,0,0,1,1,1,0,0,home,38,5
6/5/2018,603,CSConnecticut Sun,77,165,-110,CON,Connecticut Sun,-6.5,-110,1021800038,46,40,86,-6,home,1,1,1,1,1,1,0,away,40,6
6/5/2018,604,ADAtlanta Dream,82,165,-110,ATL,Atlanta Dream,6.5,-110,1021800038,46,40,86,-6,home,0,0,0,0,0,0,1,home,46,-6
6/7/2018,607,MLMinnesota Lynx,88,159,-110,MIN,Minnesota Lynx,-4.5,-110,1021800040,42,48,90,6,away,0,0,0,0,1,1,0,away,48,-6
6/7/2018,608,WMWashington Mystics,80,159,-110,WAS,Washington Mystics,4.5,-110,1021800040,42,48,90,6,away,1,1,1,1,0,0,1,home,42,6
6/7/2018,605,CSConnecticut Sun,88,165.5,-115,CON,Connecticut Sun,-5.5,-105,1021800039,54,41,95,-13,home,0,0,0,0,0,0,0,away,41,13
6/7/2018,606,NYNew York Liberty,86,165.5,-105,NYL,New York Liberty,5.5,-115,1021800039,54,41,95,-13,home,1,1,1,1,1,1,1,home,54,-13
6/7/2018,609,SSSeattle Storm,88,168,-105,SEA,Seattle Storm,8,-110,1021800041,33,42,75,9,away,1,1,1,1,1,1,1,away,42,-9
6/7/2018,610,LSL.A. Sparks,63,168,-115,LAS,Los Angeles Sparks,-8,-110,1021800041,33,42,75,9,away,0,0,0,0,0,0,0,home,33,9
6/9/2018,307,MLMinnesota Lynx,75,167.5,-110,MIN,Minnesota Lynx,5.5,-110,1021800045,44,38,82,-6,home,0,1,1,1,0,0,0,away,38,6
6/9/2018,308,CSConnecticut Sun,89,167.5,-110,CON,Connecticut Sun,-5.5,-115,1021800045,44,38,82,-6,home,1,0,0,0,1,1,1,home,44,-6
6/12/2018,601,LVLas Vegas Aces,101,161.5,-110,LVA,Las Vegas Aces,3.5,-110,1021800050,37,46,83,9,away,1,0,1,1,1,1,1,away,46,-9
6/12/2018,602,IFIndiana Fever,92,161.5,-110,IND,Indiana Fever,-3.5,-110,1021800050,37,46,83,9,away,0,1,0,0,0,0,0,home,37,9
6/12/2018,603,PPhoenix,75,169.5,-110,PHO,Phoenix Mercury,1.5,-115,1021800051,40,37,77,-3,home,0,0,0,0,0,0,0,away,37,3
6/12/2018,604,DWDallas Wings,72,169.5,-110,DAL,Dallas Wings,-1.5,-105,1021800051,40,37,77,-3,home,1,1,1,1,1,1,1,home,40,-3
6/12/2018,605,CSChicago Sky,85,169.5,-110,CHI,Chicago Sky,10.5,-110,1021800052,50,46,96,-4,home,1,1,1,0,0,0,0,away,46,4
6/12/2018,606,SSSeattle Storm,96,169.5,-110,SEA,Seattle Storm,-10.5,-110,1021800052,50,46,96,-4,home,0,0,0,1,1,1,1,home,50,-4
6/12/2018,607,ADAtlanta Dream,64,151.5,-110,ATL,Atlanta Dream,8,-110,1021800053,43,32,75,-11,home,0,1,1,0,0,0,0,away,32,11
6/12/2018,608,LSL.A. Sparks,72,151.5,-110,LAS,Los Angeles Sparks,-8,-110,1021800053,43,32,75,-11,home,1,0,0,1,1,1,1,home,43,-11
6/13/2018,611,LVLas Vegas Aces,78,163.5,-110,LVA,Las Vegas Aces,10,-115,1021800055,33,37,70,4,away,1,0,1,1,1,1,1,away,37,-4
6/13/2018,612,NYNew York Liberty,63,163.5,-110,NYL,New York Liberty,-10,-110,1021800055,33,37,70,4,away,0,1,0,0,0,0,0,home,33,4
6/13/2018,609,WMWashington Mystics,95,173,-110,WAS,Washington Mystics,9,-110,1021800054,37,65,102,28,away,1,1,1,1,1,1,1,away,65,-28
6/13/2018,610,CSConnecticut Sun,91,173,-110,CON,Connecticut Sun,-9,-110,1021800054,37,65,102,28,away,0,0,0,0,0,0,0,home,37,28
6/14/2018,301,IFIndiana Fever,67,153,-110,IND,Indiana Fever,8.5,-110,1021800056,41,40,81,-1,home,0,1,0,0,1,1,1,away,40,1
6/14/2018,302,ADAtlanta Dream,72,153,-110,ATL,Atlanta Dream,-8.5,-110,1021800056,41,40,81,-1,home,1,0,1,1,0,0,0,home,41,-1
6/15/2018,303,LSL.A. Sparks,97,159.5,-110,LAS,Los Angeles Sparks,-4,-110,1021800057,34,52,86,18,away,1,1,1,1,1,1,1,away,52,-18
6/15/2018,304,WMWashington Mystics,86,159.5,-110,WAS,Washington Mystics,4,-110,1021800057,34,52,86,18,away,0,0,0,0,0,0,0,home,34,18
6/15/2018,305,LVLas Vegas Aces,67,171.5,-110,LVA,Las Vegas Aces,8,-120,1021800058,45,39,84,-6,home,1,1,0,0,0,0,0,away,39,6
6/15/2018,306,DWDallas Wings,77,171.5,-110,DAL,Dallas Wings,-8,100,1021800058,45,39,84,-6,home,0,0,1,1,1,1,1,home,45,-6
6/15/2018,307,CSConnecticut Sun,92,176,-110,CON,Connecticut Sun,1.5,-110,1021800059,52,45,97,-7,home,0,0,0,0,0,0,0,away,45,7
6/15/2018,308,SSSeattle Storm,103,176,-110,SEA,Seattle Storm,-1.5,-110,1021800059,52,45,97,-7,home,1,1,1,1,1,1,1,home,52,-7
6/16/2018,309,ADAtlanta Dream,64,152,-115,ATL,Atlanta Dream,-3.5,-110,1021800060,35,38,73,3,away,1,1,0,1,1,1,0,away,38,-3
6/16/2018,310,IFIndiana Fever,96,152,-110,IND,Indiana Fever,3.5,-110,1021800060,35,38,73,3,away,0,0,1,0,0,0,1,home,35,3
6/16/2018,311,NYNew York Liberty,71,154,-110,NYL,New York Liberty,7,-110,1021800061,54,38,92,-16,home,0,0,0,0,0,0,0,away,38,16
6/16/2018,312,MLMinnesota Lynx,85,154,-110,MIN,Minnesota Lynx,-7,-110,1021800061,54,38,92,-16,home,1,1,1,1,1,1,1,home,54,-16
6/16/2018,313,CSConnecticut Sun,72,172.5,-110,CON,Connecticut Sun,5.5,-110,1021800062,43,21,64,-22,home,0,0,0,0,0,0,0,away,21,22
6/16/2018,314,PPhoenix,89,172.5,-110,PHO,Phoenix Mercury,-5.5,-110,1021800062,43,21,64,-22,home,1,1,1,1,1,1,1,home,43,-22
6/17/2018,315,LSL.A. Sparks,81,163,-110,LAS,Los Angeles Sparks,-8.5,-110,1021800063,33,39,72,6,away,0,0,0,0,1,1,1,away,39,-6
6/17/2018,316,CSChicago Sky,72,163,-110,CHI,Chicago Sky,8.5,-110,1021800063,33,39,72,6,away,1,1,1,1,0,0,0,home,33,6
6/17/2018,317,PPhoenix,92,163.5,-110,PHO,Phoenix Mercury,-6.5,-110,1021800064,42,46,88,4,away,1,1,1,1,1,1,1,away,46,-4
6/17/2018,318,LVLas Vegas Aces,80,163.5,-110,LVA,Las Vegas Aces,6.5,-110,1021800064,42,46,88,4,away,0,0,0,0,0,0,0,home,42,4
6/19/2018,603,ADAtlanta Dream,72,150.5,-110,ATL,Atlanta Dream,6,-110,1021800065,34,24,58,-10,home,0,0,0,0,0,0,0,away,24,10
6/19/2018,604,NYNew York Liberty,79,150.5,-110,NYL,New York Liberty,-6,-110,1021800065,34,24,58,-10,home,1,1,1,1,1,1,1,home,34,-10
6/19/2018,601,CSChicago Sky,60,168.5,-110,CHI,Chicago Sky,9.5,-110,1021800066,46,32,78,-14,home,0,1,0,0,0,0,0,away,32,14
6/19/2018,602,WMWashington Mystics,88,168.5,-110,WAS,Washington Mystics,-9.5,-110,1021800066,46,32,78,-14,home,1,0,1,1,1,1,1,home,46,-14
6/19/2018,605,DWDallas Wings,83,165.5,-110,DAL,Dallas Wings,8.5,-110,1021800067,51,36,87,-15,home,0,0,0,0,0,0,0,away,36,15
6/19/2018,606,MLMinnesota Lynx,91,165.5,-110,MIN,Minnesota Lynx,-8.5,-110,1021800067,51,36,87,-15,home,1,1,1,1,1,1,1,home,51,-15
6/19/2018,607,LVLas Vegas Aces,89,168,-110,LVA,Las Vegas Aces,10.5,-110,1021800068,39,38,77,-1,home,1,1,1,1,1,1,1,away,38,1
6/19/2018,608,SSSeattle Storm,77,168,-110,SEA,Seattle Storm,-10.5,-110,1021800068,39,38,77,-1,home,0,0,0,0,0,0,0,home,39,-1
6/19/2018,609,IFIndiana Fever,55,153.5,-110,IND,Indiana Fever,12.5,-110,1021800069,35,33,68,-2,home,1,1,1,0,0,0,0,away,33,2
6/19/2018,610,LSL.A. Sparks,74,153.5,-110,LAS,Los Angeles Sparks,-12.5,-110,1021800069,35,33,68,-2,home,0,0,0,1,1,1,1,home,35,-2
6/22/2018,611,CSConnecticut Sun,70,164.5,-110,CON,Connecticut Sun,-6,-105,1021800070,29,37,66,8,away,1,1,1,1,1,1,1,away,37,-8
6/22/2018,612,ADAtlanta Dream,75,164.5,-110,ATL,Atlanta Dream,6,-110,1021800070,29,37,66,8,away,0,0,0,0,0,0,0,home,29,8
6/22/2018,613,LSL.A. Sparks,72,163,-110,LAS,Los Angeles Sparks,-4.5,-110,1021800071,47,33,80,-14,home,1,0,0,0,0,0,0,away,33,14
6/22/2018,614,DWDallas Wings,101,163,-110,DAL,Dallas Wings,4.5,-110,1021800071,47,33,80,-14,home,0,1,1,1,1,1,1,home,47,-14
6/22/2018,615,WMWashington Mystics,93,168,-110,WAS,Washington Mystics,-6,-105,1021800072,39,64,103,25,away,1,1,1,1,1,1,1,away,64,-25
6/22/2018,616,CSChicago Sky,77,168,-110,CHI,Chicago Sky,6,-115,1021800072,39,64,103,25,away,0,0,0,0,0,0,0,home,39,25
6/22/2018,617,MLMinnesota Lynx,83,162,-110,MIN,Minnesota Lynx,2.5,-110,1021800074,30,46,76,16,away,1,1,1,1,1,1,1,away,46,-16
6/22/2018,618,PPhoenix,72,162,-110,PHO,Phoenix Mercury,-2.5,-110,1021800074,30,46,76,16,away,0,0,0,0,0,0,0,home,30,16
6/22/2018,621,NYNew York Liberty,78,159.5,-110,NYL,New York Liberty,-1,-110,1021800073,34,26,60,-8,home,0,0,0,0,0,0,0,away,26,8
6/22/2018,622,LVLas Vegas Aces,88,159.5,-110,LVA,Las Vegas Aces,1,-110,1021800073,34,26,60,-8,home,1,1,1,1,1,1,1,home,34,-8
6/22/2018,619,IFIndiana Fever,63,166.5,-110,IND,Indiana Fever,11.5,-110,1021800075,37,30,67,-7,home,0,0,0,0,0,0,0,away,30,7
6/22/2018,620,SSSeattle Storm,72,166.5,-110,SEA,Seattle Storm,-11.5,-110,1021800075,37,30,67,-7,home,1,1,1,1,1,1,1,home,37,-7
6/24/2018,301,SSSeattle Storm,97,170.5,-110,SEA,Seattle Storm,2.5,-110,1021800076,42,49,91,7,away,1,1,1,1,1,1,1,away,49,-7
6/24/2018,302,DWDallas Wings,76,170.5,-110,DAL,Dallas Wings,-2.5,-110,1021800076,42,49,91,7,away,0,0,0,0,0,0,0,home,42,7
6/24/2018,305,NYNew York Liberty,54,151,-110,NYL,New York Liberty,10.5,-110,1021800077,43,27,70,-16,home,0,0,0,0,0,0,0,away,27,16
6/24/2018,306,LSL.A. Sparks,80,151,-110,LAS,Los Angeles Sparks,-10.5,-110,1021800077,43,27,70,-16,home,1,1,1,1,1,1,1,home,43,-16
6/24/2018,309,PPhoenix,88,164.5,-110,PHO,Phoenix Mercury,-6.5,-115,1021800080,47,43,90,-4,home,0,0,0,0,0,0,0,away,43,4
6/24/2018,310,CSChicago Sky,97,164.5,-110,CHI,Chicago Sky,6.5,-105,1021800080,47,43,90,-4,home,1,1,1,1,1,1,1,home,47,-4
6/24/2018,307,MLMinnesota Lynx,88,163,-110,MIN,Minnesota Lynx,-7,-110,1021800079,33,39,72,6,away,1,1,1,1,1,1,1,away,39,-6
6/24/2018,308,LVLas Vegas Aces,73,163,-110,LVA,Las Vegas Aces,7,-110,1021800079,33,39,72,6,away,0,0,0,0,0,0,0,home,33,6
6/24/2018,303,CSConnecticut Sun,87,165.5,-110,CON,Connecticut Sun,-8.5,-110,1021800078,45,43,88,-2,home,1,1,1,1,1,1,1,away,43,2
6/24/2018,304,IFIndiana Fever,78,165.5,-110,IND,Indiana Fever,8.5,-110,1021800078,45,43,88,-2,home,0,0,0,0,0,0,0,home,45,-2
6/26/2018,311,PPhoenix,83,160.5,-110,PHO,Phoenix Mercury,-3.5,-110,1021800081,37,44,81,7,away,1,1,1,1,1,1,1,away,44,-7
6/26/2018,312,NYNew York Liberty,69,160.5,-110,NYL,New York Liberty,3.5,-110,1021800081,37,44,81,7,away,0,0,0,0,0,0,0,home,37,7
6/26/2018,313,CSConnecticut Sun,80,171,-110,CON,Connecticut Sun,3.5,-110,1021800082,43,46,89,3,away,1,1,1,1,1,1,1,away,46,-3
6/26/2018,314,WMWashington Mystics,92,171,-110,WAS,Washington Mystics,-3.5,-110,1021800082,43,46,89,3,away,0,0,0,0,0,0,0,home,43,3
6/26/2018,315,SSSeattle Storm,79,164,-110,SEA,Seattle Storm,7.5,-110,1021800083,43,34,77,-9,home,0,0,0,0,0,0,0,away,34,9
6/26/2018,316,MLMinnesota Lynx,91,164,-110,MIN,Minnesota Lynx,-7.5,-110,1021800083,43,34,77,-9,home,1,1,1,1,1,1,1,home,43,-9
6/26/2018,317,DWDallas Wings,83,158.5,-110,DAL,Dallas Wings,8.5,-133,1021800084,42,46,88,4,away,1,1,1,0,1,1,1,away,46,-4
6/26/2018,318,LSL.A. Sparks,87,158.5,-110,LAS,Los Angeles Sparks,-8.5,113,1021800084,42,46,88,4,away,0,0,0,1,0,0,0,home,42,4
6/28/2018,601,NYNew York Liberty,77,162.5,-110,NYL,New York Liberty,9.5,-115,1021800088,44,39,83,-5,home,1,1,1,1,0,1,0,away,39,5
6/28/2018,602,WMWashington Mystics,80,162.5,-110,WAS,Washington Mystics,-9.5,-110,1021800088,44,39,83,-5,home,0,0,0,0,1,0,1,home,44,-5
6/28/2018,603,LSL.A. Sparks,72,160,-110,LAS,Los Angeles Sparks,3,-110,1021800089,41,35,76,-6,home,0,0,0,0,0,0,0,away,35,6
6/28/2018,604,SSSeattle Storm,81,160,-110,SEA,Seattle Storm,-3,-110,1021800089,41,35,76,-6,home,1,1,1,1,1,1,1,home,41,-6
6/29/2018,605,PPhoenix,95,162.5,-110,PHO,Phoenix Mercury,-7.5,-110,1021800090,39,56,95,17,away,1,1,1,1,1,1,1,away,56,-17
6/29/2018,606,IFIndiana Fever,77,162.5,-110,IND,Indiana Fever,7,-110,1021800090,39,56,95,17,away,0,0,0,0,0,0,0,home,39,17
6/29/2018,607,CSChicago Sky,103,162,-110,CHI,Chicago Sky,3.5,-110,1021800091,55,52,107,-3,home,0,0,0,0,1,0,0,away,52,3
6/29/2018,608,NYNew York Liberty,99,162,-110,NYL,New York Liberty,-3.5,-110,1021800091,55,52,107,-3,home,1,1,1,1,0,1,1,home,55,-3
6/29/2018,609,ADAtlanta Dream,74,155.5,105,ATL,Atlanta Dream,12,-115,1021800092,39,36,75,-3,home,0,1,1,0,0,0,0,away,36,3
6/29/2018,610,MLMinnesota Lynx,85,155.5,-125,MIN,Minnesota Lynx,-12,-105,1021800092,39,36,75,-3,home,1,0,0,1,1,1,1,home,39,-3
6/29/2018,611,LSL.A. Sparks,78,159,105,LAS,Los Angeles Sparks,-7,-110,1021800093,44,37,81,-7,home,1,1,0,0,0,0,0,away,37,7
6/29/2018,612,LVLas Vegas Aces,94,158,-105,LVA,Las Vegas Aces,7,-110,1021800093,44,37,81,-7,home,0,0,1,1,1,1,1,home,44,-7
7/3/2018,311,SSSeattle Storm,77,165.5,-110,SEA,Seattle Storm,-4.5,-110,1021800100,28,39,67,11,away,1,1,0,0,1,1,1,away,39,-11
7/3/2018,312,NYNew York Liberty,62,165.5,-110,NYL,New York Liberty,4.5,-110,1021800100,28,39,67,11,away,0,0,1,1,0,0,0,home,28,11
7/3/2018,315,CSChicago Sky,85,174,-110,CHI,Chicago Sky,6.5,-110,1021800101,51,49,100,-2,home,0,1,1,1,0,0,0,away,49,2
7/3/2018,316,DWDallas Wings,108,174,-110,DAL,Dallas Wings,-6.5,-110,1021800101,51,49,100,-2,home,1,0,0,0,1,1,1,home,51,-2
7/3/2018,313,IFIndiana Fever,71,160,-105,IND,Indiana Fever,14,-110,1021800102,32,34,66,2,away,1,1,1,1,1,0,1,away,34,-2
7/3/2018,314,MLMinnesota Lynx,59,160,-110,MIN,Minnesota Lynx,-14,-110,1021800102,32,34,66,2,away,0,0,0,0,0,1,0,home,32,2
7/3/2018,317,CSConnecticut Sun,73,162,-110,CON,Connecticut Sun,9.5,-105,1021800103,25,41,66,16,away,1,1,1,1,1,1,1,away,41,-16
7/3/2018,318,LSL.A. Sparks,72,162,-110,LAS,Los Angeles Sparks,-9.5,-115,1021800103,25,41,66,16,away,0,0,0,0,0,0,0,home,25,16
7/6/2018,611,SSSeattle Storm,95,161,-110,SEA,Seattle Storm,-4.5,-110,1021800109,34,53,87,19,away,0,1,1,1,1,1,1,away,53,-19
7/6/2018,612,ADAtlanta Dream,86,161,-110,ATL,Atlanta Dream,4.5,-110,1021800109,34,53,87,19,away,1,0,0,0,0,0,0,home,34,19
7/7/2018,301,WMWashington Mystics,83,160,-110,WAS,Washington Mystics,6,-105,1021800110,35,30,65,-5,home,1,1,1,1,0,0,0,away,30,5
7/7/2018,302,LSL.A. Sparks,74,160,-110,LAS,Los Angeles Sparks,-6,-115,1021800110,35,30,65,-5,home,0,0,0,0,1,1,1,home,35,-5
7/7/2018,303,MLMinnesota Lynx,63,169,-110,MIN,Minnesota Lynx,-8.5,-110,1021800111,42,37,79,-5,home,0,0,0,1,0,0,0,away,37,5
7/7/2018,304,CSChicago Sky,77,169,-110,CHI,Chicago Sky,8.5,-110,1021800111,42,37,79,-5,home,1,1,1,0,1,1,1,home,42,-5
7/7/2018,305,CSConnecticut Sun,90,169,-110,CON,Connecticut Sun,-4.5,-110,1021800112,41,40,81,-1,home,0,0,0,0,0,0,1,away,40,1
7/7/2018,306,LVLas Vegas Aces,94,168,105,LVA,Las Vegas Aces,4.5,-110,1021800112,41,40,81,-1,home,1,1,1,1,1,1,0,home,41,-1
7/8/2018,307,PPhoenix,70,161,-130,PHO,Phoenix Mercury,-4.5,-105,1021800113,44,33,77,-11,home,0,0,0,0,0,0,0,away,33,11
7/8/2018,308,ADAtlanta Dream,76,161,110,ATL,Atlanta Dream,4.5,-115,1021800113,44,33,77,-11,home,1,1,1,1,1,1,1,home,44,-11
7/8/2018,309,DWDallas Wings,97,164.5,-124,DAL,Dallas Wings,-3,-110,1021800114,37,47,84,10,away,1,1,1,1,1,1,1,away,47,-10
7/8/2018,310,NYNew York Liberty,87,164.5,104,NYL,New York Liberty,3.5,-125,1021800114,37,47,84,10,away,0,0,0,0,0,0,0,home,37,10
7/8/2018,311,WMWashington Mystics,91,171.5,-110,WAS,Washington Mystics,6,-110,1021800115,44,46,90,2,away,0,0,1,0,1,1,1,away,46,-2
7/8/2018,312,SSSeattle Storm,97,171.5,-110,SEA,Seattle Storm,-6,-110,1021800115,44,46,90,2,away,1,1,0,1,0,0,0,home,44,2
7/10/2018,313,LSL.A. Sparks,77,161,-110,LAS,Los Angeles Sparks,3,-110,1021800116,34,36,70,2,away,0,1,1,1,1,1,1,away,36,-2
7/10/2018,314,SSSeattle Storm,75,161,-110,SEA,Seattle Storm,-3,-110,1021800116,34,36,70,2,away,1,0,0,0,0,0,0,home,34,2
7/10/2018,315,PPhoenix,72,171,-110,PHO,Phoenix Mercury,2.5,-110,1021800117,59,39,98,-20,home,0,0,0,0,0,0,0,away,39,20
7/10/2018,316,DWDallas Wings,101,171,-110,DAL,Dallas Wings,-2.5,-110,1021800117,59,39,98,-20,home,1,1,1,1,1,1,1,home,59,-20
7/10/2018,317,LVLas Vegas Aces,98,175.5,-110,LVA,Las Vegas Aces,4,-110,1021800118,36,49,85,13,away,0,0,0,0,1,1,1,away,49,-13
7/10/2018,318,CSChicago Sky,74,175.5,-110,CHI,Chicago Sky,-4,-110,1021800118,36,49,85,13,away,1,1,1,1,0,0,0,home,36,13
7/12/2018,601,DWDallas Wings,92,164,-110,DAL,Dallas Wings,6,-110,1021800122,50,48,98,-2,home,1,1,1,1,1,1,1,away,48,2
7/12/2018,602,LSL.A. Sparks,77,164,-110,LAS,Los Angeles Sparks,-6,-110,1021800122,50,48,98,-2,home,0,0,0,0,0,0,0,home,50,-2
8/3/2018,607,CSChicago Sky,74,170,-110,CHI,Chicago Sky,8.5,-110,1021800161,42,43,85,1,away,0,0,0,0,0,0,0,away,43,-1
8/3/2018,608,ADAtlanta Dream,89,170,-110,ATL,Atlanta Dream,-8.5,-110,1021800161,42,43,85,1,away,1,1,1,1,1,1,1,home,42,1
8/3/2018,609,MLMinnesota Lynx,75,163,-110,MIN,Minnesota Lynx,5.5,-110,1021800163,37,38,75,1,away,1,0,1,1,1,1,1,away,38,-1
8/3/2018,610,SSSeattle Storm,85,163,-110,SEA,Seattle Storm,-5.5,-110,1021800163,37,38,75,1,away,0,1,0,0,0,0,0,home,37,1
8/3/2018,605,LVLas Vegas Aces,NA,169.5,-110,LVA,Las Vegas Aces,9,-110,NA,NA,NA,NA,NA,NA,NA,NA,NA,NA,NA,NA,NA,NA,NA,NA
8/3/2018,606,WMWashington Mystics,NA,169.5,-110,WAS,Washington Mystics,-9,-110,NA,NA,NA,NA,NA,NA,NA,NA,NA,NA,NA,NA,NA,NA,NA,NA
8/4/2018,301,IFIndiana Fever,68,161.5,-110,IND,Indiana Fever,7,-110,1021800164,35,31,66,-4,home,0,0,0,0,0,0,0,away,31,4
8/4/2018,302,NYNew York Liberty,55,161.5,-110,NYL,New York Liberty,-7,-110,1021800164,35,31,66,-4,home,1,1,1,1,1,1,1,home,35,-4
8/5/2018,303,LVLas Vegas Aces,88,173,-110,LVA,Las Vegas Aces,8.5,-110,1021800165,64,49,113,-15,home,0,0,0,0,0,0,0,away,49,15
8/5/2018,304,CSConnecticut Sun,109,172.5,-110,CON,Connecticut Sun,-8.5,-110,1021800165,64,49,113,-15,home,1,1,1,1,1,1,1,home,64,-15
8/5/2018,305,WMWashington Mystics,76,171,-110,WAS,Washington Mystics,-3.5,-110,1021800166,38,43,81,5,away,0,1,1,0,1,1,1,away,43,-5
8/5/2018,306,DWDallas Wings,74,171,-110,DAL,Dallas Wings,3.5,-110,1021800166,38,43,81,5,away,1,0,0,1,0,0,0,home,38,5
8/5/2018,309,PPhoenix,75,161,-110,PHO,Phoenix Mercury,7.5,-110,1021800167,40,30,70,-10,home,0,0,0,0,0,0,0,away,30,10
8/5/2018,310,LSL.A. Sparks,78,161,-110,LAS,Los Angeles Sparks,-7.5,-110,1021800167,40,30,70,-10,home,1,1,1,1,1,1,1,home,40,-10
8/5/2018,307,ADAtlanta Dream,86,155.5,-110,ATL,Atlanta Dream,6,-110,1021800168,34,49,83,15,away,0,1,1,0,1,1,1,away,49,-15
8/5/2018,308,MLMinnesota Lynx,66,155.5,-110,MIN,Minnesota Lynx,-6,-110,1021800168,34,49,83,15,away,1,0,0,1,0,0,0,home,34,15
8/6/2018,311,SSSeattle Storm,96,163,-110,SEA,Seattle Storm,-10,-110,1021800169,44,44,88,0,tie,0,0,1,1,1,1,0,away,44,-0
8/6/2018,312,NYNew York Liberty,80,163,-110,NYL,New York Liberty,9.5,-110,1021800169,44,44,88,0,tie,1,1,0,0,0,0,1,home,44,0
8/8/2018,609,LSL.A. Sparks,82,155,-110,LAS,Los Angeles Sparks,-9,-110,1021800174,41,41,82,0,tie,0,0,0,0,0,0,1,away,41,-0
8/8/2018,610,NYNew York Liberty,81,155,-110,NYL,New York Liberty,9,-110,1021800174,41,41,82,0,tie,1,1,1,1,1,1,0,home,41,0
8/8/2018,611,CSConnecticut Sun,101,175,-110,CON,Connecticut Sun,-2,-110,1021800175,32,48,80,16,away,0,1,1,1,1,1,1,away,48,-16
8/8/2018,612,DWDallas Wings,92,175,-110,DAL,Dallas Wings,2,-110,1021800175,32,48,80,16,away,1,0,0,0,0,0,0,home,32,16
8/9/2018,613,SSSeattle Storm,77,172,-110,SEA,Seattle Storm,-0.5,-110,1021800176,57,40,97,-17,home,0,0,0,0,0,0,0,away,40,17
8/9/2018,614,WMWashington Mystics,100,172,-110,WAS,Washington Mystics,-1,-120,1021800176,57,40,97,-17,home,1,1,1,1,1,1,1,home,57,-17
8/9/2018,615,LSL.A. Sparks,73,155.5,-110,LAS,Los Angeles Sparks,-1.5,-110,1021800177,36,33,69,-3,home,1,1,0,1,1,0,0,away,33,3
8/9/2018,616,ADAtlanta Dream,79,155.5,-110,ATL,Atlanta Dream,1.5,-110,1021800177,36,33,69,-3,home,0,0,1,0,0,1,1,home,36,-3
8/9/2018,617,MLMinnesota Lynx,89,167.5,-110,MIN,Minnesota Lynx,1.5,-115,1021800178,37,43,80,6,away,0,0,1,1,1,1,1,away,43,-6
8/9/2018,618,LVLas Vegas Aces,73,167.5,-110,LVA,Las Vegas Aces,-1.5,-105,1021800178,37,43,80,6,away,1,1,0,0,0,0,0,home,37,6
8/10/2018,301,CSConnecticut Sun,86,178.5,-110,CON,Connecticut Sun,-9.5,-110,1021800179,54,38,92,-16,home,0,0,0,0,0,0,0,away,38,16
8/10/2018,302,CSChicago Sky,97,178.5,-110,CHI,Chicago Sky,9.5,-110,1021800179,54,38,92,-16,home,1,1,1,1,1,1,1,home,54,-16
8/10/2018,303,IFIndiana Fever,74,168,-110,IND,Indiana Fever,12.5,-115,1021800180,43,29,72,-14,home,0,0,0,0,0,0,0,away,29,14
8/10/2018,304,PPhoenix,94,168,-110,PHO,Phoenix Mercury,-12.5,-110,1021800180,43,29,72,-14,home,1,1,1,1,1,1,1,home,43,-14
8/11/2018,305,DWDallas Wings,82,166,-110,DAL,Dallas Wings,6.5,-110,1021800181,49,39,88,-10,home,0,0,0,0,0,0,0,away,39,10
8/11/2018,306,ADAtlanta Dream,92,166,-110,ATL,Atlanta Dream,-6.5,-110,1021800181,49,39,88,-10,home,1,1,1,1,1,1,1,home,49,-10
8/11/2018,307,IFIndiana Fever,74,166,-110,IND,Indiana Fever,10.5,-110,1021800182,51,40,91,-11,home,0,0,0,0,0,0,0,away,40,11
8/11/2018,308,LVLas Vegas Aces,92,166,-110,LVA,Las Vegas Aces,-10.5,-110,1021800182,51,40,91,-11,home,1,1,1,1,1,1,1,home,51,-11
8/12/2018,601,ADAtlanta Dream,86,159.5,-110,ATL,Atlanta Dream,-5.5,-115,1021800183,48,37,85,-11,home,0,1,0,0,0,0,0,away,37,11
8/12/2018,602,NYNew York Liberty,77,159.5,-110,NYL,New York Liberty,5.5,-105,1021800183,48,37,85,-11,home,1,0,1,1,1,1,1,home,48,-11
8/12/2018,605,CSChicago Sky,75,178.5,-110,CHI,Chicago Sky,12,-110,1021800184,35,38,73,3,away,1,0,0,0,0,1,1,away,38,-3
8/12/2018,606,CSConnecticut Sun,82,178.5,-110,CON,Connecticut Sun,-12,-110,1021800184,35,38,73,3,away,0,1,1,1,1,0,0,home,35,3
8/12/2018,603,DWDallas Wings,80,174,-110,DAL,Dallas Wings,10.5,-110,1021800185,51,37,88,-14,home,0,0,0,0,0,0,0,away,37,14
8/12/2018,604,WMWashington Mystics,93,174,-110,WAS,Washington Mystics,-10.5,-110,1021800185,51,37,88,-14,home,1,1,1,1,1,1,1,home,51,-14
8/12/2018,609,LSL.A. Sparks,78,162,-110,LAS,Los Angeles Sparks,-3,-110,1021800186,41,34,75,-7,home,1,1,1,1,1,0,0,away,34,7
8/12/2018,610,PPhoenix,86,162,-110,PHO,Phoenix Mercury,3,-110,1021800186,41,34,75,-7,home,0,0,0,0,0,1,1,home,41,-7
8/12/2018,607,SSSeattle Storm,81,163.5,-110,SEA,Seattle Storm,-3,-110,1021800187,30,35,65,5,away,1,1,1,1,1,1,1,away,35,-5
8/12/2018,608,MLMinnesota Lynx,72,163.5,-110,MIN,Minnesota Lynx,3,-110,1021800187,30,35,65,5,away,0,0,0,0,0,0,0,home,30,5
8/14/2018,611,DWDallas Wings,76,178,-110,DAL,Dallas Wings,7,-110,1021800188,50,38,88,-12,home,1,0,0,0,0,0,0,away,38,12
8/14/2018,612,CSConnecticut Sun,96,178,-110,CON,Connecticut Sun,-7,-110,1021800188,50,38,88,-12,home,0,1,1,1,1,1,1,home,50,-12
8/14/2018,613,CSChicago Sky,91,164,-110,CHI,Chicago Sky,9.5,-115,1021800189,44,39,83,-5,home,1,0,1,0,0,0,0,away,39,5
8/14/2018,614,MLMinnesota Lynx,88,164,-110,MIN,Minnesota Lynx,-9.5,-105,1021800189,44,39,83,-5,home,0,1,0,1,1,1,1,home,44,-5
8/14/2018,615,NYNew York Liberty,66,154,-110,NYL,New York Liberty,13.5,-110,1021800190,38,44,82,6,away,0,1,0,1,1,1,1,away,44,-6
8/14/2018,616,LSL.A. Sparks,74,154,-110,LAS,Los Angeles Sparks,-13.5,-110,1021800190,38,44,82,6,away,1,0,1,0,0,0,0,home,38,6
8/15/2018,301,WMWashington Mystics,76,165.5,-110,WAS,Washington Mystics,-11,-110,1021800191,41,48,89,7,away,1,1,1,1,1,1,1,away,48,-7
8/15/2018,302,IFIndiana Fever,62,165.5,-110,IND,Indiana Fever,11,-110,1021800191,41,48,89,7,away,0,0,0,0,0,0,0,home,41,7
8/15/2018,303,NYNew York Liberty,72,168.5,-110,NYL,New York Liberty,13.5,-105,1021800192,46,33,79,-13,home,0,0,0,0,0,0,0,away,33,13
8/15/2018,304,LVLas Vegas Aces,85,168.5,-110,LVA,Las Vegas Aces,-13,-110,1021800192,46,33,79,-13,home,1,1,1,1,1,1,1,home,46,-13
8/18/2018,315,CSChicago Sky,115,166.5,-110,CHI,Chicago Sky,-3.5,-110,1021800198,37,40,77,3,away,0,1,1,1,0,1,1,away,40,-3
8/18/2018,316,IFIndiana Fever,106,166.5,-110,IND,Indiana Fever,3.5,-110,1021800198,37,40,77,3,away,1,0,0,0,1,0,0,home,37,3
8/19/2018,601,LSL.A. Sparks,86,161,-110,LAS,Los Angeles Sparks,5.5,-110,1021800199,52,41,93,-11,home,0,0,0,0,0,0,0,away,41,11
8/19/2018,602,CSConnecticut Sun,89,161,-110,CON,Connecticut Sun,-5.5,-110,1021800199,52,41,93,-11,home,1,1,1,1,1,1,1,home,52,-11
8/19/2018,605,NYNew York Liberty,85,167.5,-110,NYL,New York Liberty,12,-110,1021800201,49,46,95,-3,home,1,1,0,0,1,0,1,away,46,3
8/19/2018,606,PPhoenix,96,167.5,-110,PHO,Phoenix Mercury,-12,-110,1021800201,49,46,95,-3,home,0,0,1,1,0,1,0,home,49,-3
8/19/2018,603,ADAtlanta Dream,93,175,-110,ATL,Atlanta Dream,-5,-110,1021800200,47,41,88,-6,home,1,1,1,0,0,0,0,away,41,6
8/19/2018,604,LVLas Vegas Aces,78,175,-110,LVA,Las Vegas Aces,5,-110,1021800200,47,41,88,-6,home,0,0,0,1,1,1,1,home,47,-6
8/19/2018,607,IFIndiana Fever,97,167,-110,IND,Indiana Fever,8.5,-110,1021800202,54,47,101,-7,home,0,0,0,0,0,0,0,away,47,7
8/19/2018,608,CSChicago Sky,92,167,-110,CHI,Chicago Sky,-8.5,-110,1021800202,54,47,101,-7,home,1,1,1,1,1,1,1,home,54,-7
8/19/2018,611,WMWashington Mystics,83,158,-110,WAS,Washington Mystics,-2,-115,1021800204,44,43,87,-1,home,1,1,1,0,1,0,1,away,43,1
8/19/2018,612,MLMinnesota Lynx,88,158,-110,MIN,Minnesota Lynx,2,-105,1021800204,44,43,87,-1,home,0,0,0,1,0,1,0,home,44,-1
8/19/2018,609,DWDallas Wings,68,172.5,-110,DAL,Dallas Wings,6.5,-110,1021800203,57,45,102,-12,home,0,0,0,0,0,0,0,away,45,12
8/19/2018,610,SSSeattle Storm,84,172.5,-110,SEA,Seattle Storm,-6.5,-110,1021800203,57,45,102,-12,home,1,1,1,1,1,1,1,home,57,-12
6/30/2018,315,PPhoenix,84,NA,NA,PHO,Phoenix Mercury,3.5,-110,1021800094,35,39,74,4,away,0,1,1,1,1,0,1,away,39,-4
6/30/2018,316,WMWashington Mystics,74,NA,NA,WAS,Washington Mystics,-3.5,-110,1021800094,35,39,74,4,away,1,0,0,0,0,1,0,home,35,4
6/30/2019,621,NYNew York Liberty,74,159.5,-110,NYL,New York Liberty,4,-110,1021900069,28,39,67,11,away,1,1,1,1,1,1,1,away,39,-11
6/30/2019,622,ADAtlanta Dream,58,159.5,-110,ATL,Atlanta Dream,-4,-110,1021900069,28,39,67,11,away,0,0,0,0,0,0,0,home,28,11
6/30/2019,623,MLMinnesota Lynx,86,145.5,-110,MIN,Minnesota Lynx,-2.5,-110,1021900070,41,53,94,12,away,0,1,1,1,1,1,1,away,53,-12
6/30/2019,624,DWDallas Wings,89,145.5,-110,DAL,Dallas Wings,2.5,-110,1021900070,41,53,94,12,away,1,0,0,0,0,0,0,home,41,12
6/30/2019,625,CSChicago Sky,69,159.5,-110,CHI,Chicago Sky,5.5,-110,1021900071,48,36,84,-12,home,0,0,0,0,0,0,0,away,36,12
6/30/2019,626,LSL.A. Sparks,94,159.5,-110,LAS,Los Angeles Sparks,-5.5,-110,1021900071,48,36,84,-12,home,1,1,1,1,1,1,1,home,48,-12
6/30/2019,627,PPhoenix,69,149,-110,PHO,Phoenix Mercury,1,-110,1021900072,33,34,67,1,away,1,1,1,1,1,0,1,away,34,-1
6/30/2019,628,SSSeattle Storm,67,149,-110,SEA,Seattle Storm,-1,-110,1021900072,33,34,67,1,away,0,0,0,0,0,1,0,home,33,1
7/17/2019,625,DWDallas Wings,64,148.5,-110,DAL,Dallas Wings,6.5,-110,1021900102,31,34,65,3,away,1,0,0,0,1,1,0,away,34,-3
7/17/2019,626,PPhoenix,69,148,-110,PHO,Phoenix Mercury,-6.5,-110,1021900102,31,34,65,3,away,0,1,1,1,0,0,1,home,31,3
7/17/2019,627,SSSeattle Storm,90,147,-110,SEA,Seattle Storm,5.5,-110,1021900103,40,50,90,10,away,1,1,1,1,1,1,1,away,50,-10
7/17/2019,628,MLMinnesota Lynx,79,147,-110,MIN,Minnesota Lynx,-5.5,-110,1021900103,40,50,90,10,away,0,0,0,0,0,0,0,home,40,10
8/18/2019,631,DWDallas Wings,68,149,-110,DAL,Dallas Wings,9.5,-110,1021900155,37,34,71,-3,home,0,0,0,0,1,0,0,away,34,3
8/18/2019,632,CSConnecticut Sun,78,149,-110,CON,Connecticut Sun,-9.5,-110,1021900155,37,34,71,-3,home,1,1,1,1,0,1,1,home,37,-3
8/18/2019,629,IFIndiana Fever,68,165,-110,IND,Indiana Fever,13.5,-110,1021900156,43,34,77,-9,home,0,0,0,0,0,0,0,away,34,9
8/18/2019,630,WMWashington Mystics,107,165,-110,WAS,Washington Mystics,-13.5,-110,1021900156,43,34,77,-9,home,1,1,1,1,1,1,1,home,43,-9
8/18/2019,635,LVLas Vegas Aces,100,168.5,-110,LVA,Las Vegas Aces,-2,-110,1021900157,41,47,88,6,away,0,1,0,0,0,1,1,away,47,-6
8/18/2019,636,CSChicago Sky,85,168.5,-110,CHI,Chicago Sky,2,-110,1021900157,41,47,88,6,away,1,0,1,1,1,0,0,home,41,6
8/18/2019,633,NYNew York Liberty,72,156.5,-110,NYL,New York Liberty,5,-110,1021900158,35,29,64,-6,home,1,1,0,0,0,0,0,away,29,6
8/18/2019,634,PPhoenix,78,156.5,-110,PHO,Phoenix Mercury,-5,-110,1021900158,35,29,64,-6,home,0,0,1,1,1,1,1,home,35,-6
8/18/2019,637,MLMinnesota Lynx,74,150.5,-110,MIN,Minnesota Lynx,3.5,-110,1021900159,48,39,87,-9,home,0,0,0,0,0,0,0,away,39,9
8/18/2019,638,SSSeattle Storm,82,150.5,-110,SEA,Seattle Storm,-3.5,-110,1021900159,48,39,87,-9,home,1,1,1,1,1,1,1,home,48,-9
5/25/2019,605,PPhoenix,68,158,-110,PHO,Phoenix Mercury,-3.5,-115,1021900003,32,32,64,0,tie,0,1,1,1,1,0,0,away,32,-0
5/25/2019,606,SSSeattle Storm,77,158,-110,SEA,Seattle Storm,3.5,-105,1021900003,32,32,64,0,tie,1,0,0,0,0,1,1,home,32,0
5/25/2019,607,WMWashington Mystics,69,166.5,-110,WAS,Washington Mystics,5.5,-110,1021900004,44,41,85,-3,home,1,0,0,0,0,1,0,away,41,3
5/25/2019,608,CSConnecticut Sun,84,166.5,-110,CON,Connecticut Sun,-5.5,-110,1021900004,44,41,85,-3,home,0,1,1,1,1,0,1,home,44,-3
5/25/2019,609,CSChicago Sky,71,162,-110,CHI,Chicago Sky,4,-110,1021900005,46,40,86,-6,home,0,0,1,1,0,0,0,away,40,6
5/25/2019,610,MLMinnesota Lynx,89,161.5,102,MIN,Minnesota Lynx,-4,-110,1021900005,46,40,86,-6,home,1,1,0,0,1,1,1,home,46,-6
6/19/2019,641,IFIndiana Fever,78,150,-110,IND,Indiana Fever,-1,-110,1021900046,45,44,89,-1,home,1,1,0,1,0,0,1,away,44,1
6/19/2019,642,ADAtlanta Dream,88,150,-110,ATL,Atlanta Dream,-1.5,-125,1021900046,45,44,89,-1,home,0,0,1,0,1,1,0,home,45,-1
6/19/2019,643,CSChicago Sky,91,164,-110,CHI,Chicago Sky,2,-110,1021900047,34,41,75,7,away,1,1,1,1,1,1,1,away,41,-7
6/19/2019,644,NYNew York Liberty,83,164,-110,NYL,New York Liberty,-2,-110,1021900047,34,41,75,7,away,0,0,0,0,0,0,0,home,34,7
7/13/2019,611,LVLas Vegas Aces,85,163,-110,LVA,Las Vegas Aces,2.5,-110,1021900095,44,43,87,-1,home,0,0,0,0,0,0,0,away,43,1
7/13/2019,612,WMWashington Mystics,81,163,-110,WAS,Washington Mystics,-2.5,-110,1021900095,44,43,87,-1,home,1,1,1,1,1,1,1,home,44,-1
7/30/2019,613,CSChicago Sky,94,161.5,-110,CHI,Chicago Sky,7,-110,1021900118,57,43,100,-14,home,0,0,0,1,0,0,0,away,43,14
7/30/2019,614,CSConnecticut Sun,100,161.5,-110,CON,Connecticut Sun,-7,-112,1021900118,57,43,100,-14,home,1,1,1,0,1,1,1,home,57,-14
7/30/2019,611,PPhoenix,93,158,-110,PHO,Phoenix Mercury,10.5,-110,1021900119,48,38,86,-10,home,0,0,0,0,0,0,0,away,38,10
7/30/2019,612,WMWashington Mystics,99,158,-115,WAS,Washington Mystics,-10.5,-110,1021900119,48,38,86,-10,home,1,1,1,1,1,1,1,home,48,-10
7/30/2019,615,DWDallas Wings,54,150.5,-110,DAL,Dallas Wings,12,-110,1021900120,42,27,69,-15,home,0,0,0,0,0,0,0,away,27,15
7/30/2019,616,LVLas Vegas Aces,86,150.5,-110,LVA,Las Vegas Aces,-12,-105,1021900120,42,27,69,-15,home,1,1,1,1,1,1,1,home,42,-15
8/11/2019,601,MLMinnesota Lynx,78,160,-110,MIN,Minnesota Lynx,8,-115,1021900142,51,41,92,-10,home,0,0,0,0,0,0,0,away,41,10
8/11/2019,602,WMWashington Mystics,101,160,-110,WAS,Washington Mystics,-8,-105,1021900142,51,41,92,-10,home,1,1,1,1,1,1,1,home,51,-10
8/11/2019,603,SSSeattle Storm,84,154.5,-110,SEA,Seattle Storm,-4,-110,1021900141,45,43,88,-2,home,0,0,1,1,1,1,1,away,43,2
8/11/2019,604,NYNew York Liberty,69,154.5,-110,NYL,New York Liberty,4,-110,1021900141,45,43,88,-2,home,1,1,0,0,0,0,0,home,45,-2
8/11/2019,605,CSChicago Sky,81,162.5,-110,CHI,Chicago Sky,7,-110,1021900143,39,44,83,5,away,1,1,1,1,1,1,1,away,44,-5
8/11/2019,606,LSL.A. Sparks,84,162,-115,LAS,Los Angeles Sparks,-7,-110,1021900143,39,44,83,5,away,0,0,0,0,0,0,0,home,39,5
8/11/2019,607,CSConnecticut Sun,81,159.5,-110,CON,Connecticut Sun,2.5,-105,1021900144,42,42,84,0,tie,0,0,1,1,1,1,1,away,42,-0
8/11/2019,608,LVLas Vegas Aces,89,159.5,-110,LVA,Las Vegas Aces,-2.5,-115,1021900144,42,42,84,0,tie,1,1,0,0,0,0,0,home,42,0
8/16/2019,619,SSSeattle Storm,78,150.5,-113,SEA,Seattle Storm,6.5,-115,1021900150,34,46,80,12,away,0,0,0,1,1,1,1,away,46,-12
8/16/2019,620,CSConnecticut Sun,79,150.5,-107,CON,Connecticut Sun,-6.5,-105,1021900150,34,46,80,12,away,1,1,1,0,0,0,0,home,34,12
8/16/2019,625,WMWashington Mystics,86,162.5,-110,WAS,Washington Mystics,-6,-110,1021900153,41,39,80,-2,home,1,1,0,0,0,0,0,away,39,2
8/16/2019,626,MLMinnesota Lynx,79,162.5,-110,MIN,Minnesota Lynx,6,-110,1021900153,41,39,80,-2,home,0,0,1,1,1,1,1,home,41,-2
8/16/2019,623,LSL.A. Sparks,81,165.5,-110,LAS,Los Angeles Sparks,-1.5,-110,1021900151,45,37,82,-8,home,0,0,0,0,0,0,0,away,37,8
8/16/2019,624,CSChicago Sky,91,165.5,-110,CHI,Chicago Sky,1.5,-110,1021900151,45,37,82,-8,home,1,1,1,1,1,1,1,home,45,-8
8/16/2019,621,NYNew York Liberty,77,151.5,-110,NYL,New York Liberty,4,-110,1021900152,42,36,78,-6,home,1,1,0,0,0,0,0,away,36,6
8/16/2019,622,DWDallas Wings,83,151.5,-110,DAL,Dallas Wings,-4,-110,1021900152,42,36,78,-6,home,0,0,1,1,1,1,1,home,42,-6
8/16/2019,627,ADAtlanta Dream,68,149.5,-110,ATL,Atlanta Dream,3.5,-110,1021900154,35,39,74,4,away,1,1,1,1,1,0,0,away,39,-4
8/16/2019,628,PPhoenix,77,149.5,-110,PHO,Phoenix Mercury,-3.5,-110,1021900154,35,39,74,4,away,0,0,0,0,0,1,1,home,35,4
8/20/2019,639,NYNew York Liberty,82,159,-110,NYL,New York Liberty,5,-110,1021900161,37,43,80,6,away,1,1,1,1,1,1,1,away,43,-6
8/20/2019,640,IFIndiana Fever,76,159,-110,IND,Indiana Fever,-5,-110,1021900161,37,43,80,6,away,0,0,0,0,0,0,0,home,37,6
8/20/2019,641,CSChicago Sky,87,165,-110,CHI,Chicago Sky,-5.5,-110,1021900160,44,36,80,-8,home,1,1,1,0,0,0,0,away,36,8
8/20/2019,642,ADAtlanta Dream,83,165,-110,ATL,Atlanta Dream,5.5,-110,1021900160,44,36,80,-8,home,0,0,0,1,1,1,1,home,44,-8
8/20/2019,643,PPhoenix,79,159.5,-110,PHO,Phoenix Mercury,8.5,-110,1021900162,38,38,76,0,tie,0,0,0,0,0,0,0,away,38,-0
8/20/2019,644,LVLas Vegas Aces,84,159.5,-110,LVA,Las Vegas Aces,-8.5,-110,1021900162,38,38,76,0,tie,1,1,1,1,1,1,1,home,38,0
8/20/2019,645,MLMinnesota Lynx,71,156,-110,MIN,Minnesota Lynx,6,-110,1021900163,49,32,81,-17,home,1,0,0,0,0,0,0,away,32,17
8/20/2019,646,LSL.A. Sparks,81,156,-110,LAS,Los Angeles Sparks,-6,-110,1021900163,49,32,81,-17,home,0,1,1,1,1,1,1,home,49,-17
8/22/2019,647,DWDallas Wings,70,148.5,-110,DAL,Dallas Wings,7.5,-105,1021900164,47,32,79,-15,home,0,0,0,0,0,0,0,away,32,15
8/22/2019,648,MLMinnesota Lynx,86,148.5,-110,MIN,Minnesota Lynx,-7.5,-115,1021900164,47,32,79,-15,home,1,1,1,1,1,1,1,home,47,-15
8/22/2019,649,IFIndiana Fever,65,160,-110,IND,Indiana Fever,9.5,-110,1021900165,43,31,74,-12,home,1,1,1,0,0,0,0,away,31,12
8/22/2019,650,LSL.A. Sparks,98,159.5,-112,LAS,Los Angeles Sparks,-9.5,-110,1021900165,43,31,74,-12,home,0,0,0,1,1,1,1,home,43,-12
8/23/2019,601,ADAtlanta Dream,90,158,-110,ATL,Atlanta Dream,3,-110,1021900167,51,46,97,-5,home,1,0,0,0,0,0,0,away,46,5
8/23/2019,602,NYNew York Liberty,87,158,-110,NYL,New York Liberty,-3,-110,1021900167,51,46,97,-5,home,0,1,1,1,1,1,1,home,51,-5
8/23/2019,603,LVLas Vegas Aces,85,163.5,-110,LVA,Las Vegas Aces,1.5,-110,1021900166,47,56,103,9,away,0,0,0,0,0,0,1,away,56,-9
8/23/2019,604,CSConnecticut Sun,89,163.5,-110,CON,Connecticut Sun,-1.5,-110,1021900166,47,56,103,9,away,1,1,1,1,1,1,0,home,47,9
8/23/2019,605,WMWashington Mystics,78,175,-110,WAS,Washington Mystics,-6.5,-115,1021900168,42,49,91,7,away,1,0,0,0,0,1,1,away,49,-7
8/23/2019,606,CSChicago Sky,85,175,-110,CHI,Chicago Sky,6.5,-105,1021900168,42,49,91,7,away,0,1,1,1,1,0,0,home,42,7
8/25/2019,607,NYNew York Liberty,72,171,-115,NYL,New York Liberty,15.5,-105,1021900169,47,31,78,-16,home,0,0,0,0,0,0,0,away,31,16
8/25/2019,608,WMWashington Mystics,101,171,-105,WAS,Washington Mystics,-15.5,-115,1021900169,47,31,78,-16,home,1,1,1,1,1,1,1,home,47,-16
8/25/2019,609,ADAtlanta Dream,77,148.5,-110,ATL,Atlanta Dream,5,-108,1021900170,30,42,72,12,away,1,1,1,1,1,1,1,away,42,-12
8/25/2019,610,DWDallas Wings,73,148.5,-110,DAL,Dallas Wings,-5,-112,1021900170,30,42,72,12,away,0,0,0,0,0,0,0,home,30,12
8/25/2019,611,CSConnecticut Sun,72,157.5,-115,CON,Connecticut Sun,5,-110,1021900171,42,39,81,-3,home,1,1,1,1,0,0,0,away,39,3
8/25/2019,612,LSL.A. Sparks,84,157.5,-105,LAS,Los Angeles Sparks,-5,-110,1021900171,42,39,81,-3,home,0,0,0,0,1,1,1,home,42,-3
8/25/2019,613,CSChicago Sky,94,167,-110,CHI,Chicago Sky,4,-110,1021900172,54,46,100,-8,home,1,1,0,0,0,0,0,away,46,8
8/25/2019,614,PPhoenix,86,167,-110,PHO,Phoenix Mercury,-4,-110,1021900172,54,46,100,-8,home,0,0,1,1,1,1,1,home,54,-8
8/25/2019,617,LVLas Vegas Aces,77,159,-110,LVA,Las Vegas Aces,-3.5,-105,1021900173,45,43,88,-2,home,0,0,0,0,0,0,1,away,43,2
8/25/2019,618,MLMinnesota Lynx,98,159,-110,MIN,Minnesota Lynx,3.5,-115,1021900173,45,43,88,-2,home,1,1,1,1,1,1,0,home,45,-2
8/25/2019,615,IFIndiana Fever,63,152,-110,IND,Indiana Fever,10,-110,1021900174,26,33,59,7,away,0,1,1,1,1,1,1,away,33,-7
8/25/2019,616,SSSeattle Storm,54,152,-110,SEA,Seattle Storm,-10,-110,1021900174,26,33,59,7,away,1,0,0,0,0,0,0,home,26,7
8/27/2019,623,LSL.A. Sparks,66,166.5,-110,LAS,Los Angeles Sparks,7.5,-115,1021900177,54,37,91,-17,home,0,0,0,0,0,0,0,away,37,17
8/27/2019,624,WMWashington Mystics,95,166.5,-110,WAS,Washington Mystics,-7.5,-110,1021900177,54,37,91,-17,home,1,1,1,1,1,1,1,home,54,-17
8/27/2019,621,LVLas Vegas Aces,71,162.5,-110,LVA,Las Vegas Aces,-7,-110,1021900175,53,33,86,-20,home,0,0,0,0,0,0,0,away,33,20
8/27/2019,622,IFIndiana Fever,86,162.5,-110,IND,Indiana Fever,7,-110,1021900175,53,33,86,-20,home,1,1,1,1,1,1,1,home,53,-20
8/27/2019,619,PPhoenix,95,160.5,-110,PHO,Phoenix Mercury,-6,-115,1021900176,46,49,95,3,away,1,1,1,1,1,1,1,away,49,-3
8/27/2019,620,NYNew York Liberty,82,160.5,-110,NYL,New York Liberty,6,-105,1021900176,46,49,95,3,away,0,0,0,0,0,0,0,home,46,3
8/27/2019,625,CSChicago Sky,85,168.5,-110,CHI,Chicago Sky,3.5,-110,1021900178,51,42,93,-9,home,0,0,0,1,0,0,0,away,42,9
8/27/2019,626,MLMinnesota Lynx,93,168.5,-110,MIN,Minnesota Lynx,-3.5,-110,1021900178,51,42,93,-9,home,1,1,1,0,1,1,1,home,51,-9
8/27/2019,627,CSConnecticut Sun,89,150,-110,CON,Connecticut Sun,2,-110,1021900179,36,44,80,8,away,0,1,1,1,1,1,1,away,44,-8
8/27/2019,628,SSSeattle Storm,70,150,-110,SEA,Seattle Storm,-2,-110,1021900179,36,44,80,8,away,1,0,0,0,0,0,0,home,36,8
8/29/2019,633,PPhoenix,65,157,-110,PHO,Phoenix Mercury,-6,-110,1021900182,25,29,54,4,away,1,1,1,1,1,1,1,away,29,-4
8/29/2019,634,ADAtlanta Dream,58,157,-110,ATL,Atlanta Dream,6,-110,1021900182,25,29,54,4,away,0,0,0,0,0,0,0,home,25,4
8/29/2019,629,LSL.A. Sparks,87,158.5,-110,LAS,Los Angeles Sparks,-5.5,-110,1021900180,42,33,75,-9,home,0,0,0,0,0,0,0,away,33,9
8/29/2019,630,IFIndiana Fever,83,158.5,-110,IND,Indiana Fever,5.5,-110,1021900180,42,33,75,-9,home,1,1,1,1,1,1,1,home,42,-9
8/29/2019,631,DWDallas Wings,88,159,-110,DAL,Dallas Wings,11.5,-110,1021900181,35,38,73,3,away,0,1,1,1,1,1,1,away,38,-3
8/29/2019,632,CSChicago Sky,83,159,-110,CHI,Chicago Sky,-11.5,-110,1021900181,35,38,73,3,away,1,0,0,0,0,0,0,home,35,3
8/30/2019,635,CSConnecticut Sun,94,163,-110,CON,Connecticut Sun,-10.5,-110,1021900183,41,50,91,9,away,0,1,1,1,1,1,1,away,50,-9
8/30/2019,636,NYNew York Liberty,84,163,-110,NYL,New York Liberty,10.5,-110,1021900183,41,50,91,9,away,1,0,0,0,0,0,0,home,41,9
8/31/2019,637,WMWashington Mystics,91,159,-110,WAS,Washington Mystics,-11.5,-110,1021900184,43,56,99,13,away,1,1,1,1,1,1,1,away,56,-13
8/31/2019,638,DWDallas Wings,85,159,-110,DAL,Dallas Wings,11.5,-110,1021900184,43,56,99,13,away,0,0,0,0,0,0,0,home,43,13
8/31/2019,639,LSL.A. Sparks,86,164.5,-110,LAS,Los Angeles Sparks,3.5,-110,1021900185,36,44,80,8,away,1,1,1,1,1,1,1,away,44,-8
8/31/2019,640,LVLas Vegas Aces,92,164.5,-110,LVA,Las Vegas Aces,-3.5,-110,1021900185,36,44,80,8,away,0,0,0,0,0,0,0,home,36,8
9/1/2019,641,PPhoenix,78,169,-110,PHO,Phoenix Mercury,4,-115,1021900186,54,53,107,-1,home,0,0,0,0,0,0,0,away,53,1
9/1/2019,642,CSChicago Sky,105,169,-110,CHI,Chicago Sky,-4,-110,1021900186,54,53,107,-1,home,1,1,1,1,1,1,1,home,54,-1
9/1/2019,643,ADAtlanta Dream,75,148.5,-110,ATL,Atlanta Dream,8.5,-105,1021900188,53,36,89,-17,home,0,0,0,0,0,0,0,away,36,17
9/1/2019,644,SSSeattle Storm,92,148.5,-110,SEA,Seattle Storm,-8.5,-115,1021900188,53,36,89,-17,home,1,1,1,1,1,1,1,home,53,-17
9/1/2019,645,IFIndiana Fever,73,158,-110,IND,Indiana Fever,9.5,-110,1021900187,38,41,79,3,away,0,0,1,1,1,1,1,away,41,-3
9/1/2019,646,MLMinnesota Lynx,81,158,-110,MIN,Minnesota Lynx,-9.5,-110,1021900187,38,41,79,3,away,1,1,0,0,0,0,0,home,38,3
9/3/2019,647,WMWashington Mystics,93,172.5,-110,WAS,Washington Mystics,-14.5,-110,1021900189,40,58,98,18,away,1,1,1,1,1,1,1,away,58,-18
9/3/2019,648,NYNew York Liberty,77,172.5,-110,NYL,New York Liberty,14.5,-115,1021900189,40,58,98,18,away,0,0,0,0,0,0,0,home,40,18
9/3/2019,649,SSSeattle Storm,82,154,-110,SEA,Seattle Storm,5.5,-110,1021900190,35,50,85,15,away,1,1,1,1,1,1,1,away,50,-15
9/3/2019,650,PPhoenix,70,154.5,-110,PHO,Phoenix Mercury,-5.5,-110,1021900190,35,50,85,15,away,0,0,0,0,0,0,0,home,35,15
9/3/2019,651,ADAtlanta Dream,60,158.5,-110,ATL,Atlanta Dream,10.5,-110,1021900191,34,35,69,1,away,1,1,1,1,0,1,0,away,35,-1
9/3/2019,652,LSL.A. Sparks,70,158.5,-110,LAS,Los Angeles Sparks,-10.5,-110,1021900191,34,35,69,1,away,0,0,0,0,1,0,1,home,34,1
9/4/2019,601,DWDallas Wings,72,156,-110,DAL,Dallas Wings,11,-110,1021900192,49,26,75,-23,home,0,0,0,0,0,0,0,away,26,23
9/4/2019,602,CSConnecticut Sun,102,156,-110,CON,Connecticut Sun,-11,-110,1021900192,49,26,75,-23,home,1,1,1,1,1,1,1,home,49,-23
9/5/2019,603,LVLas Vegas Aces,74,162.5,-115,LVA,Las Vegas Aces,-11.5,-110,1021900193,37,42,79,5,away,1,1,1,1,1,1,1,away,42,-5
9/5/2019,604,ADAtlanta Dream,78,162.5,-105,ATL,Atlanta Dream,11.5,-110,1021900193,37,42,79,5,away,0,0,0,0,0,0,0,home,37,5
9/5/2019,605,SSSeattle Storm,68,155,-110,SEA,Seattle Storm,6.5,-110,1021900194,50,35,85,-15,home,1,1,0,0,0,0,0,away,35,15
9/5/2019,606,LSL.A. Sparks,102,155,-110,LAS,Los Angeles Sparks,-6.5,-110,1021900194,50,35,85,-15,home,0,0,1,1,1,1,1,home,50,-15
9/6/2019,609,IFIndiana Fever,86,163.5,-110,IND,Indiana Fever,-2,-105,1021900197,49,43,92,-6,home,0,0,0,0,0,0,0,away,43,6
9/6/2019,610,NYNew York Liberty,81,163.5,-110,NYL,New York Liberty,2,-115,1021900197,49,43,92,-6,home,1,1,1,1,1,1,1,home,49,-6
9/6/2019,607,DWDallas Wings,73,166,-110,DAL,Dallas Wings,17.5,-117,1021900195,51,33,84,-18,home,0,0,0,0,0,0,0,away,33,18
9/6/2019,608,WMWashington Mystics,86,166,-113,WAS,Washington Mystics,-17.5,-103,1021900195,51,33,84,-18,home,1,1,1,1,1,1,1,home,51,-18
9/6/2019,611,CSChicago Sky,109,174.5,-110,CHI,Chicago Sky,6,-104,1021900196,52,52,104,0,tie,1,1,1,0,0,0,0,away,52,-0
9/6/2019,612,CSConnecticut Sun,104,174.5,-110,CON,Connecticut Sun,-6,-110,1021900196,52,52,104,0,tie,0,0,0,1,1,1,1,home,52,0
9/6/2019,613,MLMinnesota Lynx,83,157.5,-110,MIN,Minnesota Lynx,2.5,-115,1021900198,44,40,84,-4,home,1,0,0,0,0,0,0,away,40,4
9/6/2019,614,PPhoenix,69,157.5,-110,PHO,Phoenix Mercury,-2.5,-110,1021900198,44,40,84,-4,home,0,1,1,1,1,1,1,home,44,-4
9/8/2019,615,CSConnecticut Sun,76,160,-112,CON,Connecticut Sun,-3.5,-110,1021900200,48,39,87,-9,home,0,0,0,0,0,0,0,away,39,9
9/8/2019,616,IFIndiana Fever,104,160,-110,IND,Indiana Fever,3.5,-110,1021900200,48,39,87,-9,home,1,1,1,1,1,1,1,home,48,-9
9/8/2019,623,CSChicago Sky,86,179,-110,CHI,Chicago Sky,7,-110,1021900201,56,39,95,-17,home,0,0,0,0,0,0,0,away,39,17
9/8/2019,624,WMWashington Mystics,100,179,-110,WAS,Washington Mystics,-7,-105,1021900201,56,39,95,-17,home,1,1,1,1,1,1,1,home,56,-17
9/8/2019,619,NYNew York Liberty,71,160.5,-110,NYL,New York Liberty,2.5,-110,1021900199,38,44,82,6,away,1,1,1,1,1,1,1,away,44,-6
9/8/2019,620,ADAtlanta Dream,63,160.5,-110,ATL,Atlanta Dream,-2.5,-110,1021900199,38,44,82,6,away,0,0,0,0,0,0,0,home,38,6
9/8/2019,625,MLMinnesota Lynx,68,158,-110,MIN,Minnesota Lynx,4,-115,1021900204,36,34,70,-2,home,1,1,1,1,1,0,0,away,34,2
9/8/2019,626,LSL.A. Sparks,77,158,-110,LAS,Los Angeles Sparks,-4,-105,1021900204,36,34,70,-2,home,0,0,0,0,0,1,1,home,36,-2
9/8/2019,617,SSSeattle Storm,78,151,-110,SEA,Seattle Storm,-4.5,-115,1021900202,26,44,70,18,away,0,1,1,1,1,1,1,away,44,-18
9/8/2019,618,DWDallas Wings,64,151,-110,DAL,Dallas Wings,4.5,-105,1021900202,26,44,70,18,away,1,0,0,0,0,0,0,home,26,18
9/8/2019,621,LVLas Vegas Aces,98,162,-110,LVA,Las Vegas Aces,-3.5,-110,1021900203,48,52,100,4,away,0,0,1,1,1,1,1,away,52,-4
9/8/2019,622,PPhoenix,89,162,-110,PHO,Phoenix Mercury,3.5,-110,1021900203,48,52,100,4,away,1,1,0,0,0,0,0,home,48,4
9/11/2019,601,PPhoenix,76,171.5,-110,PHO,Phoenix Mercury,7,-110,1041900101,44,41,85,-3,home,0,0,0,0,0,0,0,away,41,3
9/11/2019,602,CSChicago Sky,105,171.5,-110,CHI,Chicago Sky,-7,-110,1041900101,44,41,85,-3,home,1,1,1,1,1,1,1,home,44,-3
9/11/2019,603,MLMinnesota Lynx,74,149.5,-110,MIN,Minnesota Lynx,2.5,-115,1041900111,47,41,88,-6,home,0,0,0,0,0,0,0,away,41,6
9/11/2019,604,SSSeattle Storm,84,149.5,-110,SEA,Seattle Storm,-2.5,-105,1041900111,47,41,88,-6,home,1,1,1,1,1,1,1,home,47,-6
9/15/2019,605,SSSeattle Storm,69,155,-110,SEA,Seattle Storm,7,-110,1041900201,43,36,79,-7,home,0,1,0,0,0,0,0,away,36,7
9/15/2019,606,LSL.A. Sparks,92,155,-110,LAS,Los Angeles Sparks,-7,-110,1041900201,43,36,79,-7,home,1,0,1,1,1,1,1,home,43,-7
9/15/2019,607,CSChicago Sky,92,176,-115,CHI,Chicago Sky,4,-110,1041900211,45,51,96,6,away,1,1,1,1,1,1,0,away,51,-6
9/15/2019,608,LVLas Vegas Aces,93,176,-106,LVA,Las Vegas Aces,-4,-115,1041900211,45,51,96,6,away,0,0,0,0,0,0,1,home,45,6
9/17/2019,611,LSL.A. Sparks,75,162.5,-110,LAS,Los Angeles Sparks,1.5,-115,1041900311,37,40,77,3,away,1,0,0,0,0,0,1,away,40,-3
9/17/2019,612,CSConnecticut Sun,84,162.5,-110,CON,Connecticut Sun,-1.5,-105,1041900311,37,40,77,3,away,0,1,1,1,1,1,0,home,37,3
9/17/2019,613,LVLas Vegas Aces,95,174,-110,LVA,Las Vegas Aces,10,-105,1041900301,50,57,107,7,away,1,0,0,0,0,0,0,away,57,-7
9/17/2019,614,WMWashington Mystics,97,174,-110,WAS,Washington Mystics,-10,-115,1041900301,50,57,107,7,away,0,1,1,1,1,1,1,home,50,7
9/19/2019,615,LSL.A. Sparks,68,163,-110,LAS,Los Angeles Sparks,1.5,-110,1041900312,41,40,81,-1,home,1,1,1,1,1,1,1,away,40,1
9/19/2019,616,CSConnecticut Sun,94,163,-110,CON,Connecticut Sun,-1.5,-110,1041900312,41,40,81,-1,home,0,0,0,0,0,0,0,home,41,-1
9/19/2019,617,LVLas Vegas Aces,91,179,-110,LVA,Las Vegas Aces,10,-115,1041900302,50,49,99,-1,home,1,0,0,0,0,0,0,away,49,1
9/19/2019,618,WMWashington Mystics,103,178.5,-115,WAS,Washington Mystics,-10,-105,1041900302,50,49,99,-1,home,0,1,1,1,1,1,1,home,50,-1
9/22/2019,621,WMWashington Mystics,75,181.5,-110,WAS,Washington Mystics,-4,-110,1041900303,47,37,84,-10,home,0,0,1,0,1,0,0,away,37,10
9/22/2019,622,LVLas Vegas Aces,92,181.5,-110,LVA,Las Vegas Aces,4,-110,1041900303,47,37,84,-10,home,1,1,0,1,0,1,1,home,47,-10
9/22/2019,619,CSConnecticut Sun,78,162,-110,CON,Connecticut Sun,5.5,-105,1041900313,32,40,72,8,away,1,0,1,1,1,1,1,away,40,-8
9/22/2019,620,LSL.A. Sparks,56,162,-110,LAS,Los Angeles Sparks,-5.5,-115,1041900313,32,40,72,8,away,0,1,0,0,0,0,0,home,32,8
9/24/2019,625,WMWashington Mystics,94,180.5,-110,WAS,Washington Mystics,-4.5,-110,1041900304,43,45,88,2,away,1,0,0,0,0,0,0,away,45,-2
9/24/2019,626,LVLas Vegas Aces,90,180.5,-110,LVA,Las Vegas Aces,4.5,-110,1041900304,43,45,88,2,away,0,1,1,1,1,1,1,home,43,2
9/29/2019,601,CSConnecticut Sun,86,167,-110,CON,Connecticut Sun,8.5,-113,1041900401,55,46,101,-9,home,0,0,0,0,0,0,0,away,46,9
9/29/2019,602,WMWashington Mystics,95,167,-110,WAS,Washington Mystics,-8.5,-110,1041900401,55,46,101,-9,home,1,1,1,1,1,1,1,home,55,-9
10/1/2019,603,CSConnecticut Sun,99,172.5,-120,CON,Connecticut Sun,7.5,104,1041900402,46,56,102,10,away,1,1,1,1,1,1,1,away,56,-10
10/1/2019,604,WMWashington Mystics,87,172.5,100,WAS,Washington Mystics,-7.5,-124,1041900402,46,56,102,10,away,0,0,0,0,0,0,0,home,46,10
10/6/2019,605,WMWashington Mystics,94,172.5,-110,WAS,Washington Mystics,2.5,-111,1041900403,39,43,82,4,away,1,1,1,1,1,1,1,away,43,-4
10/6/2019,606,CSConnecticut Sun,81,172.5,-110,CON,Connecticut Sun,-2.5,-109,1041900403,39,43,82,4,away,0,0,0,0,0,0,0,home,39,4
10/8/2019,607,WMWashington Mystics,86,175,-125,WAS,Washington Mystics,1.5,-110,1041900404,56,40,96,-16,home,0,0,0,0,0,0,0,away,40,16
10/8/2019,608,CSConnecticut Sun,90,175,105,CON,Connecticut Sun,-1.5,-110,1041900404,56,40,96,-16,home,1,1,1,1,1,1,1,home,56,-16
10/10/2019,609,CSConnecticut Sun,78,174,-110,CON,Connecticut Sun,6.5,-110,1041900405,42,43,85,1,away,1,0,0,0,0,0,1,away,43,-1
10/10/2019,610,WMWashington Mystics,89,174,-110,WAS,Washington Mystics,-6.5,-110,1041900405,42,43,85,1,away,0,1,1,1,1,1,0,home,42,1
5/24/2019,601,DWDallas Wings,72,156,-110,DAL,Dallas Wings,10.5,-105,1021900001,34,39,73,5,away,0,0,0,1,1,1,1,away,39,-5
5/24/2019,602,ADAtlanta Dream,76,156,-110,ATL,Atlanta Dream,-10.5,-115,1021900001,34,39,73,5,away,1,1,1,0,0,0,0,home,34,5
5/24/2019,603,IFIndiana Fever,81,158.5,-110,IND,Indiana Fever,3.5,-110,1021900002,33,39,72,6,away,0,0,0,0,1,1,1,away,39,-6
5/24/2019,604,NYNew York Liberty,80,158.5,-110,NYL,New York Liberty,-3.5,-110,1021900002,33,39,72,6,away,1,1,1,1,0,0,0,home,33,6
5/26/2019,611,LSL.A. Sparks,70,162,-110,LAS,Los Angeles Sparks,2.5,-110,1021900006,45,31,76,-14,home,1,1,0,0,0,0,0,away,31,14
5/26/2019,612,LVLas Vegas Aces,83,162,-110,LVA,Las Vegas Aces,-2.5,-110,1021900006,45,31,76,-14,home,0,0,1,1,1,1,1,home,45,-14
5/28/2019,613,IFIndiana Fever,77,163.5,-115,IND,Indiana Fever,9.5,-110,1021900007,40,37,77,-3,home,0,0,0,0,0,0,0,away,37,3
5/28/2019,614,CSConnecticut Sun,88,162.5,-105,CON,Connecticut Sun,-9.5,-110,1021900007,40,37,77,-3,home,1,1,1,1,1,1,1,home,40,-3
5/29/2019,615,SSSeattle Storm,61,152.5,-110,SEA,Seattle Storm,4.5,-110,1021900008,39,24,63,-15,home,0,0,0,0,0,0,0,away,24,15
5/29/2019,616,MLMinnesota Lynx,72,151.5,-110,MIN,Minnesota Lynx,-4.5,-110,1021900008,39,24,63,-15,home,1,1,1,1,1,1,1,home,39,-15
5/31/2019,617,SSSeattle Storm,82,148.5,-110,SEA,Seattle Storm,6.5,-110,1021900009,27,45,72,18,away,1,1,1,1,1,1,1,away,45,-18
5/31/2019,618,ADAtlanta Dream,66,148.5,-110,ATL,Atlanta Dream,-6.5,-110,1021900009,27,45,72,18,away,0,0,0,0,0,0,0,home,27,18
5/31/2019,619,LVLas Vegas Aces,84,165,-110,LVA,Las Vegas Aces,-2.5,-110,1021900010,42,43,85,1,away,0,0,0,1,1,1,1,away,43,-1
5/31/2019,620,PPhoenix,86,165,-110,PHO,Phoenix Mercury,2.5,-110,1021900010,42,43,85,1,away,1,1,1,0,0,0,0,home,42,1
5/31/2019,621,CSConnecticut Sun,70,164,-110,CON,Connecticut Sun,-2.5,-115,1021900011,38,31,69,-7,home,0,0,0,0,0,0,0,away,31,7
5/31/2019,622,LSL.A. Sparks,77,164.5,-110,LAS,Los Angeles Sparks,2.5,-105,1021900011,38,31,69,-7,home,1,1,1,1,1,1,1,home,38,-7
6/1/2019,623,NYNew York Liberty,77,158.5,-110,NYL,New York Liberty,3,-110,1021900012,45,29,74,-16,home,0,0,0,0,0,0,0,away,29,16
6/1/2019,624,IFIndiana Fever,92,158.5,-110,IND,Indiana Fever,-3,-110,1021900012,45,29,74,-16,home,1,1,1,1,1,1,1,home,45,-16
6/1/2019,625,ADAtlanta Dream,75,158.5,-110,ATL,Atlanta Dream,8.5,-110,1021900013,52,35,87,-17,home,0,0,0,0,0,0,0,away,35,17
6/1/2019,626,WMWashington Mystics,96,158.5,-110,WAS,Washington Mystics,-8.5,-110,1021900013,52,35,87,-17,home,1,1,1,1,1,1,1,home,52,-17
6/1/2019,629,MLMinnesota Lynx,70,153.5,-110,MIN,Minnesota Lynx,-3.5,-110,1021900015,27,41,68,14,away,0,1,1,1,1,1,1,away,41,-14
6/1/2019,630,DWDallas Wings,67,153.5,-110,DAL,Dallas Wings,3.5,-110,1021900015,27,41,68,14,away,1,0,0,0,0,0,0,home,27,14
6/1/2019,627,SSSeattle Storm,79,162,-112,SEA,Seattle Storm,2.5,-110,1021900014,48,46,94,-2,home,1,0,0,0,0,0,0,away,46,2
6/1/2019,628,CSChicago Sky,83,162,-110,CHI,Chicago Sky,-2.5,-110,1021900014,48,46,94,-2,home,0,1,1,1,1,1,1,home,48,-2
6/2/2019,631,CSConnecticut Sun,80,168,-110,CON,Connecticut Sun,5,-115,1021900016,43,40,83,-3,home,1,1,0,0,0,0,0,away,40,3
6/2/2019,632,LVLas Vegas Aces,74,168,-105,LVA,Las Vegas Aces,-4.5,-113,1021900016,43,40,83,-3,home,0,0,1,1,1,1,1,home,43,-3
6/4/2019,633,LSL.A. Sparks,78,157.5,-110,LAS,Los Angeles Sparks,-5,-110,1021900017,34,36,70,2,away,1,0,0,1,1,1,1,away,36,-2
6/4/2019,634,NYNew York Liberty,73,157.5,-110,NYL,New York Liberty,5,-115,1021900017,34,36,70,2,away,0,1,1,0,0,0,0,home,34,2
6/4/2019,635,MLMinnesota Lynx,77,148.5,-110,MIN,Minnesota Lynx,1.5,-110,1021900018,49,39,88,-10,home,0,0,0,0,0,0,0,away,39,10
6/4/2019,636,SSSeattle Storm,84,148.5,-110,SEA,Seattle Storm,-1.5,-110,1021900018,49,39,88,-10,home,1,1,1,1,1,1,1,home,49,-10
6/5/2019,637,CSChicago Sky,85,169,-110,CHI,Chicago Sky,12,-110,1021900019,57,42,99,-15,home,0,0,0,0,0,0,0,away,42,15
6/5/2019,638,WMWashington Mystics,103,169.5,-105,WAS,Washington Mystics,-12,-110,1021900019,57,42,99,-15,home,1,1,1,1,1,1,1,home,57,-15
6/6/2019,641,LSL.A. Sparks,77,158,-110,LAS,Los Angeles Sparks,7.5,-110,1021900021,43,32,75,-11,home,0,0,0,0,0,0,0,away,32,11
6/6/2019,642,CSConnecticut Sun,89,158,-115,CON,Connecticut Sun,-7.5,-110,1021900021,43,32,75,-11,home,1,1,1,1,1,1,1,home,43,-11
6/6/2019,639,LVLas Vegas Aces,92,161.5,-115,LVA,Las Vegas Aces,-4.5,-115,1021900020,25,49,74,24,away,1,1,1,1,1,1,1,away,49,-24
6/6/2019,640,ADAtlanta Dream,69,161.5,-105,ATL,Atlanta Dream,4.5,-105,1021900020,25,49,74,24,away,0,0,0,0,0,0,0,home,25,24
6/6/2019,643,PPhoenix,56,154,-115,PHO,Phoenix Mercury,2,-115,1021900022,32,24,56,-8,home,1,1,0,0,0,0,0,away,24,8
6/6/2019,644,MLMinnesota Lynx,58,153.5,-110,MIN,Minnesota Lynx,-2,-105,1021900022,32,24,56,-8,home,0,0,1,1,1,1,1,home,32,-8
6/7/2019,645,DWDallas Wings,64,154,-110,DAL,Dallas Wings,5,-105,1021900023,38,26,64,-12,home,0,0,0,0,0,0,0,away,26,12
6/7/2019,646,IFIndiana Fever,79,154,-110,IND,Indiana Fever,-5,-115,1021900023,38,26,64,-12,home,1,1,1,1,1,1,1,home,38,-12
6/7/2019,647,WMWashington Mystics,94,165.5,-110,WAS,Washington Mystics,-9.5,-110,1021900024,49,50,99,1,away,0,0,0,0,0,0,0,away,50,-1
6/7/2019,648,NYNew York Liberty,85,165.5,-110,NYL,New York Liberty,9.5,-110,1021900024,49,50,99,1,away,1,1,1,1,1,1,1,home,49,1
6/8/2019,649,LSL.A. Sparks,89,149,-110,LAS,Los Angeles Sparks,4.5,-110,1021900025,39,44,83,5,away,1,1,1,1,1,1,1,away,44,-5
6/8/2019,650,MLMinnesota Lynx,85,149,-110,MIN,Minnesota Lynx,-4.5,-110,1021900025,39,44,83,5,away,0,0,0,0,0,0,0,home,39,5
6/9/2019,605,LVLas Vegas Aces,78,169,-110,LVA,Las Vegas Aces,-11,-115,1021900027,45,37,82,-8,home,1,1,1,0,0,0,0,away,37,8
6/9/2019,606,NYNew York Liberty,88,169,-110,NYL,New York Liberty,11,-110,1021900027,45,37,82,-8,home,0,0,0,1,1,1,1,home,45,-8
6/9/2019,603,CSConnecticut Sun,65,160,-110,CON,Connecticut Sun,-6.5,-110,1021900026,32,44,76,12,away,1,1,1,1,1,1,1,away,44,-12
6/9/2019,604,ADAtlanta Dream,59,160,-110,ATL,Atlanta Dream,6.5,-110,1021900026,32,44,76,12,away,0,0,0,0,0,0,0,home,32,12
6/9/2019,601,DWDallas Wings,62,158,-110,DAL,Dallas Wings,14,-110,1021900028,40,34,74,-6,home,1,1,1,0,0,0,0,away,34,6
6/9/2019,602,WMWashington Mystics,86,158,-110,WAS,Washington Mystics,-14,-110,1021900028,40,34,74,-6,home,0,0,0,1,1,1,1,home,40,-6
6/9/2019,607,PPhoenix,94,152.5,-110,PHO,Phoenix Mercury,-2.5,-119,1021900029,28,53,81,25,away,1,1,1,1,1,1,1,away,53,-25
6/9/2019,608,IFIndiana Fever,87,152.5,-110,IND,Indiana Fever,2.5,-101,1021900029,28,53,81,25,away,0,0,0,0,0,0,0,home,28,25
6/9/2019,609,SSSeattle Storm,71,164.5,-110,SEA,Seattle Storm,-2,-110,1021900030,44,34,78,-10,home,0,0,0,0,0,0,0,away,34,10
6/9/2019,610,CSChicago Sky,78,164.5,-110,CHI,Chicago Sky,2,-110,1021900030,44,34,78,-10,home,1,1,1,1,1,1,1,home,44,-10
6/11/2019,611,SSSeattle Storm,84,156.5,-115,SEA,Seattle Storm,1.5,-110,1021900032,39,46,85,7,away,1,1,1,1,1,1,1,away,46,-7
6/11/2019,612,IFIndiana Fever,82,156.5,-110,IND,Indiana Fever,-1.5,-110,1021900032,39,46,85,7,away,0,0,0,0,0,0,0,home,39,7
6/11/2019,613,WMWashington Mystics,75,166.5,-110,WAS,Washington Mystics,3,-115,1021900031,33,37,70,4,away,1,1,1,1,1,1,1,away,37,-4
6/11/2019,614,CSConnecticut Sun,83,166.5,-110,CON,Connecticut Sun,-2.5,-115,1021900031,33,37,70,4,away,0,0,0,0,0,0,0,home,33,4
6/11/2019,615,PPhoenix,75,165.5,-110,PHO,Phoenix Mercury,-3.5,-115,1021900033,43,41,84,-2,home,0,0,1,1,1,1,0,away,41,2
6/11/2019,616,CSChicago Sky,82,165.5,-110,CHI,Chicago Sky,4,-113,1021900033,43,41,84,-2,home,1,1,0,0,0,0,1,home,43,-2
6/12/2019,617,MLMinnesota Lynx,69,156,-110,MIN,Minnesota Lynx,-3,-110,1021900034,38,28,66,-10,home,0,0,0,0,0,0,0,away,28,10
6/12/2019,618,NYNew York Liberty,75,156,-110,NYL,New York Liberty,3,-110,1021900034,38,28,66,-10,home,1,1,1,1,1,1,1,home,38,-10
6/13/2019,619,IFIndiana Fever,76,150.5,-110,IND,Indiana Fever,-3,-102,1021900035,31,34,65,3,away,0,0,1,1,1,1,1,away,34,-3
6/13/2019,620,DWDallas Wings,72,150.5,-110,DAL,Dallas Wings,3,-118,1021900035,31,34,65,3,away,1,1,0,0,0,0,0,home,31,3
6/14/2019,621,SSSeattle Storm,74,159,-110,SEA,Seattle Storm,9.5,-110,1021900036,46,38,84,-8,home,1,1,0,0,1,0,0,away,38,8
6/14/2019,622,WMWashington Mystics,71,159,-110,WAS,Washington Mystics,-9.5,-110,1021900036,46,38,84,-8,home,0,0,1,1,0,1,1,home,46,-8
6/14/2019,623,CSConnecticut Sun,85,151,-110,CON,Connecticut Sun,-6,-110,1021900037,43,44,87,1,away,1,1,0,1,1,1,1,away,44,-1
6/14/2019,624,MLMinnesota Lynx,81,151,-102,MIN,Minnesota Lynx,6,-110,1021900037,43,44,87,1,away,0,0,1,0,0,0,0,home,43,1
6/14/2019,625,LSL.A. Sparks,85,154,-105,LAS,Los Angeles Sparks,3.5,-110,1021900038,36,38,74,2,away,1,1,1,0,1,1,1,away,38,-2
6/14/2019,626,PPhoenix,68,154,-115,PHO,Phoenix Mercury,-3.5,-110,1021900038,36,38,74,2,away,0,0,0,1,0,0,0,home,36,2
6/14/2019,627,NYNew York Liberty,65,165,-115,NYL,New York Liberty,13,-110,1021900039,66,31,97,-35,home,0,0,0,0,0,0,0,away,31,35
6/14/2019,628,LVLas Vegas Aces,100,165.5,-110,LVA,Las Vegas Aces,-13,-110,1021900039,66,31,97,-35,home,1,1,1,1,1,1,1,home,66,-35
6/15/2019,629,CSChicago Sky,70,165.5,-110,CHI,Chicago Sky,3.5,-110,1021900040,29,30,59,1,away,0,0,0,1,1,0,1,away,30,-1
6/15/2019,630,IFIndiana Fever,64,165.5,-105,IND,Indiana Fever,-3.5,-110,1021900040,29,30,59,1,away,1,1,1,0,0,1,0,home,29,1
6/15/2019,631,ADAtlanta Dream,61,146,-110,ATL,Atlanta Dream,-3.5,-115,1021900041,28,32,60,4,away,1,1,1,1,1,1,1,away,32,-4
6/15/2019,632,DWDallas Wings,71,146,-110,DAL,Dallas Wings,3.5,-105,1021900041,28,32,60,4,away,0,0,0,0,0,0,0,home,28,4
6/15/2019,633,NYNew York Liberty,98,156.5,-110,NYL,New York Liberty,11,-110,1021900042,50,48,98,-2,home,0,0,0,0,0,0,0,away,48,2
6/15/2019,634,LSL.A. Sparks,92,156.5,-110,LAS,Los Angeles Sparks,-11,-110,1021900042,50,48,98,-2,home,1,1,1,1,1,1,1,home,50,-2
6/16/2019,635,SSSeattle Storm,67,155,-110,SEA,Seattle Storm,9,-110,1021900043,44,33,77,-11,home,0,0,0,0,0,0,0,away,33,11
6/16/2019,636,CSConnecticut Sun,81,155,-110,CON,Connecticut Sun,-9,-110,1021900043,44,33,77,-11,home,1,1,1,1,1,1,1,home,44,-11
6/16/2019,637,LVLas Vegas Aces,80,160.5,-110,LVA,Las Vegas Aces,-6,-110,1021900044,39,35,74,-4,home,0,0,0,0,0,0,0,away,35,4
6/16/2019,638,MLMinnesota Lynx,75,160.5,-110,MIN,Minnesota Lynx,6,-110,1021900044,39,35,74,-4,home,1,1,1,1,1,1,1,home,39,-4
6/18/2019,639,WMWashington Mystics,81,165.5,-116,WAS,Washington Mystics,1.5,-110,1021900045,27,48,75,21,away,1,1,1,1,1,1,1,away,48,-21
6/18/2019,640,LSL.A. Sparks,52,165.5,-104,LAS,Los Angeles Sparks,-1.5,-110,1021900045,27,48,75,21,away,0,0,0,0,0,0,0,home,27,21
6/20/2019,645,PPhoenix,54,145.5,-105,PHO,Phoenix Mercury,-6,-110,1021900048,33,27,60,-6,home,0,0,0,0,0,0,0,away,27,6
6/20/2019,646,DWDallas Wings,69,145,-110,DAL,Dallas Wings,6,-110,1021900048,33,27,60,-6,home,1,1,1,1,1,1,1,home,33,-6
6/20/2019,647,WMWashington Mystics,95,166.5,-110,WAS,Washington Mystics,3.5,-110,1021900049,39,51,90,12,away,1,1,1,1,1,1,1,away,51,-12
6/20/2019,648,LVLas Vegas Aces,72,166.5,-110,LVA,Las Vegas Aces,-3.5,-110,1021900049,39,51,90,12,away,0,0,0,0,0,0,0,home,39,12
6/21/2019,651,ADAtlanta Dream,76,152.5,-110,ATL,Atlanta Dream,12.5,-110,1021900050,39,25,64,-14,home,0,0,0,0,0,0,0,away,25,14
6/21/2019,652,CSConnecticut Sun,86,152.5,-110,CON,Connecticut Sun,-12.5,-110,1021900050,39,25,64,-14,home,1,1,1,1,1,1,1,home,39,-14
6/21/2019,653,IFIndiana Fever,76,162.5,-110,IND,Indiana Fever,4.5,-110,1021900051,31,40,71,9,away,1,1,1,1,1,1,1,away,40,-9
6/21/2019,654,CSChicago Sky,69,162.5,-110,CHI,Chicago Sky,-4.5,-110,1021900051,31,40,71,9,away,0,0,0,0,0,0,0,home,31,9
6/21/2019,655,LSL.A. Sparks,62,154,-110,LAS,Los Angeles Sparks,-1.5,-110,1021900052,46,34,80,-12,home,1,0,0,0,0,0,0,away,34,12
6/21/2019,656,SSSeattle Storm,84,154,-110,SEA,Seattle Storm,1.5,-110,1021900052,46,34,80,-12,home,0,1,1,1,1,1,1,home,46,-12
6/22/2019,657,NYNew York Liberty,83,156.5,-108,NYL,New York Liberty,8.5,-110,1021900053,42,43,85,1,away,1,1,0,1,0,0,0,away,43,-1
6/22/2019,658,MLMinnesota Lynx,92,156.5,-112,MIN,Minnesota Lynx,-8.5,-115,1021900053,42,43,85,1,away,0,0,1,0,1,1,1,home,42,1
6/22/2019,659,DWDallas Wings,68,153,-105,DAL,Dallas Wings,14.5,-115,1021900054,49,34,83,-15,home,0,0,1,0,0,0,0,away,34,15
6/22/2019,660,LVLas Vegas Aces,86,152.5,-110,LVA,Las Vegas Aces,-14.5,-105,1021900054,49,34,83,-15,home,1,1,0,1,1,1,1,home,49,-15
6/23/2019,661,WMWashington Mystics,89,156,-110,WAS,Washington Mystics,-9.5,-110,1021900055,45,42,87,-3,home,1,1,1,0,1,1,0,away,42,3
6/23/2019,662,ADAtlanta Dream,73,156,-110,ATL,Atlanta Dream,9.5,-110,1021900055,45,42,87,-3,home,0,0,0,1,0,0,1,home,45,-3
6/23/2019,665,CSConnecticut Sun,75,164,-110,CON,Connecticut Sun,-5,-110,1021900056,56,35,91,-21,home,0,0,0,0,0,0,0,away,35,21
6/23/2019,666,CSChicago Sky,93,164,-110,CHI,Chicago Sky,5,-110,1021900056,56,35,91,-21,home,1,1,1,1,1,1,1,home,56,-21
6/23/2019,663,LSL.A. Sparks,72,152.5,-110,LAS,Los Angeles Sparks,-1.5,-105,1021900057,44,42,86,-2,home,1,1,0,0,1,1,0,away,42,2
6/23/2019,664,PPhoenix,82,152.5,-110,PHO,Phoenix Mercury,1.5,-115,1021900057,44,42,86,-2,home,0,0,1,1,0,0,1,home,44,-2
6/23/2019,667,IFIndiana Fever,61,153,-110,IND,Indiana Fever,6,-110,1021900058,32,35,67,3,away,0,0,0,0,0,1,0,away,35,-3
6/23/2019,668,SSSeattle Storm,65,153,-110,SEA,Seattle Storm,-6,-110,1021900058,32,35,67,3,away,1,1,1,1,1,0,1,home,32,3
6/25/2019,601,MLMinnesota Lynx,78,151,-110,MIN,Minnesota Lynx,-2.5,-110,1021900059,23,43,66,20,away,1,1,1,1,1,1,1,away,43,-20
6/25/2019,602,IFIndiana Fever,74,151,-110,IND,Indiana Fever,2.5,-110,1021900059,23,43,66,20,away,0,0,0,0,0,0,0,home,23,20
6/25/2019,603,SSSeattle Storm,56,158.5,-110,SEA,Seattle Storm,6.5,-110,1021900060,36,32,68,-4,home,0,0,0,0,0,0,0,away,32,4
6/25/2019,604,LVLas Vegas Aces,60,158.5,-110,LVA,Las Vegas Aces,-6.5,-110,1021900060,36,32,68,-4,home,1,1,1,1,1,1,1,home,36,-4
6/26/2019,605,WMWashington Mystics,81,164.5,-110,WAS,Washington Mystics,-6.5,-105,1021900061,45,50,95,5,away,1,0,1,1,1,1,1,away,50,-5
6/26/2019,606,CSChicago Sky,74,164.5,-105,CHI,Chicago Sky,6.5,-115,1021900061,45,50,95,5,away,0,1,0,0,0,0,0,home,45,5
6/26/2019,607,CSConnecticut Sun,73,148.5,-110,CON,Connecticut Sun,-9,-110,1021900062,37,34,71,-3,home,1,0,0,0,0,0,0,away,34,3
6/26/2019,608,DWDallas Wings,74,148.5,-110,DAL,Dallas Wings,9,-110,1021900062,37,34,71,-3,home,0,1,1,1,1,1,1,home,37,-3
6/27/2019,609,LVLas Vegas Aces,74,158,-110,LVA,Las Vegas Aces,-2,-105,1021900063,40,34,74,-6,home,1,1,0,0,0,0,0,away,34,6
6/27/2019,610,LSL.A. Sparks,86,158,-110,LAS,Los Angeles Sparks,2,-115,1021900063,40,34,74,-6,home,0,0,1,1,1,1,1,home,40,-6
6/28/2019,611,DWDallas Wings,68,153.5,-115,DAL,Dallas Wings,4.5,-115,1021900064,38,33,71,-5,home,1,0,0,0,0,0,0,away,33,5
6/28/2019,612,NYNew York Liberty,69,153.5,-110,NYL,New York Liberty,-4,-105,1021900064,38,33,71,-5,home,0,1,1,1,1,1,1,home,38,-5
6/28/2019,613,CSChicago Sky,76,152.5,-110,CHI,Chicago Sky,3,-110,1021900066,51,43,94,-8,home,0,0,0,0,0,0,0,away,43,8
6/28/2019,614,SSSeattle Storm,79,152.5,-110,SEA,Seattle Storm,-3,-110,1021900066,51,43,94,-8,home,1,1,1,1,1,1,1,home,51,-8
6/28/2019,615,IFIndiana Fever,69,151.5,-110,IND,Indiana Fever,5,-110,1021900065,50,38,88,-12,home,1,1,1,0,0,0,0,away,38,12
6/28/2019,616,PPhoenix,91,151.5,-110,PHO,Phoenix Mercury,-5,-110,1021900065,50,38,88,-12,home,0,0,0,1,1,1,1,home,50,-12
6/29/2019,617,CSConnecticut Sun,59,161.5,-110,CON,Connecticut Sun,7,-110,1021900067,56,30,86,-26,home,0,0,0,0,0,0,0,away,30,26
6/29/2019,618,WMWashington Mystics,102,161.5,-110,WAS,Washington Mystics,-7,-110,1021900067,56,30,86,-26,home,1,1,1,1,1,1,1,home,56,-26
6/29/2019,619,IFIndiana Fever,97,159.5,-110,IND,Indiana Fever,13,-110,1021900068,45,45,90,0,tie,1,1,1,1,1,1,1,away,45,-0
6/29/2019,620,LVLas Vegas Aces,102,159.5,-110,LVA,Las Vegas Aces,-13,-110,1021900068,45,45,90,0,tie,0,0,0,0,0,0,0,home,45,0
7/2/2019,629,CSChicago Sky,82,162,-110,CHI,Chicago Sky,9,-110,1021900073,55,54,109,-1,home,0,1,0,0,0,0,0,away,54,1
7/2/2019,630,LVLas Vegas Aces,90,162,-110,LVA,Las Vegas Aces,-9,-110,1021900073,55,54,109,-1,home,1,0,1,1,1,1,1,home,55,-1
7/2/2019,631,ADAtlanta Dream,68,152,-105,ATL,Atlanta Dream,7.5,-110,1021900074,38,34,72,-4,home,1,0,0,0,0,0,0,away,34,4
7/2/2019,632,MLMinnesota Lynx,85,152,-115,MIN,Minnesota Lynx,-7.5,-110,1021900074,38,34,72,-4,home,0,1,1,1,1,1,1,home,38,-4
7/3/2019,633,NYNew York Liberty,84,150,-110,NYL,New York Liberty,7,-115,1021900075,40,41,81,1,away,0,0,1,0,1,0,1,away,41,-1
7/3/2019,634,SSSeattle Storm,83,150,-110,SEA,Seattle Storm,-7,-105,1021900075,40,41,81,1,away,1,1,0,1,0,1,0,home,40,1
7/5/2019,635,IFIndiana Fever,76,148.5,-110,IND,Indiana Fever,4,-110,1021900076,30,37,67,7,away,0,1,1,1,1,1,1,away,37,-7
7/5/2019,636,DWDallas Wings,56,148.5,-110,DAL,Dallas Wings,-4,-110,1021900076,30,37,67,7,away,1,0,0,0,0,0,0,home,30,7
7/5/2019,637,ADAtlanta Dream,77,147.5,-110,ATL,Atlanta Dream,9,-115,1021900078,24,32,56,8,away,0,1,1,1,1,1,1,away,32,-8
7/5/2019,638,SSSeattle Storm,66,147.5,-110,SEA,Seattle Storm,-9,-105,1021900078,24,32,56,8,away,1,0,0,0,0,0,0,home,24,8
7/5/2019,639,NYNew York Liberty,80,160,-110,NYL,New York Liberty,7,-110,1021900077,41,40,81,-1,home,0,0,0,0,0,0,0,away,40,1
7/5/2019,640,PPhoenix,76,160,-110,PHO,Phoenix Mercury,-7,-110,1021900077,41,40,81,-1,home,1,1,1,1,1,1,1,home,41,-1
7/5/2019,641,WMWashington Mystics,99,166,-115,WAS,Washington Mystics,-1,-110,1021900079,70,99,169,29,away,1,1,1,1,1,1,1,away,99,-29
7/5/2019,642,LVLas Vegas Aces,70,166,-105,LVA,Las Vegas Aces,1,-110,1021900079,70,99,169,29,away,0,0,0,0,0,0,0,home,70,29
7/6/2019,643,MLMinnesota Lynx,74,157,-110,MIN,Minnesota Lynx,8.5,-110,1021900080,43,44,87,1,away,1,1,1,0,0,0,0,away,44,-1
7/6/2019,644,CSConnecticut Sun,71,157,-110,CON,Connecticut Sun,-8.5,-110,1021900080,43,44,87,1,away,0,0,0,1,1,1,1,home,43,1
7/7/2019,645,LVLas Vegas Aces,90,164.5,-110,LVA,Las Vegas Aces,-5.5,-110,1021900081,32,44,76,12,away,1,1,1,1,1,1,1,away,44,-12
7/7/2019,646,NYNew York Liberty,58,164.5,-110,NYL,New York Liberty,5.5,-110,1021900081,32,44,76,12,away,0,0,0,0,0,0,0,home,32,12
7/7/2019,647,WMWashington Mystics,81,161,-110,WAS,Washington Mystics,-5,-110,1021900082,51,46,97,-5,home,0,0,0,0,0,0,0,away,46,5
7/7/2019,648,LSL.A. Sparks,98,161,-110,LAS,Los Angeles Sparks,5,-110,1021900082,51,46,97,-5,home,1,1,1,1,1,1,1,home,51,-5
7/7/2019,651,DWDallas Wings,66,154.5,-110,DAL,Dallas Wings,6.5,-110,1021900083,41,35,76,-6,home,0,0,0,0,0,0,0,away,35,6
7/7/2019,652,CSChicago Sky,78,154.5,-110,CHI,Chicago Sky,-6.5,-110,1021900083,41,35,76,-6,home,1,1,1,1,1,1,1,home,41,-6
7/7/2019,649,ADAtlanta Dream,63,153.5,-110,ATL,Atlanta Dream,7.5,-110,1021900084,29,25,54,-4,home,0,0,0,0,0,0,0,away,25,4
7/7/2019,650,PPhoenix,65,153.5,-110,PHO,Phoenix Mercury,-7.5,-110,1021900084,29,25,54,-4,home,1,1,1,1,1,1,1,home,29,-4
7/9/2019,653,LSL.A. Sparks,62,151,-110,LAS,Los Angeles Sparks,-5,-110,1021900085,37,32,69,-5,home,0,1,1,0,0,0,0,away,32,5
7/9/2019,654,DWDallas Wings,74,151,-110,DAL,Dallas Wings,5,-110,1021900085,37,32,69,-5,home,1,0,0,1,1,1,1,home,37,-5
7/10/2019,655,CSConnecticut Sun,75,151.5,-110,CON,Connecticut Sun,-6,-110,1021900086,43,41,84,-2,home,0,0,0,0,0,1,0,away,41,2
7/10/2019,656,ADAtlanta Dream,78,151.5,-110,ATL,Atlanta Dream,6,-110,1021900086,43,41,84,-2,home,1,1,1,1,1,0,1,home,43,-2
7/10/2019,657,PPhoenix,91,157.5,-110,PHO,Phoenix Mercury,8.5,-110,1021900087,44,49,93,5,away,0,0,0,0,0,0,1,away,49,-5
7/10/2019,658,WMWashington Mystics,68,157.5,-110,WAS,Washington Mystics,-8.5,-110,1021900087,44,49,93,5,away,1,1,1,1,1,1,0,home,44,5
7/10/2019,659,LVLas Vegas Aces,74,161.5,-110,LVA,Las Vegas Aces,-5.5,-117,1021900088,35,38,73,3,away,0,1,0,1,1,1,1,away,38,-3
7/10/2019,660,IFIndiana Fever,71,161.5,-110,IND,Indiana Fever,6,-110,1021900088,35,38,73,3,away,1,0,1,0,0,0,0,home,35,3
7/10/2019,661,MLMinnesota Lynx,73,158.5,-110,MIN,Minnesota Lynx,1.5,-105,1021900089,32,40,72,8,away,1,1,1,1,1,1,1,away,40,-8
7/10/2019,662,CSChicago Sky,72,158.5,-110,CHI,Chicago Sky,-1.5,-115,1021900089,32,40,72,8,away,0,0,0,0,0,0,0,home,32,8
7/12/2019,601,LSL.A. Sparks,90,155.5,-110,LAS,Los Angeles Sparks,-2.5,-110,1021900090,35,45,80,10,away,1,1,1,1,1,1,1,away,45,-10
7/12/2019,602,IFIndiana Fever,84,155.5,-110,IND,Indiana Fever,2.5,-110,1021900090,35,45,80,10,away,0,0,0,0,0,0,0,home,35,10
7/12/2019,603,MLMinnesota Lynx,53,149.5,-110,MIN,Minnesota Lynx,-1.5,-110,1021900091,37,32,69,-5,home,0,0,0,0,0,0,0,away,32,5
7/12/2019,604,ADAtlanta Dream,60,149,-105,ATL,Atlanta Dream,1.5,-110,1021900091,37,32,69,-5,home,1,1,1,1,1,1,1,home,37,-5
7/12/2019,607,NYNew York Liberty,83,162,-110,NYL,New York Liberty,3.5,-110,1021900093,55,35,90,-20,home,0,0,0,0,1,0,0,away,35,20
7/12/2019,608,CSChicago Sky,99,162,-110,CHI,Chicago Sky,-3.5,-110,1021900093,55,35,90,-20,home,1,1,1,1,0,1,1,home,55,-20
7/12/2019,605,PPhoenix,64,154,-110,PHO,Phoenix Mercury,3.5,-110,1021900092,30,36,66,6,away,1,1,1,1,1,1,0,away,36,-6
7/12/2019,606,CSConnecticut Sun,79,154,-110,CON,Connecticut Sun,-3.5,-110,1021900092,30,36,66,6,away,0,0,0,0,0,0,1,home,30,6
7/12/2019,609,DWDallas Wings,81,145,-110,DAL,Dallas Wings,5.5,-110,1021900094,52,29,81,-23,home,0,0,0,0,0,0,0,away,29,23
7/12/2019,610,SSSeattle Storm,95,145,-110,SEA,Seattle Storm,-5.5,-110,1021900094,52,29,81,-23,home,1,1,1,1,1,1,1,home,52,-23
7/14/2019,613,LSL.A. Sparks,76,152.5,-110,LAS,Los Angeles Sparks,-3.5,-105,1021900096,30,32,62,2,away,1,1,1,0,1,1,1,away,32,-2
7/14/2019,614,ADAtlanta Dream,71,152.5,-110,ATL,Atlanta Dream,3.5,-115,1021900096,30,32,62,2,away,0,0,0,1,0,0,0,home,30,2
7/14/2019,617,CSChicago Sky,89,152.5,-110,CHI,Chicago Sky,1,-110,1021900098,46,41,87,-5,home,0,0,1,1,1,1,0,away,41,5
7/14/2019,618,DWDallas Wings,79,152.5,-110,DAL,Dallas Wings,-1,-110,1021900098,46,41,87,-5,home,1,1,0,0,0,0,1,home,46,-5
7/14/2019,615,CSConnecticut Sun,76,155.5,-115,CON,Connecticut Sun,-4,-110,1021900097,30,39,69,9,away,0,1,1,1,1,1,1,away,39,-9
7/14/2019,616,IFIndiana Fever,63,155.5,-105,IND,Indiana Fever,4,-110,1021900097,30,39,69,9,away,1,0,0,0,0,0,0,home,30,9
7/14/2019,621,NYNew York Liberty,69,155.5,-110,NYL,New York Liberty,5.5,-110,1021900100,43,30,73,-13,home,0,0,0,0,0,0,0,away,30,13
7/14/2019,622,SSSeattle Storm,78,155.5,-110,SEA,Seattle Storm,-5.5,-110,1021900100,43,30,73,-13,home,1,1,1,1,1,1,1,home,43,-13
7/14/2019,619,PPhoenix,62,152,-110,PHO,Phoenix Mercury,1,-110,1021900099,36,35,71,-1,home,1,0,0,0,0,1,0,away,35,1
7/14/2019,620,MLMinnesota Lynx,75,152,-110,MIN,Minnesota Lynx,-1,-110,1021900099,36,35,71,-1,home,0,1,1,1,1,0,1,home,36,-1
7/18/2019,629,DWDallas Wings,64,150.5,-110,DAL,Dallas Wings,7.5,-110,1021900104,32,42,74,10,away,1,1,1,1,1,1,1,away,42,-10
7/18/2019,630,LSL.A. Sparks,69,150.5,-110,LAS,Los Angeles Sparks,-7.5,-110,1021900104,32,42,74,10,away,0,0,0,0,0,0,0,home,32,10
7/19/2019,631,WMWashington Mystics,95,161,-110,WAS,Washington Mystics,-8,-110,1021900105,37,41,78,4,away,1,1,1,1,1,1,1,away,41,-4
7/19/2019,632,IFIndiana Fever,88,161,-110,IND,Indiana Fever,8,-110,1021900105,37,41,78,4,away,0,0,0,0,0,0,0,home,37,4
7/19/2019,633,ADAtlanta Dream,69,150,-110,ATL,Atlanta Dream,9,-110,1021900106,49,40,89,-9,home,0,0,0,0,0,0,0,away,40,9
7/19/2019,634,CSConnecticut Sun,98,150,-110,CON,Connecticut Sun,-9,-110,1021900106,49,40,89,-9,home,1,1,1,1,1,1,1,home,49,-9
7/19/2019,635,LVLas Vegas Aces,66,157,-110,LVA,Las Vegas Aces,-1.5,-115,1021900107,43,35,78,-8,home,0,0,0,0,0,0,0,away,35,8
7/19/2019,636,SSSeattle Storm,69,157,-110,SEA,Seattle Storm,1.5,-105,1021900107,43,35,78,-8,home,1,1,1,1,1,1,1,home,43,-8
7/20/2019,637,LSL.A. Sparks,78,157.5,-110,LAS,Los Angeles Sparks,-2,-110,1021900108,44,37,81,-7,home,0,0,0,0,0,0,0,away,37,7
7/20/2019,638,NYNew York Liberty,83,157.5,-110,NYL,New York Liberty,2,-110,1021900108,44,37,81,-7,home,1,1,1,1,1,1,1,home,44,-7
7/20/2019,639,PPhoenix,70,145.5,-110,PHO,Phoenix Mercury,-2,-110,1021900109,32,36,68,4,away,1,0,0,1,1,1,1,away,36,-4
7/20/2019,640,DWDallas Wings,66,145.5,-110,DAL,Dallas Wings,2,-105,1021900109,32,36,68,4,away,0,1,1,0,0,0,0,home,32,4
7/21/2019,641,ADAtlanta Dream,65,159,-110,ATL,Atlanta Dream,13,-115,1021900110,45,31,76,-14,home,0,0,0,0,0,0,0,away,31,14
7/21/2019,642,WMWashington Mystics,93,159,-110,WAS,Washington Mystics,-13,-110,1021900110,45,31,76,-14,home,1,1,1,1,1,1,1,home,45,-14
7/21/2019,643,IFIndiana Fever,70,158.5,-110,IND,Indiana Fever,5.5,-110,1021900111,27,36,63,9,away,0,0,1,1,1,1,1,away,36,-9
7/21/2019,644,CSChicago Sky,78,158.5,-110,CHI,Chicago Sky,-5.5,-115,1021900111,27,36,63,9,away,1,1,0,0,0,0,0,home,27,9
7/21/2019,645,MLMinnesota Lynx,74,156,105,MIN,Minnesota Lynx,6,-110,1021900112,39,37,76,-2,home,1,1,0,0,0,0,0,away,37,2
7/21/2019,646,LVLas Vegas Aces,79,156,-125,LVA,Las Vegas Aces,-6,-110,1021900112,39,37,76,-2,home,0,0,1,1,1,1,1,home,39,-2
7/23/2019,647,LSL.A. Sparks,78,148,-110,LAS,Los Angeles Sparks,-1,-110,1021900113,32,30,62,-2,home,1,0,0,1,1,0,1,away,30,2
7/23/2019,648,ADAtlanta Dream,66,148,-110,ATL,Atlanta Dream,1,-110,1021900113,32,30,62,-2,home,0,1,1,0,0,1,0,home,32,-2
7/23/2019,649,SSSeattle Storm,62,153.5,-110,SEA,Seattle Storm,5,-110,1021900114,36,35,71,-1,home,0,0,0,1,0,1,0,away,35,1
7/23/2019,650,LVLas Vegas Aces,79,153.5,-110,LVA,Las Vegas Aces,-5,-110,1021900114,36,35,71,-1,home,1,1,1,0,1,0,1,home,36,-1
7/23/2019,651,IFIndiana Fever,77,149.5,-115,IND,Indiana Fever,5.5,-110,1021900115,44,43,87,-1,home,1,1,1,0,1,0,0,away,43,1
7/23/2019,652,PPhoenix,95,149.5,-105,PHO,Phoenix Mercury,-5.5,-110,1021900115,44,43,87,-1,home,0,0,0,1,0,1,1,home,44,-1
7/24/2019,653,NYNew York Liberty,63,160.5,-110,NYL,New York Liberty,9.5,-110,1021900116,36,39,75,3,away,0,0,1,1,1,1,0,away,39,-3
7/24/2019,654,CSConnecticut Sun,70,160.5,-110,CON,Connecticut Sun,-9.5,-110,1021900116,36,39,75,3,away,1,1,0,0,0,0,1,home,36,3
7/24/2019,655,WMWashington Mystics,79,160,-115,WAS,Washington Mystics,-5.5,-110,1021900117,32,44,76,12,away,1,1,1,1,1,1,1,away,44,-12
7/24/2019,656,MLMinnesota Lynx,71,160,-110,MIN,Minnesota Lynx,5.5,-110,1021900117,32,44,76,12,away,0,0,0,0,0,0,0,home,32,12
7/31/2019,617,ADAtlanta Dream,59,152,-110,ATL,Atlanta Dream,5,-110,1021900121,32,25,57,-7,home,1,0,1,0,0,0,0,away,25,7
7/31/2019,618,IFIndiana Fever,61,152,-110,IND,Indiana Fever,-5,-110,1021900121,32,25,57,-7,home,0,1,0,1,1,1,1,home,32,-7
8/1/2019,619,PPhoenix,62,154,-110,PHO,Phoenix Mercury,7,-105,1021900122,32,36,68,4,away,1,0,1,1,1,1,0,away,36,-4
8/1/2019,620,CSConnecticut Sun,68,154,-110,CON,Connecticut Sun,-7,-115,1021900122,32,36,68,4,away,0,1,0,0,0,0,1,home,32,4
8/1/2019,621,NYNew York Liberty,64,151,-110,NYL,New York Liberty,-1,-105,1021900123,55,37,92,-18,home,0,0,0,0,1,0,0,away,37,18
8/1/2019,622,DWDallas Wings,87,151,-110,DAL,Dallas Wings,1,-115,1021900123,55,37,92,-18,home,1,1,1,1,0,1,1,home,55,-18
8/1/2019,623,LVLas Vegas Aces,68,154.5,-115,LVA,Las Vegas Aces,1,-105,1021900124,40,40,80,0,tie,0,0,0,0,0,0,0,away,40,-0
8/1/2019,624,LSL.A. Sparks,76,154.5,-110,LAS,Los Angeles Sparks,-1.5,-110,1021900124,40,40,80,0,tie,1,1,1,1,1,1,1,home,40,0
8/2/2019,625,WMWashington Mystics,99,158.5,-105,WAS,Washington Mystics,-5,-110,1021900125,34,48,82,14,away,1,1,1,1,1,1,1,away,48,-14
8/2/2019,626,SSSeattle Storm,79,158.5,-115,SEA,Seattle Storm,5,-110,1021900125,34,48,82,14,away,0,0,0,0,0,0,0,home,34,14
8/3/2019,627,MLMinnesota Lynx,75,150.5,-110,MIN,Minnesota Lynx,-3,-110,1021900127,38,48,86,10,away,1,1,1,1,1,1,1,away,48,-10
8/3/2019,628,IFIndiana Fever,86,150.5,-110,IND,Indiana Fever,3,-110,1021900127,38,48,86,10,away,0,0,0,0,0,0,0,home,38,10
8/3/2019,629,CSChicago Sky,87,157.5,-110,CHI,Chicago Sky,-4,-110,1021900126,42,46,88,4,away,0,0,0,0,0,0,0,away,46,-4
8/3/2019,630,ADAtlanta Dream,75,157.5,-110,ATL,Atlanta Dream,4,-110,1021900126,42,46,88,4,away,1,1,1,1,1,1,1,home,42,4
8/3/2019,631,LVLas Vegas Aces,75,145,-110,LVA,Las Vegas Aces,-4.5,-110,1021900128,37,42,79,5,away,1,1,1,1,1,1,1,away,42,-5
8/3/2019,632,DWDallas Wings,70,145,-110,DAL,Dallas Wings,4.5,-110,1021900128,37,42,79,5,away,0,0,0,0,0,0,0,home,37,5
8/4/2019,633,CSConnecticut Sun,94,158,-110,CON,Connecticut Sun,-6,-110,1021900129,38,53,91,15,away,1,1,1,1,1,1,1,away,53,-15
8/4/2019,634,NYNew York Liberty,79,158,-110,NYL,New York Liberty,6,-110,1021900129,38,53,91,15,away,0,0,0,0,0,0,0,home,38,15
8/4/2019,635,SSSeattle Storm,75,148,-110,SEA,Seattle Storm,4.5,-110,1021900130,50,41,91,-9,home,0,0,0,0,0,0,0,away,41,9
8/4/2019,636,LSL.A. Sparks,83,148,-110,LAS,Los Angeles Sparks,-4.5,-110,1021900130,50,41,91,-9,home,1,1,1,1,1,1,1,home,50,-9
8/4/2019,637,WMWashington Mystics,82,160,-110,WAS,Washington Mystics,-7.5,-110,1021900131,60,43,103,-17,home,0,1,1,0,0,0,0,away,43,17
8/4/2019,638,PPhoenix,103,160,-110,PHO,Phoenix Mercury,7.5,-110,1021900131,60,43,103,-17,home,1,0,0,1,1,1,1,home,60,-17
8/6/2019,639,MLMinnesota Lynx,85,145.5,-124,MIN,Minnesota Lynx,-5,-110,1021900132,41,41,82,0,tie,0,0,0,0,0,1,1,away,41,-0
8/6/2019,640,ADAtlanta Dream,69,145.5,104,ATL,Atlanta Dream,5,-110,1021900132,41,41,82,0,tie,1,1,1,1,1,0,0,home,41,0
8/7/2019,641,NYNew York Liberty,92,165,-110,NYL,New York Liberty,7.5,-115,1021900133,42,49,91,7,away,1,0,1,1,1,1,1,away,49,-7
8/7/2019,642,CSChicago Sky,101,165,-110,CHI,Chicago Sky,-7.5,-105,1021900133,42,49,91,7,away,0,1,0,0,0,0,0,home,42,7
8/8/2019,643,IFIndiana Fever,78,164.5,-110,IND,Indiana Fever,13,-112,1021900134,44,42,86,-2,home,0,0,0,0,0,0,1,away,42,2
8/8/2019,644,WMWashington Mystics,91,164.5,-110,WAS,Washington Mystics,-13,-108,1021900134,44,42,86,-2,home,1,1,1,1,1,1,0,home,44,-2
8/8/2019,645,PPhoenix,74,152,-110,PHO,Phoenix Mercury,6,-106,1021900135,44,32,76,-12,home,0,0,0,0,0,0,0,away,32,12
8/8/2019,646,LSL.A. Sparks,84,152,-110,LAS,Los Angeles Sparks,-6,-114,1021900135,44,32,76,-12,home,1,1,1,1,1,1,1,home,44,-12
8/8/2019,647,DWDallas Wings,57,146,-110,DAL,Dallas Wings,9.5,-115,1021900136,37,38,75,1,away,1,1,1,1,1,1,0,away,38,-1
8/8/2019,648,SSSeattle Storm,69,146,-110,SEA,Seattle Storm,-9.5,-105,1021900136,37,38,75,1,away,0,0,0,0,0,0,1,home,37,1
8/9/2019,649,CSConnecticut Sun,57,155,-110,CON,Connecticut Sun,-3,-110,1021900137,54,25,79,-29,home,0,0,0,0,0,0,0,away,25,29
8/9/2019,650,MLMinnesota Lynx,89,155,-110,MIN,Minnesota Lynx,3,-110,1021900137,54,25,79,-29,home,1,1,1,1,1,1,1,home,54,-29
8/9/2019,651,CSChicago Sky,87,164.5,-110,CHI,Chicago Sky,7,-110,1021900138,41,48,89,7,away,1,1,1,1,1,1,1,away,48,-7
8/9/2019,652,LVLas Vegas Aces,84,164.5,-110,LVA,Las Vegas Aces,-7,-110,1021900138,41,48,89,7,away,0,0,0,0,0,0,0,home,41,7
8/10/2019,653,ADAtlanta Dream,82,151,-110,ATL,Atlanta Dream,5.5,-110,1021900139,41,39,80,-2,home,0,0,0,1,0,0,0,away,39,2
8/10/2019,654,IFIndiana Fever,87,151,-115,IND,Indiana Fever,-5.5,-110,1021900139,41,39,80,-2,home,1,1,1,0,1,1,1,home,41,-2
8/10/2019,655,DWDallas Wings,80,145.5,-110,DAL,Dallas Wings,9,-110,1021900140,46,40,86,-6,home,1,0,1,0,0,0,0,away,40,6
8/10/2019,656,PPhoenix,77,145.5,-115,PHO,Phoenix Mercury,-9,-110,1021900140,46,40,86,-6,home,0,1,0,1,1,1,1,home,46,-6
8/13/2019,609,MLMinnesota Lynx,89,156.5,-110,MIN,Minnesota Lynx,-6,-105,1021900145,40,42,82,2,away,0,1,1,1,1,1,1,away,42,-2
8/13/2019,610,NYNew York Liberty,73,156.5,-110,NYL,New York Liberty,6,-115,1021900145,40,42,82,2,away,1,0,0,0,0,0,0,home,40,2
8/13/2019,611,ADAtlanta Dream,90,152.5,-110,ATL,Atlanta Dream,13,-110,1021900146,43,49,92,6,away,0,0,0,0,1,1,1,away,49,-6
8/13/2019,612,LVLas Vegas Aces,94,152.5,-110,LVA,Las Vegas Aces,-13,-110,1021900146,43,49,92,6,away,1,1,1,1,0,0,0,home,43,6
8/14/2019,613,LSL.A. Sparks,78,147.5,-110,LAS,Los Angeles Sparks,-7,-110,1021900148,39,42,81,3,away,0,0,0,0,0,1,1,away,42,-3
8/14/2019,614,DWDallas Wings,84,147.5,-110,DAL,Dallas Wings,7,-115,1021900148,39,42,81,3,away,1,1,1,1,1,0,0,home,39,3
8/14/2019,615,SSSeattle Storm,59,161.5,-110,SEA,Seattle Storm,9,-110,1021900147,38,35,73,-3,home,0,1,1,1,1,1,0,away,35,3
8/14/2019,616,WMWashington Mystics,88,161.5,-110,WAS,Washington Mystics,-9,-110,1021900147,38,35,73,-3,home,1,0,0,0,0,0,1,home,38,-3
8/14/2019,617,CSConnecticut Sun,78,154.5,-110,CON,Connecticut Sun,-7,-115,1021900149,34,49,83,15,away,1,1,1,1,1,1,1,away,49,-15
8/14/2019,618,PPhoenix,71,154.5,-110,PHO,Phoenix Mercury,7,-105,1021900149,34,49,83,15,away,0,0,0,0,0,0,0,home,34,15
7/26/2020,659,CSChicago Sky,88,175,-110,CHI,Chicago Sky,-3.5,-110,1022001005,48,46,94,-2,home,0,0,0,0,0,1,0,away,46,2
7/26/2020,660,LVLas Vegas Aces,86,175,-110,LVA,Las Vegas Aces,3.5,-110,1022001005,48,46,94,-2,home,1,1,1,1,1,0,1,home,48,-2
7/26/2020,661,DWDallas Wings,95,154.5,-110,DAL,Dallas Wings,-6,-108,1022001006,53,49,102,-4,home,0,0,0,1,1,1,0,away,49,4
7/26/2020,662,ADAtlanta Dream,105,154.5,-110,ATL,Atlanta Dream,6,-112,1022001006,53,49,102,-4,home,1,1,1,0,0,0,1,home,53,-4
7/30/2020,675,SSSeattle Storm,71,174,-110,SEA,Seattle Storm,-7.5,-115,1022001013,50,32,82,-18,home,0,0,0,0,0,0,0,away,32,18
7/30/2020,676,WMWashington Mystics,89,174,-110,WAS,Washington Mystics,7.5,-110,1022001013,50,32,82,-18,home,1,1,1,1,1,1,1,home,50,-18
7/30/2020,677,CSChicago Sky,81,167,-110,CHI,Chicago Sky,-5,-110,1022001014,38,34,72,-4,home,1,1,0,0,0,0,0,away,34,4
7/30/2020,678,MLMinnesota Lynx,83,167,-110,MIN,Minnesota Lynx,5,-110,1022001014,38,34,72,-4,home,0,0,1,1,1,1,1,home,38,-4
7/30/2020,679,CSConnecticut Sun,76,166,-115,CON,Connecticut Sun,6.5,-110,1022001015,41,36,77,-5,home,1,1,1,0,0,0,0,away,36,5
7/30/2020,680,LSL.A. Sparks,81,166,-110,LAS,Los Angeles Sparks,-6.5,-110,1022001015,41,36,77,-5,home,0,0,0,1,1,1,1,home,41,-5
8/18/2020,607,IFIndiana Fever,62,164.5,-110,IND,Indiana Fever,5.5,-110,1022001064,37,34,71,-3,home,0,0,0,0,0,0,0,away,34,3
8/18/2020,608,CSConnecticut Sun,84,164.5,-110,CON,Connecticut Sun,-5.5,-110,1022001064,37,34,71,-3,home,1,1,1,1,1,1,1,home,37,-3
8/18/2020,609,LVLas Vegas Aces,82,171.5,-105,LVA,Las Vegas Aces,-4.5,-110,1022001065,39,46,85,7,away,1,1,1,1,1,1,1,away,46,-7
8/18/2020,610,CSChicago Sky,84,171.5,-110,CHI,Chicago Sky,4.5,-110,1022001065,39,46,85,7,away,0,0,0,0,0,0,0,home,39,7
8/18/2020,611,NYNew York Liberty,64,158,-110,NYL,New York Liberty,19,-105,1022001066,61,28,89,-33,home,0,0,0,0,0,0,0,away,28,33
8/18/2020,612,SSSeattle Storm,105,158,-110,SEA,Seattle Storm,-19,-115,1022001066,61,28,89,-33,home,1,1,1,1,1,1,1,home,61,-33
8/19/2020,613,ADAtlanta Dream,91,160,-110,ATL,Atlanta Dream,7,-110,1022001067,45,39,84,-6,home,0,0,1,0,0,0,0,away,39,6
8/19/2020,614,WMWashington Mystics,98,160,-110,WAS,Washington Mystics,-7,-110,1022001067,45,39,84,-6,home,1,1,0,1,1,1,1,home,45,-6
8/19/2020,615,DWDallas Wings,84,156.5,-110,DAL,Dallas Wings,6,-110,1022001068,39,43,82,4,away,0,1,1,1,0,1,1,away,43,-4
8/19/2020,616,MLMinnesota Lynx,91,156.5,-110,MIN,Minnesota Lynx,-6,-110,1022001068,39,43,82,4,away,1,0,0,0,1,0,0,home,39,4
8/19/2020,617,PPhoenix,74,168.5,-115,PHO,Phoenix Mercury,5.5,-110,1022001069,42,26,68,-16,home,0,0,0,0,0,0,0,away,26,16
8/19/2020,618,LSL.A. Sparks,83,168.5,-105,LAS,Los Angeles Sparks,-5.5,-110,1022001069,42,26,68,-16,home,1,1,1,1,1,1,1,home,42,-16
8/21/2020,625,LSL.A. Sparks,93,163.5,-110,LAS,Los Angeles Sparks,-15.5,-110,1022001073,35,40,75,5,away,0,1,1,1,1,1,1,away,40,-5
8/21/2020,626,ADAtlanta Dream,85,163.5,-110,ATL,Atlanta Dream,15.5,-110,1022001073,35,40,75,5,away,1,0,0,0,0,0,0,home,35,5
8/21/2020,627,WMWashington Mystics,92,160,-110,WAS,Washington Mystics,3.5,-110,1022001074,56,36,92,-20,home,0,0,0,0,0,0,0,away,36,20
8/21/2020,628,DWDallas Wings,101,160,-110,DAL,Dallas Wings,-3.5,-110,1022001074,56,36,92,-20,home,1,1,1,1,1,1,1,home,56,-20
8/21/2020,629,MLMinnesota Lynx,90,164,-110,MIN,Minnesota Lynx,1.5,-110,1022001075,42,51,93,9,away,1,1,1,1,1,1,0,away,51,-9
8/21/2020,630,PPhoenix,80,164,-110,PHO,Phoenix Mercury,-1.5,-110,1022001075,42,51,93,9,away,0,0,0,0,0,0,1,home,42,9
8/23/2020,637,ADAtlanta Dream,78,162.5,-110,ATL,Atlanta Dream,11.5,-110,1022001079,41,30,71,-11,home,0,0,0,0,0,0,0,away,30,11
8/23/2020,638,MLMinnesota Lynx,75,162.5,-110,MIN,Minnesota Lynx,-11.5,-110,1022001079,41,30,71,-11,home,1,1,1,1,1,1,1,home,41,-11
8/23/2020,639,DWDallas Wings,81,161.5,-110,DAL,Dallas Wings,10.5,-110,1022001080,38,42,80,4,away,0,0,0,0,0,1,1,away,42,-4
8/23/2020,640,LSL.A. Sparks,84,161.5,-110,LAS,Los Angeles Sparks,-10.5,-110,1022001080,38,42,80,4,away,1,1,1,1,1,0,0,home,38,4
8/23/2020,641,PPhoenix,88,167,-110,PHO,Phoenix Mercury,-4.5,-112,1022001081,39,38,77,-1,home,0,0,1,0,1,1,1,away,38,1
8/23/2020,642,WMWashington Mystics,87,167,-110,WAS,Washington Mystics,4.5,-108,1022001081,39,38,77,-1,home,1,1,0,1,0,0,0,home,39,-1
9/11/2020,649,ADAtlanta Dream,82,166,-115,ATL,Atlanta Dream,2,-110,1022001127,36,33,69,-3,home,0,0,0,0,0,0,0,away,33,3
9/11/2020,650,CSConnecticut Sun,75,166,-105,CON,Connecticut Sun,-2,-110,1022001127,36,33,69,-3,home,1,1,1,1,1,1,1,home,36,-3
9/11/2020,651,CSChicago Sky,95,172.5,-110,CHI,Chicago Sky,-5,-110,1022001128,44,50,94,6,away,1,0,1,1,0,0,1,away,50,-6
9/11/2020,652,DWDallas Wings,88,172.5,-110,DAL,Dallas Wings,5.5,-115,1022001128,44,50,94,6,away,0,1,0,0,1,1,0,home,44,6
9/11/2020,653,SSSeattle Storm,83,166.5,-110,SEA,Seattle Storm,-4.5,-110,1022001129,26,50,76,24,away,1,1,1,1,1,1,1,away,50,-24
9/11/2020,654,PPhoenix,60,166.5,-110,PHO,Phoenix Mercury,4.5,-110,1022001129,26,50,76,24,away,0,0,0,0,0,0,0,home,26,24
9/15/2020,601,CSConnecticut Sun,94,165.5,-110,CON,Connecticut Sun,2,-105,1042000111,41,41,82,0,tie,0,0,1,1,1,1,0,away,41,-0
9/15/2020,602,CSChicago Sky,81,165.5,-110,CHI,Chicago Sky,-2,-105,1042000111,41,41,82,0,tie,1,1,0,0,0,0,1,home,41,0
9/15/2020,603,WMWashington Mystics,84,164.5,-110,WAS,Washington Mystics,4.5,-110,1042000101,35,46,81,11,away,1,1,1,1,1,1,1,away,46,-11
9/15/2020,604,PPhoenix,85,164.5,-110,PHO,Phoenix Mercury,-4.5,-110,1042000101,35,46,81,11,away,0,0,0,0,0,0,0,home,35,11
9/17/2020,605,PPhoenix,79,167.5,-110,PHO,Phoenix Mercury,4.5,-110,1042000211,37,46,83,9,away,1,1,1,0,1,0,1,away,46,-9
9/17/2020,606,MLMinnesota Lynx,80,167,100,MIN,Minnesota Lynx,-4.5,-110,1042000211,37,46,83,9,away,0,0,0,1,0,1,0,home,37,9
9/17/2020,607,CSConnecticut Sun,73,159,-110,CON,Connecticut Sun,5,-105,1042000201,23,39,62,16,away,1,1,1,1,1,1,1,away,39,-16
9/17/2020,608,LSL.A. Sparks,59,158,-102,LAS,Los Angeles Sparks,-5,-115,1042000201,23,39,62,16,away,0,0,0,0,0,0,0,home,23,16
9/20/2020,611,CSConnecticut Sun,87,162.5,-110,CON,Connecticut Sun,6,-110,1042000301,25,36,61,11,away,0,1,1,1,1,1,1,away,36,-11
9/20/2020,612,LVLas Vegas Aces,62,162.5,-110,LVA,Las Vegas Aces,-6,-110,1042000301,25,36,61,11,away,1,0,0,0,0,0,0,home,25,11
9/20/2020,613,MLMinnesota Lynx,NA,162.5,-110,MIN,Minnesota Lynx,8.5,-115,NA,NA,NA,NA,NA,NA,NA,NA,NA,NA,NA,NA,NA,NA,NA,NA
9/20/2020,614,SSSeattle Storm,NA,162.5,-110,SEA,Seattle Storm,-8.5,-105,NA,NA,NA,NA,NA,NA,NA,NA,NA,NA,NA,NA,NA,NA,NA,NA
9/22/2020,617,CSConnecticut Sun,75,161,-110,CON,Connecticut Sun,5.5,-110,1042000302,38,39,77,1,away,0,0,1,1,1,1,0,away,39,-1
9/22/2020,618,LVLas Vegas Aces,83,161,-110,LVA,Las Vegas Aces,-5.5,-110,1042000302,38,39,77,1,away,1,1,0,0,0,0,1,home,38,1
9/22/2020,615,MLMinnesota Lynx,86,163,-110,MIN,Minnesota Lynx,9,-110,1042000311,50,45,95,-5,home,1,1,1,1,1,1,1,away,45,5
9/22/2020,616,SSSeattle Storm,88,163,-110,SEA,Seattle Storm,-9,-110,1042000311,50,45,95,-5,home,0,0,0,0,0,0,0,home,50,-5
9/24/2020,631,MLMinnesota Lynx,79,164,-110,MIN,Minnesota Lynx,8,-105,1042000312,46,33,79,-13,home,1,0,0,0,0,0,0,away,33,13
9/24/2020,632,SSSeattle Storm,89,164,-110,SEA,Seattle Storm,-8,-115,1042000312,46,33,79,-13,home,0,1,1,1,1,1,1,home,46,-13
9/24/2020,619,LVLas Vegas Aces,68,160.5,-110,LVA,Las Vegas Aces,-6,-110,1042000303,38,32,70,-6,home,1,1,0,1,0,0,0,away,32,6
9/24/2020,620,CSConnecticut Sun,77,160.5,-110,CON,Connecticut Sun,6,-110,1042000303,38,32,70,-6,home,0,0,1,0,1,1,1,home,38,-6
9/27/2020,623,LVLas Vegas Aces,84,156.5,-110,LVA,Las Vegas Aces,-2.5,-110,1042000304,38,37,75,-1,home,1,1,0,0,0,0,1,away,37,1
9/27/2020,624,CSConnecticut Sun,75,156.5,-110,CON,Connecticut Sun,2.5,-110,1042000304,38,37,75,-1,home,0,0,1,1,1,1,0,home,38,-1
9/27/2020,625,SSSeattle Storm,92,165,-110,SEA,Seattle Storm,-8.5,-105,1042000313,31,46,77,15,away,1,1,1,1,1,1,1,away,46,-15
9/27/2020,626,MLMinnesota Lynx,71,165,-110,MIN,Minnesota Lynx,8.5,-115,1042000313,31,46,77,15,away,0,0,0,0,0,0,0,home,31,15
9/29/2020,627,CSConnecticut Sun,63,157,-110,CON,Connecticut Sun,3,-110,1042000305,39,45,84,6,away,1,1,1,1,1,1,1,away,45,-6
9/29/2020,628,LVLas Vegas Aces,66,157,-110,LVA,Las Vegas Aces,-2.5,-115,1042000305,39,45,84,6,away,0,0,0,0,0,0,0,home,39,6
10/2/2020,601,SSSeattle Storm,93,164,-110,SEA,Seattle Storm,-6,-110,1042000401,40,57,97,17,away,0,1,1,0,0,1,1,away,57,-17
10/2/2020,602,LVLas Vegas Aces,80,164,-110,LVA,Las Vegas Aces,6,-110,1042000401,40,57,97,17,away,1,0,0,1,1,0,0,home,40,17
10/4/2020,603,SSSeattle Storm,104,167,-110,SEA,Seattle Storm,-7.5,-110,1042000402,42,48,90,6,away,1,1,1,1,1,1,1,away,48,-6
10/4/2020,604,LVLas Vegas Aces,91,167,-110,LVA,Las Vegas Aces,7,-105,1042000402,42,48,90,6,away,0,0,0,0,0,0,0,home,42,6
10/6/2020,605,LVLas Vegas Aces,59,171.5,-112,LVA,Las Vegas Aces,7.5,-110,1042000403,43,34,77,-9,home,1,1,1,0,0,0,0,away,34,9
10/6/2020,606,SSSeattle Storm,92,171.5,-108,SEA,Seattle Storm,-7.5,-110,1042000403,43,34,77,-9,home,0,0,0,1,1,1,1,home,43,-9
7/28/2020,663,WMWashington Mystics,94,166.5,-110,WAS,Washington Mystics,-3,-110,1022001007,52,48,100,-4,home,1,1,1,1,1,1,1,away,48,4
7/28/2020,664,CSConnecticut Sun,89,166.5,-110,CON,Connecticut Sun,3.5,-115,1022001007,52,48,100,-4,home,0,0,0,0,0,0,0,home,52,-4
7/28/2020,665,LSL.A. Sparks,78,172.5,-110,LAS,Los Angeles Sparks,-5.5,-110,1022001008,40,36,76,-4,home,0,0,0,0,0,1,0,away,36,4
7/28/2020,666,CSChicago Sky,96,172.5,-110,CHI,Chicago Sky,5.5,-110,1022001008,40,36,76,-4,home,1,1,1,1,1,0,1,home,40,-4
7/28/2020,667,MLMinnesota Lynx,66,156.5,-118,MIN,Minnesota Lynx,9.5,-105,1022001009,41,35,76,-6,home,0,0,0,0,0,0,0,away,35,6
7/28/2020,668,SSSeattle Storm,90,156.5,-102,SEA,Seattle Storm,-9.5,-115,1022001009,41,35,76,-6,home,1,1,1,1,1,1,1,home,41,-6
7/29/2020,669,PPhoenix,100,165,-115,PHO,Phoenix Mercury,-5,-110,1022001010,56,53,109,-3,home,1,1,1,1,1,1,0,away,53,3
7/29/2020,670,IFIndiana Fever,106,165,-105,IND,Indiana Fever,5,-110,1022001010,56,53,109,-3,home,0,0,0,0,0,0,1,home,56,-3
7/29/2020,671,NYNew York Liberty,80,166,-110,NYL,New York Liberty,4.5,-110,1022001011,58,43,101,-15,home,1,0,0,0,0,0,0,away,43,15
7/29/2020,672,DWDallas Wings,93,166,-110,DAL,Dallas Wings,-4.5,-110,1022001011,58,43,101,-15,home,0,1,1,1,1,1,1,home,58,-15
7/29/2020,673,ADAtlanta Dream,70,175,-110,ATL,Atlanta Dream,8,-110,1022001012,47,35,82,-12,home,0,0,0,0,0,0,0,away,35,12
7/29/2020,674,LVLas Vegas Aces,100,175,-110,LVA,Las Vegas Aces,-8,-110,1022001012,47,35,82,-12,home,1,1,1,1,1,1,1,home,47,-12
7/31/2020,681,NYNew York Liberty,78,168.5,-110,NYL,New York Liberty,5,-110,1022001016,41,43,84,2,away,0,0,0,0,0,0,1,away,43,-2
7/31/2020,682,ADAtlanta Dream,84,168.5,-110,ATL,Atlanta Dream,-5,-110,1022001016,41,43,84,2,away,1,1,1,1,1,1,0,home,41,2
7/31/2020,683,IFIndiana Fever,73,171.5,-110,IND,Indiana Fever,2.5,-110,1022001017,31,43,74,12,away,1,1,1,1,1,1,1,away,43,-12
7/31/2020,684,DWDallas Wings,76,171.5,-110,DAL,Dallas Wings,-2.5,-110,1022001017,31,43,74,12,away,0,0,0,0,0,0,0,home,31,12
7/31/2020,685,LVLas Vegas Aces,95,176,-108,LVA,Las Vegas Aces,-7,-110,1022001018,50,41,91,-9,home,0,0,0,0,0,0,0,away,41,9
7/31/2020,686,PPhoenix,102,175.5,-110,PHO,Phoenix Mercury,7,-110,1022001018,50,41,91,-9,home,1,1,1,1,1,1,1,home,50,-9
8/1/2020,601,MLMinnesota Lynx,78,156,-110,MIN,Minnesota Lynx,4,-112,1022001019,42,35,77,-7,home,0,0,1,0,0,0,0,away,35,7
8/1/2020,602,CSConnecticut Sun,69,156,-110,CON,Connecticut Sun,-3.5,-115,1022001019,42,35,77,-7,home,1,1,0,1,1,1,1,home,42,-7
8/1/2020,603,WMWashington Mystics,86,178,-115,WAS,Washington Mystics,-3.5,-115,1022001020,35,37,72,2,away,1,1,0,0,0,0,1,away,37,-2
8/1/2020,604,CSChicago Sky,88,178,-110,CHI,Chicago Sky,3.5,-105,1022001020,35,37,72,2,away,0,0,1,1,1,1,0,home,35,2
8/1/2020,605,LSL.A. Sparks,75,162.5,-110,LAS,Los Angeles Sparks,4.5,-115,1022001021,45,29,74,-16,home,0,0,0,0,0,0,0,away,29,16
8/1/2020,606,SSSeattle Storm,81,162.5,-110,SEA,Seattle Storm,-4.5,-105,1022001021,45,29,74,-16,home,1,1,1,1,1,1,1,home,45,-16
8/2/2020,607,PPhoenix,96,169.5,-115,PHO,Phoenix Mercury,-11,-110,1022001022,27,41,68,14,away,1,1,1,1,1,1,1,away,41,-14
8/2/2020,608,NYNew York Liberty,67,169.5,-110,NYL,New York Liberty,11,-110,1022001022,27,41,68,14,away,0,0,0,0,0,0,0,home,27,14
8/2/2020,609,ADAtlanta Dream,77,170,-110,ATL,Atlanta Dream,-1,-115,1022001023,47,39,86,-8,home,1,0,0,0,0,0,0,away,39,8
8/2/2020,610,IFIndiana Fever,93,170,-110,IND,Indiana Fever,1,-110,1022001023,47,39,86,-8,home,0,1,1,1,1,1,1,home,47,-8
8/2/2020,611,DWDallas Wings,70,171,-110,DAL,Dallas Wings,6.5,-110,1022001024,42,37,79,-5,home,0,0,0,0,0,0,0,away,37,5
8/2/2020,612,LVLas Vegas Aces,79,171,-110,LVA,Las Vegas Aces,-6.5,-110,1022001024,42,37,79,-5,home,1,1,1,1,1,1,1,home,42,-5
8/4/2020,613,DWDallas Wings,79,172,-110,DAL,Dallas Wings,6.5,-110,1022001025,43,42,85,-1,home,0,0,1,1,0,0,0,away,42,1
8/4/2020,614,CSChicago Sky,82,172,-110,CHI,Chicago Sky,-6.5,-110,1022001025,43,42,85,-1,home,1,1,0,0,1,1,1,home,43,-1
8/4/2020,615,PPhoenix,81,177.5,-110,PHO,Phoenix Mercury,-6,-115,1022001026,35,33,68,-2,home,1,1,0,0,0,0,0,away,33,2
8/4/2020,616,ADAtlanta Dream,74,177.5,-110,ATL,Atlanta Dream,6,-105,1022001026,35,33,68,-2,home,0,0,1,1,1,1,1,home,35,-2
8/4/2020,617,CSConnecticut Sun,74,156,-110,CON,Connecticut Sun,10.5,-110,1022001027,38,40,78,2,away,1,1,0,0,1,1,1,away,40,-2
8/4/2020,618,SSSeattle Storm,87,156,-110,SEA,Seattle Storm,-10.5,-110,1022001027,38,40,78,2,away,0,0,1,1,0,0,0,home,38,2
8/5/2020,619,MLMinnesota Lynx,92,157,-110,MIN,Minnesota Lynx,-5.5,-110,1022001028,39,44,83,5,away,0,1,1,1,1,1,1,away,44,-5
8/5/2020,620,NYNew York Liberty,66,157,-110,NYL,New York Liberty,5.5,-110,1022001028,39,44,83,5,away,1,0,0,0,0,0,0,home,39,5
8/5/2020,621,LVLas Vegas Aces,83,176,-110,LVA,Las Vegas Aces,2.5,-110,1022001029,37,35,72,-2,home,0,0,0,0,0,0,0,away,35,2
8/5/2020,622,WMWashington Mystics,77,176,-110,WAS,Washington Mystics,-2.5,-110,1022001029,37,35,72,-2,home,1,1,1,1,1,1,1,home,37,-2
8/5/2020,623,IFIndiana Fever,75,163.5,-110,IND,Indiana Fever,7.5,-110,1022001030,42,31,73,-11,home,0,0,0,0,0,0,0,away,31,11
8/5/2020,624,LSL.A. Sparks,86,163.5,-110,LAS,Los Angeles Sparks,-8,-110,1022001030,42,31,73,-11,home,1,1,1,1,1,1,1,home,42,-11
8/6/2020,625,SSSeattle Storm,93,157,-110,SEA,Seattle Storm,-11,-110,1022001031,39,54,93,15,away,0,1,1,1,1,1,1,away,54,-15
8/6/2020,626,ADAtlanta Dream,92,157,-110,ATL,Atlanta Dream,11,-110,1022001031,39,54,93,15,away,1,0,0,0,0,0,0,home,39,15
8/6/2020,627,CSConnecticut Sun,91,160,-110,CON,Connecticut Sun,-3.5,-110,1022001032,31,43,74,12,away,1,1,1,1,1,1,1,away,43,-12
8/6/2020,628,DWDallas Wings,68,160,-110,DAL,Dallas Wings,3.5,-110,1022001032,31,43,74,12,away,0,0,0,0,0,0,0,home,31,12
8/6/2020,629,CSChicago Sky,86,176.5,-110,CHI,Chicago Sky,-4.5,-110,1022001033,55,49,104,-6,home,1,1,0,0,0,0,0,away,49,6
8/6/2020,630,PPhoenix,96,176.5,-110,PHO,Phoenix Mercury,4.5,-110,1022001033,55,49,104,-6,home,0,0,1,1,1,1,1,home,55,-6
8/7/2020,631,IFIndiana Fever,80,158.5,-110,IND,Indiana Fever,5,-105,1022001034,41,34,75,-7,home,0,1,1,1,0,0,0,away,34,7
8/7/2020,632,MLMinnesota Lynx,87,158,-115,MIN,Minnesota Lynx,-5,-115,1022001034,41,34,75,-7,home,1,0,0,0,1,1,1,home,41,-7
8/7/2020,633,NYNew York Liberty,74,167,-110,NYL,New York Liberty,16.5,-110,1022001035,31,40,71,9,away,0,1,1,1,1,1,1,away,40,-9
8/7/2020,634,WMWashington Mystics,66,167,-110,WAS,Washington Mystics,-16.5,-110,1022001035,31,40,71,9,away,1,0,0,0,0,0,0,home,31,9
8/7/2020,635,LSL.A. Sparks,82,166,-110,LAS,Los Angeles Sparks,5,-115,1022001036,43,42,85,-1,home,0,0,0,0,0,0,0,away,42,1
8/7/2020,636,LVLas Vegas Aces,86,166,-110,LVA,Las Vegas Aces,-5,-105,1022001036,43,42,85,-1,home,1,1,1,1,1,1,1,home,43,-1
8/8/2020,637,ADAtlanta Dream,75,167,-110,ATL,Atlanta Dream,1.5,-110,1022001037,41,42,83,1,away,0,0,0,0,1,1,1,away,42,-1
8/8/2020,638,DWDallas Wings,85,165.5,-110,DAL,Dallas Wings,-1.5,-110,1022001037,41,42,83,1,away,1,1,1,1,0,0,0,home,41,1
8/8/2020,639,PPhoenix,68,166.5,-110,PHO,Phoenix Mercury,5,-110,1022001038,42,23,65,-19,home,1,1,0,0,0,0,0,away,23,19
8/8/2020,640,SSSeattle Storm,74,166.5,-110,SEA,Seattle Storm,-5,-110,1022001038,42,23,65,-19,home,0,0,1,1,1,1,1,home,42,-19
8/8/2020,641,CSChicago Sky,100,168.5,-110,CHI,Chicago Sky,-2.5,-115,1022001039,46,52,98,6,away,1,1,1,1,1,1,1,away,52,-6
8/8/2020,642,CSConnecticut Sun,93,167,-115,CON,Connecticut Sun,2.5,-105,1022001039,46,52,98,6,away,0,0,0,0,0,0,0,home,46,6
8/9/2020,647,MLMinnesota Lynx,81,152,-110,MIN,Minnesota Lynx,8,-110,1022001042,48,38,86,-10,home,0,0,0,0,0,0,0,away,38,10
8/9/2020,648,LSL.A. Sparks,97,152,-110,LAS,Los Angeles Sparks,-8,-110,1022001042,48,38,86,-10,home,1,1,1,1,1,1,1,home,48,-10
8/9/2020,643,LVLas Vegas Aces,78,164,-110,LVA,Las Vegas Aces,-13.5,-110,1022001040,44,37,81,-7,home,0,0,0,0,1,0,0,away,37,7
8/9/2020,644,NYNew York Liberty,76,164,-110,NYL,New York Liberty,13.5,-110,1022001040,44,37,81,-7,home,1,1,1,1,0,1,1,home,44,-7
8/9/2020,645,WMWashington Mystics,84,167.5,-110,WAS,Washington Mystics,-4,-110,1022001041,52,39,91,-13,home,1,0,1,1,1,1,0,away,39,13
8/9/2020,646,IFIndiana Fever,91,167.5,-110,IND,Indiana Fever,4,-110,1022001041,52,39,91,-13,home,0,1,0,0,0,0,1,home,52,-13
8/10/2020,649,CSConnecticut Sun,93,166,-110,CON,Connecticut Sun,-5,-110,1022001043,46,56,102,10,away,0,0,1,0,1,1,1,away,56,-10
8/10/2020,650,ADAtlanta Dream,82,166,-110,ATL,Atlanta Dream,5,-115,1022001043,46,56,102,10,away,1,1,0,1,0,0,0,home,46,10
8/10/2020,651,PPhoenix,91,165.5,-110,PHO,Phoenix Mercury,-3.5,-110,1022001044,38,44,82,6,away,0,0,0,1,1,1,1,away,44,-6
8/10/2020,652,DWDallas Wings,79,165,-110,DAL,Dallas Wings,3.5,-110,1022001044,38,44,82,6,away,1,1,1,0,0,0,0,home,38,6
8/10/2020,653,CSChicago Sky,71,170,-110,CHI,Chicago Sky,4.5,-110,1022001045,46,28,74,-18,home,0,0,0,0,0,0,0,away,28,18
8/10/2020,654,SSSeattle Storm,89,170,-110,SEA,Seattle Storm,-4.5,-110,1022001045,46,28,74,-18,home,1,1,1,1,1,1,1,home,46,-18
8/11/2020,657,LVLas Vegas Aces,98,167.5,-110,LVA,Las Vegas Aces,-6.5,-110,1022001047,59,60,119,1,away,0,1,1,1,1,1,1,away,60,-1
8/11/2020,658,IFIndiana Fever,79,167.5,-110,IND,Indiana Fever,6.5,-110,1022001047,59,60,119,1,away,1,0,0,0,0,0,0,home,59,1
8/11/2020,655,WMWashington Mystics,48,160.5,-110,WAS,Washington Mystics,-1.5,-110,1022001046,48,27,75,-21,home,0,0,0,0,0,0,0,away,27,21
8/11/2020,656,MLMinnesota Lynx,68,160.5,-110,MIN,Minnesota Lynx,1.5,-110,1022001046,48,27,75,-21,home,1,1,1,1,1,1,1,home,48,-21
8/11/2020,659,NYNew York Liberty,78,160.5,-110,NYL,New York Liberty,13,-110,1022001048,51,34,85,-17,home,0,0,0,0,0,0,0,away,34,17
8/11/2020,660,LSL.A. Sparks,93,160.5,-110,LAS,Los Angeles Sparks,-13,-110,1022001048,51,34,85,-17,home,1,1,1,1,1,1,1,home,51,-17
8/12/2020,661,DWDallas Wings,66,161.5,-110,DAL,Dallas Wings,4.5,-105,1022001049,25,34,59,9,away,1,1,1,1,1,1,1,away,34,-9
8/12/2020,662,CSConnecticut Sun,70,161.5,-110,CON,Connecticut Sun,-4.5,-115,1022001049,25,34,59,9,away,0,0,0,0,0,0,0,home,25,9
8/12/2020,663,PPhoenix,71,175.5,-115,PHO,Phoenix Mercury,5.5,-115,1022001050,42,36,78,-6,home,1,0,0,0,0,0,0,away,36,6
8/12/2020,664,CSChicago Sky,89,175,103,CHI,Chicago Sky,-5.5,-110,1022001050,42,36,78,-6,home,0,1,1,1,1,1,1,home,42,-6
8/12/2020,665,ADAtlanta Dream,63,159,-110,ATL,Atlanta Dream,13.5,-110,1022001051,47,28,75,-19,home,0,0,0,0,0,0,0,away,28,19
8/12/2020,666,SSSeattle Storm,100,159,-110,SEA,Seattle Storm,-14,-110,1022001051,47,28,75,-19,home,1,1,1,1,1,1,1,home,47,-19
8/13/2020,667,IFIndiana Fever,86,163.5,-110,IND,Indiana Fever,-7,-105,1022001052,40,51,91,11,away,0,1,1,1,1,1,1,away,51,-11
8/13/2020,668,NYNew York Liberty,79,163.5,-110,NYL,New York Liberty,7,-115,1022001052,40,51,91,11,away,1,0,0,0,0,0,0,home,40,11
8/13/2020,669,LSL.A. Sparks,81,162,-110,LAS,Los Angeles Sparks,-7.5,-115,1022001053,34,47,81,13,away,1,1,1,1,1,1,1,away,47,-13
8/13/2020,670,WMWashington Mystics,64,162,-110,WAS,Washington Mystics,7.5,-105,1022001053,34,47,81,13,away,0,0,0,0,0,0,0,home,34,13
8/13/2020,671,MLMinnesota Lynx,77,158.5,-115,MIN,Minnesota Lynx,3.5,-110,1022001054,53,37,90,-16,home,1,1,1,0,0,0,0,away,37,16
8/13/2020,672,LVLas Vegas Aces,87,158.5,-105,LVA,Las Vegas Aces,-3.5,-110,1022001054,53,37,90,-16,home,0,0,0,1,1,1,1,home,53,-16
8/14/2020,673,CSConnecticut Sun,77,168,-115,CON,Connecticut Sun,6,-118,1022001055,28,37,65,9,away,0,0,0,1,1,1,1,away,37,-9
8/14/2020,674,CSChicago Sky,74,168,-110,CHI,Chicago Sky,-6,-105,1022001055,28,37,65,9,away,1,1,1,0,0,0,0,home,28,9
8/14/2020,675,SSSeattle Storm,83,157,-110,SEA,Seattle Storm,-13.5,-110,1022001056,31,44,75,13,away,1,1,1,1,1,1,1,away,44,-13
8/14/2020,676,DWDallas Wings,65,157,-110,DAL,Dallas Wings,13.5,-110,1022001056,31,44,75,13,away,0,0,0,0,0,0,0,home,31,13
8/14/2020,677,ADAtlanta Dream,80,166.5,-108,ATL,Atlanta Dream,9,-110,1022001057,44,34,78,-10,home,0,0,0,0,0,0,0,away,34,10
8/14/2020,678,PPhoenix,96,166.5,-112,PHO,Phoenix Mercury,-9,-110,1022001057,44,34,78,-10,home,1,1,1,1,1,1,1,home,44,-10
8/15/2020,683,WMWashington Mystics,73,162,-110,WAS,Washington Mystics,9,-108,1022001060,43,31,74,-12,home,1,0,0,0,0,0,0,away,31,12
8/15/2020,684,LVLas Vegas Aces,88,162,-110,LVA,Las Vegas Aces,-9.5,-110,1022001060,43,31,74,-12,home,0,1,1,1,1,1,1,home,43,-12
8/15/2020,679,LSL.A. Sparks,90,167,-110,LAS,Los Angeles Sparks,-8,-110,1022001058,32,52,84,20,away,1,1,1,1,1,1,1,away,52,-20
8/15/2020,680,IFIndiana Fever,76,167,-110,IND,Indiana Fever,8,-110,1022001058,32,52,84,20,away,0,0,0,0,0,0,0,home,32,20
8/15/2020,681,NYNew York Liberty,64,154.5,-110,NYL,New York Liberty,7.5,-112,1022001059,42,33,75,-9,home,1,1,0,0,0,0,0,away,33,9
8/15/2020,682,MLMinnesota Lynx,94,154.5,-110,MIN,Minnesota Lynx,-7.5,-108,1022001059,42,33,75,-9,home,0,0,1,1,1,1,1,home,42,-9
8/16/2020,605,DWDallas Wings,95,164.5,-110,DAL,Dallas Wings,9,-110,1022001063,44,44,88,0,tie,0,1,1,1,0,0,1,away,44,-0
8/16/2020,606,PPhoenix,89,164.5,-110,PHO,Phoenix Mercury,-9,-110,1022001063,44,44,88,0,tie,1,0,0,0,1,1,0,home,44,0
8/16/2020,603,SSSeattle Storm,95,156,-110,SEA,Seattle Storm,-9.5,-110,1022001062,33,42,75,9,away,1,1,1,1,1,1,1,away,42,-9
8/16/2020,604,CSConnecticut Sun,72,156,-110,CON,Connecticut Sun,9.5,-110,1022001062,33,42,75,9,away,0,0,0,0,0,0,0,home,33,9
8/16/2020,601,CSChicago Sky,92,167.5,-110,CHI,Chicago Sky,-11.5,-115,1022001061,37,46,83,9,away,0,1,1,1,1,1,1,away,46,-9
8/16/2020,602,ADAtlanta Dream,67,167.5,-110,ATL,Atlanta Dream,11.5,-115,1022001061,37,46,83,9,away,1,0,0,0,0,0,0,home,37,9
8/20/2020,619,CSChicago Sky,101,166,-115,CHI,Chicago Sky,-15.5,-110,1022001070,44,57,101,13,away,0,1,1,1,1,1,1,away,57,-13
8/20/2020,620,NYNew York Liberty,85,166,-110,NYL,New York Liberty,15.5,-110,1022001070,44,57,101,13,away,1,0,0,0,0,0,0,home,44,13
8/20/2020,621,SSSeattle Storm,84,163,-110,SEA,Seattle Storm,-17,-112,1022001071,44,41,85,-3,home,0,1,1,0,0,0,0,away,41,3
8/20/2020,622,IFIndiana Fever,90,163,-110,IND,Indiana Fever,17,-108,1022001071,44,41,85,-3,home,1,0,0,1,1,1,1,home,44,-3
8/20/2020,623,CSConnecticut Sun,78,162.5,-110,CON,Connecticut Sun,6.5,-110,1022001072,53,42,95,-11,home,1,1,1,1,0,0,0,away,42,11
8/20/2020,624,LVLas Vegas Aces,99,162.5,-110,LVA,Las Vegas Aces,-6.5,-110,1022001072,53,42,95,-11,home,0,0,0,0,1,1,1,home,53,-11
8/22/2020,635,SSSeattle Storm,74,164.5,-115,SEA,Seattle Storm,-5,-110,1022001078,45,29,74,-16,home,1,1,0,0,0,0,0,away,29,16
8/22/2020,636,LVLas Vegas Aces,82,165.5,-110,LVA,Las Vegas Aces,5,-110,1022001078,45,29,74,-16,home,0,0,1,1,1,1,1,home,45,-16
8/22/2020,631,IFIndiana Fever,76,169.5,-105,IND,Indiana Fever,9,-105,1022001076,43,34,77,-9,home,0,0,0,0,0,0,0,away,34,9
8/22/2020,632,CSChicago Sky,87,169.5,-115,CHI,Chicago Sky,-9,-115,1022001076,43,34,77,-9,home,1,1,1,1,1,1,1,home,43,-9
8/22/2020,633,NYNew York Liberty,65,163,-115,NYL,New York Liberty,12,-110,1022001077,45,38,83,-7,home,0,0,0,0,0,0,0,away,38,7
8/22/2020,634,CSConnecticut Sun,82,163,-110,CON,Connecticut Sun,-12,-110,1022001077,45,38,83,-7,home,1,1,1,1,1,1,1,home,45,-7
8/25/2020,643,NYNew York Liberty,101,169,-115,NYL,New York Liberty,18,-115,1022001082,49,46,95,-3,home,0,0,0,0,0,0,0,away,46,3
8/25/2020,644,CSChicago Sky,99,169.5,-110,CHI,Chicago Sky,-17.5,-110,1022001082,49,46,95,-3,home,1,1,1,1,1,1,1,home,49,-3
8/25/2020,645,LVLas Vegas Aces,96,167.5,-110,LVA,Las Vegas Aces,-9.5,-110,1022001083,43,52,95,9,away,0,0,0,1,1,1,1,away,52,-9
8/25/2020,646,DWDallas Wings,92,167.5,-110,DAL,Dallas Wings,9.5,-110,1022001083,43,52,95,9,away,1,1,1,0,0,0,0,home,43,9
8/25/2020,647,IFIndiana Fever,74,164.5,-105,IND,Indiana Fever,15,-110,1022001084,46,35,81,-11,home,1,1,1,1,0,0,0,away,35,11
8/25/2020,648,SSSeattle Storm,87,164.5,-115,SEA,Seattle Storm,-15,-110,1022001084,46,35,81,-11,home,0,0,0,0,1,1,1,home,46,-11
8/28/2020,661,MLMinnesota Lynx,88,161.5,-110,MIN,Minnesota Lynx,-7,-125,1022001091,43,51,94,8,away,1,1,1,1,1,1,1,away,51,-8
8/28/2020,662,ADAtlanta Dream,79,161.5,-110,ATL,Atlanta Dream,7,105,1022001091,43,51,94,8,away,0,0,0,0,0,0,0,home,43,8
8/28/2020,663,LSL.A. Sparks,80,159,-110,LAS,Los Angeles Sparks,-5.5,-110,1022001092,39,32,71,-7,home,0,1,0,1,0,0,0,away,32,7
8/28/2020,664,CSConnecticut Sun,76,159,-110,CON,Connecticut Sun,5.5,-110,1022001092,39,32,71,-7,home,1,0,1,0,1,1,1,home,39,-7
8/28/2020,665,WMWashington Mystics,72,169.5,100,WAS,Washington Mystics,2.5,-109,1022001093,33,41,74,8,away,0,0,1,1,1,1,1,away,41,-8
8/28/2020,666,PPhoenix,94,169.5,-120,PHO,Phoenix Mercury,-2.5,-111,1022001093,33,41,74,8,away,1,1,0,0,0,0,0,home,33,8
8/29/2020,671,NYNew York Liberty,63,169,-110,NYL,New York Liberty,16.5,-110,1022001096,39,35,74,-4,home,0,0,0,1,0,0,0,away,35,4
8/29/2020,672,LVLas Vegas Aces,80,169,-110,LVA,Las Vegas Aces,-16.5,-110,1022001096,39,35,74,-4,home,1,1,1,0,1,1,1,home,39,-4
8/29/2020,669,SSSeattle Storm,88,167,-110,SEA,Seattle Storm,-6,-110,1022001095,34,49,83,15,away,1,1,1,1,1,1,1,away,49,-15
8/29/2020,670,CSChicago Sky,74,167,-110,CHI,Chicago Sky,6,-110,1022001095,34,49,83,15,away,0,0,0,0,0,0,0,home,34,15
8/29/2020,667,DWDallas Wings,82,167.5,-110,DAL,Dallas Wings,-2,-105,1022001094,37,44,81,7,away,1,1,1,1,1,1,1,away,44,-7
8/29/2020,668,IFIndiana Fever,78,167.5,-110,IND,Indiana Fever,2,-115,1022001094,37,44,81,7,away,0,0,0,0,0,0,0,home,37,7
8/30/2020,673,CSConnecticut Sun,76,161,-110,CON,Connecticut Sun,-7,-110,1022001097,28,39,67,11,away,1,1,1,1,1,1,1,away,39,-11
8/30/2020,674,WMWashington Mystics,63,161,-110,WAS,Washington Mystics,7,-110,1022001097,28,39,67,11,away,0,0,0,0,0,0,0,home,28,11
8/30/2020,675,PPhoenix,83,164.5,-110,PHO,Phoenix Mercury,4.5,-110,1022001098,36,51,87,15,away,1,1,1,1,1,1,1,away,51,-15
8/30/2020,676,MLMinnesota Lynx,79,164.5,-110,MIN,Minnesota Lynx,-4.5,-110,1022001098,36,51,87,15,away,0,0,0,0,0,0,0,home,36,15
8/30/2020,677,ADAtlanta Dream,79,164,-110,ATL,Atlanta Dream,13.5,-110,1022001099,37,38,75,1,away,1,0,1,0,1,1,0,away,38,-1
8/30/2020,678,LSL.A. Sparks,84,164,-110,LAS,Los Angeles Sparks,-13.5,-110,1022001099,37,38,75,1,away,0,1,0,1,0,0,1,home,37,1
9/1/2020,679,CSConnecticut Sun,70,156.5,-110,CON,Connecticut Sun,-11.5,-105,1022001100,32,29,61,-3,home,1,1,1,0,0,1,1,away,29,3
9/1/2020,680,NYNew York Liberty,65,156.5,-110,NYL,New York Liberty,11.5,-115,1022001100,32,29,61,-3,home,0,0,0,1,1,0,0,home,32,-3
9/1/2020,681,IFIndiana Fever,90,167,-110,IND,Indiana Fever,1.5,-105,1022001101,43,38,81,-5,home,1,0,1,0,0,0,0,away,38,5
9/1/2020,682,ADAtlanta Dream,102,167,-110,ATL,Atlanta Dream,-1.5,-115,1022001101,43,38,81,-5,home,0,1,0,1,1,1,1,home,43,-5
9/1/2020,683,PPhoenix,92,170.5,-110,PHO,Phoenix Mercury,8.5,-110,1022001102,45,52,97,7,away,1,1,1,1,1,1,1,away,52,-7
9/1/2020,684,LVLas Vegas Aces,85,170,-110,LVA,Las Vegas Aces,-8.5,-110,1022001102,45,52,97,7,away,0,0,0,0,0,0,0,home,45,7
9/2/2020,601,MLMinnesota Lynx,86,167.5,-110,MIN,Minnesota Lynx,3,-105,1022001103,40,50,90,10,away,1,1,1,1,1,1,1,away,50,-10
9/2/2020,602,CSChicago Sky,83,167.5,-110,CHI,Chicago Sky,-3,-115,1022001103,40,50,90,10,away,0,0,0,0,0,0,0,home,40,10
9/2/2020,603,LSL.A. Sparks,91,164,-110,LAS,Los Angeles Sparks,-6.5,-105,1022001104,39,48,87,9,away,0,0,0,0,0,1,1,away,48,-9
9/2/2020,604,DWDallas Wings,83,164,-110,DAL,Dallas Wings,6.5,-115,1022001104,39,48,87,9,away,1,1,1,1,1,0,0,home,39,9
9/2/2020,605,WMWashington Mystics,64,160,-110,WAS,Washington Mystics,15,-110,1022001105,38,30,68,-8,home,0,0,0,0,0,0,0,away,30,8
9/2/2020,606,SSSeattle Storm,71,160,-110,SEA,Seattle Storm,-15,-110,1022001105,38,30,68,-8,home,1,1,1,1,1,1,1,home,38,-8
9/3/2020,607,ADAtlanta Dream,62,165.5,-110,ATL,Atlanta Dream,-6.5,-110,1022001106,29,31,60,2,away,0,0,0,1,1,1,1,away,31,-2
9/3/2020,608,NYNew York Liberty,56,165.5,-110,NYL,New York Liberty,6.5,-110,1022001106,29,31,60,2,away,1,1,1,0,0,0,0,home,29,2
9/3/2020,609,LVLas Vegas Aces,93,159.5,-110,LVA,Las Vegas Aces,-9,-110,1022001107,36,43,79,7,away,0,1,1,1,1,1,1,away,43,-7
9/3/2020,610,CSConnecticut Sun,78,159.5,-110,CON,Connecticut Sun,9,-110,1022001107,36,43,79,7,away,1,0,0,0,0,0,0,home,36,7
9/3/2020,611,IFIndiana Fever,81,173.5,-110,IND,Indiana Fever,7,-105,1022001108,54,46,100,-8,home,0,0,0,0,0,0,0,away,46,8
9/3/2020,612,PPhoenix,105,173.5,-110,PHO,Phoenix Mercury,-7,-115,1022001108,54,46,100,-8,home,1,1,1,1,1,1,1,home,54,-8
9/4/2020,613,CSChicago Sky,69,165.5,-112,CHI,Chicago Sky,-8.5,-110,1022001109,45,40,85,-5,home,0,0,0,0,0,0,0,away,40,5
9/4/2020,614,WMWashington Mystics,79,165.5,-110,WAS,Washington Mystics,8.5,-110,1022001109,45,40,85,-5,home,1,1,1,1,1,1,1,home,45,-5
9/4/2020,615,MLMinnesota Lynx,88,165.5,-110,MIN,Minnesota Lynx,-4,-110,1022001110,49,41,90,-8,home,1,1,1,1,0,0,0,away,41,8
9/4/2020,616,DWDallas Wings,75,165,-104,DAL,Dallas Wings,4,-110,1022001110,49,41,90,-8,home,0,0,0,0,1,1,1,home,49,-8
9/4/2020,617,SSSeattle Storm,90,161,-120,SEA,Seattle Storm,-6.5,-115,1022001111,49,45,94,-4,home,0,0,0,0,0,0,0,away,45,4
9/4/2020,618,LSL.A. Sparks,89,161,100,LAS,Los Angeles Sparks,6.5,-105,1022001111,49,45,94,-4,home,1,1,1,1,1,1,1,home,49,-4
9/5/2020,619,CSConnecticut Sun,96,160.5,-110,CON,Connecticut Sun,-7,-110,1022001112,37,47,84,10,away,1,1,1,1,1,1,1,away,47,-10
9/5/2020,620,IFIndiana Fever,77,160.5,-110,IND,Indiana Fever,7,-110,1022001112,37,47,84,10,away,0,0,0,0,0,0,0,home,37,10
9/5/2020,621,LVLas Vegas Aces,89,170,-110,LVA,Las Vegas Aces,-10.5,-110,1022001113,44,45,89,1,away,0,0,0,0,1,0,0,away,45,-1
9/5/2020,622,ADAtlanta Dream,79,170,-110,ATL,Atlanta Dream,10.5,-110,1022001113,44,45,89,1,away,1,1,1,1,0,1,1,home,44,1
9/5/2020,623,NYNew York Liberty,67,167.5,-108,NYL,New York Liberty,12.5,-105,1022001114,45,38,83,-7,home,0,0,0,1,1,0,0,away,38,7
9/5/2020,624,PPhoenix,83,167.5,-112,PHO,Phoenix Mercury,-12.5,-115,1022001114,45,38,83,-7,home,1,1,1,0,0,1,1,home,45,-7
9/6/2020,625,DWDallas Wings,101,161,-110,DAL,Dallas Wings,1,-110,1022001115,44,38,82,-6,home,1,1,1,1,1,0,0,away,38,6
9/6/2020,626,WMWashington Mystics,94,161,-110,WAS,Washington Mystics,-1,-110,1022001115,44,38,82,-6,home,0,0,0,0,0,1,1,home,44,-6
9/6/2020,627,SSSeattle Storm,103,161.5,-110,SEA,Seattle Storm,-7,-110,1022001116,38,45,83,7,away,0,1,1,1,1,1,1,away,45,-7
9/6/2020,628,MLMinnesota Lynx,88,161.5,-110,MIN,Minnesota Lynx,7,-110,1022001116,38,45,83,7,away,1,0,0,0,0,0,0,home,38,7
9/6/2020,629,CSChicago Sky,80,170,-105,CHI,Chicago Sky,5,100,1022001117,47,48,95,1,away,1,1,1,1,1,1,1,away,48,-1
9/6/2020,630,LSL.A. Sparks,86,170,-115,LAS,Los Angeles Sparks,-5,-120,1022001117,47,48,95,1,away,0,0,0,0,0,0,0,home,47,1
9/8/2020,631,LSL.A. Sparks,96,160,-110,LAS,Los Angeles Sparks,-13.5,-108,1022001118,31,42,73,11,away,1,1,1,1,1,1,1,away,42,-11
9/8/2020,632,NYNew York Liberty,70,160,-110,NYL,New York Liberty,13.5,-112,1022001118,31,42,73,11,away,0,0,0,0,0,0,0,home,31,11
9/8/2020,633,MLMinnesota Lynx,86,158.5,-110,MIN,Minnesota Lynx,-8,-110,1022001119,48,41,89,-7,home,0,0,0,0,0,0,0,away,41,7
9/8/2020,634,WMWashington Mystics,89,158.5,-110,WAS,Washington Mystics,8,-110,1022001119,48,41,89,-7,home,1,1,1,1,1,1,1,home,48,-7
9/8/2020,635,IFIndiana Fever,86,172.5,-110,IND,Indiana Fever,14.5,-110,1022001120,58,41,99,-17,home,0,0,0,0,0,0,0,away,41,17
9/8/2020,636,LVLas Vegas Aces,92,172.5,-110,LVA,Las Vegas Aces,-14.5,-110,1022001120,58,41,99,-17,home,1,1,1,1,1,1,1,home,58,-17
9/9/2020,637,PPhoenix,100,161.5,-110,PHO,Phoenix Mercury,-4,-105,1022001121,31,51,82,20,away,1,1,1,1,1,1,1,away,51,-20
9/9/2020,638,CSConnecticut Sun,95,161.5,-110,CON,Connecticut Sun,4,-115,1022001121,31,51,82,20,away,0,0,0,0,0,0,0,home,31,20
9/9/2020,639,ADAtlanta Dream,97,169.5,-110,ATL,Atlanta Dream,7.5,-110,1022001122,55,45,100,-10,home,1,0,0,0,0,0,0,away,45,10
9/9/2020,640,CSChicago Sky,89,169.5,-110,CHI,Chicago Sky,-7.5,-110,1022001122,55,45,100,-10,home,0,1,1,1,1,1,1,home,55,-10
9/9/2020,641,DWDallas Wings,95,166,-110,DAL,Dallas Wings,12.5,-105,1022001123,55,54,109,-1,home,1,1,1,1,0,0,1,away,54,1
9/9/2020,642,SSSeattle Storm,107,166,-110,SEA,Seattle Storm,-12.5,-115,1022001123,55,54,109,-1,home,0,0,0,0,1,1,0,home,55,-1
9/10/2020,643,NYNew York Liberty,75,165,-110,NYL,New York Liberty,5.5,-112,1022001124,46,42,88,-4,home,1,1,1,1,0,0,0,away,42,4
9/10/2020,644,IFIndiana Fever,85,165,-110,IND,Indiana Fever,-5.5,-108,1022001124,46,42,88,-4,home,0,0,0,0,1,1,1,home,46,-4
9/10/2020,645,LVLas Vegas Aces,104,165.5,-115,LVA,Las Vegas Aces,-5.5,-110,1022001125,54,56,110,2,away,1,0,1,1,0,0,1,away,56,-2
9/10/2020,646,MLMinnesota Lynx,89,165.5,-105,MIN,Minnesota Lynx,5.5,-110,1022001125,54,56,110,2,away,0,1,0,0,1,1,0,home,54,2
9/10/2020,647,WMWashington Mystics,80,161.5,-115,WAS,Washington Mystics,7.5,-110,1022001126,45,39,84,-6,home,0,0,0,1,1,1,0,away,39,6
9/10/2020,648,LSL.A. Sparks,72,161.5,-110,LAS,Los Angeles Sparks,-7.5,-110,1022001126,45,39,84,-6,home,1,1,1,0,0,0,1,home,45,-6
9/12/2020,655,WMWashington Mystics,75,156,-110,WAS,Washington Mystics,-8,-110,1022001130,29,36,65,7,away,1,1,1,1,1,1,1,away,36,-7
9/12/2020,656,NYNew York Liberty,58,156,-110,NYL,New York Liberty,8,-110,1022001130,29,36,65,7,away,0,0,0,0,0,0,0,home,29,7
9/12/2020,659,LVLas Vegas Aces,84,168,-110,LVA,Las Vegas Aces,-4,-110,1022001132,35,43,78,8,away,1,1,1,1,1,1,1,away,43,-8
9/12/2020,660,LSL.A. Sparks,70,168,-110,LAS,Los Angeles Sparks,4,-110,1022001132,35,43,78,8,away,0,0,0,0,0,0,0,home,35,8
9/12/2020,657,MLMinnesota Lynx,98,168,-110,MIN,Minnesota Lynx,-5,-110,1022001131,48,49,97,1,away,1,1,1,1,1,1,1,away,49,-1
9/12/2020,658,IFIndiana Fever,86,168,-110,IND,Indiana Fever,5,-110,1022001131,48,49,97,1,away,0,0,0,0,0,0,0,home,48,1
9/13/2021,615,DDallas,75,164,-110,DAL,Dallas Wings,10.5,-110,1022100180,36,45,81,9,away,1,1,1,1,1,1,1,away,45,-9
9/13/2021,616,LVLas Vegas,85,164,-110,LVA,Las Vegas Aces,-10.5,-110,1022100180,36,45,81,9,away,0,0,0,0,0,0,0,home,36,9
9/15/2021,619,NYNew York,69,147,-110,NYL,New York Liberty,13,-110,1022100182,44,45,89,1,away,1,1,1,1,0,1,0,away,45,-1
9/15/2021,620,CConnecticut,98,147,-110,CON,Connecticut Sun,-13,-110,1022100182,44,45,89,1,away,0,0,0,0,1,0,1,home,44,1
9/17/2021,623,WWashington,80,163,-110,WAS,Washington Mystics,-1.5,-115,1022100185,46,29,75,-17,home,0,0,0,0,0,0,0,away,29,17
9/17/2021,624,NYNew York,91,163,-110,NYL,New York Liberty,1.5,-105,1022100185,46,29,75,-17,home,1,1,1,1,1,1,1,home,46,-17
9/17/2021,625,MMinnesota,92,163,-110,MIN,Minnesota Lynx,-9.5,-110,1022100184,44,51,95,7,away,1,1,1,1,1,1,1,away,51,-7
9/17/2021,626,IIndiana,73,163,-110,IND,Indiana Fever,9.5,-110,1022100184,44,51,95,7,away,0,0,0,0,0,0,0,home,44,7
9/17/2021,627,LVLas Vegas,103,171.5,-110,LVA,Las Vegas Aces,-3.5,-115,1022100186,39,61,100,22,away,1,0,0,1,1,1,1,away,61,-22
9/17/2021,628,CChicago,70,171.5,-110,CHI,Chicago Sky,3.5,-105,1022100186,39,61,100,22,away,0,1,1,0,0,0,0,home,39,22
9/17/2021,629,PPhoenix,85,156,-110,PHO,Phoenix Mercury,-2.5,-115,1022100187,61,47,108,-14,home,0,0,0,0,0,0,0,away,47,14
9/17/2021,630,SSeattle,94,156,-110,SEA,Seattle Storm,2.5,-105,1022100187,61,47,108,-14,home,1,1,1,1,1,1,1,home,61,-14
9/26/2021,611,PPhoenix,85,159.5,-110,PHO,Phoenix Mercury,-3.5,-110,1042100211,35,32,67,-3,home,1,1,1,1,1,0,0,away,32,3
9/26/2021,612,SSeattle,80,159.5,-110,SEA,Seattle Storm,3.5,-110,1042100211,35,32,67,-3,home,0,0,0,0,0,1,1,home,35,-3
9/26/2021,609,CChicago,89,166,-110,CHI,Chicago Sky,4,-110,1042100201,38,42,80,4,away,0,0,0,0,1,1,1,away,42,-4
9/26/2021,610,MMinnesota,76,166,-110,MIN,Minnesota Lynx,-4,-110,1042100201,38,42,80,4,away,1,1,1,1,0,0,0,home,38,4
9/28/2021,613,CChicago,101,154,-110,CHI,Chicago Sky,7.5,-110,1042100301,46,47,93,1,away,1,1,1,1,1,0,0,away,47,-1
9/28/2021,614,CConnecticut,95,154,-110,CON,Connecticut Sun,-7.5,-110,1042100301,46,47,93,1,away,0,0,0,0,0,1,1,home,46,1
9/28/2021,615,PPhoenix,90,169.5,-110,PHO,Phoenix Mercury,6.5,-110,1042100311,52,49,101,-3,home,1,1,1,1,1,1,0,away,49,3
9/28/2021,616,LVLas Vegas,96,169.5,-110,LVA,Las Vegas Aces,-6.5,-110,1042100311,52,49,101,-3,home,0,0,0,0,0,0,1,home,52,-3
10/15/2021,605,PPhoenix,50,165,-110,PHO,Phoenix Mercury,3,-110,1042100403,46,24,70,-22,home,0,0,0,0,0,0,0,away,24,22
10/15/2021,606,CChicago,86,165,-110,CHI,Chicago Sky,-3,-110,1042100403,46,24,70,-22,home,1,1,1,1,1,1,1,home,46,-22
6/10/2021,629,LALos Angeles,71,158,-110,LAS,Los Angeles Sparks,7,-108,1022100056,45,35,80,-10,home,0,0,0,0,0,0,0,away,35,10
6/10/2021,630,WWashington,89,158,-110,WAS,Washington Mystics,-7,-112,1022100056,45,35,80,-10,home,1,1,1,1,1,1,1,home,45,-10
6/17/2021,671,AAtlanta,93,165,-110,ATL,Atlanta Dream,-1,-110,1022100070,38,46,84,8,away,1,1,1,1,1,1,1,away,46,-8
6/17/2021,672,WWashington,96,165,-110,WAS,Washington Mystics,1,-110,1022100070,38,46,84,8,away,0,0,0,0,0,0,0,home,38,8
6/17/2021,673,SSeattle,79,164,-110,SEA,Seattle Storm,-16.5,-105,1022100069,36,40,76,4,away,1,1,1,0,0,1,1,away,40,-4
6/17/2021,674,IIndiana,69,164,-110,IND,Indiana Fever,16.5,-115,1022100069,36,40,76,4,away,0,0,0,1,1,0,0,home,36,4
6/17/2021,677,CConnecticut,75,155.5,-110,CON,Connecticut Sun,5,-110,1022100071,31,36,67,5,away,0,1,1,1,1,1,1,away,36,-5
6/17/2021,678,CChicago,81,155.5,-110,CHI,Chicago Sky,-5,-110,1022100071,31,36,67,5,away,1,0,0,0,0,0,0,home,31,5
6/17/2021,675,MMinnesota,85,167.5,-110,MIN,Minnesota Lynx,4,-110,1022100072,33,43,76,10,away,1,1,1,1,1,1,1,away,43,-10
6/17/2021,676,DDallas,73,167.5,-110,DAL,Dallas Wings,-4,-110,1022100072,33,43,76,10,away,0,0,0,0,0,0,0,home,33,10
6/17/2021,679,NYNew York,76,173,-110,NYL,New York Liberty,16,-115,1022100073,55,34,89,-21,home,0,1,0,0,0,0,0,away,34,21
6/17/2021,680,LVLas Vegas,103,173,-110,LVA,Las Vegas Aces,-16,-105,1022100073,55,34,89,-21,home,1,0,1,1,1,1,1,home,55,-21
6/27/2021,633,CChicago,58,158,-110,CHI,Chicago Sky,-5,-110,1022100090,36,30,66,-6,home,0,0,0,0,0,0,0,away,30,6
6/27/2021,634,CConnecticut,74,158,-110,CON,Connecticut Sun,5,-110,1022100090,36,30,66,-6,home,1,1,1,1,1,1,1,home,36,-6
6/27/2021,635,SSeattle,92,170.5,-110,SEA,Seattle Storm,2.5,-115,1022100091,37,42,79,5,away,0,1,1,1,1,1,1,away,42,-5
6/27/2021,636,LVLas Vegas,95,170.5,-110,LVA,Las Vegas Aces,-2.5,-105,1022100091,37,42,79,5,away,1,0,0,0,0,0,0,home,37,5
6/27/2021,637,LALos Angeles,79,156,-110,LAS,Los Angeles Sparks,7,-110,1022100089,47,43,90,-4,home,0,0,0,1,0,0,0,away,43,4
6/27/2021,638,PPhoenix,88,156.5,-110,PHO,Phoenix Mercury,-7,-110,1022100089,47,43,90,-4,home,1,1,1,0,1,1,1,home,47,-4
7/3/2021,657,WWashington,79,166.5,-110,WAS,Washington Mystics,1.5,-110,1022100103,33,51,84,18,away,1,1,1,1,1,1,1,away,51,-18
7/3/2021,658,NYNew York,82,166.5,-110,NYL,New York Liberty,-1.5,-110,1022100103,33,51,84,18,away,0,0,0,0,0,0,0,home,33,18
7/3/2021,659,CConnecticut,67,156,-105,CON,Connecticut Sun,-15,-110,1022100102,28,29,57,1,away,0,1,0,0,1,0,0,away,29,-1
7/3/2021,660,IIndiana,73,156,-115,IND,Indiana Fever,15,-110,1022100102,28,29,57,1,away,1,0,1,1,0,1,1,home,28,1
7/3/2021,661,MMinnesota,99,165.5,-110,MIN,Minnesota Lynx,4.5,-110,1022100100,41,59,100,18,away,1,1,1,1,1,1,1,away,59,-18
7/3/2021,662,PPhoenix,68,165.5,-110,PHO,Phoenix Mercury,-4.5,-110,1022100100,41,59,100,18,away,0,0,0,0,0,0,0,home,41,18
8/19/2021,627,MMinnesota,71,150.5,-110,MIN,Minnesota Lynx,6.5,-110,1022100132,42,36,78,-6,home,0,0,0,0,0,0,0,away,36,6
8/19/2021,628,CConnecticut,82,150.5,-110,CON,Connecticut Sun,-6.5,-110,1022100132,42,36,78,-6,home,1,1,1,1,1,1,1,home,42,-6
8/19/2021,629,WWashington,64,168,-110,WAS,Washington Mystics,4,-110,1022100133,39,44,83,5,away,1,1,1,1,1,1,1,away,44,-5
8/19/2021,630,PPhoenix,77,168,-110,PHO,Phoenix Mercury,-4,-110,1022100133,39,44,83,5,away,0,0,0,0,0,0,0,home,39,5
8/19/2021,631,AAtlanta,64,156.5,-110,ATL,Atlanta Dream,4,-105,1022100134,36,28,64,-8,home,0,0,0,0,0,0,0,away,28,8
8/19/2021,632,LALos Angeles,66,156.5,-110,LAS,Los Angeles Sparks,-4,-115,1022100134,36,28,64,-8,home,1,1,1,1,1,1,1,home,36,-8
8/31/2021,623,CConnecticut,85,149,-110,CON,Connecticut Sun,-9,-110,1022100156,37,45,82,8,away,1,1,1,1,1,1,1,away,45,-8
8/31/2021,624,WWashington,75,149,-110,WAS,Washington Mystics,9,-110,1022100156,37,45,82,8,away,0,0,0,0,0,0,0,home,37,8
8/31/2021,621,LALos Angeles,72,152.5,-110,LAS,Los Angeles Sparks,-5,-110,1022100155,35,30,65,-5,home,1,0,1,0,1,0,0,away,30,5
8/31/2021,622,IIndiana,74,152.5,-110,IND,Indiana Fever,5,-110,1022100155,35,30,65,-5,home,0,1,0,1,0,1,1,home,35,-5
8/31/2021,625,NYNew York,66,164.5,-110,NYL,New York Liberty,9.5,-105,1022100157,39,37,76,-2,home,1,1,0,0,0,0,0,away,37,2
8/31/2021,626,MMinnesota,74,164.5,-110,MIN,Minnesota Lynx,-9.5,-115,1022100157,39,37,76,-2,home,0,0,1,1,1,1,1,home,39,-2
8/31/2021,627,CChicago,83,167,-110,CHI,Chicago Sky,-1.5,-110,1022100158,49,46,95,-3,home,0,0,0,0,0,0,0,away,46,3
8/31/2021,628,PPhoenix,103,167,-110,PHO,Phoenix Mercury,1.5,-110,1022100158,49,46,95,-3,home,1,1,1,1,1,1,1,home,49,-3
9/5/2021,641,LVLas Vegas,84,169.5,-110,LVA,Las Vegas Aces,-2,-105,1022100165,54,46,100,-8,home,0,0,0,0,0,0,0,away,46,8
9/5/2021,642,CChicago,92,169.5,-110,CHI,Chicago Sky,2,-115,1022100165,54,46,100,-8,home,1,1,1,1,1,1,1,home,54,-8
9/5/2021,643,AAtlanta,69,156,-110,ATL,Atlanta Dream,6.5,-110,1022100166,32,32,64,0,tie,1,1,1,1,0,0,1,away,32,-0
9/5/2021,644,DDallas,64,156,-110,DAL,Dallas Wings,-6.5,-110,1022100166,32,32,64,0,tie,0,0,0,0,1,1,0,home,32,0
9/10/2021,601,AAtlanta,74,156,-110,ATL,Atlanta Dream,5,-110,1022100173,40,34,74,-6,home,1,1,0,1,0,0,0,away,34,6
9/10/2021,602,WWashington,82,156,-110,WAS,Washington Mystics,-5,-110,1022100173,40,34,74,-6,home,0,0,1,0,1,1,1,home,40,-6
9/10/2021,603,IIndiana,72,158,-110,IND,Indiana Fever,11.5,-112,1022100174,39,34,73,-5,home,0,1,1,1,1,0,0,away,34,5
9/10/2021,604,MMinnesota,89,158,-110,MIN,Minnesota Lynx,-11.5,-108,1022100174,39,34,73,-5,home,1,0,0,0,0,1,1,home,39,-5
9/11/2021,605,NYNew York,76,158.5,-105,NYL,New York Liberty,4.5,-110,1022100175,40,41,81,1,away,1,0,0,0,1,0,1,away,41,-1
9/11/2021,606,DDallas,77,158.5,-115,DAL,Dallas Wings,-4.5,-110,1022100175,40,41,81,1,away,0,1,1,1,0,1,0,home,40,1
9/11/2021,607,CConnecticut,76,148.5,-110,CON,Connecticut Sun,-3.5,-110,1022100176,43,49,92,6,away,0,0,1,1,1,1,1,away,49,-6
9/11/2021,608,PPhoenix,67,148.5,-110,PHO,Phoenix Mercury,3.5,-110,1022100176,43,49,92,6,away,1,1,0,0,0,0,0,home,43,6
9/12/2021,609,WWashington,79,166.5,-110,WAS,Washington Mystics,8.5,-110,1022100177,37,47,84,10,away,0,1,1,1,1,1,1,away,47,-10
9/12/2021,610,CChicago,71,166.5,-110,CHI,Chicago Sky,-8.5,-110,1022100177,37,47,84,10,away,1,0,0,0,0,0,0,home,37,10
9/12/2021,611,IIndiana,80,159.5,-110,IND,Indiana Fever,11.5,-110,1022100178,46,36,82,-10,home,0,0,0,0,0,0,0,away,36,10
9/12/2021,612,MMinnesota,90,159.5,-110,MIN,Minnesota Lynx,-11.5,-110,1022100178,46,36,82,-10,home,1,1,1,1,1,1,1,home,46,-10
9/12/2021,613,SSeattle,53,152,-110,SEA,Seattle Storm,-6,-110,1022100179,45,27,72,-18,home,0,0,0,0,0,0,0,away,27,18
9/12/2021,614,LALos Angeles,81,152,-110,LAS,Los Angeles Sparks,6,-110,1022100179,45,27,72,-18,home,1,1,1,1,1,1,1,home,45,-18
9/14/2021,617,IIndiana,78,154.5,-110,IND,Indiana Fever,3.5,-110,1022100181,39,43,82,4,away,1,1,1,1,1,1,1,away,43,-4
9/14/2021,618,AAtlanta,85,154.5,-110,ATL,Atlanta Dream,-3.5,-110,1022100181,39,43,82,4,away,0,0,0,0,0,0,0,home,39,4
9/16/2021,621,LALos Angeles,74,147.5,-110,LAS,Los Angeles Sparks,-2.5,-110,1022100183,31,34,65,3,away,0,0,0,1,1,1,1,away,34,-3
9/16/2021,622,AAtlanta,68,147.5,-110,ATL,Atlanta Dream,2.5,-110,1022100183,31,34,65,3,away,1,1,1,0,0,0,0,home,31,3
9/19/2021,631,AAtlanta,64,150,-110,ATL,Atlanta Dream,13,-110,1022100188,46,37,83,-9,home,0,0,0,0,0,0,0,away,37,9
9/19/2021,632,CConnecticut,84,150,-110,CON,Connecticut Sun,-13,-110,1022100188,46,37,83,-9,home,1,1,1,1,1,1,1,home,46,-9
9/19/2021,633,MMinnesota,83,164,-115,MIN,Minnesota Lynx,-5.5,-105,1022100190,41,41,82,0,tie,1,1,1,1,1,1,0,away,41,-0
9/19/2021,634,WWashington,77,164,-105,WAS,Washington Mystics,5.5,-115,1022100190,41,41,82,0,tie,0,0,0,0,0,0,1,home,41,0
9/19/2021,635,LVLas Vegas,84,168,-110,LVA,Las Vegas Aces,-3.5,-110,1022100189,47,43,90,-4,home,1,0,0,0,0,0,0,away,43,4
9/19/2021,636,PPhoenix,83,168,-110,PHO,Phoenix Mercury,3.5,-110,1022100189,47,43,90,-4,home,0,1,1,1,1,1,1,home,47,-4
9/19/2021,637,LALos Angeles,84,147.5,-110,LAS,Los Angeles Sparks,3,-110,1022100191,44,41,85,-3,home,1,0,0,0,0,1,0,away,41,3
9/19/2021,638,DDallas,87,147.5,-110,DAL,Dallas Wings,-3,-110,1022100191,44,41,85,-3,home,0,1,1,1,1,0,1,home,44,-3
9/19/2021,639,IIndiana,87,166,-110,IND,Indiana Fever,12.5,-110,1022100192,46,46,92,0,tie,0,0,1,0,0,0,1,away,46,-0
9/19/2021,640,CChicago,98,166,-110,CHI,Chicago Sky,-12.5,-110,1022100192,46,46,92,0,tie,1,1,0,1,1,1,0,home,46,0
9/23/2021,601,DDallas,64,167,-110,DAL,Dallas Wings,5,-110,1042100111,44,29,73,-15,home,0,0,0,0,0,0,0,away,29,15
9/23/2021,602,CChicago,81,167,-110,CHI,Chicago Sky,-5,-110,1042100111,44,29,73,-15,home,1,1,1,1,1,1,1,home,44,-15
9/23/2021,603,NYNew York,82,165,-110,NYL,New York Liberty,10,-105,1042100101,37,41,78,4,away,0,0,0,1,1,1,1,away,41,-4
9/23/2021,604,PPhoenix,83,165,-110,PHO,Phoenix Mercury,-10,-115,1042100101,37,41,78,4,away,1,1,1,0,0,0,0,home,37,4
9/30/2021,617,CChicago,68,155.5,-110,CHI,Chicago Sky,8,-110,1042100302,45,39,84,-6,home,1,1,1,1,1,1,0,away,39,6
9/30/2021,618,CConnecticut,79,155.5,-110,CON,Connecticut Sun,-8,-110,1042100302,45,39,84,-6,home,0,0,0,0,0,0,1,home,45,-6
9/30/2021,619,PPhoenix,117,170.5,-110,PHO,Phoenix Mercury,6,-110,1042100312,52,68,120,16,away,1,1,1,1,1,1,1,away,68,-16
9/30/2021,620,LVLas Vegas,91,170.5,-110,LVA,Las Vegas Aces,-6,-110,1042100312,52,68,120,16,away,0,0,0,0,0,0,0,home,52,16
10/3/2021,621,CConnecticut,83,153.5,-110,CON,Connecticut Sun,-4.5,-110,1042100303,37,35,72,-2,home,0,1,1,1,1,1,0,away,35,2
10/3/2021,622,CChicago,86,153.5,-110,CHI,Chicago Sky,4.5,-110,1042100303,37,35,72,-2,home,1,0,0,0,0,0,1,home,37,-2
10/3/2021,623,LVLas Vegas,60,173,-110,LVA,Las Vegas Aces,-2,-110,1042100313,46,31,77,-15,home,0,0,0,0,0,0,0,away,31,15
10/3/2021,624,PPhoenix,87,173,-110,PHO,Phoenix Mercury,2,-110,1042100313,46,31,77,-15,home,1,1,1,1,1,1,1,home,46,-15
10/6/2021,633,CConnecticut,69,156,-110,CON,Connecticut Sun,-4,-110,1042100304,54,41,95,-13,home,0,0,0,0,0,0,0,away,41,13
10/6/2021,634,CChicago,79,156,-110,CHI,Chicago Sky,4,-110,1042100304,54,41,95,-13,home,1,1,1,1,1,1,1,home,54,-13
10/6/2021,631,LVLas Vegas,93,171,-110,LVA,Las Vegas Aces,1,-110,1042100314,46,49,95,3,away,0,0,0,0,0,1,1,away,49,-3
10/6/2021,632,PPhoenix,76,171,-110,PHO,Phoenix Mercury,-1,-110,1042100314,46,49,95,3,away,1,1,1,1,1,0,0,home,46,3
10/8/2021,635,PPhoenix,87,168.5,-110,PHO,Phoenix Mercury,5.5,-110,1042100315,42,44,86,2,away,1,1,1,1,1,1,1,away,44,-2
10/8/2021,636,LVLas Vegas,84,168.5,-110,LVA,Las Vegas Aces,-5.5,-110,1042100315,42,44,86,2,away,0,0,0,0,0,0,0,home,42,2
10/10/2021,601,CChicago,91,167.5,-110,CHI,Chicago Sky,2.5,-110,1042100401,35,46,81,11,away,0,0,0,0,0,1,1,away,46,-11
10/10/2021,602,PPhoenix,77,167.5,-110,PHO,Phoenix Mercury,-2.5,-110,1042100401,35,46,81,11,away,1,1,1,1,1,0,0,home,35,11
10/13/2021,603,CChicago,86,169,-110,CHI,Chicago Sky,4.5,-110,1042100402,40,40,80,0,tie,1,1,1,1,1,1,0,away,40,-0
10/13/2021,604,PPhoenix,91,169,-110,PHO,Phoenix Mercury,-4.5,-110,1042100402,40,40,80,0,tie,0,0,0,0,0,0,1,home,40,0
10/17/2021,607,PPhoenix,74,164,-110,PHO,Phoenix Mercury,4.5,-110,1042100404,37,44,81,7,away,0,0,0,1,1,0,1,away,44,-7
10/17/2021,608,CChicago,80,164,-110,CHI,Chicago Sky,-4.5,-110,1042100404,37,44,81,7,away,1,1,1,0,0,1,0,home,37,7
5/14/2021,601,IIndiana,87,161,-110,IND,Indiana Fever,-2.5,-110,1022100001,47,47,94,0,tie,0,0,0,0,0,0,0,away,47,-0
5/14/2021,602,NYNew York,90,161,-110,NYL,New York Liberty,2.5,-110,1022100001,47,47,94,0,tie,1,1,1,1,1,1,1,home,47,0
5/14/2021,603,CConnecticut,78,163,-105,CON,Connecticut Sun,-3,-105,1022100002,33,43,76,10,away,1,1,1,1,1,1,1,away,43,-10
5/14/2021,604,AAtlanta,67,163,-115,ATL,Atlanta Dream,3,-115,1022100002,33,43,76,10,away,0,0,0,0,0,0,0,home,33,10
5/14/2021,605,PPhoenix,77,164,-110,PHO,Phoenix Mercury,1,-105,1022100003,24,33,57,9,away,1,1,1,1,1,1,0,away,33,-9
5/14/2021,606,MMinnesota,75,164,-110,MIN,Minnesota Lynx,-1,-115,1022100003,24,33,57,9,away,0,0,0,0,0,0,1,home,24,9
5/14/2021,607,DDallas,94,165,-110,DAL,Dallas Wings,6,-110,1022100004,41,44,85,3,away,0,0,0,0,1,1,1,away,44,-3
5/14/2021,608,LALos Angeles,71,165,-110,LAS,Los Angeles Sparks,-6,-110,1022100004,41,44,85,3,away,1,1,1,1,0,0,0,home,41,3
5/15/2021,609,CChicago,70,165.5,-110,CHI,Chicago Sky,-2.5,-115,1022100005,30,46,76,16,away,1,0,1,1,1,1,1,away,46,-16
5/15/2021,610,WWashington,56,165.5,-110,WAS,Washington Mystics,2.5,-105,1022100005,30,46,76,16,away,0,1,0,0,0,0,0,home,30,16
5/15/2021,611,LVLas Vegas,83,166.5,-110,LVA,Las Vegas Aces,-1,-115,1022100006,49,40,89,-9,home,1,1,1,0,0,0,0,away,40,9
5/15/2021,612,SSeattle,97,166.5,-110,SEA,Seattle Storm,1,-105,1022100006,49,40,89,-9,home,0,0,0,1,1,1,1,home,49,-9
5/16/2021,613,NYNew York,73,164.5,-126,NYL,New York Liberty,5.5,-108,1022100007,35,41,76,6,away,1,1,1,1,1,1,1,away,41,-6
5/16/2021,614,IIndiana,65,164.5,106,IND,Indiana Fever,-5.5,-112,1022100007,35,41,76,6,away,0,0,0,0,0,0,0,home,35,6
5/16/2021,615,PPhoenix,78,162,-110,PHO,Phoenix Mercury,1,-110,1022100008,37,33,70,-4,home,1,1,1,0,0,0,0,away,33,4
5/16/2021,616,CConnecticut,86,162,-110,CON,Connecticut Sun,-1,-110,1022100008,37,33,70,-4,home,0,0,0,1,1,1,1,home,37,-4
5/18/2021,617,MMinnesota,75,158,-110,MIN,Minnesota Lynx,-5.5,-112,1022100009,43,45,88,2,away,0,0,1,0,0,0,1,away,45,-2
5/18/2021,618,NYNew York,86,158,-110,NYL,New York Liberty,5.5,-108,1022100009,43,45,88,2,away,1,1,0,1,1,1,0,home,43,2
5/18/2021,619,PPhoenix,91,163,-110,PHO,Phoenix Mercury,-3.5,-109,1022100010,37,44,81,7,away,1,1,1,1,1,1,1,away,44,-7
5/18/2021,620,WWashington,70,163,-110,WAS,Washington Mystics,3,-115,1022100010,37,44,81,7,away,0,0,0,0,0,0,0,home,37,7
5/18/2021,621,LVLas Vegas,96,167.5,-115,LVA,Las Vegas Aces,1.5,-105,1022100011,31,45,76,14,away,1,1,1,1,1,1,1,away,45,-14
5/18/2021,622,SSeattle,80,167.5,-110,SEA,Seattle Storm,-1.5,-115,1022100011,31,45,76,14,away,0,0,0,0,0,0,0,home,31,14
5/19/2021,623,CChicago,85,163,-110,CHI,Chicago Sky,-3.5,-110,1022100012,26,46,72,20,away,1,1,1,1,1,1,1,away,46,-20
5/19/2021,624,AAtlanta,77,163,-110,ATL,Atlanta Dream,3.5,-110,1022100012,26,46,72,20,away,0,0,0,0,0,0,0,home,26,20
5/19/2021,625,IIndiana,67,161,-110,IND,Indiana Fever,7,-105,1022100013,50,33,83,-17,home,1,1,0,0,0,0,0,away,33,17
5/19/2021,626,CConnecticut,88,161,-110,CON,Connecticut Sun,-7,-115,1022100013,50,33,83,-17,home,0,0,1,1,1,1,1,home,50,-17
5/20/2021,627,SSeattle,90,163.5,-120,SEA,Seattle Storm,-4,-110,1022100014,48,33,81,-15,home,0,0,0,0,0,0,0,away,33,15
5/20/2021,628,MMinnesota,78,163.5,100,MIN,Minnesota Lynx,4,-110,1022100014,48,33,81,-15,home,1,1,1,1,1,1,1,home,48,-15
5/21/2021,629,AAtlanta,83,162.5,-115,ATL,Atlanta Dream,2,-110,1022100015,34,41,75,7,away,1,1,0,0,0,1,1,away,41,-7
5/21/2021,630,IIndiana,79,162.5,-105,IND,Indiana Fever,-2,-110,1022100015,34,41,75,7,away,0,0,1,1,1,0,0,home,34,7
5/21/2021,631,NYNew York,72,159,-110,NYL,New York Liberty,3,-105,1022100016,52,46,98,-6,home,0,0,0,0,0,0,0,away,46,6
5/21/2021,632,WWashington,101,159,-110,WAS,Washington Mystics,-3,-115,1022100016,52,46,98,-6,home,1,1,1,1,1,1,1,home,52,-6
5/21/2021,633,CConnecticut,84,162,-110,CON,Connecticut Sun,2.5,-105,1022100017,30,48,78,18,away,1,1,1,1,1,1,1,away,48,-18
5/21/2021,634,PPhoenix,67,162,-110,PHO,Phoenix Mercury,-2.5,-115,1022100017,30,48,78,18,away,0,0,0,0,0,0,0,home,30,18
5/21/2021,635,LALos Angeles,69,168.5,-110,LAS,Los Angeles Sparks,9.5,-110,1022100018,56,36,92,-20,home,1,1,0,0,0,0,0,away,36,20
5/21/2021,636,LVLas Vegas,97,168.5,-110,LVA,Las Vegas Aces,-9.5,-110,1022100018,56,36,92,-20,home,0,0,1,1,1,1,1,home,56,-20
5/22/2021,637,SSeattle,100,170,-110,SEA,Seattle Storm,-7.5,-110,1022100019,45,44,89,-1,home,1,1,1,1,1,1,1,away,44,1
5/22/2021,638,DDallas,97,170,-110,DAL,Dallas Wings,7.5,-110,1022100019,45,44,89,-1,home,0,0,0,0,0,0,0,home,45,-1
5/23/2021,641,NYNew York,93,165,-110,NYL,New York Liberty,5.5,-110,1022100020,52,52,104,0,tie,0,0,0,1,0,0,0,away,52,-0
5/23/2021,642,CChicago,85,165,-110,CHI,Chicago Sky,-5.5,-110,1022100020,52,52,104,0,tie,1,1,1,0,1,1,1,home,52,0
5/23/2021,639,WWashington,77,161,-110,WAS,Washington Mystics,-2.5,-110,1022100021,42,39,81,-3,home,0,0,0,0,0,0,0,away,39,3
5/23/2021,640,IIndiana,89,161,-110,IND,Indiana Fever,2.5,-110,1022100021,42,39,81,-3,home,1,1,1,1,1,1,1,home,42,-3
5/23/2021,643,CConnecticut,72,162,-110,CON,Connecticut Sun,6,-115,1022100022,33,27,60,-6,home,1,1,1,0,0,0,1,away,27,6
5/23/2021,644,LVLas Vegas,65,162,-110,LVA,Las Vegas Aces,-6,-106,1022100022,33,27,60,-6,home,0,0,0,1,1,1,0,home,33,-6
5/24/2021,665,DDallas,81,170,-110,DAL,Dallas Wings,1,-115,1022100024,39,39,78,0,tie,0,1,1,1,1,1,0,away,39,-0
5/24/2021,666,NYNew York,88,170,-110,NYL,New York Liberty,-1,-105,1022100024,39,39,78,0,tie,1,0,0,0,0,0,1,home,39,0
5/25/2021,645,WWashington,85,161,-110,WAS,Washington Mystics,-2.5,-110,1022100023,35,49,84,14,away,1,1,1,1,1,1,1,away,49,-14
5/25/2021,646,IIndiana,69,161,-110,IND,Indiana Fever,2.5,-110,1022100023,35,49,84,14,away,0,0,0,0,0,0,0,home,35,14
5/25/2021,649,AAtlanta,90,169.5,-112,ATL,Atlanta Dream,6,-105,1022100025,33,43,76,10,away,1,1,1,1,1,1,1,away,43,-10
5/25/2021,650,CChicago,83,169,-110,CHI,Chicago Sky,-6,-115,1022100025,33,43,76,10,away,0,0,0,0,0,0,0,home,33,10
5/25/2021,651,CConnecticut,87,161.5,-110,CON,Connecticut Sun,3.5,-110,1022100026,46,40,86,-6,home,0,0,0,0,0,0,1,away,40,6
5/25/2021,652,SSeattle,90,161.5,-110,SEA,Seattle Storm,-3.5,-110,1022100026,46,40,86,-6,home,1,1,1,1,1,1,0,home,46,-6
5/26/2021,653,LVLas Vegas,85,167,-110,LVA,Las Vegas Aces,-6,-110,1022100027,44,45,89,1,away,1,1,1,1,1,1,1,away,45,-1
5/26/2021,654,PPhoenix,79,167,-110,PHO,Phoenix Mercury,6,-110,1022100027,44,45,89,1,away,0,0,0,0,0,0,0,home,44,1
5/27/2021,655,DDallas,95,167.5,-110,DAL,Dallas Wings,-1,-110,1022100028,53,47,100,-6,home,0,0,1,1,0,0,0,away,47,6
5/27/2021,656,AAtlanta,101,167.5,-110,ATL,Atlanta Dream,1,-110,1022100028,53,47,100,-6,home,1,1,0,0,1,1,1,home,53,-6
5/28/2021,657,WWashington,81,156,-110,WAS,Washington Mystics,7.5,-105,1022100029,44,47,91,3,away,1,1,1,1,1,1,0,away,47,-3
5/28/2021,658,CConnecticut,86,156,-110,CON,Connecticut Sun,-7.5,-115,1022100029,44,47,91,3,away,0,0,0,0,0,0,1,home,44,3
5/28/2021,659,LALos Angeles,76,170.5,-110,LAS,Los Angeles Sparks,4,-110,1022100030,33,38,71,5,away,0,0,1,1,1,1,1,away,38,-5
5/28/2021,660,CChicago,61,170.5,-110,CHI,Chicago Sky,-4,-110,1022100030,33,38,71,5,away,1,1,0,0,0,0,0,home,33,5
5/28/2021,661,MMinnesota,72,166,-110,MIN,Minnesota Lynx,6,-115,1022100031,58,36,94,-22,home,0,0,0,0,0,0,0,away,36,22
5/28/2021,662,SSeattle,82,166,-110,SEA,Seattle Storm,-6,-105,1022100031,58,36,94,-22,home,1,1,1,1,1,1,1,home,58,-22
5/28/2021,663,IIndiana,77,165.5,-110,IND,Indiana Fever,11.5,-110,1022100032,59,47,106,-12,home,0,0,0,0,0,0,0,away,47,12
5/28/2021,664,LVLas Vegas,113,165.5,-110,LVA,Las Vegas Aces,-11.5,-110,1022100032,59,47,106,-12,home,1,1,1,1,1,1,1,home,59,-12
5/29/2021,665,AAtlanta,90,169,-110,ATL,Atlanta Dream,2,-110,1022100033,45,49,94,4,away,0,1,1,1,1,1,1,away,49,-4
5/29/2021,666,NYNew York,87,169,-110,NYL,New York Liberty,-2,-110,1022100033,45,49,94,4,away,1,0,0,0,0,0,0,home,45,4
5/29/2021,667,PPhoenix,89,168.5,-110,PHO,Phoenix Mercury,-1,-110,1022100034,37,44,81,7,away,1,1,1,1,1,1,1,away,44,-7
5/29/2021,668,DDallas,85,168.5,-110,DAL,Dallas Wings,1,-110,1022100034,37,44,81,7,away,0,0,0,0,0,0,0,home,37,7
5/30/2021,671,IIndiana,78,168.5,-110,IND,Indiana Fever,13.5,-110,1022100036,48,29,77,-19,home,0,0,0,0,0,0,0,away,29,19
5/30/2021,672,LVLas Vegas,101,168.5,-110,LVA,Las Vegas Aces,-13.5,-110,1022100036,48,29,77,-19,home,1,1,1,1,1,1,1,home,48,-19
5/30/2021,669,LALos Angeles,82,165,-110,LAS,Los Angeles Sparks,3,-110,1022100035,37,37,74,0,tie,0,0,0,0,0,1,0,away,37,-0
5/30/2021,670,CChicago,79,165,-110,CHI,Chicago Sky,-3,-110,1022100035,37,37,74,0,tie,1,1,1,1,1,0,1,home,37,0
5/30/2021,673,CConnecticut,74,156.5,-110,CON,Connecticut Sun,-2.5,-110,1022100037,33,37,70,4,away,1,1,1,1,1,1,1,away,37,-4
5/30/2021,674,MMinnesota,79,156.5,-110,MIN,Minnesota Lynx,2.5,-110,1022100037,33,37,70,4,away,0,0,0,0,0,0,0,home,33,4
6/1/2021,675,LVLas Vegas,67,160,-110,LVA,Las Vegas Aces,-1.5,-110,1022100038,33,30,63,-3,home,0,0,0,0,0,0,0,away,30,3
6/1/2021,676,CConnecticut,74,160,-110,CON,Connecticut Sun,1.5,-110,1022100038,33,30,63,-3,home,1,1,1,1,1,1,1,home,33,-3
6/1/2021,679,LALos Angeles,69,165.5,-110,LAS,Los Angeles Sparks,-1.5,-110,1022100040,38,28,66,-10,home,1,1,1,1,0,0,0,away,28,10
6/1/2021,680,DDallas,79,165.5,-110,DAL,Dallas Wings,1.5,-110,1022100040,38,28,66,-10,home,0,0,0,0,1,1,1,home,38,-10
6/1/2021,677,PPhoenix,84,163,-110,PHO,Phoenix Mercury,1.5,-113,1022100039,36,47,83,11,away,1,1,1,1,0,1,1,away,47,-11
6/1/2021,678,CChicago,83,163,-110,CHI,Chicago Sky,-1,-110,1022100039,36,47,83,11,away,0,0,0,0,1,0,0,home,36,11
6/1/2021,681,IIndiana,73,170,-110,IND,Indiana Fever,15.5,-110,1022100041,43,38,81,-5,home,1,0,0,0,0,0,0,away,38,5
6/1/2021,682,SSeattle,88,170,-110,SEA,Seattle Storm,-15.5,-110,1022100041,43,38,81,-5,home,0,1,1,1,1,1,1,home,43,-5
6/3/2021,601,LVLas Vegas,94,170.5,-110,LVA,Las Vegas Aces,-9,-115,1022100042,44,52,96,8,away,1,1,1,1,1,1,1,away,52,-8
6/3/2021,602,NYNew York,82,170.5,-110,NYL,New York Liberty,9,-105,1022100042,44,52,96,8,away,0,0,0,0,0,0,0,home,44,8
6/3/2021,603,CChicago,74,164.5,-110,CHI,Chicago Sky,1,-120,1022100043,34,26,60,-8,home,0,0,0,0,0,0,1,away,26,8
6/3/2021,604,PPhoenix,77,164.5,-110,PHO,Phoenix Mercury,-1,100,1022100043,34,26,60,-8,home,1,1,1,1,1,1,0,home,34,-8
6/3/2021,605,IIndiana,63,158,-110,IND,Indiana Fever,5,-110,1022100044,48,25,73,-23,home,1,0,0,0,0,0,0,away,25,23
6/3/2021,606,LALos Angeles,98,158,-110,LAS,Los Angeles Sparks,-5,-110,1022100044,48,25,73,-23,home,0,1,1,1,1,1,1,home,48,-23
6/4/2021,607,AAtlanta,84,161.5,-110,ATL,Atlanta Dream,6.5,-110,1022100045,41,42,83,1,away,0,0,0,1,1,1,0,away,42,-1
6/4/2021,608,MMinnesota,86,161.5,-110,MIN,Minnesota Lynx,-7.5,-102,1022100045,41,42,83,1,away,1,1,1,0,0,0,1,home,41,1
6/4/2021,609,DDallas,102,172.5,-110,DAL,Dallas Wings,9,-105,1022100046,57,54,111,-3,home,1,1,1,0,0,0,0,away,54,3
6/4/2021,610,SSeattle,105,172.5,-110,SEA,Seattle Storm,-9,-115,1022100046,57,54,111,-3,home,0,0,0,1,1,1,1,home,57,-3
6/5/2021,611,LVLas Vegas,96,167,-110,LVA,Las Vegas Aces,-7,-110,1022100047,57,56,113,-1,home,1,0,0,0,0,0,0,away,56,1
6/5/2021,612,WWashington,93,167,-110,WAS,Washington Mystics,7,-110,1022100047,57,56,113,-1,home,0,1,1,1,1,1,1,home,57,-1
6/5/2021,613,CChicago,63,157,-110,CHI,Chicago Sky,-1,-130,1022100048,40,31,71,-9,home,0,0,0,0,0,0,0,away,31,9
6/5/2021,614,LALos Angeles,68,157,-110,LAS,Los Angeles Sparks,1,110,1022100048,40,31,71,-9,home,1,1,1,1,1,1,1,home,40,-9
6/5/2021,615,NYNew York,64,158.5,-110,NYL,New York Liberty,9.5,-110,1022100049,43,37,80,-6,home,1,0,0,0,1,1,0,away,37,6
6/5/2021,616,CConnecticut,85,158.5,-110,CON,Connecticut Sun,-9.5,-110,1022100049,43,37,80,-6,home,0,1,1,1,0,0,1,home,43,-6
6/6/2021,619,DDallas,68,178.5,-110,DAL,Dallas Wings,9,-110,1022100051,33,28,61,-5,home,0,1,0,0,0,0,0,away,28,5
6/6/2021,620,SSeattle,67,178.5,-110,SEA,Seattle Storm,-9,-110,1022100051,33,28,61,-5,home,1,0,1,1,1,1,1,home,33,-5
6/6/2021,617,AAtlanta,80,163,-110,ATL,Atlanta Dream,4.5,-110,1022100050,52,38,90,-14,home,0,0,0,0,0,0,0,away,38,14
6/6/2021,618,MMinnesota,100,163,-110,MIN,Minnesota Lynx,-4.5,-110,1022100050,52,38,90,-14,home,1,1,1,1,1,1,1,home,52,-14
6/8/2021,621,MMinnesota,81,164.5,-110,MIN,Minnesota Lynx,-2,-110,1022100052,43,38,81,-5,home,1,1,1,0,0,0,0,away,38,5
6/8/2021,622,WWashington,85,164.5,-110,WAS,Washington Mystics,2,-110,1022100052,43,38,81,-5,home,0,0,0,1,1,1,1,home,43,-5
6/8/2021,623,DDallas,85,166,-110,DAL,Dallas Wings,2,-105,1022100055,35,42,77,7,away,0,1,1,1,1,1,1,away,42,-7
6/8/2021,624,PPhoenix,81,166,-110,PHO,Phoenix Mercury,-2,-115,1022100055,35,42,77,7,away,1,0,0,0,0,0,0,home,35,7
6/9/2021,625,SSeattle,95,170.5,-110,SEA,Seattle Storm,-8.5,-115,1022100053,43,45,88,2,away,1,1,1,1,1,1,1,away,45,-2
6/9/2021,626,AAtlanta,71,170.5,-110,ATL,Atlanta Dream,8.5,-105,1022100053,43,45,88,2,away,0,0,0,0,0,0,0,home,43,2
6/9/2021,627,IIndiana,76,159.5,-110,IND,Indiana Fever,11,-115,1022100054,51,39,90,-12,home,0,0,0,0,0,0,0,away,39,12
6/9/2021,628,CChicago,92,159.5,-110,CHI,Chicago Sky,-11,-110,1022100054,51,39,90,-12,home,1,1,1,1,1,1,1,home,51,-12
6/11/2021,631,SSeattle,86,171,-110,SEA,Seattle Storm,-9.5,-105,1022100057,35,45,80,10,away,1,1,1,0,1,1,1,away,45,-10
6/11/2021,632,AAtlanta,75,171,-110,ATL,Atlanta Dream,9.5,-115,1022100057,35,45,80,10,away,0,0,0,1,0,0,0,home,35,10
6/11/2021,633,DDallas,77,167,-110,DAL,Dallas Wings,2.5,-110,1022100058,33,40,73,7,away,1,1,1,1,1,1,1,away,40,-7
6/11/2021,634,PPhoenix,59,167,-110,PHO,Phoenix Mercury,-2.5,-110,1022100058,33,40,73,7,away,0,0,0,0,0,0,0,home,33,7
6/12/2021,635,CChicago,83,161,-112,CHI,Chicago Sky,-11,-110,1022100059,49,56,105,7,away,1,1,1,1,1,1,1,away,56,-7
6/12/2021,636,IIndiana,79,161,-108,IND,Indiana Fever,11,-110,1022100059,49,56,105,7,away,0,0,0,0,0,0,0,home,49,7
6/12/2021,637,LALos Angeles,64,157,-110,LAS,Los Angeles Sparks,10,-110,1022100060,49,35,84,-14,home,0,0,0,0,0,0,0,away,35,14
6/12/2021,638,MMinnesota,80,157,-110,MIN,Minnesota Lynx,-10,-110,1022100060,49,35,84,-14,home,1,1,1,1,1,1,1,home,49,-14
6/13/2021,639,SSeattle,89,157,-110,SEA,Seattle Storm,-5,-110,1022100061,29,43,72,14,away,1,1,1,1,1,1,1,away,43,-14
6/13/2021,640,CConnecticut,66,157,-110,CON,Connecticut Sun,5,-110,1022100061,29,43,72,14,away,0,0,0,0,0,0,0,home,29,14
6/13/2021,641,WWashington,78,167.5,-110,WAS,Washington Mystics,-4,-110,1022100062,51,49,100,-2,home,1,1,1,1,1,1,1,away,49,2
6/13/2021,642,AAtlanta,101,167.5,-110,ATL,Atlanta Dream,4,-115,1022100062,51,49,100,-2,home,0,0,0,0,0,0,0,home,51,-2
6/13/2021,643,NYNew York,85,159.5,-105,NYL,New York Liberty,7,-110,1022100064,36,48,84,12,away,1,1,1,1,1,1,1,away,48,-12
6/13/2021,644,PPhoenix,83,159.5,-115,PHO,Phoenix Mercury,-7,-110,1022100064,36,48,84,12,away,0,0,0,0,0,0,0,home,36,12
6/13/2021,645,DDallas,78,172,-110,DAL,Dallas Wings,8.5,-105,1022100063,43,41,84,-2,home,0,0,0,0,0,1,1,away,41,2
6/13/2021,646,LVLas Vegas,85,172,-110,LVA,Las Vegas Aces,-8.5,-115,1022100063,43,41,84,-2,home,1,1,1,1,1,0,0,home,43,-2
6/15/2021,651,SSeattle,87,166.5,-110,SEA,Seattle Storm,-15,-110,1022100065,33,41,74,8,away,0,1,1,1,1,1,1,away,41,-8
6/15/2021,652,IIndiana,70,166.5,-110,IND,Indiana Fever,15,-110,1022100065,33,41,74,8,away,1,0,0,0,0,0,0,home,33,8
6/15/2021,653,CChicago,105,160,-115,CHI,Chicago Sky,4,-110,1022100066,49,58,107,9,away,1,1,1,1,1,1,1,away,58,-9
6/15/2021,654,MMinnesota,89,159,-110,MIN,Minnesota Lynx,-4,-110,1022100066,49,58,107,9,away,0,0,0,0,0,0,0,home,49,9
6/15/2021,655,NYNew York,78,172.5,-110,NYL,New York Liberty,14,-105,1022100067,48,45,93,-3,home,0,1,1,1,1,1,1,away,45,3
6/15/2021,656,LVLas Vegas,100,172.5,-110,LVA,Las Vegas Aces,-14,-115,1022100067,48,45,93,-3,home,1,0,0,0,0,0,0,home,48,-3
6/16/2021,661,PPhoenix,80,153.5,-110,PHO,Phoenix Mercury,-5,-110,1022100068,53,43,96,-10,home,0,0,0,0,0,0,0,away,43,10
6/16/2021,662,LALos Angeles,85,153.5,-110,LAS,Los Angeles Sparks,5,-110,1022100068,53,43,96,-10,home,1,1,1,1,1,1,1,home,53,-10
6/18/2021,681,PPhoenix,80,155,-110,PHO,Phoenix Mercury,-3.5,-110,1022100074,36,44,80,8,away,1,1,1,1,1,1,1,away,44,-8
6/18/2021,682,LALos Angeles,66,155,-110,LAS,Los Angeles Sparks,3.5,-110,1022100074,36,44,80,8,away,0,0,0,0,0,0,0,home,36,8
6/19/2021,601,CConnecticut,81,156.5,-110,CON,Connecticut Sun,6.5,-110,1022100075,40,34,74,-6,home,1,1,1,1,0,0,0,away,34,6
6/19/2021,602,CChicago,91,156.5,-110,CHI,Chicago Sky,-6.5,-110,1022100075,40,34,74,-6,home,0,0,0,0,1,1,1,home,40,-6
6/19/2021,603,IIndiana,77,165,-110,IND,Indiana Fever,9.5,-110,1022100076,46,39,85,-7,home,1,1,1,1,1,0,0,away,39,7
6/19/2021,604,WWashington,82,165,-110,WAS,Washington Mystics,-9.5,-110,1022100076,46,39,85,-7,home,0,0,0,0,0,1,1,home,46,-7
6/19/2021,605,MMinnesota,77,165,-110,MIN,Minnesota Lynx,3,-113,1022100077,55,35,90,-20,home,0,0,0,0,0,0,0,away,35,20
6/19/2021,606,DDallas,95,165,-110,DAL,Dallas Wings,-3,-110,1022100077,55,35,90,-20,home,1,1,1,1,1,1,1,home,55,-20
6/20/2021,611,NYNew York,76,160.5,-110,NYL,New York Liberty,2.5,-110,1022100078,36,44,80,8,away,1,0,1,1,1,1,1,away,44,-8
6/20/2021,612,LALos Angeles,73,160.5,-110,LAS,Los Angeles Sparks,-2.5,-110,1022100078,36,44,80,8,away,0,1,0,0,0,0,0,home,36,8
6/22/2021,615,CChicago,92,171,-107,CHI,Chicago Sky,-6.5,-110,1022100080,32,48,80,16,away,1,1,1,1,1,1,1,away,48,-16
6/22/2021,616,NYNew York,72,171,-113,NYL,New York Liberty,6.5,-110,1022100080,32,48,80,16,away,0,0,0,0,0,0,0,home,32,16
6/22/2021,613,DDallas,70,155.5,-110,DAL,Dallas Wings,-0.5,-110,1022100079,30,38,68,8,away,0,0,0,1,1,1,1,away,38,-8
6/22/2021,614,CConnecticut,80,155.5,-110,CON,Connecticut Sun,-0.5,-110,1022100079,30,38,68,8,away,1,1,1,0,0,0,0,home,30,8
6/22/2021,617,WWashington,87,167.5,-110,WAS,Washington Mystics,13.5,-110,1022100081,36,43,79,7,away,1,1,1,1,1,1,1,away,43,-7
6/22/2021,618,SSeattle,83,167.5,-110,SEA,Seattle Storm,-13.5,-110,1022100081,36,43,79,7,away,0,0,0,0,0,0,0,home,36,7
6/23/2021,619,MMinnesota,87,167.5,-110,MIN,Minnesota Lynx,-4,-110,1022100082,46,40,86,-6,home,1,0,0,0,0,0,0,away,40,6
6/23/2021,620,AAtlanta,85,167,-110,ATL,Atlanta Dream,4,-110,1022100082,46,40,86,-6,home,0,1,1,1,1,1,1,home,46,-6
6/24/2021,623,CChicago,91,171,-110,CHI,Chicago Sky,-6,-110,1022100084,27,55,82,28,away,1,1,1,1,1,1,1,away,55,-28
6/24/2021,624,NYNew York,68,171,-110,NYL,New York Liberty,7,-110,1022100084,27,55,82,28,away,0,0,0,0,0,0,0,home,27,28
6/24/2021,621,DDallas,89,162.5,-110,DAL,Dallas Wings,-8,-120,1022100083,24,43,67,19,away,1,1,1,1,1,1,1,away,43,-19
6/24/2021,622,IIndiana,64,162.5,-110,IND,Indiana Fever,8.5,-110,1022100083,24,43,67,19,away,0,0,0,0,0,0,0,home,24,19
6/24/2021,625,WWashington,82,156.5,-110,WAS,Washington Mystics,-3.5,-110,1022100085,49,44,93,-5,home,1,1,1,1,1,0,1,away,44,5
6/24/2021,626,LALos Angeles,89,156.5,-110,LAS,Los Angeles Sparks,3.5,-110,1022100085,49,44,93,-5,home,0,0,0,0,0,1,0,home,49,-5
6/25/2021,627,LVLas Vegas,89,172,-110,LVA,Las Vegas Aces,-6,-110,1022100086,44,48,92,4,away,0,0,0,0,1,0,1,away,48,-4
6/25/2021,628,MMinnesota,90,172,-110,MIN,Minnesota Lynx,6,-110,1022100086,44,48,92,4,away,1,1,1,1,0,1,0,home,44,4
6/26/2021,629,WWashington,74,167.5,-110,WAS,Washington Mystics,6.5,-115,1022100087,46,30,76,-16,home,0,0,0,0,0,0,0,away,30,16
6/26/2021,630,DDallas,85,167.5,-110,DAL,Dallas Wings,-6,-112,1022100087,46,30,76,-16,home,1,1,1,1,1,1,1,home,46,-16
6/26/2021,631,NYNew York,101,170,-110,NYL,New York Liberty,5,-110,1022100088,40,43,83,3,away,1,1,1,1,1,1,1,away,43,-3
6/26/2021,632,AAtlanta,78,170,-110,ATL,Atlanta Dream,-5,-110,1022100088,40,43,83,3,away,0,0,0,0,0,0,0,home,40,3
6/29/2021,639,NYNew York,69,170.5,-110,NYL,New York Liberty,3.5,-110,1022100092,40,34,74,-6,home,1,1,1,1,0,0,0,away,34,6
6/29/2021,640,AAtlanta,73,170.5,-110,ATL,Atlanta Dream,-3.5,-110,1022100092,40,34,74,-6,home,0,0,0,0,1,1,1,home,40,-6
6/29/2021,641,CConnecticut,90,158,-110,CON,Connecticut Sun,-6.5,-110,1022100093,33,49,82,16,away,1,1,1,1,1,1,1,away,49,-16
6/29/2021,642,WWashington,71,158,-110,WAS,Washington Mystics,6.5,-110,1022100093,33,49,82,16,away,0,0,0,0,0,0,0,home,33,16
6/30/2021,643,CChicago,91,166,-110,CHI,Chicago Sky,-2,-105,1022100094,29,51,80,22,away,1,1,1,1,1,1,1,away,51,-22
6/30/2021,644,DDallas,81,166,-105,DAL,Dallas Wings,2,-115,1022100094,29,51,80,22,away,0,0,0,0,0,0,0,home,29,22
6/30/2021,645,MMinnesota,82,165.5,-110,MIN,Minnesota Lynx,2.5,-110,1022100095,44,45,89,1,away,1,0,0,0,0,1,1,away,45,-1
6/30/2021,646,PPhoenix,76,165.5,-110,PHO,Phoenix Mercury,-2.5,-110,1022100095,44,45,89,1,away,0,1,1,1,1,0,0,home,44,1
6/30/2021,647,LVLas Vegas,99,164.5,-110,LVA,Las Vegas Aces,-12,-110,1022100096,37,56,93,19,away,0,0,1,1,1,1,1,away,56,-19
6/30/2021,648,LALos Angeles,75,164.5,-110,LAS,Los Angeles Sparks,12,-110,1022100096,37,56,93,19,away,1,1,0,0,0,0,0,home,37,19
7/1/2021,649,CConnecticut,86,153.5,-110,CON,Connecticut Sun,-15,-110,1022100097,37,55,92,18,away,0,1,1,1,1,1,1,away,55,-18
7/1/2021,650,IIndiana,80,153.5,-110,IND,Indiana Fever,15,-110,1022100097,37,55,92,18,away,1,0,0,0,0,0,0,home,37,18
7/2/2021,651,CChicago,91,167.5,-110,CHI,Chicago Sky,-2.5,-115,1022100098,51,48,99,-3,home,1,1,1,1,1,1,1,away,48,3
7/2/2021,652,DDallas,100,167.5,-110,DAL,Dallas Wings,2.5,-110,1022100098,51,48,99,-3,home,0,0,0,0,0,0,0,home,51,-3
7/2/2021,655,LVLas Vegas,66,167.5,-110,LVA,Las Vegas Aces,-15,-110,1022100099,30,38,68,8,away,1,1,0,0,1,1,1,away,38,-8
7/2/2021,656,LALos Angeles,58,167.5,-110,LAS,Los Angeles Sparks,15,-110,1022100099,30,38,68,8,away,0,0,1,1,0,0,0,home,30,8
7/2/2021,653,AAtlanta,88,166.5,-110,ATL,Atlanta Dream,15.5,-105,1022100101,50,47,97,-3,home,0,0,1,0,0,0,0,away,47,3
7/2/2021,654,SSeattle,91,166.5,-110,SEA,Seattle Storm,-15.5,-115,1022100101,50,47,97,-3,home,1,1,0,1,1,1,1,home,50,-3
7/4/2021,601,AAtlanta,95,174,-110,ATL,Atlanta Dream,15,-112,1022100104,51,48,99,-3,home,1,0,1,1,1,0,0,away,48,3
7/4/2021,602,LVLas Vegas,118,174,-110,LVA,Las Vegas Aces,-15,-108,1022100104,51,48,99,-3,home,0,1,0,0,0,1,1,home,51,-3
7/4/2021,603,SSeattle,84,159.5,-110,SEA,Seattle Storm,-11.5,-105,1022100105,30,39,69,9,away,0,1,1,1,1,1,1,away,39,-9
7/4/2021,604,LALos Angeles,74,159.5,-110,LAS,Los Angeles Sparks,11.5,-115,1022100105,30,39,69,9,away,1,0,0,0,0,0,0,home,30,9
7/5/2021,605,DDallas,96,166.5,-110,DAL,Dallas Wings,-5.5,-110,1022100106,51,47,98,-4,home,1,0,0,0,0,1,0,away,47,4
7/5/2021,606,NYNew York,99,166.5,-110,NYL,New York Liberty,5.5,-110,1022100106,51,47,98,-4,home,0,1,1,1,1,0,1,home,51,-4
7/7/2021,607,DDallas,79,167.5,-115,DAL,Dallas Wings,4.5,-110,1022100107,38,46,84,8,away,0,0,0,1,1,1,1,away,46,-8
7/7/2021,608,MMinnesota,85,167.5,-105,MIN,Minnesota Lynx,-4,-111,1022100107,38,46,84,8,away,1,1,1,0,0,0,0,home,38,8
7/7/2021,611,PPhoenix,99,173,-110,PHO,Phoenix Mercury,10.5,-105,1022100108,43,50,93,7,away,1,0,0,1,1,1,1,away,50,-7
7/7/2021,612,LVLas Vegas,90,173,-110,LVA,Las Vegas Aces,-10.5,-115,1022100108,43,50,93,7,away,0,1,1,0,0,0,0,home,43,7
7/7/2021,609,LALos Angeles,62,158,-110,LAS,Los Angeles Sparks,15.5,-110,1022100109,38,29,67,-9,home,0,0,0,0,0,0,0,away,29,9
7/7/2021,610,SSeattle,71,158,-110,SEA,Seattle Storm,-15.5,-110,1022100109,38,29,67,-9,home,1,1,1,1,1,1,1,home,38,-9
7/9/2021,615,NYNew York,69,164,-110,NYL,New York Liberty,-3.5,-110,1022100111,44,40,84,-4,home,1,1,1,1,1,0,0,away,40,4
7/9/2021,616,IIndiana,82,164,-110,IND,Indiana Fever,3.5,-110,1022100111,44,40,84,-4,home,0,0,0,0,0,1,1,home,44,-4
7/9/2021,613,AAtlanta,72,159.5,-110,ATL,Atlanta Dream,14,-110,1022100110,43,39,82,-4,home,0,0,0,0,0,1,0,away,39,4
7/9/2021,614,CConnecticut,84,159.5,-110,CON,Connecticut Sun,-14,-110,1022100110,43,39,82,-4,home,1,1,1,1,1,0,1,home,43,-4
7/9/2021,617,SSeattle,77,164,-110,SEA,Seattle Storm,-7,-120,1022100112,39,34,73,-5,home,1,1,1,1,0,0,0,away,34,5
7/9/2021,618,PPhoenix,85,164,-110,PHO,Phoenix Mercury,7,100,1022100112,39,34,73,-5,home,0,0,0,0,1,1,1,home,39,-5
7/9/2021,619,MMinnesota,77,171.5,-110,MIN,Minnesota Lynx,4.5,-110,1022100113,37,49,86,12,away,1,1,1,1,1,1,1,away,49,-12
7/9/2021,620,LVLas Vegas,67,171.5,-110,LVA,Las Vegas Aces,-4.5,-110,1022100113,37,49,86,12,away,0,0,0,0,0,0,0,home,37,12
7/10/2021,621,WWashington,89,170.5,-105,WAS,Washington Mystics,9,-110,1022100114,44,46,90,2,away,0,1,1,1,1,1,1,away,46,-2
7/10/2021,622,CChicago,85,170.5,-115,CHI,Chicago Sky,-9,-111,1022100114,44,46,90,2,away,1,0,0,0,0,0,0,home,44,2
7/11/2021,623,LVLas Vegas,95,173.5,-110,LVA,Las Vegas Aces,-3.5,-110,1022100115,42,48,90,6,away,0,0,0,0,0,1,1,away,48,-6
7/11/2021,624,DDallas,79,173.5,-110,DAL,Dallas Wings,3.5,-110,1022100115,42,48,90,6,away,1,1,1,1,1,0,0,home,42,6
7/11/2021,625,CConnecticut,71,157,-110,CON,Connecticut Sun,-8.5,-112,1022100116,28,37,65,9,away,1,1,1,1,1,1,1,away,37,-9
7/11/2021,626,NYNew York,54,157,-110,NYL,New York Liberty,8.5,-108,1022100116,28,37,65,9,away,0,0,0,0,0,0,0,home,28,9
7/11/2021,627,IIndiana,79,166.5,-110,IND,Indiana Fever,5.5,-113,1022100117,40,42,82,2,away,0,0,0,0,1,1,1,away,42,-2
7/11/2021,628,AAtlanta,68,166.5,-110,ATL,Atlanta Dream,-5.5,-107,1022100117,40,42,82,2,away,1,1,1,1,0,0,0,home,40,2
7/11/2021,629,PPhoenix,75,162,-110,PHO,Phoenix Mercury,9,-115,1022100118,44,39,83,-5,home,1,1,1,0,0,0,0,away,39,5
7/11/2021,630,SSeattle,82,162,-110,SEA,Seattle Storm,-9,-105,1022100118,44,39,83,-5,home,0,0,0,1,1,1,1,home,44,-5
7/11/2021,631,MMinnesota,86,153.5,-110,MIN,Minnesota Lynx,-8,-110,1022100119,31,43,74,12,away,1,1,1,1,1,1,1,away,43,-12
7/11/2021,632,LALos Angeles,61,153.5,-110,LAS,Los Angeles Sparks,8,-110,1022100119,31,43,74,12,away,0,0,0,0,0,0,0,home,31,12
8/15/2021,603,SSeattle,85,160,-110,SEA,Seattle Storm,6.5,-110,1022100120,35,32,67,-3,home,1,1,1,1,0,0,0,away,32,3
8/15/2021,604,CChicago,87,160,-110,CHI,Chicago Sky,-6.5,-110,1022100120,35,32,67,-3,home,0,0,0,0,1,1,1,home,35,-3
8/15/2021,605,CConnecticut,80,156.5,-110,CON,Connecticut Sun,-4.5,-110,1022100121,27,47,74,20,away,1,1,1,1,1,1,1,away,47,-20
8/15/2021,606,DDallas,59,156.5,-110,DAL,Dallas Wings,4.5,-110,1022100121,27,47,74,20,away,0,0,0,0,0,0,0,home,27,20
8/15/2021,609,AAtlanta,81,164,-115,ATL,Atlanta Dream,6,-105,1022100123,40,35,75,-5,home,0,0,0,0,0,0,0,away,35,5
8/15/2021,610,PPhoenix,92,164,-105,PHO,Phoenix Mercury,-6,-115,1022100123,40,35,75,-5,home,1,1,1,1,1,1,1,home,40,-5
8/15/2021,607,WWashington,83,173,-118,WAS,Washington Mystics,11,-110,1022100122,35,50,85,15,away,1,1,1,1,1,1,1,away,50,-15
8/15/2021,608,LVLas Vegas,84,173,-102,LVA,Las Vegas Aces,-11,-110,1022100122,35,50,85,15,away,0,0,0,0,0,0,0,home,35,15
8/15/2021,611,NYNew York,78,162.5,-110,NYL,New York Liberty,6.5,-110,1022100124,45,41,86,-4,home,0,0,0,0,0,0,0,away,41,4
8/15/2021,612,MMinnesota,88,162.5,-110,MIN,Minnesota Lynx,-6.5,-110,1022100124,45,41,86,-4,home,1,1,1,1,1,1,1,home,45,-4
8/15/2021,613,IIndiana,70,155,-110,IND,Indiana Fever,4.5,-107,1022100125,49,46,95,-3,home,0,0,0,0,0,0,0,away,46,3
8/15/2021,614,LALos Angeles,75,155,-110,LAS,Los Angeles Sparks,-4.5,-113,1022100125,49,46,95,-3,home,1,1,1,1,1,1,1,home,49,-3
8/17/2021,615,MMinnesota,60,154,-110,MIN,Minnesota Lynx,3.5,-110,1022100126,42,28,70,-14,home,0,0,0,0,0,0,0,away,28,14
8/17/2021,616,CConnecticut,72,154,-110,CON,Connecticut Sun,-3.5,-110,1022100126,42,28,70,-14,home,1,1,1,1,1,1,1,home,42,-14
8/17/2021,617,DDallas,80,167,-110,DAL,Dallas Wings,6,-113,1022100127,36,33,69,-3,home,1,1,1,1,0,0,0,away,33,3
8/17/2021,618,CChicago,76,167,-110,CHI,Chicago Sky,-6,-107,1022100127,36,33,69,-3,home,0,0,0,0,1,1,1,home,36,-3
8/17/2021,619,IIndiana,80,160.5,-110,IND,Indiana Fever,10,-110,1022100129,35,39,74,4,away,0,1,1,1,1,1,1,away,39,-4
8/17/2021,620,PPhoenix,84,160.5,-110,PHO,Phoenix Mercury,-10,-110,1022100129,35,39,74,4,away,1,0,0,0,0,0,0,home,35,4
8/17/2021,621,WWashington,83,172.5,-110,WAS,Washington Mystics,9.5,-110,1022100128,41,49,90,8,away,0,0,0,0,0,0,1,away,49,-8
8/17/2021,622,LVLas Vegas,93,172.5,-110,LVA,Las Vegas Aces,-9.5,-110,1022100128,41,49,90,8,away,1,1,1,1,1,1,0,home,41,8
8/17/2021,623,AAtlanta,80,158.5,-110,ATL,Atlanta Dream,4,-110,1022100130,30,36,66,6,away,1,0,0,1,1,1,1,away,36,-6
8/17/2021,624,LALos Angeles,85,158.5,-110,LAS,Los Angeles Sparks,-4,-110,1022100130,30,36,66,6,away,0,1,1,0,0,0,0,home,30,6
8/18/2021,625,SSeattle,79,157,-110,SEA,Seattle Storm,2,-110,1022100131,42,41,83,-1,home,0,0,1,1,1,0,0,away,41,1
8/18/2021,626,NYNew York,83,157,-110,NYL,New York Liberty,-2,-110,1022100131,42,41,83,-1,home,1,1,0,0,0,1,1,home,42,-1
8/20/2021,633,SSeattle,99,164.5,-110,SEA,Seattle Storm,-9,-110,1022100135,47,46,93,-1,home,1,0,0,0,0,0,0,away,46,1
8/20/2021,634,NYNew York,83,164.5,-110,NYL,New York Liberty,9,-110,1022100135,47,46,93,-1,home,0,1,1,1,1,1,1,home,47,-1
8/20/2021,635,IIndiana,83,159,-110,IND,Indiana Fever,7.5,-110,1022100136,48,45,93,-3,home,1,0,0,0,0,0,0,away,45,3
8/20/2021,636,DDallas,81,159,-110,DAL,Dallas Wings,-7.5,-110,1022100136,48,45,93,-3,home,0,1,1,1,1,1,1,home,48,-3
8/21/2021,637,PPhoenix,84,164.5,-110,PHO,Phoenix Mercury,-5.5,-110,1022100137,32,39,71,7,away,1,1,1,1,1,1,1,away,39,-7
8/21/2021,638,AAtlanta,69,164.5,-110,ATL,Atlanta Dream,5.5,-110,1022100137,32,39,71,7,away,0,0,0,0,0,0,0,home,32,7
8/21/2021,639,MMinnesota,101,161.5,-110,MIN,Minnesota Lynx,-2.5,-115,1022100138,44,48,92,4,away,1,1,1,1,1,1,1,away,48,-4
8/21/2021,640,CChicago,95,161.5,-110,CHI,Chicago Sky,2.5,-105,1022100138,44,48,92,4,away,0,0,0,0,0,0,0,home,44,4
8/22/2021,641,LALos Angeles,86,154,-110,LAS,Los Angeles Sparks,3.5,-115,1022100139,45,38,83,-7,home,1,1,1,1,1,0,0,away,38,7
8/22/2021,642,NYNew York,83,154,-110,NYL,New York Liberty,-3.5,-105,1022100139,45,38,83,-7,home,0,0,0,0,0,1,1,home,45,-7
8/22/2021,643,SSeattle,85,167.5,-110,SEA,Seattle Storm,-8,-110,1022100140,33,43,76,10,away,0,0,0,1,1,1,1,away,43,-10
8/22/2021,644,WWashington,78,167.5,-110,WAS,Washington Mystics,8,-110,1022100140,33,43,76,10,away,1,1,1,0,0,0,0,home,33,10
8/24/2021,649,LALos Angeles,68,157,-110,LAS,Los Angeles Sparks,2,-110,1022100144,56,23,79,-33,home,0,0,0,0,0,0,0,away,23,33
8/24/2021,650,WWashington,78,157,-110,WAS,Washington Mystics,-2,-110,1022100144,56,23,79,-33,home,1,1,1,1,1,1,1,home,56,-33
8/24/2021,651,SSeattle,70,165.5,-110,SEA,Seattle Storm,-4,-115,1022100141,40,33,73,-7,home,0,0,0,0,0,0,0,away,33,7
8/24/2021,652,MMinnesota,76,165.5,-110,MIN,Minnesota Lynx,4,-105,1022100141,40,33,73,-7,home,1,1,1,1,1,1,1,home,40,-7
8/24/2021,645,LVLas Vegas,62,156,-107,LVA,Las Vegas Aces,3,-105,1022100143,40,32,72,-8,home,1,0,1,0,0,0,0,away,32,8
8/24/2021,646,CConnecticut,76,156,-113,CON,Connecticut Sun,-3,-115,1022100143,40,32,72,-8,home,0,1,0,1,1,1,1,home,40,-8
8/24/2021,647,CChicago,86,167.5,-110,CHI,Chicago Sky,-7,-110,1022100142,33,40,73,7,away,1,1,1,1,1,1,1,away,40,-7
8/24/2021,648,AAtlanta,79,167.5,-110,ATL,Atlanta Dream,7,-110,1022100142,33,40,73,7,away,0,0,0,0,0,0,0,home,33,7
8/25/2021,601,PPhoenix,106,162.5,-110,PHO,Phoenix Mercury,-6.5,-110,1022100145,42,55,97,13,away,1,1,1,1,1,1,1,away,55,-13
8/25/2021,602,NYNew York,79,162.5,-110,NYL,New York Liberty,6.5,-110,1022100145,42,55,97,13,away,0,0,0,0,0,0,0,home,42,13
8/26/2021,603,LALos Angeles,72,145.5,-110,LAS,Los Angeles Sparks,12,-115,1022100147,36,39,75,3,away,0,0,0,0,1,1,0,away,39,-3
8/26/2021,604,CConnecticut,76,145.5,-110,CON,Connecticut Sun,-12,-105,1022100147,36,39,75,3,away,1,1,1,1,0,0,1,home,36,3
8/26/2021,607,DDallas,82,162.5,-110,DAL,Dallas Wings,4.5,-105,1022100148,43,34,77,-9,home,0,0,0,0,0,0,0,away,34,9
8/26/2021,608,WWashington,77,162.5,-110,WAS,Washington Mystics,-4.5,-115,1022100148,43,34,77,-9,home,1,1,1,1,1,1,1,home,43,-9
8/26/2021,605,LVLas Vegas,78,166.5,-110,LVA,Las Vegas Aces,-12.5,-115,1022100146,48,40,88,-8,home,0,0,0,1,1,1,0,away,40,8
8/26/2021,606,AAtlanta,71,166.5,-110,ATL,Atlanta Dream,12.5,-105,1022100146,48,40,88,-8,home,1,1,1,0,0,0,1,home,48,-8
8/27/2021,609,PPhoenix,80,165.5,-110,PHO,Phoenix Mercury,-3.5,-105,1022100149,32,42,74,10,away,1,1,1,1,1,1,1,away,42,-10
8/27/2021,610,NYNew York,64,165.5,-110,NYL,New York Liberty,3.5,-115,1022100149,32,42,74,10,away,0,0,0,0,0,0,0,home,32,10
8/27/2021,611,CChicago,73,167,-110,CHI,Chicago Sky,6,-110,1022100150,32,28,60,-4,home,1,0,0,0,0,0,0,away,28,4
8/27/2021,612,SSeattle,69,167,-110,SEA,Seattle Storm,-6,-110,1022100150,32,28,60,-4,home,0,1,1,1,1,1,1,home,32,-4
8/28/2021,613,LVLas Vegas,87,164.5,-115,LVA,Las Vegas Aces,-12.5,-110,1022100151,31,50,81,19,away,1,1,1,1,1,1,1,away,50,-19
8/28/2021,614,IIndiana,71,164.5,-105,IND,Indiana Fever,12.5,-110,1022100151,31,50,81,19,away,0,0,0,0,0,0,0,home,31,19
8/28/2021,615,DDallas,75,161,-110,DAL,Dallas Wings,-1,-105,1022100153,19,35,54,16,away,1,1,1,1,1,1,1,away,35,-16
8/28/2021,616,WWashington,76,161,-110,WAS,Washington Mystics,1,-115,1022100153,19,35,54,16,away,0,0,0,0,0,0,0,home,19,16
8/28/2021,617,LALos Angeles,61,144.5,-110,LAS,Los Angeles Sparks,9.5,-110,1022100152,40,37,77,-3,home,0,1,1,1,1,0,0,away,37,3
8/28/2021,618,CConnecticut,76,144.5,-110,CON,Connecticut Sun,-9.5,-110,1022100152,40,37,77,-3,home,1,0,0,0,0,1,1,home,40,-3
8/29/2021,619,CChicago,107,164,-110,CHI,Chicago Sky,6.5,-109,1022100154,41,63,104,22,away,1,1,1,1,1,1,1,away,63,-22
8/29/2021,620,SSeattle,75,164,-110,SEA,Seattle Storm,-6.5,-111,1022100154,41,63,104,22,away,0,0,0,0,0,0,0,home,41,22
9/2/2021,629,AAtlanta,68,159,-110,ATL,Atlanta Dream,6.5,-105,1022100159,36,31,67,-5,home,0,0,0,1,1,0,0,away,31,5
9/2/2021,630,DDallas,72,159,-110,DAL,Dallas Wings,-6.5,-115,1022100159,36,31,67,-5,home,1,1,1,0,0,1,1,home,36,-5
9/2/2021,631,LALos Angeles,57,152,-110,LAS,Los Angeles Sparks,7.5,-110,1022100160,35,41,76,6,away,0,0,1,1,1,1,1,away,41,-6
9/2/2021,632,MMinnesota,66,152,-110,MIN,Minnesota Lynx,-7.5,-110,1022100160,35,41,76,6,away,1,1,0,0,0,0,0,home,35,6
9/2/2021,633,NYNew York,75,163.5,-110,NYL,New York Liberty,12,-110,1022100162,40,45,85,5,away,0,0,0,1,1,1,1,away,45,-5
9/2/2021,634,SSeattle,85,163.5,-110,SEA,Seattle Storm,-12,-110,1022100162,40,45,85,5,away,1,1,1,0,0,0,0,home,40,5
9/2/2021,635,CChicago,83,171,-110,CHI,Chicago Sky,3.5,-115,1022100161,52,36,88,-16,home,0,0,0,0,0,0,0,away,36,16
9/2/2021,636,LVLas Vegas,90,171,-110,LVA,Las Vegas Aces,-3.5,-105,1022100161,52,36,88,-16,home,1,1,1,1,1,1,1,home,52,-16
9/4/2021,637,PPhoenix,87,160,-110,PHO,Phoenix Mercury,-7.5,-110,1022100163,44,40,84,-4,home,1,1,0,0,0,0,0,away,40,4
9/4/2021,638,IIndiana,65,160,-110,IND,Indiana Fever,7.5,-110,1022100163,44,40,84,-4,home,0,0,1,1,1,1,1,home,44,-4
9/4/2021,639,WWashington,75,159.5,-110,WAS,Washington Mystics,7.5,-110,1022100164,50,35,85,-15,home,0,0,0,0,0,0,0,away,35,15
9/4/2021,640,MMinnesota,93,159.5,-110,MIN,Minnesota Lynx,-7.5,-110,1022100164,50,35,85,-15,home,1,1,1,1,1,1,1,home,50,-15
9/6/2021,645,PPhoenix,86,159.5,-110,PHO,Phoenix Mercury,-11,-110,1022100167,42,43,85,1,away,0,0,0,0,0,1,1,away,43,-1
9/6/2021,646,IIndiana,81,159.5,-110,IND,Indiana Fever,11,-110,1022100167,42,43,85,1,away,1,1,1,1,1,0,0,home,42,1
9/7/2021,647,CConnecticut,83,148.5,-110,CON,Connecticut Sun,-9,-110,1022100168,25,48,73,23,away,1,1,1,1,1,1,1,away,48,-23
9/7/2021,648,DDallas,56,148.5,-110,DAL,Dallas Wings,9,-110,1022100168,25,48,73,23,away,0,0,0,0,0,0,0,home,25,23
9/7/2021,649,WWashington,71,163.5,-110,WAS,Washington Mystics,10,-110,1022100169,54,39,93,-15,home,0,0,0,0,0,0,0,away,39,15
9/7/2021,650,SSeattle,105,163.5,-110,SEA,Seattle Storm,-10,-110,1022100169,54,39,93,-15,home,1,1,1,1,1,1,1,home,54,-15
9/8/2021,651,PPhoenix,76,155,-110,PHO,Phoenix Mercury,-4,-110,1022100170,48,34,82,-14,home,0,0,0,0,0,0,0,away,34,14
9/8/2021,652,AAtlanta,75,155,-110,ATL,Atlanta Dream,4,-110,1022100170,48,34,82,-14,home,1,1,1,1,1,1,1,home,48,-14
9/8/2021,653,MMinnesota,81,167,-110,MIN,Minnesota Lynx,4,-110,1022100171,55,41,96,-14,home,1,0,0,0,0,0,0,away,41,14
9/8/2021,654,LVLas Vegas,102,167,-110,LVA,Las Vegas Aces,-4,-110,1022100171,55,41,96,-14,home,0,1,1,1,1,1,1,home,55,-14
9/9/2021,655,CConnecticut,75,142,-105,CON,Connecticut Sun,-10,-110,1022100172,28,45,73,17,away,1,1,1,1,1,1,1,away,45,-17
9/9/2021,656,LALos Angeles,57,142,-115,LAS,Los Angeles Sparks,10,-110,1022100172,28,45,73,17,away,0,0,0,0,0,0,0,home,28,17
7/7/2022,645,CChicago,93,168,-110,CHI,Chicago Sky,-9,-110,1022200134,38,48,86,10,away,0,1,1,1,1,1,1,away,48,-10
7/7/2022,646,IIndiana,84,168,-110,IND,Indiana Fever,9,-110,1022200134,38,48,86,10,away,1,0,0,0,0,0,0,home,38,10
7/7/2022,647,NYNew York,81,164.5,-120,NYL,New York Liberty,4.5,-110,1022200135,42,34,76,-8,home,0,0,0,0,0,0,0,away,34,8
7/7/2022,648,PPhoenix,84,164.5,100,PHO,Phoenix Mercury,-4.5,-110,1022200135,42,34,76,-8,home,1,1,1,1,1,1,1,home,42,-8
7/7/2022,649,SSeattle,106,161,-115,SEA,Seattle Storm,-4.5,-110,1022200136,32,51,83,19,away,1,1,1,1,1,1,1,away,51,-19
7/7/2022,650,LALos Angeles,69,161,-105,LAS,Los Angeles Sparks,4.5,-110,1022200136,32,51,83,19,away,0,0,0,0,0,0,0,home,32,19
7/15/2022,621,MMinnesota,87,167,-110,MIN,Minnesota Lynx,-4,-110,1022200147,38,37,75,-1,home,1,0,1,0,0,0,0,away,37,1
7/15/2022,622,IIndiana,77,167,-110,IND,Indiana Fever,4,-110,1022200147,38,37,75,-1,home,0,1,0,1,1,1,1,home,38,-1
7/15/2022,623,CConnecticut,93,156,-110,CON,Connecticut Sun,-8,-110,1022200148,33,51,84,18,away,1,1,1,1,1,1,1,away,51,-18
7/15/2022,624,AAtlanta,68,156,-110,ATL,Atlanta Dream,8,-110,1022200148,33,51,84,18,away,0,0,0,0,0,0,0,home,33,18
9/4/2022,635,CChicago,76,162,-110,CHI,Chicago Sky,0.5,-110,1042200213,38,40,78,2,away,1,0,0,0,0,0,1,away,40,-2
9/4/2022,636,CConnecticut,72,162,-110,CON,Connecticut Sun,-0.5,-110,1042200213,38,40,78,2,away,0,1,1,1,1,1,0,home,38,2
9/4/2022,637,LVLas Vegas,110,165,-110,LVA,Las Vegas Aces,1,-110,1042200203,40,48,88,8,away,1,1,1,1,1,1,1,away,48,-8
9/4/2022,638,SSeattle,98,165,-110,SEA,Seattle Storm,-1,-110,1042200203,40,48,88,8,away,0,0,0,0,0,0,0,home,40,8
9/11/2022,601,CConnecticut,64,168,-110,CON,Connecticut Sun,6,-110,1042200301,34,38,72,4,away,0,0,0,0,1,1,1,away,38,-4
9/11/2022,602,LVLas Vegas,67,168.5,-110,LVA,Las Vegas Aces,-6,-110,1042200301,34,38,72,4,away,1,1,1,1,0,0,0,home,34,4
9/15/2022,605,LVLas Vegas,76,160.5,-110,LVA,Las Vegas Aces,1,-107,1042200303,53,42,95,-11,home,1,1,0,0,0,0,0,away,42,11
9/15/2022,606,CConnecticut,105,160.5,-110,CON,Connecticut Sun,-1,-113,1042200303,53,42,95,-11,home,0,0,1,1,1,1,1,home,53,-11
5/6/2022,601,IIndiana,70,162,-110,IND,Indiana Fever,9,-110,1022200001,50,31,81,-19,home,1,0,0,0,0,0,0,away,31,19
5/6/2022,602,WWashington,84,162,-110,WAS,Washington Mystics,-9,-110,1022200001,50,31,81,-19,home,0,1,1,1,1,1,1,home,50,-19
5/6/2022,603,LALos Angeles,98,155,-110,LAS,Los Angeles Sparks,3.5,-110,1022200002,39,42,81,3,away,0,0,1,0,1,1,1,away,42,-3
5/6/2022,604,CChicago,91,155,-110,CHI,Chicago Sky,-3.5,-110,1022200002,39,42,81,3,away,1,1,0,1,0,0,0,home,39,3
5/6/2022,605,MMinnesota,74,161,-110,MIN,Minnesota Lynx,9,-110,1022200004,41,41,82,0,tie,1,1,1,0,0,1,1,away,41,-0
5/6/2022,606,SSeattle,97,161,-110,SEA,Seattle Storm,-9,-110,1022200004,41,41,82,0,tie,0,0,0,1,1,0,0,home,41,0
5/6/2022,607,LVLas Vegas,106,173,-110,LVA,Las Vegas Aces,-4.5,-110,1022200003,32,54,86,22,away,1,1,1,1,1,1,1,away,54,-22
5/6/2022,608,PPhoenix,88,173,-110,PHO,Phoenix Mercury,4.5,-110,1022200003,32,54,86,22,away,0,0,0,0,0,0,0,home,32,22
5/14/2022,661,PPhoenix,69,161.5,-110,PHO,Phoenix Mercury,-2,-110,1022200018,32,34,66,2,away,1,0,1,1,0,1,0,away,34,-2
5/14/2022,662,SSeattle,64,161.5,-110,SEA,Seattle Storm,2,-110,1022200018,32,34,66,2,away,0,1,0,0,1,0,1,home,32,2
5/14/2022,663,LALos Angeles,60,158,-110,LAS,Los Angeles Sparks,7.5,-110,1022200019,49,25,74,-24,home,0,0,0,0,0,0,0,away,25,24
5/14/2022,664,CConnecticut,77,158,-110,CON,Connecticut Sun,-7.5,-110,1022200019,49,25,74,-24,home,1,1,1,1,1,1,1,home,49,-24
5/14/2022,665,CChicago,82,160,-105,CHI,Chicago Sky,-8,-110,1022200020,38,47,85,9,away,1,1,1,1,1,1,1,away,47,-9
5/14/2022,666,MMinnesota,78,160,-115,MIN,Minnesota Lynx,8,-110,1022200020,38,47,85,9,away,0,0,0,0,0,0,0,home,38,9
5/17/2022,611,CConnecticut,92,155,-110,CON,Connecticut Sun,-8.5,-110,1022200023,32,51,83,19,away,0,0,1,1,1,1,1,away,51,-19
5/17/2022,612,NYNew York,65,155,-110,NYL,New York Liberty,8.5,-110,1022200023,32,51,83,19,away,1,1,0,0,0,0,0,home,32,19
5/17/2022,609,AAtlanta,101,158.5,-115,ATL,Atlanta Dream,-0.5,-110,1022200024,35,50,85,15,away,1,1,1,1,1,1,1,away,50,-15
5/17/2022,610,IIndiana,79,158.5,-105,IND,Indiana Fever,-0.5,-110,1022200024,35,50,85,15,away,0,0,0,0,0,0,0,home,35,15
5/17/2022,613,WWashington,84,161,-110,WAS,Washington Mystics,-3,-110,1022200025,34,37,71,3,away,0,0,0,0,0,1,1,away,37,-3
5/17/2022,614,DDallas,68,161,-110,DAL,Dallas Wings,3,-110,1022200025,34,37,71,3,away,1,1,1,1,1,0,0,home,34,3
5/17/2022,615,PPhoenix,74,170,-110,PHO,Phoenix Mercury,8,-105,1022200026,39,43,82,4,away,1,1,1,1,1,1,1,away,43,-4
5/17/2022,616,LVLas Vegas,86,170,-110,LVA,Las Vegas Aces,-8,-115,1022200026,39,43,82,4,away,0,0,0,0,0,0,0,home,39,4
5/17/2022,617,MMinnesota,87,160,-115,MIN,Minnesota Lynx,7,-110,1022200027,40,46,86,6,away,0,1,1,1,1,1,1,away,46,-6
5/17/2022,618,LALos Angeles,84,160,-105,LAS,Los Angeles Sparks,-7,-110,1022200027,40,46,86,6,away,1,0,0,0,0,0,0,home,40,6
5/24/2022,601,AAtlanta,50,157.5,-110,ATL,Atlanta Dream,8.5,-110,1022200040,34,25,59,-9,home,0,0,0,0,0,0,0,away,25,9
5/24/2022,602,WWashington,70,157.5,-110,WAS,Washington Mystics,-8.5,-110,1022200040,34,25,59,-9,home,1,1,1,1,1,1,1,home,34,-9
5/24/2022,603,DDallas,85,160,-110,DAL,Dallas Wings,8,-110,1022200039,39,27,66,-12,home,0,0,0,0,0,0,0,away,27,12
5/24/2022,604,CConnecticut,77,160,-110,CON,Connecticut Sun,-8,-110,1022200039,39,27,66,-12,home,1,1,1,1,1,1,1,home,39,-12
5/24/2022,605,IIndiana,90,162.5,-110,IND,Indiana Fever,13,-105,1022200041,42,49,91,7,away,0,0,0,0,0,0,0,away,49,-7
5/24/2022,606,CChicago,95,162.5,-110,CHI,Chicago Sky,-13,-115,1022200041,42,49,91,7,away,1,1,1,1,1,1,1,home,42,7
5/24/2022,607,NYNew York,78,160.5,-110,NYL,New York Liberty,5,-110,1022200042,45,42,87,-3,home,0,0,0,0,0,0,0,away,42,3
5/24/2022,608,MMinnesota,84,160.5,-110,MIN,Minnesota Lynx,-5,-110,1022200042,45,42,87,-3,home,1,1,1,1,1,1,1,home,45,-3
6/17/2022,613,SSeattle,71,162.5,-115,SEA,Seattle Storm,7.5,-110,1022200089,42,32,74,-10,home,1,1,0,0,0,0,0,away,32,10
6/17/2022,614,CConnecticut,82,162.5,-105,CON,Connecticut Sun,-7.5,-110,1022200089,42,32,74,-10,home,0,0,1,1,1,1,1,home,42,-10
6/17/2022,615,AAtlanta,100,158.5,-115,ATL,Atlanta Dream,7,-110,1022200091,56,42,98,-14,home,1,1,0,1,0,0,0,away,42,14
6/17/2022,616,CChicago,106,158.5,-105,CHI,Chicago Sky,-7,-110,1022200091,56,42,98,-14,home,0,0,1,0,1,1,1,home,56,-14
6/17/2022,617,PPhoenix,88,169.5,-110,PHO,Phoenix Mercury,5,-110,1022200090,53,39,92,-14,home,0,0,0,0,0,0,0,away,39,14
6/17/2022,618,DDallas,93,169.5,-110,DAL,Dallas Wings,-5,-110,1022200090,53,39,92,-14,home,1,1,1,1,1,1,1,home,53,-14
7/14/2022,613,LVLas Vegas,108,175,-110,LVA,Las Vegas Aces,-6,-110,1022200143,36,71,107,35,away,1,1,1,1,1,1,1,away,71,-35
7/14/2022,614,NYNew York,74,175,-110,NYL,New York Liberty,6,-110,1022200143,36,71,107,35,away,0,0,0,0,0,0,0,home,36,35
7/14/2022,615,DDallas,92,165.5,-110,DAL,Dallas Wings,4.5,-110,1022200144,27,48,75,21,away,1,1,1,1,1,1,1,away,48,-21
7/14/2022,616,MMinnesota,87,165.5,-110,MIN,Minnesota Lynx,-4.5,-110,1022200144,27,48,75,21,away,0,0,0,0,0,0,0,home,27,21
7/14/2022,617,WWashington,75,160,-110,WAS,Washington Mystics,-4.5,-110,1022200145,43,45,88,2,away,1,1,1,1,1,1,1,away,45,-2
7/14/2022,618,PPhoenix,80,160,-110,PHO,Phoenix Mercury,4.5,-110,1022200145,43,45,88,2,away,0,0,0,0,0,0,0,home,43,2
7/14/2022,619,CChicago,80,169,-110,CHI,Chicago Sky,-6,-110,1022200146,28,37,65,9,away,0,0,1,1,1,1,1,away,37,-9
7/14/2022,620,LALos Angeles,68,169,-110,LAS,Los Angeles Sparks,6,-110,1022200146,28,37,65,9,away,1,1,0,0,0,0,0,home,28,9
7/19/2022,635,NYNew York,63,161.5,-110,NYL,New York Liberty,5,-110,1022200154,39,35,74,-4,home,0,0,1,1,1,0,0,away,35,4
7/19/2022,636,CConnecticut,82,161.5,-110,CON,Connecticut Sun,-5,-110,1022200154,39,35,74,-4,home,1,1,0,0,0,1,1,home,39,-4
7/19/2022,637,AAtlanta,92,173.5,-110,ATL,Atlanta Dream,13,-110,1022200155,36,52,88,16,away,1,1,1,1,1,1,1,away,52,-16
7/19/2022,638,LVLas Vegas,76,173.5,-110,LVA,Las Vegas Aces,-13,-110,1022200155,36,52,88,16,away,0,0,0,0,0,0,0,home,36,16
7/19/2022,639,IIndiana,79,162.5,-110,IND,Indiana Fever,8,-110,1022200156,42,40,82,-2,home,0,0,0,0,1,1,0,away,40,2
7/19/2022,640,LALos Angeles,86,162.5,-110,LAS,Los Angeles Sparks,-8,-110,1022200156,42,40,82,-2,home,1,1,1,1,0,0,1,home,42,-2
7/24/2022,601,DDallas,96,167,-110,DAL,Dallas Wings,-6.5,-115,1022200166,39,45,84,6,away,0,0,0,0,1,1,1,away,45,-6
7/24/2022,602,IIndiana,86,167,-110,IND,Indiana Fever,6.5,-105,1022200166,39,45,84,6,away,1,1,1,1,0,0,0,home,39,6
7/24/2022,603,AAtlanta,72,157.5,-110,ATL,Atlanta Dream,7.5,-108,1022200167,41,34,75,-7,home,0,1,1,0,0,0,0,away,34,7
7/24/2022,604,SSeattle,82,157.5,-110,SEA,Seattle Storm,-7.5,-112,1022200167,41,34,75,-7,home,1,0,0,1,1,1,1,home,41,-7
7/24/2022,605,CConnecticut,86,164,-110,CON,Connecticut Sun,-5.5,-110,1022200168,32,42,74,10,away,1,1,1,1,1,1,1,away,42,-10
7/24/2022,606,MMinnesota,79,164,-110,MIN,Minnesota Lynx,5.5,-110,1022200168,32,42,74,10,away,0,0,0,0,0,0,0,home,32,10
8/6/2022,601,IIndiana,91,164.5,-110,IND,Indiana Fever,13.5,-115,1022200193,38,50,88,12,away,1,1,1,1,1,1,1,away,50,-12
8/6/2022,602,DDallas,95,164.5,-110,DAL,Dallas Wings,-13.5,-105,1022200193,38,50,88,12,away,0,0,0,0,0,0,0,home,38,12
8/6/2022,603,NYNew York,62,158,-110,NYL,New York Liberty,-5.5,-115,1022200194,43,34,77,-9,home,0,0,0,0,0,0,0,away,34,9
8/6/2022,604,PPhoenix,76,158,-110,PHO,Phoenix Mercury,5.5,-105,1022200194,43,34,77,-9,home,1,1,1,1,1,1,1,home,43,-9
8/8/2022,613,NYNew York,77,162,-110,NYL,New York Liberty,4.5,-110,1022200199,44,38,82,-6,home,0,0,0,0,0,0,0,away,38,6
8/8/2022,614,DDallas,86,162,-110,DAL,Dallas Wings,-4.5,-110,1022200199,44,38,82,-6,home,1,1,1,1,1,1,1,home,44,-6
8/9/2022,615,SSeattle,111,165,-110,SEA,Seattle Storm,5,-110,1022200200,55,66,121,11,away,1,1,1,1,1,1,1,away,66,-11
8/9/2022,616,CChicago,100,165,-110,CHI,Chicago Sky,-5,-110,1022200200,55,66,121,11,away,0,0,0,0,0,0,0,home,55,11
8/9/2022,617,AAtlanta,90,166.5,-110,ATL,Atlanta Dream,13,-110,1022200201,47,44,91,-3,home,0,0,1,0,1,0,0,away,44,3
8/9/2022,618,LVLas Vegas,97,166.5,-110,LVA,Las Vegas Aces,-13,-110,1022200201,47,44,91,-3,home,1,1,0,1,0,1,1,home,47,-3
8/9/2022,619,CConnecticut,97,159.5,-110,CON,Connecticut Sun,-8.5,-110,1022200202,32,53,85,21,away,0,1,1,1,1,1,1,away,53,-21
8/9/2022,620,LALos Angeles,71,159.5,-110,LAS,Los Angeles Sparks,8.5,-110,1022200202,32,53,85,21,away,1,0,0,0,0,0,0,home,32,21
8/10/2022,621,NYNew York,91,163,-110,NYL,New York Liberty,2.5,-110,1022200203,39,38,77,-1,home,0,0,0,0,0,0,1,away,38,1
8/10/2022,622,DDallas,73,163,-110,DAL,Dallas Wings,-2.5,-110,1022200203,39,38,77,-1,home,1,1,1,1,1,1,0,home,39,-1
8/10/2022,623,MMinnesota,86,161,-110,MIN,Minnesota Lynx,-6.5,-110,1022200204,40,42,82,2,away,0,1,1,0,0,0,0,away,42,-2
8/10/2022,624,PPhoenix,77,161,-110,PHO,Phoenix Mercury,6.5,-110,1022200204,40,42,82,2,away,1,0,0,1,1,1,1,home,40,2
8/11/2022,625,CChicago,78,175.5,-110,CHI,Chicago Sky,1.5,-110,1022200205,47,33,80,-14,home,0,0,0,0,0,0,0,away,33,14
8/11/2022,626,LVLas Vegas,89,175.5,-110,LVA,Las Vegas Aces,-1.5,-110,1022200205,47,33,80,-14,home,1,1,1,1,1,1,1,home,47,-14
8/11/2022,627,CConnecticut,93,162,-110,CON,Connecticut Sun,-11,-110,1022200206,43,54,97,11,away,1,1,1,1,1,1,1,away,54,-11
8/11/2022,628,LALos Angeles,69,162,-110,LAS,Los Angeles Sparks,11,-110,1022200206,43,54,97,11,away,0,0,0,0,0,0,0,home,43,11
8/12/2022,629,WWashington,82,159,-110,WAS,Washington Mystics,-13.5,-110,1022200207,30,39,69,9,away,1,1,1,1,1,1,1,away,39,-9
8/12/2022,630,IIndiana,70,159,-110,IND,Indiana Fever,13.5,-110,1022200207,30,39,69,9,away,0,0,0,0,0,0,0,home,30,9
8/12/2022,631,NYNew York,80,159.5,-110,NYL,New York Liberty,-1.5,-110,1022200208,42,53,95,11,away,1,1,1,1,1,1,1,away,53,-11
8/12/2022,632,AAtlanta,70,159.5,-110,ATL,Atlanta Dream,1.5,-110,1022200208,42,53,95,11,away,0,0,0,0,0,0,0,home,42,11
8/12/2022,633,SSeattle,96,163.5,-110,SEA,Seattle Storm,-0.5,-110,1022200209,28,45,73,17,away,1,1,1,1,1,1,1,away,45,-17
8/12/2022,634,MMinnesota,69,163.5,-110,MIN,Minnesota Lynx,-0.5,-110,1022200209,28,45,73,17,away,0,0,0,0,0,0,0,home,28,17
8/12/2022,635,DDallas,74,159.5,-110,DAL,Dallas Wings,-1.5,-110,1022200210,39,43,82,4,away,1,1,1,1,1,1,1,away,43,-4
8/12/2022,636,PPhoenix,86,159.5,-110,PHO,Phoenix Mercury,1.5,-110,1022200210,39,43,82,4,away,0,0,0,0,0,0,0,home,39,4
8/14/2022,641,MMinnesota,83,164.5,-110,MIN,Minnesota Lynx,6,-115,1022200211,45,34,79,-11,home,0,0,0,0,0,0,0,away,34,11
8/14/2022,642,CConnecticut,90,164.5,-110,CON,Connecticut Sun,-6,-105,1022200211,45,34,79,-11,home,1,1,1,1,1,1,1,home,45,-11
8/14/2022,643,AAtlanta,83,160.5,-110,ATL,Atlanta Dream,4.5,-107,1022200212,52,49,101,-3,home,1,0,0,0,0,0,0,away,49,3
8/14/2022,644,NYNew York,87,160.5,-110,NYL,New York Liberty,-4.5,-113,1022200212,52,49,101,-3,home,0,1,1,1,1,1,1,home,52,-3
8/14/2022,645,IIndiana,83,158,-110,IND,Indiana Fever,11.5,-110,1022200213,57,40,97,-17,home,1,1,0,0,0,0,0,away,40,17
8/14/2022,646,WWashington,95,158,-110,WAS,Washington Mystics,-11.5,-110,1022200213,57,40,97,-17,home,0,0,1,1,1,1,1,home,57,-17
8/14/2022,649,SSeattle,100,168,-110,SEA,Seattle Storm,6.5,-110,1022200215,50,51,101,1,away,0,0,0,0,1,1,1,away,51,-1
8/14/2022,650,LVLas Vegas,109,168,-110,LVA,Las Vegas Aces,-6.5,-110,1022200215,50,51,101,1,away,1,1,1,1,0,0,0,home,50,1
8/14/2022,647,CChicago,82,165.5,-110,CHI,Chicago Sky,-7.5,-110,1022200214,25,39,64,14,away,1,1,1,1,1,1,1,away,39,-14
8/14/2022,648,PPhoenix,67,165.5,-110,PHO,Phoenix Mercury,7.5,-110,1022200214,25,39,64,14,away,0,0,0,0,0,0,0,home,25,14
8/14/2022,651,DDallas,116,164,-110,DAL,Dallas Wings,-6,-110,1022200216,29,66,95,37,away,0,0,1,1,1,1,1,away,66,-37
8/14/2022,652,LALos Angeles,88,164,-110,LAS,Los Angeles Sparks,6,-110,1022200216,29,66,95,37,away,1,1,0,0,0,0,0,home,29,37
8/17/2022,601,NYNew York,98,167.5,-110,NYL,New York Liberty,10,-110,1042200111,45,48,93,3,away,0,1,0,0,0,0,0,away,48,-3
8/17/2022,602,CChicago,91,167.5,-110,CHI,Chicago Sky,-10,-110,1042200111,45,48,93,3,away,1,0,1,1,1,1,1,home,45,3
8/17/2022,603,PPhoenix,63,168,-110,PHO,Phoenix Mercury,16.5,-110,1042200101,42,37,79,-5,home,1,1,1,0,0,0,0,away,37,5
8/17/2022,604,LVLas Vegas,79,168,-110,LVA,Las Vegas Aces,-16.5,-110,1042200101,42,37,79,-5,home,0,0,0,1,1,1,1,home,42,-5
8/18/2022,605,DDallas,68,163.5,-110,DAL,Dallas Wings,9.5,-107,1042200121,47,37,84,-10,home,0,0,0,0,0,0,0,away,37,10
8/18/2022,606,CConnecticut,93,163.5,-110,CON,Connecticut Sun,-9.5,-113,1042200121,47,37,84,-10,home,1,1,1,1,1,1,1,home,47,-10
8/18/2022,607,WWashington,83,157,-115,WAS,Washington Mystics,4,-110,1042200131,40,42,82,2,away,1,0,0,0,0,0,1,away,42,-2
8/18/2022,608,SSeattle,86,157,-105,SEA,Seattle Storm,-4,-110,1042200131,40,42,82,2,away,0,1,1,1,1,1,0,home,40,2
8/20/2022,609,NYNew York,62,170,-110,NYL,New York Liberty,9,-110,1042200112,52,28,80,-24,home,0,0,0,0,0,0,0,away,28,24
8/20/2022,610,CChicago,100,170,-110,CHI,Chicago Sky,-9,-110,1042200112,52,28,80,-24,home,1,1,1,1,1,1,1,home,52,-24
8/20/2022,611,PPhoenix,80,164.5,-110,PHO,Phoenix Mercury,17.5,-110,1042200102,63,44,107,-19,home,0,0,0,0,0,0,0,away,44,19
8/20/2022,612,LVLas Vegas,117,164.5,-110,LVA,Las Vegas Aces,-17.5,-110,1042200102,63,44,107,-19,home,1,1,1,1,1,1,1,home,63,-19
8/21/2022,613,DDallas,89,164,-110,DAL,Dallas Wings,11.5,-110,1042200122,30,46,76,16,away,1,1,1,1,1,1,1,away,46,-16
8/21/2022,614,CConnecticut,79,164,-110,CON,Connecticut Sun,-11.5,-110,1042200122,30,46,76,16,away,0,0,0,0,0,0,0,home,30,16
8/21/2022,615,WWashington,84,160,-110,WAS,Washington Mystics,3.5,-110,1042200132,45,43,88,-2,home,0,0,0,0,0,0,0,away,43,2
8/21/2022,616,SSeattle,97,160,-110,SEA,Seattle Storm,-3.5,-110,1042200132,45,43,88,-2,home,1,1,1,1,1,1,1,home,45,-2
8/23/2022,617,CChicago,90,167,-110,CHI,Chicago Sky,-7,-118,1042200113,42,54,96,12,away,1,1,1,1,1,1,1,away,54,-12
8/23/2022,618,NYNew York,72,167,-110,NYL,New York Liberty,7,-102,1042200113,42,54,96,12,away,0,0,0,0,0,0,0,home,42,12
8/24/2022,621,CConnecticut,73,165,-110,CON,Connecticut Sun,-6.5,-110,1042200123,34,34,68,0,tie,0,1,0,0,0,0,1,away,34,-0
8/24/2022,622,DDallas,58,165,-110,DAL,Dallas Wings,6.5,-110,1042200123,34,34,68,0,tie,1,0,1,1,1,1,0,home,34,0
8/28/2022,627,SSeattle,76,171.5,-110,SEA,Seattle Storm,5.5,-110,1042200201,36,43,79,7,away,1,1,1,1,1,1,1,away,43,-7
8/28/2022,628,LVLas Vegas,73,171.5,-110,LVA,Las Vegas Aces,-5.5,-110,1042200201,36,43,79,7,away,0,0,0,0,0,0,0,home,36,7
8/28/2022,629,CConnecticut,68,166,-110,CON,Connecticut Sun,4,-110,1042200211,34,34,68,0,tie,1,1,0,0,0,1,1,away,34,-0
8/28/2022,630,CChicago,63,166,-110,CHI,Chicago Sky,-4,-110,1042200211,34,34,68,0,tie,0,0,1,1,1,0,0,home,34,0
8/31/2022,631,CConnecticut,77,164.5,-115,CON,Connecticut Sun,5.5,-110,1042200212,47,32,79,-15,home,0,0,0,0,0,0,0,away,32,15
8/31/2022,632,CChicago,85,164.5,-105,CHI,Chicago Sky,-5.5,-110,1042200212,47,32,79,-15,home,1,1,1,1,1,1,1,home,47,-15
8/31/2022,633,SSeattle,73,169.5,-110,SEA,Seattle Storm,6,-110,1042200202,36,36,72,0,tie,1,0,1,1,1,1,1,away,36,-0
8/31/2022,634,LVLas Vegas,78,169.5,-110,LVA,Las Vegas Aces,-6,-110,1042200202,36,36,72,0,tie,0,1,0,0,0,0,0,home,36,0
9/6/2022,641,CChicago,80,160,-110,CHI,Chicago Sky,1.5,-110,1042200214,58,41,99,-17,home,0,0,0,0,0,0,0,away,41,17
9/6/2022,642,CConnecticut,104,160,-110,CON,Connecticut Sun,-1.5,-110,1042200214,58,41,99,-17,home,1,1,1,1,1,1,1,home,58,-17
9/6/2022,639,LVLas Vegas,97,165,-110,LVA,Las Vegas Aces,1,-110,1042200204,47,44,91,-3,home,0,0,0,0,0,0,0,away,44,3
9/6/2022,640,SSeattle,92,165,-110,SEA,Seattle Storm,-1,-110,1042200204,47,44,91,-3,home,1,1,1,1,1,1,1,home,47,-3
9/8/2022,645,CConnecticut,72,158.5,-110,CON,Connecticut Sun,4,-110,1042200215,40,40,80,0,tie,1,1,1,1,1,1,0,away,40,-0
9/8/2022,646,CChicago,63,158.5,-110,CHI,Chicago Sky,-4,-110,1042200215,40,40,80,0,tie,0,0,0,0,0,0,1,home,40,0
9/13/2022,603,CConnecticut,71,161.5,-110,CON,Connecticut Sun,4.5,-110,1042200302,45,37,82,-8,home,0,0,0,0,0,0,0,away,37,8
9/13/2022,604,LVLas Vegas,85,161.5,-110,LVA,Las Vegas Aces,-4.5,-110,1042200302,45,37,82,-8,home,1,1,1,1,1,1,1,home,45,-8
9/18/2022,605,LVLas Vegas,78,163,-110,LVA,Las Vegas Aces,-1.5,-110,1042200304,28,30,58,2,away,1,1,1,1,1,1,0,away,30,-2
9/18/2022,606,CConnecticut,71,163,-110,CON,Connecticut Sun,1.5,-110,1042200304,28,30,58,2,away,0,0,0,0,0,0,1,home,28,2
5/7/2022,611,CConnecticut,79,162,-110,CON,Connecticut Sun,-6,-105,1022200005,38,30,68,-8,home,1,1,1,1,1,0,0,away,30,8
5/7/2022,612,NYNew York,81,162,-110,NYL,New York Liberty,6,-115,1022200005,38,30,68,-8,home,0,0,0,0,0,1,1,home,38,-8
5/7/2022,613,AAtlanta,66,162.5,-115,ATL,Atlanta Dream,8,-110,1022200006,35,39,74,4,away,1,1,1,1,1,1,1,away,39,-4
5/7/2022,614,DDallas,59,162.5,-105,DAL,Dallas Wings,-8,-110,1022200006,35,39,74,4,away,0,0,0,0,0,0,0,home,35,4
5/8/2022,621,LALos Angeles,87,160.5,-110,LAS,Los Angeles Sparks,-7,-110,1022200007,36,43,79,7,away,0,1,1,0,0,1,1,away,43,-7
5/8/2022,622,IIndiana,77,160.5,-110,IND,Indiana Fever,7,-110,1022200007,36,43,79,7,away,1,0,0,1,1,0,0,home,36,7
5/8/2022,623,WWashington,78,159,-110,WAS,Washington Mystics,2.5,-105,1022200009,23,47,70,24,away,1,1,1,1,1,1,1,away,47,-24
5/8/2022,624,MMinnesota,66,159,-110,MIN,Minnesota Lynx,-2.5,-115,1022200009,23,47,70,24,away,0,0,0,0,0,0,0,home,23,24
5/8/2022,625,SSeattle,74,177,-105,SEA,Seattle Storm,4.5,-110,1022200008,39,33,72,-6,home,0,0,0,0,0,0,0,away,33,6
5/8/2022,626,LVLas Vegas,85,177,-115,LVA,Las Vegas Aces,-4.5,-110,1022200008,39,33,72,-6,home,1,1,1,1,1,1,1,home,39,-6
5/10/2022,633,MMinnesota,76,159,-110,MIN,Minnesota Lynx,-3,-110,1022200011,48,39,87,-9,home,1,1,1,1,0,0,0,away,39,9
5/10/2022,634,IIndiana,82,159,-110,IND,Indiana Fever,3,-110,1022200011,48,39,87,-9,home,0,0,0,0,1,1,1,home,48,-9
5/10/2022,631,LVLas Vegas,76,168,-110,LVA,Las Vegas Aces,-5,-110,1022200010,36,49,85,13,away,1,1,1,1,1,1,1,away,49,-13
5/10/2022,632,WWashington,89,168,-110,WAS,Washington Mystics,5,-110,1022200010,36,49,85,13,away,0,0,0,0,0,0,0,home,36,13
5/11/2022,641,LALos Angeles,75,161.5,-110,LAS,Los Angeles Sparks,-5.5,-110,1022200012,40,39,79,-1,home,0,0,0,1,0,0,0,away,39,1
5/11/2022,642,AAtlanta,77,161.5,-110,ATL,Atlanta Dream,5.5,-110,1022200012,40,39,79,-1,home,1,1,1,0,1,1,1,home,40,-1
5/11/2022,643,NYNew York,50,165,-110,NYL,New York Liberty,5,-110,1022200013,36,17,53,-19,home,0,0,0,0,0,0,0,away,17,19
5/11/2022,644,CChicago,83,165,-110,CHI,Chicago Sky,-5,-110,1022200013,36,17,53,-19,home,1,1,1,1,1,1,1,home,36,-19
5/11/2022,645,SSeattle,77,163,-110,SEA,Seattle Storm,2,-110,1022200014,39,31,70,-8,home,1,1,1,1,0,0,0,away,31,8
5/11/2022,646,PPhoenix,97,163,-110,PHO,Phoenix Mercury,-2,-110,1022200014,39,31,70,-8,home,0,0,0,0,1,1,1,home,39,-8
5/13/2022,649,DDallas,94,159.5,-105,DAL,Dallas Wings,7.5,-110,1022200015,44,41,85,-3,home,0,0,0,0,0,0,0,away,41,3
5/13/2022,650,WWashington,86,159.5,-115,WAS,Washington Mystics,-7.5,-110,1022200015,44,41,85,-3,home,1,1,1,1,1,1,1,home,44,-3
5/13/2022,651,LVLas Vegas,96,167.5,-110,LVA,Las Vegas Aces,-8.5,-110,1022200016,33,49,82,16,away,1,1,1,1,1,1,1,away,49,-16
5/13/2022,652,AAtlanta,73,167.5,-110,ATL,Atlanta Dream,8.5,-110,1022200016,33,49,82,16,away,0,0,0,0,0,0,0,home,33,16
5/13/2022,653,IIndiana,92,159,-110,IND,Indiana Fever,6,-110,1022200017,41,41,82,0,tie,1,0,1,1,1,1,1,away,41,-0
5/13/2022,654,NYNew York,86,159,-110,NYL,New York Liberty,-6,-110,1022200017,41,41,82,0,tie,0,1,0,0,0,0,0,home,41,0
5/15/2022,601,DDallas,81,164.5,-115,DAL,Dallas Wings,2,-110,1022200021,37,39,76,2,away,0,1,1,1,0,1,1,away,39,-2
5/15/2022,602,NYNew York,71,164.5,-105,NYL,New York Liberty,-2,-110,1022200021,37,39,76,2,away,1,0,0,0,1,0,0,home,37,2
5/15/2022,603,AAtlanta,85,157.5,-110,ATL,Atlanta Dream,2,-110,1022200022,36,36,72,0,tie,0,0,0,1,1,1,1,away,36,-0
5/15/2022,604,IIndiana,79,157.5,-110,IND,Indiana Fever,-2,-110,1022200022,36,36,72,0,tie,1,1,1,0,0,0,0,home,36,0
5/18/2022,621,CChicago,71,162,-110,CHI,Chicago Sky,1,-110,1022200028,46,34,80,-12,home,0,0,0,0,0,0,0,away,34,12
5/18/2022,622,SSeattle,74,162,-110,SEA,Seattle Storm,-1,-110,1022200028,46,34,80,-12,home,1,1,1,1,1,1,1,home,46,-12
5/19/2022,633,DDallas,94,159,-110,DAL,Dallas Wings,2,-115,1022200030,41,44,85,3,away,1,0,1,1,1,1,1,away,44,-3
5/19/2022,634,PPhoenix,84,159,-110,PHO,Phoenix Mercury,-2,-105,1022200030,41,44,85,3,away,0,1,0,0,0,0,0,home,41,3
5/19/2022,631,MMinnesota,87,168.5,-115,MIN,Minnesota Lynx,10,-110,1022200029,54,43,97,-11,home,0,0,0,0,0,0,0,away,43,11
5/19/2022,632,LVLas Vegas,93,168.5,-105,LVA,Las Vegas Aces,-10,-110,1022200029,54,43,97,-11,home,1,1,1,1,1,1,1,home,54,-11
5/20/2022,641,IIndiana,85,155.5,-110,IND,Indiana Fever,16,-110,1022200031,37,35,72,-2,home,1,0,1,0,0,1,0,away,35,2
5/20/2022,642,CConnecticut,94,155.5,-110,CON,Connecticut Sun,-16,-110,1022200031,37,35,72,-2,home,0,1,0,1,1,0,1,home,37,-2
5/20/2022,643,WWashington,78,158,-110,WAS,Washington Mystics,-1.5,-110,1022200032,44,44,88,0,tie,1,1,0,0,0,0,1,away,44,-0
5/20/2022,644,AAtlanta,73,158,-110,ATL,Atlanta Dream,1.5,-110,1022200032,44,44,88,0,tie,0,0,1,1,1,1,0,home,44,0
5/20/2022,645,LALos Angeles,80,161,-105,LAS,Los Angeles Sparks,7,-105,1022200033,51,41,92,-10,home,0,0,0,0,0,0,0,away,41,10
5/20/2022,646,SSeattle,83,161,-115,SEA,Seattle Storm,-7,-115,1022200033,51,41,92,-10,home,1,1,1,1,1,1,1,home,51,-10
5/21/2022,649,PPhoenix,80,169,-110,PHO,Phoenix Mercury,10.5,-110,1022200034,44,42,86,-2,home,1,1,1,1,1,1,1,away,42,2
5/21/2022,650,LVLas Vegas,100,169,-110,LVA,Las Vegas Aces,-10.5,-110,1022200034,44,42,86,-2,home,0,0,0,0,0,0,0,home,44,-2
5/21/2022,651,MMinnesota,78,164,-110,MIN,Minnesota Lynx,2,-110,1022200035,43,45,88,2,away,0,1,1,1,1,1,1,away,45,-2
5/21/2022,652,DDallas,94,164,-110,DAL,Dallas Wings,-2,-110,1022200035,43,45,88,2,away,1,0,0,0,0,0,0,home,43,2
5/22/2022,655,CConnecticut,92,161.5,-110,CON,Connecticut Sun,-13,-110,1022200036,41,54,95,13,away,1,1,1,1,1,1,1,away,54,-13
5/22/2022,656,IIndiana,70,161.5,-110,IND,Indiana Fever,13,-110,1022200036,41,54,95,13,away,0,0,0,0,0,0,0,home,41,13
5/22/2022,657,CChicago,82,162,-110,CHI,Chicago Sky,1.5,-110,1022200037,42,38,80,-4,home,0,0,1,1,1,0,0,away,38,4
5/22/2022,658,WWashington,73,162,-110,WAS,Washington Mystics,-1.5,-110,1022200037,42,38,80,-4,home,1,1,0,0,0,1,1,home,42,-4
5/23/2022,661,LALos Angeles,76,171,-110,LAS,Los Angeles Sparks,10.5,-110,1022200038,57,36,93,-21,home,0,0,0,0,0,0,0,away,36,21
5/23/2022,662,LVLas Vegas,104,171,-110,LVA,Las Vegas Aces,-10.5,-110,1022200038,57,36,93,-21,home,1,1,1,1,1,1,1,home,57,-21
5/25/2022,611,PPhoenix,94,164,-115,PHO,Phoenix Mercury,2.5,-110,1022200043,56,45,101,-11,home,1,1,1,0,0,0,0,away,45,11
5/25/2022,612,LALos Angeles,99,164,-105,LAS,Los Angeles Sparks,-2.5,-110,1022200043,56,45,101,-11,home,0,0,0,1,1,1,1,home,56,-11
5/26/2022,615,DDallas,68,160.5,-110,DAL,Dallas Wings,8.5,-110,1022200044,47,35,82,-12,home,0,0,0,0,0,0,0,away,35,12
5/26/2022,616,CConnecticut,99,160.5,-110,CON,Connecticut Sun,-8.5,-110,1022200044,47,35,82,-12,home,1,1,1,1,1,1,1,home,47,-12
5/27/2022,621,LALos Angeles,96,168,-110,LAS,Los Angeles Sparks,-6,-115,1022200045,55,47,102,-8,home,0,1,0,0,0,0,0,away,47,8
5/27/2022,622,IIndiana,101,168,-110,IND,Indiana Fever,6,-105,1022200045,55,47,102,-8,home,1,0,1,1,1,1,1,home,55,-8
5/27/2022,623,NYNew York,71,156,-110,NYL,New York Liberty,8.5,-110,1022200046,34,24,58,-10,home,1,0,0,0,0,0,0,away,24,10
5/27/2022,624,SSeattle,79,156,-110,SEA,Seattle Storm,-8.5,-110,1022200046,34,24,58,-10,home,0,1,1,1,1,1,1,home,34,-10
5/28/2022,631,LVLas Vegas,83,172.5,-110,LVA,Las Vegas Aces,-1,-110,1022200047,38,51,89,13,away,1,1,1,1,1,1,1,away,51,-13
5/28/2022,632,CChicago,76,172.5,-110,CHI,Chicago Sky,1,-110,1022200047,38,51,89,13,away,0,0,0,0,0,0,0,home,38,13
5/28/2022,633,WWashington,71,154,-115,WAS,Washington Mystics,10,-115,1022200048,41,37,78,-4,home,1,0,1,0,0,0,0,away,37,4
5/28/2022,634,CConnecticut,79,154,-105,CON,Connecticut Sun,-10,-105,1022200048,41,37,78,-4,home,0,1,0,1,1,1,1,home,41,-4
5/29/2022,641,PPhoenix,54,162.5,-105,PHO,Phoenix Mercury,-1.5,-110,1022200049,50,23,73,-27,home,1,0,0,0,0,0,0,away,23,27
5/29/2022,642,AAtlanta,81,162.5,-115,ATL,Atlanta Dream,1.5,-110,1022200049,50,23,73,-27,home,0,1,1,1,1,1,1,home,50,-27
5/29/2022,643,NYNew York,61,152,-110,NYL,New York Liberty,7.5,-110,1022200050,49,23,72,-26,home,0,0,0,0,0,0,0,away,23,26
5/29/2022,644,SSeattle,92,152,-110,SEA,Seattle Storm,-7.5,-110,1022200050,49,23,72,-26,home,1,1,1,1,1,1,1,home,49,-26
5/29/2022,645,LALos Angeles,85,169,-105,LAS,Los Angeles Sparks,2,-110,1022200051,34,45,79,11,away,1,1,1,1,1,1,1,away,45,-11
5/29/2022,646,MMinnesota,83,169,-115,MIN,Minnesota Lynx,-2,-110,1022200051,34,45,79,11,away,0,0,0,0,0,0,0,home,34,11
5/31/2022,649,WWashington,87,165,-110,WAS,Washington Mystics,-7.5,-105,1022200052,46,38,84,-8,home,0,0,0,1,0,0,0,away,38,8
5/31/2022,650,IIndiana,75,165,-110,IND,Indiana Fever,7.5,-115,1022200052,46,38,84,-8,home,1,1,1,0,1,1,1,home,46,-8
5/31/2022,651,PPhoenix,70,166.5,-110,PHO,Phoenix Mercury,8.5,-110,1022200053,35,28,63,-7,home,0,0,0,0,0,0,0,away,28,7
5/31/2022,652,CChicago,73,166.5,-110,CHI,Chicago Sky,-8.5,-110,1022200053,35,28,63,-7,home,1,1,1,1,1,1,1,home,35,-7
5/31/2022,653,CConnecticut,81,167.5,-110,CON,Connecticut Sun,3.5,-110,1022200054,50,42,92,-8,home,0,1,0,0,0,0,0,away,42,8
5/31/2022,654,LVLas Vegas,89,167.5,-110,LVA,Las Vegas Aces,-3.5,-110,1022200054,50,42,92,-8,home,1,0,1,1,1,1,1,home,50,-8
5/31/2022,655,DDallas,91,169.5,-110,DAL,Dallas Wings,-1.5,-110,1022200055,52,40,92,-12,home,0,0,0,0,0,0,0,away,40,12
5/31/2022,656,LALos Angeles,93,169.5,-110,LAS,Los Angeles Sparks,1.5,-110,1022200055,52,40,92,-12,home,1,1,1,1,1,1,1,home,52,-12
6/1/2022,663,MMinnesota,76,157,-110,MIN,Minnesota Lynx,4.5,-110,1022200056,43,37,80,-6,home,0,0,0,0,0,0,0,away,37,6
6/1/2022,664,AAtlanta,84,157,-110,ATL,Atlanta Dream,-4.5,-110,1022200056,43,37,80,-6,home,1,1,1,1,1,1,1,home,43,-6
6/1/2022,661,IIndiana,74,163,-110,IND,Indiana Fever,4.5,-110,1022200057,40,47,87,7,away,0,0,0,0,0,0,1,away,47,-7
6/1/2022,662,NYNew York,87,163,-110,NYL,New York Liberty,-4.5,-110,1022200057,40,47,87,7,away,1,1,1,1,1,1,0,home,40,7
6/2/2022,601,CConnecticut,97,169,-110,CON,Connecticut Sun,5,-110,1022200058,50,53,103,3,away,1,1,1,1,1,1,1,away,53,-3
6/2/2022,602,LVLas Vegas,90,169,-110,LVA,Las Vegas Aces,-5,-110,1022200058,50,53,103,3,away,0,0,0,0,0,0,0,home,50,3
6/3/2022,603,NYNew York,74,154,-110,NYL,New York Liberty,12,-110,1022200059,28,30,58,2,away,1,1,1,0,1,1,1,away,30,-2
6/3/2022,604,WWashington,70,154,-110,WAS,Washington Mystics,-12,-110,1022200059,28,30,58,2,away,0,0,0,1,0,0,0,home,28,2
6/3/2022,605,CChicago,73,156,-110,CHI,Chicago Sky,-4.5,-114,1022200060,31,39,70,8,away,1,1,1,1,1,1,1,away,39,-8
6/3/2022,606,AAtlanta,65,156,-110,ATL,Atlanta Dream,4.5,-106,1022200060,31,39,70,8,away,0,0,0,0,0,0,0,home,31,8
6/3/2022,607,CConnecticut,92,163.5,-110,CON,Connecticut Sun,-7,-110,1022200061,45,42,87,-3,home,1,1,1,0,0,0,0,away,42,3
6/3/2022,608,PPhoenix,88,163.5,-110,PHO,Phoenix Mercury,7,-110,1022200061,45,42,87,-3,home,0,0,0,1,1,1,1,home,45,-3
6/3/2022,609,DDallas,68,159.5,-110,DAL,Dallas Wings,6,-110,1022200062,27,31,58,4,away,1,1,1,1,1,1,1,away,31,-4
6/3/2022,610,SSeattle,51,159.5,-110,SEA,Seattle Storm,-6,-110,1022200062,27,31,58,4,away,0,0,0,0,0,0,0,home,27,4
6/5/2022,611,MMinnesota,84,158,-110,MIN,Minnesota Lynx,1.5,111,1022200063,37,46,83,9,away,0,1,1,1,1,1,1,away,46,-9
6/5/2022,612,NYNew York,77,158,-110,NYL,New York Liberty,-1.5,-131,1022200063,37,46,83,9,away,1,0,0,0,0,0,0,home,37,9
6/5/2022,613,IIndiana,66,159,-110,IND,Indiana Fever,7,-115,1022200064,29,26,55,-3,home,0,0,0,0,0,0,0,away,26,3
6/5/2022,614,AAtlanta,75,159,-110,ATL,Atlanta Dream,-7,-105,1022200064,29,26,55,-3,home,1,1,1,1,1,1,1,home,29,-3
6/5/2022,615,CConnecticut,93,154.5,-110,CON,Connecticut Sun,4,-107,1022200068,43,42,85,-1,home,0,0,0,0,0,0,0,away,42,1
6/5/2022,616,SSeattle,86,154.5,-110,SEA,Seattle Storm,-4,-113,1022200068,43,42,85,-1,home,1,1,1,1,1,1,1,home,43,-1
6/5/2022,619,LALos Angeles,74,171,-110,LAS,Los Angeles Sparks,-3,-110,1022200067,43,40,83,-3,home,0,0,0,0,0,0,0,away,40,3
6/5/2022,620,PPhoenix,81,171,-110,PHO,Phoenix Mercury,3,-110,1022200067,43,40,83,-3,home,1,1,1,1,1,1,1,home,43,-3
6/5/2022,621,WWashington,82,154,-110,WAS,Washington Mystics,5.5,-109,1022200065,36,34,70,-2,home,0,0,0,0,0,0,0,away,34,2
6/5/2022,622,CChicago,91,154,-110,CHI,Chicago Sky,-5.5,-111,1022200065,36,34,70,-2,home,1,1,1,1,1,1,1,home,36,-2
6/5/2022,617,DDallas,78,172.5,-110,DAL,Dallas Wings,7.5,-110,1022200066,40,38,78,-2,home,1,1,0,0,0,0,0,away,38,2
6/5/2022,618,LVLas Vegas,84,172.5,-110,LVA,Las Vegas Aces,-7.5,-110,1022200066,40,38,78,-2,home,0,0,1,1,1,1,1,home,40,-2
6/7/2022,623,MMinnesota,69,158.5,-110,MIN,Minnesota Lynx,2.5,-110,1022200069,45,37,82,-8,home,0,1,0,0,0,0,0,away,37,8
6/7/2022,624,NYNew York,88,158.5,-110,NYL,New York Liberty,-2.5,-110,1022200069,45,37,82,-8,home,1,0,1,1,1,1,1,home,45,-8
6/7/2022,625,AAtlanta,60,149.5,-110,ATL,Atlanta Dream,8.5,-113,1022200070,34,33,67,-1,home,0,0,0,0,0,0,0,away,33,1
6/7/2022,626,SSeattle,72,149.5,-110,SEA,Seattle Storm,-8.5,-107,1022200070,34,33,67,-1,home,1,1,1,1,1,1,1,home,34,-1
6/8/2022,627,IIndiana,69,167,-120,IND,Indiana Fever,15.5,-115,1022200071,48,37,85,-11,home,0,0,0,0,0,0,0,away,37,11
6/8/2022,628,CConnecticut,88,167,100,CON,Connecticut Sun,-15.5,-105,1022200071,48,37,85,-11,home,1,1,1,1,1,1,1,home,48,-11
6/8/2022,629,CChicago,82,156,-105,CHI,Chicago Sky,3.5,-110,1022200072,45,40,85,-5,home,0,0,0,0,1,1,0,away,40,5
6/8/2022,630,WWashington,84,156,-115,WAS,Washington Mystics,-3.5,-110,1022200072,45,40,85,-5,home,1,1,1,1,0,0,1,home,45,-5
6/10/2022,635,NYNew York,97,160.5,-105,NYL,New York Liberty,-1.5,-110,1022200074,43,38,81,-5,home,0,0,0,0,0,0,0,away,38,5
6/10/2022,636,IIndiana,83,160.5,-115,IND,Indiana Fever,1.5,-110,1022200074,43,38,81,-5,home,1,1,1,1,1,1,1,home,43,-5
6/10/2022,637,CChicago,83,163,-110,CHI,Chicago Sky,6,-110,1022200073,44,45,89,1,away,1,1,1,0,1,0,1,away,45,-1
6/10/2022,638,CConnecticut,79,163,-110,CON,Connecticut Sun,-6,-110,1022200073,44,45,89,1,away,0,0,0,1,0,1,0,home,44,1
6/10/2022,639,WWashington,76,158,-110,WAS,Washington Mystics,-8,-110,1022200076,28,39,67,11,away,1,1,1,1,1,1,1,away,39,-11
6/10/2022,640,MMinnesota,59,158,-110,MIN,Minnesota Lynx,8,-110,1022200076,28,39,67,11,away,0,0,0,0,0,0,0,home,28,11
6/10/2022,641,SSeattle,89,153.5,-110,SEA,Seattle Storm,-5.5,-110,1022200075,41,42,83,1,away,1,1,1,1,1,1,1,away,42,-1
6/10/2022,642,DDallas,88,153.5,-110,DAL,Dallas Wings,5.5,-110,1022200075,41,42,83,1,away,0,0,0,0,0,0,0,home,41,1
6/10/2022,643,AAtlanta,88,154,-115,ATL,Atlanta Dream,4,-115,1022200077,38,36,74,-2,home,0,0,0,0,0,0,0,away,36,2
6/10/2022,644,PPhoenix,90,154,-105,PHO,Phoenix Mercury,-4,-105,1022200077,38,36,74,-2,home,1,1,1,1,1,1,1,home,38,-2
6/11/2022,645,LVLas Vegas,89,177,-110,LVA,Las Vegas Aces,-6.5,-110,1022200078,35,52,87,17,away,1,0,1,1,1,1,1,away,52,-17
6/11/2022,646,LALos Angeles,72,177,-110,LAS,Los Angeles Sparks,6.5,-110,1022200078,35,52,87,17,away,0,1,0,0,0,0,0,home,35,17
6/12/2022,651,CChicago,88,159,-110,CHI,Chicago Sky,-7,-110,1022200079,45,44,89,-1,home,0,0,0,0,0,0,0,away,44,1
6/12/2022,652,NYNew York,86,159,-110,NYL,New York Liberty,7,-110,1022200079,45,44,89,-1,home,1,1,1,1,1,1,1,home,45,-1
6/12/2022,653,SSeattle,84,157,-110,SEA,Seattle Storm,-3.5,-110,1022200080,38,39,77,1,away,0,0,0,0,0,0,1,away,39,-1
6/12/2022,654,DDallas,79,157,-110,DAL,Dallas Wings,3.5,-110,1022200080,38,39,77,1,away,1,1,1,1,1,1,0,home,38,1
6/12/2022,655,PPhoenix,99,160.5,-110,PHO,Phoenix Mercury,6,-110,1022200081,39,38,77,-1,home,0,1,1,1,0,1,0,away,38,1
6/12/2022,656,WWashington,90,160.5,-110,WAS,Washington Mystics,-6,-110,1022200081,39,38,77,-1,home,1,0,0,0,1,0,1,home,39,-1
6/12/2022,657,IIndiana,84,166,-110,IND,Indiana Fever,2,-110,1022200082,36,43,79,7,away,1,0,1,0,1,1,1,away,43,-7
6/12/2022,658,MMinnesota,80,166,-110,MIN,Minnesota Lynx,-2,-110,1022200082,36,43,79,7,away,0,1,0,1,0,0,0,home,36,7
6/14/2022,601,PPhoenix,65,161,-110,PHO,Phoenix Mercury,8.5,-110,1022200083,44,34,78,-10,home,0,1,0,0,0,0,0,away,34,10
6/14/2022,602,WWashington,83,161,-110,WAS,Washington Mystics,-8.5,-110,1022200083,44,34,78,-10,home,1,0,1,1,1,1,1,home,44,-10
6/14/2022,603,SSeattle,81,156.5,-115,SEA,Seattle Storm,-8,-110,1022200084,46,39,85,-7,home,1,0,0,0,0,0,0,away,39,7
6/14/2022,604,MMinnesota,79,156.5,-105,MIN,Minnesota Lynx,8,-110,1022200084,46,39,85,-7,home,0,1,1,1,1,1,1,home,46,-7
6/15/2022,605,LVLas Vegas,92,174.5,-110,LVA,Las Vegas Aces,-9,-110,1022200085,44,35,79,-9,home,0,0,0,0,0,0,0,away,35,9
6/15/2022,606,DDallas,84,174.5,-110,DAL,Dallas Wings,9,-110,1022200085,44,35,79,-9,home,1,1,1,1,1,1,1,home,44,-9
6/15/2022,609,AAtlanta,92,157.5,-110,ATL,Atlanta Dream,10,-105,1022200086,58,41,99,-17,home,1,0,0,0,0,0,0,away,41,17
6/15/2022,610,CConnecticut,105,157.5,-110,CON,Connecticut Sun,-10,-115,1022200086,58,41,99,-17,home,0,1,1,1,1,1,1,home,58,-17
6/15/2022,607,PPhoenix,93,169.5,-110,PHO,Phoenix Mercury,1,-110,1022200087,36,53,89,17,away,1,1,1,1,1,1,1,away,53,-17
6/15/2022,608,IIndiana,80,169.5,-110,IND,Indiana Fever,-1,-110,1022200087,36,53,89,17,away,0,0,0,0,0,0,0,home,36,17
6/16/2022,611,WWashington,65,157.5,-110,WAS,Washington Mystics,-4,-110,1022200088,40,35,75,-5,home,0,0,1,1,1,1,0,away,35,5
6/16/2022,612,NYNew York,77,157.5,-110,NYL,New York Liberty,4,-110,1022200088,40,35,75,-5,home,1,1,0,0,0,0,1,home,40,-5
6/19/2022,619,SSeattle,81,158.5,-110,SEA,Seattle Storm,-3,-110,1022200092,37,39,76,2,away,1,1,1,1,1,0,1,away,39,-2
6/19/2022,620,NYNew York,72,158.5,-110,NYL,New York Liberty,3,-110,1022200092,37,39,76,2,away,0,0,0,0,0,1,0,home,37,2
6/19/2022,621,CConnecticut,63,159.5,-110,CON,Connecticut Sun,-3.5,-110,1022200094,43,27,70,-16,home,0,0,0,0,0,0,0,away,27,16
6/19/2022,622,WWashington,71,159.5,-110,WAS,Washington Mystics,3.5,-110,1022200094,43,27,70,-16,home,1,1,1,1,1,1,1,home,43,-16
6/19/2022,623,CChicago,87,171.5,-110,CHI,Chicago Sky,-8,-110,1022200093,37,50,87,13,away,1,0,1,1,0,1,1,away,50,-13
6/19/2022,624,IIndiana,89,171.5,-110,IND,Indiana Fever,8,-110,1022200093,37,50,87,13,away,0,1,0,0,1,0,0,home,37,13
6/19/2022,625,LALos Angeles,82,169,-110,LAS,Los Angeles Sparks,4,-110,1022200095,50,45,95,-5,home,0,0,0,0,1,1,1,away,45,5
6/19/2022,626,DDallas,92,169,-110,DAL,Dallas Wings,-4,-110,1022200095,50,45,95,-5,home,1,1,1,1,0,0,0,home,50,-5
6/19/2022,627,MMinnesota,95,172,-110,MIN,Minnesota Lynx,15,-110,1022200096,39,50,89,11,away,1,1,1,1,1,1,1,away,50,-11
6/19/2022,628,LVLas Vegas,96,172,-110,LVA,Las Vegas Aces,-15,-110,1022200096,39,50,89,11,away,0,0,0,0,0,0,0,home,39,11
6/21/2022,631,DDallas,75,163.5,-110,DAL,Dallas Wings,-4,-105,1022200097,51,40,91,-11,home,0,0,0,0,0,0,0,away,40,11
6/21/2022,632,AAtlanta,80,163.5,-110,ATL,Atlanta Dream,4,-115,1022200097,51,40,91,-11,home,1,1,1,1,1,1,1,home,51,-11
6/21/2022,633,MMinnesota,84,169,-110,MIN,Minnesota Lynx,6,-115,1022200099,40,36,76,-4,home,0,0,0,0,0,0,0,away,36,4
6/21/2022,634,PPhoenix,71,169,-110,PHO,Phoenix Mercury,-6,-105,1022200099,40,36,76,-4,home,1,1,1,1,1,1,1,home,40,-4
6/21/2022,635,CChicago,104,176.5,-110,CHI,Chicago Sky,8,-110,1022200098,62,51,113,-11,home,0,0,0,0,0,0,0,away,51,11
6/21/2022,636,LVLas Vegas,95,176.5,-110,LVA,Las Vegas Aces,-8,-110,1022200098,62,51,113,-11,home,1,1,1,1,1,1,1,home,62,-11
6/21/2022,637,WWashington,82,161,-110,WAS,Washington Mystics,-2.5,-110,1022200100,35,31,66,-4,home,1,0,0,0,0,0,0,away,31,4
6/21/2022,638,LALos Angeles,84,161,-110,LAS,Los Angeles Sparks,2.5,-110,1022200100,35,31,66,-4,home,0,1,1,1,1,1,1,home,35,-4
6/22/2022,639,NYNew York,81,163.5,-110,NYL,New York Liberty,10.5,-110,1022200101,42,51,93,9,away,1,1,1,1,1,1,1,away,51,-9
6/22/2022,640,CConnecticut,77,163.5,-110,CON,Connecticut Sun,-10.5,-110,1022200101,42,51,93,9,away,0,0,0,0,0,0,0,home,42,9
6/23/2022,641,IIndiana,68,170.5,-110,IND,Indiana Fever,9,-110,1022200102,55,38,93,-17,home,0,0,0,0,0,0,0,away,38,17
6/23/2022,642,DDallas,94,170.5,-110,DAL,Dallas Wings,-9,-110,1022200102,55,38,93,-17,home,1,1,1,1,1,1,1,home,55,-17
6/23/2022,643,PPhoenix,88,166.5,-110,PHO,Phoenix Mercury,2.5,-110,1022200103,60,48,108,-12,home,1,1,1,1,0,0,0,away,48,12
6/23/2022,644,MMinnesota,100,166.5,-110,MIN,Minnesota Lynx,-2.5,-110,1022200103,60,48,108,-12,home,0,0,0,0,1,1,1,home,60,-12
6/23/2022,645,WWashington,71,154.5,-110,WAS,Washington Mystics,4.5,-110,1022200104,46,37,83,-9,home,0,1,0,0,0,0,0,away,37,9
6/23/2022,646,SSeattle,85,154.5,-110,SEA,Seattle Storm,-4.5,-110,1022200104,46,37,83,-9,home,1,0,1,1,1,1,1,home,46,-9
6/23/2022,647,CChicago,82,173,-110,CHI,Chicago Sky,-4.5,-110,1022200105,25,54,79,29,away,1,1,1,1,1,1,1,away,54,-29
6/23/2022,648,LALos Angeles,59,173,-110,LAS,Los Angeles Sparks,4.5,-110,1022200105,25,54,79,29,away,0,0,0,0,0,0,0,home,25,29
6/24/2022,649,NYNew York,89,159,-110,NYL,New York Liberty,1,-110,1022200106,43,53,96,10,away,1,1,1,1,1,1,1,away,53,-10
6/24/2022,650,AAtlanta,77,159,-110,ATL,Atlanta Dream,-1,-110,1022200106,43,53,96,10,away,0,0,0,0,0,0,0,home,43,10
6/25/2022,651,PPhoenix,83,168.5,-110,PHO,Phoenix Mercury,6.5,-105,1022200107,45,44,89,-1,home,0,0,0,0,0,0,0,away,44,1
6/25/2022,652,DDallas,72,168.5,-110,DAL,Dallas Wings,-6.5,-115,1022200107,45,44,89,-1,home,1,1,1,1,1,1,1,home,45,-1
6/25/2022,653,LALos Angeles,85,160,-110,LAS,Los Angeles Sparks,7,-115,1022200108,43,49,92,6,away,0,0,0,0,1,1,1,away,49,-6
6/25/2022,654,SSeattle,77,160,-110,SEA,Seattle Storm,-7,-105,1022200108,43,49,92,6,away,1,1,1,1,0,0,0,home,43,6
6/25/2022,655,WWashington,87,167,-110,WAS,Washington Mystics,9,-110,1022200109,40,46,86,6,away,1,1,1,0,1,1,1,away,46,-6
6/25/2022,656,LVLas Vegas,86,167,-110,LVA,Las Vegas Aces,-9,-110,1022200109,40,46,86,6,away,0,0,0,1,0,0,0,home,40,6
6/26/2022,661,CConnecticut,72,163.5,-110,CON,Connecticut Sun,-8,-110,1022200110,22,39,61,17,away,1,0,1,1,1,1,1,away,39,-17
6/26/2022,662,AAtlanta,61,163.5,-110,ATL,Atlanta Dream,8,-110,1022200110,22,39,61,17,away,0,1,0,0,0,0,0,home,22,17
6/26/2022,663,MMinnesota,85,170.5,-105,MIN,Minnesota Lynx,5.5,-110,1022200111,46,44,90,-2,home,0,0,1,1,1,1,1,away,44,2
6/26/2022,664,CChicago,88,170.5,-115,CHI,Chicago Sky,-5.5,-110,1022200111,46,44,90,-2,home,1,1,0,0,0,0,0,home,46,-2
6/27/2022,601,IIndiana,71,169.5,-110,IND,Indiana Fever,7,-110,1022200112,45,41,86,-4,home,0,0,0,0,1,1,1,away,41,4
6/27/2022,602,PPhoenix,83,169.5,-110,PHO,Phoenix Mercury,-7,-110,1022200112,45,41,86,-4,home,1,1,1,1,0,0,0,home,45,-4
6/27/2022,603,LVLas Vegas,79,176,-110,LVA,Las Vegas Aces,-8.5,-105,1022200113,36,40,76,4,away,0,0,0,0,0,1,1,away,40,-4
6/27/2022,604,LALos Angeles,73,176,-110,LAS,Los Angeles Sparks,8.5,-115,1022200113,36,40,76,4,away,1,1,1,1,1,0,0,home,36,4
6/28/2022,607,AAtlanta,74,153.5,-113,ATL,Atlanta Dream,7.5,-110,1022200114,52,32,84,-20,home,0,0,0,0,0,0,0,away,32,20
6/28/2022,608,WWashington,92,153.5,-107,WAS,Washington Mystics,-7.5,-110,1022200114,52,32,84,-20,home,1,1,1,1,1,1,1,home,52,-20
6/28/2022,605,DDallas,64,165,-110,DAL,Dallas Wings,3,-110,1022200115,50,24,74,-26,home,0,0,0,0,0,0,0,away,24,26
6/28/2022,606,MMinnesota,92,165,-110,MIN,Minnesota Lynx,-3,-110,1022200115,50,24,74,-26,home,1,1,1,1,1,1,1,home,50,-26
6/29/2022,609,CConnecticut,83,165,-110,CON,Connecticut Sun,2,-110,1022200116,55,33,88,-22,home,0,0,0,0,0,0,0,away,33,22
6/29/2022,610,CChicago,91,165,-110,CHI,Chicago Sky,-2,-110,1022200116,55,33,88,-22,home,1,1,1,1,1,1,1,home,55,-22
6/29/2022,611,IIndiana,78,166,-110,IND,Indiana Fever,7,-110,1022200117,49,43,92,-6,home,0,0,0,1,1,1,1,away,43,6
6/29/2022,612,PPhoenix,99,166,-110,PHO,Phoenix Mercury,-7,-110,1022200117,49,43,92,-6,home,1,1,1,0,0,0,0,home,49,-6
6/29/2022,613,LVLas Vegas,78,166,-110,LVA,Las Vegas Aces,-1,-110,1022200118,44,47,91,3,away,1,0,1,1,1,1,1,away,47,-3
6/29/2022,614,SSeattle,88,166,-110,SEA,Seattle Storm,1,-110,1022200118,44,47,91,3,away,0,1,0,0,0,0,0,home,44,3
6/30/2022,615,AAtlanta,92,159.5,-107,ATL,Atlanta Dream,5.5,-110,1022200119,36,41,77,5,away,0,0,0,1,1,1,1,away,41,-5
6/30/2022,616,NYNew York,81,159.5,-113,NYL,New York Liberty,-5.5,-110,1022200119,36,41,77,5,away,1,1,1,0,0,0,0,home,36,5
7/1/2022,619,LVLas Vegas,91,175.5,-110,LVA,Las Vegas Aces,-4.5,-110,1022200121,33,46,79,13,away,1,1,1,1,1,1,1,away,46,-13
7/1/2022,620,MMinnesota,85,175.5,-110,MIN,Minnesota Lynx,4.5,-110,1022200121,33,46,79,13,away,0,0,0,0,0,0,0,home,33,13
7/1/2022,617,LALos Angeles,97,167,-110,LAS,Los Angeles Sparks,5,-110,1022200120,49,46,95,-3,home,1,1,0,0,0,0,0,away,46,3
7/1/2022,618,DDallas,89,167,-110,DAL,Dallas Wings,-5,-110,1022200120,49,46,95,-3,home,0,0,1,1,1,1,1,home,49,-3
7/1/2022,621,IIndiana,57,162,-110,IND,Indiana Fever,13,-110,1022200122,46,27,73,-19,home,0,0,0,0,0,0,0,away,27,19
7/1/2022,622,SSeattle,73,162,-110,SEA,Seattle Storm,-13,-110,1022200122,46,27,73,-19,home,1,1,1,1,1,1,1,home,46,-19
7/2/2022,623,PPhoenix,75,168,-110,PHO,Phoenix Mercury,8.5,-110,1022200123,46,40,86,-6,home,0,0,0,0,0,0,0,away,40,6
7/2/2022,624,CChicago,91,168,-110,CHI,Chicago Sky,-8.5,-110,1022200123,46,40,86,-6,home,1,1,1,1,1,1,1,home,46,-6
7/3/2022,625,WWashington,72,157.5,-110,WAS,Washington Mystics,8,-115,1022200124,34,49,83,15,away,1,1,1,1,1,1,1,away,49,-15
7/3/2022,626,CConnecticut,74,157.5,-110,CON,Connecticut Sun,-8,-105,1022200124,34,49,83,15,away,0,0,0,0,0,0,0,home,34,15
7/3/2022,627,SSeattle,76,155,-105,SEA,Seattle Storm,-5.5,-110,1022200125,46,41,87,-5,home,0,0,0,0,0,0,0,away,41,5
7/3/2022,628,AAtlanta,90,155,-115,ATL,Atlanta Dream,5.5,-110,1022200125,46,41,87,-5,home,1,1,1,1,1,1,1,home,46,-5
7/3/2022,629,NYNew York,74,164.5,-110,NYL,New York Liberty,4,-115,1022200127,40,43,83,3,away,0,0,0,0,0,0,1,away,43,-3
7/3/2022,630,LALos Angeles,84,164.5,-110,LAS,Los Angeles Sparks,-4,-105,1022200127,40,43,83,3,away,1,1,1,1,1,1,0,home,40,3
7/3/2022,631,LVLas Vegas,71,173.5,-110,LVA,Las Vegas Aces,-5,-110,1022200126,49,35,84,-14,home,0,0,0,0,0,0,0,away,35,14
7/3/2022,632,MMinnesota,102,173.5,-110,MIN,Minnesota Lynx,5,-110,1022200126,49,35,84,-14,home,1,1,1,1,1,1,1,home,49,-14
7/4/2022,633,PPhoenix,75,167,-105,PHO,Phoenix Mercury,-1,-109,1022200128,42,40,82,-2,home,1,0,1,0,0,0,0,away,40,2
7/4/2022,634,LALos Angeles,78,167,-115,LAS,Los Angeles Sparks,1,-111,1022200128,42,40,82,-2,home,0,1,0,1,1,1,1,home,42,-2
7/5/2022,635,SSeattle,95,159.5,-110,SEA,Seattle Storm,-11,-110,1022200129,35,44,79,9,away,0,1,1,0,0,1,1,away,44,-9
7/5/2022,636,IIndiana,73,159.5,-110,IND,Indiana Fever,11,-110,1022200129,35,44,79,9,away,1,0,0,1,1,0,0,home,35,9
7/5/2022,637,CConnecticut,71,162.5,-110,CON,Connecticut Sun,-5,-105,1022200130,41,38,79,-3,home,0,0,0,0,0,0,0,away,38,3
7/5/2022,638,DDallas,82,162.5,-110,DAL,Dallas Wings,5,-115,1022200130,41,38,79,-3,home,1,1,1,1,1,1,1,home,41,-3
7/6/2022,639,CChicago,78,167.5,-110,CHI,Chicago Sky,-1.5,-110,1022200131,42,39,81,-3,home,0,0,0,0,0,0,0,away,39,3
7/6/2022,640,MMinnesota,81,167.5,-110,MIN,Minnesota Lynx,1.5,-110,1022200131,42,39,81,-3,home,1,1,1,1,1,1,1,home,42,-3
7/6/2022,641,WWashington,85,157,-110,WAS,Washington Mystics,-5,-110,1022200132,36,41,77,5,away,0,1,0,0,0,0,1,away,41,-5
7/6/2022,642,AAtlanta,66,157,-110,ATL,Atlanta Dream,5,-110,1022200132,36,41,77,5,away,1,0,1,1,1,1,0,home,36,5
7/6/2022,643,NYNew York,116,168.5,-110,NYL,New York Liberty,11.5,-115,1022200133,63,55,118,-8,home,1,1,1,1,1,0,0,away,55,8
7/6/2022,644,LVLas Vegas,107,168.5,-110,LVA,Las Vegas Aces,-11.5,-105,1022200133,63,55,118,-8,home,0,0,0,0,0,1,1,home,63,-8
7/12/2022,601,DDallas,74,160,-110,DAL,Dallas Wings,9.5,-110,1022200137,39,41,80,2,away,0,0,0,0,1,1,1,away,41,-2
7/12/2022,602,SSeattle,83,160,-110,SEA,Seattle Storm,-9.5,-110,1022200137,39,41,80,2,away,1,1,1,1,0,0,0,home,39,2
7/12/2022,603,LVLas Vegas,107,174,-110,LVA,Las Vegas Aces,-6.5,-110,1022200138,28,52,80,24,away,1,1,1,1,1,1,1,away,52,-24
7/12/2022,604,NYNew York,101,174,-110,NYL,New York Liberty,6.5,-110,1022200138,28,52,80,24,away,0,0,0,0,0,0,0,home,28,24
7/12/2022,607,PPhoenix,107,165,-110,PHO,Phoenix Mercury,7.5,-110,1022200140,47,45,92,-2,home,1,0,1,0,0,0,0,away,45,2
7/12/2022,608,MMinnesota,118,165,-110,MIN,Minnesota Lynx,-7.5,-110,1022200140,47,45,92,-2,home,0,1,0,1,1,1,1,home,47,-2
7/12/2022,605,AAtlanta,75,163.5,-110,ATL,Atlanta Dream,9,-110,1022200139,44,47,91,3,away,0,0,0,0,1,1,1,away,47,-3
7/12/2022,606,CChicago,90,163.5,-110,CHI,Chicago Sky,-9,-110,1022200139,44,47,91,3,away,1,1,1,1,0,0,0,home,44,3
7/12/2022,609,WWashington,94,158,-110,WAS,Washington Mystics,-6.5,-110,1022200141,44,53,97,9,away,1,1,1,1,1,1,1,away,53,-9
7/12/2022,610,LALos Angeles,81,158,-110,LAS,Los Angeles Sparks,6.5,-110,1022200141,44,53,97,9,away,0,0,0,0,0,0,0,home,44,9
7/13/2022,611,CConnecticut,89,161.5,-110,CON,Connecticut Sun,-10,-105,1022200142,28,41,69,13,away,1,1,1,1,1,1,1,away,41,-13
7/13/2022,612,IIndiana,81,161.5,-110,IND,Indiana Fever,10,-115,1022200142,28,41,69,13,away,0,0,0,0,0,0,0,home,28,13
7/16/2022,625,CChicago,89,169,-110,CHI,Chicago Sky,-4.5,-110,1022200149,42,41,83,-1,home,0,1,1,1,0,0,0,away,41,1
7/16/2022,626,DDallas,81,169,-110,DAL,Dallas Wings,4.5,-110,1022200149,42,41,83,-1,home,1,0,0,0,1,1,1,home,42,-1
7/17/2022,627,LVLas Vegas,91,174.5,-110,LVA,Las Vegas Aces,-4,-110,1022200150,37,35,72,-2,home,0,0,0,0,0,0,1,away,35,2
7/17/2022,628,CConnecticut,83,174.5,-110,CON,Connecticut Sun,4,-110,1022200150,37,35,72,-2,home,1,1,1,1,1,1,0,home,37,-2
7/17/2022,629,MMinnesota,57,161.5,-110,MIN,Minnesota Lynx,5,-110,1022200151,37,28,65,-9,home,1,1,0,0,0,0,0,away,28,9
7/17/2022,630,WWashington,70,161.5,-110,WAS,Washington Mystics,-5,-110,1022200151,37,28,65,-9,home,0,0,1,1,1,1,1,home,37,-9
7/17/2022,633,IIndiana,65,162.5,-110,IND,Indiana Fever,14,-110,1022200153,42,31,73,-11,home,1,0,0,0,0,0,0,away,31,11
7/17/2022,634,SSeattle,81,162.5,-110,SEA,Seattle Storm,-14,-110,1022200153,42,31,73,-11,home,0,1,1,1,1,1,1,home,42,-11
7/17/2022,631,AAtlanta,85,162.5,-110,ATL,Atlanta Dream,6,-110,1022200152,41,41,82,0,tie,1,1,1,1,1,1,1,away,41,-0
7/17/2022,632,PPhoenix,75,162.5,-110,PHO,Phoenix Mercury,-6,-110,1022200152,41,41,82,0,tie,0,0,0,0,0,0,0,home,41,0
7/20/2022,641,SSeattle,74,159,-105,SEA,Seattle Storm,2.5,-110,1022200157,35,31,66,-4,home,1,0,0,0,0,0,0,away,31,4
7/20/2022,642,CChicago,78,159,-115,CHI,Chicago Sky,-2.5,-110,1022200157,35,31,66,-4,home,0,1,1,1,1,1,1,home,35,-4
7/21/2022,643,NYNew York,69,156.5,-110,NYL,New York Liberty,8,-110,1022200158,40,37,77,-3,home,1,1,1,1,1,0,0,away,37,3
7/21/2022,644,WWashington,78,156.5,-110,WAS,Washington Mystics,-8,-110,1022200158,40,37,77,-3,home,0,0,0,0,0,1,1,home,40,-3
7/21/2022,645,AAtlanta,78,161.5,-110,ATL,Atlanta Dream,2.5,-110,1022200159,52,42,94,-10,home,0,0,0,0,0,0,0,away,42,10
7/21/2022,646,LALos Angeles,85,161.5,-110,LAS,Los Angeles Sparks,-2.5,-110,1022200159,52,42,94,-10,home,1,1,1,1,1,1,1,home,52,-10
7/21/2022,647,IIndiana,77,176.5,-110,IND,Indiana Fever,17,-108,1022200160,52,32,84,-20,home,0,0,0,0,0,0,0,away,32,20
7/21/2022,648,LVLas Vegas,90,176.5,-110,LVA,Las Vegas Aces,-17,-112,1022200160,52,32,84,-20,home,1,1,1,1,1,1,1,home,52,-20
7/22/2022,649,CConnecticut,94,159.5,-110,CON,Connecticut Sun,2.5,-110,1022200161,38,51,89,13,away,1,1,1,1,1,1,1,away,51,-13
7/22/2022,650,MMinnesota,84,159.5,-110,MIN,Minnesota Lynx,-2.5,-110,1022200161,38,51,89,13,away,0,0,0,0,0,0,0,home,38,13
7/22/2022,651,DDallas,83,164.5,-110,DAL,Dallas Wings,7.5,-110,1022200162,50,39,89,-11,home,0,0,0,0,0,0,0,away,39,11
7/22/2022,652,CChicago,89,164.5,-110,CHI,Chicago Sky,-7.5,-113,1022200162,50,39,89,-11,home,1,1,1,1,1,1,1,home,50,-11
7/22/2022,653,SSeattle,78,160.5,-110,SEA,Seattle Storm,-6,-124,1022200163,42,42,84,0,tie,0,1,0,0,0,1,0,away,42,-0
7/22/2022,654,PPhoenix,94,160.5,-110,PHO,Phoenix Mercury,6,104,1022200163,42,42,84,0,tie,1,0,1,1,1,0,1,home,42,0
7/23/2022,655,CChicago,80,164,-110,CHI,Chicago Sky,-4,-112,1022200164,37,39,76,2,away,1,0,0,0,0,0,0,away,39,-2
7/23/2022,656,NYNew York,83,164,-110,NYL,New York Liberty,4,-108,1022200164,37,39,76,2,away,0,1,1,1,1,1,1,home,37,2
7/23/2022,657,LALos Angeles,66,173,-110,LAS,Los Angeles Sparks,9.5,-108,1022200165,39,39,78,0,tie,0,0,0,0,0,1,1,away,39,-0
7/23/2022,658,LVLas Vegas,84,173,-110,LVA,Las Vegas Aces,-9.5,-112,1022200165,39,39,78,0,tie,1,1,1,1,1,0,0,home,39,0
7/28/2022,613,SSeattle,83,159,-110,SEA,Seattle Storm,3.5,-110,1022200170,44,40,84,-4,home,1,1,1,1,1,1,1,away,40,4
7/28/2022,614,CConnecticut,88,159,-110,CON,Connecticut Sun,-3.5,-110,1022200170,44,40,84,-4,home,0,0,0,0,0,0,0,home,44,-4
7/28/2022,611,MMinnesota,92,160.5,-110,MIN,Minnesota Lynx,1,-110,1022200169,29,49,78,20,away,1,1,1,1,1,1,1,away,49,-20
7/28/2022,612,AAtlanta,85,160.5,-110,ATL,Atlanta Dream,-1,-110,1022200169,29,49,78,20,away,0,0,0,0,0,0,0,home,29,20
7/28/2022,615,WWashington,87,157.5,-110,WAS,Washington Mystics,1.5,-110,1022200171,36,56,92,20,away,1,1,1,1,1,1,1,away,56,-20
7/28/2022,616,DDallas,77,157.5,-110,DAL,Dallas Wings,-1.5,-110,1022200171,36,56,92,20,away,0,0,0,0,0,0,0,home,36,20
7/28/2022,617,LALos Angeles,80,167.5,-110,LAS,Los Angeles Sparks,5,-105,1022200172,54,32,86,-22,home,1,0,0,0,0,0,0,away,32,22
7/28/2022,618,PPhoenix,90,167.5,-110,PHO,Phoenix Mercury,-5,-115,1022200172,54,32,86,-22,home,0,1,1,1,1,1,1,home,54,-22
7/29/2022,619,LVLas Vegas,93,175.5,-110,LVA,Las Vegas Aces,-14,-110,1022200173,37,54,91,17,away,1,1,1,1,1,1,1,away,54,-17
7/29/2022,620,IIndiana,72,175.5,-110,IND,Indiana Fever,14,-110,1022200173,37,54,91,17,away,0,0,0,0,0,0,0,home,37,17
7/29/2022,621,NYNew York,81,166,-110,NYL,New York Liberty,8,-110,1022200174,44,46,90,2,away,1,0,1,1,1,1,1,away,46,-2
7/29/2022,622,CChicago,89,166,-110,CHI,Chicago Sky,-8,-110,1022200174,44,46,90,2,away,0,1,0,0,0,0,0,home,44,2
7/30/2022,623,SSeattle,82,156.5,-115,SEA,Seattle Storm,1.5,-108,1022200175,35,35,70,0,tie,0,0,0,0,0,0,0,away,35,-0
7/30/2022,624,WWashington,77,156.5,-105,WAS,Washington Mystics,-1.5,-112,1022200175,35,35,70,0,tie,1,1,1,1,1,1,1,home,35,0
7/30/2022,625,DDallas,81,164,-110,DAL,Dallas Wings,2,-110,1022200176,35,42,77,7,away,0,1,1,1,1,1,1,away,42,-7
7/30/2022,626,AAtlanta,68,164,-110,ATL,Atlanta Dream,-2,-110,1022200176,35,42,77,7,away,1,0,0,0,0,0,0,home,35,7
7/31/2022,627,CChicago,95,164,-115,CHI,Chicago Sky,4,-105,1022200177,44,45,89,1,away,1,1,1,1,1,1,1,away,45,-1
7/31/2022,628,CConnecticut,92,164,-105,CON,Connecticut Sun,-4,-115,1022200177,44,45,89,1,away,0,0,0,0,0,0,0,home,44,1
7/31/2022,629,PPhoenix,69,166.5,-110,PHO,Phoenix Mercury,-1.5,-110,1022200178,35,27,62,-8,home,0,0,0,0,0,0,0,away,27,8
7/31/2022,630,NYNew York,89,166.5,-110,NYL,New York Liberty,1.5,-110,1022200178,35,27,62,-8,home,1,1,1,1,1,1,1,home,35,-8
7/31/2022,633,SSeattle,75,156,-110,SEA,Seattle Storm,3,-110,1022200180,36,37,73,1,away,0,0,0,1,1,1,0,away,37,-1
7/31/2022,634,WWashington,78,156,-110,WAS,Washington Mystics,-3,-110,1022200180,36,37,73,1,away,1,1,1,0,0,0,1,home,36,1
7/31/2022,631,LVLas Vegas,94,173,-110,LVA,Las Vegas Aces,-17.5,-110,1022200179,31,43,74,12,away,1,1,1,1,1,1,1,away,43,-12
7/31/2022,632,IIndiana,69,173,-110,IND,Indiana Fever,17.5,-110,1022200179,31,43,74,12,away,0,0,0,0,0,0,0,home,31,12
7/31/2022,635,MMinnesota,84,167.5,-110,MIN,Minnesota Lynx,-3.5,-110,1022200181,43,52,95,9,away,1,1,1,1,1,1,1,away,52,-9
7/31/2022,636,LALos Angeles,77,167.5,-110,LAS,Los Angeles Sparks,3.5,-110,1022200181,43,52,95,9,away,0,0,0,0,0,0,0,home,43,9
8/2/2022,643,PPhoenix,63,167,-105,PHO,Phoenix Mercury,10,-105,1022200182,35,25,60,-10,home,1,0,0,0,0,0,0,away,25,10
8/2/2022,644,CConnecticut,87,167,-115,CON,Connecticut Sun,-10,-115,1022200182,35,25,60,-10,home,0,1,1,1,1,1,1,home,35,-10
8/2/2022,645,LVLas Vegas,73,165,-115,LVA,Las Vegas Aces,-3,-115,1022200184,39,41,80,2,away,0,1,1,1,0,1,1,away,41,-2
8/2/2022,646,WWashington,83,165,-105,WAS,Washington Mystics,3,-105,1022200184,39,41,80,2,away,1,0,0,0,1,0,0,home,39,2
8/2/2022,641,LALos Angeles,73,165.5,-110,LAS,Los Angeles Sparks,5.5,-110,1022200183,53,41,94,-12,home,1,1,1,0,0,0,0,away,41,12
8/2/2022,642,NYNew York,102,165.5,-110,NYL,New York Liberty,-5.5,-110,1022200183,53,41,94,-12,home,0,0,0,1,1,1,1,home,53,-12
8/2/2022,647,DDallas,84,165.5,-110,DAL,Dallas Wings,11,-110,1022200185,39,42,81,3,away,0,0,1,0,1,1,1,away,42,-3
8/2/2022,648,CChicago,78,165.5,-110,CHI,Chicago Sky,-11,-110,1022200185,39,42,81,3,away,1,1,0,1,0,0,0,home,39,3
8/3/2022,653,IIndiana,81,158,-110,IND,Indiana Fever,10,-110,1022200186,62,34,96,-28,home,0,0,0,0,0,0,0,away,34,28
8/3/2022,654,AAtlanta,91,158,-110,ATL,Atlanta Dream,-10,-110,1022200186,62,34,96,-28,home,1,1,1,1,1,1,1,home,62,-28
8/3/2022,651,LALos Angeles,61,162.5,-110,LAS,Los Angeles Sparks,7,-110,1022200187,28,39,67,11,away,1,1,1,1,1,1,1,away,39,-11
8/3/2022,652,NYNew York,64,162.5,-110,NYL,New York Liberty,-7,-110,1022200187,28,39,67,11,away,0,0,0,0,0,0,0,home,28,11
8/3/2022,655,MMinnesota,77,162,-110,MIN,Minnesota Lynx,6,-110,1022200188,56,32,88,-24,home,0,0,0,0,0,0,0,away,32,24
8/3/2022,656,SSeattle,89,162,-110,SEA,Seattle Storm,-6,-110,1022200188,56,32,88,-24,home,1,1,1,1,1,1,1,home,56,-24
8/4/2022,657,PPhoenix,64,163.5,-110,PHO,Phoenix Mercury,12.5,-110,1022200189,45,45,90,0,tie,1,0,0,1,1,1,1,away,45,-0
8/4/2022,658,CConnecticut,77,163.5,-110,CON,Connecticut Sun,-12.5,-110,1022200189,45,45,90,0,tie,0,1,1,0,0,0,0,home,45,0
8/4/2022,659,LVLas Vegas,80,171,-110,LVA,Las Vegas Aces,-8.5,-110,1022200190,42,35,77,-7,home,1,0,0,0,0,0,0,away,35,7
8/4/2022,660,DDallas,82,171,-110,DAL,Dallas Wings,8.5,-110,1022200190,42,35,77,-7,home,0,1,1,1,1,1,1,home,42,-7
8/5/2022,661,LALos Angeles,86,157.5,-110,LAS,Los Angeles Sparks,5.5,-110,1022200191,47,45,92,-2,home,0,0,0,0,0,0,0,away,45,2
8/5/2022,662,AAtlanta,88,157.5,-110,ATL,Atlanta Dream,-5.5,-110,1022200191,47,45,92,-2,home,1,1,1,1,1,1,1,home,47,-2
8/5/2022,663,WWashington,83,160.5,-110,WAS,Washington Mystics,6,-110,1022200192,55,34,89,-21,home,0,0,0,0,0,0,0,away,34,21
8/5/2022,664,CChicago,93,160.5,-110,CHI,Chicago Sky,-6,-110,1022200192,55,34,89,-21,home,1,1,1,1,1,1,1,home,55,-21
8/7/2022,605,CConnecticut,91,166.5,-110,CON,Connecticut Sun,4,-110,1022200195,50,46,96,-4,home,0,0,0,0,0,0,0,away,46,4
8/7/2022,606,CChicago,94,166.5,-110,CHI,Chicago Sky,-4,-110,1022200195,50,46,96,-4,home,1,1,1,1,1,1,1,home,50,-4
8/7/2022,607,LVLas Vegas,89,166.5,-110,LVA,Las Vegas Aces,2.5,-103,1022200197,43,44,87,1,away,0,1,1,1,1,1,1,away,44,-1
8/7/2022,608,SSeattle,81,166.5,-110,SEA,Seattle Storm,-2.5,-117,1022200197,43,44,87,1,away,1,0,0,0,0,0,0,home,43,1
8/7/2022,609,LALos Angeles,79,159,-110,LAS,Los Angeles Sparks,10.5,-110,1022200196,32,40,72,8,away,1,1,1,1,1,1,1,away,40,-8
8/7/2022,610,WWashington,76,159,-110,WAS,Washington Mystics,-10.5,-110,1022200196,32,40,72,8,away,0,0,0,0,0,0,0,home,32,8
8/7/2022,611,AAtlanta,71,162.5,-112,ATL,Atlanta Dream,6,-110,1022200198,41,36,77,-5,home,0,0,0,0,0,0,0,away,36,5
8/7/2022,612,MMinnesota,81,162.5,-108,MIN,Minnesota Lynx,-6,-110,1022200198,41,36,77,-5,home,1,1,1,1,1,1,1,home,41,-5
8/26/2023,621,LVLas Vegas,62,170,-110,LVA,Las Vegas Aces,-10,-110,1022300203,27,30,57,3,away,0,0,1,0,1,1,1,away,30,-3
8/26/2023,622,WWashington,78,170,-110,WAS,Washington Mystics,10,-110,1022300203,27,30,57,3,away,1,1,0,1,0,0,0,home,27,3
8/26/2023,623,NYNew York,111,166,-110,NYL,New York Liberty,-9,-110,1022300204,35,65,100,30,away,1,1,1,1,1,1,1,away,65,-30
8/26/2023,624,MMinnesota,76,166,-110,MIN,Minnesota Lynx,9,-110,1022300204,35,65,100,30,away,0,0,0,0,0,0,0,home,35,30
9/1/2023,647,DDallas,110,170.5,-115,DAL,Dallas Wings,-4.5,-115,1022300216,46,54,100,8,away,0,0,0,0,1,1,1,away,54,-8
9/1/2023,648,IIndiana,100,170.5,-110,IND,Indiana Fever,4.5,-105,1022300216,46,54,100,8,away,1,1,1,1,0,0,0,home,46,8
9/1/2023,649,CConnecticut,58,160.5,-110,CON,Connecticut Sun,7.5,-108,1022300217,49,32,81,-17,home,0,0,0,0,0,0,0,away,32,17
9/1/2023,650,NYNew York,89,160.5,-110,NYL,New York Liberty,-7.5,-112,1022300217,49,32,81,-17,home,1,1,1,1,1,1,1,home,49,-17
9/1/2023,651,AAtlanta,85,164,-110,ATL,Atlanta Dream,1.5,-110,1022300218,43,43,86,0,tie,0,0,0,1,1,0,0,away,43,-0
9/1/2023,652,MMinnesota,91,164,-110,MIN,Minnesota Lynx,-1.5,-110,1022300218,43,43,86,0,tie,1,1,1,0,0,1,1,home,43,0
10/1/2023,623,NYNew York,87,160.5,-107,NYL,New York Liberty,-5.5,-110,1042300214,44,45,89,1,away,0,0,0,0,0,0,0,away,45,-1
10/1/2023,624,CConnecticut,84,160.5,-113,CON,Connecticut Sun,5.5,-108,1042300214,44,45,89,1,away,1,1,1,1,1,1,1,home,44,1
10/15/2023,633,LVLas Vegas,73,172,-110,LVA,Las Vegas Aces,-2,-113,1042300303,43,40,83,-3,home,0,0,0,0,0,0,0,away,40,3
10/15/2023,634,NYNew York,87,172,-105,NYL,New York Liberty,2,-107,1042300303,43,40,83,-3,home,1,1,1,1,1,1,1,home,43,-3
5/23/2023,649,CConnecticut,88,158.5,-110,CON,Connecticut Sun,5,-110,1022300010,42,43,85,1,away,0,0,1,1,1,1,1,away,43,-1
5/23/2023,650,WWashington,81,158.5,-110,WAS,Washington Mystics,-5,-110,1022300010,42,43,85,1,away,1,1,0,0,0,0,0,home,42,1
5/23/2023,651,AAtlanta,83,162,-110,ATL,Atlanta Dream,1.5,-110,1022300011,47,40,87,-7,home,0,0,0,0,0,0,0,away,40,7
5/23/2023,652,MMinnesota,77,162,-110,MIN,Minnesota Lynx,-1.5,-110,1022300011,47,40,87,-7,home,1,1,1,1,1,1,1,home,47,-7
6/11/2023,601,DDallas,93,170,-110,DAL,Dallas Wings,8.5,-110,1022300046,45,51,96,6,away,0,1,0,1,0,1,1,away,51,-6
6/11/2023,602,NYNew York,102,170,-110,NYL,New York Liberty,-8.5,-110,1022300046,45,51,96,6,away,1,0,1,0,1,0,0,home,45,6
6/11/2023,603,CChicago,80,168,-105,CHI,Chicago Sky,13,-105,1022300047,56,39,95,-17,home,0,0,0,0,0,0,0,away,39,17
6/11/2023,604,LVLas Vegas,93,168,-115,LVA,Las Vegas Aces,-13,-115,1022300047,56,39,95,-17,home,1,1,1,1,1,1,1,home,56,-17
6/11/2023,605,WWashington,71,155,-110,WAS,Washington Mystics,-4,-110,1022300050,21,46,67,25,away,1,1,1,1,1,1,1,away,46,-25
6/11/2023,606,SSeattle,65,155,-110,SEA,Seattle Storm,4,-110,1022300050,21,46,67,25,away,0,0,0,0,0,0,0,home,21,25
6/11/2023,607,CConnecticut,89,163,-112,CON,Connecticut Sun,-3.5,-110,1022300048,44,48,92,4,away,0,0,0,1,1,1,1,away,48,-4
6/11/2023,608,AAtlanta,77,163,-108,ATL,Atlanta Dream,3.5,-110,1022300048,44,48,92,4,away,1,1,1,0,0,0,0,home,44,4
6/11/2023,609,PPhoenix,85,160.5,-125,PHO,Phoenix Mercury,3,-108,1022300049,42,43,85,1,away,1,1,1,1,1,1,1,away,43,-1
6/11/2023,610,IIndiana,82,160.5,105,IND,Indiana Fever,-3,-112,1022300049,42,43,85,1,away,0,0,0,0,0,0,0,home,42,1
6/11/2023,611,LALos Angeles,86,160,-108,LAS,Los Angeles Sparks,-1,-115,1022300051,43,43,86,0,tie,0,0,0,0,0,0,0,away,43,-0
6/11/2023,612,MMinnesota,91,160,-112,MIN,Minnesota Lynx,1,-105,1022300051,43,43,86,0,tie,1,1,1,1,1,1,1,home,43,0
6/13/2023,613,WWashington,66,157.5,-107,WAS,Washington Mystics,-4.5,-115,1022300052,41,38,79,-3,home,1,0,1,0,0,0,0,away,38,3
6/13/2023,614,IIndiana,87,157.5,-113,IND,Indiana Fever,4.5,-105,1022300052,41,38,79,-3,home,0,1,0,1,1,1,1,home,41,-3
6/13/2023,615,AAtlanta,86,171.5,-110,ATL,Atlanta Dream,10,-112,1022300053,46,41,87,-5,home,1,0,0,1,1,1,0,away,41,5
6/13/2023,616,NYNew York,79,171.5,-110,NYL,New York Liberty,-10,-108,1022300053,46,41,87,-5,home,0,1,1,0,0,0,1,home,46,-5
6/13/2023,617,SSeattle,83,162,-107,SEA,Seattle Storm,5.5,122,1022300054,36,50,86,14,away,1,1,1,1,1,1,1,away,50,-14
6/13/2023,618,PPhoenix,69,162,-113,PHO,Phoenix Mercury,-5.5,-142,1022300054,36,50,86,14,away,0,0,0,0,0,0,0,home,36,14
6/14/2023,619,LALos Angeles,79,169,-110,LAS,Los Angeles Sparks,5.5,-110,1022300055,32,38,70,6,away,1,1,1,1,1,1,1,away,38,-6
6/14/2023,620,DDallas,61,169,-111,DAL,Dallas Wings,-5.5,-110,1022300055,32,38,70,6,away,0,0,0,0,0,0,0,home,32,6
6/18/2023,633,PPhoenix,71,162,-111,PHO,Phoenix Mercury,14.5,-110,1022300062,53,34,87,-19,home,0,0,0,0,0,0,0,away,34,19
6/18/2023,634,NYNew York,89,162,-110,NYL,New York Liberty,-14.5,-110,1022300062,53,34,87,-19,home,1,1,1,1,1,1,1,home,53,-19
6/18/2023,635,CChicago,69,155.5,-110,CHI,Chicago Sky,4,-118,1022300063,42,38,80,-4,home,0,0,0,0,0,0,0,away,38,4
6/18/2023,636,WWashington,77,155.5,-110,WAS,Washington Mystics,-4,-102,1022300063,42,38,80,-4,home,1,1,1,1,1,1,1,home,42,-4
6/18/2023,637,AAtlanta,100,165.5,-110,ATL,Atlanta Dream,-1,-110,1022300064,41,48,89,7,away,1,1,1,1,1,1,1,away,48,-7
6/18/2023,638,IIndiana,94,165.5,-110,IND,Indiana Fever,1,-110,1022300064,41,48,89,7,away,0,0,0,0,0,0,0,home,41,7
6/18/2023,639,CConnecticut,83,157,-115,CON,Connecticut Sun,-4,-115,1022300065,44,39,83,-5,home,0,0,0,1,1,0,0,away,39,5
6/18/2023,640,LALos Angeles,74,157,-105,LAS,Los Angeles Sparks,4,-105,1022300065,44,39,83,-5,home,1,1,1,0,0,1,1,home,44,-5
6/18/2023,641,MMinnesota,62,170,-114,MIN,Minnesota Lynx,17,-110,1022300066,54,41,95,-13,home,1,0,0,0,0,0,0,away,41,13
6/18/2023,642,LVLas Vegas,93,170,-106,LVA,Las Vegas Aces,-17,-110,1022300066,54,41,95,-13,home,0,1,1,1,1,1,1,home,54,-13
6/22/2023,653,WWashington,80,155,-110,WAS,Washington Mystics,-2,-110,1022300071,30,43,73,13,away,1,1,1,1,1,1,1,away,43,-13
6/22/2023,654,CChicago,59,155,-110,CHI,Chicago Sky,2,-110,1022300071,30,43,73,13,away,0,0,0,0,0,0,0,home,30,13
6/22/2023,651,CConnecticut,89,158.5,110,CON,Connecticut Sun,-4,-110,1022300072,28,41,69,13,away,1,1,1,1,1,1,1,away,41,-13
6/22/2023,652,MMinnesota,68,158.5,-130,MIN,Minnesota Lynx,4,-110,1022300072,28,41,69,13,away,0,0,0,0,0,0,0,home,28,13
6/22/2023,655,IIndiana,80,164.5,-110,IND,Indiana Fever,3,-110,1022300073,44,48,92,4,away,0,1,1,0,1,1,1,away,48,-4
6/22/2023,656,SSeattle,68,164.5,-110,SEA,Seattle Storm,-3,-110,1022300073,44,48,92,4,away,1,0,0,1,0,0,0,home,44,4
7/18/2023,647,MMinnesota,73,169.5,-115,MIN,Minnesota Lynx,6,-110,1022300120,54,37,91,-17,home,0,0,0,0,0,0,0,away,37,17
7/18/2023,648,AAtlanta,82,169.5,-105,ATL,Atlanta Dream,-6,-110,1022300120,54,37,91,-17,home,1,1,1,1,1,1,1,home,54,-17
7/18/2023,649,CConnecticut,66,164,-110,CON,Connecticut Sun,-7,-110,1022300121,43,34,77,-9,home,0,0,0,0,0,0,0,away,34,9
7/18/2023,650,PPhoenix,72,164,-110,PHO,Phoenix Mercury,7,-110,1022300121,43,34,77,-9,home,1,1,1,1,1,1,1,home,43,-9
7/21/2023,663,NYNew York,96,163,-110,NYL,New York Liberty,-10.5,-110,1022300128,41,50,91,9,away,0,1,1,1,1,1,1,away,50,-9
7/21/2023,664,WWashington,87,163,-110,WAS,Washington Mystics,10.5,-110,1022300128,41,50,91,9,away,1,0,0,0,0,0,0,home,41,9
7/23/2023,609,PPhoenix,69,156,-110,PHO,Phoenix Mercury,3,-110,1022300134,46,31,77,-15,home,1,0,0,0,0,0,0,away,31,15
7/23/2023,610,WWashington,84,156,-110,WAS,Washington Mystics,-3,-110,1022300134,46,31,77,-15,home,0,1,1,1,1,1,1,home,46,-15
7/23/2023,611,IIndiana,83,170.5,-110,IND,Indiana Fever,13,-110,1022300133,68,46,114,-22,home,0,0,0,0,0,0,0,away,46,22
7/23/2023,612,NYNew York,101,170.5,-110,NYL,New York Liberty,-13,-110,1022300133,68,46,114,-22,home,1,1,1,1,1,1,1,home,68,-22
7/25/2023,613,SSeattle,82,171,-110,SEA,Seattle Storm,15,-112,1022300136,35,45,80,10,away,1,0,1,1,0,1,1,away,45,-10
7/25/2023,614,NYNew York,86,171,-110,NYL,New York Liberty,-15,-108,1022300136,35,45,80,10,away,0,1,0,0,1,0,0,home,35,10
7/25/2023,615,PPhoenix,65,163.5,-110,PHO,Phoenix Mercury,8,-113,1022300135,45,33,78,-12,home,0,0,0,0,0,0,0,away,33,12
7/25/2023,616,AAtlanta,78,163.5,-110,ATL,Atlanta Dream,-8,-107,1022300135,45,33,78,-12,home,1,1,1,1,1,1,1,home,45,-12
7/25/2023,617,LVLas Vegas,107,167,-110,LVA,Las Vegas Aces,-14.5,-110,1022300137,48,55,103,7,away,1,1,1,1,1,1,1,away,55,-7
7/25/2023,618,CChicago,95,167,-110,CHI,Chicago Sky,14.5,-110,1022300137,48,55,103,7,away,0,0,0,0,0,0,0,home,48,7
7/25/2023,619,CConnecticut,88,168,-110,CON,Connecticut Sun,4,-112,1022300138,42,40,82,-2,home,1,1,1,1,1,1,1,away,40,2
7/25/2023,620,DDallas,83,168,-110,DAL,Dallas Wings,-4,-108,1022300138,42,40,82,-2,home,0,0,0,0,0,0,0,home,42,-2
7/25/2023,621,IIndiana,78,163.5,-110,IND,Indiana Fever,4.5,-110,1022300139,47,38,85,-9,home,0,1,1,1,0,0,0,away,38,9
7/25/2023,622,LALos Angeles,79,163.5,-110,LAS,Los Angeles Sparks,-4.5,-110,1022300139,47,38,85,-9,home,1,0,0,0,1,1,1,home,47,-9
7/26/2023,623,WWashington,92,159,-115,WAS,Washington Mystics,4,-102,1022300140,58,60,118,2,away,0,0,1,0,0,0,1,away,60,-2
7/26/2023,624,MMinnesota,97,159,-105,MIN,Minnesota Lynx,-4,-118,1022300140,58,60,118,2,away,1,1,0,1,1,1,0,home,58,2
7/27/2023,625,IIndiana,68,160.5,-110,IND,Indiana Fever,2.5,-110,1022300141,45,39,84,-6,home,0,1,0,0,0,0,0,away,39,6
7/27/2023,626,LALos Angeles,81,160.5,-110,LAS,Los Angeles Sparks,-2.5,-110,1022300141,45,39,84,-6,home,1,0,1,1,1,1,1,home,45,-6
7/27/2023,627,AAtlanta,84,175,-110,ATL,Atlanta Dream,9,-112,1022300142,57,42,99,-15,home,0,0,0,0,0,0,0,away,42,15
7/27/2023,628,NYNew York,95,175,-110,NYL,New York Liberty,-9,-108,1022300142,57,42,99,-15,home,1,1,1,1,1,1,1,home,57,-15
7/28/2023,631,WWashington,62,165,-110,WAS,Washington Mystics,8.5,105,1022300144,43,29,72,-14,home,0,0,0,0,0,0,0,away,29,14
7/28/2023,632,DDallas,90,165,-110,DAL,Dallas Wings,-8.5,-125,1022300144,43,29,72,-14,home,1,1,1,1,1,1,1,home,43,-14
7/28/2023,633,SSeattle,83,160.5,-110,SEA,Seattle Storm,4,-105,1022300143,40,42,82,2,away,1,1,1,1,0,1,0,away,42,-2
7/28/2023,634,CChicago,74,160.5,-110,CHI,Chicago Sky,-4,-115,1022300143,40,42,82,2,away,0,0,0,0,1,0,1,home,40,2
7/28/2023,629,MMinnesota,88,166,-110,MIN,Minnesota Lynx,14,-110,1022300038,39,48,87,9,away,0,0,1,1,1,1,1,away,48,-9
7/28/2023,630,NYNew York,83,166,-110,NYL,New York Liberty,-14,-110,1022300038,39,48,87,9,away,1,1,0,0,0,0,0,home,39,9
7/30/2023,635,MMinnesota,87,160.5,-110,MIN,Minnesota Lynx,12.5,100,1022300145,44,48,92,4,away,0,1,1,1,1,0,1,away,48,-4
7/30/2023,636,CConnecticut,83,159.5,-105,CON,Connecticut Sun,-12.5,-120,1022300145,44,48,92,4,away,1,0,0,0,0,1,0,home,44,4
7/30/2023,637,WWashington,73,166,-110,WAS,Washington Mystics,8.5,-110,1022300146,40,41,81,1,away,0,1,1,1,0,0,0,away,41,-1
7/30/2023,638,AAtlanta,80,166,-110,ATL,Atlanta Dream,-8.5,-110,1022300146,40,41,81,1,away,1,0,0,0,1,1,1,home,40,1
7/30/2023,643,NYNew York,87,168,-110,NYL,New York Liberty,-8.5,-115,1022300150,35,51,86,16,away,1,1,1,1,1,1,1,away,51,-16
7/30/2023,644,LALos Angeles,79,168,-110,LAS,Los Angeles Sparks,8.5,-105,1022300150,35,51,86,16,away,0,0,0,0,0,0,0,home,35,16
7/30/2023,639,SSeattle,85,162,-115,SEA,Seattle Storm,4,-110,1022300147,27,47,74,20,away,0,1,1,1,1,1,1,away,47,-20
7/30/2023,640,IIndiana,62,162,-105,IND,Indiana Fever,-4,-110,1022300147,27,47,74,20,away,1,0,0,0,0,0,0,home,27,20
7/30/2023,641,PPhoenix,85,155,-110,PHO,Phoenix Mercury,7,-110,1022300148,57,48,105,-9,home,0,0,0,0,0,0,0,away,48,9
7/30/2023,642,CChicago,104,155,-110,CHI,Chicago Sky,-7,-110,1022300148,57,48,105,-9,home,1,1,1,1,1,1,1,home,57,-9
7/30/2023,645,DDallas,91,176,-110,DAL,Dallas Wings,11,-115,1022300149,58,41,99,-17,home,0,0,0,0,0,0,0,away,41,17
7/30/2023,646,LVLas Vegas,104,176,-110,LVA,Las Vegas Aces,-11,-105,1022300149,58,41,99,-17,home,1,1,1,1,1,1,1,home,58,-17
8/1/2023,649,PPhoenix,71,158,-115,PHO,Phoenix Mercury,6,-110,1022300152,46,43,89,-3,home,0,1,1,1,1,0,0,away,43,3
8/1/2023,650,IIndiana,72,158,-105,IND,Indiana Fever,-6,-110,1022300152,46,43,89,-3,home,1,0,0,0,0,1,1,home,46,-3
8/1/2023,647,MMinnesota,69,164,-110,MIN,Minnesota Lynx,11.5,-110,1022300151,37,30,67,-7,home,0,1,0,0,0,0,0,away,30,7
8/1/2023,648,CConnecticut,79,164,-110,CON,Connecticut Sun,-11.5,-110,1022300151,37,30,67,-7,home,1,0,1,1,1,1,1,home,37,-7
8/1/2023,653,AAtlanta,72,179.5,-110,ATL,Atlanta Dream,13.5,-110,1022300153,54,43,97,-11,home,0,0,0,0,0,0,0,away,43,11
8/1/2023,654,LVLas Vegas,93,179.5,-110,LVA,Las Vegas Aces,-13.5,-110,1022300153,54,43,97,-11,home,1,1,1,1,1,1,1,home,54,-11
8/1/2023,651,NYNew York,76,166.5,-120,NYL,New York Liberty,-8.5,-115,1022300154,34,32,66,-2,home,1,0,0,1,0,0,0,away,32,2
8/1/2023,652,LALos Angeles,69,166.5,100,LAS,Los Angeles Sparks,8.5,-105,1022300154,34,32,66,-2,home,0,1,1,0,1,1,1,home,34,-2
8/2/2023,655,DDallas,76,167.5,-110,DAL,Dallas Wings,-7,-115,1022300155,33,46,79,13,away,1,1,1,1,1,1,1,away,46,-13
8/2/2023,656,SSeattle,65,168,-110,SEA,Seattle Storm,7,-105,1022300155,33,46,79,13,away,0,0,0,0,0,0,0,home,33,13
8/3/2023,657,AAtlanta,71,164,-110,ATL,Atlanta Dream,-7.5,-110,1022300156,43,36,79,-7,home,1,0,1,1,1,0,0,away,36,7
8/3/2023,658,PPhoenix,91,164,-110,PHO,Phoenix Mercury,7.5,-110,1022300156,43,36,79,-7,home,0,1,0,0,0,1,1,home,43,-7
8/4/2023,659,CConnecticut,88,160.5,-110,CON,Connecticut Sun,-8,-110,1022300157,33,56,89,23,away,0,1,1,1,1,1,1,away,56,-23
8/4/2023,660,IIndiana,72,160.5,-110,IND,Indiana Fever,8,-110,1022300157,33,56,89,23,away,1,0,0,0,0,0,0,home,33,23
8/4/2023,661,LALos Angeles,77,157,-110,LAS,Los Angeles Sparks,3,-110,1022300158,48,40,88,-8,home,0,0,0,0,0,0,0,away,40,8
8/4/2023,662,WWashington,79,157,-110,WAS,Washington Mystics,-3,-110,1022300158,48,40,88,-8,home,1,1,1,1,1,1,1,home,48,-8
8/4/2023,665,CChicago,104,165,-110,CHI,Chicago Sky,10.5,-115,1022300159,48,58,106,10,away,1,1,1,1,1,1,1,away,58,-10
8/4/2023,666,DDallas,89,165,-110,DAL,Dallas Wings,-10.5,-105,1022300159,48,58,106,10,away,0,0,0,0,0,0,0,home,48,10
8/4/2023,663,NYNew York,76,170.5,-110,NYL,New York Liberty,-9,-110,1022300160,42,41,83,-1,home,0,1,1,1,1,1,0,away,41,1
8/4/2023,664,MMinnesota,66,170.5,-110,MIN,Minnesota Lynx,9,-110,1022300160,42,41,83,-1,home,1,0,0,0,0,0,1,home,42,-1
8/5/2023,601,SSeattle,97,159,-115,SEA,Seattle Storm,4,-110,1022300161,50,41,91,-9,home,0,0,0,0,0,0,0,away,41,9
8/5/2023,602,PPhoenix,91,159,-110,PHO,Phoenix Mercury,-4,-110,1022300161,50,41,91,-9,home,1,1,1,1,1,1,1,home,50,-9
8/6/2023,605,IIndiana,73,167,-105,IND,Indiana Fever,8,-110,1022300162,43,34,77,-9,home,0,0,0,0,0,0,0,away,34,9
8/6/2023,606,AAtlanta,82,167,-115,ATL,Atlanta Dream,-8,-110,1022300162,43,34,77,-9,home,1,1,1,1,1,1,1,home,43,-9
8/6/2023,603,LALos Angeles,91,155.5,-110,LAS,Los Angeles Sparks,3,-115,1022300164,36,43,79,7,away,0,0,1,1,0,1,1,away,43,-7
8/6/2023,604,WWashington,83,155.5,-110,WAS,Washington Mystics,-3,-110,1022300164,36,43,79,7,away,1,1,0,0,1,0,0,home,36,7
8/6/2023,607,LVLas Vegas,61,176.5,-110,LVA,Las Vegas Aces,-5,-105,1022300163,49,44,93,-5,home,0,0,1,0,0,0,0,away,44,5
8/6/2023,608,NYNew York,99,176.5,-110,NYL,New York Liberty,5,-115,1022300163,49,44,93,-5,home,1,1,0,1,1,1,1,home,49,-5
8/6/2023,609,CChicago,104,166.5,-110,CHI,Chicago Sky,9,-109,1022300165,37,46,83,9,away,1,1,0,0,1,1,1,away,46,-9
8/6/2023,610,DDallas,96,166.5,-110,DAL,Dallas Wings,-9,-110,1022300165,37,46,83,9,away,0,0,1,1,0,0,0,home,37,9
8/8/2023,611,CConnecticut,81,160.5,-110,CON,Connecticut Sun,-7.5,-115,1022300166,34,50,84,16,away,0,0,0,1,1,1,1,away,50,-16
8/8/2023,612,SSeattle,69,160.5,-110,SEA,Seattle Storm,7.5,-105,1022300166,34,50,84,16,away,1,1,1,0,0,0,0,home,34,16
8/8/2023,613,LALos Angeles,87,157.5,-110,LAS,Los Angeles Sparks,-0.5,-110,1022300167,41,40,81,-1,home,1,1,1,0,0,0,0,away,40,1
8/8/2023,614,IIndiana,80,157.5,-110,IND,Indiana Fever,-0.5,-110,1022300167,41,40,81,-1,home,0,0,0,1,1,1,1,home,41,-1
8/8/2023,617,MMinnesota,88,164.5,-110,MIN,Minnesota Lynx,3,-109,1022300168,38,45,83,7,away,1,1,1,1,1,1,1,away,45,-7
8/8/2023,618,CChicago,79,164.5,-110,CHI,Chicago Sky,-3,-111,1022300168,38,45,83,7,away,0,0,0,0,0,0,0,home,38,7
8/8/2023,615,LVLas Vegas,104,177.5,-110,LVA,Las Vegas Aces,-8.5,-110,1022300169,26,54,80,28,away,1,1,1,1,1,1,1,away,54,-28
8/8/2023,616,DDallas,84,177.5,-110,DAL,Dallas Wings,8.5,-110,1022300169,26,54,80,28,away,0,0,0,0,0,0,0,home,26,28
8/8/2023,619,WWashington,72,159.5,-110,WAS,Washington Mystics,3.5,-110,1022300170,44,34,78,-10,home,0,0,0,0,0,0,0,away,34,10
8/8/2023,620,PPhoenix,91,159.5,-110,PHO,Phoenix Mercury,-3.5,-110,1022300170,44,34,78,-10,home,1,1,1,1,1,1,1,home,44,-10
8/10/2023,621,MMinnesota,73,163.5,-115,MIN,Minnesota Lynx,-2.5,-110,1022300171,45,35,80,-10,home,1,0,1,0,0,0,0,away,35,10
8/10/2023,622,IIndiana,91,163.5,-105,IND,Indiana Fever,2.5,-110,1022300171,45,35,80,-10,home,0,1,0,1,1,1,1,home,45,-10
8/10/2023,625,CConnecticut,84,159.5,-110,CON,Connecticut Sun,-7,-110,1022300172,52,48,100,-4,home,0,0,0,0,0,0,0,away,48,4
8/10/2023,626,PPhoenix,90,159.5,-110,PHO,Phoenix Mercury,7,-110,1022300172,52,48,100,-4,home,1,1,1,1,1,1,1,home,52,-4
8/10/2023,623,AAtlanta,67,163,-110,ATL,Atlanta Dream,-5.5,-105,1022300173,27,34,61,7,away,1,1,1,1,1,1,1,away,34,-7
8/10/2023,624,SSeattle,68,163,-110,SEA,Seattle Storm,5.5,-115,1022300173,27,34,61,7,away,0,0,0,0,0,0,0,home,27,7
8/11/2023,627,CChicago,73,169.5,-110,CHI,Chicago Sky,12,-115,1022300174,48,40,88,-8,home,0,0,0,0,0,0,0,away,40,8
8/11/2023,628,NYNew York,89,169.5,-110,NYL,New York Liberty,-12,-105,1022300174,48,40,88,-8,home,1,1,1,1,1,1,1,home,48,-8
8/11/2023,629,WWashington,89,169.5,-110,WAS,Washington Mystics,17.5,-110,1022300175,57,48,105,-9,home,0,0,0,0,0,0,0,away,48,9
8/11/2023,630,LVLas Vegas,113,169.5,-110,LVA,Las Vegas Aces,-17.5,-110,1022300175,57,48,105,-9,home,1,1,1,1,1,1,1,home,57,-9
8/12/2023,631,AAtlanta,74,164,-110,ATL,Atlanta Dream,-0.5,-105,1022300176,38,45,83,7,away,1,1,1,1,1,1,1,away,45,-7
8/12/2023,632,LALos Angeles,85,164,-110,LAS,Los Angeles Sparks,-0.5,-115,1022300176,38,45,83,7,away,0,0,0,0,0,0,0,home,38,7
8/12/2023,633,CConnecticut,81,168.5,-110,CON,Connecticut Sun,3,-105,1022300177,52,43,95,-9,home,1,0,0,0,0,0,0,away,43,9
8/12/2023,634,DDallas,91,168.5,-110,DAL,Dallas Wings,-3,-115,1022300177,52,43,95,-9,home,0,1,1,1,1,1,1,home,52,-9
8/13/2023,637,CChicago,76,162,-125,CHI,Chicago Sky,2.5,-110,1022300178,40,39,79,-1,home,0,0,0,0,0,0,0,away,39,1
8/13/2023,638,WWashington,83,162,105,WAS,Washington Mystics,-2.5,-110,1022300178,40,39,79,-1,home,1,1,1,1,1,1,1,home,40,-1
8/13/2023,635,NYNew York,100,165.5,-115,NYL,New York Liberty,-10.5,-110,1022300180,51,58,109,7,away,1,1,0,0,0,0,0,away,58,-7
8/13/2023,636,IIndiana,89,165.5,-105,IND,Indiana Fever,10.5,-110,1022300180,51,58,109,7,away,0,0,1,1,1,1,1,home,51,7
8/13/2023,639,PPhoenix,71,160.5,-112,PHO,Phoenix Mercury,2.5,-105,1022300179,51,35,86,-16,home,1,1,0,0,0,0,0,away,35,16
8/13/2023,640,SSeattle,81,160.5,-108,SEA,Seattle Storm,-2.5,-115,1022300179,51,35,86,-16,home,0,0,1,1,1,1,1,home,51,-16
8/13/2023,641,AAtlanta,65,176,-110,ATL,Atlanta Dream,17,-110,1022300181,36,30,66,-6,home,1,1,0,0,0,0,0,away,30,6
8/13/2023,642,LVLas Vegas,86,176,-110,LVA,Las Vegas Aces,-17,-110,1022300181,36,30,66,-6,home,0,0,1,1,1,1,1,home,36,-6
8/17/2023,643,NYNew York,75,175,-110,NYL,New York Liberty,7,100,1022300182,53,40,93,-13,home,1,1,0,0,0,0,0,away,40,13
8/17/2023,644,LVLas Vegas,88,175,-110,LVA,Las Vegas Aces,-7,-120,1022300182,53,40,93,-13,home,0,0,1,1,1,1,1,home,53,-13
8/18/2023,647,WWashington,83,162,-115,WAS,Washington Mystics,-5,-110,1022300184,42,42,84,0,tie,0,1,0,1,0,0,1,away,42,-0
8/18/2023,648,IIndiana,79,162,-105,IND,Indiana Fever,5.5,-110,1022300184,42,42,84,0,tie,1,0,1,0,1,1,0,home,42,0
8/18/2023,649,DDallas,95,169,-110,DAL,Dallas Wings,5,-110,1022300183,40,46,86,6,away,0,0,0,1,0,1,1,away,46,-6
8/18/2023,650,CConnecticut,75,169,-110,CON,Connecticut Sun,-5,-110,1022300183,40,46,86,6,away,1,1,1,0,1,0,0,home,40,6
8/18/2023,651,CChicago,67,161,-110,CHI,Chicago Sky,2,-113,1022300185,39,37,76,-2,home,0,1,1,1,1,1,1,away,37,2
8/18/2023,652,AAtlanta,78,161,-110,ATL,Atlanta Dream,-2,-107,1022300185,39,37,76,-2,home,1,0,0,0,0,0,0,home,39,-2
8/18/2023,655,MMinnesota,78,162,-110,MIN,Minnesota Lynx,-1,-105,1022300187,39,46,85,7,away,0,0,1,1,1,1,1,away,46,-7
8/18/2023,656,SSeattle,70,161.5,-110,SEA,Seattle Storm,1,-115,1022300187,39,46,85,7,away,1,1,0,0,0,0,0,home,39,7
8/18/2023,653,NYNew York,85,164.5,-110,NYL,New York Liberty,-12.5,-110,1022300186,38,43,81,5,away,0,1,0,0,1,1,1,away,43,-5
8/18/2023,654,PPhoenix,63,164.5,-110,PHO,Phoenix Mercury,12.5,-110,1022300186,38,43,81,5,away,1,0,1,1,0,0,0,home,38,5
8/19/2023,657,LALos Angeles,78,169.5,-110,LAS,Los Angeles Sparks,16.5,-110,1022300188,36,42,78,6,away,1,1,1,1,1,0,1,away,42,-6
8/19/2023,658,LVLas Vegas,72,169.5,-110,LVA,Las Vegas Aces,-17,-108,1022300188,36,42,78,6,away,0,0,0,0,0,1,0,home,36,6
8/20/2023,659,DDallas,97,166.5,-110,DAL,Dallas Wings,-5.5,-118,1022300189,46,56,102,10,away,1,1,1,1,1,1,1,away,56,-10
8/20/2023,660,WWashington,84,166.5,-110,WAS,Washington Mystics,5.5,-102,1022300189,46,56,102,10,away,0,0,0,0,0,0,0,home,46,10
8/20/2023,661,CConnecticut,79,160.5,-110,CON,Connecticut Sun,-6,-110,1022300190,40,45,85,5,away,0,1,1,1,0,0,0,away,45,-5
8/20/2023,662,CChicago,73,160.5,-110,CHI,Chicago Sky,6,-110,1022300190,40,45,85,5,away,1,0,0,0,1,1,1,home,40,5
8/20/2023,663,IIndiana,83,160.5,-115,IND,Indiana Fever,-4,-114,1022300191,32,40,72,8,away,1,1,1,1,1,1,1,away,40,-8
8/20/2023,664,PPhoenix,73,160.5,-105,PHO,Phoenix Mercury,4,-106,1022300191,32,40,72,8,away,0,0,0,0,0,0,0,home,32,8
8/20/2023,665,SSeattle,88,159.5,-110,SEA,Seattle Storm,5.5,-110,1022300192,40,47,87,7,away,1,1,1,1,1,1,1,away,47,-7
8/20/2023,666,MMinnesota,74,159.5,-110,MIN,Minnesota Lynx,-5.5,-110,1022300192,40,47,87,7,away,0,0,0,0,0,0,0,home,40,7
8/22/2023,601,LVLas Vegas,112,167,-110,LVA,Las Vegas Aces,-16,-110,1022300193,55,56,111,1,away,1,1,1,1,0,1,1,away,56,-1
8/22/2023,602,AAtlanta,100,167,-110,ATL,Atlanta Dream,16,-110,1022300193,55,56,111,1,away,0,0,0,0,1,0,0,home,55,1
8/22/2023,603,CConnecticut,68,159,-110,CON,Connecticut Sun,-4,-110,1022300194,31,36,67,5,away,0,0,0,0,1,1,1,away,36,-5
8/22/2023,604,WWashington,64,159,-110,WAS,Washington Mystics,4,-110,1022300194,31,36,67,5,away,1,1,1,1,0,0,0,home,31,5
8/22/2023,605,SSeattle,79,158,-110,SEA,Seattle Storm,4.5,-110,1022300195,50,40,90,-10,home,0,0,0,0,0,0,0,away,40,10
8/22/2023,606,CChicago,102,158,-110,CHI,Chicago Sky,-4.5,-110,1022300195,50,40,90,-10,home,1,1,1,1,1,1,1,home,50,-10
8/22/2023,607,DDallas,86,169.5,-110,DAL,Dallas Wings,-6,-110,1022300196,39,36,75,-3,home,0,0,0,0,1,1,0,away,36,3
8/22/2023,608,MMinnesota,91,169.5,-110,MIN,Minnesota Lynx,6,-110,1022300196,39,36,75,-3,home,1,1,1,1,0,0,1,home,39,-3
8/23/2023,609,PPhoenix,62,154.5,-110,PHO,Phoenix Mercury,11,-115,1022300197,44,30,74,-14,home,0,0,0,0,0,0,0,away,30,14
8/23/2023,610,LALos Angeles,91,154.5,-110,LAS,Los Angeles Sparks,-11,-110,1022300197,44,30,74,-14,home,1,1,1,1,1,1,1,home,44,-14
8/24/2023,613,NYNew York,95,165.5,-115,NYL,New York Liberty,-6,-110,1022300198,48,34,82,-14,home,0,0,1,0,1,0,0,away,34,14
8/24/2023,614,CConnecticut,90,166,-110,CON,Connecticut Sun,6,-110,1022300198,48,34,82,-14,home,1,1,0,1,0,1,1,home,48,-14
8/24/2023,611,SSeattle,86,160,-110,SEA,Seattle Storm,4,-115,1022300199,46,38,84,-8,home,1,1,0,0,1,0,0,away,38,8
8/24/2023,612,IIndiana,90,160,-110,IND,Indiana Fever,-4,-105,1022300199,46,38,84,-8,home,0,0,1,1,0,1,1,home,46,-8
8/24/2023,617,MMinnesota,90,166,-112,MIN,Minnesota Lynx,6,-110,1022300201,48,50,98,2,away,0,0,0,1,1,1,0,away,50,-2
8/24/2023,618,DDallas,81,166,-108,DAL,Dallas Wings,-6,-110,1022300201,48,50,98,2,away,1,1,1,0,0,0,1,home,48,2
8/24/2023,615,LVLas Vegas,94,171.5,-110,LVA,Las Vegas Aces,-14.5,-110,1022300200,50,37,87,-13,home,0,0,0,0,0,0,0,away,37,13
8/24/2023,616,CChicago,87,171.5,-110,CHI,Chicago Sky,14.5,-110,1022300200,50,37,87,-13,home,1,1,1,1,1,1,1,home,50,-13
8/25/2023,619,LALos Angeles,83,160,-110,LAS,Los Angeles Sparks,-1.5,-112,1022300202,52,39,91,-13,home,0,0,0,0,0,0,0,away,39,13
8/25/2023,620,AAtlanta,78,160,-110,ATL,Atlanta Dream,1.5,-108,1022300202,52,39,91,-13,home,1,1,1,1,1,1,1,home,52,-13
8/27/2023,625,LALos Angeles,68,156.5,-110,LAS,Los Angeles Sparks,6,-106,1022300205,43,38,81,-5,home,1,1,1,1,1,0,0,away,38,5
8/27/2023,626,CConnecticut,83,156.5,-110,CON,Connecticut Sun,-6,-114,1022300205,43,38,81,-5,home,0,0,0,0,0,1,1,home,43,-5
8/27/2023,627,AAtlanta,80,165,-110,ATL,Atlanta Dream,-1.5,-110,1022300206,47,37,84,-10,home,1,0,0,0,0,0,0,away,37,10
8/27/2023,628,IIndiana,83,165,-110,IND,Indiana Fever,1.5,-110,1022300206,47,37,84,-10,home,0,1,1,1,1,1,1,home,47,-10
8/27/2023,631,DDallas,77,162.5,-114,DAL,Dallas Wings,-7.5,-110,1022300207,42,35,77,-7,home,1,0,0,0,0,0,0,away,35,7
8/27/2023,632,PPhoenix,74,162.5,-106,PHO,Phoenix Mercury,7.5,-110,1022300207,42,35,77,-7,home,0,1,1,1,1,1,1,home,42,-7
8/27/2023,629,CChicago,90,161.5,-110,CHI,Chicago Sky,-1,-110,1022300208,55,46,101,-9,home,0,0,0,0,0,0,0,away,46,9
8/27/2023,630,SSeattle,85,161.5,-110,SEA,Seattle Storm,1,-110,1022300208,55,46,101,-9,home,1,1,1,1,1,1,1,home,55,-9
8/28/2023,633,LVLas Vegas,85,174,-110,LVA,Las Vegas Aces,2,-108,1022300209,47,35,82,-12,home,1,1,0,0,0,0,0,away,35,12
8/28/2023,634,NYNew York,94,174.5,-116,NYL,New York Liberty,-2,-112,1022300209,47,35,82,-12,home,0,0,1,1,1,1,1,home,47,-12
8/29/2023,637,PPhoenix,76,160,-110,PHO,Phoenix Mercury,8,-105,1022300210,54,26,80,-28,home,0,0,0,0,0,0,0,away,26,28
8/29/2023,638,AAtlanta,94,159.5,-110,ATL,Atlanta Dream,-8,-115,1022300210,54,26,80,-28,home,1,1,1,1,1,1,1,home,54,-28
8/29/2023,635,MMinnesota,72,161.5,-110,MIN,Minnesota Lynx,7,-110,1022300211,42,37,79,-5,home,0,0,0,0,0,0,0,away,37,5
8/29/2023,636,WWashington,83,161.5,-110,WAS,Washington Mystics,-7,-107,1022300211,42,37,79,-5,home,1,1,1,1,1,1,1,home,42,-5
8/29/2023,639,CChicago,76,162,-110,CHI,Chicago Sky,5,-118,1022300212,43,43,86,0,tie,0,0,0,0,0,0,0,away,43,-0
8/29/2023,640,LALos Angeles,75,162,-110,LAS,Los Angeles Sparks,-5,-102,1022300212,43,43,86,0,tie,1,1,1,1,1,1,1,home,43,0
8/31/2023,641,PPhoenix,74,154,-105,PHO,Phoenix Mercury,15,-110,1022300213,38,41,79,3,away,1,1,1,0,1,1,1,away,41,-3
8/31/2023,642,CConnecticut,84,154,-115,CON,Connecticut Sun,-15,-110,1022300213,38,41,79,3,away,0,0,0,1,0,0,0,home,38,3
8/31/2023,643,WWashington,75,168.5,-110,WAS,Washington Mystics,10.5,-110,1022300214,40,30,70,-10,home,0,0,0,0,0,0,0,away,30,10
8/31/2023,644,LVLas Vegas,84,168.5,-110,LVA,Las Vegas Aces,-10.5,-110,1022300214,40,30,70,-10,home,1,1,1,1,1,1,1,home,40,-10
8/31/2023,645,SSeattle,72,158.5,-105,SEA,Seattle Storm,7,-101,1022300215,29,38,67,9,away,1,1,1,1,1,1,1,away,38,-9
8/31/2023,646,LALos Angeles,61,158.5,-115,LAS,Los Angeles Sparks,-7,-119,1022300215,29,38,67,9,away,0,0,0,0,0,0,0,home,29,9
9/2/2023,653,SSeattle,77,170,-110,SEA,Seattle Storm,20,-114,1022300219,49,43,92,-6,home,0,0,0,0,0,0,0,away,43,6
9/2/2023,654,LVLas Vegas,103,170,-110,LVA,Las Vegas Aces,-20,-106,1022300219,49,43,92,-6,home,1,1,1,1,1,1,1,home,49,-6
9/3/2023,655,NYNew York,86,164.5,-110,NYL,New York Liberty,-8.5,-107,1022300220,36,41,77,5,away,0,1,1,1,1,1,1,away,41,-5
9/3/2023,656,CChicago,69,164.5,-110,CHI,Chicago Sky,8.5,-113,1022300220,36,41,77,5,away,1,0,0,0,0,0,0,home,36,5
9/3/2023,657,IIndiana,97,171,-110,IND,Indiana Fever,9,-105,1022300221,36,39,75,3,away,1,1,1,1,1,1,1,away,39,-3
9/3/2023,658,DDallas,84,171,-110,DAL,Dallas Wings,-9,-115,1022300221,36,39,75,3,away,0,0,0,0,0,0,0,home,36,3
9/3/2023,659,PPhoenix,73,157,-112,PHO,Phoenix Mercury,8,-110,1022300222,41,41,82,0,tie,1,0,1,1,1,1,0,away,41,-0
9/3/2023,660,MMinnesota,86,157,-108,MIN,Minnesota Lynx,-8,-110,1022300222,41,41,82,0,tie,0,1,0,0,0,0,1,home,41,0
9/3/2023,661,WWashington,64,157.5,-110,WAS,Washington Mystics,-3.5,-127,1022300223,38,34,72,-4,home,0,0,1,0,0,0,0,away,34,4
9/3/2023,662,LALos Angeles,72,157.5,-110,LAS,Los Angeles Sparks,3.5,107,1022300223,38,34,72,-4,home,1,1,0,1,1,1,1,home,38,-4
9/5/2023,601,CChicago,96,165,-110,CHI,Chicago Sky,1,-110,1022300225,34,49,83,15,away,1,1,1,1,1,1,1,away,49,-15
9/5/2023,602,IIndiana,69,165,-110,IND,Indiana Fever,-1,-110,1022300225,34,49,83,15,away,0,0,0,0,0,0,0,home,34,15
9/5/2023,603,LALos Angeles,76,151.5,-110,LAS,Los Angeles Sparks,10.5,-110,1022300224,49,36,85,-13,home,0,0,0,0,0,0,0,away,36,13
9/5/2023,604,CConnecticut,90,151.5,-110,CON,Connecticut Sun,-10.5,-110,1022300224,49,36,85,-13,home,1,1,1,1,1,1,1,home,49,-13
9/5/2023,605,NYNew York,94,172.5,-110,NYL,New York Liberty,-6.5,-110,1022300226,51,53,104,2,away,1,1,1,1,0,0,0,away,53,-2
9/5/2023,606,DDallas,93,172.5,-110,DAL,Dallas Wings,6.5,-110,1022300226,51,53,104,2,away,0,0,0,0,1,1,1,home,51,2
9/5/2023,607,WWashington,100,153.5,-110,WAS,Washington Mystics,-7,-110,1022300227,33,50,83,17,away,1,1,1,1,1,1,1,away,50,-17
9/5/2023,608,PPhoenix,77,153.5,-110,PHO,Phoenix Mercury,7,-110,1022300227,33,50,83,17,away,0,0,0,0,0,0,0,home,33,17
9/6/2023,609,SSeattle,68,164,-108,SEA,Seattle Storm,9,-110,1022300228,47,40,87,-7,home,1,1,1,1,1,1,0,away,40,7
9/6/2023,610,AAtlanta,79,164,-112,ATL,Atlanta Dream,-9,-110,1022300228,47,40,87,-7,home,0,0,0,0,0,0,1,home,47,-7
9/7/2023,611,LALos Angeles,89,160.5,-110,LAS,Los Angeles Sparks,16,-110,1022300229,43,50,93,7,away,0,0,0,1,1,1,1,away,50,-7
9/7/2023,612,NYNew York,96,160.5,-110,NYL,New York Liberty,-16,-110,1022300229,43,50,93,7,away,1,1,1,0,0,0,0,home,43,7
9/8/2023,615,IIndiana,59,161,-110,IND,Indiana Fever,10,-110,1022300230,37,31,68,-6,home,0,0,0,0,0,0,0,away,31,6
9/8/2023,616,CConnecticut,76,161,-110,CON,Connecticut Sun,-10,-110,1022300230,37,31,68,-6,home,1,1,1,1,1,1,1,home,37,-6
9/8/2023,613,AAtlanta,80,162,-110,ATL,Atlanta Dream,5.5,-110,1022300231,35,42,77,7,away,1,1,1,1,1,1,1,away,42,-7
9/8/2023,614,WWashington,75,162,-110,WAS,Washington Mystics,-5.5,-110,1022300231,35,42,77,7,away,0,0,0,0,0,0,0,home,35,7
9/8/2023,617,MMinnesota,87,165,-110,MIN,Minnesota Lynx,4,-105,1022300232,44,39,83,-5,home,1,1,1,1,1,0,0,away,39,5
9/8/2023,618,CChicago,92,165.5,-110,CHI,Chicago Sky,-4.5,-110,1022300232,44,39,83,-5,home,0,0,0,0,0,1,1,home,44,-5
9/8/2023,619,SSeattle,91,169.5,-110,SEA,Seattle Storm,11.5,-110,1022300233,56,45,101,-11,home,0,0,0,0,0,0,0,away,45,11
9/8/2023,620,DDallas,106,169.5,-112,DAL,Dallas Wings,-11.5,-110,1022300233,56,45,101,-11,home,1,1,1,1,1,1,1,home,56,-11
9/8/2023,621,LVLas Vegas,94,164.5,-110,LVA,Las Vegas Aces,-19.5,-110,1022300234,31,48,79,17,away,1,1,1,1,1,1,1,away,48,-17
9/8/2023,622,PPhoenix,73,164.5,-110,PHO,Phoenix Mercury,19.5,-110,1022300234,31,48,79,17,away,0,0,0,0,0,0,0,home,31,17
9/10/2023,625,WWashington,90,162,-112,WAS,Washington Mystics,10,-105,1022300238,50,50,100,0,tie,0,0,0,0,0,0,0,away,50,-0
9/10/2023,626,NYNew York,88,162,-108,NYL,New York Liberty,-10,-115,1022300238,50,50,100,0,tie,1,1,1,1,1,1,1,home,50,0
9/10/2023,629,DDallas,94,172,-115,DAL,Dallas Wings,1,-110,1022300235,39,44,83,5,away,1,1,1,1,1,1,1,away,44,-5
9/10/2023,630,AAtlanta,77,172,-105,ATL,Atlanta Dream,-1,-110,1022300235,39,44,83,5,away,0,0,0,0,0,0,0,home,39,5
9/10/2023,627,CChicago,102,159,-110,CHI,Chicago Sky,9.5,-107,1022300236,43,41,84,-2,home,1,1,1,1,0,1,0,away,41,2
9/10/2023,628,CConnecticut,91,159,-110,CON,Connecticut Sun,-9.5,-113,1022300236,43,41,84,-2,home,0,0,0,0,1,0,1,home,43,-2
9/10/2023,623,MMinnesota,72,165.5,-110,MIN,Minnesota Lynx,-2.5,-110,1022300237,56,44,100,-12,home,0,0,0,0,0,0,0,away,44,12
9/10/2023,624,IIndiana,87,165.5,-110,IND,Indiana Fever,2.5,-110,1022300237,56,44,100,-12,home,1,1,1,1,1,1,1,home,56,-12
9/10/2023,631,LALos Angeles,91,158.5,-115,LAS,Los Angeles Sparks,-2,-110,1022300240,53,44,97,-9,home,0,0,0,0,0,0,0,away,44,9
9/10/2023,632,SSeattle,89,158.5,-105,SEA,Seattle Storm,2,-110,1022300240,53,44,97,-9,home,1,1,1,1,1,1,1,home,53,-9
9/10/2023,633,PPhoenix,85,166,-110,PHO,Phoenix Mercury,21,-110,1022300239,53,41,94,-12,home,0,0,0,0,0,0,0,away,41,12
9/10/2023,634,LVLas Vegas,100,166,-110,LVA,Las Vegas Aces,-21,-105,1022300239,53,41,94,-12,home,1,1,1,1,1,1,1,home,53,-12
9/13/2023,641,MMinnesota,60,159.5,-110,MIN,Minnesota Lynx,9,-107,1042300121,46,32,78,-14,home,0,0,0,0,0,0,0,away,32,14
9/13/2023,642,CConnecticut,90,159.5,-110,CON,Connecticut Sun,-9,-113,1042300121,46,32,78,-14,home,1,1,1,1,1,1,1,home,46,-14
9/13/2023,643,CChicago,59,172.5,-110,CHI,Chicago Sky,16.5,-110,1042300101,53,36,89,-17,home,0,0,0,0,0,0,0,away,36,17
9/13/2023,644,LVLas Vegas,87,172.5,-110,LVA,Las Vegas Aces,-16.5,-110,1042300101,53,36,89,-17,home,1,1,1,1,1,1,1,home,53,-17
9/15/2023,645,WWashington,75,163.5,-110,WAS,Washington Mystics,10,-110,1042300111,46,42,88,-4,home,1,1,1,1,0,1,0,away,42,4
9/15/2023,646,NYNew York,90,164,-116,NYL,New York Liberty,-10,-110,1042300111,46,42,88,-4,home,0,0,0,0,1,0,1,home,46,-4
9/15/2023,647,AAtlanta,82,169,-110,ATL,Atlanta Dream,6,-110,1042300131,49,49,98,0,tie,1,1,1,1,1,1,1,away,49,-0
9/15/2023,648,DDallas,94,169.5,-112,DAL,Dallas Wings,-6,-110,1042300131,49,49,98,0,tie,0,0,0,0,0,0,0,home,49,0
9/17/2023,651,MMinnesota,82,159,-110,MIN,Minnesota Lynx,9.5,-115,1042300122,39,44,83,5,away,1,1,1,1,1,1,1,away,44,-5
9/17/2023,652,CConnecticut,75,159,-110,CON,Connecticut Sun,-9.5,-105,1042300122,39,44,83,5,away,0,0,0,0,0,0,0,home,39,5
9/17/2023,653,CChicago,70,170.5,-110,CHI,Chicago Sky,17.5,-105,1042300102,44,29,73,-15,home,0,0,0,0,0,0,0,away,29,15
9/17/2023,654,LVLas Vegas,92,170.5,-110,LVA,Las Vegas Aces,-17.5,-115,1042300102,44,29,73,-15,home,1,1,1,1,1,1,1,home,44,-15
9/19/2023,655,WWashington,85,162,-110,WAS,Washington Mystics,10.5,-110,1042300112,46,35,81,-11,home,1,1,0,0,0,0,0,away,35,11
9/19/2023,656,NYNew York,90,162,-110,NYL,New York Liberty,-10.5,-110,1042300112,46,35,81,-11,home,0,0,1,1,1,1,1,home,46,-11
9/19/2023,647,AAtlanta,74,169.5,-105,ATL,Atlanta Dream,7,-110,1042300132,52,34,86,-18,home,0,1,1,0,0,0,0,away,34,18
9/19/2023,648,DDallas,101,169.5,-115,DAL,Dallas Wings,-7,-110,1042300132,52,34,86,-18,home,1,0,0,1,1,1,1,home,52,-18
9/20/2023,603,CConnecticut,90,155,-110,CON,Connecticut Sun,-5.5,-117,1042300123,34,49,83,15,away,1,1,1,1,1,1,1,away,49,-15
9/20/2023,604,MMinnesota,75,155,-110,MIN,Minnesota Lynx,5.5,-110,1042300123,34,49,83,15,away,0,0,0,0,0,0,0,home,34,15
9/24/2023,609,CConnecticut,78,162,-115,CON,Connecticut Sun,8.5,-112,1042300211,40,37,77,-3,home,1,1,1,1,1,1,0,away,37,3
9/24/2023,610,NYNew York,63,162,-105,NYL,New York Liberty,-8.5,-108,1042300211,40,37,77,-3,home,0,0,0,0,0,0,1,home,40,-3
9/24/2023,611,DDallas,83,174,-110,DAL,Dallas Wings,10,-110,1042300201,49,45,94,-4,home,0,0,0,0,0,0,0,away,45,4
9/24/2023,612,LVLas Vegas,97,174,-110,LVA,Las Vegas Aces,-10,-110,1042300201,49,45,94,-4,home,1,1,1,1,1,1,1,home,49,-4
9/26/2023,613,CConnecticut,77,159,-115,CON,Connecticut Sun,9.5,-110,1042300212,38,42,80,4,away,0,0,1,1,1,1,1,away,42,-4
9/26/2023,614,NYNew York,84,159,-105,NYL,New York Liberty,-9.5,-110,1042300212,38,42,80,4,away,1,1,0,0,0,0,0,home,38,4
9/26/2023,615,DDallas,84,175,-110,DAL,Dallas Wings,10.5,-108,1042300202,44,37,81,-7,home,0,0,0,0,0,0,0,away,37,7
9/26/2023,616,LVLas Vegas,91,175,-110,LVA,Las Vegas Aces,-10.5,-112,1042300202,44,37,81,-7,home,1,1,1,1,1,1,1,home,44,-7
9/29/2023,617,NYNew York,92,158.5,-110,NYL,New York Liberty,-4.5,100,1042300213,40,54,94,14,away,1,1,1,1,1,1,1,away,54,-14
9/29/2023,618,CConnecticut,81,159,-105,CON,Connecticut Sun,4.5,-120,1042300213,40,54,94,14,away,0,0,0,0,0,0,0,home,40,14
9/29/2023,619,LVLas Vegas,64,175,-105,LVA,Las Vegas Aces,-6.5,-112,1042300203,36,31,67,-5,home,1,1,0,0,0,0,1,away,31,5
9/29/2023,620,DDallas,61,175,-115,DAL,Dallas Wings,6.5,-108,1042300203,36,31,67,-5,home,0,0,1,1,1,1,0,home,36,-5
10/8/2023,629,NYNew York,82,170.5,-110,NYL,New York Liberty,4.5,-110,1042300301,46,49,95,3,away,0,0,0,1,1,1,1,away,49,-3
10/8/2023,630,LVLas Vegas,99,170.5,-110,LVA,Las Vegas Aces,-4.5,-110,1042300301,46,49,95,3,away,1,1,1,0,0,0,0,home,46,3
10/11/2023,631,NYNew York,76,171,-110,NYL,New York Liberty,4.5,-112,1042300302,52,44,96,-8,home,0,0,0,0,0,0,0,away,44,8
10/11/2023,632,LVLas Vegas,104,171,-110,LVA,Las Vegas Aces,-4.5,-108,1042300302,52,44,96,-8,home,1,1,1,1,1,1,1,home,52,-8
10/18/2023,633,LVLas Vegas,70,168.5,-110,LVA,Las Vegas Aces,5.5,-110,1042300304,39,30,69,-9,home,0,0,0,0,0,0,0,away,30,9
10/18/2023,634,NYNew York,69,168.5,-110,NYL,New York Liberty,-5.5,-110,1042300304,39,30,69,-9,home,1,1,1,1,1,1,1,home,39,-9
5/19/2023,631,NYNew York,64,163.5,-110,NYL,New York Liberty,-2,-116,1022300002,39,26,65,-13,home,1,0,0,0,0,0,0,away,26,13
5/19/2023,632,WWashington,80,163.5,-110,WAS,Washington Mystics,2,-104,1022300002,39,26,65,-13,home,0,1,1,1,1,1,1,home,39,-13
5/19/2023,631,CConnecticut,70,162,-110,CON,Connecticut Sun,-7.5,-110,1022300001,28,35,63,7,away,1,1,1,1,1,1,1,away,35,-7
5/19/2023,632,IIndiana,61,162,-110,IND,Indiana Fever,7.5,-110,1022300001,28,35,63,7,away,0,0,0,0,0,0,0,home,28,7
5/19/2023,635,CChicago,77,162.5,-110,CHI,Chicago Sky,5,-110,1022300003,27,44,71,17,away,0,0,0,1,1,1,1,away,44,-17
5/19/2023,636,MMinnesota,66,162.5,-110,MIN,Minnesota Lynx,-5,-110,1022300003,27,44,71,17,away,1,1,1,0,0,0,0,home,27,17
5/19/2023,637,PPhoenix,71,156.5,-110,PHO,Phoenix Mercury,2.5,-110,1022300004,54,41,95,-13,home,1,1,1,1,0,0,0,away,41,13
5/19/2023,638,LALos Angeles,94,156.5,-110,LAS,Los Angeles Sparks,-2.5,-110,1022300004,54,41,95,-13,home,0,0,0,0,1,1,1,home,54,-13
5/20/2023,639,AAtlanta,78,161.5,-110,ATL,Atlanta Dream,2,-110,1022300006,47,30,77,-17,home,0,1,0,0,0,0,0,away,30,17
5/20/2023,640,DDallas,85,161.5,-110,DAL,Dallas Wings,-1.5,-110,1022300006,47,30,77,-17,home,1,0,1,1,1,1,1,home,47,-17
5/20/2023,641,LVLas Vegas,105,167.5,-120,LVA,Las Vegas Aces,-13.5,-110,1022300005,28,43,71,15,away,1,1,1,1,1,1,1,away,43,-15
5/20/2023,642,SSeattle,64,167.5,100,SEA,Seattle Storm,13.5,-110,1022300005,28,43,71,15,away,0,0,0,0,0,0,0,home,28,15
5/21/2023,643,WWashington,74,159,-110,WAS,Washington Mystics,-0.5,-125,1022300007,34,38,72,4,away,1,1,1,1,1,1,1,away,38,-4
5/21/2023,644,CConnecticut,80,159,-110,CON,Connecticut Sun,-0.5,105,1022300007,34,38,72,4,away,0,0,0,0,0,0,0,home,34,4
5/21/2023,645,IIndiana,73,159.5,-110,IND,Indiana Fever,16.5,-110,1022300008,62,35,97,-27,home,0,0,0,0,0,0,0,away,35,27
5/21/2023,646,NYNew York,90,159.5,-110,NYL,New York Liberty,-16.5,-110,1022300008,62,35,97,-27,home,1,1,1,1,1,1,1,home,62,-27
5/21/2023,647,CChicago,75,160,-110,CHI,Chicago Sky,4,-110,1022300009,35,41,76,6,away,1,1,1,1,1,1,1,away,41,-6
5/21/2023,648,PPhoenix,69,160,-110,PHO,Phoenix Mercury,-4,-110,1022300009,35,41,76,6,away,0,0,0,0,0,0,0,home,35,6
5/25/2023,655,LVLas Vegas,94,169.5,-110,LVA,Las Vegas Aces,-15.5,-110,1022300012,46,36,82,-10,home,0,0,0,0,0,0,0,away,36,10
5/25/2023,656,LALos Angeles,85,169.5,-110,LAS,Los Angeles Sparks,15.5,-110,1022300012,46,36,82,-10,home,1,1,1,1,1,1,1,home,46,-10
5/25/2023,653,MMinnesota,81,160,-110,MIN,Minnesota Lynx,5,-110,1022300013,57,40,97,-17,home,0,0,0,0,0,0,0,away,40,17
5/25/2023,654,PPhoenix,90,160,-110,PHO,Phoenix Mercury,-5,-110,1022300013,57,40,97,-17,home,1,1,1,1,1,1,1,home,57,-17
5/26/2023,601,WWashington,71,157,-110,WAS,Washington Mystics,-5,-110,1022300014,34,40,74,6,away,0,1,0,1,1,1,1,away,40,-6
5/26/2023,602,CChicago,69,157,-110,CHI,Chicago Sky,5,-110,1022300014,34,40,74,6,away,1,0,1,0,0,0,0,home,34,6
5/26/2023,603,DDallas,95,161,-110,DAL,Dallas Wings,-4.5,-110,1022300015,41,52,93,11,away,0,0,1,1,1,1,1,away,52,-11
5/26/2023,604,SSeattle,91,161,-110,SEA,Seattle Storm,4,-110,1022300015,41,52,93,11,away,1,1,0,0,0,0,0,home,41,11
5/27/2023,605,CConnecticut,65,165,-110,CON,Connecticut Sun,6.5,-110,1022300016,32,38,70,6,away,1,1,1,1,1,1,1,away,38,-6
5/27/2023,606,NYNew York,81,165,-110,NYL,New York Liberty,-6.5,-110,1022300016,32,38,70,6,away,0,0,0,0,0,0,0,home,32,6
5/27/2023,607,LALos Angeles,65,171,-110,LAS,Los Angeles Sparks,15.5,-110,1022300017,59,28,87,-31,home,0,0,0,0,0,0,0,away,28,31
5/27/2023,608,LVLas Vegas,93,171,-110,LVA,Las Vegas Aces,-15.5,-110,1022300017,59,28,87,-31,home,1,1,1,1,1,1,1,home,59,-31
5/28/2023,609,IIndiana,90,159.5,-110,IND,Indiana Fever,6.5,109,1022300018,47,41,88,-6,home,0,0,0,0,0,0,0,away,41,6
5/28/2023,610,AAtlanta,87,159.5,-110,ATL,Atlanta Dream,-6.5,-129,1022300018,47,41,88,-6,home,1,1,1,1,1,1,1,home,47,-6
5/28/2023,611,DDallas,88,161.5,-110,DAL,Dallas Wings,3,-110,1022300019,49,45,94,-4,home,0,0,0,1,0,0,0,away,45,4
5/28/2023,612,CChicago,94,161.5,-110,CHI,Chicago Sky,-3,-110,1022300019,49,45,94,-4,home,1,1,1,0,1,1,1,home,49,-4
5/28/2023,613,MMinnesota,73,170.5,-110,MIN,Minnesota Lynx,14.5,105,1022300020,50,38,88,-12,home,1,0,0,0,0,0,0,away,38,12
5/28/2023,614,LVLas Vegas,94,170,-115,LVA,Las Vegas Aces,-14.5,-125,1022300020,50,38,88,-12,home,0,1,1,1,1,1,1,home,50,-12
5/30/2023,615,CChicago,65,162.5,-110,CHI,Chicago Sky,3.5,-110,1022300021,40,25,65,-15,home,0,0,0,0,0,0,0,away,25,15
5/30/2023,616,AAtlanta,83,162.5,-110,ATL,Atlanta Dream,-3.5,-110,1022300021,40,25,65,-15,home,1,1,1,1,1,1,1,home,40,-15
5/30/2023,617,IIndiana,78,158,-120,IND,Indiana Fever,12,-102,1022300022,38,34,72,-4,home,0,0,0,1,1,0,0,away,34,4
5/30/2023,618,CConnecticut,81,158,100,CON,Connecticut Sun,-12,-118,1022300022,38,34,72,-4,home,1,1,1,0,0,1,1,home,38,-4
5/30/2023,621,MMinnesota,89,169,-116,MIN,Minnesota Lynx,6,-105,1022300023,52,46,98,-6,home,1,1,1,1,1,1,0,away,46,6
5/30/2023,622,DDallas,94,169,-104,DAL,Dallas Wings,-6,-115,1022300023,52,46,98,-6,home,0,0,0,0,0,0,1,home,52,-6
5/30/2023,619,NYNew York,86,163,-110,NYL,New York Liberty,-14.5,-110,1022300024,39,46,85,7,away,1,1,1,1,1,0,1,away,46,-7
5/30/2023,620,SSeattle,78,163,-110,SEA,Seattle Storm,14.5,-110,1022300024,39,46,85,7,away,0,0,0,0,0,1,0,home,39,7
6/1/2023,623,CConnecticut,89,159.5,-110,CON,Connecticut Sun,-6,-115,1022300025,47,47,94,0,tie,1,1,1,1,0,1,1,away,47,-0
6/1/2023,624,MMinnesota,84,159.5,-110,MIN,Minnesota Lynx,6,-105,1022300025,47,47,94,0,tie,0,0,0,0,1,0,0,home,47,0
6/2/2023,625,NYNew York,77,159,-105,NYL,New York Liberty,-10,-110,1022300028,43,35,78,-8,home,0,0,0,0,0,0,0,away,35,8
6/2/2023,626,CChicago,76,159,-115,CHI,Chicago Sky,10,-110,1022300028,43,35,78,-8,home,1,1,1,1,1,1,1,home,43,-8
6/2/2023,627,DDallas,74,168,-110,DAL,Dallas Wings,7,105,1022300026,36,30,66,-6,home,0,1,1,0,0,0,0,away,30,6
6/2/2023,628,WWashington,75,168,-110,WAS,Washington Mystics,-7,-125,1022300026,36,30,66,-6,home,1,0,0,1,1,1,1,home,36,-6
6/2/2023,629,LVLas Vegas,92,173,-116,LVA,Las Vegas Aces,-11.5,-110,1022300027,30,45,75,15,away,1,1,1,1,1,1,1,away,45,-15
6/2/2023,630,AAtlanta,87,173,-104,ATL,Atlanta Dream,11.5,-110,1022300027,30,45,75,15,away,0,0,0,0,0,0,0,home,30,15
6/2/2023,631,LALos Angeles,99,164,-110,LAS,Los Angeles Sparks,3.5,-110,1022300029,44,44,88,0,tie,1,1,1,1,1,1,1,away,44,-0
6/2/2023,632,PPhoenix,93,164,-110,PHO,Phoenix Mercury,-3.5,-110,1022300029,44,44,88,0,tie,0,0,0,0,0,0,0,home,44,0
6/3/2023,633,MMinnesota,80,160.5,-110,MIN,Minnesota Lynx,8,-110,1022300030,32,39,71,7,away,0,0,0,1,1,1,1,away,39,-7
6/3/2023,634,WWashington,78,160.5,-110,WAS,Washington Mystics,-8,-110,1022300030,32,39,71,7,away,1,1,1,0,0,0,0,home,32,7
6/3/2023,635,SSeattle,85,162,-110,SEA,Seattle Storm,6.5,-106,1022300031,39,39,78,0,tie,1,1,1,1,1,0,0,away,39,-0
6/3/2023,636,LALos Angeles,92,162,-110,LAS,Los Angeles Sparks,-6.5,-114,1022300031,39,39,78,0,tie,0,0,0,0,0,1,1,home,39,0
6/4/2023,637,DDallas,74,166,-110,DAL,Dallas Wings,6,-110,1022300032,44,30,74,-14,home,0,0,0,0,0,0,0,away,30,14
6/4/2023,638,CConnecticut,80,166,-110,CON,Connecticut Sun,-6,-110,1022300032,44,30,74,-14,home,1,1,1,1,1,1,1,home,44,-14
6/4/2023,639,CChicago,86,155.5,-110,CHI,Chicago Sky,12,-113,1022300033,47,30,77,-17,home,0,0,0,0,0,0,0,away,30,17
6/4/2023,640,NYNew York,82,155.5,-110,NYL,New York Liberty,-12,-107,1022300033,47,30,77,-17,home,1,1,1,1,1,1,1,home,47,-17
6/4/2023,641,LVLas Vegas,84,171.5,-110,LVA,Las Vegas Aces,-14.5,-111,1022300034,39,38,77,-1,home,0,0,0,0,0,0,0,away,38,1
6/4/2023,642,IIndiana,80,171.5,-110,IND,Indiana Fever,14.5,-109,1022300034,39,38,77,-1,home,1,1,1,1,1,1,1,home,39,-1
6/6/2023,645,LVLas Vegas,90,168,-110,LVA,Las Vegas Aces,-5.5,-104,1022300035,31,48,79,17,away,1,1,1,1,1,1,1,away,48,-17
6/6/2023,646,CConnecticut,84,168,-110,CON,Connecticut Sun,5.5,-116,1022300035,31,48,79,17,away,0,0,0,0,0,0,0,home,31,17
6/6/2023,647,IIndiana,103,157,-110,IND,Indiana Fever,5,-112,1022300036,44,50,94,6,away,0,1,0,0,0,1,1,away,50,-6
6/6/2023,648,CChicago,108,157,-110,CHI,Chicago Sky,-5,-108,1022300036,44,50,94,6,away,1,0,1,1,1,0,0,home,44,6
6/6/2023,649,LALos Angeles,63,164,-110,LAS,Los Angeles Sparks,-3,-117,1022300037,35,38,73,3,away,1,1,1,1,1,1,1,away,38,-3
6/6/2023,650,SSeattle,66,164,-110,SEA,Seattle Storm,3,-103,1022300037,35,38,73,3,away,0,0,0,0,0,0,0,home,35,3
6/7/2023,653,PPhoenix,79,167.5,-115,PHO,Phoenix Mercury,5,-107,1022300039,44,48,92,4,away,1,1,1,1,0,0,0,away,48,-4
6/7/2023,654,DDallas,84,167.5,-110,DAL,Dallas Wings,-5,-113,1022300039,44,48,92,4,away,0,0,0,0,1,1,1,home,44,4
6/7/2023,651,MMinnesota,NA,163,-115,MIN,Minnesota Lynx,13.5,-110,NA,NA,NA,NA,NA,NA,NA,NA,NA,NA,NA,NA,NA,NA,NA,NA
6/7/2023,652,NYNew York,NA,163,-105,NYL,New York Liberty,-13.5,-110,NA,NA,NA,NA,NA,NA,NA,NA,NA,NA,NA,NA,NA,NA,NA,NA
6/8/2023,655,LVLas Vegas,77,167,-115,LVA,Las Vegas Aces,-5.5,-110,1022300040,43,28,71,-15,home,0,0,0,0,0,0,0,away,28,15
6/8/2023,656,CConnecticut,94,168,-110,CON,Connecticut Sun,5.5,-110,1022300040,43,28,71,-15,home,1,1,1,1,1,1,1,home,43,-15
6/9/2023,657,NYNew York,106,165,-115,NYL,New York Liberty,-5.5,-131,1022300041,39,61,100,22,away,0,0,1,1,1,1,1,away,61,-22
6/9/2023,658,AAtlanta,83,165,-105,ATL,Atlanta Dream,6.5,-110,1022300041,39,61,100,22,away,1,1,0,0,0,0,0,home,39,22
6/9/2023,659,IIndiana,71,160.5,-110,IND,Indiana Fever,3,-115,1022300043,34,36,70,2,away,1,1,0,0,0,1,1,away,36,-2
6/9/2023,660,MMinnesota,69,160.5,-110,MIN,Minnesota Lynx,-3,-105,1022300043,34,36,70,2,away,0,0,1,1,1,0,0,home,34,2
6/9/2023,661,PPhoenix,77,168,-115,PHO,Phoenix Mercury,4.5,120,1022300042,45,42,87,-3,home,1,1,1,1,1,1,0,away,42,3
6/9/2023,662,DDallas,90,168,-105,DAL,Dallas Wings,-5.5,-115,1022300042,45,42,87,-3,home,0,0,0,0,0,0,1,home,45,-3
6/9/2023,665,CChicago,62,158.5,-110,CHI,Chicago Sky,3.5,-109,1022300044,37,33,70,-4,home,0,0,0,0,0,0,0,away,33,4
6/9/2023,666,LALos Angeles,77,158.5,-110,LAS,Los Angeles Sparks,-3.5,-111,1022300044,37,33,70,-4,home,1,1,1,1,1,1,1,home,37,-4
6/9/2023,663,WWashington,73,156,-110,WAS,Washington Mystics,-12.5,-106,1022300045,32,46,78,14,away,1,1,1,1,1,1,1,away,46,-14
6/9/2023,664,SSeattle,66,156,-110,SEA,Seattle Storm,12.5,-114,1022300045,32,46,78,14,away,0,0,0,0,0,0,0,home,32,14
6/15/2023,621,AAtlanta,92,164,-110,ATL,Atlanta Dream,9,-110,1022300056,50,40,90,-10,home,1,1,0,0,0,0,0,away,40,10
6/15/2023,622,CConnecticut,88,164,-110,CON,Connecticut Sun,-9,-110,1022300056,50,40,90,-10,home,0,0,1,1,1,1,1,home,50,-10
6/15/2023,623,IIndiana,92,157,-110,IND,Indiana Fever,-1.5,-112,1022300057,37,38,75,1,away,0,0,0,0,0,0,0,away,38,-1
6/15/2023,624,CChicago,90,157,-110,CHI,Chicago Sky,1.5,-108,1022300057,37,38,75,1,away,1,1,1,1,1,1,1,home,37,1
6/15/2023,625,SSeattle,63,168,-105,SEA,Seattle Storm,18.5,-115,1022300058,47,37,84,-10,home,1,0,0,0,0,1,0,away,37,10
6/15/2023,626,LVLas Vegas,96,168,-110,LVA,Las Vegas Aces,-18.5,-105,1022300058,47,37,84,-10,home,0,1,1,1,1,0,1,home,47,-10
6/16/2023,627,PPhoenix,69,156,-105,PHO,Phoenix Mercury,12,-110,1022300059,54,38,92,-16,home,0,0,0,0,0,0,0,away,38,16
6/16/2023,628,WWashington,88,156,-115,WAS,Washington Mystics,-12,105,1022300059,54,38,92,-16,home,1,1,1,1,1,1,1,home,54,-16
6/16/2023,629,MMinnesota,77,160,-115,MIN,Minnesota Lynx,5.5,103,1022300060,43,34,77,-9,home,0,0,1,0,0,0,0,away,34,9
6/16/2023,630,LALos Angeles,72,160.5,-110,LAS,Los Angeles Sparks,-5.5,-123,1022300060,43,34,77,-9,home,1,1,0,1,1,1,1,home,43,-9
6/17/2023,631,SSeattle,109,165,-110,SEA,Seattle Storm,8.5,-105,1022300061,47,55,102,8,away,1,1,1,1,1,1,1,away,55,-8
6/17/2023,632,DDallas,103,165,-110,DAL,Dallas Wings,-8.5,-115,1022300061,47,55,102,8,away,0,0,0,0,0,0,0,home,47,8
6/20/2023,643,AAtlanta,73,173.5,-110,ATL,Atlanta Dream,4,-110,1022300067,43,32,75,-11,home,0,0,0,0,0,0,0,away,32,11
6/20/2023,644,DDallas,85,173.5,-110,DAL,Dallas Wings,-4,-110,1022300067,43,32,75,-11,home,1,1,1,1,1,1,1,home,43,-11
6/20/2023,647,MMinnesota,67,157.5,-110,MIN,Minnesota Lynx,6.5,-110,1022300068,33,32,65,-1,home,0,0,0,1,0,1,1,away,32,1
6/20/2023,648,LALos Angeles,61,157.5,-103,LAS,Los Angeles Sparks,-6.5,-110,1022300068,33,32,65,-1,home,1,1,1,0,1,0,0,home,33,-1
6/20/2023,645,CConnecticut,85,160.5,-110,CON,Connecticut Sun,-8,-110,1022300069,48,45,93,-3,home,1,1,1,0,1,1,0,away,45,3
6/20/2023,646,SSeattle,79,160.5,-110,SEA,Seattle Storm,8,-110,1022300069,48,45,93,-3,home,0,0,0,1,0,0,1,home,48,-3
6/21/2023,649,LVLas Vegas,99,164,-110,LVA,Las Vegas Aces,-19.5,-110,1022300070,40,57,97,17,away,1,1,1,1,1,1,1,away,57,-17
6/21/2023,650,PPhoenix,79,164,-110,PHO,Phoenix Mercury,19.5,-110,1022300070,40,57,97,17,away,0,0,0,0,0,0,0,home,40,17
6/23/2023,601,NYNew York,110,172,-115,NYL,New York Liberty,-7,-108,1022300074,40,59,99,19,away,1,1,1,1,1,1,1,away,59,-19
6/23/2023,602,AAtlanta,80,172,-105,ATL,Atlanta Dream,7,-112,1022300074,40,59,99,19,away,0,0,0,0,0,0,0,home,40,19
6/23/2023,603,DDallas,74,163.5,-110,DAL,Dallas Wings,-2.5,-117,1022300075,33,42,75,9,away,1,1,1,1,1,1,1,away,42,-9
6/23/2023,604,LALos Angeles,76,163.5,-110,LAS,Los Angeles Sparks,2.5,-103,1022300075,33,42,75,9,away,0,0,0,0,0,0,0,home,33,9
6/24/2023,605,PPhoenix,74,162.5,-112,PHO,Phoenix Mercury,1.5,-110,1022300077,49,34,83,-15,home,0,0,0,0,0,0,0,away,34,15
6/24/2023,606,SSeattle,97,162.5,-108,SEA,Seattle Storm,-1.5,-110,1022300077,49,34,83,-15,home,1,1,1,1,1,1,1,home,49,-15
6/24/2023,607,IIndiana,88,170,-115,IND,Indiana Fever,15.5,-110,1022300076,57,43,100,-14,home,0,0,0,0,0,0,0,away,43,14
6/24/2023,608,LVLas Vegas,101,170,-105,LVA,Las Vegas Aces,-15.5,-110,1022300076,57,43,100,-14,home,1,1,1,1,1,1,1,home,57,-14
6/25/2023,609,CChicago,72,157.5,-102,CHI,Chicago Sky,6,-112,1022300078,54,42,96,-12,home,1,1,1,0,0,0,0,away,42,12
6/25/2023,610,CConnecticut,96,157.5,-118,CON,Connecticut Sun,-6,-110,1022300078,54,42,96,-12,home,0,0,0,1,1,1,1,home,54,-12
6/25/2023,611,WWashington,88,162,-110,WAS,Washington Mystics,7,-110,1022300079,39,45,84,6,away,1,1,1,1,1,1,1,away,45,-6
6/25/2023,612,NYNew York,89,162.5,-110,NYL,New York Liberty,-7,-110,1022300079,39,45,84,6,away,0,0,0,0,0,0,0,home,39,6
6/25/2023,613,DDallas,83,162.5,-110,DAL,Dallas Wings,-2.5,-110,1022300080,44,44,88,0,tie,1,1,0,0,0,0,0,away,44,-0
6/25/2023,614,LALos Angeles,93,162.5,-110,LAS,Los Angeles Sparks,2.5,-110,1022300080,44,44,88,0,tie,0,0,1,1,1,1,1,home,44,0
6/26/2023,615,IIndiana,80,168.5,-110,IND,Indiana Fever,14.5,-105,1022300081,48,49,97,1,away,1,0,1,0,0,0,1,away,49,-1
6/26/2023,616,LVLas Vegas,88,168.5,-110,LVA,Las Vegas Aces,-14.5,-115,1022300081,48,49,97,1,away,0,1,0,1,1,1,0,home,48,1
6/27/2023,617,NYNew York,89,168,-110,NYL,New York Liberty,-5,-108,1022300082,43,47,90,4,away,1,0,1,0,1,1,0,away,47,-4
6/27/2023,618,CConnecticut,81,168,-110,CON,Connecticut Sun,5,-112,1022300082,43,47,90,4,away,0,1,0,1,0,0,1,home,43,4
6/27/2023,619,SSeattle,93,161,-110,SEA,Seattle Storm,3.5,-110,1022300083,53,47,100,-6,home,0,0,0,0,0,0,0,away,47,6
6/27/2023,620,MMinnesota,104,161,-110,MIN,Minnesota Lynx,-3.5,-110,1022300083,53,47,100,-6,home,1,1,1,1,1,1,1,home,53,-6
6/27/2023,621,DDallas,77,168,-110,DAL,Dallas Wings,-4,-110,1022300084,32,36,68,4,away,1,1,1,1,1,1,1,away,36,-4
6/27/2023,622,PPhoenix,62,168.5,-110,PHO,Phoenix Mercury,4,-110,1022300084,32,36,68,4,away,0,0,0,0,0,0,0,home,32,4
6/28/2023,623,LALos Angeles,63,155.5,-115,LAS,Los Angeles Sparks,2.5,-110,1022300085,46,37,83,-9,home,1,1,1,0,0,0,0,away,37,9
6/28/2023,624,CChicago,80,156.5,-110,CHI,Chicago Sky,-2.5,-110,1022300085,46,37,83,-9,home,0,0,0,1,1,1,1,home,46,-9
6/28/2023,625,AAtlanta,86,163,-108,ATL,Atlanta Dream,5,-110,1022300086,61,33,94,-28,home,1,0,0,0,0,0,0,away,33,28
6/28/2023,626,WWashington,109,163,-112,WAS,Washington Mystics,-5,-110,1022300086,61,33,94,-28,home,0,1,1,1,1,1,1,home,61,-28
6/29/2023,627,MMinnesota,99,162,-105,MIN,Minnesota Lynx,2.5,-107,1022300089,46,48,94,2,away,1,1,1,1,1,1,1,away,48,-2
6/29/2023,628,SSeattle,97,162,-115,SEA,Seattle Storm,-3,-110,1022300089,46,48,94,2,away,0,0,0,0,0,0,0,home,46,2
6/29/2023,629,IIndiana,63,163,-110,IND,Indiana Fever,-3,105,1022300088,52,35,87,-17,home,0,0,0,0,0,0,0,away,35,17
6/29/2023,630,PPhoenix,85,163,-110,PHO,Phoenix Mercury,3,-125,1022300088,52,35,87,-17,home,1,1,1,1,1,1,1,home,52,-17
6/29/2023,631,NYNew York,81,175.5,-105,NYL,New York Liberty,6.5,-110,1022300087,49,42,91,-7,home,0,0,0,0,0,0,0,away,42,7
6/29/2023,632,LVLas Vegas,98,175.5,-115,LVA,Las Vegas Aces,-6.5,-110,1022300087,49,42,91,-7,home,1,1,1,1,1,1,1,home,49,-7
6/30/2023,633,WWashington,89,163.5,-110,WAS,Washington Mystics,-1.5,-110,1022300090,47,48,95,1,away,0,0,0,0,0,0,0,away,48,-1
6/30/2023,634,AAtlanta,94,163.5,-110,ATL,Atlanta Dream,2.5,-125,1022300090,47,48,95,1,away,1,1,1,1,1,1,1,home,47,1
6/30/2023,635,LALos Angeles,78,155.5,-110,LAS,Los Angeles Sparks,2,-110,1022300091,43,38,81,-5,home,1,0,0,0,1,1,0,away,38,5
6/30/2023,636,CChicago,86,155.5,-110,CHI,Chicago Sky,-2,-110,1022300091,43,38,81,-5,home,0,1,1,1,0,0,1,home,43,-5
7/1/2023,637,CConnecticut,84,171,-110,CON,Connecticut Sun,11,-105,1022300092,59,48,107,-11,home,0,0,0,0,0,0,0,away,48,11
7/1/2023,638,LVLas Vegas,102,169.5,-110,LVA,Las Vegas Aces,-11,-115,1022300092,59,48,107,-11,home,1,1,1,1,1,1,1,home,59,-11
7/1/2023,639,MMinnesota,86,158,-135,MIN,Minnesota Lynx,1.5,-115,1022300093,37,46,83,9,away,0,0,0,1,1,1,1,away,46,-9
7/1/2023,640,PPhoenix,76,158,115,PHO,Phoenix Mercury,-1.5,-105,1022300093,37,46,83,9,away,1,1,1,0,0,0,0,home,37,9
7/2/2023,643,WWashington,72,161.5,-115,WAS,Washington Mystics,6,-102,1022300096,37,33,70,-4,home,1,1,1,0,0,0,0,away,33,4
7/2/2023,644,DDallas,89,161.5,-105,DAL,Dallas Wings,-6,-115,1022300096,37,33,70,-4,home,0,0,0,1,1,1,1,home,37,-4
7/2/2023,641,LALos Angeles,84,165.5,-113,LAS,Los Angeles Sparks,5,-108,1022300094,54,48,102,-6,home,0,1,0,0,0,1,1,away,48,6
7/2/2023,642,AAtlanta,112,165.5,-107,ATL,Atlanta Dream,-5,-112,1022300094,54,48,102,-6,home,1,0,1,1,1,0,0,home,54,-6
7/2/2023,645,CChicago,89,159.5,-110,CHI,Chicago Sky,3,-110,1022300095,47,54,101,7,away,0,0,1,1,1,1,1,away,54,-7
7/2/2023,646,IIndiana,87,159.5,-110,IND,Indiana Fever,-3,-110,1022300095,47,54,101,7,away,1,1,0,0,0,0,0,home,47,7
7/2/2023,647,NYNew York,81,170.5,-110,NYL,New York Liberty,-10.5,-110,1022300097,27,44,71,17,away,1,1,1,1,1,1,1,away,44,-17
7/2/2023,648,SSeattle,66,170.5,-110,SEA,Seattle Storm,10.5,-110,1022300097,27,44,71,17,away,0,0,0,0,0,0,0,home,27,17
7/5/2023,649,PPhoenix,95,167,-110,PHO,Phoenix Mercury,15,-115,1022300098,53,46,99,-7,home,0,0,0,0,0,0,0,away,46,7
7/5/2023,650,NYNew York,99,167,-110,NYL,New York Liberty,-15,-110,1022300098,53,46,99,-7,home,1,1,1,1,1,1,1,home,53,-7
7/5/2023,651,IIndiana,83,165.5,-110,IND,Indiana Fever,2,-110,1022300099,47,42,89,-5,home,1,0,0,0,0,0,0,away,42,5
7/5/2023,652,MMinnesota,90,166,-110,MIN,Minnesota Lynx,-2,-110,1022300099,47,42,89,-5,home,0,1,1,1,1,1,1,home,47,-5
7/5/2023,653,DDallas,82,173,106,DAL,Dallas Wings,11.5,-105,1022300100,42,51,93,9,away,1,1,1,1,1,1,1,away,51,-9
7/5/2023,654,LVLas Vegas,89,173,-126,LVA,Las Vegas Aces,-11.5,-115,1022300100,42,51,93,9,away,0,0,0,0,0,0,0,home,42,9
7/5/2023,655,AAtlanta,90,168.5,-110,ATL,Atlanta Dream,1.5,-110,1022300101,40,53,93,13,away,1,1,1,1,1,1,1,away,53,-13
7/5/2023,656,LALos Angeles,79,168.5,-110,LAS,Los Angeles Sparks,-1.5,-110,1022300101,40,53,93,13,away,0,0,0,0,0,0,0,home,40,13
7/6/2023,601,SSeattle,73,166,-110,SEA,Seattle Storm,10,-110,1022300102,57,24,81,-33,home,0,0,0,0,0,0,0,away,24,33
7/6/2023,602,CConnecticut,93,166,-110,CON,Connecticut Sun,-10,-110,1022300102,57,24,81,-33,home,1,1,1,1,1,1,1,home,57,-33
7/7/2023,603,IIndiana,88,155.5,-110,IND,Indiana Fever,-0.5,-120,1022300103,55,40,95,-15,home,0,0,0,0,0,0,0,away,40,15
7/7/2023,604,WWashington,96,155,-105,WAS,Washington Mystics,-0.5,100,1022300103,55,40,95,-15,home,1,1,1,1,1,1,1,home,55,-15
7/7/2023,607,AAtlanta,82,168.5,-110,ATL,Atlanta Dream,1,-108,1022300104,41,42,83,1,away,1,1,1,1,1,1,1,away,42,-1
7/7/2023,608,CChicago,68,168.5,-110,CHI,Chicago Sky,-1,-110,1022300104,41,42,83,1,away,0,0,0,0,0,0,0,home,41,1
7/7/2023,609,PPhoenix,64,160.5,-110,PHO,Phoenix Mercury,5.5,-110,1022300106,39,22,61,-17,home,0,0,0,0,0,0,0,away,22,17
7/7/2023,610,MMinnesota,75,160.5,-110,MIN,Minnesota Lynx,-5.5,-110,1022300106,39,22,61,-17,home,1,1,1,1,1,1,1,home,39,-17
7/7/2023,605,LVLas Vegas,78,177.5,-110,LVA,Las Vegas Aces,-10,-105,1022300105,39,40,79,1,away,0,0,0,1,0,1,1,away,40,-1
7/7/2023,606,DDallas,80,177.5,-110,DAL,Dallas Wings,10,-115,1022300105,39,40,79,1,away,1,1,1,0,1,0,0,home,39,1
7/8/2023,611,SSeattle,76,169.5,-110,SEA,Seattle Storm,15.5,-110,1022300107,35,36,71,1,away,0,0,0,0,0,1,1,away,36,-1
7/8/2023,612,NYNew York,80,169.5,-110,NYL,New York Liberty,-15.5,-110,1022300107,35,36,71,1,away,1,1,1,1,1,0,0,home,35,1
7/9/2023,613,WWashington,84,161.5,-110,WAS,Washington Mystics,4.5,-110,1022300108,46,41,87,-5,home,0,0,0,1,1,1,0,away,41,5
7/9/2023,614,CConnecticut,92,161.5,-110,CON,Connecticut Sun,-4.5,-110,1022300108,46,41,87,-5,home,1,1,1,0,0,0,1,home,46,-5
7/9/2023,615,DDallas,77,168.5,-110,DAL,Dallas Wings,-3.5,-110,1022300109,38,38,76,0,tie,0,1,1,1,1,1,1,away,38,-0
7/9/2023,616,IIndiana,76,168.5,-110,IND,Indiana Fever,3.5,-110,1022300109,38,38,76,0,tie,1,0,0,0,0,0,0,home,38,0
7/9/2023,617,LALos Angeles,72,159,-110,LAS,Los Angeles Sparks,2,-110,1022300110,42,36,78,-6,home,1,0,0,0,0,1,0,away,36,6
7/9/2023,618,PPhoenix,78,159,-110,PHO,Phoenix Mercury,-2,-110,1022300110,42,36,78,-6,home,0,1,1,1,1,0,1,home,42,-6
7/9/2023,619,LVLas Vegas,113,171,-103,LVA,Las Vegas Aces,-11.5,-113,1022300111,42,54,96,12,away,1,1,1,1,1,1,1,away,54,-12
7/9/2023,620,MMinnesota,89,171,-117,MIN,Minnesota Lynx,11.5,-107,1022300111,42,54,96,12,away,0,0,0,0,0,0,0,home,42,12
7/9/2023,621,AAtlanta,88,166.5,-110,ATL,Atlanta Dream,2,-104,1022300112,33,42,75,9,away,1,0,1,1,1,1,1,away,42,-9
7/9/2023,622,CChicago,77,166.5,-116,CHI,Chicago Sky,-2,-116,1022300112,33,42,75,9,away,0,1,0,0,0,0,0,home,33,9
7/11/2023,623,SSeattle,86,159,-110,SEA,Seattle Storm,5,-124,1022300113,47,39,86,-8,home,1,1,1,0,0,0,0,away,39,8
7/11/2023,624,WWashington,93,159,-110,WAS,Washington Mystics,-5,-105,1022300113,47,39,86,-8,home,0,0,0,1,1,1,1,home,47,-8
7/11/2023,625,PPhoenix,72,170,-110,PHO,Phoenix Mercury,17,-114,1022300114,52,34,86,-18,home,0,1,0,0,0,0,0,away,34,18
7/11/2023,626,LVLas Vegas,98,170,-110,LVA,Las Vegas Aces,-17,-106,1022300114,52,34,86,-18,home,1,0,1,1,1,1,1,home,52,-18
7/12/2023,627,NYNew York,95,169.5,-110,NYL,New York Liberty,-10,-107,1022300115,41,48,89,7,away,0,0,0,0,0,1,1,away,48,-7
7/12/2023,628,IIndiana,87,169.5,-110,IND,Indiana Fever,10,-113,1022300115,41,48,89,7,away,1,1,1,1,1,0,0,home,41,7
7/12/2023,629,CConnecticut,84,160.5,-115,CON,Connecticut Sun,-5.5,-110,1022300116,38,36,74,-2,home,1,1,1,1,1,0,0,away,36,2
7/12/2023,630,CChicago,72,160.5,-105,CHI,Chicago Sky,5.5,-110,1022300116,38,36,74,-2,home,0,0,0,0,0,1,1,home,38,-2
7/12/2023,631,DDallas,107,168,-110,DAL,Dallas Wings,-2.5,-110,1022300117,34,50,84,16,away,1,1,1,1,1,1,1,away,50,-16
7/12/2023,632,MMinnesota,67,168,-110,MIN,Minnesota Lynx,2.5,-110,1022300117,34,50,84,16,away,0,0,0,0,0,0,0,home,34,16
7/12/2023,633,SSeattle,75,167,-112,SEA,Seattle Storm,14,-108,1022300118,48,33,81,-15,home,0,0,0,0,0,0,0,away,33,15
7/12/2023,634,AAtlanta,85,167,-108,ATL,Atlanta Dream,-14,-110,1022300118,48,33,81,-15,home,1,1,1,1,1,1,1,home,48,-15
7/12/2023,635,LVLas Vegas,97,169.5,-110,LVA,Las Vegas Aces,-13,-110,1022300119,31,54,85,23,away,1,1,1,1,1,1,1,away,54,-23
7/12/2023,636,LALos Angeles,78,169.5,-110,LAS,Los Angeles Sparks,13,-110,1022300119,31,54,85,23,away,0,0,0,0,0,0,0,home,31,23
7/19/2023,651,IIndiana,82,158,-112,IND,Indiana Fever,2.5,-110,1022300122,36,39,75,3,away,0,1,1,1,1,0,1,away,39,-3
7/19/2023,652,WWashington,76,158,-108,WAS,Washington Mystics,-2.5,-110,1022300122,36,39,75,3,away,1,0,0,0,0,1,0,home,36,3
7/19/2023,653,DDallas,98,167.5,-110,DAL,Dallas Wings,7,-110,1022300123,51,49,100,-2,home,1,1,1,1,1,1,1,away,49,2
7/19/2023,654,NYNew York,88,167.5,-110,NYL,New York Liberty,-7.5,-110,1022300123,51,49,100,-2,home,0,0,0,0,0,0,0,home,51,-2
7/20/2023,655,AAtlanta,71,169.5,-110,ATL,Atlanta Dream,5.5,-115,1022300124,38,41,79,3,away,0,0,1,1,1,0,1,away,41,-3
7/20/2023,656,CConnecticut,82,169.5,-110,CON,Connecticut Sun,-5.5,-105,1022300124,38,41,79,3,away,1,1,0,0,0,1,0,home,38,3
7/20/2023,657,LALos Angeles,70,165,-110,LAS,Los Angeles Sparks,3,105,1022300125,46,29,75,-17,home,1,1,0,0,0,0,0,away,29,17
7/20/2023,658,MMinnesota,73,165,-110,MIN,Minnesota Lynx,-3,-125,1022300125,46,29,75,-17,home,0,0,1,1,1,1,1,home,46,-17
7/20/2023,659,CChicago,62,155,-110,CHI,Chicago Sky,-2,-107,1022300126,40,30,70,-10,home,0,0,0,0,0,0,0,away,30,10
7/20/2023,660,PPhoenix,80,155,-110,PHO,Phoenix Mercury,2,-113,1022300126,40,30,70,-10,home,1,1,1,1,1,1,1,home,40,-10
7/20/2023,661,LVLas Vegas,79,170.5,-110,LVA,Las Vegas Aces,-16.5,-110,1022300127,28,39,67,11,away,0,1,1,1,1,1,1,away,39,-11
7/20/2023,662,SSeattle,63,170.5,-110,SEA,Seattle Storm,16.5,-109,1022300127,28,39,67,11,away,1,0,0,0,0,0,0,home,28,11
7/22/2023,601,CConnecticut,86,167.5,-110,CON,Connecticut Sun,1,-106,1022300129,38,45,83,7,away,1,1,1,1,1,1,1,away,45,-7
7/22/2023,602,AAtlanta,78,167.5,-110,ATL,Atlanta Dream,-1,-114,1022300129,38,45,83,7,away,0,0,0,0,0,0,0,home,38,7
7/22/2023,603,LVLas Vegas,98,171,-110,LVA,Las Vegas Aces,-14.5,-105,1022300132,30,48,78,18,away,1,1,1,1,1,1,1,away,48,-18
7/22/2023,604,MMinnesota,81,171,-110,MIN,Minnesota Lynx,14.5,-115,1022300132,30,48,78,18,away,0,0,0,0,0,0,0,home,30,18
7/22/2023,605,LALos Angeles,84,164.5,-110,LAS,Los Angeles Sparks,8,-110,1022300131,52,48,100,-4,home,0,0,0,1,1,0,0,away,48,4
7/22/2023,606,DDallas,98,164.5,-110,DAL,Dallas Wings,-8,-110,1022300131,52,48,100,-4,home,1,1,1,0,0,1,1,home,52,-4
7/22/2023,607,CChicago,90,159,-110,CHI,Chicago Sky,1.5,-110,1022300130,32,49,81,17,away,1,1,1,1,1,1,1,away,49,-17
7/22/2023,608,SSeattle,75,159,-110,SEA,Seattle Storm,-1.5,-110,1022300130,32,49,81,17,away,0,0,0,0,0,0,0,home,32,17
